,_Player_,_Squad_,_Born_,defense__Rk,defense__Nation,defense__Pos,defense__Age,defense__90s,defense_Tackles_Tkl,defense_Tackles_TklW,defense_Tackles_Def 3rd,defense_Tackles_Mid 3rd,defense_Tackles_Att 3rd,defense_Challenges_Tkl,defense_Challenges_Att,defense_Challenges_Tkl%,defense_Challenges_Lost,defense_Blocks_Blocks,defense_Blocks_Sh,defense_Blocks_Pass,defense__Int,defense__Tkl+Int,defense__Clr,defense__Err,defense_Matches,gca__Rk,gca__Nation,gca__Pos,gca__Age,gca__90s,gca_SCA_SCA,gca_SCA_SCA90,gca_SCATypes_PassLive,gca_SCATypes_PassDead,gca_SCATypes_TO,gca_SCATypes_Sh,gca_SCATypes_Fld,gca_SCATypes_Def,gca_GCA_GCA,gca_GCA_GCA90,gca_GCATypes_PassLive,gca_GCATypes_PassDead,gca_GCATypes_TO,gca_GCATypes_Sh,gca_GCATypes_Fld,gca_GCATypes_Def,gca_Matches,keepersadv__Rk,keepersadv__Nation,keepersadv__Pos,keepersadv__Age,keepersadv__90s,keepersadv_Goals_GA,keepersadv_Goals_PKA,keepersadv_Goals_FK,keepersadv_Goals_CK,keepersadv_Goals_OG,keepersadv_Expected_PSxG,keepersadv_Expected_PSxG/SoT,keepersadv_Expected_PSxG+/-,keepersadv_Expected_/90,keepersadv_Launched_Cmp,keepersadv_Launched_Att,keepersadv_Launched_Cmp%,keepersadv_Passes_Att (GK),keepersadv_Passes_Thr,keepersadv_Passes_Launch%,keepersadv_Passes_AvgLen,keepersadv_GoalKicks_Att,keepersadv_GoalKicks_Launch%,keepersadv_GoalKicks_AvgLen,keepersadv_Crosses_Opp,keepersadv_Crosses_Stp,keepersadv_Crosses_Stp%,keepersadv_Sweeper_#OPA,keepersadv_Sweeper_#OPA/90,keepersadv_Sweeper_AvgDist,keepersadv_Matches,keepers__Rk,keepers__Nation,keepers__Pos,keepers__Age,keepers_PlayingTime_MP,keepers_PlayingTime_Starts,keepers_PlayingTime_Min,keepers_PlayingTime_90s,keepers_Performance_GA,keepers_Performance_GA90,keepers_Performance_SoTA,keepers_Performance_Saves,keepers_Performance_Save%,keepers_Performance_W,keepers_Performance_D,keepers_Performance_L,keepers_Performance_CS,keepers_Performance_CS%,keepers_PenaltyKicks_PKatt,keepers_PenaltyKicks_PKA,keepers_PenaltyKicks_PKsv,keepers_PenaltyKicks_PKm,keepers_PenaltyKicks_Save%,keepers_Matches,misc__Rk,misc__Nation,misc__Pos,misc__Age,misc__90s,misc_Performance_CrdY,misc_Performance_CrdR,misc_Performance_2CrdY,misc_Performance_Fls,misc_Performance_Fld,misc_Performance_Off,misc_Performance_Crs,misc_Performance_Int,misc_Performance_TklW,misc_Performance_PKwon,misc_Performance_PKcon,misc_Performance_OG,misc_Performance_Recov,misc_AerialDuels_Won,misc_AerialDuels_Lost,misc_AerialDuels_Won%,misc_Matches,passingtypes__Rk,passingtypes__Nation,passingtypes__Pos,passingtypes__Age,passingtypes__90s,passingtypes__Att,passingtypes_PassTypes_Live,passingtypes_PassTypes_Dead,passingtypes_PassTypes_FK,passingtypes_PassTypes_TB,passingtypes_PassTypes_Sw,passingtypes_PassTypes_Crs,passingtypes_PassTypes_TI,passingtypes_PassTypes_CK,passingtypes_CornerKicks_In,passingtypes_CornerKicks_Out,passingtypes_CornerKicks_Str,passingtypes_Outcomes_Cmp,passingtypes_Outcomes_Off,passingtypes_Outcomes_Blocks,passingtypes_Matches,passing__Rk,passing__Nation,passing__Pos,passing__Age,passing__90s,passing_Total_Cmp,passing_Total_Att,passing_Total_Cmp%,passing_Total_TotDist,passing_Total_PrgDist,passing_Short_Cmp,passing_Short_Att,passing_Short_Cmp%,passing_Medium_Cmp,passing_Medium_Att,passing_Medium_Cmp%,passing_Long_Cmp,passing_Long_Att,passing_Long_Cmp%,passing__Ast,passing__xAG,passing_Expected_xA,passing_Expected_A-xAG,passing__KP,passing__1/3,passing__PPA,passing__CrsPA,passing__PrgP,passing_Matches,playingtime__Rk,playingtime__Nation,playingtime__Pos,playingtime__Age,playingtime_PlayingTime_MP,playingtime_PlayingTime_Min,playingtime_PlayingTime_Mn/MP,playingtime_PlayingTime_Min%,playingtime_PlayingTime_90s,playingtime_Starts_Starts,playingtime_Starts_Mn/Start,playingtime_Starts_Compl,playingtime_Subs_Subs,playingtime_Subs_Mn/Sub,playingtime_Subs_unSub,playingtime_TeamSuccess_PPM,playingtime_TeamSuccess_onG,playingtime_TeamSuccess_onGA,playingtime_TeamSuccess_+/-,playingtime_TeamSuccess_+/-90,playingtime_TeamSuccess_On-Off,playingtime_TeamSuccess(xG)_onxG,playingtime_TeamSuccess(xG)_onxGA,playingtime_TeamSuccess(xG)_xG+/-,playingtime_TeamSuccess(xG)_xG+/-90,playingtime_TeamSuccess(xG)_On-Off,playingtime_Matches,possession__Rk,possession__Nation,possession__Pos,possession__Age,possession__90s,possession_Touches_Touches,possession_Touches_Def Pen,possession_Touches_Def 3rd,possession_Touches_Mid 3rd,possession_Touches_Att 3rd,possession_Touches_Att Pen,possession_Touches_Live,possession_Take-Ons_Att,possession_Take-Ons_Succ,possession_Take-Ons_Succ%,possession_Take-Ons_Tkld,possession_Take-Ons_Tkld%,possession_Carries_Carries,possession_Carries_TotDist,possession_Carries_PrgDist,possession_Carries_PrgC,possession_Carries_1/3,possession_Carries_CPA,possession_Carries_Mis,possession_Carries_Dis,possession_Receiving_Rec,possession_Receiving_PrgR,possession_Matches,shooting__Rk,shooting__Nation,shooting__Pos,shooting__Age,shooting__90s,shooting_Standard_Gls,shooting_Standard_Sh,shooting_Standard_SoT,shooting_Standard_SoT%,shooting_Standard_Sh/90,shooting_Standard_SoT/90,shooting_Standard_G/Sh,shooting_Standard_G/SoT,shooting_Standard_Dist,shooting_Standard_FK,shooting_Standard_PK,shooting_Standard_PKatt,shooting_Expected_xG,shooting_Expected_npxG,shooting_Expected_npxG/Sh,shooting_Expected_G-xG,shooting_Expected_np:G-xG,shooting_Matches,stats__Rk,stats__Nation,stats__Pos,stats__Age,stats_PlayingTime_MP,stats_PlayingTime_Starts,stats_PlayingTime_Min,stats_PlayingTime_90s,stats_Performance_Gls,stats_Performance_Ast,stats_Performance_G+A,stats_Performance_G-PK,stats_Performance_PK,stats_Performance_PKatt,stats_Performance_CrdY,stats_Performance_CrdR,stats_Expected_xG,stats_Expected_npxG,stats_Expected_xAG,stats_Expected_npxG+xAG,stats_Progression_PrgC,stats_Progression_PrgP,stats_Progression_PrgR,stats_Per90Minutes_Gls,stats_Per90Minutes_Ast,stats_Per90Minutes_G+A,stats_Per90Minutes_G-PK,stats_Per90Minutes_G+A-PK,stats_Per90Minutes_xG,stats_Per90Minutes_xAG,stats_Per90Minutes_xG+xAG,stats_Per90Minutes_npxG,stats_Per90Minutes_npxG+xAG,stats_Matches,Name,Position,Age,ca,pa,Nationality,Club,Corners,Crossing,Dribbling,Finishing,First Touch,Free Kick Taking,Heading,Long Shots,Long Throws,Marking,Passing,Penalty Taking,Tackling,Technique,Aggressiion,Anticipation,Bravery,Composure,Concentration,Vision,Decision,Determination,Flair,Leadership,Off The Ball,Positioning,Teamwork,Work Rate,Acceleration,Agility,Balance,Jumping Reach,Natural Fitness,Pace,Stamina,Strength,Stability,Foul,Contest performance,Injury,diversity,Aerial Reach,Command Of Area,Communication,Eccentricity,Handling,Kicking,One On Ones,Reflexes,Rushing Out,Punching,Throwing,Adaptation,Ambition,Argue,Loyal,Resistant to stress,Professional,Sportsmanship,Emotional control,GK,DL,DC,DR,WBL,WBR,DM,ML,MC,MR,AML,AMC,AMR,ST,Height,Weight,Left Foot,Right Foot,Values,Current reputation,Domestic reputation,World reputation,Race,RCA,Colour of skin,Date of birth,Number of national team appearances,Goals scored for the national team,Salary,Rental club,UID
0,Sargis Adamyan,Köln,1993,2.0,am ARM,FWMF,29.0,7.2,14.0,7.0,5.0,3.0,6.0,7.0,17.0,41.2,10.0,12.0,0.0,12.0,4.0,18.0,5.0,0.0,Matches,2.0,am ARM,FWMF,29.0,7.2,22.0,3.07,16.0,0.0,0.0,6.0,0.0,0.0,3.0,0.42,1.0,0.0,0.0,2.0,0.0,0.0,Matches,,,,,,,,,,,,,,,,,,,,,,,,,,,,,,,,,,,,,,,,,,,,,,,,,,,,,,,,2.0,am ARM,FWMF,29.0,7.2,3.0,0.0,0.0,17.0,6.0,4.0,13.0,4.0,7.0,0.0,0.0,0.0,40.0,12.0,25.0,32.4,Matches,2.0,am ARM,FWMF,29.0,7.2,179.0,159.0,19.0,0.0,1.0,1.0,13.0,6.0,0.0,0.0,0.0,0.0,123.0,1.0,8.0,Matches,2.0,am ARM,FWMF,29.0,7.2,123.0,179.0,68.7,2000.0,527.0,61.0,76.0,80.3,48.0,64.0,75.0,10.0,16.0,62.5,2.0,0.8,1.4,1.2,8.0,7.0,11.0,2.0,24.0,Matches,2,am ARM,FWMF,29,24,644.0,27.0,21.0,7.2,4,62.0,0,20,20.0,4,1.13,11.0,16.0,-5.0,-0.7,-0.7,11.2,11.7,-0.5,-0.06,-0.28,Matches,2.0,am ARM,FWMF,29.0,7.2,310.0,6.0,36.0,134.0,147.0,48.0,310.0,27.0,6.0,22.2,16.0,59.3,166.0,924.0,352.0,12.0,8.0,5.0,28.0,16.0,191.0,58.0,Matches,2.0,am ARM,FWMF,29.0,7.2,1.0,21.0,11.0,52.4,2.93,1.54,0.05,0.09,14.0,0.0,0.0,0.0,3.4,3.4,0.16,-2.4,-2.4,Matches,2.0,am ARM,FWMF,29.0,24.0,4.0,644.0,7.2,1.0,2.0,3.0,1.0,0.0,0.0,3.0,0.0,3.4,3.4,0.8,4.1,12.0,24.0,58.0,0.14,0.28,0.42,0.14,0.42,0.47,0.11,0.58,0.47,0.58,Matches,Sargis Adamyan,M/AM/S L,29,130,132,"Armenia,Germany",1. FC Köln,9,11,14,10,12,9,10,12,8,6,12,11,8,13,14,10,13,11,10,14,11,13,15,6,14,7,10,14,14,13,15,11,11,16,13,10,8,9,13,7,10,2,1,1,3,1,2,3,2,2,1,2,14,11,9,10,14,8,10,8,1,1,1,1,1,1,1,18,1,12,18,10,12,20,184,78,10,20,3261439,6248,6298,4748,North_African__Middle_Eastern,115,7,1993/5/23,34,2,12499.0,,92057768
1,Felix Agu,Werder Bremen,1999,5.0,de GER,DFFW,22.0,0.5,1.0,0.0,0.0,1.0,0.0,0.0,0.0,,0.0,1.0,1.0,0.0,0.0,1.0,0.0,0.0,Matches,5.0,de GER,DFFW,22.0,0.5,4.0,7.2,3.0,1.0,0.0,0.0,0.0,0.0,0.0,0.0,0.0,0.0,0.0,0.0,0.0,0.0,Matches,,,,,,,,,,,,,,,,,,,,,,,,,,,,,,,,,,,,,,,,,,,,,,,,,,,,,,,,5.0,de GER,DFFW,22.0,0.5,0.0,0.0,0.0,3.0,3.0,0.0,1.0,0.0,0.0,0.0,1.0,0.0,3.0,1.0,1.0,50.0,Matches,5.0,de GER,DFFW,22.0,0.5,25.0,19.0,6.0,0.0,0.0,0.0,1.0,6.0,0.0,0.0,0.0,0.0,16.0,0.0,2.0,Matches,5.0,de GER,DFFW,22.0,0.5,16.0,25.0,64.0,299.0,144.0,4.0,5.0,80.0,9.0,10.0,90.0,2.0,6.0,33.3,0.0,0.1,0.1,-0.1,1.0,1.0,1.0,0.0,2.0,Matches,5,de GER,DFFW,22,3,49.0,16.0,1.6,0.5,0,,0,3,16.0,9,1.33,1.0,2.0,-1.0,-1.84,-1.48,0.4,2.4,-2.0,-3.53,-3.24,Matches,5.0,de GER,DFFW,22.0,0.5,33.0,1.0,7.0,13.0,14.0,2.0,33.0,3.0,0.0,0.0,2.0,66.7,19.0,165.0,24.0,0.0,2.0,0.0,1.0,2.0,19.0,2.0,Matches,5.0,de GER,DFFW,22.0,0.5,0.0,1.0,0.0,0.0,1.84,0.0,0.0,,15.9,0.0,0.0,0.0,0.0,0.0,0.04,0.0,0.0,Matches,5.0,de GER,DFFW,22.0,3.0,0.0,49.0,0.5,0.0,0.0,0.0,0.0,0.0,0.0,0.0,0.0,0.0,0.0,0.1,0.1,0.0,2.0,2.0,0.0,0.0,0.0,0.0,0.0,0.07,0.14,0.22,0.07,0.22,Matches,Felix Agu,D/WB RL,22,126,145,"Germany,Nigeria",SV Werder Bremen,8,11,12,8,14,6,9,8,14,12,10,8,12,13,14,10,11,11,10,8,9,12,8,7,13,10,13,15,15,14,11,11,16,15,14,10,13,5,14,6,15,1,1,1,1,2,1,1,3,3,2,2,8,14,6,10,10,13,14,16,1,18,10,20,18,20,1,1,1,12,1,1,10,1,180,71,12,20,4674999,6299,6299,4599,Mixed_Race,113,10,1999/9/27,0,0,12997.0,,92098106
2,Lucas Alario,Eint Frankfurt,1992,9.0,ar ARG,FWMF,29.0,3.7,3.0,2.0,1.0,0.0,2.0,0.0,1.0,0.0,1.0,0.0,0.0,0.0,2.0,5.0,13.0,0.0,Matches,9.0,ar ARG,FWMF,29.0,3.7,8.0,2.17,6.0,0.0,1.0,1.0,0.0,0.0,2.0,0.54,1.0,0.0,0.0,1.0,0.0,0.0,Matches,,,,,,,,,,,,,,,,,,,,,,,,,,,,,,,,,,,,,,,,,,,,,,,,,,,,,,,,9.0,ar ARG,FWMF,29.0,3.7,0.0,0.0,0.0,9.0,2.0,5.0,0.0,2.0,2.0,0.0,0.0,0.0,10.0,21.0,23.0,47.7,Matches,9.0,ar ARG,FWMF,29.0,3.7,85.0,80.0,5.0,0.0,0.0,0.0,0.0,0.0,0.0,0.0,0.0,0.0,56.0,0.0,1.0,Matches,9.0,ar ARG,FWMF,29.0,3.7,56.0,85.0,65.9,792.0,190.0,29.0,41.0,70.7,20.0,28.0,71.4,4.0,5.0,80.0,0.0,0.0,0.4,0.0,1.0,4.0,0.0,0.0,8.0,Matches,10,ar ARG,FWMF,29,20,331.0,17.0,10.8,3.7,2,78.0,1,18,10.0,9,1.25,5.0,9.0,-4.0,-1.09,-1.42,6.1,3.5,2.6,0.69,0.49,Matches,9.0,ar ARG,FWMF,29.0,3.7,131.0,13.0,22.0,51.0,61.0,24.0,131.0,8.0,5.0,62.5,3.0,37.5,53.0,234.0,116.0,2.0,6.0,1.0,4.0,8.0,91.0,17.0,Matches,9.0,ar ARG,FWMF,29.0,3.7,1.0,11.0,4.0,36.4,2.99,1.09,0.09,0.25,14.7,0.0,0.0,0.0,1.4,1.4,0.13,-0.4,-0.4,Matches,9.0,ar ARG,FWMF,29.0,20.0,2.0,331.0,3.7,1.0,0.0,1.0,1.0,0.0,0.0,0.0,0.0,1.4,1.4,0.0,1.5,2.0,8.0,17.0,0.27,0.0,0.27,0.27,0.27,0.39,0.01,0.4,0.39,0.4,Matches,Lucas Alario,S,29,135,147,"Argentina,Italy",Eintracht Frankfurt,6,9,11,16,14,9,16,11,5,6,11,14,7,14,12,16,14,14,13,12,14,16,10,9,15,7,13,12,11,13,13,12,13,11,13,13,13,11,16,7,6,1,3,3,1,4,2,3,2,3,3,2,11,15,6,13,14,14,9,12,1,1,1,1,1,1,1,1,1,1,1,1,1,20,184,78,12,20,9728872,6498,6948,5998,Mediterranean_Hispanic,134,6,1992/10/8,9,3,47944.0,,14046979
3,Faride Alidou,Eint Frankfurt,2001,10.0,de GER,DFMF,21.0,2.0,8.0,5.0,3.0,4.0,1.0,3.0,9.0,33.3,6.0,3.0,0.0,3.0,1.0,9.0,3.0,0.0,Matches,10.0,de GER,DFMF,21.0,2.0,8.0,3.87,7.0,0.0,1.0,0.0,0.0,0.0,1.0,0.48,1.0,0.0,0.0,0.0,0.0,0.0,Matches,,,,,,,,,,,,,,,,,,,,,,,,,,,,,,,,,,,,,,,,,,,,,,,,,,,,,,,,10.0,de GER,DFMF,21.0,2.0,0.0,0.0,0.0,8.0,1.0,2.0,7.0,1.0,5.0,0.0,0.0,0.0,16.0,2.0,7.0,22.2,Matches,10.0,de GER,DFMF,21.0,2.0,101.0,84.0,17.0,0.0,0.0,0.0,7.0,17.0,0.0,0.0,0.0,0.0,74.0,0.0,2.0,Matches,10.0,de GER,DFMF,21.0,2.0,74.0,101.0,73.3,1164.0,410.0,38.0,41.0,92.7,33.0,46.0,71.7,2.0,9.0,22.2,1.0,0.5,0.3,0.5,3.0,8.0,7.0,3.0,16.0,Matches,11,de GER,DFMF,21,15,182.0,12.0,5.9,2.0,0,,0,15,12.0,10,1.13,3.0,4.0,-1.0,-0.49,-0.71,4.0,2.5,1.4,0.69,0.47,Matches,10.0,de GER,DFMF,21.0,2.0,139.0,3.0,23.0,65.0,52.0,5.0,139.0,10.0,2.0,20.0,8.0,80.0,63.0,413.0,223.0,8.0,4.0,4.0,5.0,5.0,71.0,24.0,Matches,10.0,de GER,DFMF,21.0,2.0,0.0,2.0,0.0,0.0,0.99,0.0,0.0,,17.0,0.0,0.0,0.0,0.1,0.1,0.05,-0.1,-0.1,Matches,10.0,de GER,DFMF,21.0,15.0,0.0,182.0,2.0,0.0,1.0,1.0,0.0,0.0,0.0,0.0,0.0,0.1,0.1,0.5,0.6,8.0,16.0,24.0,0.0,0.49,0.49,0.0,0.49,0.05,0.24,0.28,0.05,0.28,Matches,Faride Alidou,M/AM RL,21,118,-8,"Germany,Togo",Eintracht Frankfurt,6,11,13,10,11,7,8,10,8,6,9,12,7,13,12,9,11,9,8,10,9,12,14,4,11,7,11,12,16,12,12,12,14,16,11,12,12,6,13,5,14,1,2,1,2,3,2,2,3,3,2,2,19,14,8,12,10,11,10,13,1,1,1,1,12,13,1,16,8,16,20,10,18,14,186,0,10,20,54000001,5895,5895,3745,African_Caribbean,109,16,2001/7/18,0,0,7614.0,,91206292
4,Lukáš Ambros,Wolfsburg,2004,12.0,cz CZE,MF,18.0,0.2,1.0,0.0,1.0,0.0,0.0,1.0,4.0,25.0,3.0,1.0,0.0,1.0,0.0,1.0,2.0,1.0,Matches,12.0,cz CZE,MF,18.0,0.2,0.0,0.0,0.0,0.0,0.0,0.0,0.0,0.0,0.0,0.0,0.0,0.0,0.0,0.0,0.0,0.0,Matches,,,,,,,,,,,,,,,,,,,,,,,,,,,,,,,,,,,,,,,,,,,,,,,,,,,,,,,,12.0,cz CZE,MF,18.0,0.2,0.0,0.0,0.0,0.0,1.0,0.0,0.0,0.0,0.0,0.0,0.0,0.0,1.0,0.0,0.0,,Matches,12.0,cz CZE,MF,18.0,0.2,3.0,3.0,0.0,0.0,0.0,0.0,0.0,0.0,0.0,0.0,0.0,0.0,3.0,0.0,0.0,Matches,12.0,cz CZE,MF,18.0,0.2,3.0,3.0,100.0,43.0,4.0,2.0,2.0,100.0,1.0,1.0,100.0,0.0,0.0,,0.0,0.0,0.0,0.0,0.0,0.0,0.0,0.0,0.0,Matches,13,cz CZE,MF,18,1,17.0,17.0,0.6,0.2,0,,0,1,17.0,8,0.0,0.0,2.0,-2.0,-10.59,-10.91,0.0,1.0,-1.0,-5.36,-5.39,Matches,12.0,cz CZE,MF,18.0,0.2,9.0,1.0,3.0,5.0,1.0,0.0,9.0,1.0,0.0,0.0,1.0,100.0,4.0,28.0,7.0,0.0,0.0,0.0,0.0,0.0,4.0,0.0,Matches,12.0,cz CZE,MF,18.0,0.2,0.0,0.0,0.0,,0.0,0.0,,,,0.0,0.0,0.0,0.0,0.0,,0.0,0.0,Matches,12.0,cz CZE,MF,18.0,1.0,0.0,17.0,0.2,0.0,0.0,0.0,0.0,0.0,0.0,0.0,0.0,0.0,0.0,0.0,0.0,0.0,0.0,0.0,0.0,0.0,0.0,0.0,0.0,0.0,0.0,0.0,0.0,0.0,Matches,Lukáš Ambros,M/AM C,18,102,-75,Czech Republic,VfL Wolfsburg,13,10,13,10,13,13,7,11,2,7,13,12,7,14,11,9,9,11,9,13,9,13,14,14,11,8,11,11,12,12,11,9,13,12,11,7,12,5,12,6,12,3,4,1,1,2,2,4,1,2,3,4,17,14,6,8,11,15,14,14,1,1,1,1,1,1,1,12,18,12,14,20,14,10,182,71,20,12,15000000,5099,4545,3623,Northern_European,102,4,2004/6/5,0,0,4794.0,,2000141427
5,Charles Aránguiz,Leverkusen,1989,18.0,cl CHI,MF,33.0,5.5,17.0,7.0,7.0,10.0,0.0,12.0,20.0,60.0,8.0,4.0,0.0,4.0,7.0,24.0,4.0,0.0,Matches,18.0,cl CHI,MF,33.0,5.5,10.0,1.83,10.0,0.0,0.0,0.0,0.0,0.0,0.0,0.0,0.0,0.0,0.0,0.0,0.0,0.0,Matches,,,,,,,,,,,,,,,,,,,,,,,,,,,,,,,,,,,,,,,,,,,,,,,,,,,,,,,,18.0,cl CHI,MF,33.0,5.5,1.0,0.0,0.0,7.0,10.0,0.0,12.0,7.0,7.0,0.0,0.0,0.0,33.0,2.0,7.0,22.2,Matches,18.0,cl CHI,MF,33.0,5.5,311.0,290.0,20.0,12.0,0.0,0.0,12.0,1.0,7.0,4.0,3.0,0.0,248.0,1.0,3.0,Matches,18.0,cl CHI,MF,33.0,5.5,248.0,311.0,79.7,3706.0,1211.0,136.0,154.0,88.3,84.0,96.0,87.5,15.0,39.0,38.5,0.0,0.2,0.2,-0.2,3.0,21.0,3.0,0.0,32.0,Matches,20,cl CHI,MF,33,10,493.0,49.0,16.1,5.5,4,60.0,0,6,42.0,0,0.8,7.0,10.0,-3.0,-0.55,-0.93,7.4,8.6,-1.2,-0.22,-0.57,Matches,18.0,cl CHI,MF,33.0,5.5,368.0,9.0,84.0,225.0,61.0,8.0,368.0,7.0,4.0,57.1,1.0,14.3,172.0,681.0,278.0,3.0,3.0,0.0,8.0,2.0,244.0,7.0,Matches,18.0,cl CHI,MF,33.0,5.5,1.0,5.0,2.0,40.0,0.91,0.37,0.2,0.5,18.5,0.0,0.0,0.0,0.3,0.3,0.06,0.7,0.7,Matches,18.0,cl CHI,MF,33.0,10.0,4.0,493.0,5.5,1.0,0.0,1.0,1.0,0.0,0.0,1.0,0.0,0.3,0.3,0.2,0.5,3.0,32.0,7.0,0.18,0.0,0.18,0.18,0.18,0.06,0.04,0.1,0.06,0.1,Matches,Charles Aránguiz,DM/M C,33,144,150,Chile,Bayer 04 Leverkusen,12,13,11,8,14,13,10,11,8,12,15,17,13,15,14,16,14,16,14,13,15,16,10,12,12,13,18,17,11,15,14,7,17,11,16,10,17,12,18,14,17,1,2,2,3,1,3,1,1,1,2,2,10,13,6,14,17,15,12,15,1,1,1,1,1,1,19,8,20,8,11,13,11,1,171,69,10,20,7001790,7200,7000,6500,Native_American,144,7,1989/4/17,96,7,95890.0,,75001932
6,Mehmet Aydin,Schalke 04,2002,22.0,de GER,DFFW,20.0,6.3,25.0,18.0,14.0,9.0,2.0,11.0,24.0,45.8,13.0,11.0,0.0,11.0,10.0,35.0,15.0,0.0,Matches,22.0,de GER,DFFW,20.0,6.3,13.0,2.07,10.0,1.0,0.0,2.0,0.0,0.0,0.0,0.0,0.0,0.0,0.0,0.0,0.0,0.0,Matches,,,,,,,,,,,,,,,,,,,,,,,,,,,,,,,,,,,,,,,,,,,,,,,,,,,,,,,,22.0,de GER,DFFW,20.0,6.3,0.0,0.0,0.0,6.0,6.0,0.0,23.0,10.0,18.0,0.0,0.0,0.0,49.0,13.0,17.0,43.3,Matches,22.0,de GER,DFFW,20.0,6.3,280.0,220.0,56.0,4.0,1.0,1.0,23.0,51.0,1.0,0.0,0.0,0.0,178.0,4.0,13.0,Matches,22.0,de GER,DFFW,20.0,6.3,178.0,280.0,63.6,3104.0,1260.0,88.0,112.0,78.6,72.0,105.0,68.6,15.0,35.0,42.9,0.0,0.8,0.3,-0.8,4.0,13.0,5.0,3.0,15.0,Matches,25,de GER,DFFW,20,16,567.0,35.0,18.5,6.3,3,78.0,1,13,26.0,9,0.75,5.0,12.0,-7.0,-1.11,-0.06,8.3,9.7,-1.4,-0.22,0.36,Matches,22.0,de GER,DFFW,20.0,6.3,380.0,24.0,128.0,165.0,97.0,5.0,380.0,14.0,4.0,28.6,7.0,50.0,166.0,963.0,416.0,9.0,12.0,2.0,13.0,3.0,158.0,21.0,Matches,22.0,de GER,DFFW,20.0,6.3,0.0,5.0,0.0,0.0,0.79,0.0,0.0,,23.3,0.0,0.0,0.0,0.2,0.2,0.04,-0.2,-0.2,Matches,22.0,de GER,DFFW,20.0,16.0,3.0,567.0,6.3,0.0,0.0,0.0,0.0,0.0,0.0,0.0,0.0,0.2,0.2,0.8,1.0,9.0,15.0,21.0,0.0,0.0,0.0,0.0,0.0,0.03,0.12,0.15,0.03,0.15,Matches,Mehmet Aydin,D/WB R,20,116,-75,"Turkey,Germany",FC Schalke 04,5,12,12,8,13,6,8,8,12,11,12,12,13,13,15,12,13,12,11,12,11,15,13,8,13,11,13,15,13,12,12,10,13,14,14,11,12,10,12,7,16,1,2,1,4,2,2,2,3,3,3,4,10,13,8,17,11,11,10,9,1,10,1,18,10,20,8,10,12,15,10,10,12,1,180,68,7,20,11700001,5798,5072,3824,North_African__Middle_Eastern,116,6,2002/2/9,0,0,14383.0,,92099272
7,Aymen Barkok,Mainz 05,1998,28.0,ma MAR,MF,24.0,6.5,18.0,8.0,10.0,5.0,3.0,5.0,10.0,50.0,5.0,7.0,0.0,7.0,3.0,21.0,9.0,0.0,Matches,28.0,ma MAR,MF,24.0,6.5,18.0,2.76,13.0,1.0,1.0,2.0,1.0,0.0,1.0,0.15,1.0,0.0,0.0,0.0,0.0,0.0,Matches,,,,,,,,,,,,,,,,,,,,,,,,,,,,,,,,,,,,,,,,,,,,,,,,,,,,,,,,28.0,ma MAR,MF,24.0,6.5,1.0,0.0,0.0,17.0,4.0,0.0,12.0,3.0,8.0,0.0,0.0,0.0,52.0,15.0,14.0,51.7,Matches,28.0,ma MAR,MF,24.0,6.5,264.0,249.0,12.0,2.0,2.0,1.0,12.0,7.0,3.0,1.0,1.0,0.0,181.0,3.0,10.0,Matches,28.0,ma MAR,MF,24.0,6.5,181.0,264.0,68.6,2801.0,919.0,92.0,119.0,77.3,64.0,91.0,70.3,14.0,20.0,70.0,1.0,0.9,1.2,0.1,8.0,18.0,7.0,1.0,40.0,Matches,32,ma MAR,MF,24,23,584.0,25.0,19.1,6.5,3,76.0,0,20,18.0,10,1.43,12.0,11.0,1.0,0.15,0.23,10.6,10.7,0.0,-0.01,0.23,Matches,28.0,ma MAR,MF,24.0,6.5,360.0,12.0,53.0,156.0,158.0,16.0,360.0,20.0,9.0,45.0,11.0,55.0,185.0,1396.0,726.0,17.0,16.0,4.0,16.0,9.0,216.0,28.0,Matches,28.0,ma MAR,MF,24.0,6.5,0.0,11.0,2.0,18.2,1.7,0.31,0.0,0.0,23.3,0.0,0.0,0.0,0.5,0.5,0.04,-0.5,-0.5,Matches,28.0,ma MAR,MF,24.0,23.0,3.0,584.0,6.5,0.0,1.0,1.0,0.0,0.0,0.0,1.0,0.0,0.5,0.5,0.9,1.4,17.0,40.0,28.0,0.0,0.15,0.15,0.0,0.15,0.08,0.14,0.21,0.08,0.21,Matches,Aymen Barkok,M/AM RC,24,125,135,"Morocco,Germany",1. FSV Mainz 05,13,11,15,11,14,13,7,12,6,9,13,12,11,16,15,11,13,12,9,13,10,11,16,5,12,9,12,12,13,13,12,12,13,15,12,12,11,12,12,10,15,2,2,3,3,2,1,3,1,2,1,1,8,12,8,16,12,12,12,10,1,1,1,10,1,14,10,12,18,15,12,20,15,10,189,82,11,20,2773094,6242,6042,5242,North_African__Middle_Eastern,124,8,1998/5/21,18,1,12466.0,,91143866
8,Timo Baumgartl,Union Berlin,1996,33.0,de GER,DF,26.0,6.2,11.0,6.0,5.0,4.0,2.0,5.0,18.0,27.8,13.0,12.0,4.0,8.0,2.0,13.0,14.0,0.0,Matches,33.0,de GER,DF,26.0,6.2,8.0,1.28,7.0,0.0,0.0,1.0,0.0,0.0,1.0,0.16,1.0,0.0,0.0,0.0,0.0,0.0,Matches,,,,,,,,,,,,,,,,,,,,,,,,,,,,,,,,,,,,,,,,,,,,,,,,,,,,,,,,33.0,de GER,DF,26.0,6.2,2.0,0.0,0.0,11.0,6.0,0.0,6.0,2.0,6.0,0.0,0.0,0.0,41.0,19.0,10.0,65.5,Matches,33.0,de GER,DF,26.0,6.2,316.0,301.0,15.0,13.0,0.0,3.0,6.0,0.0,0.0,0.0,0.0,0.0,257.0,0.0,2.0,Matches,33.0,de GER,DF,26.0,6.2,257.0,316.0,81.3,4858.0,1773.0,97.0,102.0,95.1,132.0,145.0,91.0,26.0,63.0,41.3,1.0,0.1,0.2,0.9,3.0,20.0,4.0,2.0,28.0,Matches,37,de GER,DF,26,8,562.0,70.0,18.4,6.2,6,82.0,3,2,37.0,9,1.38,7.0,10.0,-3.0,-0.48,-1.06,8.2,8.4,-0.2,-0.02,0.14,Matches,33.0,de GER,DF,26.0,6.2,372.0,33.0,160.0,187.0,26.0,9.0,372.0,0.0,0.0,,0.0,,212.0,1099.0,626.0,4.0,4.0,0.0,3.0,0.0,227.0,2.0,Matches,33.0,de GER,DF,26.0,6.2,0.0,4.0,2.0,50.0,0.64,0.32,0.0,0.0,11.5,0.0,0.0,0.0,0.2,0.2,0.05,-0.2,-0.2,Matches,33.0,de GER,DF,26.0,8.0,6.0,562.0,6.2,0.0,1.0,1.0,0.0,0.0,0.0,2.0,0.0,0.2,0.2,0.1,0.3,4.0,28.0,2.0,0.0,0.16,0.16,0.0,0.16,0.03,0.02,0.05,0.03,0.05,Matches,Timo Baumgartl,D C,26,135,140,Germany,PSV Eindhoven,4,7,9,6,11,4,13,5,9,14,10,6,16,11,9,14,12,14,15,9,13,13,5,11,8,14,16,14,12,11,13,15,13,14,13,16,14,6,11,13,6,4,3,3,1,3,2,1,2,3,2,1,9,12,3,13,10,14,16,18,1,1,20,12,1,8,1,1,1,1,1,1,1,1,192,88,10,20,6916385,6250,6250,4750,Northern_European,134,3,1996/3/4,0,0,19999.0,1. FC Union Berlin,92065892
9,Julian Baumgartlinger,Augsburg,1988,34.0,at AUT,MF,34.0,6.2,15.0,4.0,5.0,6.0,4.0,6.0,19.0,31.6,13.0,4.0,2.0,2.0,4.0,19.0,15.0,0.0,Matches,34.0,at AUT,MF,34.0,6.2,8.0,1.3,7.0,0.0,0.0,1.0,0.0,0.0,0.0,0.0,0.0,0.0,0.0,0.0,0.0,0.0,Matches,,,,,,,,,,,,,,,,,,,,,,,,,,,,,,,,,,,,,,,,,,,,,,,,,,,,,,,,34.0,at AUT,MF,34.0,6.2,1.0,0.0,0.0,5.0,9.0,0.0,2.0,4.0,4.0,0.0,0.0,0.0,39.0,7.0,9.0,43.8,Matches,34.0,at AUT,MF,34.0,6.2,228.0,219.0,9.0,4.0,0.0,2.0,2.0,1.0,0.0,0.0,0.0,0.0,189.0,0.0,2.0,Matches,34.0,at AUT,MF,34.0,6.2,189.0,228.0,82.9,3450.0,906.0,76.0,88.0,86.4,86.0,99.0,86.9,22.0,28.0,78.6,0.0,0.1,0.5,-0.1,2.0,15.0,8.0,1.0,25.0,Matches,38,at AUT,MF,34,16,554.0,35.0,18.1,6.2,3,90.0,3,13,22.0,11,0.69,11.0,17.0,-6.0,-0.97,-0.44,8.4,10.7,-2.4,-0.38,0.4,Matches,34.0,at AUT,MF,34.0,6.2,292.0,19.0,93.0,156.0,44.0,3.0,292.0,4.0,1.0,25.0,2.0,50.0,143.0,462.0,203.0,1.0,2.0,0.0,7.0,3.0,151.0,3.0,Matches,34.0,at AUT,MF,34.0,6.2,0.0,3.0,0.0,0.0,0.49,0.0,0.0,,18.2,0.0,0.0,0.0,0.3,0.3,0.09,-0.3,-0.3,Matches,34.0,at AUT,MF,34.0,16.0,3.0,554.0,6.2,0.0,0.0,0.0,0.0,0.0,0.0,1.0,0.0,0.3,0.3,0.1,0.4,1.0,25.0,3.0,0.0,0.0,0.0,0.0,0.0,0.04,0.02,0.06,0.04,0.06,Matches,Julian Baumgartlinger,DM/M C,34,135,138,Austria,FC Augsburg,7,8,9,7,10,6,12,8,10,13,12,8,16,11,18,12,17,13,17,9,12,17,6,15,12,14,17,18,12,10,14,11,19,13,18,15,18,10,17,12,8,1,2,3,3,2,3,2,1,2,1,1,12,16,4,14,13,18,15,14,1,1,1,1,1,1,20,1,20,1,1,1,1,1,181,85,14,20,617606,6700,6700,5550,Northern_European,133,3,1988/1/2,84,1,24000.0,,5607656
10,Karim Bellarabi,Leverkusen,1990,41.0,de GER,FWMF,32.0,0.9,2.0,0.0,1.0,1.0,0.0,2.0,3.0,66.7,1.0,0.0,0.0,0.0,0.0,2.0,0.0,0.0,Matches,41.0,de GER,FWMF,32.0,0.9,4.0,4.24,4.0,0.0,0.0,0.0,0.0,0.0,0.0,0.0,0.0,0.0,0.0,0.0,0.0,0.0,Matches,,,,,,,,,,,,,,,,,,,,,,,,,,,,,,,,,,,,,,,,,,,,,,,,,,,,,,,,41.0,de GER,FWMF,32.0,0.9,0.0,0.0,0.0,2.0,0.0,2.0,8.0,0.0,0.0,0.0,0.0,0.0,4.0,0.0,0.0,,Matches,41.0,de GER,FWMF,32.0,0.9,57.0,56.0,1.0,0.0,0.0,0.0,8.0,1.0,0.0,0.0,0.0,0.0,37.0,0.0,1.0,Matches,41.0,de GER,FWMF,32.0,0.9,37.0,57.0,64.9,493.0,171.0,24.0,31.0,77.4,13.0,23.0,56.5,0.0,2.0,0.0,0.0,0.0,0.0,0.0,0.0,4.0,0.0,0.0,4.0,Matches,46,de GER,FWMF,32,8,85.0,11.0,2.8,0.9,1,45.0,0,7,6.0,8,1.5,0.0,1.0,-1.0,-1.06,-1.33,1.5,2.0,-0.5,-0.54,-0.81,Matches,41.0,de GER,FWMF,32.0,0.9,68.0,1.0,9.0,25.0,35.0,4.0,68.0,5.0,1.0,20.0,4.0,80.0,41.0,183.0,90.0,4.0,3.0,2.0,1.0,2.0,55.0,11.0,Matches,41.0,de GER,FWMF,32.0,0.9,0.0,0.0,0.0,,0.0,0.0,,,,0.0,0.0,0.0,0.0,0.0,,0.0,0.0,Matches,41.0,de GER,FWMF,32.0,8.0,1.0,85.0,0.9,0.0,0.0,0.0,0.0,0.0,0.0,0.0,0.0,0.0,0.0,0.0,0.0,4.0,4.0,11.0,0.0,0.0,0.0,0.0,0.0,0.0,0.0,0.0,0.0,0.0,Matches,Karim Bellarabi,M/AM RL,32,138,151,"Germany,Morocco,Ghana",Bayer 04 Leverkusen,9,12,14,10,12,9,6,11,7,8,12,9,12,13,14,9,14,10,11,12,10,10,12,7,12,11,13,16,16,14,14,8,12,17,16,11,12,10,12,15,13,2,2,3,1,1,2,2,3,3,3,1,7,13,10,15,12,12,10,10,1,1,1,1,1,12,1,15,1,20,15,10,20,10,184,79,8,20,5077335,6900,6900,5750,North_African__Middle_Eastern,127,10,1990/4/8,11,1,95000.0,,92017768
11,Ermin Bičakčić,Hoffenheim,1990,45.0,ba BIH,DF,32.0,2.9,8.0,4.0,6.0,1.0,1.0,2.0,6.0,33.3,4.0,4.0,3.0,1.0,5.0,13.0,14.0,0.0,Matches,45.0,ba BIH,DF,32.0,2.9,1.0,0.34,0.0,0.0,0.0,1.0,0.0,0.0,0.0,0.0,0.0,0.0,0.0,0.0,0.0,0.0,Matches,,,,,,,,,,,,,,,,,,,,,,,,,,,,,,,,,,,,,,,,,,,,,,,,,,,,,,,,45.0,ba BIH,DF,32.0,2.9,0.0,0.0,0.0,1.0,1.0,1.0,1.0,5.0,4.0,0.0,0.0,0.0,10.0,9.0,11.0,45.0,Matches,45.0,ba BIH,DF,32.0,2.9,96.0,91.0,5.0,2.0,0.0,1.0,1.0,2.0,0.0,0.0,0.0,0.0,68.0,0.0,1.0,Matches,45.0,ba BIH,DF,32.0,2.9,68.0,96.0,70.8,1373.0,653.0,24.0,27.0,88.9,35.0,47.0,74.5,9.0,19.0,47.4,0.0,0.0,0.0,0.0,0.0,6.0,1.0,0.0,7.0,Matches,53,ba BIH,DF,32,9,265.0,29.0,8.7,2.9,0,,0,9,29.0,10,1.11,5.0,11.0,-6.0,-2.04,-1.94,4.1,8.6,-4.6,-1.55,-1.6,Matches,45.0,ba BIH,DF,32.0,2.9,137.0,32.0,76.0,43.0,18.0,4.0,137.0,0.0,0.0,,0.0,,59.0,207.0,91.0,0.0,2.0,0.0,2.0,0.0,62.0,3.0,Matches,45.0,ba BIH,DF,32.0,2.9,0.0,2.0,1.0,50.0,0.68,0.34,0.0,0.0,11.5,0.0,0.0,0.0,0.1,0.1,0.07,-0.1,-0.1,Matches,45.0,ba BIH,DF,32.0,9.0,0.0,265.0,2.9,0.0,0.0,0.0,0.0,0.0,0.0,0.0,0.0,0.1,0.1,0.0,0.1,0.0,7.0,3.0,0.0,0.0,0.0,0.0,0.0,0.04,0.0,0.04,0.04,0.04,Matches,Ermin Bičakčić,D RC,32,124,129,"Bosnia and Herzegovina,Germany",TSG Hoffenheim,3,6,6,8,8,4,13,4,14,16,9,5,16,8,8,12,17,11,14,7,10,16,5,12,8,13,15,11,11,8,13,13,12,13,12,16,15,13,13,16,10,1,2,1,2,1,3,3,2,1,4,3,11,15,7,9,13,17,9,14,1,1,20,15,1,11,1,1,1,1,1,1,1,1,185,85,15,20,782050,6100,6700,4750,Northern_European,121,6,1990/1/24,35,3,29999.0,,35013742
12,Tom Bischof,Hoffenheim,2005,46.0,de GER,MFFW,17.0,3.5,15.0,10.0,8.0,3.0,4.0,7.0,10.0,70.0,3.0,5.0,1.0,4.0,1.0,16.0,1.0,0.0,Matches,46.0,de GER,MFFW,17.0,3.5,7.0,2.0,5.0,0.0,0.0,0.0,2.0,0.0,0.0,0.0,0.0,0.0,0.0,0.0,0.0,0.0,Matches,,,,,,,,,,,,,,,,,,,,,,,,,,,,,,,,,,,,,,,,,,,,,,,,,,,,,,,,46.0,de GER,MFFW,17.0,3.5,0.0,0.0,0.0,9.0,5.0,0.0,7.0,1.0,10.0,0.0,0.0,0.0,16.0,2.0,5.0,28.6,Matches,46.0,de GER,MFFW,17.0,3.5,121.0,116.0,5.0,2.0,1.0,0.0,7.0,1.0,2.0,2.0,0.0,0.0,84.0,0.0,6.0,Matches,46.0,de GER,MFFW,17.0,3.5,84.0,121.0,69.4,1266.0,420.0,43.0,55.0,78.2,26.0,36.0,72.2,8.0,16.0,50.0,0.0,0.7,0.8,-0.7,5.0,9.0,4.0,1.0,16.0,Matches,54,de GER,MFFW,17,11,315.0,29.0,10.3,3.5,3,62.0,0,8,16.0,10,0.45,6.0,7.0,-1.0,-0.29,-0.02,5.2,6.2,-1.1,-0.3,-0.24,Matches,46.0,de GER,MFFW,17.0,3.5,182.0,2.0,35.0,77.0,74.0,8.0,182.0,9.0,1.0,11.1,6.0,66.7,101.0,431.0,178.0,8.0,11.0,2.0,10.0,6.0,105.0,12.0,Matches,46.0,de GER,MFFW,17.0,3.5,0.0,7.0,2.0,28.6,2.0,0.57,0.0,0.0,22.4,0.0,0.0,0.0,1.0,1.0,0.14,-1.0,-1.0,Matches,46.0,de GER,MFFW,17.0,11.0,3.0,315.0,3.5,0.0,0.0,0.0,0.0,0.0,0.0,0.0,0.0,1.0,1.0,0.7,1.8,8.0,16.0,12.0,0.0,0.0,0.0,0.0,0.0,0.29,0.21,0.5,0.29,0.5,Matches,Tom Bischof,M/AM C,17,92,-85,Germany,TSG Hoffenheim,7,7,13,11,15,9,9,11,7,11,14,8,11,15,13,10,7,13,6,14,15,5,15,4,11,9,14,10,10,11,10,5,8,8,5,5,6,8,11,8,13,2,1,2,1,1,2,2,1,3,1,3,11,9,8,9,12,11,11,10,1,1,1,1,1,1,1,1,20,1,1,19,1,1,176,66,20,7,21000000,4750,4750,2750,Mediterranean_Hispanic,91,3,2005/6/28,0,0,1409.0,,2000147056
13,Daley Blind,Bayern Munich,1990,49.0,nl NED,DFMF,32.0,1.5,2.0,0.0,2.0,0.0,0.0,0.0,1.0,0.0,1.0,4.0,2.0,2.0,2.0,4.0,6.0,0.0,Matches,49.0,nl NED,DFMF,32.0,1.5,4.0,2.69,4.0,0.0,0.0,0.0,0.0,0.0,0.0,0.0,0.0,0.0,0.0,0.0,0.0,0.0,Matches,,,,,,,,,,,,,,,,,,,,,,,,,,,,,,,,,,,,,,,,,,,,,,,,,,,,,,,,49.0,nl NED,DFMF,32.0,1.5,0.0,0.0,0.0,1.0,0.0,0.0,1.0,2.0,0.0,0.0,0.0,0.0,7.0,2.0,1.0,66.7,Matches,49.0,nl NED,DFMF,32.0,1.5,100.0,92.0,7.0,6.0,0.0,1.0,1.0,1.0,0.0,0.0,0.0,0.0,87.0,1.0,1.0,Matches,49.0,nl NED,DFMF,32.0,1.5,87.0,100.0,87.0,1659.0,659.0,30.0,33.0,90.9,50.0,55.0,90.9,7.0,9.0,77.8,0.0,0.1,0.3,-0.1,2.0,8.0,1.0,0.0,10.0,Matches,57,nl NED,DFMF,32,4,134.0,34.0,4.4,1.5,1,90.0,1,3,15.0,15,2.25,3.0,5.0,-2.0,-1.34,-3.07,2.8,3.6,-0.8,-0.55,-1.74,Matches,49.0,nl NED,DFMF,32.0,1.5,117.0,10.0,44.0,65.0,9.0,0.0,117.0,0.0,0.0,,0.0,,62.0,258.0,134.0,0.0,0.0,0.0,1.0,0.0,74.0,0.0,Matches,49.0,nl NED,DFMF,32.0,1.5,0.0,1.0,1.0,100.0,0.67,0.67,0.0,0.0,24.8,0.0,0.0,0.0,0.1,0.1,0.06,-0.1,-0.1,Matches,49.0,nl NED,DFMF,32.0,4.0,1.0,134.0,1.5,0.0,0.0,0.0,0.0,0.0,0.0,0.0,0.0,0.1,0.1,0.1,0.1,0.0,10.0,0.0,0.0,0.0,0.0,0.0,0.0,0.04,0.04,0.08,0.04,0.08,Matches,Daley Blind,D/WB/DM LC,32,147,152,Holland,AFC Ajax,12,12,8,8,15,10,13,8,10,14,16,11,13,14,12,16,14,17,14,16,16,17,10,16,14,15,17,16,9,11,14,12,17,9,14,12,17,12,15,5,17,3,1,2,3,3,1,2,2,3,3,2,16,14,8,16,18,18,16,15,1,19,20,10,18,8,20,14,14,1,1,1,1,1,180,72,20,8,15971693,7500,7500,6500,Northern_European,140,4,1990/3/9,91,2,49999.0,,37005632
14,Kevin-Prince Boateng,Hertha BSC,1987,50.0,gh GHA,MF,35.0,5.2,8.0,6.0,4.0,2.0,2.0,3.0,9.0,33.3,6.0,11.0,3.0,8.0,3.0,11.0,5.0,0.0,Matches,50.0,gh GHA,MF,35.0,5.2,9.0,1.73,8.0,1.0,0.0,0.0,0.0,0.0,1.0,0.19,1.0,0.0,0.0,0.0,0.0,0.0,Matches,,,,,,,,,,,,,,,,,,,,,,,,,,,,,,,,,,,,,,,,,,,,,,,,,,,,,,,,50.0,gh GHA,MF,35.0,5.2,3.0,0.0,0.0,23.0,8.0,0.0,7.0,3.0,6.0,0.0,0.0,0.0,27.0,19.0,16.0,54.3,Matches,50.0,gh GHA,MF,35.0,5.2,252.0,224.0,27.0,9.0,1.0,0.0,7.0,10.0,0.0,0.0,0.0,0.0,185.0,1.0,1.0,Matches,50.0,gh GHA,MF,35.0,5.2,185.0,252.0,73.4,3113.0,971.0,90.0,114.0,78.9,66.0,86.0,76.7,23.0,34.0,67.6,0.0,0.2,0.3,-0.2,3.0,19.0,2.0,0.0,24.0,Matches,58,gh GHA,MF,35,16,467.0,29.0,15.3,5.2,5,61.0,0,11,15.0,13,0.44,5.0,12.0,-7.0,-1.35,-0.65,6.1,7.8,-1.7,-0.33,0.33,Matches,50.0,gh GHA,MF,35.0,5.2,320.0,11.0,66.0,172.0,85.0,15.0,320.0,4.0,1.0,25.0,3.0,75.0,156.0,519.0,169.0,2.0,1.0,2.0,10.0,8.0,203.0,20.0,Matches,50.0,gh GHA,MF,35.0,5.2,0.0,6.0,0.0,0.0,1.16,0.0,0.0,,19.2,0.0,0.0,0.0,0.3,0.3,0.06,-0.3,-0.3,Matches,50.0,gh GHA,MF,35.0,16.0,5.0,467.0,5.2,0.0,0.0,0.0,0.0,0.0,0.0,3.0,0.0,0.3,0.3,0.2,0.5,2.0,24.0,20.0,0.0,0.0,0.0,0.0,0.0,0.07,0.03,0.1,0.07,0.1,Matches,Kevin-Prince Boateng,M/AM C,35,121,157,"Ghana,Germany",Hertha Berlin,9,12,14,10,15,11,13,15,3,9,16,13,10,16,15,13,14,13,9,14,12,17,17,16,14,10,13,12,8,11,16,13,13,8,7,12,11,16,15,13,16,2,2,1,1,2,2,3,4,1,1,3,15,12,16,4,16,11,6,6,1,1,1,1,1,1,15,8,20,8,11,20,11,13,186,85,13,20,112453,5899,6599,5499,Mixed_Race,119,13,1987/3/6,15,2,7614.0,,8723705
15,Yvandro Borges Sanches,Gladbach,2004,52.0,lu LUX,FWMF,18.0,0.3,2.0,2.0,0.0,2.0,0.0,2.0,2.0,100.0,0.0,0.0,0.0,0.0,0.0,2.0,0.0,0.0,Matches,52.0,lu LUX,FWMF,18.0,0.3,2.0,6.43,0.0,0.0,1.0,0.0,0.0,1.0,0.0,0.0,0.0,0.0,0.0,0.0,0.0,0.0,Matches,,,,,,,,,,,,,,,,,,,,,,,,,,,,,,,,,,,,,,,,,,,,,,,,,,,,,,,,52.0,lu LUX,FWMF,18.0,0.3,0.0,0.0,0.0,1.0,0.0,0.0,2.0,0.0,2.0,0.0,0.0,0.0,3.0,0.0,0.0,,Matches,52.0,lu LUX,FWMF,18.0,0.3,9.0,8.0,1.0,0.0,0.0,0.0,2.0,0.0,0.0,0.0,0.0,0.0,8.0,0.0,0.0,Matches,52.0,lu LUX,FWMF,18.0,0.3,8.0,9.0,88.9,113.0,17.0,2.0,2.0,100.0,3.0,4.0,75.0,1.0,1.0,100.0,0.0,0.0,0.0,0.0,0.0,0.0,1.0,1.0,0.0,Matches,62,lu LUX,FWMF,18,3,28.0,9.0,0.9,0.3,0,,0,3,9.0,10,1.33,1.0,2.0,-1.0,-3.21,-3.15,0.6,0.7,-0.1,-0.17,-0.13,Matches,52.0,lu LUX,FWMF,18.0,0.3,15.0,2.0,3.0,7.0,6.0,0.0,15.0,2.0,2.0,100.0,0.0,0.0,9.0,70.0,43.0,1.0,1.0,0.0,2.0,4.0,9.0,5.0,Matches,52.0,lu LUX,FWMF,18.0,0.3,0.0,1.0,0.0,0.0,3.21,0.0,0.0,,34.7,0.0,0.0,0.0,0.1,0.1,0.1,-0.1,-0.1,Matches,52.0,lu LUX,FWMF,18.0,3.0,0.0,28.0,0.3,0.0,0.0,0.0,0.0,0.0,0.0,0.0,0.0,0.1,0.1,0.0,0.1,1.0,0.0,5.0,0.0,0.0,0.0,0.0,0.0,0.34,0.0,0.34,0.34,0.34,Matches,Yvandro Borges Sanches,AM RL,18,103,-75,"Luxembourg,Cape Verde Islands",Borussia Mönchengladbach,12,9,14,11,12,8,4,8,2,4,12,8,6,14,4,9,9,9,8,12,9,14,16,2,11,5,10,10,15,15,8,6,13,15,10,5,12,1,12,3,12,2,1,2,1,1,1,3,1,1,3,3,16,15,6,12,13,14,16,17,1,1,1,1,1,1,1,15,12,15,20,14,18,12,175,68,8,20,21640000,5245,4028,4016,North_African__Middle_Eastern,96,15,2004/5/24,12,1,6673.0,,2000124674
16,Josip Brekalo,Wolfsburg,1998,57.0,hr CRO,MFFW,24.0,3.0,2.0,1.0,2.0,0.0,0.0,0.0,4.0,0.0,4.0,0.0,0.0,0.0,2.0,4.0,2.0,0.0,Matches,57.0,hr CRO,MFFW,24.0,3.0,7.0,2.32,3.0,3.0,0.0,1.0,0.0,0.0,1.0,0.33,0.0,1.0,0.0,0.0,0.0,0.0,Matches,,,,,,,,,,,,,,,,,,,,,,,,,,,,,,,,,,,,,,,,,,,,,,,,,,,,,,,,57.0,hr CRO,MFFW,24.0,3.0,0.0,0.0,0.0,2.0,3.0,1.0,13.0,2.0,1.0,0.0,0.0,0.0,14.0,0.0,2.0,0.0,Matches,57.0,hr CRO,MFFW,24.0,3.0,148.0,132.0,16.0,4.0,0.0,3.0,13.0,5.0,4.0,4.0,0.0,0.0,103.0,0.0,9.0,Matches,57.0,hr CRO,MFFW,24.0,3.0,103.0,148.0,69.6,1684.0,475.0,57.0,65.0,87.7,31.0,41.0,75.6,11.0,20.0,55.0,1.0,0.4,0.4,0.6,5.0,10.0,4.0,0.0,13.0,Matches,67,hr CRO,MFFW,24,6,271.0,45.0,8.9,3.0,3,74.0,0,3,17.0,6,1.17,2.0,5.0,-3.0,-1.0,-1.38,2.1,4.5,-2.4,-0.79,-0.87,Matches,57.0,hr CRO,MFFW,24.0,3.0,168.0,0.0,21.0,103.0,48.0,3.0,168.0,8.0,5.0,62.5,2.0,25.0,106.0,752.0,296.0,9.0,7.0,2.0,3.0,6.0,134.0,17.0,Matches,57.0,hr CRO,MFFW,24.0,3.0,0.0,2.0,1.0,50.0,0.66,0.33,0.0,0.0,20.2,0.0,0.0,0.0,0.1,0.1,0.05,-0.1,-0.1,Matches,57.0,hr CRO,MFFW,24.0,6.0,3.0,271.0,3.0,0.0,1.0,1.0,0.0,0.0,0.0,0.0,0.0,0.1,0.1,0.4,0.5,9.0,13.0,17.0,0.0,0.33,0.33,0.0,0.33,0.03,0.14,0.17,0.03,0.17,Matches,Josip Brekalo,AM RLC,24,136,147,Croatia,VfL Wolfsburg,14,13,15,12,15,15,6,16,4,4,13,10,4,15,10,13,8,12,10,13,12,13,16,4,14,4,10,9,16,15,13,7,13,15,13,8,11,5,14,9,14,1,1,2,2,2,1,3,1,2,3,3,15,14,15,7,15,7,8,10,1,1,1,1,1,1,1,15,1,12,20,18,15,12,175,70,12,20,6456994,6800,6550,5800,Northern_European,134,2,1998/6/23,33,4,34520.0,,24046837
17,Jacob Bruun Larsen,Hoffenheim,1998,61.0,dk DEN,FW,23.0,3.6,4.0,3.0,0.0,1.0,3.0,3.0,4.0,75.0,1.0,3.0,1.0,2.0,1.0,5.0,0.0,0.0,Matches,61.0,dk DEN,FW,23.0,3.6,12.0,3.3,11.0,0.0,1.0,0.0,0.0,0.0,0.0,0.0,0.0,0.0,0.0,0.0,0.0,0.0,Matches,,,,,,,,,,,,,,,,,,,,,,,,,,,,,,,,,,,,,,,,,,,,,,,,,,,,,,,,61.0,dk DEN,FW,23.0,3.6,0.0,0.0,0.0,1.0,1.0,4.0,4.0,1.0,3.0,0.0,0.0,0.0,7.0,3.0,5.0,37.5,Matches,61.0,dk DEN,FW,23.0,3.6,88.0,81.0,6.0,1.0,0.0,0.0,4.0,0.0,0.0,0.0,0.0,0.0,62.0,1.0,3.0,Matches,61.0,dk DEN,FW,23.0,3.6,62.0,88.0,70.5,807.0,152.0,42.0,55.0,76.4,16.0,20.0,80.0,1.0,5.0,20.0,0.0,0.4,0.4,-0.4,7.0,5.0,2.0,0.0,4.0,Matches,72,dk DEN,FW,23,12,328.0,27.0,10.7,3.6,3,67.0,0,9,14.0,5,1.25,5.0,8.0,-3.0,-0.82,-0.63,5.8,6.4,-0.6,-0.16,-0.08,Matches,61.0,dk DEN,FW,23.0,3.6,124.0,1.0,9.0,52.0,65.0,16.0,124.0,7.0,2.0,28.6,5.0,71.4,74.0,494.0,174.0,10.0,5.0,5.0,9.0,6.0,85.0,24.0,Matches,61.0,dk DEN,FW,23.0,3.6,1.0,7.0,2.0,28.6,1.92,0.55,0.14,0.5,14.9,0.0,0.0,0.0,1.3,1.3,0.19,-0.3,-0.3,Matches,61.0,dk DEN,FW,23.0,12.0,3.0,328.0,3.6,1.0,0.0,1.0,1.0,0.0,0.0,0.0,0.0,1.3,1.3,0.4,1.7,10.0,4.0,24.0,0.27,0.0,0.27,0.27,0.27,0.36,0.11,0.47,0.36,0.47,Matches,Jacob Bruun Larsen,M/AM RL,23,131,145,Denmark,TSG Hoffenheim,12,11,12,10,11,11,9,11,10,7,12,10,7,12,15,13,9,12,10,12,11,11,12,7,16,9,15,16,14,13,11,10,16,14,14,10,12,4,11,11,17,1,2,3,2,2,1,3,2,1,1,2,14,17,5,12,10,13,15,17,1,10,1,10,13,14,1,19,1,20,19,12,20,10,183,75,15,20,4475230,6500,6500,5000,Northern_European,124,1,1998/9/19,6,1,38329.0,,27112672
18,Lee Buchanan,Werder Bremen,2001,62.0,eng ENG,DFFW,21.0,5.2,14.0,10.0,2.0,11.0,1.0,6.0,12.0,50.0,6.0,5.0,0.0,5.0,12.0,26.0,21.0,0.0,Matches,62.0,eng ENG,DFFW,21.0,5.2,7.0,1.34,7.0,0.0,0.0,0.0,0.0,0.0,0.0,0.0,0.0,0.0,0.0,0.0,0.0,0.0,Matches,,,,,,,,,,,,,,,,,,,,,,,,,,,,,,,,,,,,,,,,,,,,,,,,,,,,,,,,62.0,eng ENG,DFFW,21.0,5.2,2.0,0.0,0.0,6.0,6.0,1.0,18.0,12.0,10.0,0.0,0.0,0.0,42.0,8.0,7.0,53.3,Matches,62.0,eng ENG,DFFW,21.0,5.2,267.0,228.0,39.0,1.0,1.0,3.0,18.0,38.0,0.0,0.0,0.0,0.0,179.0,0.0,4.0,Matches,62.0,eng ENG,DFFW,21.0,5.2,179.0,267.0,67.0,3373.0,1351.0,74.0,93.0,79.6,77.0,107.0,72.0,26.0,61.0,42.6,0.0,0.8,0.6,-0.8,5.0,16.0,5.0,2.0,21.0,Matches,73,eng ENG,DFFW,21,21,472.0,22.0,15.4,5.2,2,74.0,0,19,17.0,9,1.0,15.0,8.0,7.0,1.33,2.03,10.0,8.9,1.1,0.21,0.65,Matches,62.0,eng ENG,DFFW,21.0,5.2,350.0,29.0,125.0,145.0,86.0,9.0,350.0,7.0,0.0,0.0,6.0,85.7,168.0,724.0,348.0,10.0,4.0,1.0,7.0,3.0,185.0,20.0,Matches,62.0,eng ENG,DFFW,21.0,5.2,1.0,5.0,1.0,20.0,0.95,0.19,0.2,1.0,22.1,0.0,0.0,0.0,0.3,0.3,0.06,0.7,0.7,Matches,62.0,eng ENG,DFFW,21.0,21.0,2.0,472.0,5.2,1.0,0.0,1.0,1.0,0.0,0.0,2.0,0.0,0.3,0.3,0.8,1.1,10.0,21.0,20.0,0.19,0.0,0.19,0.19,0.19,0.06,0.16,0.21,0.06,0.21,Matches,Lee Buchanan,D/WB LC,21,111,138,England,SV Werder Bremen,8,11,13,10,10,7,11,7,12,11,9,6,12,10,11,10,12,9,9,10,11,12,11,9,12,10,9,13,14,11,12,10,12,14,13,11,12,6,14,13,15,1,1,3,3,1,1,1,2,1,2,2,11,15,16,9,9,14,6,12,1,20,15,9,20,11,11,12,1,1,10,1,1,1,175,67,20,14,3324999,5550,5550,3010,Mixed_Race,104,12,2001/3/7,0,0,4640.0,,29191592
19,Jonathan Burkardt,Mainz 05,2000,65.0,de GER,MFFW,22.0,5.9,3.0,1.0,0.0,1.0,2.0,1.0,4.0,25.0,3.0,6.0,1.0,5.0,1.0,4.0,1.0,0.0,Matches,65.0,de GER,MFFW,22.0,5.9,20.0,3.38,10.0,0.0,2.0,5.0,2.0,1.0,3.0,0.51,2.0,0.0,0.0,1.0,0.0,0.0,Matches,,,,,,,,,,,,,,,,,,,,,,,,,,,,,,,,,,,,,,,,,,,,,,,,,,,,,,,,65.0,de GER,MFFW,22.0,5.9,2.0,0.0,0.0,6.0,11.0,3.0,11.0,1.0,1.0,2.0,0.0,0.0,13.0,8.0,15.0,34.8,Matches,65.0,de GER,MFFW,22.0,5.9,109.0,106.0,1.0,0.0,2.0,2.0,11.0,0.0,0.0,0.0,0.0,0.0,71.0,2.0,5.0,Matches,65.0,de GER,MFFW,22.0,5.9,71.0,109.0,65.1,1119.0,317.0,37.0,46.0,80.4,23.0,32.0,71.9,8.0,14.0,57.1,2.0,1.1,1.6,0.9,7.0,3.0,9.0,2.0,14.0,Matches,76,de GER,MFFW,22,11,533.0,48.0,17.4,5.9,7,59.0,0,4,29.0,0,1.18,7.0,12.0,-5.0,-0.84,-0.99,8.5,9.8,-1.3,-0.22,-0.04,Matches,65.0,de GER,MFFW,22.0,5.9,180.0,2.0,19.0,65.0,99.0,37.0,179.0,20.0,11.0,55.0,8.0,40.0,128.0,642.0,257.0,9.0,7.0,6.0,17.0,9.0,139.0,46.0,Matches,65.0,de GER,MFFW,22.0,5.9,1.0,20.0,6.0,30.0,3.38,1.01,0.05,0.17,12.6,0.0,0.0,1.0,3.0,2.2,0.11,-2.0,-1.2,Matches,65.0,de GER,MFFW,22.0,11.0,7.0,533.0,5.9,1.0,2.0,3.0,1.0,0.0,1.0,2.0,0.0,3.0,2.2,1.1,3.3,9.0,14.0,46.0,0.17,0.34,0.51,0.17,0.51,0.5,0.18,0.68,0.37,0.55,Matches,Jonathan Burkardt,S RLC,22,132,152,Germany,1. FSV Mainz 05,4,7,13,12,12,4,10,8,4,7,12,13,7,13,11,14,14,12,11,12,11,16,13,12,14,7,16,16,16,14,9,10,16,16,14,10,11,3,14,7,13,2,4,3,1,1,3,1,1,1,1,1,9,14,6,17,12,14,16,17,1,1,1,1,1,10,1,10,1,10,15,15,15,20,181,76,14,20,10962000,6600,6600,5600,Northern_European,126,2,2000/7/11,0,0,28766.0,,91170086
20,Jamie Bynoe-Gittens,Dortmund,2004,68.0,eng ENG,FWMF,17.0,5.9,8.0,4.0,2.0,5.0,1.0,2.0,7.0,28.6,5.0,1.0,0.0,1.0,1.0,9.0,2.0,0.0,Matches,68.0,eng ENG,FWMF,17.0,5.9,21.0,3.54,11.0,0.0,5.0,3.0,2.0,0.0,9.0,1.52,7.0,0.0,1.0,1.0,0.0,0.0,Matches,,,,,,,,,,,,,,,,,,,,,,,,,,,,,,,,,,,,,,,,,,,,,,,,,,,,,,,,68.0,eng ENG,FWMF,17.0,5.9,1.0,0.0,0.0,9.0,18.0,0.0,6.0,1.0,4.0,0.0,0.0,0.0,23.0,9.0,10.0,47.4,Matches,68.0,eng ENG,FWMF,17.0,5.9,142.0,138.0,3.0,0.0,2.0,1.0,6.0,3.0,0.0,0.0,0.0,0.0,104.0,1.0,1.0,Matches,68.0,eng ENG,FWMF,17.0,5.9,104.0,142.0,73.2,1235.0,328.0,72.0,90.0,80.0,20.0,28.0,71.4,2.0,9.0,22.2,1.0,0.7,1.0,0.3,2.0,9.0,5.0,0.0,9.0,Matches,80,eng ENG,FWMF,17,15,533.0,36.0,17.4,5.9,4,59.0,0,11,27.0,3,2.53,19.0,7.0,12.0,2.03,1.06,12.9,8.4,4.4,0.75,-0.09,Matches,68.0,eng ENG,FWMF,17.0,5.9,251.0,5.0,32.0,80.0,147.0,37.0,251.0,55.0,20.0,36.4,28.0,50.9,179.0,1422.0,714.0,24.0,13.0,18.0,22.0,5.0,192.0,38.0,Matches,68.0,eng ENG,FWMF,17.0,5.9,3.0,24.0,11.0,45.8,4.05,1.86,0.13,0.27,17.6,0.0,0.0,0.0,2.4,2.4,0.1,0.6,0.6,Matches,68.0,eng ENG,FWMF,17.0,15.0,4.0,533.0,5.9,3.0,1.0,4.0,3.0,0.0,0.0,1.0,0.0,2.4,2.4,0.7,3.1,24.0,9.0,38.0,0.51,0.17,0.68,0.51,0.68,0.41,0.12,0.53,0.41,0.53,Matches,Jamie Bynoe-Gittens,AM RL,17,123,-85,"England,Barbados",Borussia Dortmund,10,12,17,11,12,11,5,10,4,6,13,12,5,17,8,9,7,9,8,12,6,17,14,7,9,4,8,7,17,15,11,6,5,16,10,10,20,14,9,16,16,2,3,3,1,3,2,3,3,1,2,1,11,10,5,9,8,11,13,17,1,1,1,1,1,1,1,14,1,12,20,1,15,13,175,0,12,20,68780000,5750,4074,3829,African_Caribbean,115,17,2004/8/8,0,0,5999.0,,2000015300
21,Daniel Caligiuri,Augsburg,1988,71.0,it ITA,DFMF,34.0,3.2,8.0,5.0,5.0,3.0,0.0,4.0,5.0,80.0,1.0,3.0,2.0,1.0,3.0,11.0,2.0,0.0,Matches,71.0,it ITA,DFMF,34.0,3.2,10.0,3.09,3.0,4.0,0.0,0.0,3.0,0.0,1.0,0.31,0.0,0.0,0.0,0.0,1.0,0.0,Matches,,,,,,,,,,,,,,,,,,,,,,,,,,,,,,,,,,,,,,,,,,,,,,,,,,,,,,,,71.0,it ITA,DFMF,34.0,3.2,1.0,0.0,0.0,5.0,4.0,0.0,11.0,3.0,5.0,0.0,0.0,0.0,33.0,5.0,5.0,50.0,Matches,71.0,it ITA,DFMF,34.0,3.2,166.0,116.0,50.0,9.0,0.0,2.0,11.0,35.0,6.0,5.0,1.0,0.0,107.0,0.0,3.0,Matches,71.0,it ITA,DFMF,34.0,3.2,107.0,166.0,64.5,1897.0,934.0,47.0,57.0,82.5,42.0,71.0,59.2,13.0,29.0,44.8,0.0,0.4,0.3,-0.4,4.0,10.0,4.0,0.0,16.0,Matches,83,it ITA,DFMF,34,13,290.0,22.0,9.5,3.2,2,74.0,1,11,13.0,20,0.85,2.0,10.0,-8.0,-2.48,-2.06,1.7,7.8,-6.1,-1.88,-1.3,Matches,71.0,it ITA,DFMF,34.0,3.2,200.0,12.0,65.0,88.0,52.0,5.0,200.0,11.0,5.0,45.5,4.0,36.4,82.0,441.0,234.0,7.0,5.0,1.0,5.0,4.0,83.0,8.0,Matches,71.0,it ITA,DFMF,34.0,3.2,1.0,6.0,2.0,33.3,1.86,0.62,0.17,0.5,19.8,0.0,0.0,0.0,0.4,0.4,0.07,0.6,0.6,Matches,71.0,it ITA,DFMF,34.0,13.0,2.0,290.0,3.2,1.0,0.0,1.0,1.0,0.0,0.0,1.0,0.0,0.4,0.4,0.4,0.8,7.0,16.0,8.0,0.31,0.0,0.31,0.31,0.31,0.12,0.12,0.24,0.12,0.24,Matches,Daniel Caligiuri,D/WB/M/AM RL,34,137,144,"Germany,Italy",FC Augsburg,14,12,13,11,11,14,8,12,12,9,11,14,12,12,14,12,15,10,13,12,11,13,11,9,12,11,15,16,13,11,15,9,14,14,15,13,13,8,14,5,16,3,3,4,3,3,3,3,2,3,4,3,9,14,6,12,11,15,13,10,1,1,1,16,1,20,1,15,10,18,15,13,18,10,182,80,10,20,701317,6850,6850,5500,Mediterranean_Hispanic,126,5,1988/1/15,0,0,34520.0,,91003264
22,Irvin Cardona,Augsburg,1997,74.0,fr FRA,MFFW,24.0,3.5,1.0,1.0,1.0,0.0,0.0,1.0,5.0,20.0,4.0,3.0,0.0,3.0,4.0,5.0,8.0,0.0,Matches,74.0,fr FRA,MFFW,24.0,3.5,5.0,1.42,4.0,0.0,0.0,0.0,1.0,0.0,1.0,0.28,0.0,0.0,0.0,0.0,1.0,0.0,Matches,,,,,,,,,,,,,,,,,,,,,,,,,,,,,,,,,,,,,,,,,,,,,,,,,,,,,,,,74.0,fr FRA,MFFW,24.0,3.5,2.0,0.0,0.0,2.0,5.0,1.0,9.0,4.0,1.0,1.0,0.0,0.0,9.0,3.0,8.0,27.3,Matches,74.0,fr FRA,MFFW,24.0,3.5,74.0,71.0,2.0,0.0,1.0,0.0,9.0,1.0,0.0,0.0,0.0,0.0,36.0,1.0,2.0,Matches,74.0,fr FRA,MFFW,24.0,3.5,36.0,74.0,48.6,452.0,108.0,22.0,32.0,68.8,8.0,21.0,38.1,2.0,10.0,20.0,0.0,0.1,0.1,-0.1,3.0,4.0,1.0,0.0,3.0,Matches,86,fr FRA,MFFW,24,10,318.0,32.0,10.4,3.5,0,,0,10,32.0,2,0.4,6.0,9.0,-3.0,-0.85,-0.26,4.8,8.4,-3.6,-1.03,-0.36,Matches,74.0,fr FRA,MFFW,24.0,3.5,120.0,7.0,16.0,40.0,64.0,16.0,120.0,7.0,4.0,57.1,3.0,42.9,68.0,359.0,222.0,9.0,6.0,1.0,13.0,4.0,72.0,17.0,Matches,74.0,fr FRA,MFFW,24.0,3.5,1.0,9.0,4.0,44.4,2.55,1.13,0.11,0.25,13.9,0.0,0.0,0.0,1.9,1.9,0.21,-0.9,-0.9,Matches,74.0,fr FRA,MFFW,24.0,10.0,0.0,318.0,3.5,1.0,0.0,1.0,1.0,0.0,0.0,2.0,0.0,1.9,1.9,0.1,1.9,9.0,3.0,17.0,0.28,0.0,0.28,0.28,0.28,0.52,0.03,0.55,0.52,0.55,Matches,Irvin Cardona,AM/S RL,24,125,136,France,Stade Brestois 29,7,12,13,12,13,10,13,12,3,5,13,15,6,14,10,12,14,13,11,12,12,14,14,10,14,8,12,15,13,12,14,14,14,13,14,12,12,9,13,7,12,1,3,1,1,3,3,1,2,2,3,4,12,14,7,12,12,13,12,13,1,1,1,1,1,1,1,12,1,12,20,12,15,18,185,76,8,20,2289811,6250,6250,3905,Northern_European,123,6,1997/8/8,0,0,6898.0,,85141637
23,Timothy Chandler,Eint Frankfurt,1990,77.0,us USA,DF,32.0,1.0,2.0,2.0,2.0,0.0,0.0,2.0,2.0,100.0,0.0,1.0,0.0,1.0,0.0,2.0,3.0,0.0,Matches,77.0,us USA,DF,32.0,1.0,3.0,3.1,2.0,1.0,0.0,0.0,0.0,0.0,0.0,0.0,0.0,0.0,0.0,0.0,0.0,0.0,Matches,,,,,,,,,,,,,,,,,,,,,,,,,,,,,,,,,,,,,,,,,,,,,,,,,,,,,,,,77.0,us USA,DF,32.0,1.0,0.0,0.0,0.0,0.0,0.0,0.0,3.0,0.0,2.0,0.0,0.0,0.0,5.0,1.0,0.0,100.0,Matches,77.0,us USA,DF,32.0,1.0,61.0,43.0,17.0,0.0,0.0,0.0,3.0,17.0,0.0,0.0,0.0,0.0,36.0,1.0,2.0,Matches,77.0,us USA,DF,32.0,1.0,36.0,61.0,59.0,770.0,554.0,8.0,20.0,40.0,18.0,25.0,72.0,8.0,10.0,80.0,0.0,0.0,0.1,0.0,1.0,7.0,0.0,0.0,7.0,Matches,89,us USA,DF,32,6,86.0,14.0,2.8,1.0,0,,0,6,14.0,25,2.17,1.0,5.0,-4.0,-4.19,-4.49,1.2,2.1,-0.9,-0.94,-1.23,Matches,77.0,us USA,DF,32.0,1.0,71.0,2.0,14.0,32.0,25.0,2.0,71.0,4.0,1.0,25.0,3.0,75.0,28.0,99.0,59.0,2.0,0.0,1.0,2.0,0.0,37.0,6.0,Matches,77.0,us USA,DF,32.0,1.0,0.0,0.0,0.0,,0.0,0.0,,,,0.0,0.0,0.0,0.0,0.0,,0.0,0.0,Matches,77.0,us USA,DF,32.0,6.0,0.0,86.0,1.0,0.0,0.0,0.0,0.0,0.0,0.0,0.0,0.0,0.0,0.0,0.0,0.0,2.0,7.0,6.0,0.0,0.0,0.0,0.0,0.0,0.0,0.02,0.02,0.0,0.02,Matches,Timothy Chandler,D/WB/M RL,32,125,133,"United States,Germany",Eintracht Frankfurt,8,13,10,7,11,7,10,9,17,12,10,6,12,11,12,11,14,10,14,9,11,15,9,11,12,12,13,15,12,10,15,13,14,14,14,15,13,10,13,10,15,2,3,4,4,2,1,1,1,1,3,3,10,12,6,10,11,14,13,11,1,16,10,20,16,20,8,16,10,16,10,1,12,1,187,84,8,20,1302023,6248,6098,4748,Mixed_Race,115,10,1990/3/29,29,1,14999.0,,91001071
24,Fabio Chiarodia,Werder Bremen,2005,78.0,it ITA,DF,17.0,0.7,0.0,0.0,0.0,0.0,0.0,0.0,0.0,,0.0,1.0,0.0,1.0,2.0,2.0,4.0,0.0,Matches,78.0,it ITA,DF,17.0,0.7,0.0,0.0,0.0,0.0,0.0,0.0,0.0,0.0,0.0,0.0,0.0,0.0,0.0,0.0,0.0,0.0,Matches,,,,,,,,,,,,,,,,,,,,,,,,,,,,,,,,,,,,,,,,,,,,,,,,,,,,,,,,78.0,it ITA,DF,17.0,0.7,0.0,0.0,0.0,0.0,0.0,0.0,0.0,2.0,0.0,0.0,0.0,0.0,1.0,1.0,1.0,50.0,Matches,78.0,it ITA,DF,17.0,0.7,22.0,20.0,2.0,2.0,0.0,1.0,0.0,0.0,0.0,0.0,0.0,0.0,15.0,0.0,1.0,Matches,78.0,it ITA,DF,17.0,0.7,15.0,22.0,68.2,335.0,140.0,3.0,6.0,50.0,8.0,9.0,88.9,4.0,5.0,80.0,0.0,0.0,0.0,0.0,0.0,3.0,0.0,0.0,4.0,Matches,91,it ITA,DF,17,3,66.0,22.0,2.2,0.7,1,62.0,0,2,2.0,23,1.33,0.0,1.0,-1.0,-1.36,-1.0,0.3,2.9,-2.6,-3.52,-3.24,Matches,78.0,it ITA,DF,17.0,0.7,29.0,6.0,16.0,11.0,2.0,1.0,29.0,0.0,0.0,,0.0,,9.0,44.0,13.0,0.0,0.0,0.0,0.0,0.0,12.0,0.0,Matches,78.0,it ITA,DF,17.0,0.7,0.0,0.0,0.0,,0.0,0.0,,,,0.0,0.0,0.0,0.0,0.0,,0.0,0.0,Matches,78.0,it ITA,DF,17.0,3.0,1.0,66.0,0.7,0.0,0.0,0.0,0.0,0.0,0.0,0.0,0.0,0.0,0.0,0.0,0.0,0.0,4.0,0.0,0.0,0.0,0.0,0.0,0.0,0.0,0.0,0.0,0.0,0.0,Matches,Fabio Chiarodia,D C,17,87,-75,"Italy,Germany",SV Werder Bremen,6,3,8,7,12,9,11,9,1,10,13,6,16,16,14,11,10,10,11,11,10,8,5,7,9,16,9,11,11,9,10,13,5,8,8,6,19,5,7,5,14,2,1,1,2,1,2,3,3,1,2,2,19,11,8,9,8,13,6,12,1,8,20,1,1,1,12,1,1,1,1,1,1,1,186,0,20,5,7879999,4350,4350,2272,Mediterranean_Hispanic,85,10,2005/6/5,0,0,646.0,,2000116422
25,Darko Churlinov,Stuttgart,2000,80.0,mk MKD,FW,22.0,0.3,3.0,2.0,2.0,1.0,0.0,2.0,3.0,66.7,1.0,1.0,0.0,1.0,0.0,3.0,0.0,0.0,Matches,80.0,mk MKD,FW,22.0,0.3,0.0,0.0,0.0,0.0,0.0,0.0,0.0,0.0,0.0,0.0,0.0,0.0,0.0,0.0,0.0,0.0,Matches,,,,,,,,,,,,,,,,,,,,,,,,,,,,,,,,,,,,,,,,,,,,,,,,,,,,,,,,80.0,mk MKD,FW,22.0,0.3,0.0,0.0,0.0,0.0,1.0,0.0,0.0,0.0,2.0,0.0,0.0,0.0,0.0,0.0,1.0,0.0,Matches,80.0,mk MKD,FW,22.0,0.3,0.0,0.0,0.0,0.0,0.0,0.0,0.0,0.0,0.0,0.0,0.0,0.0,0.0,0.0,0.0,Matches,80.0,mk MKD,FW,22.0,0.3,0.0,0.0,,0.0,0.0,0.0,0.0,,0.0,0.0,,0.0,0.0,,0.0,0.0,0.0,0.0,0.0,0.0,0.0,0.0,0.0,Matches,93,mk MKD,FW,22,1,27.0,27.0,0.9,0.3,0,,0,1,27.0,0,1.0,0.0,0.0,0.0,0.0,0.36,0.1,1.1,-1.1,-3.52,-3.62,Matches,80.0,mk MKD,FW,22.0,0.3,5.0,1.0,2.0,3.0,0.0,0.0,5.0,0.0,0.0,,0.0,,1.0,1.0,0.0,0.0,0.0,0.0,1.0,1.0,1.0,0.0,Matches,80.0,mk MKD,FW,22.0,0.3,0.0,0.0,0.0,,0.0,0.0,,,,0.0,0.0,0.0,0.0,0.0,,0.0,0.0,Matches,80.0,mk MKD,FW,22.0,1.0,0.0,27.0,0.3,0.0,0.0,0.0,0.0,0.0,0.0,0.0,0.0,0.0,0.0,0.0,0.0,0.0,0.0,0.0,0.0,0.0,0.0,0.0,0.0,0.0,0.0,0.0,0.0,0.0,Matches,Darko Churlinov,AM RL,22,123,140,North Macedonia,Burnley,6,11,15,11,12,9,7,10,6,9,12,9,10,14,16,12,12,11,12,13,10,17,16,4,12,8,11,15,14,14,11,8,13,15,12,9,12,11,13,9,18,2,2,3,1,1,2,3,3,3,3,3,18,16,7,7,13,12,10,9,1,10,1,10,12,14,1,15,10,15,20,12,18,10,180,73,10,20,10949620,6150,5750,4500,Mediterranean_Hispanic,120,4,2000/7/11,17,3,12499.0,,91178617
26,Soumaïla Coulibaly,Dortmund,2003,85.0,fr FRA,DF,18.0,0.5,0.0,0.0,0.0,0.0,0.0,0.0,0.0,,0.0,0.0,0.0,0.0,0.0,0.0,0.0,1.0,Matches,85.0,fr FRA,DF,18.0,0.5,1.0,2.0,1.0,0.0,0.0,0.0,0.0,0.0,0.0,0.0,0.0,0.0,0.0,0.0,0.0,0.0,Matches,,,,,,,,,,,,,,,,,,,,,,,,,,,,,,,,,,,,,,,,,,,,,,,,,,,,,,,,85.0,fr FRA,DF,18.0,0.5,0.0,0.0,0.0,1.0,0.0,0.0,0.0,0.0,0.0,0.0,0.0,0.0,1.0,1.0,0.0,100.0,Matches,85.0,fr FRA,DF,18.0,0.5,46.0,46.0,0.0,0.0,0.0,0.0,0.0,0.0,0.0,0.0,0.0,0.0,45.0,0.0,1.0,Matches,85.0,fr FRA,DF,18.0,0.5,45.0,46.0,97.8,851.0,279.0,11.0,11.0,100.0,34.0,34.0,100.0,0.0,0.0,,0.0,0.0,0.0,0.0,0.0,3.0,0.0,0.0,6.0,Matches,99,fr FRA,DF,18,1,45.0,45.0,1.5,0.5,0,,0,1,45.0,10,1.0,1.0,3.0,-2.0,-4.0,-5.22,0.9,0.7,0.3,0.52,-0.31,Matches,85.0,fr FRA,DF,18.0,0.5,48.0,1.0,7.0,40.0,1.0,0.0,48.0,0.0,0.0,,0.0,,40.0,200.0,91.0,0.0,0.0,0.0,0.0,0.0,43.0,0.0,Matches,85.0,fr FRA,DF,18.0,0.5,0.0,0.0,0.0,,0.0,0.0,,,,0.0,0.0,0.0,0.0,0.0,,0.0,0.0,Matches,85.0,fr FRA,DF,18.0,1.0,0.0,45.0,0.5,0.0,0.0,0.0,0.0,0.0,0.0,0.0,0.0,0.0,0.0,0.0,0.0,0.0,6.0,0.0,0.0,0.0,0.0,0.0,0.0,0.0,0.0,0.0,0.0,0.0,Matches,Soumaïla Coulibaly,D C,18,102,-8,"France,Mali",Borussia Dortmund,9,7,7,6,15,6,12,10,8,12,16,5,16,10,13,12,11,13,9,16,6,4,8,11,10,16,10,11,12,13,11,14,14,13,7,12,14,15,17,6,14,3,2,1,3,3,3,2,4,1,1,1,10,9,8,11,11,11,12,18,1,1,20,1,1,1,1,1,1,1,1,1,1,1,190,82,20,10,31480000,5114,5108,3413,African_Caribbean,109,12,2003/10/14,0,0,28766.0,,2000011613
27,Tanguy Coulibaly,Stuttgart,2001,86.0,fr FRA,FWDF,21.0,3.6,12.0,9.0,9.0,1.0,2.0,5.0,12.0,41.7,7.0,10.0,0.0,10.0,3.0,15.0,0.0,0.0,Matches,86.0,fr FRA,FWDF,21.0,3.6,13.0,3.58,8.0,1.0,4.0,0.0,0.0,0.0,1.0,0.28,0.0,0.0,1.0,0.0,0.0,0.0,Matches,,,,,,,,,,,,,,,,,,,,,,,,,,,,,,,,,,,,,,,,,,,,,,,,,,,,,,,,86.0,fr FRA,FWDF,21.0,3.6,3.0,0.0,0.0,8.0,5.0,3.0,10.0,3.0,9.0,0.0,0.0,0.0,26.0,0.0,5.0,0.0,Matches,86.0,fr FRA,FWDF,21.0,3.6,141.0,126.0,14.0,3.0,0.0,1.0,10.0,10.0,1.0,1.0,0.0,0.0,98.0,1.0,13.0,Matches,86.0,fr FRA,FWDF,21.0,3.6,98.0,141.0,69.5,1412.0,420.0,61.0,70.0,87.1,29.0,40.0,72.5,5.0,13.0,38.5,0.0,0.5,0.7,-0.5,6.0,8.0,4.0,1.0,12.0,Matches,100,fr FRA,FWDF,21,14,326.0,23.0,10.7,3.6,0,,0,14,23.0,8,1.0,11.0,6.0,5.0,1.38,1.94,7.3,4.9,2.5,0.68,0.68,Matches,86.0,fr FRA,FWDF,21.0,3.6,206.0,2.0,30.0,81.0,101.0,17.0,205.0,22.0,11.0,50.0,11.0,50.0,126.0,811.0,415.0,14.0,9.0,5.0,7.0,9.0,123.0,38.0,Matches,86.0,fr FRA,FWDF,21.0,3.6,4.0,11.0,6.0,54.5,3.04,1.66,0.27,0.5,19.4,0.0,1.0,1.0,2.3,1.5,0.14,1.7,1.5,Matches,86.0,fr FRA,FWDF,21.0,14.0,0.0,326.0,3.6,4.0,0.0,4.0,3.0,1.0,1.0,3.0,0.0,2.3,1.5,0.5,2.0,14.0,12.0,38.0,1.1,0.0,1.1,0.83,0.83,0.63,0.13,0.75,0.41,0.54,Matches,Tanguy Coulibaly,WB/M/AM RL,21,121,142,France,VfB Stuttgart,10,9,14,9,11,9,10,10,6,7,11,12,9,12,11,10,12,9,9,11,10,12,16,6,11,7,11,13,15,15,11,8,14,15,12,11,8,7,10,6,14,1,4,1,3,1,3,1,2,2,1,2,15,14,6,10,10,12,12,14,1,7,1,1,16,10,1,16,1,12,20,1,16,14,175,72,20,8,3739999,6047,5747,4247,African_Caribbean,111,17,2001/2/18,0,0,8630.0,,49039276
28,Nicolas Cozza,Wolfsburg,1999,87.0,fr FRA,DF,23.0,1.1,3.0,3.0,1.0,2.0,0.0,2.0,3.0,66.7,1.0,3.0,1.0,2.0,0.0,3.0,0.0,0.0,Matches,87.0,fr FRA,DF,23.0,1.1,1.0,0.9,1.0,0.0,0.0,0.0,0.0,0.0,0.0,0.0,0.0,0.0,0.0,0.0,0.0,0.0,Matches,,,,,,,,,,,,,,,,,,,,,,,,,,,,,,,,,,,,,,,,,,,,,,,,,,,,,,,,87.0,fr FRA,DF,23.0,1.1,0.0,0.0,0.0,0.0,1.0,0.0,0.0,0.0,3.0,0.0,0.0,0.0,6.0,1.0,0.0,100.0,Matches,87.0,fr FRA,DF,23.0,1.1,44.0,41.0,3.0,1.0,0.0,0.0,0.0,2.0,0.0,0.0,0.0,0.0,33.0,0.0,0.0,Matches,87.0,fr FRA,DF,23.0,1.1,33.0,44.0,75.0,571.0,190.0,16.0,19.0,84.2,14.0,15.0,93.3,3.0,9.0,33.3,0.0,0.0,0.0,0.0,0.0,3.0,0.0,0.0,4.0,Matches,101,fr FRA,DF,23,5,100.0,20.0,3.3,1.1,0,,0,5,20.0,10,2.0,2.0,2.0,0.0,0.0,-0.27,2.8,1.9,0.9,0.8,0.82,Matches,87.0,fr FRA,DF,23.0,1.1,53.0,2.0,26.0,26.0,3.0,0.0,53.0,1.0,0.0,0.0,0.0,0.0,36.0,246.0,85.0,2.0,0.0,0.0,1.0,2.0,35.0,2.0,Matches,87.0,fr FRA,DF,23.0,1.1,0.0,0.0,0.0,,0.0,0.0,,,,0.0,0.0,0.0,0.0,0.0,,0.0,0.0,Matches,87.0,fr FRA,DF,23.0,5.0,0.0,100.0,1.1,0.0,0.0,0.0,0.0,0.0,0.0,0.0,0.0,0.0,0.0,0.0,0.0,2.0,4.0,2.0,0.0,0.0,0.0,0.0,0.0,0.0,0.0,0.0,0.0,0.0,Matches,Nicolas Cozza,D LC,23,125,139,France,Montpellier Hérault SC,9,11,11,8,13,7,12,9,10,14,13,8,13,12,10,14,12,13,13,11,12,11,10,10,12,14,14,13,12,12,14,12,13,12,14,13,13,9,14,11,12,2,2,3,3,3,2,3,1,1,2,1,8,13,11,10,12,14,12,15,1,20,20,1,14,1,1,1,1,1,1,1,1,1,178,72,20,8,2298572,6250,6250,3814,Northern_European,125,3,1999/1/8,0,0,8049.0,,49037761
29,Finn Dahmen,Mainz 05,1998,89.0,de GER,GK,24.0,8.0,0.0,0.0,0.0,0.0,0.0,0.0,0.0,,0.0,0.0,0.0,0.0,0.0,0.0,3.0,0.0,Matches,89.0,de GER,GK,24.0,8.0,3.0,0.37,3.0,0.0,0.0,0.0,0.0,0.0,0.0,0.0,0.0,0.0,0.0,0.0,0.0,0.0,Matches,6.0,de GER,GK,24.0,8.0,16.0,1.0,0.0,3.0,0.0,13.5,0.25,-2.5,-0.32,48.0,139.0,34.5,226.0,38.0,42.9,36.6,54.0,77.8,54.5,158.0,17.0,10.8,8.0,1.0,13.8,Matches,6.0,de GER,GK,24.0,8.0,8.0,720.0,8.0,16.0,2.0,44.0,26.0,65.9,3.0,2.0,3.0,0.0,0.0,3.0,1.0,2.0,0.0,66.7,Matches,89.0,de GER,GK,24.0,8.0,0.0,0.0,0.0,0.0,0.0,0.0,0.0,0.0,0.0,0.0,0.0,0.0,18.0,7.0,1.0,87.5,Matches,89.0,de GER,GK,24.0,8.0,280.0,203.0,77.0,23.0,0.0,0.0,0.0,0.0,0.0,0.0,0.0,0.0,185.0,0.0,0.0,Matches,89.0,de GER,GK,24.0,8.0,185.0,280.0,66.1,5576.0,4122.0,32.0,32.0,100.0,87.0,87.0,100.0,65.0,160.0,40.6,0.0,0.0,0.0,0.0,0.0,10.0,0.0,0.0,0.0,Matches,103,de GER,GK,24,8,720.0,90.0,23.5,8.0,8,90.0,8,0,,26,1.38,17.0,16.0,1.0,0.12,0.2,13.2,15.2,-2.0,-0.25,-0.08,Matches,89.0,de GER,GK,24.0,8.0,294.0,226.0,288.0,7.0,0.0,0.0,294.0,0.0,0.0,,0.0,,190.0,1151.0,638.0,0.0,0.0,0.0,0.0,0.0,111.0,0.0,Matches,89.0,de GER,GK,24.0,8.0,0.0,0.0,0.0,,0.0,0.0,,,,0.0,0.0,0.0,0.0,0.0,,0.0,0.0,Matches,89.0,de GER,GK,24.0,8.0,8.0,720.0,8.0,0.0,0.0,0.0,0.0,0.0,0.0,0.0,0.0,0.0,0.0,0.0,0.0,0.0,0.0,0.0,0.0,0.0,0.0,0.0,0.0,0.0,0.0,0.0,0.0,0.0,Matches,Finn Dahmen,GK,24,122,135,"Germany,England",1. FSV Mainz 05,1,3,1,1,11,4,6,2,2,1,12,4,1,11,11,12,12,12,12,11,12,13,7,7,1,14,11,10,10,15,14,15,16,11,11,12,13,6,16,3,10,12,12,12,8,13,12,14,14,12,8,11,7,15,12,15,14,16,14,14,20,1,1,1,1,1,1,1,1,1,1,1,1,1,186,80,7,20,635345,6100,6100,4112,Northern_European,122,3,1998/3/27,0,0,7671.0,,92071481
30,Mahmoud Dahoud,Dortmund,1996,90.0,de GER,MF,26.0,3.7,11.0,9.0,3.0,4.0,4.0,7.0,7.0,100.0,0.0,6.0,2.0,4.0,7.0,18.0,3.0,0.0,Matches,90.0,de GER,MF,26.0,3.7,6.0,1.6,5.0,0.0,0.0,1.0,0.0,0.0,1.0,0.27,0.0,0.0,0.0,1.0,0.0,0.0,Matches,,,,,,,,,,,,,,,,,,,,,,,,,,,,,,,,,,,,,,,,,,,,,,,,,,,,,,,,90.0,de GER,MF,26.0,3.7,1.0,0.0,0.0,3.0,2.0,0.0,3.0,7.0,9.0,0.0,0.0,0.0,24.0,1.0,3.0,25.0,Matches,90.0,de GER,MF,26.0,3.7,259.0,253.0,4.0,2.0,1.0,1.0,3.0,0.0,2.0,0.0,2.0,0.0,213.0,2.0,7.0,Matches,90.0,de GER,MF,26.0,3.7,213.0,259.0,82.2,3941.0,1179.0,89.0,103.0,86.4,91.0,93.0,97.8,30.0,45.0,66.7,0.0,0.5,0.2,-0.5,4.0,25.0,1.0,0.0,25.0,Matches,104,de GER,MF,26,9,337.0,37.0,11.0,3.7,4,65.0,1,5,15.0,6,2.11,10.0,3.0,7.0,1.87,0.81,7.7,4.0,3.7,0.98,0.18,Matches,90.0,de GER,MF,26.0,3.7,302.0,9.0,64.0,183.0,56.0,2.0,302.0,5.0,3.0,60.0,2.0,40.0,153.0,736.0,305.0,5.0,6.0,1.0,6.0,4.0,218.0,4.0,Matches,90.0,de GER,MF,26.0,3.7,0.0,6.0,1.0,16.7,1.6,0.27,0.0,0.0,26.2,1.0,0.0,0.0,0.4,0.4,0.07,-0.4,-0.4,Matches,90.0,de GER,MF,26.0,9.0,4.0,337.0,3.7,0.0,0.0,0.0,0.0,0.0,0.0,1.0,0.0,0.4,0.4,0.5,0.9,5.0,25.0,4.0,0.0,0.0,0.0,0.0,0.0,0.12,0.13,0.24,0.12,0.24,Matches,Mahmoud Dahoud,DM/M C,26,140,150,"Germany,Syria",Borussia Dortmund,9,11,16,10,16,9,6,11,5,9,17,10,10,16,14,13,11,16,10,16,10,12,14,10,12,10,16,16,13,17,11,8,13,13,14,8,11,6,12,13,9,3,3,2,1,2,4,3,4,3,2,3,7,15,13,11,9,13,14,17,1,1,1,1,1,1,20,1,18,1,1,12,1,1,178,68,12,20,12957411,7093,7093,5743,North_African__Middle_Eastern,128,7,1996/1/1,2,0,76660.0,,92063787
31,Muhammed Damar,Hoffenheim,2004,91.0,de GER,MF,18.0,1.8,6.0,3.0,1.0,2.0,3.0,1.0,2.0,50.0,1.0,3.0,0.0,3.0,0.0,6.0,0.0,0.0,Matches,91.0,de GER,MF,18.0,1.8,5.0,2.83,5.0,0.0,0.0,0.0,0.0,0.0,1.0,0.57,1.0,0.0,0.0,0.0,0.0,0.0,Matches,,,,,,,,,,,,,,,,,,,,,,,,,,,,,,,,,,,,,,,,,,,,,,,,,,,,,,,,91.0,de GER,MF,18.0,1.8,0.0,0.0,0.0,6.0,1.0,0.0,2.0,0.0,3.0,0.0,0.0,0.0,12.0,2.0,2.0,50.0,Matches,91.0,de GER,MF,18.0,1.8,65.0,63.0,1.0,0.0,0.0,0.0,2.0,1.0,0.0,0.0,0.0,0.0,52.0,1.0,2.0,Matches,91.0,de GER,MF,18.0,1.8,52.0,65.0,80.0,686.0,179.0,30.0,34.0,88.2,19.0,21.0,90.5,0.0,2.0,0.0,0.0,0.2,0.1,-0.2,3.0,5.0,1.0,0.0,9.0,Matches,105,de GER,MF,18,6,159.0,27.0,5.2,1.8,1,45.0,0,5,23.0,9,0.33,2.0,5.0,-3.0,-1.7,-1.51,2.9,2.4,0.5,0.28,0.39,Matches,91.0,de GER,MF,18.0,1.8,94.0,1.0,17.0,49.0,29.0,6.0,94.0,6.0,0.0,0.0,5.0,83.3,49.0,273.0,145.0,2.0,3.0,1.0,9.0,2.0,65.0,7.0,Matches,91.0,de GER,MF,18.0,1.8,0.0,1.0,0.0,0.0,0.57,0.0,0.0,,10.4,0.0,0.0,0.0,0.1,0.1,0.11,-0.1,-0.1,Matches,91.0,de GER,MF,18.0,6.0,1.0,159.0,1.8,0.0,0.0,0.0,0.0,0.0,0.0,0.0,0.0,0.1,0.1,0.2,0.3,2.0,9.0,7.0,0.0,0.0,0.0,0.0,0.0,0.06,0.09,0.15,0.06,0.15,Matches,Muhammed Damar,M/AM RLC,18,109,-8,"Germany,Turkey",TSG Hoffenheim,13,9,12,11,14,15,7,13,3,8,13,12,9,15,11,10,9,11,9,13,10,13,17,3,11,7,11,11,12,12,12,10,13,12,11,8,12,4,7,5,12,1,3,2,3,2,1,3,1,2,2,2,11,15,7,8,12,13,12,12,1,1,1,1,1,1,1,12,18,12,15,20,15,7,185,73,13,20,37249999,5449,5449,3349,North_African__Middle_Eastern,108,7,2004/4/9,0,0,9588.0,,2000146258
32,Vladimír Darida,Hertha BSC,1990,93.0,cz CZE,MF,31.0,0.3,1.0,1.0,0.0,1.0,0.0,0.0,0.0,,0.0,1.0,0.0,1.0,0.0,1.0,0.0,0.0,Matches,93.0,cz CZE,MF,31.0,0.3,0.0,0.0,0.0,0.0,0.0,0.0,0.0,0.0,0.0,0.0,0.0,0.0,0.0,0.0,0.0,0.0,Matches,,,,,,,,,,,,,,,,,,,,,,,,,,,,,,,,,,,,,,,,,,,,,,,,,,,,,,,,93.0,cz CZE,MF,31.0,0.3,0.0,0.0,0.0,1.0,1.0,0.0,0.0,0.0,1.0,0.0,0.0,0.0,1.0,0.0,1.0,0.0,Matches,93.0,cz CZE,MF,31.0,0.3,12.0,10.0,2.0,1.0,0.0,0.0,0.0,0.0,1.0,0.0,0.0,0.0,8.0,0.0,0.0,Matches,93.0,cz CZE,MF,31.0,0.3,8.0,12.0,66.7,101.0,6.0,5.0,6.0,83.3,2.0,3.0,66.7,0.0,1.0,0.0,0.0,0.0,0.0,0.0,0.0,0.0,0.0,0.0,0.0,Matches,107,cz CZE,MF,31,3,31.0,10.0,1.0,0.3,0,,0,3,10.0,7,0.67,1.0,1.0,0.0,0.0,0.8,0.1,0.5,-0.4,-1.14,-0.54,Matches,93.0,cz CZE,MF,31.0,0.3,20.0,0.0,5.0,6.0,9.0,0.0,20.0,1.0,1.0,100.0,0.0,0.0,7.0,38.0,19.0,1.0,1.0,0.0,4.0,1.0,8.0,1.0,Matches,93.0,cz CZE,MF,31.0,0.3,0.0,0.0,0.0,,0.0,0.0,,,,0.0,0.0,0.0,0.0,0.0,,0.0,0.0,Matches,93.0,cz CZE,MF,31.0,3.0,0.0,31.0,0.3,0.0,0.0,0.0,0.0,0.0,0.0,0.0,0.0,0.0,0.0,0.0,0.0,1.0,0.0,1.0,0.0,0.0,0.0,0.0,0.0,0.0,0.0,0.0,0.0,0.0,Matches,Vladimír Darida,DM/M/AM C,31,128,140,Czech Republic,Hertha Berlin,12,11,11,11,12,12,6,12,7,8,12,13,10,13,14,12,13,12,14,12,11,15,11,11,13,11,18,20,11,13,13,6,18,11,17,7,17,3,16,11,17,4,3,1,1,1,3,2,1,2,1,3,12,14,4,13,11,17,15,17,1,1,1,1,1,1,17,12,20,12,10,18,10,10,172,67,12,20,2135374,6500,7041,5992,Northern_European,120,4,1990/8/8,76,8,47913.0,,25019899
33,Thomas Delaney,Hoffenheim,1991,95.0,dk DEN,MF,30.0,3.3,6.0,3.0,3.0,2.0,1.0,3.0,8.0,37.5,5.0,5.0,0.0,5.0,1.0,7.0,4.0,0.0,Matches,95.0,dk DEN,MF,30.0,3.3,3.0,0.91,2.0,0.0,0.0,0.0,1.0,0.0,0.0,0.0,0.0,0.0,0.0,0.0,0.0,0.0,Matches,,,,,,,,,,,,,,,,,,,,,,,,,,,,,,,,,,,,,,,,,,,,,,,,,,,,,,,,95.0,dk DEN,MF,30.0,3.3,0.0,0.0,0.0,3.0,6.0,0.0,3.0,1.0,3.0,0.0,0.0,0.0,25.0,11.0,4.0,73.3,Matches,95.0,dk DEN,MF,30.0,3.3,162.0,156.0,6.0,6.0,0.0,2.0,3.0,0.0,0.0,0.0,0.0,0.0,110.0,0.0,6.0,Matches,95.0,dk DEN,MF,30.0,3.3,110.0,162.0,67.9,2072.0,879.0,45.0,57.0,78.9,51.0,63.0,81.0,13.0,32.0,40.6,0.0,0.0,0.1,0.0,1.0,8.0,0.0,0.0,14.0,Matches,109,dk DEN,MF,30,6,298.0,50.0,9.7,3.3,4,69.0,1,2,11.0,4,1.0,2.0,11.0,-9.0,-2.72,-2.72,2.2,6.3,-4.1,-1.23,-1.26,Matches,95.0,dk DEN,MF,30.0,3.3,191.0,10.0,80.0,90.0,22.0,0.0,191.0,6.0,2.0,33.3,3.0,50.0,105.0,321.0,132.0,0.0,0.0,0.0,1.0,2.0,112.0,3.0,Matches,95.0,dk DEN,MF,30.0,3.3,0.0,1.0,0.0,0.0,0.3,0.0,0.0,,20.0,0.0,0.0,0.0,0.1,0.1,0.11,-0.1,-0.1,Matches,95.0,dk DEN,MF,30.0,6.0,4.0,298.0,3.3,0.0,0.0,0.0,0.0,0.0,0.0,0.0,0.0,0.1,0.1,0.0,0.1,0.0,14.0,3.0,0.0,0.0,0.0,0.0,0.0,0.03,0.01,0.04,0.03,0.04,Matches,Thomas Delaney,DM/M C,30,145,146,"Denmark,United States",Sevilla,8,10,9,11,12,13,16,12,8,14,13,9,17,11,15,15,19,14,17,11,14,18,7,13,13,15,17,18,11,10,14,15,16,12,17,14,16,14,15,5,14,2,2,1,1,1,1,3,3,1,2,2,17,15,4,14,16,17,15,12,1,8,10,1,1,1,20,11,20,1,11,1,1,1,182,79,20,8,31490411,6999,7499,6749,Northern_European,144,4,1991/9/3,69,7,76711.0,,27002693
34,Sepp van den Berg,Schalke 04,2001,98.0,nl NED,DF,20.0,7.7,5.0,4.0,2.0,2.0,1.0,1.0,4.0,25.0,3.0,8.0,5.0,3.0,13.0,18.0,33.0,2.0,Matches,98.0,nl NED,DF,20.0,7.7,3.0,0.39,2.0,1.0,0.0,0.0,0.0,0.0,0.0,0.0,0.0,0.0,0.0,0.0,0.0,0.0,Matches,,,,,,,,,,,,,,,,,,,,,,,,,,,,,,,,,,,,,,,,,,,,,,,,,,,,,,,,98.0,nl NED,DF,20.0,7.7,2.0,0.0,0.0,4.0,0.0,0.0,0.0,13.0,4.0,0.0,0.0,0.0,45.0,14.0,15.0,48.3,Matches,98.0,nl NED,DF,20.0,7.7,334.0,319.0,14.0,9.0,0.0,3.0,0.0,5.0,0.0,0.0,0.0,0.0,277.0,1.0,0.0,Matches,98.0,nl NED,DF,20.0,7.7,277.0,334.0,82.9,5687.0,1969.0,76.0,89.0,85.4,163.0,176.0,92.6,35.0,61.0,57.4,0.0,0.1,0.1,-0.1,2.0,16.0,0.0,0.0,12.0,Matches,112,nl NED,DF,20,9,696.0,77.0,22.7,7.7,8,85.0,7,1,14.0,1,1.22,14.0,19.0,-5.0,-0.65,0.53,10.3,15.0,-4.6,-0.6,-0.11,Matches,98.0,nl NED,DF,20.0,7.7,419.0,50.0,250.0,152.0,19.0,12.0,419.0,4.0,1.0,25.0,3.0,75.0,223.0,1062.0,528.0,1.0,0.0,0.0,8.0,1.0,217.0,3.0,Matches,98.0,nl NED,DF,20.0,7.7,1.0,5.0,1.0,20.0,0.65,0.13,0.2,1.0,13.0,0.0,0.0,0.0,0.6,0.6,0.12,0.4,0.4,Matches,98.0,nl NED,DF,20.0,9.0,8.0,696.0,7.7,1.0,0.0,1.0,1.0,0.0,0.0,2.0,0.0,0.6,0.6,0.1,0.7,1.0,12.0,3.0,0.13,0.0,0.13,0.13,0.13,0.08,0.02,0.1,0.08,0.1,Matches,Sepp van den Berg,D/WB RC,20,122,-8,Holland,Liverpool,3,9,8,8,11,8,13,7,7,13,12,6,13,12,13,13,12,12,12,11,12,14,11,8,12,13,14,13,13,12,12,15,14,13,13,12,12,10,11,7,12,2,2,1,2,2,3,1,2,3,2,1,14,15,6,13,12,15,8,10,1,1,20,16,1,16,1,1,1,1,1,1,1,1,192,87,10,20,71914876,6100,5750,4100,Northern_European,121,2,2001/12/20,0,0,13919.0,FC Schalke 04,37074900
35,Abdou Diallo,RB Leipzig,1996,100.0,sn SEN,DFMF,26.0,5.3,6.0,5.0,5.0,1.0,0.0,1.0,3.0,33.3,2.0,8.0,5.0,3.0,8.0,14.0,22.0,0.0,Matches,100.0,sn SEN,DFMF,26.0,5.3,5.0,0.94,5.0,0.0,0.0,0.0,0.0,0.0,0.0,0.0,0.0,0.0,0.0,0.0,0.0,0.0,Matches,,,,,,,,,,,,,,,,,,,,,,,,,,,,,,,,,,,,,,,,,,,,,,,,,,,,,,,,100.0,sn SEN,DFMF,26.0,5.3,2.0,0.0,0.0,3.0,2.0,1.0,1.0,8.0,5.0,0.0,1.0,0.0,40.0,12.0,11.0,52.2,Matches,100.0,sn SEN,DFMF,26.0,5.3,381.0,365.0,15.0,13.0,1.0,3.0,1.0,2.0,0.0,0.0,0.0,0.0,323.0,1.0,2.0,Matches,100.0,sn SEN,DFMF,26.0,5.3,323.0,381.0,84.8,6092.0,2643.0,128.0,139.0,92.1,157.0,174.0,90.2,36.0,60.0,60.0,0.0,0.1,0.3,-0.1,1.0,25.0,4.0,0.0,24.0,Matches,114,sn SEN,DFMF,26,8,478.0,60.0,15.6,5.3,5,87.0,4,3,14.0,12,2.75,11.0,4.0,7.0,1.32,0.76,9.0,5.4,3.6,0.69,-0.07,Matches,100.0,sn SEN,DFMF,26.0,5.3,443.0,57.0,203.0,216.0,27.0,8.0,443.0,5.0,3.0,60.0,1.0,20.0,277.0,1519.0,942.0,11.0,3.0,1.0,3.0,6.0,305.0,3.0,Matches,100.0,sn SEN,DFMF,26.0,5.3,1.0,4.0,1.0,25.0,0.75,0.19,0.25,1.0,8.0,0.0,0.0,0.0,0.4,0.4,0.1,0.6,0.6,Matches,100.0,sn SEN,DFMF,26.0,8.0,5.0,478.0,5.3,1.0,0.0,1.0,1.0,0.0,0.0,2.0,0.0,0.4,0.4,0.1,0.5,11.0,24.0,3.0,0.19,0.0,0.19,0.19,0.19,0.07,0.02,0.09,0.07,0.09,Matches,Abdou Diallo,D LC,26,137,145,"Senegal,France",Paris Saint-Germain,4,9,10,6,11,5,14,7,12,15,13,9,15,12,12,13,16,14,11,12,13,15,9,14,7,12,14,12,13,12,16,15,14,15,14,15,14,10,15,6,13,3,1,1,4,1,3,2,1,1,3,2,13,15,6,8,16,14,12,14,1,17,20,10,12,8,14,1,10,1,1,1,1,1,187,79,20,9,5145562,6844,6844,5351,Mixed_Race,137,10,1996/5/4,17,2,103561.0,RB Leipzig,85120721
36,Justin Diehl,Köln,2004,101.0,de GER,MFFW,17.0,0.2,0.0,0.0,0.0,0.0,0.0,0.0,0.0,,0.0,0.0,0.0,0.0,0.0,0.0,0.0,0.0,Matches,101.0,de GER,MFFW,17.0,0.2,0.0,0.0,0.0,0.0,0.0,0.0,0.0,0.0,0.0,0.0,0.0,0.0,0.0,0.0,0.0,0.0,Matches,,,,,,,,,,,,,,,,,,,,,,,,,,,,,,,,,,,,,,,,,,,,,,,,,,,,,,,,101.0,de GER,MFFW,17.0,0.2,0.0,0.0,0.0,0.0,1.0,1.0,0.0,0.0,0.0,0.0,0.0,0.0,0.0,0.0,0.0,,Matches,101.0,de GER,MFFW,17.0,0.2,2.0,2.0,0.0,0.0,0.0,0.0,0.0,0.0,0.0,0.0,0.0,0.0,2.0,0.0,0.0,Matches,101.0,de GER,MFFW,17.0,0.2,2.0,2.0,100.0,19.0,0.0,2.0,2.0,100.0,0.0,0.0,,0.0,0.0,,0.0,0.0,0.0,0.0,0.0,0.0,0.0,0.0,0.0,Matches,115,de GER,MFFW,17,2,17.0,9.0,0.6,0.2,0,,0,2,9.0,2,1.5,0.0,0.0,0.0,0.0,0.15,1.2,0.0,1.2,6.25,6.13,Matches,101.0,de GER,MFFW,17.0,0.2,3.0,0.0,0.0,0.0,3.0,0.0,3.0,1.0,0.0,0.0,1.0,100.0,3.0,17.0,12.0,0.0,0.0,0.0,0.0,0.0,4.0,1.0,Matches,101.0,de GER,MFFW,17.0,0.2,0.0,0.0,0.0,,0.0,0.0,,,,0.0,0.0,0.0,0.0,0.0,,0.0,0.0,Matches,101.0,de GER,MFFW,17.0,2.0,0.0,17.0,0.2,0.0,0.0,0.0,0.0,0.0,0.0,0.0,0.0,0.0,0.0,0.0,0.0,0.0,0.0,1.0,0.0,0.0,0.0,0.0,0.0,0.0,0.0,0.0,0.0,0.0,Matches,Justin Diehl,AM RLC,17,89,-75,"Germany,Ghana",1. FC Köln,9,13,12,12,12,8,9,7,4,5,8,3,5,12,6,9,6,11,11,12,12,13,12,5,10,5,7,10,13,12,6,11,9,12,8,11,8,11,3,5,8,2,3,3,4,3,1,1,1,1,2,1,7,13,7,13,13,13,13,13,1,1,1,1,1,1,1,13,1,13,18,17,20,12,170,0,13,20,7879999,4366,4366,1937,African_Caribbean,92,15,2004/11/27,0,0,689.0,,2000116586
37,Kasper Dolberg,Hoffenheim,1997,107.0,dk DEN,FWMF,24.0,4.5,7.0,5.0,1.0,4.0,2.0,4.0,6.0,66.7,2.0,6.0,2.0,4.0,0.0,7.0,5.0,0.0,Matches,107.0,dk DEN,FWMF,24.0,4.5,8.0,1.79,6.0,0.0,0.0,0.0,1.0,1.0,1.0,0.22,1.0,0.0,0.0,0.0,0.0,0.0,Matches,,,,,,,,,,,,,,,,,,,,,,,,,,,,,,,,,,,,,,,,,,,,,,,,,,,,,,,,107.0,dk DEN,FWMF,24.0,4.5,0.0,0.0,0.0,5.0,6.0,2.0,1.0,0.0,5.0,0.0,0.0,0.0,6.0,9.0,9.0,50.0,Matches,107.0,dk DEN,FWMF,24.0,4.5,79.0,73.0,4.0,0.0,0.0,0.0,1.0,2.0,0.0,0.0,0.0,0.0,55.0,2.0,1.0,Matches,107.0,dk DEN,FWMF,24.0,4.5,55.0,79.0,69.6,677.0,96.0,33.0,41.0,80.5,14.0,24.0,58.3,1.0,1.0,100.0,0.0,0.4,0.3,-0.4,4.0,3.0,2.0,0.0,4.0,Matches,123,dk DEN,FWMF,24,13,402.0,31.0,13.1,4.5,4,60.0,1,9,18.0,2,0.38,6.0,15.0,-9.0,-2.01,-2.01,5.1,8.8,-3.7,-0.84,-0.86,Matches,107.0,dk DEN,FWMF,24.0,4.5,148.0,10.0,23.0,56.0,71.0,16.0,148.0,8.0,3.0,37.5,4.0,50.0,82.0,444.0,158.0,4.0,7.0,2.0,24.0,6.0,96.0,20.0,Matches,107.0,dk DEN,FWMF,24.0,4.5,1.0,7.0,3.0,42.9,1.57,0.67,0.14,0.33,16.7,0.0,0.0,0.0,0.5,0.5,0.07,0.5,0.5,Matches,107.0,dk DEN,FWMF,24.0,13.0,4.0,402.0,4.5,1.0,0.0,1.0,1.0,0.0,0.0,0.0,0.0,0.5,0.5,0.4,0.9,4.0,4.0,20.0,0.22,0.0,0.22,0.22,0.22,0.11,0.1,0.21,0.11,0.21,Matches,Kasper Dolberg,S L,24,133,150,Denmark,OGC Nice,8,11,13,13,13,13,13,14,6,3,12,14,4,16,10,14,12,15,11,13,12,8,14,4,14,8,8,6,15,15,13,13,12,14,12,12,12,11,10,13,13,1,1,3,2,2,1,1,1,2,3,3,15,14,5,14,14,14,16,16,1,1,1,1,1,1,1,1,1,1,15,12,14,20,187,82,10,20,10076857,6900,6900,5500,Northern_European,132,4,1997/10/6,35,10,57496.0,Sevilla,27102380
38,Niklas Dorsch,Augsburg,1998,108.0,de GER,MF,24.0,5.4,21.0,12.0,8.0,11.0,2.0,9.0,16.0,56.3,7.0,9.0,3.0,6.0,6.0,27.0,9.0,0.0,Matches,108.0,de GER,MF,24.0,5.4,8.0,1.49,6.0,0.0,0.0,0.0,2.0,0.0,0.0,0.0,0.0,0.0,0.0,0.0,0.0,0.0,Matches,,,,,,,,,,,,,,,,,,,,,,,,,,,,,,,,,,,,,,,,,,,,,,,,,,,,,,,,108.0,de GER,MF,24.0,5.4,1.0,0.0,0.0,10.0,6.0,0.0,1.0,6.0,12.0,0.0,0.0,0.0,38.0,5.0,7.0,41.7,Matches,108.0,de GER,MF,24.0,5.4,183.0,172.0,11.0,11.0,1.0,0.0,1.0,0.0,0.0,0.0,0.0,0.0,140.0,0.0,2.0,Matches,108.0,de GER,MF,24.0,5.4,140.0,183.0,76.5,2575.0,691.0,56.0,69.0,81.2,68.0,84.0,81.0,14.0,25.0,56.0,0.0,0.1,0.3,-0.1,1.0,7.0,2.0,0.0,14.0,Matches,124,de GER,MF,24,11,483.0,44.0,15.8,5.4,5,75.0,3,6,18.0,1,1.18,4.0,11.0,-7.0,-1.3,-0.82,4.4,10.9,-6.5,-1.22,-0.61,Matches,108.0,de GER,MF,24.0,5.4,237.0,24.0,95.0,121.0,27.0,0.0,237.0,8.0,5.0,62.5,3.0,37.5,99.0,526.0,223.0,2.0,1.0,0.0,1.0,5.0,100.0,0.0,Matches,108.0,de GER,MF,24.0,5.4,0.0,0.0,0.0,,0.0,0.0,,,,0.0,0.0,0.0,0.0,0.0,,0.0,0.0,Matches,108.0,de GER,MF,24.0,11.0,5.0,483.0,5.4,0.0,0.0,0.0,0.0,0.0,0.0,1.0,0.0,0.0,0.0,0.1,0.1,2.0,14.0,0.0,0.0,0.0,0.0,0.0,0.0,0.0,0.03,0.03,0.0,0.03,Matches,Niklas Dorsch,DM/M C,24,130,142,Germany,FC Augsburg,9,10,12,9,13,7,8,9,6,11,16,9,12,14,12,14,13,15,12,14,14,15,11,12,11,12,17,14,11,15,13,9,13,11,15,9,14,10,15,7,10,1,1,1,1,1,2,1,3,2,3,1,7,11,9,12,14,10,13,8,1,1,1,1,1,1,20,12,20,12,10,12,10,1,178,76,10,20,5548404,6450,6450,4500,Northern_European,126,4,1998/1/15,0,0,18500.0,,91144312
39,Ondrej Duda,Köln,1994,112.0,sk SVK,MF,27.0,7.7,9.0,8.0,2.0,5.0,2.0,4.0,11.0,36.4,7.0,7.0,1.0,6.0,2.0,11.0,3.0,0.0,Matches,112.0,sk SVK,MF,27.0,7.7,22.0,2.88,17.0,2.0,2.0,0.0,1.0,0.0,3.0,0.39,2.0,0.0,1.0,0.0,0.0,0.0,Matches,,,,,,,,,,,,,,,,,,,,,,,,,,,,,,,,,,,,,,,,,,,,,,,,,,,,,,,,112.0,sk SVK,MF,27.0,7.7,4.0,0.0,0.0,16.0,18.0,1.0,12.0,2.0,8.0,0.0,0.0,0.0,43.0,5.0,11.0,31.3,Matches,112.0,sk SVK,MF,27.0,7.7,279.0,259.0,19.0,6.0,0.0,7.0,12.0,2.0,1.0,1.0,0.0,0.0,208.0,1.0,10.0,Matches,112.0,sk SVK,MF,27.0,7.7,208.0,279.0,74.6,3598.0,866.0,97.0,115.0,84.3,82.0,101.0,81.2,20.0,37.0,54.1,0.0,0.7,0.8,-0.7,8.0,28.0,5.0,1.0,40.0,Matches,129,sk SVK,MF,27,13,689.0,53.0,22.5,7.7,9,62.0,0,4,33.0,2,1.08,11.0,15.0,-4.0,-0.52,-0.48,11.3,11.5,-0.2,-0.02,-0.23,Matches,112.0,sk SVK,MF,27.0,7.7,360.0,5.0,37.0,205.0,120.0,14.0,360.0,21.0,9.0,42.9,11.0,52.4,220.0,1157.0,450.0,12.0,9.0,3.0,16.0,13.0,241.0,33.0,Matches,112.0,sk SVK,MF,27.0,7.7,0.0,12.0,3.0,25.0,1.57,0.39,0.0,0.0,18.6,0.0,0.0,0.0,0.7,0.7,0.06,-0.7,-0.7,Matches,112.0,sk SVK,MF,27.0,13.0,9.0,689.0,7.7,0.0,0.0,0.0,0.0,0.0,0.0,4.0,0.0,0.7,0.7,0.7,1.4,12.0,40.0,33.0,0.0,0.0,0.0,0.0,0.0,0.1,0.09,0.18,0.1,0.18,Matches,Ondrej Duda,AM C,27,131,138,Slovakia,1. FC Köln,13,12,13,12,17,12,8,12,4,8,12,15,8,16,12,11,9,12,10,16,10,9,15,6,14,9,11,11,13,13,12,8,10,12,15,11,9,9,12,10,8,1,2,2,3,1,1,4,2,4,3,2,13,14,10,7,10,11,9,14,1,1,1,1,1,1,1,7,15,7,9,20,9,12,181,74,12,20,3270160,6250,6750,5150,Northern_European,128,3,1994/12/5,59,10,19164.0,,63023511
40,Julien Duranville,Dortmund,2006,113.0,be BEL,MF,16.0,0.3,1.0,1.0,0.0,1.0,0.0,1.0,1.0,100.0,0.0,0.0,0.0,0.0,0.0,1.0,0.0,0.0,Matches,113.0,be BEL,MF,16.0,0.3,5.0,15.52,3.0,0.0,2.0,0.0,0.0,0.0,1.0,3.1,1.0,0.0,0.0,0.0,0.0,0.0,Matches,,,,,,,,,,,,,,,,,,,,,,,,,,,,,,,,,,,,,,,,,,,,,,,,,,,,,,,,113.0,be BEL,MF,16.0,0.3,0.0,0.0,0.0,1.0,1.0,0.0,7.0,0.0,1.0,0.0,0.0,0.0,1.0,0.0,0.0,,Matches,113.0,be BEL,MF,16.0,0.3,17.0,16.0,1.0,0.0,0.0,0.0,7.0,1.0,0.0,0.0,0.0,0.0,11.0,0.0,1.0,Matches,113.0,be BEL,MF,16.0,0.3,11.0,17.0,64.7,164.0,100.0,5.0,5.0,100.0,4.0,8.0,50.0,1.0,1.0,100.0,0.0,0.3,0.5,-0.3,2.0,0.0,3.0,3.0,1.0,Matches,130,be BEL,MF,16,1,29.0,29.0,0.9,0.3,0,,0,1,29.0,1,1.0,2.0,0.0,2.0,6.21,5.11,1.2,1.2,0.0,0.01,-0.82,Matches,113.0,be BEL,MF,16.0,0.3,20.0,0.0,2.0,3.0,15.0,0.0,20.0,3.0,3.0,100.0,0.0,0.0,16.0,231.0,76.0,4.0,0.0,0.0,1.0,0.0,17.0,4.0,Matches,113.0,be BEL,MF,16.0,0.3,0.0,1.0,0.0,0.0,3.1,0.0,0.0,,25.4,0.0,0.0,0.0,0.0,0.0,0.02,0.0,0.0,Matches,113.0,be BEL,MF,16.0,1.0,0.0,29.0,0.3,0.0,0.0,0.0,0.0,0.0,0.0,0.0,0.0,0.0,0.0,0.3,0.3,4.0,1.0,4.0,0.0,0.0,0.0,0.0,0.0,0.06,0.83,0.89,0.06,0.89,Matches,Julien Duranville,AM RL,16,101,-9,"Belgium,Ivory Coast,Democratic Republic of Congo",RSC Anderlecht,8,10,14,12,9,10,5,9,2,4,12,4,6,14,14,9,13,8,9,9,9,15,14,5,10,9,12,10,17,15,6,6,12,15,8,8,8,6,6,11,12,1,2,3,2,3,3,2,1,1,1,2,12,11,8,9,12,13,12,15,1,1,1,1,1,1,1,14,1,12,20,1,18,12,170,0,8,20,24620000,4750,5000,4000,African_Caribbean,97,16,2006/5/5,0,0,2000.0,,2000155483
41,Lilian Egloff,Stuttgart,2002,115.0,de GER,MFFW,19.0,2.7,12.0,10.0,4.0,5.0,3.0,4.0,6.0,66.7,2.0,2.0,0.0,2.0,1.0,13.0,1.0,0.0,Matches,115.0,de GER,MFFW,19.0,2.7,10.0,3.75,8.0,0.0,0.0,1.0,1.0,0.0,2.0,0.75,2.0,0.0,0.0,0.0,0.0,0.0,Matches,,,,,,,,,,,,,,,,,,,,,,,,,,,,,,,,,,,,,,,,,,,,,,,,,,,,,,,,115.0,de GER,MFFW,19.0,2.7,1.0,0.0,0.0,3.0,5.0,0.0,2.0,1.0,10.0,0.0,0.0,0.0,13.0,3.0,4.0,42.9,Matches,115.0,de GER,MFFW,19.0,2.7,73.0,66.0,4.0,0.0,2.0,0.0,2.0,1.0,0.0,0.0,0.0,0.0,42.0,3.0,2.0,Matches,115.0,de GER,MFFW,19.0,2.7,42.0,73.0,57.5,574.0,201.0,29.0,39.0,74.4,11.0,16.0,68.8,1.0,5.0,20.0,0.0,0.4,0.8,-0.4,4.0,3.0,3.0,0.0,7.0,Matches,132,de GER,MFFW,19,10,241.0,24.0,7.9,2.7,2,63.0,0,8,15.0,16,0.9,6.0,6.0,0.0,0.0,0.38,5.7,3.9,1.9,0.7,0.68,Matches,115.0,de GER,MFFW,19.0,2.7,113.0,1.0,15.0,40.0,58.0,14.0,113.0,5.0,3.0,60.0,1.0,20.0,62.0,325.0,131.0,8.0,3.0,3.0,10.0,5.0,68.0,22.0,Matches,115.0,de GER,MFFW,19.0,2.7,0.0,8.0,0.0,0.0,2.99,0.0,0.0,,20.6,0.0,0.0,0.0,0.4,0.4,0.04,-0.4,-0.4,Matches,115.0,de GER,MFFW,19.0,10.0,2.0,241.0,2.7,0.0,0.0,0.0,0.0,0.0,0.0,1.0,0.0,0.4,0.4,0.4,0.7,8.0,7.0,22.0,0.0,0.0,0.0,0.0,0.0,0.13,0.15,0.28,0.13,0.28,Matches,Lilian Egloff,M/AM RLC,19,112,-75,Germany,VfB Stuttgart,12,11,13,12,12,12,11,12,6,7,13,10,9,12,14,11,13,11,11,12,12,12,13,10,10,8,14,13,13,13,12,11,12,12,12,8,12,7,12,12,14,3,4,1,1,3,2,3,1,2,3,3,19,11,3,13,12,11,10,11,1,1,1,1,1,1,5,10,18,10,16,20,16,12,182,81,10,20,49600000,5600,5600,3510,Northern_European,111,3,2002/8/20,0,0,4757.0,,91190766
42,Kingsley Ehizibue,Köln,1995,116.0,nl NED,DF,27.0,0.7,0.0,0.0,0.0,0.0,0.0,0.0,0.0,,0.0,1.0,0.0,1.0,2.0,2.0,1.0,0.0,Matches,116.0,nl NED,DF,27.0,0.7,1.0,1.48,1.0,0.0,0.0,0.0,0.0,0.0,0.0,0.0,0.0,0.0,0.0,0.0,0.0,0.0,Matches,,,,,,,,,,,,,,,,,,,,,,,,,,,,,,,,,,,,,,,,,,,,,,,,,,,,,,,,116.0,nl NED,DF,27.0,0.7,0.0,0.0,0.0,2.0,2.0,0.0,0.0,2.0,0.0,0.0,0.0,0.0,5.0,1.0,0.0,100.0,Matches,116.0,nl NED,DF,27.0,0.7,24.0,18.0,6.0,1.0,0.0,0.0,0.0,5.0,0.0,0.0,0.0,0.0,15.0,0.0,1.0,Matches,116.0,nl NED,DF,27.0,0.7,15.0,24.0,62.5,275.0,142.0,8.0,10.0,80.0,3.0,6.0,50.0,4.0,6.0,66.7,0.0,0.0,0.0,0.0,0.0,1.0,1.0,0.0,2.0,Matches,133,nl NED,DF,27,1,61.0,61.0,2.0,0.7,1,61.0,0,0,,1,1.0,1.0,2.0,-1.0,-1.48,-1.36,1.1,0.8,0.3,0.44,0.29,Matches,116.0,nl NED,DF,27.0,0.7,33.0,1.0,12.0,14.0,7.0,0.0,33.0,1.0,0.0,0.0,1.0,100.0,15.0,66.0,31.0,1.0,2.0,0.0,2.0,0.0,18.0,3.0,Matches,116.0,nl NED,DF,27.0,0.7,0.0,1.0,1.0,100.0,1.48,1.48,0.0,0.0,35.5,0.0,0.0,0.0,0.0,0.0,0.02,0.0,0.0,Matches,116.0,nl NED,DF,27.0,1.0,1.0,61.0,0.7,0.0,0.0,0.0,0.0,0.0,0.0,0.0,0.0,0.0,0.0,0.0,0.0,1.0,2.0,3.0,0.0,0.0,0.0,0.0,0.0,0.03,0.0,0.03,0.03,0.03,Matches,Kingsley Ehizibue,D/WB R,27,125,130,"Nigeria,Holland,Germany",Udinese Calcio,8,12,12,8,10,7,10,7,14,12,11,8,13,11,12,8,14,9,8,9,9,12,10,9,12,11,10,16,16,13,13,15,16,18,15,12,9,11,12,3,9,1,2,1,2,3,3,2,1,1,2,3,9,13,8,14,8,16,15,13,1,1,1,20,1,20,1,1,1,15,1,1,10,1,189,83,7,20,2072819,6250,6000,4250,African_Caribbean,115,16,1995/5/25,0,0,17799.0,,37053569
43,Chidera Ejuke,Hertha BSC,1998,118.0,ng NGA,FWMF,24.0,9.9,5.0,4.0,1.0,4.0,0.0,1.0,5.0,20.0,4.0,4.0,0.0,4.0,4.0,9.0,1.0,0.0,Matches,118.0,ng NGA,FWMF,24.0,9.9,41.0,4.16,28.0,0.0,9.0,1.0,2.0,1.0,5.0,0.51,5.0,0.0,0.0,0.0,0.0,0.0,Matches,,,,,,,,,,,,,,,,,,,,,,,,,,,,,,,,,,,,,,,,,,,,,,,,,,,,,,,,118.0,ng NGA,FWMF,24.0,9.9,0.0,0.0,0.0,2.0,10.0,1.0,16.0,4.0,4.0,0.0,0.0,0.0,66.0,5.0,3.0,62.5,Matches,118.0,ng NGA,FWMF,24.0,9.9,292.0,282.0,8.0,1.0,3.0,2.0,16.0,4.0,3.0,1.0,1.0,0.0,227.0,2.0,6.0,Matches,118.0,ng NGA,FWMF,24.0,9.9,227.0,292.0,77.7,3432.0,773.0,127.0,152.0,83.6,66.0,82.0,80.5,23.0,31.0,74.2,3.0,1.3,0.9,1.7,10.0,28.0,10.0,1.0,39.0,Matches,135,ng NGA,FWMF,24,20,890.0,45.0,29.1,9.9,9,69.0,1,11,24.0,0,0.9,9.0,12.0,-3.0,-0.3,0.69,10.1,14.2,-4.1,-0.41,0.27,Matches,118.0,ng NGA,FWMF,24.0,9.9,434.0,2.0,34.0,226.0,196.0,32.0,434.0,97.0,47.0,48.5,40.0,41.2,303.0,2533.0,1113.0,38.0,21.0,18.0,32.0,20.0,308.0,67.0,Matches,118.0,ng NGA,FWMF,24.0,9.9,0.0,24.0,5.0,20.8,2.43,0.51,0.0,0.0,21.1,0.0,0.0,0.0,1.5,1.5,0.06,-1.5,-1.5,Matches,118.0,ng NGA,FWMF,24.0,20.0,9.0,890.0,9.9,0.0,3.0,3.0,0.0,0.0,0.0,0.0,0.0,1.5,1.5,1.3,2.7,38.0,39.0,67.0,0.0,0.3,0.3,0.0,0.3,0.15,0.13,0.28,0.15,0.28,Matches,Chidera Ejuke,AM RL,24,130,141,Nigeria,CSKA Moscow,7,9,16,11,12,7,5,11,3,5,12,10,8,14,8,10,8,11,10,11,11,13,18,5,13,9,10,10,16,17,14,8,13,15,14,9,11,6,12,7,9,1,3,3,3,4,1,3,4,1,2,1,12,12,2,9,10,9,12,18,1,1,1,1,1,1,1,12,1,1,20,13,16,12,176,72,11,20,8548171,6247,6247,5247,African_Caribbean,124,13,1998/1/2,8,0,28766.0,Hertha Berlin,13182752
44,Kilian Fischer,Wolfsburg,2000,127.0,de GER,DFFW,21.0,5.6,9.0,6.0,3.0,4.0,2.0,6.0,11.0,54.5,5.0,6.0,0.0,6.0,5.0,14.0,18.0,0.0,Matches,127.0,de GER,DFFW,21.0,5.6,7.0,1.26,5.0,0.0,1.0,0.0,1.0,0.0,1.0,0.18,0.0,0.0,0.0,0.0,1.0,0.0,Matches,,,,,,,,,,,,,,,,,,,,,,,,,,,,,,,,,,,,,,,,,,,,,,,,,,,,,,,,127.0,de GER,DFFW,21.0,5.6,2.0,0.0,0.0,8.0,5.0,0.0,12.0,5.0,6.0,1.0,1.0,0.0,24.0,2.0,6.0,25.0,Matches,127.0,de GER,DFFW,21.0,5.6,273.0,210.0,63.0,4.0,0.0,0.0,12.0,59.0,0.0,0.0,0.0,0.0,223.0,0.0,9.0,Matches,127.0,de GER,DFFW,21.0,5.6,223.0,273.0,81.7,3747.0,1495.0,109.0,120.0,90.8,91.0,109.0,83.5,19.0,31.0,61.3,0.0,0.4,0.3,-0.4,5.0,19.0,4.0,4.0,23.0,Matches,145,de GER,DFFW,21,10,502.0,50.0,16.4,5.6,5,86.0,2,5,14.0,15,2.2,6.0,8.0,-2.0,-0.36,-0.75,5.8,8.3,-2.5,-0.45,-0.54,Matches,127.0,de GER,DFFW,21.0,5.6,327.0,16.0,113.0,137.0,78.0,7.0,327.0,6.0,3.0,50.0,3.0,50.0,160.0,726.0,355.0,6.0,5.0,2.0,4.0,1.0,177.0,21.0,Matches,127.0,de GER,DFFW,21.0,5.6,0.0,3.0,1.0,33.3,0.54,0.18,0.0,0.0,19.8,0.0,0.0,0.0,0.3,0.3,0.12,-0.3,-0.3,Matches,127.0,de GER,DFFW,21.0,10.0,5.0,502.0,5.6,0.0,0.0,0.0,0.0,0.0,0.0,2.0,0.0,0.3,0.3,0.4,0.7,6.0,23.0,21.0,0.0,0.0,0.0,0.0,0.0,0.06,0.07,0.13,0.06,0.13,Matches,Kilian Fischer,D RL,21,122,142,Germany,VfL Wolfsburg,4,13,11,7,11,4,7,7,13,11,12,7,13,12,14,12,13,12,11,12,11,16,12,6,12,11,15,16,14,12,12,9,14,15,15,11,14,11,13,7,18,1,1,1,3,2,3,3,2,1,2,2,15,17,3,8,16,19,14,16,1,15,10,20,15,15,12,10,13,10,1,1,1,1,182,77,12,20,4674999,6100,6100,4100,Northern_European,117,1,2000/10/12,0,0,18219.0,,91207901
45,Florian Flick,Schalke 04,2000,129.0,de GER,MF,22.0,5.7,12.0,3.0,7.0,5.0,0.0,4.0,14.0,28.6,10.0,9.0,3.0,6.0,4.0,16.0,18.0,0.0,Matches,129.0,de GER,MF,22.0,5.7,7.0,1.23,6.0,0.0,0.0,1.0,0.0,0.0,0.0,0.0,0.0,0.0,0.0,0.0,0.0,0.0,Matches,,,,,,,,,,,,,,,,,,,,,,,,,,,,,,,,,,,,,,,,,,,,,,,,,,,,,,,,129.0,de GER,MF,22.0,5.7,1.0,0.0,0.0,6.0,4.0,0.0,1.0,4.0,3.0,0.0,0.0,0.0,32.0,14.0,7.0,66.7,Matches,129.0,de GER,MF,22.0,5.7,185.0,180.0,3.0,3.0,0.0,1.0,1.0,0.0,0.0,0.0,0.0,0.0,129.0,2.0,3.0,Matches,129.0,de GER,MF,22.0,5.7,129.0,185.0,69.7,2170.0,656.0,64.0,82.0,78.0,50.0,63.0,79.4,11.0,25.0,44.0,0.0,0.0,0.1,0.0,1.0,13.0,0.0,0.0,12.0,Matches,147,de GER,MF,22,8,512.0,64.0,16.7,5.7,5,85.0,4,3,30.0,7,0.63,6.0,12.0,-6.0,-1.05,0.0,6.7,7.8,-1.1,-0.19,0.39,Matches,129.0,de GER,MF,22.0,5.7,244.0,28.0,86.0,135.0,26.0,1.0,244.0,2.0,1.0,50.0,1.0,50.0,94.0,445.0,186.0,2.0,4.0,0.0,3.0,2.0,99.0,2.0,Matches,129.0,de GER,MF,22.0,5.7,0.0,2.0,1.0,50.0,0.35,0.18,0.0,0.0,24.9,0.0,0.0,0.0,0.1,0.1,0.04,-0.1,-0.1,Matches,129.0,de GER,MF,22.0,8.0,5.0,512.0,5.7,0.0,0.0,0.0,0.0,0.0,0.0,1.0,0.0,0.1,0.1,0.0,0.1,2.0,12.0,2.0,0.0,0.0,0.0,0.0,0.0,0.01,0.01,0.02,0.01,0.02,Matches,Florian Flick,D/DM/M C,22,122,138,Germany,FC Schalke 04,3,7,10,8,12,3,12,8,4,12,13,6,14,12,14,13,16,12,14,12,13,17,8,8,10,13,16,17,11,10,14,14,16,12,17,13,13,13,13,4,13,1,2,3,3,4,3,3,1,1,1,2,8,12,6,16,14,14,12,12,1,1,16,10,1,1,20,1,18,1,1,8,1,1,190,79,9,20,1774999,6100,6100,4107,Northern_European,120,2,2000/5/1,0,0,12466.0,,2000025214
46,Timothy Fosu-Mensah,Leverkusen,1998,132.0,nl NED,DF,24.0,2.1,7.0,5.0,3.0,3.0,1.0,4.0,4.0,100.0,0.0,2.0,0.0,2.0,0.0,7.0,1.0,0.0,Matches,132.0,nl NED,DF,24.0,2.1,5.0,2.36,5.0,0.0,0.0,0.0,0.0,0.0,0.0,0.0,0.0,0.0,0.0,0.0,0.0,0.0,Matches,,,,,,,,,,,,,,,,,,,,,,,,,,,,,,,,,,,,,,,,,,,,,,,,,,,,,,,,132.0,nl NED,DF,24.0,2.1,1.0,0.0,0.0,3.0,1.0,1.0,4.0,0.0,5.0,0.0,1.0,0.0,12.0,2.0,2.0,50.0,Matches,132.0,nl NED,DF,24.0,2.1,119.0,96.0,22.0,2.0,0.0,1.0,4.0,20.0,0.0,0.0,0.0,0.0,93.0,1.0,3.0,Matches,132.0,nl NED,DF,24.0,2.1,93.0,119.0,78.2,1267.0,310.0,62.0,69.0,89.9,27.0,34.0,79.4,2.0,9.0,22.2,0.0,0.3,0.2,-0.3,4.0,2.0,2.0,1.0,7.0,Matches,150,nl NED,DF,24,11,191.0,17.0,6.2,2.1,1,53.0,0,10,14.0,19,2.27,5.0,2.0,3.0,1.41,1.26,3.3,1.9,1.4,0.64,0.42,Matches,132.0,nl NED,DF,24.0,2.1,138.0,3.0,34.0,65.0,39.0,3.0,138.0,1.0,0.0,0.0,1.0,100.0,42.0,174.0,109.0,3.0,2.0,0.0,3.0,1.0,87.0,8.0,Matches,132.0,nl NED,DF,24.0,2.1,0.0,3.0,2.0,66.7,1.41,0.94,0.0,0.0,24.5,0.0,0.0,0.0,0.1,0.1,0.04,-0.1,-0.1,Matches,132.0,nl NED,DF,24.0,11.0,1.0,191.0,2.1,0.0,0.0,0.0,0.0,0.0,0.0,1.0,0.0,0.1,0.1,0.3,0.4,3.0,7.0,8.0,0.0,0.0,0.0,0.0,0.0,0.05,0.13,0.18,0.05,0.18,Matches,Timothy Fosu-Mensah,D RC,24,126,138,"Holland,Ghana",Bayer 04 Leverkusen,8,7,9,6,12,7,11,8,8,12,11,8,13,11,13,12,12,10,11,10,11,16,7,6,11,12,12,12,15,12,12,15,14,16,15,15,10,6,7,15,8,2,4,2,3,2,2,2,3,3,3,3,14,16,3,12,10,11,16,18,1,14,16,20,1,1,15,1,15,1,1,5,1,1,185,86,10,20,2541380,6300,6400,5350,African_Caribbean,119,16,1998/1/2,3,0,25889.0,,37051102
47,Raphael Framberger,Augsburg,1995,133.0,de GER,DFFW,26.0,2.0,10.0,6.0,6.0,4.0,0.0,3.0,5.0,60.0,2.0,2.0,1.0,1.0,2.0,12.0,5.0,0.0,Matches,133.0,de GER,DFFW,26.0,2.0,1.0,0.51,1.0,0.0,0.0,0.0,0.0,0.0,0.0,0.0,0.0,0.0,0.0,0.0,0.0,0.0,Matches,,,,,,,,,,,,,,,,,,,,,,,,,,,,,,,,,,,,,,,,,,,,,,,,,,,,,,,,133.0,de GER,DFFW,26.0,2.0,0.0,0.0,0.0,4.0,0.0,0.0,4.0,2.0,6.0,0.0,0.0,0.0,8.0,5.0,2.0,71.4,Matches,133.0,de GER,DFFW,26.0,2.0,64.0,44.0,20.0,0.0,0.0,0.0,4.0,20.0,0.0,0.0,0.0,0.0,33.0,0.0,3.0,Matches,133.0,de GER,DFFW,26.0,2.0,33.0,64.0,51.6,404.0,291.0,22.0,27.0,81.5,9.0,19.0,47.4,0.0,10.0,0.0,0.0,0.0,0.1,0.0,1.0,2.0,1.0,0.0,3.0,Matches,151,de GER,DFFW,26,3,176.0,59.0,5.8,2.0,2,80.0,0,1,17.0,8,0.33,2.0,6.0,-4.0,-2.05,-1.51,1.0,3.9,-2.9,-1.46,-0.8,Matches,133.0,de GER,DFFW,26.0,2.0,88.0,8.0,32.0,37.0,21.0,0.0,88.0,1.0,0.0,0.0,1.0,100.0,26.0,114.0,54.0,0.0,0.0,0.0,3.0,3.0,32.0,3.0,Matches,133.0,de GER,DFFW,26.0,2.0,0.0,0.0,0.0,,0.0,0.0,,,,0.0,0.0,0.0,0.0,0.0,,0.0,0.0,Matches,133.0,de GER,DFFW,26.0,3.0,2.0,176.0,2.0,0.0,0.0,0.0,0.0,0.0,0.0,0.0,0.0,0.0,0.0,0.0,0.0,0.0,3.0,3.0,0.0,0.0,0.0,0.0,0.0,0.0,0.02,0.02,0.0,0.02,Matches,Raphael Framberger,D/WB R,26,125,130,Germany,FC Augsburg,10,12,11,7,10,6,7,10,15,13,11,6,14,10,14,13,11,11,13,9,11,13,9,11,11,13,13,16,14,11,13,8,13,16,15,11,12,9,14,15,10,3,2,2,2,2,3,3,1,2,3,2,7,10,4,14,10,16,14,17,1,1,1,20,1,20,10,1,10,12,1,1,12,1,179,76,10,20,2519143,6293,6293,4743,Northern_European,119,3,1995/9/6,0,0,9615.0,,91122823
48,Bartol Franjić,Wolfsburg,2000,134.0,hr CRO,MF,22.0,2.5,4.0,2.0,2.0,2.0,0.0,0.0,2.0,0.0,2.0,4.0,1.0,3.0,5.0,9.0,4.0,0.0,Matches,134.0,hr CRO,MF,22.0,2.5,3.0,1.19,2.0,0.0,1.0,0.0,0.0,0.0,2.0,0.79,1.0,0.0,1.0,0.0,0.0,0.0,Matches,,,,,,,,,,,,,,,,,,,,,,,,,,,,,,,,,,,,,,,,,,,,,,,,,,,,,,,,134.0,hr CRO,MF,22.0,2.5,0.0,0.0,0.0,1.0,1.0,0.0,1.0,5.0,2.0,0.0,0.0,0.0,12.0,5.0,3.0,62.5,Matches,134.0,hr CRO,MF,22.0,2.5,79.0,79.0,0.0,0.0,0.0,0.0,1.0,0.0,0.0,0.0,0.0,0.0,61.0,0.0,1.0,Matches,134.0,hr CRO,MF,22.0,2.5,61.0,79.0,77.2,929.0,258.0,33.0,36.0,91.7,21.0,27.0,77.8,4.0,7.0,57.1,1.0,0.1,0.1,0.9,2.0,6.0,1.0,0.0,4.0,Matches,152,hr CRO,MF,22,5,227.0,45.0,7.4,2.5,3,71.0,0,2,7.0,10,1.8,3.0,5.0,-2.0,-0.79,-1.14,2.4,4.0,-1.6,-0.63,-0.68,Matches,134.0,hr CRO,MF,22.0,2.5,114.0,8.0,35.0,64.0,17.0,3.0,114.0,2.0,1.0,50.0,1.0,50.0,51.0,222.0,88.0,3.0,2.0,0.0,6.0,0.0,62.0,1.0,Matches,134.0,hr CRO,MF,22.0,2.5,0.0,2.0,2.0,100.0,0.79,0.79,0.0,0.0,11.6,0.0,0.0,0.0,0.3,0.3,0.13,-0.3,-0.3,Matches,134.0,hr CRO,MF,22.0,5.0,3.0,227.0,2.5,0.0,1.0,1.0,0.0,0.0,0.0,0.0,0.0,0.3,0.3,0.1,0.4,3.0,4.0,1.0,0.0,0.4,0.4,0.0,0.4,0.1,0.04,0.14,0.1,0.14,Matches,Bartol Franjić,D/DM/M LC,22,126,146,Croatia,VfL Wolfsburg,4,10,12,8,12,6,12,9,10,12,13,12,13,12,13,12,16,12,12,12,12,16,10,14,11,12,18,16,12,10,12,12,15,13,15,13,13,9,11,5,18,4,1,2,1,2,3,3,3,2,4,1,14,13,4,18,12,17,14,13,1,15,18,1,12,1,20,10,18,1,1,1,1,1,186,77,20,12,7332001,6300,5900,5300,Northern_European,123,2,2000/1/14,0,0,16958.0,,24058104
49,Oscar Fraulo,Gladbach,2003,135.0,dk DEN,FWMF,18.0,0.1,0.0,0.0,0.0,0.0,0.0,0.0,0.0,,0.0,0.0,0.0,0.0,0.0,0.0,0.0,0.0,Matches,135.0,dk DEN,FWMF,18.0,0.1,0.0,0.0,0.0,0.0,0.0,0.0,0.0,0.0,0.0,0.0,0.0,0.0,0.0,0.0,0.0,0.0,Matches,,,,,,,,,,,,,,,,,,,,,,,,,,,,,,,,,,,,,,,,,,,,,,,,,,,,,,,,135.0,dk DEN,FWMF,18.0,0.1,0.0,0.0,0.0,0.0,0.0,0.0,0.0,0.0,0.0,0.0,0.0,0.0,3.0,0.0,0.0,,Matches,135.0,dk DEN,FWMF,18.0,0.1,16.0,16.0,0.0,0.0,0.0,0.0,0.0,0.0,0.0,0.0,0.0,0.0,10.0,0.0,0.0,Matches,135.0,dk DEN,FWMF,18.0,0.1,10.0,16.0,62.5,153.0,25.0,6.0,6.0,100.0,4.0,6.0,66.7,0.0,4.0,0.0,0.0,0.0,0.0,0.0,0.0,0.0,0.0,0.0,0.0,Matches,153,dk DEN,FWMF,18,2,8.0,4.0,0.3,0.1,0,,0,2,4.0,13,0.0,0.0,0.0,0.0,0.0,0.09,0.1,0.2,-0.1,-0.89,-0.85,Matches,135.0,dk DEN,FWMF,18.0,0.1,16.0,1.0,3.0,9.0,4.0,0.0,16.0,1.0,1.0,100.0,0.0,0.0,7.0,75.0,19.0,0.0,1.0,0.0,0.0,0.0,10.0,0.0,Matches,135.0,dk DEN,FWMF,18.0,0.1,0.0,0.0,0.0,,0.0,0.0,,,,0.0,0.0,0.0,0.0,0.0,,0.0,0.0,Matches,135.0,dk DEN,FWMF,18.0,2.0,0.0,8.0,0.1,0.0,0.0,0.0,0.0,0.0,0.0,0.0,0.0,0.0,0.0,0.0,0.0,0.0,0.0,0.0,0.0,0.0,0.0,0.0,0.0,0.0,0.0,0.0,0.0,0.0,Matches,Oscar Fraulo,DM/M C,18,103,-8,"Denmark,Italy",Borussia Mönchengladbach,11,10,11,10,13,11,7,12,3,10,13,8,11,13,14,9,11,12,9,13,9,13,13,10,11,11,12,12,12,12,11,9,14,12,12,8,13,8,13,4,12,4,3,2,1,1,2,2,3,1,3,1,9,12,3,10,10,12,9,8,1,1,1,1,8,8,16,10,20,10,10,15,10,1,180,77,11,20,29840000,5149,4378,3768,Northern_European,103,2,2003/12/6,0,0,15341.0,,27159740
50,Angelo Fulgini,Mainz 05,1996,141.0,fr FRA,MF,25.0,5.8,6.0,5.0,2.0,3.0,1.0,5.0,12.0,41.7,7.0,5.0,0.0,5.0,5.0,11.0,7.0,0.0,Matches,141.0,fr FRA,MF,25.0,5.8,18.0,3.09,17.0,0.0,0.0,0.0,1.0,0.0,1.0,0.17,1.0,0.0,0.0,0.0,0.0,0.0,Matches,,,,,,,,,,,,,,,,,,,,,,,,,,,,,,,,,,,,,,,,,,,,,,,,,,,,,,,,141.0,fr FRA,MF,25.0,5.8,1.0,0.0,0.0,7.0,15.0,1.0,7.0,5.0,5.0,0.0,0.0,0.0,30.0,4.0,12.0,25.0,Matches,141.0,fr FRA,MF,25.0,5.8,238.0,230.0,7.0,0.0,1.0,1.0,7.0,5.0,1.0,0.0,0.0,0.0,188.0,1.0,3.0,Matches,141.0,fr FRA,MF,25.0,5.8,188.0,238.0,79.0,2496.0,683.0,123.0,139.0,88.5,48.0,69.0,69.6,6.0,15.0,40.0,1.0,0.8,0.4,0.2,8.0,13.0,10.0,1.0,29.0,Matches,159,fr FRA,MF,25,16,525.0,33.0,17.2,5.8,5,56.0,0,11,22.0,2,1.19,5.0,11.0,-6.0,-1.03,-1.21,6.4,10.2,-3.7,-0.64,-0.54,Matches,141.0,fr FRA,MF,25.0,5.8,320.0,6.0,36.0,177.0,110.0,14.0,320.0,25.0,8.0,32.0,14.0,56.0,199.0,800.0,326.0,3.0,6.0,2.0,12.0,7.0,228.0,43.0,Matches,141.0,fr FRA,MF,25.0,5.8,0.0,8.0,4.0,50.0,1.37,0.69,0.0,0.0,18.6,0.0,0.0,0.0,0.6,0.6,0.07,-0.6,-0.6,Matches,141.0,fr FRA,MF,25.0,16.0,5.0,525.0,5.8,0.0,1.0,1.0,0.0,0.0,0.0,1.0,0.0,0.6,0.6,0.8,1.4,3.0,29.0,43.0,0.0,0.17,0.17,0.0,0.17,0.1,0.13,0.23,0.1,0.23,Matches,Angelo Fulgini,M/AM C,25,134,142,"France,Ivory Coast",1. FSV Mainz 05,14,12,15,11,14,15,11,12,5,11,14,13,11,16,12,12,12,13,12,15,12,14,16,10,13,11,12,12,12,15,12,11,16,13,14,11,12,10,12,6,17,3,2,3,3,3,3,4,1,1,3,2,13,14,5,14,11,15,11,10,1,1,1,12,1,12,12,12,20,12,12,18,12,14,183,71,10,20,7472536,6700,6800,5250,North_African__Middle_Eastern,133,11,1996/8/20,0,0,34520.0,,85133890
51,Jacek Góralski,Bochum,1992,152.0,pl POL,MF,29.0,1.6,6.0,3.0,3.0,3.0,0.0,4.0,6.0,66.7,2.0,4.0,0.0,4.0,3.0,9.0,5.0,0.0,Matches,152.0,pl POL,MF,29.0,1.6,3.0,1.85,2.0,0.0,0.0,0.0,1.0,0.0,0.0,0.0,0.0,0.0,0.0,0.0,0.0,0.0,Matches,,,,,,,,,,,,,,,,,,,,,,,,,,,,,,,,,,,,,,,,,,,,,,,,,,,,,,,,152.0,pl POL,MF,29.0,1.6,0.0,0.0,0.0,1.0,4.0,0.0,0.0,3.0,3.0,0.0,0.0,0.0,7.0,0.0,2.0,0.0,Matches,152.0,pl POL,MF,29.0,1.6,39.0,35.0,4.0,4.0,0.0,1.0,0.0,0.0,0.0,0.0,0.0,0.0,31.0,0.0,1.0,Matches,152.0,pl POL,MF,29.0,1.6,31.0,39.0,79.5,488.0,138.0,14.0,17.0,82.4,12.0,12.0,100.0,3.0,6.0,50.0,0.0,0.1,0.0,-0.1,2.0,0.0,0.0,0.0,3.0,Matches,173,pl POL,MF,29,4,146.0,37.0,4.8,1.6,2,60.0,0,2,14.0,1,0.0,0.0,5.0,-5.0,-3.08,-2.25,1.0,5.1,-4.1,-2.51,-1.84,Matches,152.0,pl POL,MF,29.0,1.6,59.0,5.0,22.0,33.0,4.0,0.0,59.0,0.0,0.0,,0.0,,25.0,123.0,65.0,1.0,3.0,0.0,1.0,0.0,29.0,0.0,Matches,152.0,pl POL,MF,29.0,1.6,0.0,0.0,0.0,,0.0,0.0,,,,0.0,0.0,0.0,0.0,0.0,,0.0,0.0,Matches,152.0,pl POL,MF,29.0,4.0,2.0,146.0,1.6,0.0,0.0,0.0,0.0,0.0,0.0,0.0,0.0,0.0,0.0,0.1,0.1,1.0,3.0,0.0,0.0,0.0,0.0,0.0,0.0,0.0,0.04,0.04,0.0,0.04,Matches,Jacek Góralski,DM/M C,29,121,125,Poland,VfL Bochum 1848,5,5,8,7,10,5,6,7,8,14,10,7,15,9,19,15,19,12,13,10,10,18,9,15,11,15,18,18,13,15,12,9,16,12,16,11,13,16,14,9,10,1,1,3,1,2,3,1,3,1,2,3,10,15,9,15,17,15,13,8,1,1,1,1,1,1,20,1,16,1,1,1,1,1,172,66,8,20,1735779,6050,6000,4850,Northern_European,119,1,1992/9/21,21,1,6922.0,,96029863
52,Ryan Gravenberch,Bayern Munich,2002,156.0,nl NED,MF,20.0,6.4,17.0,8.0,4.0,10.0,3.0,7.0,13.0,53.8,6.0,9.0,1.0,8.0,9.0,26.0,10.0,0.0,Matches,156.0,nl NED,MF,20.0,6.4,25.0,3.91,22.0,0.0,0.0,3.0,0.0,0.0,1.0,0.16,1.0,0.0,0.0,0.0,0.0,0.0,Matches,,,,,,,,,,,,,,,,,,,,,,,,,,,,,,,,,,,,,,,,,,,,,,,,,,,,,,,,156.0,nl NED,MF,20.0,6.4,1.0,0.0,0.0,9.0,7.0,0.0,6.0,9.0,8.0,0.0,0.0,0.0,57.0,4.0,6.0,40.0,Matches,156.0,nl NED,MF,20.0,6.4,373.0,365.0,6.0,1.0,0.0,3.0,6.0,2.0,3.0,1.0,2.0,0.0,326.0,2.0,9.0,Matches,156.0,nl NED,MF,20.0,6.4,326.0,373.0,87.4,4941.0,1234.0,182.0,202.0,90.1,119.0,130.0,91.5,16.0,20.0,80.0,0.0,0.5,0.8,-0.5,8.0,34.0,9.0,0.0,44.0,Matches,179,nl NED,MF,20,24,576.0,24.0,18.8,6.4,3,59.0,0,21,19.0,8,2.21,17.0,10.0,7.0,1.09,-0.61,14.3,7.6,6.7,1.05,-0.08,Matches,156.0,nl NED,MF,20.0,6.4,483.0,12.0,68.0,269.0,155.0,11.0,483.0,19.0,11.0,57.9,6.0,31.6,301.0,1632.0,729.0,11.0,18.0,1.0,21.0,13.0,344.0,31.0,Matches,156.0,nl NED,MF,20.0,6.4,0.0,11.0,3.0,27.3,1.72,0.47,0.0,0.0,20.6,0.0,0.0,0.0,0.9,0.9,0.08,-0.9,-0.9,Matches,156.0,nl NED,MF,20.0,24.0,3.0,576.0,6.4,0.0,0.0,0.0,0.0,0.0,0.0,1.0,0.0,0.9,0.9,0.5,1.4,11.0,44.0,31.0,0.0,0.0,0.0,0.0,0.0,0.14,0.08,0.21,0.14,0.21,Matches,Ryan Gravenberch,DM/M/AM C,20,138,-9,"Holland,Suriname",FC Bayern München,14,12,14,10,15,13,12,13,4,10,15,10,11,15,11,12,13,14,11,12,13,15,15,8,12,11,12,12,13,14,15,14,12,13,14,13,12,4,12,8,9,3,2,2,3,1,2,3,1,3,1,2,11,16,2,13,15,11,13,12,1,1,1,1,1,1,17,10,20,10,12,17,10,1,190,77,11,20,80320000,6997,6997,5497,African_Caribbean,135,13,2002/5/16,10,1,176437.0,,37071197
53,Leo Greiml,Schalke 04,2001,158.0,at AUT,DF,21.0,4.0,10.0,5.0,4.0,5.0,1.0,5.0,12.0,41.7,7.0,7.0,3.0,4.0,3.0,13.0,16.0,0.0,Matches,158.0,at AUT,DF,21.0,4.0,3.0,0.75,3.0,0.0,0.0,0.0,0.0,0.0,0.0,0.0,0.0,0.0,0.0,0.0,0.0,0.0,Matches,,,,,,,,,,,,,,,,,,,,,,,,,,,,,,,,,,,,,,,,,,,,,,,,,,,,,,,,158.0,at AUT,DF,21.0,4.0,2.0,0.0,0.0,12.0,2.0,0.0,3.0,3.0,5.0,0.0,1.0,0.0,21.0,10.0,5.0,66.7,Matches,158.0,at AUT,DF,21.0,4.0,197.0,191.0,6.0,4.0,1.0,0.0,3.0,2.0,0.0,0.0,0.0,0.0,160.0,0.0,1.0,Matches,158.0,at AUT,DF,21.0,4.0,160.0,197.0,81.2,3284.0,1149.0,41.0,46.0,89.1,101.0,111.0,91.0,17.0,37.0,45.9,0.0,0.1,0.1,-0.1,1.0,10.0,1.0,0.0,10.0,Matches,181,at AUT,DF,21,7,358.0,51.0,11.7,4.0,3,90.0,3,4,22.0,12,0.86,2.0,13.0,-11.0,-2.77,-1.93,4.0,9.7,-5.7,-1.43,-1.04,Matches,158.0,at AUT,DF,21.0,4.0,241.0,36.0,135.0,101.0,5.0,1.0,241.0,1.0,1.0,100.0,0.0,0.0,135.0,598.0,357.0,4.0,1.0,0.0,3.0,0.0,143.0,1.0,Matches,158.0,at AUT,DF,21.0,4.0,0.0,1.0,1.0,100.0,0.25,0.25,0.0,0.0,10.8,0.0,0.0,0.0,0.1,0.1,0.11,-0.1,-0.1,Matches,158.0,at AUT,DF,21.0,7.0,3.0,358.0,4.0,0.0,0.0,0.0,0.0,0.0,0.0,2.0,0.0,0.1,0.1,0.1,0.2,4.0,10.0,1.0,0.0,0.0,0.0,0.0,0.0,0.03,0.02,0.05,0.03,0.05,Matches,Leo Greiml,D C,21,121,147,Austria,FC Schalke 04,4,8,10,6,11,6,13,7,7,13,12,8,15,11,16,13,16,12,12,11,12,16,8,6,8,13,12,14,12,11,14,14,12,12,12,13,12,11,11,8,7,3,1,3,1,3,3,2,4,2,3,2,10,15,7,10,14,15,12,10,1,1,20,13,1,1,1,1,1,1,1,1,1,1,186,73,12,20,2449999,6038,6038,4045,Northern_European,121,4,2001/7/3,0,0,19177.0,,16191211
54,Brajan Gruda,Mainz 05,2004,162.0,de GER,MF,18.0,0.0,0.0,0.0,0.0,0.0,0.0,0.0,0.0,,0.0,0.0,0.0,0.0,0.0,0.0,0.0,0.0,Matches,162.0,de GER,MF,18.0,0.0,1.0,22.5,1.0,0.0,0.0,0.0,0.0,0.0,0.0,0.0,0.0,0.0,0.0,0.0,0.0,0.0,Matches,,,,,,,,,,,,,,,,,,,,,,,,,,,,,,,,,,,,,,,,,,,,,,,,,,,,,,,,162.0,de GER,MF,18.0,0.0,0.0,0.0,0.0,1.0,0.0,0.0,1.0,0.0,0.0,0.0,0.0,0.0,1.0,0.0,0.0,,Matches,162.0,de GER,MF,18.0,0.0,4.0,4.0,0.0,0.0,0.0,0.0,1.0,0.0,0.0,0.0,0.0,0.0,2.0,0.0,0.0,Matches,162.0,de GER,MF,18.0,0.0,2.0,4.0,50.0,49.0,17.0,1.0,3.0,33.3,0.0,0.0,,1.0,1.0,100.0,0.0,0.1,0.0,-0.1,1.0,0.0,1.0,1.0,0.0,Matches,185,de GER,MF,18,2,4.0,2.0,0.1,0.0,0,,0,2,2.0,4,0.0,0.0,1.0,-1.0,-22.5,-22.5,0.4,0.7,-0.3,-7.83,-7.65,Matches,162.0,de GER,MF,18.0,0.0,8.0,0.0,0.0,2.0,6.0,1.0,8.0,2.0,0.0,0.0,2.0,100.0,4.0,29.0,0.0,0.0,0.0,0.0,0.0,1.0,3.0,0.0,Matches,162.0,de GER,MF,18.0,0.0,0.0,0.0,0.0,,0.0,0.0,,,,0.0,0.0,0.0,0.0,0.0,,0.0,0.0,Matches,162.0,de GER,MF,18.0,2.0,0.0,4.0,0.0,0.0,0.0,0.0,0.0,0.0,0.0,0.0,0.0,0.0,0.0,0.1,0.1,0.0,0.0,0.0,0.0,0.0,0.0,0.0,0.0,0.0,1.63,1.63,0.0,1.63,Matches,Brajan Gruda,AM/S RLC,18,96,-75,"Germany,Albania",1. FSV Mainz 05,11,8,12,12,12,12,12,11,2,4,12,14,5,13,12,9,8,10,8,12,8,13,16,10,12,5,10,10,12,12,10,12,14,12,11,9,14,6,12,4,13,2,2,4,1,2,3,1,1,2,1,3,11,13,7,13,12,13,8,7,1,1,1,1,1,1,1,10,12,10,15,18,15,20,182,72,20,9,16720000,4809,4809,2318,Northern_European,93,2,2004/5/31,0,0,1151.0,,2000180822
55,Péter Gulácsi,RB Leipzig,1990,168.0,hu HUN,GK,32.0,6.0,0.0,0.0,0.0,0.0,0.0,0.0,0.0,,0.0,0.0,0.0,0.0,0.0,0.0,2.0,0.0,Matches,168.0,hu HUN,GK,32.0,6.0,1.0,0.17,1.0,0.0,0.0,0.0,0.0,0.0,0.0,0.0,0.0,0.0,0.0,0.0,0.0,0.0,Matches,12.0,hu HUN,GK,32.0,6.0,10.0,1.0,0.0,2.0,1.0,10.1,0.37,1.1,0.19,11.0,37.0,29.7,179.0,37.0,15.6,26.4,36.0,25.0,29.6,61.0,3.0,4.9,10.0,1.67,19.4,Matches,12.0,hu HUN,GK,32.0,6.0,6.0,540.0,6.0,10.0,1.67,26.0,17.0,65.4,2.0,2.0,2.0,2.0,33.3,1.0,1.0,0.0,0.0,0.0,Matches,168.0,hu HUN,GK,32.0,6.0,0.0,0.0,0.0,0.0,0.0,0.0,0.0,0.0,0.0,0.0,0.0,0.0,12.0,0.0,0.0,,Matches,168.0,hu HUN,GK,32.0,6.0,215.0,173.0,42.0,6.0,0.0,0.0,0.0,0.0,0.0,0.0,0.0,0.0,189.0,0.0,0.0,Matches,168.0,hu HUN,GK,32.0,6.0,189.0,215.0,87.9,4257.0,2285.0,44.0,44.0,100.0,112.0,112.0,100.0,33.0,59.0,55.9,0.0,0.0,0.0,0.0,0.0,3.0,0.0,0.0,0.0,Matches,191,hu HUN,GK,32,6,540.0,90.0,17.6,6.0,6,90.0,6,0,,0,1.33,10.0,10.0,0.0,0.0,-0.82,9.6,8.8,0.8,0.13,-0.75,Matches,168.0,hu HUN,GK,32.0,6.0,225.0,180.0,225.0,0.0,0.0,0.0,225.0,0.0,0.0,,0.0,,142.0,625.0,303.0,0.0,0.0,0.0,0.0,0.0,119.0,0.0,Matches,168.0,hu HUN,GK,32.0,6.0,0.0,0.0,0.0,,0.0,0.0,,,,0.0,0.0,0.0,0.0,0.0,,0.0,0.0,Matches,168.0,hu HUN,GK,32.0,6.0,6.0,540.0,6.0,0.0,0.0,0.0,0.0,0.0,0.0,0.0,0.0,0.0,0.0,0.0,0.0,0.0,0.0,0.0,0.0,0.0,0.0,0.0,0.0,0.0,0.0,0.0,0.0,0.0,Matches,Péter Gulácsi,GK,32,138,146,Hungary,RB Leipzig,4,2,1,2,9,7,3,3,2,3,10,2,1,9,8,16,13,13,17,7,11,12,3,12,2,8,14,10,12,13,14,14,13,10,12,15,17,4,15,4,13,14,13,10,8,16,13,15,16,15,11,10,14,16,5,15,13,17,14,18,20,1,1,1,1,1,1,1,1,1,1,1,1,1,191,86,6,20,347975206,7160,7161,6211,Northern_European,133,4,1990/5/6,49,0,67077.0,,28018193
56,Manuel Gulde,Freiburg,1991,169.0,de GER,DF,31.0,7.1,14.0,8.0,10.0,4.0,0.0,2.0,4.0,50.0,2.0,5.0,1.0,4.0,19.0,33.0,25.0,0.0,Matches,169.0,de GER,DF,31.0,7.1,6.0,0.84,4.0,0.0,0.0,0.0,0.0,2.0,1.0,0.14,1.0,0.0,0.0,0.0,0.0,0.0,Matches,,,,,,,,,,,,,,,,,,,,,,,,,,,,,,,,,,,,,,,,,,,,,,,,,,,,,,,,169.0,de GER,DF,31.0,7.1,2.0,0.0,0.0,9.0,2.0,0.0,4.0,19.0,8.0,0.0,0.0,0.0,37.0,22.0,20.0,52.4,Matches,169.0,de GER,DF,31.0,7.1,412.0,392.0,20.0,14.0,0.0,0.0,4.0,3.0,0.0,0.0,0.0,0.0,343.0,0.0,3.0,Matches,169.0,de GER,DF,31.0,7.1,343.0,412.0,83.3,6393.0,1826.0,128.0,144.0,88.9,172.0,190.0,90.5,38.0,65.0,58.5,0.0,0.2,0.3,-0.2,2.0,24.0,2.0,2.0,23.0,Matches,192,de GER,DF,31,15,643.0,43.0,21.0,7.1,8,73.0,5,7,8.0,8,1.4,6.0,15.0,-9.0,-1.26,-1.86,7.5,12.0,-4.5,-0.63,-0.77,Matches,169.0,de GER,DF,31.0,7.1,491.0,39.0,209.0,256.0,28.0,5.0,491.0,0.0,0.0,,0.0,,244.0,1154.0,643.0,6.0,7.0,0.0,4.0,1.0,295.0,5.0,Matches,169.0,de GER,DF,31.0,7.1,1.0,2.0,1.0,50.0,0.28,0.14,0.5,1.0,6.1,0.0,0.0,0.0,0.7,0.7,0.35,0.3,0.3,Matches,169.0,de GER,DF,31.0,15.0,8.0,643.0,7.1,1.0,0.0,1.0,1.0,0.0,0.0,2.0,0.0,0.7,0.7,0.2,0.9,6.0,23.0,5.0,0.14,0.0,0.14,0.14,0.14,0.1,0.02,0.12,0.1,0.12,Matches,Manuel Gulde,D C,31,127,129,Germany,Sport-Club Freiburg,5,8,7,5,11,6,14,4,10,13,12,7,13,11,6,13,12,13,16,9,14,10,6,10,7,15,15,10,12,11,12,12,13,14,12,12,16,5,14,14,9,2,2,2,3,2,3,3,1,3,3,1,9,12,8,13,9,13,17,14,1,10,20,10,8,8,12,1,12,1,1,1,1,1,184,83,12,20,1823251,6250,6250,4500,Northern_European,126,5,1991/2/12,0,0,9198.0,,35017406
57,André Hahn,Augsburg,1990,175.0,de GER,FWMF,31.0,4.3,9.0,5.0,4.0,4.0,1.0,8.0,12.0,66.7,4.0,9.0,2.0,7.0,4.0,13.0,14.0,0.0,Matches,175.0,de GER,FWMF,31.0,4.3,3.0,0.69,3.0,0.0,0.0,0.0,0.0,0.0,1.0,0.23,1.0,0.0,0.0,0.0,0.0,0.0,Matches,,,,,,,,,,,,,,,,,,,,,,,,,,,,,,,,,,,,,,,,,,,,,,,,,,,,,,,,175.0,de GER,FWMF,31.0,4.3,1.0,0.0,0.0,8.0,3.0,1.0,6.0,4.0,5.0,0.0,0.0,0.0,19.0,13.0,15.0,46.4,Matches,175.0,de GER,FWMF,31.0,4.3,83.0,80.0,2.0,0.0,0.0,2.0,6.0,2.0,0.0,0.0,0.0,0.0,33.0,1.0,5.0,Matches,175.0,de GER,FWMF,31.0,4.3,33.0,83.0,39.8,542.0,216.0,15.0,25.0,60.0,13.0,26.0,50.0,2.0,17.0,11.8,0.0,0.0,0.0,0.0,1.0,7.0,1.0,0.0,8.0,Matches,199,de GER,FWMF,31,7,391.0,56.0,12.8,4.3,4,82.0,3,3,21.0,0,1.71,6.0,6.0,0.0,0.0,0.71,4.7,8.2,-3.5,-0.8,-0.11,Matches,175.0,de GER,FWMF,31.0,4.3,156.0,14.0,38.0,63.0,58.0,7.0,156.0,6.0,1.0,16.7,4.0,66.7,57.0,256.0,115.0,3.0,5.0,0.0,13.0,1.0,70.0,10.0,Matches,175.0,de GER,FWMF,31.0,4.3,2.0,7.0,2.0,28.6,1.61,0.46,0.29,1.0,21.4,0.0,0.0,0.0,0.4,0.4,0.06,1.6,1.6,Matches,175.0,de GER,FWMF,31.0,7.0,4.0,391.0,4.3,2.0,0.0,2.0,2.0,0.0,0.0,1.0,0.0,0.4,0.4,0.0,0.4,3.0,8.0,10.0,0.46,0.0,0.46,0.46,0.46,0.09,0.01,0.1,0.09,0.1,Matches,André Hahn,M/AM RL,31,131,140,Germany,FC Augsburg,9,15,12,14,10,8,14,12,12,7,9,12,8,11,17,12,16,11,14,10,9,17,12,11,15,10,12,17,13,11,17,12,18,14,16,14,13,8,14,8,15,2,2,1,2,3,2,1,2,1,2,2,10,16,9,8,14,13,12,9,1,1,1,1,1,14,1,15,1,20,15,10,20,14,185,80,12,20,2573768,6600,6600,5750,Northern_European,126,4,1990/8/13,1,0,34614.0,,91018460
58,Genki Haraguchi,Stuttgart,1991,180.0,jp JPN,MF,31.0,8.3,16.0,7.0,7.0,7.0,2.0,4.0,16.0,25.0,12.0,13.0,2.0,11.0,8.0,24.0,6.0,0.0,Matches,180.0,jp JPN,MF,31.0,8.3,22.0,2.64,19.0,0.0,0.0,0.0,2.0,1.0,2.0,0.24,2.0,0.0,0.0,0.0,0.0,0.0,Matches,,,,,,,,,,,,,,,,,,,,,,,,,,,,,,,,,,,,,,,,,,,,,,,,,,,,,,,,180.0,jp JPN,MF,31.0,8.3,1.0,0.0,0.0,4.0,16.0,0.0,8.0,8.0,7.0,0.0,0.0,1.0,38.0,6.0,12.0,33.3,Matches,180.0,jp JPN,MF,31.0,8.3,301.0,296.0,3.0,1.0,0.0,2.0,8.0,1.0,0.0,0.0,0.0,0.0,243.0,2.0,9.0,Matches,180.0,jp JPN,MF,31.0,8.3,243.0,301.0,80.7,3710.0,864.0,134.0,153.0,87.6,79.0,93.0,84.9,16.0,25.0,64.0,2.0,0.7,0.3,1.3,8.0,30.0,2.0,2.0,30.0,Matches,204,jp JPN,MF,31,11,748.0,68.0,24.4,8.3,9,80.0,3,2,13.0,5,0.91,9.0,16.0,-7.0,-0.84,-0.65,11.3,12.1,-0.7,-0.09,-0.21,Matches,180.0,jp JPN,MF,31.0,8.3,381.0,13.0,66.0,219.0,100.0,9.0,381.0,15.0,9.0,60.0,5.0,33.3,238.0,1148.0,539.0,16.0,10.0,3.0,15.0,5.0,262.0,28.0,Matches,180.0,jp JPN,MF,31.0,8.3,0.0,5.0,1.0,20.0,0.6,0.12,0.0,0.0,24.8,1.0,0.0,0.0,0.3,0.3,0.06,-0.3,-0.3,Matches,180.0,jp JPN,MF,31.0,11.0,9.0,748.0,8.3,0.0,2.0,2.0,0.0,0.0,0.0,1.0,0.0,0.3,0.3,0.7,1.0,16.0,30.0,28.0,0.0,0.24,0.24,0.0,0.24,0.03,0.08,0.12,0.03,0.12,Matches,Genki Haraguchi,M/AM RLC,31,133,138,Japan,1. FC Union Berlin,11,10,15,10,13,9,8,11,6,9,14,9,10,15,16,10,14,11,11,11,9,13,13,7,11,9,13,16,16,16,10,8,13,14,13,10,9,9,11,6,15,2,4,1,4,2,1,1,2,2,3,2,10,15,12,13,10,15,10,14,1,1,1,1,1,1,1,15,18,15,18,20,16,10,176,70,10,20,2510863,6490,7190,5990,10,123,7,1991/5/9,73,11,12499.0,,45015136
59,Thorgan Hazard,Dortmund,1993,183.0,be BEL,FWDF,29.0,5.2,17.0,6.0,5.0,11.0,1.0,12.0,17.0,70.6,5.0,6.0,0.0,6.0,5.0,22.0,5.0,0.0,Matches,183.0,be BEL,FWDF,29.0,5.2,23.0,4.45,16.0,4.0,0.0,3.0,0.0,0.0,0.0,0.0,0.0,0.0,0.0,0.0,0.0,0.0,Matches,,,,,,,,,,,,,,,,,,,,,,,,,,,,,,,,,,,,,,,,,,,,,,,,,,,,,,,,183.0,be BEL,FWDF,29.0,5.2,1.0,0.0,0.0,14.0,5.0,4.0,37.0,5.0,6.0,0.0,0.0,0.0,44.0,4.0,8.0,33.3,Matches,183.0,be BEL,FWDF,29.0,5.2,324.0,268.0,55.0,9.0,0.0,2.0,37.0,26.0,17.0,4.0,12.0,0.0,235.0,1.0,3.0,Matches,183.0,be BEL,FWDF,29.0,5.2,235.0,324.0,72.5,3790.0,1328.0,121.0,151.0,80.1,92.0,118.0,78.0,18.0,41.0,43.9,0.0,0.9,0.9,-0.9,11.0,17.0,7.0,1.0,28.0,Matches,207,be BEL,FWDF,29,14,464.0,33.0,15.2,5.2,2,77.0,1,12,26.0,1,1.79,6.0,8.0,-2.0,-0.39,-1.81,8.2,7.5,0.7,0.13,-0.81,Matches,183.0,be BEL,FWDF,29.0,5.2,386.0,12.0,76.0,148.0,169.0,18.0,386.0,15.0,3.0,20.0,9.0,60.0,209.0,1019.0,567.0,21.0,11.0,5.0,7.0,0.0,223.0,50.0,Matches,183.0,be BEL,FWDF,29.0,5.2,0.0,8.0,3.0,37.5,1.55,0.58,0.0,0.0,14.2,0.0,0.0,0.0,1.3,1.3,0.17,-1.3,-1.3,Matches,183.0,be BEL,FWDF,29.0,14.0,2.0,464.0,5.2,0.0,0.0,0.0,0.0,0.0,0.0,1.0,0.0,1.3,1.3,0.9,2.3,21.0,28.0,50.0,0.0,0.0,0.0,0.0,0.0,0.26,0.18,0.44,0.26,0.44,Matches,Thorgan Hazard,M/AM RLC,29,144,153,Belgium,Borussia Dortmund,15,13,14,12,14,13,7,13,7,8,13,13,8,15,14,11,10,10,13,13,12,13,13,10,13,8,15,15,14,13,10,8,11,14,13,9,13,6,12,16,18,2,2,3,1,3,3,3,2,4,3,1,11,16,8,10,14,16,14,14,1,8,1,5,10,8,8,20,12,18,20,15,18,15,175,71,14,20,35814998,7400,7600,7000,Northern_European,131,6,1993/3/29,45,9,95825.0,,85023676
60,Dominique Heintz,Bochum,1993,185.0,de GER,DF,28.0,8.8,13.0,9.0,5.0,7.0,1.0,6.0,17.0,35.3,11.0,11.0,7.0,4.0,12.0,25.0,34.0,0.0,Matches,185.0,de GER,DF,28.0,8.8,8.0,0.91,7.0,0.0,0.0,0.0,0.0,1.0,1.0,0.11,1.0,0.0,0.0,0.0,0.0,0.0,Matches,,,,,,,,,,,,,,,,,,,,,,,,,,,,,,,,,,,,,,,,,,,,,,,,,,,,,,,,185.0,de GER,DF,28.0,8.8,1.0,0.0,0.0,11.0,4.0,0.0,8.0,12.0,9.0,0.0,0.0,0.0,54.0,18.0,12.0,60.0,Matches,185.0,de GER,DF,28.0,8.8,326.0,295.0,31.0,6.0,0.0,2.0,8.0,24.0,0.0,0.0,0.0,0.0,269.0,0.0,2.0,Matches,185.0,de GER,DF,28.0,8.8,269.0,326.0,82.5,5201.0,1712.0,98.0,108.0,90.7,139.0,158.0,88.0,30.0,53.0,56.6,0.0,0.2,0.7,-0.2,3.0,16.0,8.0,2.0,21.0,Matches,210,de GER,DF,28,11,795.0,72.0,26.0,8.8,8,80.0,3,3,51.0,10,1.36,10.0,19.0,-9.0,-1.02,-0.1,10.8,19.7,-8.9,-1.01,-0.35,Matches,185.0,de GER,DF,28.0,8.8,404.0,51.0,192.0,191.0,24.0,4.0,404.0,4.0,4.0,100.0,0.0,0.0,193.0,900.0,387.0,3.0,5.0,0.0,0.0,4.0,192.0,2.0,Matches,185.0,de GER,DF,28.0,8.8,0.0,4.0,1.0,25.0,0.45,0.11,0.0,0.0,17.4,0.0,0.0,0.0,0.3,0.3,0.08,-0.3,-0.3,Matches,185.0,de GER,DF,28.0,11.0,8.0,795.0,8.8,0.0,0.0,0.0,0.0,0.0,0.0,1.0,0.0,0.3,0.3,0.2,0.5,3.0,21.0,2.0,0.0,0.0,0.0,0.0,0.0,0.04,0.02,0.06,0.04,0.06,Matches,Dominique Heintz,D C,28,131,136,Germany,1. FC Union Berlin,5,9,7,7,10,8,13,11,13,15,13,9,15,10,7,12,14,14,14,12,14,13,5,11,7,14,16,9,11,7,14,15,12,15,13,15,13,9,13,8,9,2,4,2,2,3,2,2,1,2,3,1,7,14,5,13,11,17,15,17,1,14,20,10,10,1,10,1,1,1,1,1,1,1,188,89,20,10,6435676,6700,6700,5500,Northern_European,132,3,1993/8/15,0,0,15332.0,VfL Bochum 1848,92018444
61,Lucas Hernández,Bayern Munich,1996,187.0,fr FRA,DF,26.0,5.3,6.0,4.0,3.0,3.0,0.0,5.0,6.0,83.3,1.0,2.0,1.0,1.0,5.0,11.0,7.0,0.0,Matches,187.0,fr FRA,DF,26.0,5.3,4.0,0.76,4.0,0.0,0.0,0.0,0.0,0.0,0.0,0.0,0.0,0.0,0.0,0.0,0.0,0.0,Matches,,,,,,,,,,,,,,,,,,,,,,,,,,,,,,,,,,,,,,,,,,,,,,,,,,,,,,,,187.0,fr FRA,DF,26.0,5.3,1.0,0.0,0.0,4.0,4.0,0.0,2.0,5.0,4.0,0.0,0.0,0.0,33.0,4.0,2.0,66.7,Matches,187.0,fr FRA,DF,26.0,5.3,377.0,347.0,27.0,3.0,0.0,9.0,2.0,24.0,0.0,0.0,0.0,0.0,337.0,3.0,4.0,Matches,187.0,fr FRA,DF,26.0,5.3,337.0,377.0,89.4,6346.0,2535.0,133.0,140.0,95.0,153.0,170.0,90.0,43.0,51.0,84.3,0.0,0.2,0.1,-0.2,1.0,29.0,2.0,0.0,34.0,Matches,212,fr FRA,DF,26,7,476.0,68.0,15.6,5.3,6,75.0,2,1,27.0,2,2.71,19.0,3.0,16.0,3.03,1.7,16.0,4.2,11.8,2.23,1.32,Matches,187.0,fr FRA,DF,26.0,5.3,407.0,20.0,153.0,222.0,33.0,2.0,407.0,3.0,1.0,33.3,1.0,33.3,267.0,1151.0,657.0,3.0,3.0,0.0,1.0,0.0,302.0,4.0,Matches,187.0,fr FRA,DF,26.0,5.3,0.0,0.0,0.0,,0.0,0.0,,,,0.0,0.0,0.0,0.0,0.0,,0.0,0.0,Matches,187.0,fr FRA,DF,26.0,7.0,6.0,476.0,5.3,0.0,0.0,0.0,0.0,0.0,0.0,1.0,0.0,0.0,0.0,0.2,0.2,3.0,34.0,4.0,0.0,0.0,0.0,0.0,0.0,0.0,0.03,0.03,0.0,0.03,Matches,Lucas Hernández,D LC,26,155,160,"France,Spain",FC Bayern München,4,12,12,7,12,9,14,7,12,16,14,7,17,13,17,15,19,14,15,12,14,19,10,12,12,16,15,18,14,13,15,13,13,15,15,13,14,12,15,11,14,1,1,3,3,2,3,1,3,3,3,3,12,17,18,12,15,12,10,8,1,18,20,10,14,1,1,1,1,1,1,1,1,1,184,79,20,7,55282496,7750,7650,7250,Mediterranean_Hispanic,156,5,1996/2/14,32,0,249315.0,,67197145
62,Patrick Herrmann,Gladbach,1991,188.0,de GER,FWMF,31.0,1.8,6.0,2.0,4.0,1.0,1.0,2.0,4.0,50.0,2.0,2.0,0.0,2.0,2.0,8.0,1.0,0.0,Matches,188.0,de GER,FWMF,31.0,1.8,6.0,3.31,4.0,1.0,0.0,1.0,0.0,0.0,0.0,0.0,0.0,0.0,0.0,0.0,0.0,0.0,Matches,,,,,,,,,,,,,,,,,,,,,,,,,,,,,,,,,,,,,,,,,,,,,,,,,,,,,,,,188.0,de GER,FWMF,31.0,1.8,2.0,0.0,0.0,4.0,4.0,0.0,12.0,2.0,2.0,0.0,1.0,0.0,16.0,2.0,5.0,28.6,Matches,188.0,de GER,FWMF,31.0,1.8,122.0,96.0,25.0,6.0,1.0,1.0,12.0,17.0,2.0,0.0,0.0,0.0,85.0,1.0,6.0,Matches,188.0,de GER,FWMF,31.0,1.8,85.0,122.0,69.7,1321.0,444.0,46.0,50.0,92.0,29.0,40.0,72.5,6.0,19.0,31.6,0.0,0.5,0.6,-0.5,4.0,7.0,3.0,1.0,6.0,Matches,213,de GER,FWMF,31,21,164.0,8.0,5.4,1.8,0,,0,21,8.0,11,1.33,6.0,8.0,-2.0,-1.1,-1.07,3.7,4.8,-1.1,-0.6,-0.59,Matches,188.0,de GER,FWMF,31.0,1.8,150.0,3.0,35.0,49.0,68.0,15.0,150.0,4.0,0.0,0.0,4.0,100.0,75.0,371.0,177.0,7.0,8.0,3.0,1.0,4.0,85.0,19.0,Matches,188.0,de GER,FWMF,31.0,1.8,1.0,6.0,2.0,33.3,3.29,1.1,0.17,0.5,19.7,0.0,0.0,0.0,0.4,0.4,0.06,0.6,0.6,Matches,188.0,de GER,FWMF,31.0,21.0,0.0,164.0,1.8,1.0,0.0,1.0,1.0,0.0,0.0,2.0,0.0,0.4,0.4,0.5,0.8,7.0,6.0,19.0,0.55,0.0,0.55,0.55,0.55,0.19,0.27,0.46,0.19,0.46,Matches,Patrick Herrmann,M/AM RL,31,126,142,Germany,Borussia Mönchengladbach,12,13,13,11,12,12,9,11,8,9,13,12,11,13,14,12,12,12,12,14,12,11,14,13,15,10,15,15,13,14,12,10,13,13,12,9,10,8,13,9,16,1,1,1,1,1,2,3,3,1,2,3,7,12,8,20,11,17,16,14,1,1,1,12,10,14,1,14,1,18,15,12,20,14,179,71,10,20,2160891,6300,6300,5500,Northern_European,126,2,1991/2/12,2,0,28766.0,,35017417
63,Jannes Horn,Bochum,1997,196.0,de GER,DFFW,25.0,0.7,2.0,1.0,1.0,1.0,0.0,1.0,1.0,100.0,0.0,1.0,0.0,1.0,3.0,5.0,2.0,0.0,Matches,196.0,de GER,DFFW,25.0,0.7,0.0,0.0,0.0,0.0,0.0,0.0,0.0,0.0,0.0,0.0,0.0,0.0,0.0,0.0,0.0,0.0,Matches,,,,,,,,,,,,,,,,,,,,,,,,,,,,,,,,,,,,,,,,,,,,,,,,,,,,,,,,196.0,de GER,DFFW,25.0,0.7,1.0,0.0,0.0,1.0,0.0,0.0,0.0,3.0,1.0,0.0,1.0,0.0,2.0,0.0,0.0,,Matches,196.0,de GER,DFFW,25.0,0.7,19.0,17.0,2.0,0.0,0.0,0.0,0.0,2.0,0.0,0.0,0.0,0.0,15.0,0.0,2.0,Matches,196.0,de GER,DFFW,25.0,0.7,15.0,19.0,78.9,211.0,120.0,6.0,7.0,85.7,6.0,7.0,85.7,0.0,0.0,,0.0,0.0,0.0,0.0,0.0,0.0,0.0,0.0,0.0,Matches,222,de GER,DFFW,25,2,59.0,30.0,1.9,0.7,1,45.0,0,1,14.0,8,1.5,0.0,2.0,-2.0,-3.05,-2.15,0.2,1.4,-1.2,-1.84,-1.1,Matches,196.0,de GER,DFFW,25.0,0.7,27.0,3.0,22.0,3.0,2.0,0.0,27.0,0.0,0.0,,0.0,,11.0,49.0,16.0,0.0,0.0,0.0,0.0,0.0,12.0,0.0,Matches,196.0,de GER,DFFW,25.0,0.7,0.0,0.0,0.0,,0.0,0.0,,,,0.0,0.0,0.0,0.0,0.0,,0.0,0.0,Matches,196.0,de GER,DFFW,25.0,2.0,1.0,59.0,0.7,0.0,0.0,0.0,0.0,0.0,0.0,1.0,0.0,0.0,0.0,0.0,0.0,0.0,0.0,0.0,0.0,0.0,0.0,0.0,0.0,0.0,0.0,0.0,0.0,0.0,Matches,Jannes Horn,D/WB LC,25,124,133,Germany,VfL Bochum 1848,13,15,9,7,11,12,12,9,15,11,13,9,13,12,12,10,15,12,10,11,10,14,13,9,11,11,13,15,13,11,14,13,16,16,13,12,12,10,13,6,15,1,3,3,1,3,2,4,3,2,2,1,7,13,10,10,14,12,10,8,1,20,15,7,20,7,10,14,10,1,11,1,1,1,186,79,20,9,2329599,6250,6250,4500,Northern_European,118,3,1997/2/6,0,0,10000.0,,91132038
64,Callum Hudson-Odoi,Leverkusen,2000,199.0,eng ENG,FWMF,21.0,6.7,5.0,3.0,4.0,0.0,1.0,1.0,1.0,100.0,0.0,0.0,0.0,0.0,2.0,7.0,4.0,0.0,Matches,199.0,eng ENG,FWMF,21.0,6.7,26.0,3.86,19.0,4.0,1.0,2.0,0.0,0.0,2.0,0.3,2.0,0.0,0.0,0.0,0.0,0.0,Matches,,,,,,,,,,,,,,,,,,,,,,,,,,,,,,,,,,,,,,,,,,,,,,,,,,,,,,,,199.0,eng ENG,FWMF,21.0,6.7,0.0,0.0,0.0,2.0,20.0,2.0,12.0,2.0,3.0,0.0,0.0,0.0,26.0,0.0,5.0,0.0,Matches,199.0,eng ENG,FWMF,21.0,6.7,248.0,223.0,22.0,8.0,1.0,2.0,12.0,4.0,4.0,3.0,0.0,0.0,206.0,3.0,6.0,Matches,199.0,eng ENG,FWMF,21.0,6.7,206.0,248.0,83.1,3427.0,782.0,114.0,128.0,89.1,67.0,78.0,85.9,22.0,30.0,73.3,1.0,0.8,0.9,0.2,13.0,18.0,7.0,1.0,31.0,Matches,226,eng ENG,FWMF,21,14,605.0,43.0,19.8,6.7,7,68.0,0,7,18.0,8,1.5,12.0,13.0,-1.0,-0.15,-0.48,9.8,8.7,1.0,0.15,-0.12,Matches,199.0,eng ENG,FWMF,21.0,6.7,288.0,6.0,32.0,145.0,117.0,10.0,288.0,28.0,14.0,50.0,10.0,35.7,193.0,1610.0,893.0,30.0,23.0,6.0,7.0,14.0,240.0,44.0,Matches,199.0,eng ENG,FWMF,21.0,6.7,0.0,4.0,1.0,25.0,0.6,0.15,0.0,0.0,20.4,0.0,0.0,0.0,0.2,0.2,0.05,-0.2,-0.2,Matches,199.0,eng ENG,FWMF,21.0,14.0,7.0,605.0,6.7,0.0,1.0,1.0,0.0,0.0,0.0,0.0,0.0,0.2,0.2,0.8,0.9,30.0,31.0,44.0,0.0,0.15,0.15,0.0,0.15,0.03,0.11,0.14,0.03,0.14,Matches,Callum Hudson-Odoi,AM RLC,21,148,170,"England,Ghana",Chelsea,10,15,15,9,15,12,7,8,3,5,15,10,5,15,7,10,6,14,8,14,13,10,15,6,15,9,9,14,16,15,12,8,12,15,12,8,12,8,6,8,4,1,3,3,2,1,4,3,2,2,3,3,17,18,7,9,15,11,13,14,1,1,1,1,1,15,1,15,1,15,20,16,19,9,178,79,13,20,71914876,7400,7150,6250,African_Caribbean,135,17,2000/11/7,3,0,139190.0,Bayer 04 Leverkusen,28112986
65,Arijon Ibrahimović,Bayern Munich,2005,203.0,de GER,MF,16.0,0.2,1.0,1.0,1.0,0.0,0.0,0.0,0.0,,0.0,0.0,0.0,0.0,0.0,1.0,0.0,0.0,Matches,203.0,de GER,MF,16.0,0.2,1.0,6.43,1.0,0.0,0.0,0.0,0.0,0.0,0.0,0.0,0.0,0.0,0.0,0.0,0.0,0.0,Matches,,,,,,,,,,,,,,,,,,,,,,,,,,,,,,,,,,,,,,,,,,,,,,,,,,,,,,,,203.0,de GER,MF,16.0,0.2,0.0,0.0,0.0,0.0,1.0,0.0,0.0,0.0,1.0,0.0,0.0,0.0,1.0,2.0,0.0,100.0,Matches,203.0,de GER,MF,16.0,0.2,8.0,8.0,0.0,0.0,0.0,0.0,0.0,0.0,0.0,0.0,0.0,0.0,7.0,0.0,0.0,Matches,203.0,de GER,MF,16.0,0.2,7.0,8.0,87.5,120.0,9.0,4.0,4.0,100.0,2.0,3.0,66.7,1.0,1.0,100.0,0.0,0.1,0.0,-0.1,1.0,0.0,0.0,0.0,0.0,Matches,230,de GER,MF,16,1,14.0,14.0,0.5,0.2,0,,0,1,14.0,4,3.0,0.0,0.0,0.0,0.0,-1.6,0.9,0.0,0.9,5.71,4.62,Matches,203.0,de GER,MF,16.0,0.2,13.0,0.0,3.0,6.0,4.0,2.0,13.0,1.0,0.0,0.0,0.0,0.0,6.0,9.0,8.0,0.0,1.0,0.0,0.0,0.0,9.0,2.0,Matches,203.0,de GER,MF,16.0,0.2,0.0,2.0,2.0,100.0,12.86,12.86,0.0,0.0,6.9,0.0,0.0,0.0,0.5,0.5,0.26,-0.5,-0.5,Matches,203.0,de GER,MF,16.0,1.0,0.0,14.0,0.2,0.0,0.0,0.0,0.0,0.0,0.0,0.0,0.0,0.5,0.5,0.1,0.6,0.0,0.0,2.0,0.0,0.0,0.0,0.0,0.0,3.31,0.37,3.68,3.31,3.68,Matches,Arijon Ibrahimović,AM RLC,16,95,-8,"Germany,Kosovo",FC Bayern München,12,11,14,12,13,13,7,12,2,7,12,12,8,14,8,9,9,10,8,12,8,15,15,3,12,8,11,11,12,12,10,8,14,13,10,11,14,6,13,4,12,2,2,2,2,4,1,1,3,2,1,1,12,17,11,14,13,12,10,10,1,1,1,1,1,1,8,12,15,12,15,20,15,12,176,73,8,20,26279999,4996,4996,3002,Mediterranean_Hispanic,96,6,2005/12/11,0,0,64.0,,2000114473
66,Tony Jantschke,Gladbach,1990,212.0,de GER,DFMF,32.0,1.1,2.0,1.0,1.0,1.0,0.0,1.0,1.0,100.0,0.0,5.0,3.0,2.0,0.0,2.0,5.0,0.0,Matches,212.0,de GER,DFMF,32.0,1.1,0.0,0.0,0.0,0.0,0.0,0.0,0.0,0.0,0.0,0.0,0.0,0.0,0.0,0.0,0.0,0.0,Matches,,,,,,,,,,,,,,,,,,,,,,,,,,,,,,,,,,,,,,,,,,,,,,,,,,,,,,,,212.0,de GER,DFMF,32.0,1.1,0.0,0.0,0.0,2.0,0.0,0.0,1.0,0.0,1.0,0.0,0.0,0.0,1.0,4.0,1.0,80.0,Matches,212.0,de GER,DFMF,32.0,1.1,86.0,86.0,0.0,0.0,0.0,0.0,1.0,0.0,0.0,0.0,0.0,0.0,79.0,0.0,0.0,Matches,212.0,de GER,DFMF,32.0,1.1,79.0,86.0,91.9,1453.0,438.0,26.0,27.0,96.3,45.0,48.0,93.8,7.0,10.0,70.0,0.0,0.0,0.0,0.0,0.0,1.0,0.0,0.0,2.0,Matches,239,de GER,DFMF,32,8,99.0,12.0,3.2,1.1,1,79.0,0,7,3.0,17,2.0,3.0,4.0,-1.0,-0.91,-0.85,1.3,2.6,-1.3,-1.14,-1.14,Matches,212.0,de GER,DFMF,32.0,1.1,99.0,11.0,57.0,39.0,3.0,0.0,99.0,0.0,0.0,,0.0,,59.0,217.0,70.0,0.0,0.0,0.0,0.0,0.0,74.0,1.0,Matches,212.0,de GER,DFMF,32.0,1.1,0.0,0.0,0.0,,0.0,0.0,,,,0.0,0.0,0.0,0.0,0.0,,0.0,0.0,Matches,212.0,de GER,DFMF,32.0,8.0,1.0,99.0,1.1,0.0,0.0,0.0,0.0,0.0,0.0,0.0,0.0,0.0,0.0,0.0,0.0,0.0,2.0,1.0,0.0,0.0,0.0,0.0,0.0,0.0,0.0,0.0,0.0,0.0,Matches,Tony Jantschke,D C,32,126,135,Germany,Borussia Mönchengladbach,3,8,7,6,11,3,13,6,15,14,12,6,14,11,13,14,16,12,15,10,13,17,7,14,8,15,14,15,11,10,12,12,12,11,11,13,12,8,14,15,16,2,3,1,1,3,3,2,1,1,3,1,5,10,3,20,14,18,16,18,1,1,20,14,1,12,14,1,10,1,1,1,1,1,177,76,12,20,1122652,6299,6299,4499,Northern_European,126,2,1990/4/7,0,0,23014.0,,29022529
67,Stevan Jovetić,Hertha BSC,1989,215.0,me MNE,FWMF,32.0,9.9,3.0,2.0,2.0,1.0,0.0,1.0,11.0,9.1,10.0,2.0,1.0,1.0,2.0,5.0,10.0,0.0,Matches,215.0,me MNE,FWMF,32.0,9.9,32.0,3.23,24.0,0.0,4.0,1.0,3.0,0.0,6.0,0.61,5.0,0.0,1.0,0.0,0.0,0.0,Matches,,,,,,,,,,,,,,,,,,,,,,,,,,,,,,,,,,,,,,,,,,,,,,,,,,,,,,,,215.0,me MNE,FWMF,32.0,9.9,0.0,0.0,0.0,8.0,19.0,6.0,8.0,2.0,2.0,0.0,0.0,0.0,35.0,14.0,28.0,33.3,Matches,215.0,me MNE,FWMF,32.0,9.9,316.0,297.0,17.0,4.0,3.0,4.0,8.0,4.0,1.0,0.0,0.0,0.0,200.0,2.0,12.0,Matches,215.0,me MNE,FWMF,32.0,9.9,200.0,316.0,63.3,3381.0,1339.0,101.0,144.0,70.1,61.0,100.0,61.0,24.0,32.0,75.0,2.0,1.1,1.0,0.9,14.0,37.0,9.0,2.0,40.0,Matches,244,me MNE,FWMF,32,17,892.0,52.0,29.2,9.9,8,81.0,5,9,27.0,2,0.76,16.0,20.0,-4.0,-0.4,0.55,13.8,18.4,-4.6,-0.46,0.2,Matches,215.0,me MNE,FWMF,32.0,9.9,416.0,12.0,41.0,214.0,164.0,39.0,416.0,21.0,10.0,47.6,7.0,33.3,261.0,1182.0,471.0,14.0,10.0,8.0,21.0,9.0,323.0,44.0,Matches,215.0,me MNE,FWMF,32.0,9.9,4.0,27.0,6.0,22.2,2.72,0.61,0.15,0.67,18.4,1.0,0.0,0.0,2.7,2.7,0.1,1.3,1.3,Matches,215.0,me MNE,FWMF,32.0,17.0,8.0,892.0,9.9,4.0,2.0,6.0,4.0,0.0,0.0,0.0,0.0,2.7,2.7,1.1,3.8,14.0,40.0,44.0,0.4,0.2,0.61,0.4,0.61,0.28,0.11,0.38,0.28,0.38,Matches,Stevan Jovetić,AM/S C,32,133,156,"Montenegro,Serbia",Hertha Berlin,12,13,15,15,16,14,13,14,4,4,15,16,6,16,11,13,12,15,13,16,14,11,17,12,14,7,11,11,10,12,14,11,10,10,12,12,13,9,15,16,13,3,1,2,1,1,3,1,2,3,2,3,15,15,7,13,15,14,15,15,1,1,1,1,1,1,1,1,1,1,13,17,10,20,183,79,12,20,5662014,7000,7250,5750,Northern_European,133,4,1989/11/2,63,31,40000.0,,5789007
68,Marcin Kamiński,Schalke 04,1992,224.0,pl POL,DF,30.0,7.0,6.0,4.0,4.0,0.0,2.0,2.0,4.0,50.0,2.0,8.0,7.0,1.0,9.0,15.0,28.0,0.0,Matches,224.0,pl POL,DF,30.0,7.0,12.0,1.71,11.0,0.0,1.0,0.0,0.0,0.0,1.0,0.14,1.0,0.0,0.0,0.0,0.0,0.0,Matches,,,,,,,,,,,,,,,,,,,,,,,,,,,,,,,,,,,,,,,,,,,,,,,,,,,,,,,,224.0,pl POL,DF,30.0,7.0,0.0,0.0,0.0,1.0,0.0,0.0,3.0,9.0,4.0,0.0,0.0,0.0,41.0,29.0,17.0,63.0,Matches,224.0,pl POL,DF,30.0,7.0,314.0,289.0,23.0,19.0,0.0,3.0,3.0,2.0,0.0,0.0,0.0,0.0,254.0,2.0,2.0,Matches,224.0,pl POL,DF,30.0,7.0,254.0,314.0,80.9,5229.0,2285.0,81.0,88.0,92.0,124.0,144.0,86.1,47.0,73.0,64.4,0.0,0.1,0.1,-0.1,2.0,20.0,1.0,0.0,25.0,Matches,254,pl POL,DF,30,8,632.0,79.0,20.7,7.0,7,90.0,7,1,2.0,10,1.5,13.0,22.0,-9.0,-1.28,-0.28,8.9,18.2,-9.2,-1.31,-1.0,Matches,224.0,pl POL,DF,30.0,7.0,380.0,48.0,206.0,152.0,24.0,4.0,380.0,1.0,1.0,100.0,0.0,0.0,171.0,643.0,387.0,2.0,1.0,0.0,4.0,1.0,191.0,3.0,Matches,224.0,pl POL,DF,30.0,7.0,2.0,4.0,2.0,50.0,0.57,0.28,0.5,1.0,16.4,2.0,0.0,0.0,0.4,0.4,0.1,1.6,1.6,Matches,224.0,pl POL,DF,30.0,8.0,7.0,632.0,7.0,2.0,0.0,2.0,2.0,0.0,0.0,0.0,0.0,0.4,0.4,0.1,0.5,2.0,25.0,3.0,0.28,0.0,0.28,0.28,0.28,0.06,0.02,0.07,0.06,0.07,Matches,Marcin Kamiński,D C,30,122,124,Poland,FC Schalke 04,4,8,8,8,11,12,13,8,6,14,13,8,13,11,11,13,12,14,14,11,13,11,8,12,8,14,12,11,11,9,14,14,11,12,12,13,12,6,13,10,12,3,2,2,3,3,3,1,2,2,1,1,14,12,4,14,10,13,15,16,1,12,20,1,8,1,14,1,12,1,1,1,1,6,192,84,20,10,295635,6100,5900,5000,Northern_European,122,5,1992/1/15,7,0,23014.0,,96008380
69,Thomas Kastanaras,Stuttgart,2003,229.0,gr GRE,FWDF,19.0,0.8,0.0,0.0,0.0,0.0,0.0,0.0,0.0,,0.0,1.0,0.0,1.0,0.0,0.0,0.0,0.0,Matches,229.0,gr GRE,FWDF,19.0,0.8,2.0,2.5,1.0,0.0,0.0,1.0,0.0,0.0,0.0,0.0,0.0,0.0,0.0,0.0,0.0,0.0,Matches,,,,,,,,,,,,,,,,,,,,,,,,,,,,,,,,,,,,,,,,,,,,,,,,,,,,,,,,229.0,gr GRE,FWDF,19.0,0.8,0.0,0.0,0.0,0.0,0.0,0.0,1.0,0.0,0.0,0.0,0.0,0.0,3.0,0.0,2.0,0.0,Matches,229.0,gr GRE,FWDF,19.0,0.8,17.0,15.0,2.0,0.0,0.0,0.0,1.0,0.0,0.0,0.0,0.0,0.0,14.0,0.0,2.0,Matches,229.0,gr GRE,FWDF,19.0,0.8,14.0,17.0,82.4,175.0,38.0,8.0,9.0,88.9,3.0,3.0,100.0,1.0,1.0,100.0,0.0,0.1,0.0,-0.1,1.0,2.0,1.0,1.0,2.0,Matches,259,gr GRE,FWDF,19,4,72.0,18.0,2.4,0.8,1,45.0,0,3,9.0,12,0.25,0.0,3.0,-3.0,-3.75,-3.48,1.1,0.8,0.3,0.32,0.26,Matches,229.0,gr GRE,FWDF,19.0,0.8,29.0,1.0,5.0,13.0,11.0,3.0,29.0,1.0,0.0,0.0,1.0,100.0,15.0,45.0,23.0,1.0,0.0,0.0,5.0,0.0,17.0,6.0,Matches,229.0,gr GRE,FWDF,19.0,0.8,0.0,2.0,1.0,50.0,2.5,1.25,0.0,0.0,13.7,0.0,0.0,0.0,0.3,0.3,0.13,-0.3,-0.3,Matches,229.0,gr GRE,FWDF,19.0,4.0,1.0,72.0,0.8,0.0,0.0,0.0,0.0,0.0,0.0,0.0,0.0,0.3,0.3,0.1,0.3,1.0,2.0,6.0,0.0,0.0,0.0,0.0,0.0,0.32,0.08,0.4,0.32,0.4,Matches,Thomas Kastanaras,S,19,109,-75,"Germany,Greece",VfB Stuttgart,4,7,11,13,12,12,13,9,4,4,11,14,5,12,11,13,12,12,11,11,10,13,13,5,13,5,11,12,12,12,12,12,13,12,12,12,13,6,14,7,7,2,1,1,1,3,4,2,1,3,3,3,11,14,4,15,12,15,14,15,1,1,1,1,1,1,1,5,1,1,12,14,12,20,186,80,12,20,40699999,5249,5249,3253,Mediterranean_Hispanic,109,4,2003/1/9,0,0,6711.0,,2000051522
70,Timothée Kolodziejczak,Schalke 04,1991,244.0,fr FRA,DF,30.0,0.3,0.0,0.0,0.0,0.0,0.0,0.0,1.0,0.0,1.0,0.0,0.0,0.0,1.0,1.0,1.0,0.0,Matches,244.0,fr FRA,DF,30.0,0.3,0.0,0.0,0.0,0.0,0.0,0.0,0.0,0.0,0.0,0.0,0.0,0.0,0.0,0.0,0.0,0.0,Matches,,,,,,,,,,,,,,,,,,,,,,,,,,,,,,,,,,,,,,,,,,,,,,,,,,,,,,,,244.0,fr FRA,DF,30.0,0.3,0.0,0.0,0.0,0.0,0.0,0.0,1.0,1.0,0.0,0.0,0.0,0.0,0.0,0.0,2.0,0.0,Matches,244.0,fr FRA,DF,30.0,0.3,17.0,14.0,3.0,0.0,0.0,0.0,1.0,3.0,0.0,0.0,0.0,0.0,14.0,0.0,0.0,Matches,244.0,fr FRA,DF,30.0,0.3,14.0,17.0,82.4,289.0,157.0,8.0,8.0,100.0,3.0,5.0,60.0,3.0,4.0,75.0,0.0,0.0,0.0,0.0,0.0,4.0,0.0,0.0,0.0,Matches,281,fr FRA,DF,30,1,25.0,25.0,0.8,0.3,0,,0,1,25.0,3,0.0,0.0,0.0,0.0,0.0,1.07,0.0,0.6,-0.6,-2.13,-1.62,Matches,244.0,fr FRA,DF,30.0,0.3,20.0,0.0,11.0,6.0,3.0,1.0,20.0,0.0,0.0,,0.0,,6.0,14.0,3.0,0.0,0.0,0.0,0.0,0.0,13.0,0.0,Matches,244.0,fr FRA,DF,30.0,0.3,0.0,0.0,0.0,,0.0,0.0,,,,0.0,0.0,0.0,0.0,0.0,,0.0,0.0,Matches,244.0,fr FRA,DF,30.0,1.0,0.0,25.0,0.3,0.0,0.0,0.0,0.0,0.0,0.0,0.0,0.0,0.0,0.0,0.0,0.0,0.0,0.0,0.0,0.0,0.0,0.0,0.0,0.0,0.0,0.0,0.0,0.0,0.0,Matches,Timothée Kolodziejczak,D LC,30,124,135,"France,Poland,Martinique",FC Schalke 04,5,11,9,7,10,5,13,7,16,14,12,9,13,11,15,12,17,11,13,10,11,16,8,11,10,13,14,14,12,12,16,13,16,14,15,15,12,10,14,7,10,1,3,1,2,1,4,3,2,1,1,1,14,15,7,10,13,13,14,14,1,17,20,1,15,1,1,1,1,1,1,1,1,1,185,75,20,6,839390,6200,6200,4700,Mixed_Race,124,12,1991/10/1,0,0,21095.0,,34011922
71,Filip Kostić,Eint Frankfurt,1992,247.0,rs SRB,DFMF,29.0,0.8,2.0,0.0,1.0,1.0,0.0,0.0,0.0,,0.0,0.0,0.0,0.0,1.0,3.0,0.0,0.0,Matches,247.0,rs SRB,DFMF,29.0,0.8,1.0,1.23,0.0,1.0,0.0,0.0,0.0,0.0,0.0,0.0,0.0,0.0,0.0,0.0,0.0,0.0,Matches,,,,,,,,,,,,,,,,,,,,,,,,,,,,,,,,,,,,,,,,,,,,,,,,,,,,,,,,247.0,rs SRB,DFMF,29.0,0.8,1.0,0.0,0.0,1.0,1.0,0.0,7.0,1.0,0.0,0.0,0.0,0.0,3.0,0.0,0.0,,Matches,247.0,rs SRB,DFMF,29.0,0.8,40.0,25.0,14.0,3.0,0.0,1.0,7.0,6.0,5.0,3.0,2.0,0.0,23.0,1.0,0.0,Matches,247.0,rs SRB,DFMF,29.0,0.8,23.0,40.0,57.5,469.0,260.0,8.0,11.0,72.7,12.0,16.0,75.0,3.0,11.0,27.3,0.0,0.1,0.1,-0.1,1.0,1.0,1.0,0.0,4.0,Matches,285,rs SRB,DFMF,29,1,74.0,74.0,2.4,0.8,1,74.0,0,0,,0,0.0,1.0,5.0,-4.0,-4.86,-5.17,0.8,3.5,-2.7,-3.35,-3.69,Matches,247.0,rs SRB,DFMF,29.0,0.8,45.0,0.0,10.0,16.0,20.0,3.0,45.0,3.0,1.0,33.3,1.0,33.3,23.0,172.0,105.0,3.0,1.0,1.0,0.0,1.0,23.0,3.0,Matches,247.0,rs SRB,DFMF,29.0,0.8,0.0,1.0,0.0,0.0,1.22,0.0,0.0,,21.1,0.0,0.0,0.0,0.0,0.0,0.02,0.0,0.0,Matches,247.0,rs SRB,DFMF,29.0,1.0,1.0,74.0,0.8,0.0,0.0,0.0,0.0,0.0,0.0,1.0,0.0,0.0,0.0,0.1,0.1,3.0,4.0,3.0,0.0,0.0,0.0,0.0,0.0,0.03,0.08,0.11,0.03,0.11,Matches,Filip Kostić,WB/M/AM L,29,148,155,Serbia,Juventus,15,18,13,10,13,12,6,13,10,7,15,11,8,14,13,11,14,11,11,13,12,15,12,7,13,8,13,14,15,13,16,10,16,16,16,13,13,8,13,5,16,1,3,2,1,3,1,2,3,1,1,2,13,17,12,10,14,13,10,12,1,10,1,1,18,1,1,20,10,14,18,10,14,1,184,84,20,7,18833967,7400,7400,6500,Mediterranean_Hispanic,138,6,1992/11/1,48,3,61731.0,,62070416
72,Max Kruse,Wolfsburg,1988,254.0,de GER,MFFW,34.0,3.0,1.0,1.0,0.0,1.0,0.0,0.0,1.0,0.0,1.0,2.0,1.0,1.0,0.0,1.0,1.0,0.0,Matches,254.0,de GER,MFFW,34.0,3.0,10.0,3.31,8.0,0.0,1.0,1.0,0.0,0.0,1.0,0.33,1.0,0.0,0.0,0.0,0.0,0.0,Matches,,,,,,,,,,,,,,,,,,,,,,,,,,,,,,,,,,,,,,,,,,,,,,,,,,,,,,,,254.0,de GER,MFFW,34.0,3.0,0.0,0.0,0.0,3.0,3.0,0.0,6.0,0.0,1.0,0.0,0.0,0.0,9.0,6.0,1.0,85.7,Matches,254.0,de GER,MFFW,34.0,3.0,121.0,105.0,16.0,3.0,1.0,3.0,6.0,8.0,2.0,0.0,0.0,0.0,90.0,0.0,8.0,Matches,254.0,de GER,MFFW,34.0,3.0,90.0,121.0,74.4,1644.0,240.0,36.0,49.0,73.5,42.0,48.0,87.5,9.0,12.0,75.0,0.0,0.1,0.2,-0.1,3.0,4.0,3.0,1.0,7.0,Matches,292,de GER,MFFW,34,5,272.0,54.0,8.9,3.0,2,90.0,2,3,31.0,0,0.4,3.0,6.0,-3.0,-0.99,-1.38,2.8,7.4,-4.6,-1.52,-1.67,Matches,254.0,de GER,MFFW,34.0,3.0,144.0,2.0,11.0,62.0,72.0,18.0,144.0,4.0,2.0,50.0,2.0,50.0,68.0,317.0,146.0,4.0,3.0,1.0,4.0,3.0,105.0,30.0,Matches,254.0,de GER,MFFW,34.0,3.0,0.0,9.0,2.0,22.2,2.98,0.66,0.0,0.0,13.9,0.0,0.0,0.0,0.7,0.7,0.08,-0.7,-0.7,Matches,254.0,de GER,MFFW,34.0,5.0,2.0,272.0,3.0,0.0,0.0,0.0,0.0,0.0,0.0,0.0,0.0,0.7,0.7,0.1,0.9,4.0,7.0,30.0,0.0,0.0,0.0,0.0,0.0,0.25,0.05,0.29,0.25,0.29,Matches,Max Kruse,AM/S RLC,34,136,149,Germany,VfL Wolfsburg,14,12,12,15,16,13,13,13,3,4,15,19,4,16,12,12,9,16,11,15,14,9,14,11,15,5,8,8,11,12,15,9,16,12,12,12,12,7,16,10,15,1,3,1,1,3,1,1,1,1,2,3,7,8,16,7,12,6,12,8,1,1,1,1,1,1,1,10,12,10,15,18,15,20,180,86,20,13,6698073,6600,6600,6100,Northern_European,132,5,1988/3/19,14,4,76711.0,,35008236
73,Pierre Kunde,Bochum,1995,256.0,cm CMR,MFFW,27.0,4.2,12.0,6.0,3.0,8.0,1.0,6.0,14.0,42.9,8.0,7.0,1.0,6.0,7.0,19.0,9.0,0.0,Matches,256.0,cm CMR,MFFW,27.0,4.2,7.0,1.67,5.0,1.0,0.0,0.0,1.0,0.0,0.0,0.0,0.0,0.0,0.0,0.0,0.0,0.0,Matches,,,,,,,,,,,,,,,,,,,,,,,,,,,,,,,,,,,,,,,,,,,,,,,,,,,,,,,,256.0,cm CMR,MFFW,27.0,4.2,0.0,0.0,0.0,3.0,10.0,1.0,8.0,7.0,6.0,0.0,0.0,0.0,42.0,4.0,6.0,40.0,Matches,256.0,cm CMR,MFFW,27.0,4.2,202.0,179.0,23.0,7.0,1.0,5.0,8.0,14.0,2.0,2.0,0.0,0.0,119.0,0.0,3.0,Matches,256.0,cm CMR,MFFW,27.0,4.2,119.0,202.0,58.9,2164.0,730.0,51.0,68.0,75.0,53.0,81.0,65.4,13.0,46.0,28.3,0.0,0.2,0.2,-0.2,4.0,18.0,3.0,2.0,16.0,Matches,294,cm CMR,MFFW,27,12,377.0,31.0,12.3,4.2,3,81.0,0,9,15.0,4,0.83,3.0,13.0,-10.0,-2.39,-1.65,4.2,12.2,-8.0,-1.92,-1.32,Matches,256.0,cm CMR,MFFW,27.0,4.2,265.0,11.0,60.0,155.0,57.0,3.0,265.0,9.0,5.0,55.6,4.0,44.4,123.0,671.0,312.0,6.0,7.0,0.0,11.0,2.0,122.0,1.0,Matches,256.0,cm CMR,MFFW,27.0,4.2,1.0,4.0,1.0,25.0,0.95,0.24,0.25,1.0,24.7,0.0,0.0,0.0,0.3,0.3,0.08,0.7,0.7,Matches,256.0,cm CMR,MFFW,27.0,12.0,3.0,377.0,4.2,1.0,0.0,1.0,1.0,0.0,0.0,0.0,0.0,0.3,0.3,0.2,0.5,6.0,16.0,1.0,0.24,0.0,0.24,0.24,0.24,0.08,0.05,0.13,0.08,0.13,Matches,Pierre Kunde,DM/M C,27,120,125,Cameroon,Olympiacos SF Piraeus,12,10,13,12,12,10,10,14,7,10,12,7,11,13,14,12,15,11,8,12,11,15,11,8,13,10,13,15,14,13,13,12,16,13,13,14,12,11,12,7,8,1,3,1,1,3,3,2,1,2,2,1,12,15,10,11,10,14,11,11,1,1,1,1,1,1,16,1,20,1,1,10,1,1,180,79,10,20,469625,5999,6249,3999,African_Caribbean,120,11,1995/7/26,29,1,16558.0,,67211690
74,Stefan Lainer,Gladbach,1992,262.0,at AUT,DF,29.0,9.1,16.0,8.0,10.0,5.0,1.0,10.0,23.0,43.5,13.0,8.0,1.0,7.0,14.0,30.0,34.0,1.0,Matches,262.0,at AUT,DF,29.0,9.1,13.0,1.43,11.0,1.0,0.0,0.0,1.0,0.0,0.0,0.0,0.0,0.0,0.0,0.0,0.0,0.0,Matches,,,,,,,,,,,,,,,,,,,,,,,,,,,,,,,,,,,,,,,,,,,,,,,,,,,,,,,,262.0,at AUT,DF,29.0,9.1,2.0,0.0,0.0,10.0,7.0,1.0,18.0,14.0,8.0,0.0,0.0,0.0,45.0,8.0,8.0,50.0,Matches,262.0,at AUT,DF,29.0,9.1,618.0,536.0,80.0,6.0,2.0,1.0,18.0,73.0,0.0,0.0,0.0,0.0,501.0,2.0,13.0,Matches,262.0,at AUT,DF,29.0,9.1,501.0,618.0,81.1,7802.0,2734.0,266.0,299.0,89.0,196.0,235.0,83.4,27.0,53.0,50.9,0.0,1.2,1.3,-1.2,8.0,38.0,13.0,7.0,45.0,Matches,301,at AUT,DF,29,17,817.0,48.0,26.7,9.1,9,83.0,2,8,9.0,12,1.47,12.0,20.0,-8.0,-0.88,-1.08,15.9,16.4,-0.4,-0.05,-0.01,Matches,262.0,at AUT,DF,29.0,9.1,720.0,37.0,203.0,383.0,136.0,20.0,720.0,11.0,2.0,18.2,8.0,72.7,382.0,1792.0,908.0,23.0,8.0,5.0,12.0,4.0,477.0,39.0,Matches,262.0,at AUT,DF,29.0,9.1,0.0,6.0,4.0,66.7,0.66,0.44,0.0,0.0,13.1,0.0,0.0,0.0,0.8,0.8,0.13,-0.8,-0.8,Matches,262.0,at AUT,DF,29.0,17.0,9.0,817.0,9.1,0.0,0.0,0.0,0.0,0.0,0.0,2.0,0.0,0.8,0.8,1.2,2.0,23.0,45.0,39.0,0.0,0.0,0.0,0.0,0.0,0.09,0.13,0.22,0.09,0.22,Matches,Stefan Lainer,D/WB R,29,128,137,Austria,Borussia Mönchengladbach,4,11,11,7,11,7,11,7,14,13,11,11,13,11,16,12,16,11,12,11,12,16,10,12,12,13,16,17,13,11,12,8,16,14,17,11,11,12,13,9,8,1,1,1,2,3,3,3,3,2,2,1,11,12,10,14,12,16,12,10,1,12,8,20,10,18,1,1,1,12,1,1,1,1,175,73,11,20,2859052,6400,6800,5400,Northern_European,125,4,1992/8/27,37,2,47944.0,,16014123
75,Jordan Larsson,Schalke 04,1997,264.0,se SWE,FWMF,25.0,5.1,8.0,5.0,1.0,7.0,0.0,2.0,9.0,22.2,7.0,9.0,0.0,9.0,4.0,12.0,3.0,0.0,Matches,264.0,se SWE,FWMF,25.0,5.1,11.0,2.13,9.0,1.0,1.0,0.0,0.0,0.0,0.0,0.0,0.0,0.0,0.0,0.0,0.0,0.0,Matches,,,,,,,,,,,,,,,,,,,,,,,,,,,,,,,,,,,,,,,,,,,,,,,,,,,,,,,,264.0,se SWE,FWMF,25.0,5.1,0.0,0.0,0.0,7.0,6.0,1.0,2.0,4.0,5.0,0.0,0.0,0.0,23.0,6.0,11.0,35.3,Matches,264.0,se SWE,FWMF,25.0,5.1,117.0,112.0,5.0,1.0,0.0,1.0,2.0,2.0,2.0,1.0,1.0,0.0,87.0,0.0,5.0,Matches,264.0,se SWE,FWMF,25.0,5.1,87.0,117.0,74.4,1236.0,400.0,49.0,58.0,84.5,27.0,33.0,81.8,4.0,10.0,40.0,0.0,0.4,0.6,-0.4,4.0,7.0,5.0,0.0,12.0,Matches,304,se SWE,FWMF,25,11,463.0,42.0,15.1,5.1,5,60.0,0,6,27.0,4,0.55,4.0,12.0,-8.0,-1.56,-0.58,5.1,8.8,-3.7,-0.71,-0.23,Matches,264.0,se SWE,FWMF,25.0,5.1,173.0,2.0,20.0,90.0,67.0,12.0,173.0,13.0,4.0,30.8,7.0,53.8,91.0,508.0,164.0,5.0,3.0,1.0,4.0,7.0,106.0,29.0,Matches,264.0,se SWE,FWMF,25.0,5.1,0.0,10.0,0.0,0.0,1.94,0.0,0.0,,16.7,0.0,0.0,0.0,1.2,1.2,0.12,-1.2,-1.2,Matches,264.0,se SWE,FWMF,25.0,11.0,5.0,463.0,5.1,0.0,0.0,0.0,0.0,0.0,0.0,0.0,0.0,1.2,1.2,0.4,1.7,5.0,12.0,29.0,0.0,0.0,0.0,0.0,0.0,0.24,0.09,0.32,0.24,0.32,Matches,Jordan Larsson,AM/S R,25,122,135,"Sweden,Cape Verde Islands",FC Schalke 04,13,11,14,12,13,13,11,12,3,5,12,12,5,14,14,12,8,12,9,12,10,13,14,5,13,6,10,9,16,14,12,7,13,15,12,8,11,11,11,7,8,1,1,3,3,3,1,3,3,1,1,1,12,12,9,5,11,12,12,9,1,1,1,1,1,1,1,10,1,10,13,10,18,20,175,68,20,9,1245776,6100,6000,5100,Mixed_Race,112,7,1997/6/20,3,1,28766.0,,93053655
76,Danny Latza,Schalke 04,1989,265.0,de GER,MF,32.0,9.5,17.0,13.0,8.0,8.0,1.0,5.0,17.0,29.4,12.0,16.0,1.0,15.0,5.0,22.0,15.0,0.0,Matches,265.0,de GER,MF,32.0,9.5,15.0,1.58,6.0,4.0,0.0,3.0,2.0,0.0,0.0,0.0,0.0,0.0,0.0,0.0,0.0,0.0,Matches,,,,,,,,,,,,,,,,,,,,,,,,,,,,,,,,,,,,,,,,,,,,,,,,,,,,,,,,265.0,de GER,MF,32.0,9.5,2.0,0.0,0.0,13.0,12.0,0.0,20.0,5.0,13.0,0.0,0.0,0.0,60.0,14.0,21.0,40.0,Matches,265.0,de GER,MF,32.0,9.5,394.0,356.0,37.0,17.0,2.0,2.0,20.0,2.0,10.0,5.0,3.0,1.0,310.0,1.0,10.0,Matches,265.0,de GER,MF,32.0,9.5,310.0,394.0,78.7,5376.0,1274.0,132.0,151.0,87.4,137.0,163.0,84.0,31.0,51.0,60.8,1.0,0.2,0.4,0.8,4.0,21.0,5.0,2.0,33.0,Matches,305,de GER,MF,32,20,853.0,43.0,27.9,9.5,8,81.0,5,12,17.0,7,0.8,12.0,28.0,-16.0,-1.69,-0.87,12.5,18.7,-6.2,-0.65,-0.19,Matches,265.0,de GER,MF,32.0,9.5,503.0,16.0,142.0,257.0,111.0,15.0,503.0,13.0,4.0,30.8,8.0,61.5,244.0,1080.0,561.0,11.0,3.0,1.0,7.0,8.0,282.0,15.0,Matches,265.0,de GER,MF,32.0,9.5,0.0,16.0,2.0,12.5,1.69,0.21,0.0,0.0,19.0,1.0,0.0,0.0,0.9,0.9,0.06,-0.9,-0.9,Matches,265.0,de GER,MF,32.0,20.0,8.0,853.0,9.5,0.0,1.0,1.0,0.0,0.0,0.0,2.0,0.0,0.9,0.9,0.2,1.1,11.0,33.0,15.0,0.0,0.11,0.11,0.0,0.11,0.1,0.02,0.12,0.09,0.12,Matches,Danny Latza,DM/M C,32,121,134,Germany,FC Schalke 04,12,11,10,9,12,13,12,12,6,12,13,12,12,12,16,12,16,12,12,12,12,12,10,16,13,12,16,17,11,10,12,11,13,11,14,11,12,14,10,14,17,3,3,2,1,3,3,1,3,3,3,2,7,13,10,13,10,12,9,9,1,1,12,12,1,10,18,12,20,12,10,14,10,1,179,76,12,20,475080,6050,6050,4050,Mediterranean_Hispanic,121,4,1989/12/7,0,0,25889.0,,35016428
77,Maxim Leitsch,Mainz 05,1998,267.0,de GER,DF,24.0,7.4,9.0,7.0,6.0,3.0,0.0,4.0,5.0,80.0,1.0,7.0,4.0,3.0,18.0,27.0,26.0,1.0,Matches,267.0,de GER,DF,24.0,7.4,5.0,0.68,5.0,0.0,0.0,0.0,0.0,0.0,1.0,0.14,1.0,0.0,0.0,0.0,0.0,0.0,Matches,,,,,,,,,,,,,,,,,,,,,,,,,,,,,,,,,,,,,,,,,,,,,,,,,,,,,,,,267.0,de GER,DF,24.0,7.4,0.0,0.0,0.0,3.0,3.0,0.0,0.0,18.0,7.0,0.0,0.0,0.0,35.0,18.0,13.0,58.1,Matches,267.0,de GER,DF,24.0,7.4,328.0,319.0,9.0,6.0,0.0,2.0,0.0,1.0,0.0,0.0,0.0,0.0,249.0,0.0,2.0,Matches,267.0,de GER,DF,24.0,7.4,249.0,328.0,75.9,4691.0,1687.0,105.0,127.0,82.7,114.0,142.0,80.3,27.0,50.0,54.0,0.0,0.0,0.1,0.0,1.0,16.0,1.0,0.0,25.0,Matches,308,de GER,DF,24,9,663.0,74.0,21.7,7.4,7,89.0,6,2,22.0,10,1.56,9.0,13.0,-4.0,-0.54,-0.66,9.0,10.6,-1.6,-0.22,-0.04,Matches,267.0,de GER,DF,24.0,7.4,405.0,42.0,188.0,205.0,12.0,2.0,405.0,1.0,0.0,0.0,1.0,100.0,203.0,957.0,443.0,5.0,0.0,1.0,5.0,1.0,225.0,1.0,Matches,267.0,de GER,DF,24.0,7.4,0.0,2.0,1.0,50.0,0.27,0.14,0.0,0.0,19.1,0.0,0.0,0.0,0.2,0.2,0.09,-0.2,-0.2,Matches,267.0,de GER,DF,24.0,9.0,7.0,663.0,7.4,0.0,0.0,0.0,0.0,0.0,0.0,0.0,0.0,0.2,0.2,0.0,0.2,5.0,25.0,1.0,0.0,0.0,0.0,0.0,0.0,0.02,0.0,0.03,0.02,0.03,Matches,Maxim Leitsch,D LC,24,128,138,Germany,1. FSV Mainz 05,4,8,8,6,11,12,13,6,8,14,12,7,13,11,12,13,14,12,14,11,13,13,8,8,8,13,13,14,13,11,15,14,14,16,12,13,13,4,15,13,9,2,2,3,3,2,2,3,2,1,1,4,8,13,6,13,12,15,15,17,1,15,20,1,12,1,1,1,1,1,1,1,1,1,188,75,20,10,3531771,6400,6400,4900,Northern_European,128,3,1998/5/18,0,0,19177.0,,92084880
78,Tim Lemperle,Köln,2002,268.0,de GER,FWMF,20.0,1.5,6.0,4.0,3.0,1.0,2.0,3.0,5.0,60.0,2.0,5.0,0.0,5.0,1.0,7.0,4.0,0.0,Matches,268.0,de GER,FWMF,20.0,1.5,7.0,4.81,4.0,0.0,2.0,1.0,0.0,0.0,0.0,0.0,0.0,0.0,0.0,0.0,0.0,0.0,Matches,,,,,,,,,,,,,,,,,,,,,,,,,,,,,,,,,,,,,,,,,,,,,,,,,,,,,,,,268.0,de GER,FWMF,20.0,1.5,0.0,0.0,0.0,2.0,0.0,0.0,1.0,1.0,4.0,0.0,0.0,0.0,15.0,4.0,8.0,33.3,Matches,268.0,de GER,FWMF,20.0,1.5,53.0,51.0,1.0,0.0,2.0,0.0,1.0,0.0,0.0,0.0,0.0,0.0,28.0,1.0,3.0,Matches,268.0,de GER,FWMF,20.0,1.5,28.0,53.0,52.8,344.0,123.0,17.0,26.0,65.4,5.0,12.0,41.7,2.0,4.0,50.0,0.0,1.0,1.0,-1.0,3.0,3.0,2.0,0.0,5.0,Matches,309,de GER,FWMF,20,12,132.0,11.0,4.3,1.5,0,,0,12,11.0,6,1.58,2.0,2.0,0.0,0.0,0.15,2.5,1.0,1.5,1.06,0.95,Matches,268.0,de GER,FWMF,20.0,1.5,85.0,4.0,13.0,37.0,38.0,9.0,85.0,8.0,3.0,37.5,5.0,62.5,49.0,234.0,82.0,1.0,2.0,2.0,6.0,6.0,53.0,16.0,Matches,268.0,de GER,FWMF,20.0,1.5,0.0,2.0,0.0,0.0,1.36,0.0,0.0,,12.6,0.0,0.0,0.0,0.1,0.1,0.06,-0.1,-0.1,Matches,268.0,de GER,FWMF,20.0,12.0,0.0,132.0,1.5,0.0,0.0,0.0,0.0,0.0,0.0,0.0,0.0,0.1,0.1,1.0,1.2,1.0,5.0,16.0,0.0,0.0,0.0,0.0,0.0,0.08,0.71,0.79,0.08,0.79,Matches,Tim Lemperle,AM/S RL,20,110,-75,Germany,1. FC Köln,10,10,13,11,13,11,11,11,6,5,12,11,5,13,10,10,9,8,10,13,7,13,14,7,11,5,7,9,13,12,10,13,12,14,12,9,9,8,10,10,12,2,3,2,1,3,1,2,1,3,1,3,7,13,7,13,13,13,13,13,1,1,1,1,7,7,1,13,7,13,18,13,20,16,187,78,10,20,26400001,5500,5500,3250,Northern_European,99,4,2002/2/5,0,0,3817.0,,91190494
79,Jamie Leweling,Union Berlin,2001,270.0,de GER,FWMF,21.0,2.9,5.0,3.0,2.0,2.0,1.0,3.0,5.0,60.0,2.0,3.0,0.0,3.0,1.0,6.0,0.0,0.0,Matches,270.0,de GER,FWMF,21.0,2.9,10.0,3.42,5.0,0.0,2.0,2.0,1.0,0.0,2.0,0.68,1.0,0.0,0.0,1.0,0.0,0.0,Matches,,,,,,,,,,,,,,,,,,,,,,,,,,,,,,,,,,,,,,,,,,,,,,,,,,,,,,,,270.0,de GER,FWMF,21.0,2.9,1.0,0.0,0.0,6.0,9.0,1.0,10.0,1.0,3.0,0.0,0.0,0.0,19.0,1.0,8.0,11.1,Matches,270.0,de GER,FWMF,21.0,2.9,57.0,55.0,2.0,0.0,0.0,0.0,10.0,1.0,0.0,0.0,0.0,0.0,39.0,0.0,2.0,Matches,270.0,de GER,FWMF,21.0,2.9,39.0,57.0,68.4,546.0,108.0,24.0,28.0,85.7,8.0,15.0,53.3,4.0,7.0,57.1,1.0,0.3,0.3,0.7,3.0,2.0,2.0,2.0,4.0,Matches,311,de GER,FWMF,21,16,265.0,17.0,8.7,2.9,0,,0,16,17.0,14,1.94,7.0,5.0,2.0,0.68,0.33,4.8,6.0,-1.2,-0.41,-0.3,Matches,270.0,de GER,FWMF,21.0,2.9,123.0,0.0,12.0,33.0,82.0,18.0,123.0,25.0,5.0,20.0,17.0,68.0,87.0,727.0,167.0,8.0,11.0,2.0,14.0,8.0,89.0,24.0,Matches,270.0,de GER,FWMF,21.0,2.9,1.0,9.0,5.0,55.6,3.06,1.7,0.11,0.2,16.7,0.0,0.0,0.0,0.7,0.7,0.07,0.3,0.3,Matches,270.0,de GER,FWMF,21.0,16.0,0.0,265.0,2.9,1.0,1.0,2.0,1.0,0.0,0.0,1.0,0.0,0.7,0.7,0.3,0.9,8.0,4.0,24.0,0.34,0.34,0.68,0.34,0.68,0.22,0.09,0.32,0.22,0.32,Matches,Jamie Leweling,AM/S RLC,21,124,145,"Germany,Ghana",1. FC Union Berlin,11,11,13,11,12,10,7,10,4,4,11,12,4,13,13,11,11,11,11,11,9,16,12,7,11,8,12,12,15,13,12,11,12,15,12,12,9,7,9,8,9,1,2,3,3,2,4,1,2,2,2,2,19,11,6,13,12,15,14,14,1,1,1,1,1,1,1,8,1,12,15,20,15,17,184,86,16,20,5400000,5900,5900,3700,African_Caribbean,117,12,2001/2/26,0,0,19177.0,,92103754
80,Dimitris Limnios,Köln,1998,273.0,gr GRE,FW,24.0,0.4,0.0,0.0,0.0,0.0,0.0,0.0,0.0,,0.0,0.0,0.0,0.0,1.0,1.0,0.0,0.0,Matches,273.0,gr GRE,FW,24.0,0.4,2.0,4.62,1.0,1.0,0.0,0.0,0.0,0.0,0.0,0.0,0.0,0.0,0.0,0.0,0.0,0.0,Matches,,,,,,,,,,,,,,,,,,,,,,,,,,,,,,,,,,,,,,,,,,,,,,,,,,,,,,,,273.0,gr GRE,FW,24.0,0.4,0.0,0.0,0.0,0.0,1.0,0.0,6.0,1.0,0.0,0.0,0.0,0.0,1.0,1.0,2.0,33.3,Matches,273.0,gr GRE,FW,24.0,0.4,23.0,20.0,3.0,0.0,0.0,0.0,6.0,0.0,3.0,1.0,2.0,0.0,13.0,0.0,2.0,Matches,273.0,gr GRE,FW,24.0,0.4,13.0,23.0,56.5,190.0,28.0,7.0,8.0,87.5,4.0,8.0,50.0,1.0,3.0,33.3,0.0,0.1,0.1,-0.1,2.0,1.0,0.0,0.0,0.0,Matches,314,gr GRE,FW,24,2,39.0,20.0,1.3,0.4,0,,0,2,20.0,6,0.5,0.0,1.0,-1.0,-2.31,-2.19,0.9,1.3,-0.4,-0.85,-1.02,Matches,273.0,gr GRE,FW,24.0,0.4,28.0,0.0,2.0,10.0,16.0,3.0,28.0,2.0,2.0,100.0,0.0,0.0,18.0,98.0,54.0,2.0,0.0,0.0,0.0,1.0,18.0,7.0,Matches,273.0,gr GRE,FW,24.0,0.4,0.0,1.0,0.0,0.0,2.31,0.0,0.0,,19.5,0.0,0.0,0.0,0.0,0.0,0.02,0.0,0.0,Matches,273.0,gr GRE,FW,24.0,2.0,0.0,39.0,0.4,0.0,0.0,0.0,0.0,0.0,0.0,0.0,0.0,0.0,0.0,0.1,0.1,2.0,0.0,7.0,0.0,0.0,0.0,0.0,0.0,0.05,0.21,0.26,0.05,0.26,Matches,Dimitris Limnios,M/AM RL,24,120,130,"Greece,Brazil",1. FC Köln,10,12,12,10,12,11,9,9,8,9,10,11,8,12,11,11,10,11,10,12,11,13,12,7,13,9,12,14,15,14,9,11,15,15,14,10,12,6,13,4,11,3,3,2,2,2,3,3,4,3,3,2,9,15,8,12,13,13,12,13,1,1,1,1,1,12,1,16,1,16,16,7,20,6,180,71,7,20,685175,5750,6250,4250,Mediterranean_Hispanic,118,2,1998/5/27,23,3,10000.0,,36096206
81,Myziane Maolida,Hertha BSC,1999,283.0,km COM,FWMF,23.0,1.1,1.0,1.0,1.0,0.0,0.0,1.0,2.0,50.0,1.0,0.0,0.0,0.0,0.0,1.0,1.0,0.0,Matches,283.0,km COM,FWMF,23.0,1.1,1.0,0.95,1.0,0.0,0.0,0.0,0.0,0.0,0.0,0.0,0.0,0.0,0.0,0.0,0.0,0.0,Matches,,,,,,,,,,,,,,,,,,,,,,,,,,,,,,,,,,,,,,,,,,,,,,,,,,,,,,,,283.0,km COM,FWMF,23.0,1.1,0.0,0.0,0.0,1.0,0.0,0.0,1.0,0.0,1.0,0.0,0.0,0.0,3.0,0.0,1.0,0.0,Matches,283.0,km COM,FWMF,23.0,1.1,15.0,14.0,0.0,0.0,0.0,0.0,1.0,0.0,0.0,0.0,0.0,0.0,8.0,1.0,0.0,Matches,283.0,km COM,FWMF,23.0,1.1,8.0,15.0,53.3,129.0,30.0,4.0,7.0,57.1,3.0,6.0,50.0,1.0,1.0,100.0,0.0,0.2,0.5,-0.2,1.0,1.0,0.0,0.0,0.0,Matches,329,km COM,FWMF,23,3,95.0,32.0,3.1,1.1,1,55.0,0,2,20.0,7,0.0,1.0,3.0,-2.0,-1.89,-1.14,0.6,1.2,-0.7,-0.62,-0.01,Matches,283.0,km COM,FWMF,23.0,1.1,26.0,0.0,3.0,13.0,10.0,3.0,26.0,4.0,2.0,50.0,2.0,50.0,21.0,109.0,26.0,1.0,1.0,0.0,3.0,5.0,20.0,9.0,Matches,283.0,km COM,FWMF,23.0,1.1,0.0,0.0,0.0,,0.0,0.0,,,,0.0,0.0,0.0,0.0,0.0,,0.0,0.0,Matches,283.0,km COM,FWMF,23.0,3.0,1.0,95.0,1.1,0.0,0.0,0.0,0.0,0.0,0.0,0.0,0.0,0.0,0.0,0.2,0.2,1.0,0.0,9.0,0.0,0.0,0.0,0.0,0.0,0.0,0.22,0.22,0.0,0.22,Matches,Myziane Maolida,AM/S RL,23,122,135,"France,Comoros",Hertha Berlin,4,11,15,11,14,6,8,12,4,4,10,8,4,14,9,9,10,8,8,10,8,12,14,7,14,8,11,10,16,14,14,9,16,16,12,15,11,13,13,10,12,2,1,3,1,3,1,2,2,1,3,3,13,14,1,12,10,12,12,12,1,1,1,1,1,1,1,1,1,1,19,1,15,20,182,78,8,20,2457789,6046,6196,4496,African_Caribbean,108,14,1999/2/14,0,0,2225.0,,48039186
82,Philipp Max,Eint Frankfurt,1993,290.0,de GER,DF,28.0,7.7,12.0,9.0,4.0,7.0,1.0,5.0,16.0,31.3,11.0,10.0,2.0,8.0,3.0,15.0,11.0,0.0,Matches,290.0,de GER,DF,28.0,7.7,31.0,4.02,17.0,11.0,1.0,2.0,0.0,0.0,1.0,0.13,1.0,0.0,0.0,0.0,0.0,0.0,Matches,,,,,,,,,,,,,,,,,,,,,,,,,,,,,,,,,,,,,,,,,,,,,,,,,,,,,,,,290.0,de GER,DF,28.0,7.7,1.0,0.0,0.0,6.0,2.0,1.0,60.0,3.0,9.0,0.0,0.0,0.0,31.0,5.0,6.0,45.5,Matches,290.0,de GER,DF,28.0,7.7,479.0,358.0,120.0,14.0,0.0,0.0,60.0,80.0,26.0,18.0,4.0,0.0,364.0,1.0,12.0,Matches,290.0,de GER,DF,28.0,7.7,364.0,479.0,76.0,5827.0,2134.0,198.0,219.0,90.4,134.0,169.0,79.3,29.0,74.0,39.2,1.0,1.6,2.4,-0.6,16.0,28.0,18.0,9.0,34.0,Matches,337,de GER,DF,28,10,694.0,69.0,22.7,7.7,8,79.0,3,2,32.0,0,1.2,11.0,13.0,-2.0,-0.26,-0.56,11.7,10.0,1.7,0.23,-0.04,Matches,290.0,de GER,DF,28.0,7.7,541.0,20.0,107.0,230.0,206.0,16.0,541.0,7.0,3.0,42.9,3.0,42.9,275.0,1159.0,546.0,14.0,7.0,0.0,8.0,3.0,329.0,52.0,Matches,290.0,de GER,DF,28.0,7.7,0.0,9.0,3.0,33.3,1.17,0.39,0.0,0.0,18.3,2.0,0.0,0.0,0.7,0.7,0.08,-0.7,-0.7,Matches,290.0,de GER,DF,28.0,10.0,8.0,694.0,7.7,0.0,1.0,1.0,0.0,0.0,0.0,1.0,0.0,0.7,0.7,1.6,2.3,14.0,34.0,52.0,0.0,0.13,0.13,0.0,0.13,0.09,0.21,0.3,0.09,0.3,Matches,Philipp Max,D/WB L,28,140,147,Germany,PSV Eindhoven,13,16,12,9,13,14,8,9,14,10,13,15,12,12,13,10,14,12,11,13,12,15,12,10,11,10,15,15,15,12,14,9,15,15,15,11,12,10,15,5,15,3,2,1,3,3,3,3,1,1,2,2,10,18,6,10,11,17,13,13,1,20,1,12,20,12,8,15,8,10,15,1,10,1,177,77,20,10,17040376,7000,7000,5750,Northern_European,128,3,1993/9/30,3,0,22998.0,,91100531
83,Noah Mbamba,Leverkusen,2005,295.0,be BEL,MF,17.0,0.0,0.0,0.0,0.0,0.0,0.0,0.0,0.0,,0.0,0.0,0.0,0.0,0.0,0.0,0.0,0.0,Matches,295.0,be BEL,MF,17.0,0.0,0.0,0.0,0.0,0.0,0.0,0.0,0.0,0.0,0.0,0.0,0.0,0.0,0.0,0.0,0.0,0.0,Matches,,,,,,,,,,,,,,,,,,,,,,,,,,,,,,,,,,,,,,,,,,,,,,,,,,,,,,,,295.0,be BEL,MF,17.0,0.0,0.0,0.0,0.0,0.0,0.0,0.0,0.0,0.0,0.0,0.0,0.0,0.0,0.0,0.0,0.0,,Matches,295.0,be BEL,MF,17.0,0.0,0.0,0.0,0.0,0.0,0.0,0.0,0.0,0.0,0.0,0.0,0.0,0.0,0.0,0.0,0.0,Matches,295.0,be BEL,MF,17.0,0.0,0.0,0.0,,0.0,0.0,0.0,0.0,,0.0,0.0,,0.0,0.0,,0.0,0.0,0.0,0.0,0.0,0.0,0.0,0.0,0.0,Matches,342,be BEL,MF,17,1,1.0,1.0,0.0,0.0,0,,0,1,1.0,11,0.0,0.0,0.0,0.0,0.0,-0.24,0.0,0.0,0.0,0.0,-0.25,Matches,295.0,be BEL,MF,17.0,0.0,0.0,0.0,0.0,0.0,0.0,0.0,0.0,0.0,0.0,,0.0,,0.0,0.0,0.0,0.0,0.0,0.0,0.0,0.0,0.0,0.0,Matches,295.0,be BEL,MF,17.0,0.0,0.0,0.0,0.0,,0.0,0.0,,,,0.0,0.0,0.0,0.0,0.0,,0.0,0.0,Matches,295.0,be BEL,MF,17.0,1.0,0.0,1.0,0.0,0.0,0.0,0.0,0.0,0.0,0.0,0.0,0.0,0.0,0.0,0.0,0.0,0.0,0.0,0.0,0.0,0.0,0.0,0.0,0.0,0.0,0.0,0.0,0.0,0.0,Matches,Noah Mbamba,DM,17,97,-8,Belgium,Club Brugge KV,6,6,11,5,13,8,12,7,8,13,14,10,12,13,8,11,9,13,10,10,9,10,13,8,10,10,10,11,13,11,12,13,13,13,12,13,11,8,10,10,12,1,3,1,2,3,1,2,3,3,4,4,7,11,1,10,13,10,7,16,1,1,14,1,1,1,20,1,14,1,1,1,1,1,187,0,8,20,25600000,5296,5296,2996,African_Caribbean,97,18,2005/1/5,0,0,1249.0,,2000084166
84,Jean-Manuel Mbom,Werder Bremen,2000,296.0,de GER,MF,22.0,0.1,0.0,0.0,0.0,0.0,0.0,0.0,1.0,0.0,1.0,0.0,0.0,0.0,0.0,0.0,0.0,0.0,Matches,296.0,de GER,MF,22.0,0.1,0.0,0.0,0.0,0.0,0.0,0.0,0.0,0.0,0.0,0.0,0.0,0.0,0.0,0.0,0.0,0.0,Matches,,,,,,,,,,,,,,,,,,,,,,,,,,,,,,,,,,,,,,,,,,,,,,,,,,,,,,,,296.0,de GER,MF,22.0,0.1,0.0,0.0,0.0,1.0,1.0,0.0,0.0,0.0,0.0,0.0,0.0,0.0,0.0,0.0,2.0,0.0,Matches,296.0,de GER,MF,22.0,0.1,3.0,3.0,0.0,0.0,0.0,0.0,0.0,0.0,0.0,0.0,0.0,0.0,2.0,0.0,0.0,Matches,296.0,de GER,MF,22.0,0.1,2.0,3.0,66.7,47.0,39.0,0.0,1.0,0.0,1.0,1.0,100.0,1.0,1.0,100.0,0.0,0.0,0.0,0.0,0.0,2.0,0.0,0.0,1.0,Matches,343,de GER,MF,22,2,6.0,3.0,0.2,0.1,0,,0,2,3.0,9,0.0,0.0,2.0,-2.0,-30.0,-29.68,0.0,1.1,-1.1,-16.22,-15.9,Matches,296.0,de GER,MF,22.0,0.1,3.0,0.0,0.0,3.0,0.0,0.0,3.0,0.0,0.0,,0.0,,1.0,2.0,0.0,0.0,0.0,0.0,0.0,0.0,3.0,0.0,Matches,296.0,de GER,MF,22.0,0.1,0.0,0.0,0.0,,0.0,0.0,,,,0.0,0.0,0.0,0.0,0.0,,0.0,0.0,Matches,296.0,de GER,MF,22.0,2.0,0.0,6.0,0.1,0.0,0.0,0.0,0.0,0.0,0.0,0.0,0.0,0.0,0.0,0.0,0.0,0.0,1.0,0.0,0.0,0.0,0.0,0.0,0.0,0.0,0.0,0.0,0.0,0.0,Matches,Jean-Manuel Mbom,DM/M RC,22,122,139,"Germany,Cameroon",SV Werder Bremen,9,9,10,10,11,12,10,12,8,9,12,14,10,13,15,12,16,14,12,13,12,15,12,12,10,10,14,14,13,12,14,12,17,12,14,14,12,10,16,10,15,1,2,1,1,2,2,3,2,2,2,1,10,14,8,12,16,13,13,10,1,12,1,15,1,14,20,12,18,12,1,10,1,1,183,79,10,20,3549999,6100,6000,4250,Mixed_Race,117,14,2000/2/24,0,0,3288.0,,92083876
85,Thomas Meunier,Dortmund,1991,298.0,be BEL,DF,30.0,6.5,16.0,7.0,8.0,5.0,3.0,10.0,17.0,58.8,7.0,7.0,2.0,5.0,9.0,25.0,16.0,0.0,Matches,298.0,be BEL,DF,30.0,6.5,17.0,2.62,15.0,1.0,0.0,0.0,1.0,0.0,0.0,0.0,0.0,0.0,0.0,0.0,0.0,0.0,Matches,,,,,,,,,,,,,,,,,,,,,,,,,,,,,,,,,,,,,,,,,,,,,,,,,,,,,,,,298.0,be BEL,DF,30.0,6.5,2.0,0.0,0.0,12.0,4.0,1.0,16.0,9.0,7.0,0.0,0.0,0.0,44.0,7.0,3.0,70.0,Matches,298.0,be BEL,DF,30.0,6.5,435.0,368.0,67.0,5.0,1.0,3.0,16.0,62.0,0.0,0.0,0.0,0.0,322.0,0.0,14.0,Matches,298.0,be BEL,DF,30.0,6.5,322.0,435.0,74.0,5628.0,2069.0,146.0,173.0,84.4,130.0,170.0,76.5,34.0,59.0,57.6,0.0,0.6,0.8,-0.6,6.0,27.0,11.0,5.0,30.0,Matches,345,be BEL,DF,30,10,585.0,59.0,19.1,6.5,7,77.0,5,3,15.0,6,2.1,5.0,9.0,-4.0,-0.62,-2.18,11.0,8.8,2.2,0.34,-0.59,Matches,298.0,be BEL,DF,30.0,6.5,503.0,25.0,131.0,213.0,162.0,11.0,503.0,10.0,4.0,40.0,4.0,40.0,273.0,1150.0,556.0,9.0,7.0,1.0,8.0,5.0,306.0,45.0,Matches,298.0,be BEL,DF,30.0,6.5,0.0,4.0,0.0,0.0,0.62,0.0,0.0,,26.5,0.0,0.0,0.0,0.2,0.2,0.04,-0.2,-0.2,Matches,298.0,be BEL,DF,30.0,10.0,7.0,585.0,6.5,0.0,0.0,0.0,0.0,0.0,0.0,2.0,0.0,0.2,0.2,0.6,0.7,9.0,30.0,45.0,0.0,0.0,0.0,0.0,0.0,0.03,0.09,0.12,0.03,0.12,Matches,Thomas Meunier,D/WB R,30,134,145,Belgium,Borussia Dortmund,8,15,13,10,11,10,13,12,8,11,11,3,14,13,14,13,15,12,13,13,10,16,12,8,15,10,16,16,13,11,15,14,15,15,15,16,13,8,14,12,14,1,3,2,1,3,1,1,2,1,3,1,11,16,8,15,11,17,14,16,1,1,10,20,1,18,10,8,12,15,8,6,10,10,191,90,8,20,8776634,6900,7300,6250,Northern_European,128,2,1991/9/12,56,8,191781.0,,18043393
86,Alexander Meyer,Dortmund,1991,299.0,de GER,GK,31.0,7.0,0.0,0.0,0.0,0.0,0.0,0.0,1.0,0.0,1.0,0.0,0.0,0.0,0.0,0.0,1.0,0.0,Matches,299.0,de GER,GK,31.0,7.0,1.0,0.14,1.0,0.0,0.0,0.0,0.0,0.0,0.0,0.0,0.0,0.0,0.0,0.0,0.0,0.0,Matches,17.0,de GER,GK,31.0,7.0,12.0,0.0,0.0,2.0,0.0,7.9,0.25,-4.1,-0.58,24.0,60.0,40.0,278.0,35.0,16.2,27.3,44.0,34.1,35.0,91.0,8.0,8.8,18.0,2.57,19.8,Matches,17.0,de GER,GK,31.0,7.0,7.0,630.0,7.0,12.0,1.71,32.0,20.0,62.5,3.0,2.0,2.0,1.0,14.3,0.0,0.0,0.0,0.0,,Matches,299.0,de GER,GK,31.0,7.0,0.0,0.0,0.0,0.0,0.0,0.0,0.0,0.0,0.0,0.0,0.0,0.0,14.0,1.0,0.0,100.0,Matches,299.0,de GER,GK,31.0,7.0,323.0,261.0,61.0,17.0,0.0,1.0,0.0,0.0,0.0,0.0,0.0,0.0,280.0,1.0,2.0,Matches,299.0,de GER,GK,31.0,7.0,280.0,323.0,86.7,6953.0,4124.0,56.0,57.0,98.2,145.0,146.0,99.3,79.0,117.0,67.5,0.0,0.0,0.0,0.0,0.0,4.0,0.0,0.0,1.0,Matches,346,de GER,GK,31,7,630.0,90.0,20.6,7.0,7,90.0,7,0,,27,1.57,15.0,12.0,3.0,0.43,-0.9,12.9,9.9,3.0,0.43,-0.49,Matches,299.0,de GER,GK,31.0,7.0,335.0,230.0,327.0,7.0,1.0,1.0,335.0,0.0,0.0,,0.0,,216.0,1193.0,669.0,0.0,0.0,0.0,0.0,0.0,186.0,0.0,Matches,299.0,de GER,GK,31.0,7.0,0.0,0.0,0.0,,0.0,0.0,,,,0.0,0.0,0.0,0.0,0.0,,0.0,0.0,Matches,299.0,de GER,GK,31.0,7.0,7.0,630.0,7.0,0.0,0.0,0.0,0.0,0.0,0.0,0.0,0.0,0.0,0.0,0.0,0.0,0.0,1.0,0.0,0.0,0.0,0.0,0.0,0.0,0.0,0.0,0.0,0.0,0.0,Matches,Alexander Meyer,GK,31,120,122,Germany,Borussia Dortmund,2,2,1,3,10,5,1,3,3,3,13,2,3,9,10,13,16,12,8,11,10,12,1,12,3,10,13,14,9,11,13,18,14,8,9,15,13,5,12,8,13,16,10,11,5,15,12,12,14,8,6,11,7,12,7,14,14,14,14,14,20,1,1,1,1,1,1,1,1,1,1,1,1,1,195,90,6,20,166154,5470,5470,3470,Northern_European,114,4,1991/4/13,0,0,4499.0,,91018450
87,Sven Michel,Union Berlin,1990,300.0,de GER,FWMF,32.0,5.5,9.0,5.0,1.0,5.0,3.0,4.0,8.0,50.0,4.0,5.0,1.0,4.0,0.0,9.0,4.0,0.0,Matches,300.0,de GER,FWMF,32.0,5.5,13.0,2.36,12.0,0.0,1.0,0.0,0.0,0.0,2.0,0.36,2.0,0.0,0.0,0.0,0.0,0.0,Matches,,,,,,,,,,,,,,,,,,,,,,,,,,,,,,,,,,,,,,,,,,,,,,,,,,,,,,,,300.0,de GER,FWMF,32.0,5.5,2.0,0.0,0.0,13.0,4.0,4.0,17.0,0.0,5.0,0.0,0.0,0.0,29.0,25.0,46.0,35.2,Matches,300.0,de GER,FWMF,32.0,5.5,181.0,176.0,3.0,0.0,2.0,0.0,17.0,1.0,1.0,0.0,0.0,0.0,100.0,2.0,11.0,Matches,300.0,de GER,FWMF,32.0,5.5,100.0,181.0,55.2,1279.0,290.0,66.0,93.0,71.0,19.0,39.0,48.7,6.0,18.0,33.3,1.0,0.9,0.3,0.1,7.0,9.0,4.0,2.0,12.0,Matches,347,de GER,FWMF,32,21,495.0,24.0,16.2,5.5,2,74.0,1,19,18.0,11,1.62,8.0,5.0,3.0,0.55,0.19,6.9,5.3,1.6,0.29,0.51,Matches,300.0,de GER,FWMF,32.0,5.5,259.0,5.0,25.0,85.0,152.0,20.0,258.0,12.0,3.0,25.0,9.0,75.0,121.0,585.0,164.0,9.0,3.0,1.0,20.0,7.0,183.0,50.0,Matches,300.0,de GER,FWMF,32.0,5.5,3.0,15.0,2.0,13.3,2.73,0.36,0.13,1.0,24.2,0.0,1.0,1.0,1.7,0.9,0.06,1.3,1.1,Matches,300.0,de GER,FWMF,32.0,21.0,2.0,495.0,5.5,3.0,1.0,4.0,2.0,1.0,1.0,2.0,0.0,1.7,0.9,0.9,1.8,9.0,12.0,50.0,0.55,0.18,0.73,0.36,0.55,0.3,0.16,0.46,0.16,0.32,Matches,Sven Michel,M/AM/S L,32,130,130,Germany,1. FC Union Berlin,9,11,13,14,12,9,9,13,8,6,12,9,7,12,16,14,14,11,9,14,9,17,12,9,14,7,12,16,15,14,11,9,15,15,13,12,13,5,11,12,10,3,2,3,1,1,1,3,1,3,3,3,6,13,10,11,14,10,8,6,1,1,1,1,1,1,1,18,8,12,18,10,12,20,179,81,20,9,1699495,6249,6249,4016,Northern_European,120,2,1990/7/15,0,0,15341.0,,91127780
88,Enzo Millot,Stuttgart,2002,301.0,fr FRA,MF,20.0,9.9,23.0,16.0,9.0,10.0,4.0,12.0,19.0,63.2,7.0,20.0,3.0,17.0,12.0,35.0,7.0,0.0,Matches,301.0,fr FRA,MF,20.0,9.9,34.0,3.43,21.0,2.0,4.0,2.0,3.0,2.0,3.0,0.3,2.0,0.0,1.0,0.0,0.0,0.0,Matches,,,,,,,,,,,,,,,,,,,,,,,,,,,,,,,,,,,,,,,,,,,,,,,,,,,,,,,,301.0,fr FRA,MF,20.0,9.9,3.0,0.0,0.0,16.0,19.0,1.0,23.0,12.0,16.0,0.0,1.0,0.0,46.0,8.0,15.0,34.8,Matches,301.0,fr FRA,MF,20.0,9.9,396.0,372.0,22.0,5.0,2.0,1.0,23.0,6.0,6.0,3.0,3.0,0.0,311.0,2.0,10.0,Matches,301.0,fr FRA,MF,20.0,9.9,311.0,396.0,78.5,4366.0,1069.0,176.0,207.0,85.0,107.0,122.0,87.7,13.0,28.0,46.4,1.0,1.6,2.2,-0.6,12.0,22.0,12.0,4.0,29.0,Matches,348,fr FRA,MF,20,23,890.0,39.0,29.1,9.9,9,73.0,2,14,17.0,6,1.04,14.0,19.0,-5.0,-0.51,-0.22,14.7,16.4,-1.7,-0.17,-0.34,Matches,301.0,fr FRA,MF,20.0,9.9,545.0,15.0,94.0,264.0,196.0,35.0,545.0,46.0,21.0,45.7,19.0,41.3,285.0,1785.0,729.0,23.0,14.0,7.0,18.0,13.0,354.0,58.0,Matches,301.0,fr FRA,MF,20.0,9.9,0.0,17.0,7.0,41.2,1.72,0.71,0.0,0.0,18.0,1.0,0.0,0.0,1.2,1.2,0.07,-1.2,-1.2,Matches,301.0,fr FRA,MF,20.0,23.0,9.0,890.0,9.9,0.0,1.0,1.0,0.0,0.0,0.0,3.0,0.0,1.2,1.2,1.6,2.8,23.0,29.0,58.0,0.0,0.1,0.1,0.0,0.1,0.12,0.16,0.29,0.12,0.29,Matches,Enzo Millot,M/AM RLC,20,110,-8,"France,Martinique",VfB Stuttgart,10,12,12,8,13,11,8,11,3,3,13,11,5,13,11,12,13,13,11,14,12,13,13,10,12,9,13,13,13,13,11,8,13,12,12,8,12,7,12,10,12,1,2,2,3,3,2,2,2,1,3,2,10,14,6,10,14,14,12,14,1,1,1,1,1,1,8,12,20,12,16,18,16,1,175,0,20,9,60352001,5495,5495,3495,African_Caribbean,104,12,2002/7/17,0,0,7691.0,,49048469
89,Maximilian Mittelstädt,Hertha BSC,1997,302.0,de GER,DFMF,25.0,9.4,39.0,20.0,31.0,6.0,2.0,17.0,39.0,43.6,22.0,13.0,2.0,11.0,26.0,65.0,27.0,0.0,Matches,302.0,de GER,DFMF,25.0,9.4,23.0,2.44,15.0,2.0,2.0,2.0,1.0,1.0,0.0,0.0,0.0,0.0,0.0,0.0,0.0,0.0,Matches,,,,,,,,,,,,,,,,,,,,,,,,,,,,,,,,,,,,,,,,,,,,,,,,,,,,,,,,302.0,de GER,DFMF,25.0,9.4,5.0,0.0,0.0,13.0,9.0,0.0,39.0,26.0,20.0,0.0,1.0,0.0,84.0,10.0,16.0,38.5,Matches,302.0,de GER,DFMF,25.0,9.4,472.0,347.0,123.0,5.0,1.0,5.0,39.0,105.0,13.0,4.0,8.0,0.0,326.0,2.0,11.0,Matches,302.0,de GER,DFMF,25.0,9.4,326.0,472.0,69.1,5021.0,2310.0,182.0,206.0,88.3,113.0,168.0,67.3,21.0,74.0,28.4,0.0,0.8,1.2,-0.8,11.0,29.0,7.0,4.0,37.0,Matches,349,de GER,DFMF,25,17,849.0,50.0,27.7,9.4,7,79.0,4,10,30.0,14,0.94,9.0,15.0,-6.0,-0.64,0.22,11.5,17.4,-5.9,-0.63,-0.03,Matches,302.0,de GER,DFMF,25.0,9.4,616.0,33.0,223.0,281.0,126.0,8.0,616.0,33.0,19.0,57.6,12.0,36.4,261.0,1789.0,982.0,29.0,19.0,4.0,12.0,9.0,253.0,29.0,Matches,302.0,de GER,DFMF,25.0,9.4,0.0,6.0,2.0,33.3,0.64,0.21,0.0,0.0,23.4,0.0,0.0,0.0,0.3,0.3,0.05,-0.3,-0.3,Matches,302.0,de GER,DFMF,25.0,17.0,7.0,849.0,9.4,0.0,0.0,0.0,0.0,0.0,0.0,5.0,0.0,0.3,0.3,0.8,1.1,29.0,37.0,29.0,0.0,0.0,0.0,0.0,0.0,0.03,0.09,0.12,0.03,0.12,Matches,Maximilian Mittelstädt,D/WB/M L,25,133,141,Germany,Hertha Berlin,12,13,13,6,14,11,12,11,12,10,14,10,12,14,13,10,14,13,10,12,10,14,13,11,11,9,14,16,14,14,12,12,13,14,15,11,9,12,13,7,16,3,1,1,1,4,3,4,1,1,1,1,7,12,6,15,11,12,14,10,1,20,1,8,20,8,14,18,14,5,14,1,1,1,180,71,20,9,4470057,6641,6641,4741,Northern_European,123,4,1997/3/18,0,0,26849.0,,91143714
90,Anthony Modeste,Dortmund,1988,303.0,fr FRA,FW,34.0,9.0,4.0,4.0,2.0,0.0,2.0,2.0,5.0,40.0,3.0,7.0,0.0,7.0,2.0,6.0,22.0,0.0,Matches,303.0,fr FRA,FW,34.0,9.0,12.0,1.33,10.0,0.0,0.0,2.0,0.0,0.0,1.0,0.11,1.0,0.0,0.0,0.0,0.0,0.0,Matches,,,,,,,,,,,,,,,,,,,,,,,,,,,,,,,,,,,,,,,,,,,,,,,,,,,,,,,,303.0,fr FRA,FW,34.0,9.0,4.0,0.0,0.0,14.0,7.0,6.0,2.0,2.0,4.0,0.0,0.0,0.0,15.0,33.0,37.0,47.1,Matches,303.0,fr FRA,FW,34.0,9.0,127.0,117.0,6.0,0.0,0.0,0.0,2.0,0.0,0.0,0.0,0.0,0.0,73.0,4.0,1.0,Matches,303.0,fr FRA,FW,34.0,9.0,73.0,127.0,57.5,940.0,170.0,40.0,60.0,66.7,22.0,44.0,50.0,2.0,4.0,50.0,1.0,1.1,0.5,-0.1,7.0,5.0,5.0,1.0,8.0,Matches,350,fr FRA,FW,34,19,813.0,43.0,26.6,9.0,7,83.0,3,12,19.0,12,1.79,13.0,9.0,4.0,0.44,-0.96,15.0,13.3,1.6,0.18,-0.87,Matches,303.0,fr FRA,FW,34.0,9.0,219.0,22.0,34.0,98.0,88.0,34.0,219.0,4.0,0.0,0.0,4.0,100.0,91.0,299.0,94.0,3.0,1.0,2.0,18.0,9.0,142.0,36.0,Matches,303.0,fr FRA,FW,34.0,9.0,2.0,23.0,10.0,43.5,2.55,1.11,0.09,0.2,11.1,0.0,0.0,0.0,4.3,4.3,0.19,-2.3,-2.3,Matches,303.0,fr FRA,FW,34.0,19.0,7.0,813.0,9.0,2.0,1.0,3.0,2.0,0.0,0.0,4.0,0.0,4.3,4.3,1.1,5.4,3.0,8.0,36.0,0.22,0.11,0.33,0.22,0.33,0.48,0.12,0.6,0.48,0.6,Matches,Anthony Modeste,S,34,134,145,"France,Martinique",Borussia Dortmund,7,9,11,15,14,8,17,11,8,6,10,14,6,13,9,14,15,15,13,11,14,14,14,8,14,7,11,8,11,11,15,16,14,12,10,16,15,7,14,6,7,2,1,3,2,2,1,3,3,1,2,1,12,10,13,8,10,13,10,7,1,1,1,1,1,1,1,5,1,5,7,7,7,20,187,84,12,20,4961506,7000,6006,5255,African_Caribbean,133,15,1988/4/14,0,0,95889.0,,8443059
91,Tobias Mohr,Schalke 04,1995,304.0,de GER,DFMF,26.0,9.3,8.0,5.0,3.0,5.0,0.0,2.0,7.0,28.6,5.0,14.0,5.0,9.0,8.0,16.0,19.0,0.0,Matches,304.0,de GER,DFMF,26.0,9.3,29.0,3.11,17.0,8.0,1.0,2.0,1.0,0.0,4.0,0.43,3.0,1.0,0.0,0.0,0.0,0.0,Matches,,,,,,,,,,,,,,,,,,,,,,,,,,,,,,,,,,,,,,,,,,,,,,,,,,,,,,,,304.0,de GER,DFMF,26.0,9.3,0.0,0.0,0.0,5.0,4.0,0.0,87.0,8.0,5.0,0.0,0.0,0.0,51.0,8.0,12.0,40.0,Matches,304.0,de GER,DFMF,26.0,9.3,506.0,372.0,133.0,30.0,1.0,10.0,87.0,78.0,24.0,9.0,14.0,0.0,308.0,1.0,18.0,Matches,304.0,de GER,DFMF,26.0,9.3,308.0,506.0,60.9,6380.0,2809.0,108.0,135.0,80.0,137.0,193.0,71.0,55.0,139.0,39.6,3.0,1.6,2.0,1.4,20.0,24.0,13.0,8.0,28.0,Matches,351,de GER,DFMF,26,18,839.0,47.0,27.4,9.3,8,76.0,4,10,23.0,8,0.78,11.0,16.0,-5.0,-0.54,0.72,11.9,14.6,-2.8,-0.3,0.3,Matches,304.0,de GER,DFMF,26.0,9.3,594.0,30.0,198.0,219.0,183.0,13.0,594.0,7.0,4.0,57.1,2.0,28.6,263.0,1526.0,793.0,20.0,7.0,1.0,8.0,8.0,290.0,39.0,Matches,304.0,de GER,DFMF,26.0,9.3,0.0,12.0,1.0,8.3,1.29,0.11,0.0,0.0,19.3,1.0,0.0,0.0,0.6,0.6,0.05,-0.6,-0.6,Matches,304.0,de GER,DFMF,26.0,18.0,8.0,839.0,9.3,0.0,3.0,3.0,0.0,0.0,0.0,0.0,0.0,0.6,0.6,1.6,2.2,20.0,28.0,39.0,0.0,0.32,0.32,0.0,0.32,0.07,0.17,0.24,0.07,0.24,Matches,Tobias Mohr,AM L,26,126,130,Germany,FC Schalke 04,15,15,13,11,12,14,7,12,14,10,12,12,11,12,13,11,12,11,10,12,10,13,13,6,12,11,12,16,13,12,9,9,16,15,14,9,12,8,12,7,19,3,3,3,1,3,1,1,2,2,3,2,7,12,6,13,10,12,14,14,1,15,1,10,15,10,1,15,12,10,20,10,10,8,183,78,20,9,1661033,6300,6300,4300,Northern_European,123,4,1995/8/24,0,0,17260.0,,91150906
92,Florent Mollet,Schalke 04,1991,306.0,fr FRA,MF,30.0,4.6,4.0,1.0,0.0,4.0,0.0,2.0,7.0,28.6,5.0,7.0,1.0,6.0,1.0,5.0,1.0,0.0,Matches,306.0,fr FRA,MF,30.0,4.6,14.0,3.07,11.0,0.0,0.0,2.0,1.0,0.0,0.0,0.0,0.0,0.0,0.0,0.0,0.0,0.0,Matches,,,,,,,,,,,,,,,,,,,,,,,,,,,,,,,,,,,,,,,,,,,,,,,,,,,,,,,,306.0,fr FRA,MF,30.0,4.6,1.0,0.0,0.0,4.0,7.0,2.0,9.0,1.0,1.0,0.0,0.0,0.0,25.0,1.0,11.0,8.3,Matches,306.0,fr FRA,MF,30.0,4.6,152.0,138.0,14.0,4.0,0.0,0.0,9.0,2.0,4.0,2.0,2.0,0.0,113.0,0.0,7.0,Matches,306.0,fr FRA,MF,30.0,4.6,113.0,152.0,74.3,1664.0,410.0,59.0,71.0,83.1,39.0,45.0,86.7,5.0,15.0,33.3,0.0,0.4,0.5,-0.4,4.0,12.0,2.0,1.0,14.0,Matches,353,fr FRA,MF,30,9,410.0,46.0,13.4,4.6,4,72.0,1,5,24.0,3,0.56,3.0,13.0,-10.0,-2.2,-1.31,5.9,8.5,-2.6,-0.58,-0.07,Matches,306.0,fr FRA,MF,30.0,4.6,206.0,2.0,23.0,110.0,75.0,9.0,206.0,5.0,2.0,40.0,3.0,60.0,109.0,632.0,309.0,6.0,8.0,0.0,11.0,8.0,130.0,24.0,Matches,306.0,fr FRA,MF,30.0,4.6,1.0,11.0,1.0,9.1,2.41,0.22,0.09,1.0,22.1,2.0,0.0,0.0,0.4,0.4,0.03,0.6,0.6,Matches,306.0,fr FRA,MF,30.0,9.0,4.0,410.0,4.6,1.0,0.0,1.0,1.0,0.0,0.0,1.0,0.0,0.4,0.4,0.4,0.7,6.0,14.0,24.0,0.22,0.0,0.22,0.22,0.22,0.08,0.08,0.16,0.08,0.16,Matches,Florent Mollet,M/AM RLC,30,126,135,France,FC Schalke 04,15,14,11,12,14,16,7,16,6,8,14,12,9,14,13,12,11,14,11,14,13,13,13,8,13,9,12,11,12,12,13,6,14,12,13,9,10,13,13,6,12,2,3,3,2,1,1,2,2,2,3,2,6,12,13,14,12,15,13,8,1,1,1,1,1,1,1,12,16,15,15,20,18,10,170,67,13,20,1600872,6300,6600,4800,Northern_European,126,5,1991/11/19,0,0,25889.0,,85084448
93,Marlon Mustapha,Mainz 05,2001,311.0,at AUT,FWMF,21.0,0.8,2.0,2.0,0.0,2.0,0.0,0.0,0.0,,0.0,4.0,0.0,4.0,0.0,2.0,0.0,0.0,Matches,311.0,at AUT,FWMF,21.0,0.8,3.0,3.91,2.0,0.0,1.0,0.0,0.0,0.0,0.0,0.0,0.0,0.0,0.0,0.0,0.0,0.0,Matches,,,,,,,,,,,,,,,,,,,,,,,,,,,,,,,,,,,,,,,,,,,,,,,,,,,,,,,,311.0,at AUT,FWMF,21.0,0.8,1.0,0.0,0.0,3.0,0.0,1.0,0.0,0.0,2.0,0.0,0.0,0.0,4.0,1.0,2.0,33.3,Matches,311.0,at AUT,FWMF,21.0,0.8,23.0,21.0,2.0,0.0,0.0,0.0,0.0,1.0,0.0,0.0,0.0,0.0,13.0,0.0,1.0,Matches,311.0,at AUT,FWMF,21.0,0.8,13.0,23.0,56.5,182.0,76.0,7.0,12.0,58.3,5.0,9.0,55.6,0.0,0.0,,0.0,0.3,0.0,-0.3,1.0,1.0,1.0,0.0,2.0,Matches,363,at AUT,FWMF,21,6,69.0,12.0,2.3,0.8,0,,0,6,12.0,7,2.0,1.0,1.0,0.0,0.0,0.03,1.4,0.3,1.0,1.34,1.56,Matches,311.0,at AUT,FWMF,21.0,0.8,45.0,0.0,2.0,22.0,22.0,5.0,45.0,3.0,2.0,66.7,1.0,33.3,24.0,217.0,133.0,5.0,4.0,2.0,7.0,2.0,30.0,9.0,Matches,311.0,at AUT,FWMF,21.0,0.8,0.0,3.0,0.0,0.0,3.91,0.0,0.0,,16.3,0.0,0.0,0.0,0.5,0.5,0.18,-0.5,-0.5,Matches,311.0,at AUT,FWMF,21.0,6.0,0.0,69.0,0.8,0.0,0.0,0.0,0.0,0.0,0.0,1.0,0.0,0.5,0.5,0.3,0.8,5.0,2.0,9.0,0.0,0.0,0.0,0.0,0.0,0.7,0.34,1.04,0.7,1.04,Matches,Marlon Mustapha,S R,21,116,136,Austria,1. FSV Mainz 05,3,7,12,12,11,4,12,8,3,6,11,12,8,12,16,11,12,10,9,11,10,13,14,4,14,7,12,16,16,11,12,12,13,15,13,12,11,12,10,8,9,2,1,2,1,2,4,1,3,3,3,1,12,17,8,13,11,12,8,8,1,1,1,1,1,1,1,1,1,1,14,12,15,20,185,82,11,20,3324999,5800,5600,3300,African_Caribbean,113,15,2001/5/24,0,0,4794.0,,16283628
94,Luca Netz,Gladbach,2003,316.0,de GER,DF,19.0,7.8,25.0,13.0,19.0,3.0,3.0,19.0,32.0,59.4,13.0,5.0,1.0,4.0,6.0,31.0,27.0,0.0,Matches,316.0,de GER,DF,19.0,7.8,15.0,1.92,12.0,2.0,0.0,0.0,1.0,0.0,3.0,0.38,2.0,1.0,0.0,0.0,0.0,0.0,Matches,,,,,,,,,,,,,,,,,,,,,,,,,,,,,,,,,,,,,,,,,,,,,,,,,,,,,,,,316.0,de GER,DF,19.0,7.8,0.0,0.0,0.0,5.0,2.0,1.0,6.0,6.0,13.0,0.0,0.0,0.0,43.0,8.0,12.0,40.0,Matches,316.0,de GER,DF,19.0,7.8,348.0,286.0,61.0,9.0,1.0,0.0,6.0,48.0,4.0,3.0,0.0,0.0,279.0,1.0,9.0,Matches,316.0,de GER,DF,19.0,7.8,279.0,348.0,80.2,4100.0,1108.0,161.0,176.0,91.5,99.0,121.0,81.8,11.0,31.0,35.5,3.0,1.2,1.0,1.8,5.0,11.0,3.0,0.0,12.0,Matches,368,de GER,DF,19,20,702.0,35.0,22.9,7.8,7,85.0,3,13,8.0,12,1.3,14.0,16.0,-2.0,-0.26,-0.22,14.7,15.9,-1.2,-0.15,-0.15,Matches,316.0,de GER,DF,19.0,7.8,446.0,29.0,155.0,184.0,113.0,11.0,446.0,13.0,10.0,76.9,3.0,23.1,199.0,891.0,463.0,12.0,10.0,3.0,13.0,6.0,244.0,32.0,Matches,316.0,de GER,DF,19.0,7.8,1.0,4.0,2.0,50.0,0.51,0.26,0.25,0.5,14.8,0.0,0.0,0.0,1.0,1.0,0.26,0.0,0.0,Matches,316.0,de GER,DF,19.0,20.0,7.0,702.0,7.8,1.0,3.0,4.0,1.0,0.0,0.0,0.0,0.0,1.0,1.0,1.2,2.2,12.0,12.0,32.0,0.13,0.38,0.51,0.13,0.51,0.13,0.15,0.28,0.13,0.28,Matches,Luca Netz,D/WB L,19,123,-85,Germany,Borussia Mönchengladbach,15,13,12,9,12,12,7,9,8,11,12,7,11,13,8,12,12,11,10,12,10,15,13,7,13,11,12,12,15,12,12,9,14,15,14,12,13,3,12,8,14,2,1,1,3,2,2,1,1,2,1,4,8,15,6,14,14,15,15,17,1,20,10,1,18,1,1,15,1,1,11,1,1,1,184,83,20,10,60800000,6150,6150,5150,Northern_European,114,1,2003/5/15,0,0,38355.0,,91195878
95,Jessic Ngankam,Hertha BSC,2000,319.0,de GER,FWMF,22.0,9.2,14.0,9.0,7.0,4.0,3.0,6.0,14.0,42.9,8.0,6.0,1.0,5.0,1.0,15.0,4.0,0.0,Matches,319.0,de GER,FWMF,22.0,9.2,19.0,2.07,10.0,0.0,1.0,3.0,4.0,1.0,3.0,0.33,1.0,0.0,0.0,1.0,1.0,0.0,Matches,,,,,,,,,,,,,,,,,,,,,,,,,,,,,,,,,,,,,,,,,,,,,,,,,,,,,,,,319.0,de GER,FWMF,22.0,9.2,5.0,0.0,0.0,19.0,13.0,1.0,2.0,1.0,9.0,1.0,0.0,0.0,24.0,14.0,52.0,21.2,Matches,319.0,de GER,FWMF,22.0,9.2,113.0,108.0,5.0,1.0,0.0,2.0,2.0,1.0,0.0,0.0,0.0,0.0,70.0,0.0,5.0,Matches,319.0,de GER,FWMF,22.0,9.2,70.0,113.0,61.9,881.0,201.0,50.0,64.0,78.1,12.0,25.0,48.0,3.0,7.0,42.9,0.0,0.3,0.3,-0.3,6.0,7.0,3.0,0.0,7.0,Matches,371,de GER,FWMF,22,18,826.0,46.0,27.0,9.2,8,64.0,1,10,31.0,0,0.78,10.0,21.0,-11.0,-1.2,-0.55,11.8,17.6,-5.8,-0.63,-0.04,Matches,319.0,de GER,FWMF,22.0,9.2,233.0,5.0,31.0,102.0,107.0,34.0,232.0,28.0,10.0,35.7,16.0,57.1,139.0,781.0,275.0,9.0,7.0,6.0,26.0,18.0,152.0,42.0,Matches,319.0,de GER,FWMF,22.0,9.2,4.0,18.0,7.0,38.9,1.96,0.76,0.17,0.43,13.8,0.0,1.0,1.0,4.1,3.3,0.19,-0.1,-0.3,Matches,319.0,de GER,FWMF,22.0,18.0,8.0,826.0,9.2,4.0,0.0,4.0,3.0,1.0,1.0,5.0,0.0,4.1,3.3,0.3,3.7,9.0,7.0,42.0,0.44,0.0,0.44,0.33,0.33,0.45,0.04,0.49,0.36,0.4,Matches,Jessic Ngankam,AM/S RL,22,123,139,"Germany,Cameroon",Hertha Berlin,5,8,13,13,12,6,12,10,7,7,11,9,8,11,13,13,15,13,10,9,10,15,13,10,13,5,13,13,14,13,16,12,14,13,13,16,12,8,12,17,14,3,3,4,1,2,4,2,3,4,3,2,10,13,9,13,16,13,14,14,1,1,1,1,1,1,1,8,1,12,15,13,17,20,184,84,9,20,3079999,5500,5507,4005,African_Caribbean,119,16,2000/7/20,0,0,2500.0,,91175633
96,Florian Niederlechner,Hertha BSC,1990,321.0,de GER,FW,31.0,8.7,9.0,7.0,2.0,4.0,3.0,2.0,8.0,25.0,6.0,7.0,0.0,7.0,3.0,12.0,10.0,0.0,Matches,321.0,de GER,FW,31.0,8.7,18.0,2.07,10.0,0.0,2.0,2.0,2.0,2.0,3.0,0.35,2.0,0.0,0.0,0.0,1.0,0.0,Matches,,,,,,,,,,,,,,,,,,,,,,,,,,,,,,,,,,,,,,,,,,,,,,,,,,,,,,,,321.0,de GER,FW,31.0,8.7,2.0,0.0,0.0,8.0,16.0,10.0,4.0,3.0,7.0,0.0,0.0,0.0,25.0,18.0,39.0,31.6,Matches,321.0,de GER,FW,31.0,8.7,146.0,139.0,7.0,0.0,0.0,1.0,4.0,0.0,0.0,0.0,0.0,0.0,95.0,0.0,6.0,Matches,321.0,de GER,FW,31.0,8.7,95.0,146.0,65.1,1480.0,258.0,50.0,65.0,76.9,35.0,50.0,70.0,6.0,11.0,54.5,0.0,0.2,0.4,-0.2,4.0,10.0,2.0,0.0,11.0,Matches,375,de GER,FW,31,16,781.0,49.0,25.5,8.7,11,64.0,0,5,16.0,1,0.94,14.0,16.0,-2.0,-0.23,0.76,10.7,16.3,-5.6,-0.65,-0.06,Matches,321.0,de GER,FW,31.0,8.7,249.0,10.0,27.0,114.0,111.0,32.0,249.0,22.0,11.0,50.0,9.0,40.9,108.0,453.0,225.0,9.0,6.0,4.0,11.0,6.0,146.0,28.0,Matches,321.0,de GER,FW,31.0,8.7,1.0,21.0,7.0,33.3,2.42,0.81,0.05,0.14,15.1,0.0,0.0,0.0,2.3,2.3,0.11,-1.3,-1.3,Matches,321.0,de GER,FW,31.0,16.0,11.0,781.0,8.7,1.0,0.0,1.0,1.0,0.0,0.0,2.0,0.0,2.3,2.3,0.2,2.5,9.0,11.0,28.0,0.12,0.0,0.12,0.12,0.12,0.26,0.02,0.29,0.26,0.29,Matches,Florian Niederlechner,S,31,132,135,Germany,FC Augsburg,6,9,12,13,14,8,13,11,5,6,11,12,7,13,16,14,16,13,13,13,13,15,11,7,12,7,15,16,11,13,15,13,11,12,14,16,12,8,15,7,5,2,1,2,2,3,4,2,1,1,2,3,7,12,6,10,12,11,14,10,1,1,1,1,1,1,1,1,1,1,1,10,1,20,187,86,14,20,3168870,6600,6600,5750,Northern_European,131,4,1990/10/24,0,0,19177.0,,92037896
97,Hugo Novoa,RB Leipzig,2003,326.0,es ESP,DFFW,19.0,2.0,8.0,2.0,1.0,3.0,4.0,4.0,7.0,57.1,3.0,4.0,0.0,4.0,1.0,9.0,0.0,0.0,Matches,326.0,es ESP,DFFW,19.0,2.0,2.0,0.97,2.0,0.0,0.0,0.0,0.0,0.0,0.0,0.0,0.0,0.0,0.0,0.0,0.0,0.0,Matches,,,,,,,,,,,,,,,,,,,,,,,,,,,,,,,,,,,,,,,,,,,,,,,,,,,,,,,,326.0,es ESP,DFFW,19.0,2.0,0.0,0.0,0.0,6.0,2.0,4.0,10.0,1.0,2.0,0.0,0.0,0.0,4.0,3.0,4.0,42.9,Matches,326.0,es ESP,DFFW,19.0,2.0,108.0,87.0,21.0,2.0,0.0,1.0,10.0,19.0,0.0,0.0,0.0,0.0,77.0,0.0,6.0,Matches,326.0,es ESP,DFFW,19.0,2.0,77.0,108.0,71.3,1064.0,275.0,48.0,53.0,90.6,23.0,33.0,69.7,2.0,7.0,28.6,0.0,0.0,0.1,0.0,2.0,1.0,0.0,0.0,4.0,Matches,382,es ESP,DFFW,19,7,184.0,26.0,6.0,2.0,2,63.0,0,5,12.0,8,1.71,5.0,2.0,3.0,1.47,0.84,3.8,3.0,0.7,0.36,-0.42,Matches,326.0,es ESP,DFFW,19.0,2.0,135.0,1.0,21.0,58.0,58.0,11.0,135.0,10.0,5.0,50.0,4.0,40.0,71.0,460.0,124.0,5.0,1.0,3.0,1.0,7.0,86.0,20.0,Matches,326.0,es ESP,DFFW,19.0,2.0,1.0,3.0,2.0,66.7,1.47,0.98,0.33,0.5,13.2,0.0,0.0,0.0,0.9,0.9,0.29,0.1,0.1,Matches,326.0,es ESP,DFFW,19.0,7.0,2.0,184.0,2.0,1.0,0.0,1.0,1.0,0.0,0.0,0.0,0.0,0.9,0.9,0.0,0.9,5.0,4.0,20.0,0.49,0.0,0.49,0.49,0.49,0.43,0.02,0.45,0.43,0.45,Matches,Hugo Novoa,AM/S R,19,117,-8,Spain,RB Leipzig,11,10,13,12,12,12,8,9,8,9,12,12,8,13,7,11,13,11,9,12,10,13,13,4,12,8,12,14,13,13,12,11,14,15,12,9,11,2,11,5,17,3,1,3,2,3,1,3,1,3,1,2,16,14,4,9,11,16,15,16,1,1,1,10,1,15,1,10,1,15,12,10,18,20,182,68,8,20,48600001,5845,5145,4573,Mediterranean_Hispanic,105,3,2003/1/24,0,0,4999.0,,2000013687
98,Tim Oermann,Bochum,2003,328.0,de GER,DF,18.0,2.2,2.0,1.0,2.0,0.0,0.0,1.0,1.0,100.0,0.0,3.0,2.0,1.0,1.0,3.0,8.0,1.0,Matches,328.0,de GER,DF,18.0,2.2,0.0,0.0,0.0,0.0,0.0,0.0,0.0,0.0,0.0,0.0,0.0,0.0,0.0,0.0,0.0,0.0,Matches,,,,,,,,,,,,,,,,,,,,,,,,,,,,,,,,,,,,,,,,,,,,,,,,,,,,,,,,328.0,de GER,DF,18.0,2.2,0.0,0.0,0.0,3.0,0.0,0.0,0.0,1.0,1.0,0.0,0.0,0.0,5.0,4.0,5.0,44.4,Matches,328.0,de GER,DF,18.0,2.2,51.0,51.0,0.0,0.0,0.0,0.0,0.0,0.0,0.0,0.0,0.0,0.0,39.0,0.0,1.0,Matches,328.0,de GER,DF,18.0,2.2,39.0,51.0,76.5,738.0,268.0,14.0,16.0,87.5,18.0,19.0,94.7,6.0,12.0,50.0,0.0,0.0,0.0,0.0,0.0,1.0,0.0,0.0,0.0,Matches,385,de GER,DF,18,4,194.0,49.0,6.3,2.2,2,86.0,1,2,11.0,7,1.0,1.0,6.0,-5.0,-2.32,-1.47,0.5,5.1,-4.6,-2.14,-1.48,Matches,328.0,de GER,DF,18.0,2.2,69.0,16.0,51.0,18.0,0.0,0.0,69.0,0.0,0.0,,0.0,,32.0,179.0,82.0,0.0,0.0,0.0,1.0,0.0,38.0,0.0,Matches,328.0,de GER,DF,18.0,2.2,0.0,0.0,0.0,,0.0,0.0,,,,0.0,0.0,0.0,0.0,0.0,,0.0,0.0,Matches,328.0,de GER,DF,18.0,4.0,2.0,194.0,2.2,0.0,0.0,0.0,0.0,0.0,0.0,0.0,0.0,0.0,0.0,0.0,0.0,0.0,0.0,0.0,0.0,0.0,0.0,0.0,0.0,0.0,0.0,0.0,0.0,0.0,Matches,Tim Oermann,D/DM C,18,102,-75,Germany,VfL Bochum 1848,3,7,10,6,10,3,12,6,6,12,13,6,11,12,10,10,12,11,11,11,10,15,11,10,8,13,12,12,13,11,13,12,13,13,12,12,11,4,12,6,9,3,3,3,2,2,1,1,4,3,3,3,9,13,4,17,14,15,13,14,1,1,20,10,1,1,16,1,12,1,1,1,1,1,187,76,8,20,13376000,5093,5093,3053,Northern_European,100,2,2003/10/6,0,0,5273.0,,2000070513
99,Mathias Olesen,Köln,2001,330.0,lu LUX,MF,21.0,5.3,10.0,5.0,4.0,4.0,2.0,5.0,8.0,62.5,3.0,6.0,1.0,5.0,2.0,12.0,3.0,0.0,Matches,330.0,lu LUX,MF,21.0,5.3,4.0,0.75,4.0,0.0,0.0,0.0,0.0,0.0,0.0,0.0,0.0,0.0,0.0,0.0,0.0,0.0,Matches,,,,,,,,,,,,,,,,,,,,,,,,,,,,,,,,,,,,,,,,,,,,,,,,,,,,,,,,330.0,lu LUX,MF,21.0,5.3,1.0,0.0,0.0,6.0,5.0,1.0,2.0,2.0,5.0,0.0,0.0,0.0,29.0,3.0,6.0,33.3,Matches,330.0,lu LUX,MF,21.0,5.3,157.0,151.0,5.0,1.0,0.0,2.0,2.0,0.0,0.0,0.0,0.0,0.0,123.0,1.0,4.0,Matches,330.0,lu LUX,MF,21.0,5.3,123.0,157.0,78.3,1974.0,458.0,61.0,75.0,81.3,41.0,48.0,85.4,10.0,16.0,62.5,0.0,0.1,0.2,-0.1,2.0,9.0,3.0,1.0,15.0,Matches,387,lu LUX,MF,21,14,478.0,34.0,15.6,5.3,6,59.0,1,8,15.0,12,1.43,5.0,9.0,-4.0,-0.75,-0.72,4.9,6.9,-2.0,-0.39,-0.64,Matches,330.0,lu LUX,MF,21.0,5.3,193.0,5.0,45.0,113.0,38.0,3.0,193.0,4.0,2.0,50.0,1.0,25.0,100.0,513.0,212.0,2.0,5.0,0.0,4.0,9.0,114.0,11.0,Matches,330.0,lu LUX,MF,21.0,5.3,0.0,0.0,0.0,,0.0,0.0,,,,0.0,0.0,0.0,0.0,0.0,,0.0,0.0,Matches,330.0,lu LUX,MF,21.0,14.0,6.0,478.0,5.3,0.0,0.0,0.0,0.0,0.0,0.0,1.0,0.0,0.0,0.0,0.1,0.1,2.0,15.0,11.0,0.0,0.0,0.0,0.0,0.0,0.0,0.02,0.02,0.0,0.02,Matches,Mathias Olesen,DM/M C,21,110,138,"Luxembourg,Denmark",1. FC Köln,8,9,11,10,11,11,12,11,10,11,11,10,11,10,11,11,12,12,12,11,11,14,10,12,11,12,14,14,11,11,11,14,13,13,14,12,11,7,11,14,15,4,2,1,3,3,2,3,3,2,2,3,14,14,7,15,14,18,15,15,1,1,1,1,7,7,16,9,20,9,7,14,7,1,188,0,12,20,3100000,5746,4567,3299,Northern_European,110,4,2001/3/21,6,0,3999.0,,91193053
100,Jordi Osei-Tutu,Bochum,1998,337.0,eng ENG,DFFW,23.0,8.3,23.0,18.0,13.0,5.0,5.0,12.0,23.0,52.2,11.0,12.0,5.0,7.0,10.0,33.0,8.0,0.0,Matches,337.0,eng ENG,DFFW,23.0,8.3,16.0,1.91,7.0,2.0,2.0,2.0,3.0,0.0,1.0,0.12,0.0,0.0,0.0,1.0,0.0,0.0,Matches,,,,,,,,,,,,,,,,,,,,,,,,,,,,,,,,,,,,,,,,,,,,,,,,,,,,,,,,337.0,eng ENG,DFFW,23.0,8.3,3.0,0.0,0.0,8.0,23.0,3.0,15.0,10.0,18.0,0.0,0.0,0.0,48.0,6.0,12.0,33.3,Matches,337.0,eng ENG,DFFW,23.0,8.3,217.0,176.0,39.0,2.0,0.0,0.0,15.0,34.0,3.0,0.0,0.0,0.0,150.0,2.0,7.0,Matches,337.0,eng ENG,DFFW,23.0,8.3,150.0,217.0,69.1,2287.0,881.0,84.0,102.0,82.4,50.0,71.0,70.4,12.0,26.0,46.2,0.0,0.2,0.3,-0.2,5.0,11.0,5.0,2.0,19.0,Matches,395,eng ENG,DFFW,23,20,749.0,37.0,24.5,8.3,8,68.0,1,12,17.0,7,0.7,6.0,20.0,-14.0,-1.68,-0.98,8.0,14.3,-6.2,-0.75,0.01,Matches,337.0,eng ENG,DFFW,23.0,8.3,350.0,16.0,95.0,125.0,135.0,21.0,350.0,24.0,10.0,41.7,12.0,50.0,189.0,1639.0,758.0,25.0,13.0,8.0,25.0,11.0,169.0,39.0,Matches,337.0,eng ENG,DFFW,23.0,8.3,0.0,12.0,5.0,41.7,1.44,0.6,0.0,0.0,19.9,0.0,0.0,0.0,0.7,0.7,0.05,-0.7,-0.7,Matches,337.0,eng ENG,DFFW,23.0,20.0,8.0,749.0,8.3,0.0,0.0,0.0,0.0,0.0,0.0,3.0,0.0,0.7,0.7,0.2,0.8,25.0,19.0,39.0,0.0,0.0,0.0,0.0,0.0,0.08,0.02,0.1,0.08,0.1,Matches,Jordi Osei-Tutu,D/WB RL,23,119,137,"England,Ghana",VfL Bochum 1848,9,12,13,7,11,7,9,8,14,11,11,5,11,12,14,13,15,11,8,9,9,14,10,6,12,12,12,15,14,13,15,9,12,15,13,12,10,12,10,11,13,1,2,2,3,2,2,2,1,3,1,3,9,13,8,12,7,13,15,7,1,10,1,20,15,20,1,1,1,12,1,1,12,1,176,70,10,20,1914517,5950,5950,3250,African_Caribbean,110,15,1998/10/2,0,0,7335.0,,28106678
101,Reece Oxford,Augsburg,1998,341.0,eng ENG,DF,23.0,1.0,1.0,1.0,1.0,0.0,0.0,0.0,0.0,,0.0,4.0,3.0,1.0,1.0,2.0,5.0,0.0,Matches,341.0,eng ENG,DF,23.0,1.0,1.0,0.96,1.0,0.0,0.0,0.0,0.0,0.0,0.0,0.0,0.0,0.0,0.0,0.0,0.0,0.0,Matches,,,,,,,,,,,,,,,,,,,,,,,,,,,,,,,,,,,,,,,,,,,,,,,,,,,,,,,,341.0,eng ENG,DF,23.0,1.0,0.0,0.0,0.0,0.0,2.0,0.0,0.0,1.0,1.0,0.0,0.0,0.0,6.0,7.0,7.0,50.0,Matches,341.0,eng ENG,DF,23.0,1.0,52.0,50.0,1.0,1.0,0.0,0.0,0.0,0.0,0.0,0.0,0.0,0.0,28.0,1.0,0.0,Matches,341.0,eng ENG,DF,23.0,1.0,28.0,52.0,53.8,638.0,273.0,2.0,5.0,40.0,22.0,31.0,71.0,3.0,14.0,21.4,0.0,0.1,0.1,-0.1,1.0,2.0,1.0,0.0,4.0,Matches,399,eng ENG,DF,23,3,94.0,31.0,3.1,1.0,1,75.0,0,2,10.0,0,0.33,0.0,1.0,-1.0,-0.96,-0.35,2.1,1.3,0.8,0.73,1.48,Matches,341.0,eng ENG,DF,23.0,1.0,67.0,10.0,47.0,19.0,2.0,0.0,67.0,0.0,0.0,,0.0,,24.0,140.0,70.0,0.0,0.0,0.0,1.0,0.0,26.0,0.0,Matches,341.0,eng ENG,DF,23.0,1.0,0.0,0.0,0.0,,0.0,0.0,,,,0.0,0.0,0.0,0.0,0.0,,0.0,0.0,Matches,341.0,eng ENG,DF,23.0,3.0,1.0,94.0,1.0,0.0,0.0,0.0,0.0,0.0,0.0,0.0,0.0,0.0,0.0,0.1,0.1,0.0,4.0,0.0,0.0,0.0,0.0,0.0,0.0,0.0,0.06,0.06,0.0,0.06,Matches,Reece Oxford,D/DM C,23,128,142,"England,Jamaica",FC Augsburg,4,7,8,9,11,6,11,7,12,14,13,9,15,12,12,14,15,13,12,10,12,11,8,12,8,13,14,12,13,11,13,16,13,13,12,13,13,9,16,9,15,2,2,3,2,2,1,3,3,3,1,2,10,13,10,12,15,11,16,12,1,1,20,12,1,8,16,1,14,1,1,1,1,1,191,78,9,20,4102136,6400,5632,4626,African_Caribbean,126,14,1998/12/16,0,0,16781.0,,28101903
102,Kevin Paredes,Wolfsburg,2003,347.0,us USA,FWMF,19.0,5.9,13.0,9.0,6.0,3.0,4.0,9.0,12.0,75.0,3.0,7.0,0.0,7.0,6.0,19.0,8.0,0.0,Matches,347.0,us USA,FWMF,19.0,5.9,25.0,4.24,22.0,0.0,1.0,0.0,2.0,0.0,4.0,0.68,4.0,0.0,0.0,0.0,0.0,0.0,Matches,,,,,,,,,,,,,,,,,,,,,,,,,,,,,,,,,,,,,,,,,,,,,,,,,,,,,,,,347.0,us USA,FWMF,19.0,5.9,2.0,0.0,0.0,4.0,18.0,2.0,22.0,6.0,9.0,0.0,0.0,0.0,38.0,3.0,5.0,37.5,Matches,347.0,us USA,FWMF,19.0,5.9,211.0,190.0,20.0,6.0,0.0,3.0,22.0,14.0,0.0,0.0,0.0,0.0,159.0,1.0,4.0,Matches,347.0,us USA,FWMF,19.0,5.9,159.0,211.0,75.4,2576.0,866.0,82.0,98.0,83.7,59.0,73.0,80.8,12.0,27.0,44.4,3.0,1.7,1.4,1.3,13.0,15.0,16.0,5.0,29.0,Matches,406,us USA,FWMF,19,22,529.0,24.0,17.3,5.9,1,72.0,0,21,22.0,2,1.09,13.0,8.0,5.0,0.85,0.71,10.8,10.4,0.5,0.08,0.09,Matches,347.0,us USA,FWMF,19.0,5.9,277.0,9.0,52.0,105.0,122.0,15.0,277.0,15.0,4.0,26.7,7.0,46.7,177.0,1090.0,651.0,24.0,7.0,7.0,9.0,4.0,180.0,40.0,Matches,347.0,us USA,FWMF,19.0,5.9,1.0,4.0,2.0,50.0,0.68,0.34,0.25,0.5,21.4,0.0,0.0,0.0,0.2,0.2,0.04,0.8,0.8,Matches,347.0,us USA,FWMF,19.0,22.0,1.0,529.0,5.9,1.0,3.0,4.0,1.0,0.0,0.0,2.0,0.0,0.2,0.2,1.7,1.9,24.0,29.0,40.0,0.17,0.51,0.68,0.17,0.68,0.03,0.29,0.32,0.03,0.32,Matches,Kevin Paredes,AM RL,19,115,-75,"United States,Dominican Republic",VfL Wolfsburg,7,11,13,10,11,7,5,8,6,10,11,7,12,12,13,12,13,11,9,11,10,13,13,5,13,10,12,12,15,12,12,5,14,14,13,8,12,11,15,9,17,3,2,3,1,2,1,2,3,3,1,2,10,12,6,12,10,13,12,12,1,12,1,10,15,10,1,15,8,12,20,10,15,8,168,61,20,9,38849998,5745,5395,4245,Mixed_Race,109,7,2003/5/7,0,0,19177.0,,72056310
103,Felix Passlack,Dortmund,1998,349.0,de GER,DF,24.0,0.7,4.0,3.0,0.0,4.0,0.0,1.0,1.0,100.0,0.0,1.0,1.0,0.0,0.0,4.0,1.0,0.0,Matches,349.0,de GER,DF,24.0,0.7,6.0,8.44,4.0,0.0,0.0,0.0,1.0,1.0,1.0,1.41,1.0,0.0,0.0,0.0,0.0,0.0,Matches,,,,,,,,,,,,,,,,,,,,,,,,,,,,,,,,,,,,,,,,,,,,,,,,,,,,,,,,349.0,de GER,DF,24.0,0.7,0.0,0.0,0.0,0.0,1.0,0.0,2.0,0.0,3.0,0.0,0.0,0.0,5.0,1.0,1.0,50.0,Matches,349.0,de GER,DF,24.0,0.7,40.0,34.0,6.0,0.0,1.0,0.0,2.0,6.0,0.0,0.0,0.0,0.0,30.0,0.0,3.0,Matches,349.0,de GER,DF,24.0,0.7,30.0,40.0,75.0,655.0,309.0,8.0,10.0,80.0,16.0,17.0,94.1,6.0,11.0,54.5,0.0,0.4,0.2,-0.4,2.0,3.0,2.0,1.0,8.0,Matches,408,de GER,DF,24,3,64.0,21.0,2.1,0.7,0,,0,3,21.0,20,3.0,2.0,0.0,2.0,2.81,1.7,2.2,1.0,1.2,1.69,0.89,Matches,349.0,de GER,DF,24.0,0.7,47.0,2.0,13.0,25.0,10.0,1.0,47.0,1.0,1.0,100.0,0.0,0.0,24.0,68.0,43.0,1.0,1.0,0.0,1.0,1.0,27.0,3.0,Matches,349.0,de GER,DF,24.0,0.7,0.0,0.0,0.0,,0.0,0.0,,,,0.0,0.0,0.0,0.0,0.0,,0.0,0.0,Matches,349.0,de GER,DF,24.0,3.0,0.0,64.0,0.7,0.0,0.0,0.0,0.0,0.0,0.0,0.0,0.0,0.0,0.0,0.4,0.4,1.0,8.0,3.0,0.0,0.0,0.0,0.0,0.0,0.0,0.56,0.56,0.0,0.56,Matches,Felix Passlack,D/WB RL,24,128,135,Germany,Borussia Dortmund,11,11,11,10,10,11,8,9,14,9,10,14,10,11,15,8,15,9,8,8,8,15,11,11,10,10,16,16,16,14,11,7,15,16,14,10,10,7,12,4,17,1,4,2,1,2,1,3,2,3,2,1,7,12,8,15,10,14,15,12,1,15,1,20,14,20,1,12,10,15,10,10,15,1,170,74,12,20,1100089,6250,6250,4750,Northern_European,108,4,1998/5/29,0,0,19230.0,,92071494
104,Paulinho,Leverkusen,2000,350.0,br BRA,FW,22.0,0.9,0.0,0.0,0.0,0.0,0.0,0.0,0.0,,0.0,1.0,0.0,1.0,0.0,0.0,2.0,0.0,Matches,350.0,br BRA,FW,22.0,0.9,1.0,1.1,1.0,0.0,0.0,0.0,0.0,0.0,0.0,0.0,0.0,0.0,0.0,0.0,0.0,0.0,Matches,,,,,,,,,,,,,,,,,,,,,,,,,,,,,,,,,,,,,,,,,,,,,,,,,,,,,,,,350.0,br BRA,FW,22.0,0.9,0.0,0.0,0.0,0.0,1.0,0.0,0.0,0.0,0.0,0.0,0.0,0.0,5.0,1.0,4.0,20.0,Matches,350.0,br BRA,FW,22.0,0.9,28.0,27.0,1.0,0.0,0.0,0.0,0.0,0.0,1.0,0.0,0.0,0.0,23.0,0.0,1.0,Matches,350.0,br BRA,FW,22.0,0.9,23.0,28.0,82.1,279.0,86.0,16.0,19.0,84.2,5.0,6.0,83.3,0.0,0.0,,0.0,0.0,0.0,0.0,0.0,1.0,0.0,0.0,4.0,Matches,409,br BRA,FW,22,4,82.0,21.0,2.7,0.9,1,45.0,0,3,12.0,4,1.0,1.0,2.0,-1.0,-1.1,-1.37,0.8,1.6,-0.8,-0.86,-1.15,Matches,350.0,br BRA,FW,22.0,0.9,38.0,2.0,4.0,18.0,17.0,3.0,38.0,4.0,2.0,50.0,2.0,50.0,22.0,175.0,58.0,3.0,2.0,3.0,2.0,1.0,26.0,8.0,Matches,350.0,br BRA,FW,22.0,0.9,1.0,2.0,1.0,50.0,2.2,1.1,0.5,1.0,16.1,0.0,0.0,0.0,0.5,0.5,0.26,0.5,0.5,Matches,350.0,br BRA,FW,22.0,4.0,1.0,82.0,0.9,1.0,0.0,1.0,1.0,0.0,0.0,0.0,0.0,0.5,0.5,0.0,0.5,3.0,4.0,8.0,1.1,0.0,1.1,1.1,1.1,0.58,0.0,0.58,0.58,0.58,Matches,Paulinho,M C,34,143,154,Brazil,COR,10,10,12,14,13,12,14,13,11,13,12,12,14,13,11,16,12,12,14,13,15,16,14,12,16,12,15,14,13,13,14,12,14,13,14,16,15,13,12,7,12,2,3,2,2,2,2,2,3,2,1,4,11,13,12,15,12,13,10,12,1,1,1,1,1,1,15,1,20,1,1,15,1,1,181,81,10,20,347975206,7600,7350,6000,Mixed_Race,143,14,1988/7/25,56,13,33545.0,,19003703
105,Dženan Pejčinović,Wolfsburg,2005,356.0,de GER,FW,17.0,0.1,0.0,0.0,0.0,0.0,0.0,0.0,0.0,,0.0,0.0,0.0,0.0,0.0,0.0,0.0,0.0,Matches,356.0,de GER,FW,17.0,0.1,0.0,0.0,0.0,0.0,0.0,0.0,0.0,0.0,0.0,0.0,0.0,0.0,0.0,0.0,0.0,0.0,Matches,,,,,,,,,,,,,,,,,,,,,,,,,,,,,,,,,,,,,,,,,,,,,,,,,,,,,,,,356.0,de GER,FW,17.0,0.1,0.0,0.0,0.0,0.0,0.0,0.0,0.0,0.0,0.0,0.0,0.0,0.0,0.0,1.0,4.0,20.0,Matches,356.0,de GER,FW,17.0,0.1,0.0,0.0,0.0,0.0,0.0,0.0,0.0,0.0,0.0,0.0,0.0,0.0,0.0,0.0,0.0,Matches,356.0,de GER,FW,17.0,0.1,0.0,0.0,,0.0,0.0,0.0,0.0,,0.0,0.0,,0.0,0.0,,0.0,0.0,0.0,0.0,0.0,0.0,0.0,0.0,0.0,Matches,416,de GER,FW,17,1,11.0,11.0,0.4,0.1,0,,0,1,11.0,9,0.0,0.0,0.0,0.0,0.0,-0.27,0.9,0.5,0.4,3.63,3.64,Matches,356.0,de GER,FW,17.0,0.1,1.0,0.0,0.0,0.0,1.0,1.0,1.0,0.0,0.0,,0.0,,0.0,0.0,0.0,0.0,0.0,0.0,0.0,0.0,1.0,0.0,Matches,356.0,de GER,FW,17.0,0.1,0.0,0.0,0.0,,0.0,0.0,,,,0.0,0.0,0.0,0.0,0.0,,0.0,0.0,Matches,356.0,de GER,FW,17.0,1.0,0.0,11.0,0.1,0.0,0.0,0.0,0.0,0.0,0.0,0.0,0.0,0.0,0.0,0.0,0.0,0.0,0.0,0.0,0.0,0.0,0.0,0.0,0.0,0.0,0.0,0.0,0.0,0.0,Matches,Dženan Pejčinović,S,17,102,-8,"Germany,Montenegro",VfL Wolfsburg,3,7,12,13,12,8,12,9,2,5,12,13,6,13,11,10,9,10,8,12,8,16,13,8,12,5,11,12,12,12,12,13,15,13,11,12,13,3,12,5,10,3,1,1,2,3,2,2,3,3,3,3,12,16,8,10,12,14,16,18,1,1,1,1,1,1,1,1,1,1,14,14,14,20,188,82,20,12,27937500,5250,5250,3750,Northern_European,102,3,2005/2/25,0,0,9588.0,,2000147146
106,Peter Pekarík,Hertha BSC,1986,357.0,sk SVK,DF,35.0,2.3,4.0,3.0,4.0,0.0,0.0,4.0,6.0,66.7,2.0,6.0,2.0,4.0,4.0,8.0,7.0,0.0,Matches,357.0,sk SVK,DF,35.0,2.3,1.0,0.44,1.0,0.0,0.0,0.0,0.0,0.0,0.0,0.0,0.0,0.0,0.0,0.0,0.0,0.0,Matches,,,,,,,,,,,,,,,,,,,,,,,,,,,,,,,,,,,,,,,,,,,,,,,,,,,,,,,,357.0,sk SVK,DF,35.0,2.3,0.0,0.0,0.0,0.0,0.0,0.0,4.0,4.0,3.0,0.0,0.0,0.0,14.0,4.0,5.0,44.4,Matches,357.0,sk SVK,DF,35.0,2.3,115.0,94.0,21.0,0.0,0.0,1.0,4.0,21.0,0.0,0.0,0.0,0.0,89.0,0.0,2.0,Matches,357.0,sk SVK,DF,35.0,2.3,89.0,115.0,77.4,1465.0,603.0,43.0,47.0,91.5,35.0,46.0,76.1,9.0,17.0,52.9,0.0,0.0,0.1,0.0,1.0,4.0,1.0,1.0,7.0,Matches,417,sk SVK,DF,35,5,206.0,41.0,6.7,2.3,2,83.0,1,3,13.0,19,0.8,3.0,7.0,-4.0,-1.75,-1.02,2.5,4.4,-1.9,-0.82,-0.23,Matches,357.0,sk SVK,DF,35.0,2.3,137.0,10.0,58.0,66.0,15.0,0.0,137.0,0.0,0.0,,0.0,,62.0,383.0,213.0,2.0,0.0,0.0,1.0,1.0,68.0,1.0,Matches,357.0,sk SVK,DF,35.0,2.3,0.0,0.0,0.0,,0.0,0.0,,,,0.0,0.0,0.0,0.0,0.0,,0.0,0.0,Matches,357.0,sk SVK,DF,35.0,5.0,2.0,206.0,2.3,0.0,0.0,0.0,0.0,0.0,0.0,0.0,0.0,0.0,0.0,0.0,0.0,2.0,7.0,1.0,0.0,0.0,0.0,0.0,0.0,0.0,0.01,0.01,0.0,0.01,Matches,Peter Pekarík,D/WB R,35,126,130,Slovakia,Hertha Berlin,8,12,10,5,11,5,10,6,13,12,12,6,13,11,10,16,12,13,16,9,15,12,6,14,10,14,17,16,11,13,10,8,15,12,15,9,17,8,17,6,10,3,1,3,1,2,3,2,2,2,2,3,14,14,3,16,16,17,17,18,1,14,10,20,12,18,1,1,1,8,1,1,8,1,177,73,10,20,196016,6200,6800,4750,Northern_European,124,4,1986/10/30,112,2,14999.0,,7563749
107,Luca Pellegrini,Eint Frankfurt,1999,358.0,it ITA,DF,23.0,6.2,13.0,8.0,10.0,3.0,0.0,8.0,8.0,100.0,0.0,8.0,2.0,6.0,7.0,20.0,11.0,1.0,Matches,358.0,it ITA,DF,23.0,6.2,14.0,2.27,6.0,5.0,1.0,0.0,2.0,0.0,0.0,0.0,0.0,0.0,0.0,0.0,0.0,0.0,Matches,,,,,,,,,,,,,,,,,,,,,,,,,,,,,,,,,,,,,,,,,,,,,,,,,,,,,,,,358.0,it ITA,DF,23.0,6.2,1.0,0.0,0.0,8.0,8.0,0.0,54.0,7.0,8.0,0.0,0.0,0.0,53.0,5.0,3.0,62.5,Matches,358.0,it ITA,DF,23.0,6.2,431.0,315.0,113.0,13.0,1.0,7.0,54.0,81.0,19.0,13.0,2.0,0.0,292.0,3.0,23.0,Matches,358.0,it ITA,DF,23.0,6.2,292.0,431.0,67.7,5244.0,2035.0,140.0,164.0,85.4,106.0,137.0,77.4,38.0,90.0,42.2,0.0,0.8,0.9,-0.8,8.0,16.0,4.0,2.0,22.0,Matches,418,it ITA,DF,23,9,557.0,62.0,18.2,6.2,7,74.0,2,2,21.0,1,1.56,10.0,7.0,3.0,0.48,0.38,8.8,5.0,3.8,0.62,0.45,Matches,358.0,it ITA,DF,23.0,6.2,514.0,11.0,127.0,224.0,170.0,10.0,514.0,26.0,11.0,42.3,12.0,46.2,240.0,1188.0,674.0,19.0,17.0,2.0,7.0,5.0,267.0,28.0,Matches,358.0,it ITA,DF,23.0,6.2,0.0,14.0,2.0,14.3,2.26,0.32,0.0,0.0,27.7,3.0,0.0,0.0,0.6,0.6,0.04,-0.6,-0.6,Matches,358.0,it ITA,DF,23.0,9.0,7.0,557.0,6.2,0.0,0.0,0.0,0.0,0.0,0.0,1.0,0.0,0.6,0.6,0.8,1.4,19.0,22.0,28.0,0.0,0.0,0.0,0.0,0.0,0.09,0.14,0.23,0.09,0.23,Matches,Luca Pellegrini,D/WB/M L,23,138,155,Italy,Juventus,10,14,13,7,13,5,11,9,11,12,14,6,14,14,17,13,14,11,14,12,13,13,13,8,15,13,14,16,14,14,15,10,14,14,13,13,13,15,12,11,13,2,1,1,3,1,3,3,1,1,3,2,10,16,13,13,12,15,12,13,1,20,5,1,19,1,1,17,5,1,7,1,1,1,178,72,20,11,10557494,6900,6850,5500,Mediterranean_Hispanic,136,3,1999/3/7,1,0,35577.0,Eintracht Frankfurt,43252226
108,Ricardo Pepi,Augsburg,2003,359.0,us USA,FW,19.0,1.1,1.0,1.0,1.0,0.0,0.0,1.0,1.0,100.0,0.0,1.0,0.0,1.0,0.0,1.0,1.0,0.0,Matches,359.0,us USA,FW,19.0,1.1,2.0,1.89,2.0,0.0,0.0,0.0,0.0,0.0,0.0,0.0,0.0,0.0,0.0,0.0,0.0,0.0,Matches,,,,,,,,,,,,,,,,,,,,,,,,,,,,,,,,,,,,,,,,,,,,,,,,,,,,,,,,359.0,us USA,FW,19.0,1.1,0.0,0.0,0.0,0.0,0.0,0.0,0.0,0.0,1.0,0.0,0.0,0.0,5.0,3.0,8.0,27.3,Matches,359.0,us USA,FW,19.0,1.1,27.0,25.0,2.0,0.0,0.0,0.0,0.0,0.0,0.0,0.0,0.0,0.0,18.0,0.0,1.0,Matches,359.0,us USA,FW,19.0,1.1,18.0,27.0,66.7,223.0,7.0,10.0,15.0,66.7,6.0,7.0,85.7,0.0,0.0,,0.0,0.1,0.0,-0.1,2.0,0.0,0.0,0.0,1.0,Matches,421,us USA,FW,19,4,95.0,24.0,3.1,1.1,1,55.0,0,3,13.0,0,0.75,0.0,3.0,-3.0,-2.84,-2.3,0.5,1.7,-1.2,-1.15,-0.45,Matches,359.0,us USA,FW,19.0,1.1,40.0,1.0,6.0,21.0,14.0,2.0,40.0,5.0,3.0,60.0,2.0,40.0,19.0,144.0,57.0,2.0,2.0,1.0,4.0,0.0,22.0,4.0,Matches,359.0,us USA,FW,19.0,1.1,0.0,1.0,0.0,0.0,0.95,0.0,0.0,,14.6,0.0,0.0,0.0,0.1,0.1,0.09,-0.1,-0.1,Matches,359.0,us USA,FW,19.0,4.0,1.0,95.0,1.1,0.0,0.0,0.0,0.0,0.0,0.0,0.0,0.0,0.1,0.1,0.1,0.2,2.0,1.0,4.0,0.0,0.0,0.0,0.0,0.0,0.09,0.06,0.14,0.09,0.14,Matches,Ricardo Pepi,S,19,112,-8,"United States,Mexico",FC Augsburg,6,9,11,12,11,8,13,10,8,6,10,13,6,10,11,13,12,11,11,10,11,12,10,7,13,6,10,11,12,11,11,13,13,14,13,9,12,7,2,3,10,1,1,2,1,2,2,2,2,3,1,3,11,13,8,12,12,11,13,20,1,1,1,1,1,1,1,1,1,1,1,12,1,20,185,78,12,20,68416000,5850,6211,3733,Mediterranean_Hispanic,106,6,2003/1/9,11,3,6904.0,FC Groningen,20048604
109,Nils Petersen,Freiburg,1988,361.0,de GER,FW,33.0,3.1,6.0,4.0,0.0,3.0,3.0,2.0,5.0,40.0,3.0,11.0,2.0,9.0,1.0,7.0,6.0,0.0,Matches,361.0,de GER,FW,33.0,3.1,5.0,1.62,3.0,0.0,0.0,2.0,0.0,0.0,0.0,0.0,0.0,0.0,0.0,0.0,0.0,0.0,Matches,,,,,,,,,,,,,,,,,,,,,,,,,,,,,,,,,,,,,,,,,,,,,,,,,,,,,,,,361.0,de GER,FW,33.0,3.1,1.0,0.0,0.0,5.0,2.0,3.0,0.0,1.0,4.0,0.0,0.0,0.0,8.0,14.0,23.0,37.8,Matches,361.0,de GER,FW,33.0,3.1,74.0,72.0,2.0,0.0,0.0,0.0,0.0,0.0,0.0,0.0,0.0,0.0,33.0,0.0,1.0,Matches,361.0,de GER,FW,33.0,3.1,33.0,74.0,44.6,408.0,79.0,18.0,36.0,50.0,10.0,22.0,45.5,2.0,6.0,33.3,0.0,0.0,0.0,0.0,1.0,1.0,1.0,0.0,5.0,Matches,424,de GER,FW,33,27,277.0,10.0,9.1,3.1,0,,0,27,10.0,7,1.96,7.0,8.0,-1.0,-0.32,-0.58,4.3,7.5,-3.2,-1.03,-1.11,Matches,361.0,de GER,FW,33.0,3.1,138.0,8.0,18.0,55.0,65.0,15.0,138.0,5.0,0.0,0.0,4.0,80.0,54.0,145.0,52.0,1.0,1.0,1.0,16.0,4.0,88.0,12.0,Matches,361.0,de GER,FW,33.0,3.1,1.0,9.0,2.0,22.2,2.92,0.65,0.11,0.5,17.7,0.0,0.0,0.0,1.2,1.2,0.13,-0.2,-0.2,Matches,361.0,de GER,FW,33.0,27.0,0.0,277.0,3.1,1.0,0.0,1.0,1.0,0.0,0.0,1.0,0.0,1.2,1.2,0.0,1.2,1.0,5.0,12.0,0.32,0.0,0.32,0.32,0.32,0.39,0.01,0.4,0.39,0.4,Matches,Nils Petersen,S,33,136,136,Germany,Sport-Club Freiburg,6,8,9,17,11,8,15,12,5,7,9,16,7,10,9,17,12,15,17,9,10,13,8,10,15,7,12,14,11,12,11,14,14,12,15,13,14,5,14,7,5,2,3,3,1,3,3,3,2,2,4,3,7,11,5,15,12,17,14,16,1,1,1,1,1,1,1,7,1,8,7,1,8,20,188,83,15,20,1696111,6750,6750,6100,Northern_European,133,3,1988/12/6,2,0,10331.0,,35011356
110,Luca Pfeiffer,Stuttgart,1996,363.0,de GER,FW,25.0,7.8,1.0,1.0,1.0,0.0,0.0,0.0,1.0,0.0,1.0,4.0,0.0,4.0,1.0,2.0,5.0,0.0,Matches,363.0,de GER,FW,25.0,7.8,24.0,3.09,20.0,0.0,0.0,2.0,2.0,0.0,0.0,0.0,0.0,0.0,0.0,0.0,0.0,0.0,Matches,,,,,,,,,,,,,,,,,,,,,,,,,,,,,,,,,,,,,,,,,,,,,,,,,,,,,,,,363.0,de GER,FW,25.0,7.8,1.0,1.0,0.0,14.0,9.0,1.0,1.0,1.0,1.0,0.0,0.0,0.0,16.0,30.0,28.0,51.7,Matches,363.0,de GER,FW,25.0,7.8,201.0,186.0,14.0,0.0,1.0,4.0,1.0,0.0,0.0,0.0,0.0,0.0,129.0,1.0,3.0,Matches,363.0,de GER,FW,25.0,7.8,129.0,201.0,64.2,2051.0,499.0,68.0,96.0,70.8,44.0,67.0,65.7,11.0,16.0,68.8,0.0,1.0,1.1,-1.0,12.0,8.0,5.0,1.0,22.0,Matches,426,de GER,FW,25,19,701.0,37.0,22.9,7.8,6,78.0,0,13,18.0,7,0.95,11.0,14.0,-3.0,-0.39,-0.04,13.7,10.9,2.8,0.36,0.38,Matches,363.0,de GER,FW,25.0,7.8,255.0,5.0,16.0,156.0,85.0,29.0,255.0,6.0,2.0,33.3,3.0,50.0,136.0,565.0,254.0,9.0,8.0,0.0,13.0,6.0,195.0,38.0,Matches,363.0,de GER,FW,25.0,7.8,0.0,12.0,1.0,8.3,1.54,0.13,0.0,0.0,13.8,0.0,0.0,0.0,1.6,1.6,0.13,-1.6,-1.6,Matches,363.0,de GER,FW,25.0,19.0,6.0,701.0,7.8,0.0,0.0,0.0,0.0,0.0,0.0,1.0,1.0,1.6,1.6,1.0,2.6,9.0,22.0,38.0,0.0,0.0,0.0,0.0,0.0,0.21,0.13,0.33,0.21,0.33,Matches,Luca Pfeiffer,S,25,123,133,Germany,VfB Stuttgart,3,6,12,14,12,4,14,8,4,6,13,12,6,13,13,13,13,12,12,13,13,14,10,7,13,6,12,11,11,11,14,16,15,12,13,15,14,8,14,5,10,3,1,4,2,3,2,1,3,1,3,2,8,13,6,12,12,11,10,11,1,1,1,1,1,1,1,1,1,1,14,11,14,20,196,95,14,20,2802994,6250,6250,4750,Northern_European,123,4,1996/8/20,0,0,8500.0,,91175522
111,Maximilian Philipp,Wolfsburg,1994,364.0,de GER,FW,28.0,1.3,2.0,1.0,1.0,1.0,0.0,1.0,1.0,100.0,0.0,1.0,0.0,1.0,0.0,2.0,0.0,0.0,Matches,364.0,de GER,FW,28.0,1.3,1.0,0.78,1.0,0.0,0.0,0.0,0.0,0.0,0.0,0.0,0.0,0.0,0.0,0.0,0.0,0.0,Matches,,,,,,,,,,,,,,,,,,,,,,,,,,,,,,,,,,,,,,,,,,,,,,,,,,,,,,,,364.0,de GER,FW,28.0,1.3,0.0,0.0,0.0,0.0,7.0,1.0,7.0,0.0,1.0,0.0,0.0,0.0,3.0,1.0,2.0,33.3,Matches,364.0,de GER,FW,28.0,1.3,42.0,34.0,8.0,2.0,0.0,0.0,7.0,1.0,5.0,5.0,0.0,0.0,27.0,0.0,2.0,Matches,364.0,de GER,FW,28.0,1.3,27.0,42.0,64.3,427.0,64.0,17.0,19.0,89.5,7.0,9.0,77.8,2.0,9.0,22.2,0.0,0.0,0.1,0.0,1.0,1.0,1.0,0.0,1.0,Matches,428,de GER,FW,28,3,116.0,39.0,3.8,1.3,1,58.0,0,2,29.0,4,1.33,0.0,1.0,-1.0,-0.78,-1.08,1.2,2.3,-1.1,-0.85,-0.88,Matches,364.0,de GER,FW,28.0,1.3,51.0,0.0,3.0,19.0,29.0,4.0,51.0,2.0,0.0,0.0,2.0,100.0,31.0,113.0,31.0,3.0,0.0,2.0,1.0,1.0,34.0,6.0,Matches,364.0,de GER,FW,28.0,1.3,0.0,1.0,1.0,100.0,0.78,0.78,0.0,0.0,18.2,0.0,0.0,0.0,0.1,0.1,0.07,-0.1,-0.1,Matches,364.0,de GER,FW,28.0,3.0,1.0,116.0,1.3,0.0,0.0,0.0,0.0,0.0,0.0,0.0,0.0,0.1,0.1,0.0,0.1,3.0,1.0,6.0,0.0,0.0,0.0,0.0,0.0,0.05,0.03,0.08,0.05,0.08,Matches,Maximilian Philipp,AM RLC,28,131,143,Germany,VfL Wolfsburg,13,11,13,12,16,14,8,15,4,6,12,16,7,16,13,12,9,12,10,14,12,11,14,6,13,7,11,9,14,13,12,11,12,14,12,11,10,4,12,11,13,2,2,3,3,2,1,1,1,3,4,3,12,12,5,7,11,15,18,17,1,1,1,1,1,1,1,10,12,10,15,20,15,14,183,77,14,20,3641623,6550,6550,5050,Northern_European,130,3,1994/3/1,0,0,76711.0,,91108767
112,Sebastian Polter,Schalke 04,1991,370.0,de GER,FW,31.0,7.0,4.0,3.0,0.0,4.0,0.0,1.0,4.0,25.0,3.0,4.0,0.0,4.0,1.0,5.0,6.0,0.0,Matches,370.0,de GER,FW,31.0,7.0,16.0,2.29,13.0,0.0,0.0,2.0,1.0,0.0,4.0,0.57,3.0,0.0,0.0,0.0,1.0,0.0,Matches,,,,,,,,,,,,,,,,,,,,,,,,,,,,,,,,,,,,,,,,,,,,,,,,,,,,,,,,370.0,de GER,FW,31.0,7.0,3.0,0.0,0.0,23.0,11.0,3.0,2.0,1.0,3.0,0.0,0.0,0.0,24.0,39.0,35.0,52.7,Matches,370.0,de GER,FW,31.0,7.0,160.0,142.0,13.0,1.0,0.0,1.0,2.0,0.0,0.0,0.0,0.0,0.0,84.0,5.0,3.0,Matches,370.0,de GER,FW,31.0,7.0,84.0,160.0,52.5,1126.0,290.0,44.0,80.0,55.0,28.0,50.0,56.0,1.0,4.0,25.0,3.0,1.0,0.8,2.0,9.0,5.0,5.0,0.0,11.0,Matches,434,de GER,FW,31,19,630.0,33.0,20.6,7.0,5,73.0,2,14,19.0,1,0.84,14.0,22.0,-8.0,-1.14,-0.11,11.2,16.5,-5.3,-0.76,-0.3,Matches,370.0,de GER,FW,31.0,7.0,230.0,8.0,21.0,104.0,108.0,43.0,230.0,4.0,2.0,50.0,2.0,50.0,107.0,373.0,131.0,4.0,4.0,2.0,26.0,11.0,168.0,32.0,Matches,370.0,de GER,FW,31.0,7.0,2.0,12.0,7.0,58.3,1.71,1.0,0.17,0.29,9.8,0.0,0.0,0.0,2.0,2.0,0.17,0.0,0.0,Matches,370.0,de GER,FW,31.0,19.0,5.0,630.0,7.0,2.0,3.0,5.0,2.0,0.0,0.0,3.0,0.0,2.0,2.0,1.0,3.0,4.0,11.0,32.0,0.29,0.43,0.71,0.29,0.71,0.28,0.15,0.43,0.28,0.43,Matches,Sebastian Polter,S,31,125,130,Germany,FC Schalke 04,3,7,8,14,11,4,16,11,5,6,9,15,6,10,16,13,18,13,12,11,12,17,8,12,14,7,12,16,11,9,14,17,17,14,13,16,12,14,14,3,6,12,10,12,15,8,12,10,8,8,12,12,13,15,16,7,15,8,6,8,5,1,1,1,1,1,1,1,1,1,14,14,14,20,192,92,13,20,2911988,6250,6250,5250,Northern_European,125,4,1991/4/1,0,0,28766.0,,35026146
113,Stefan Posch,Hoffenheim,1997,371.0,at AUT,DF,25.0,0.2,0.0,0.0,0.0,0.0,0.0,0.0,0.0,,0.0,0.0,0.0,0.0,0.0,0.0,0.0,0.0,Matches,371.0,at AUT,DF,25.0,0.2,0.0,0.0,0.0,0.0,0.0,0.0,0.0,0.0,0.0,0.0,0.0,0.0,0.0,0.0,0.0,0.0,Matches,,,,,,,,,,,,,,,,,,,,,,,,,,,,,,,,,,,,,,,,,,,,,,,,,,,,,,,,371.0,at AUT,DF,25.0,0.2,2.0,1.0,1.0,2.0,0.0,0.0,0.0,0.0,0.0,0.0,0.0,0.0,0.0,0.0,0.0,,Matches,371.0,at AUT,DF,25.0,0.2,12.0,10.0,2.0,2.0,0.0,0.0,0.0,0.0,0.0,0.0,0.0,0.0,8.0,0.0,1.0,Matches,371.0,at AUT,DF,25.0,0.2,8.0,12.0,66.7,163.0,27.0,1.0,3.0,33.3,6.0,6.0,100.0,1.0,2.0,50.0,0.0,0.0,0.0,0.0,0.0,0.0,0.0,0.0,0.0,Matches,435,at AUT,DF,25,1,18.0,18.0,0.6,0.2,1,18.0,0,0,,2,0.0,0.0,0.0,0.0,0.0,0.27,0.0,0.0,0.0,0.08,0.17,Matches,371.0,at AUT,DF,25.0,0.2,12.0,2.0,7.0,5.0,0.0,0.0,12.0,0.0,0.0,,0.0,,6.0,23.0,11.0,0.0,0.0,0.0,0.0,0.0,7.0,0.0,Matches,371.0,at AUT,DF,25.0,0.2,0.0,0.0,0.0,,0.0,0.0,,,,0.0,0.0,0.0,0.0,0.0,,0.0,0.0,Matches,371.0,at AUT,DF,25.0,1.0,1.0,18.0,0.2,0.0,0.0,0.0,0.0,0.0,0.0,2.0,1.0,0.0,0.0,0.0,0.0,0.0,0.0,0.0,0.0,0.0,0.0,0.0,0.0,0.0,0.0,0.0,0.0,0.0,Matches,Stefan Posch,D RC,25,129,138,Austria,TSG Hoffenheim,5,9,9,6,11,5,13,6,10,13,11,9,14,11,8,13,14,16,12,9,13,12,5,10,6,12,16,10,13,13,12,16,14,14,14,12,14,11,16,7,10,3,3,3,3,3,3,1,3,1,4,3,12,15,10,10,16,13,15,18,1,8,20,15,1,11,10,1,7,1,1,1,1,1,189,82,12,20,3178596,6445,6345,4745,Northern_European,128,2,1997/5/14,16,1,21999.0,Bologna FC 1909,16147386
114,Yussuf Poulsen,RB Leipzig,1994,372.0,dk DEN,FW,28.0,4.6,6.0,4.0,1.0,4.0,1.0,2.0,5.0,40.0,3.0,3.0,1.0,2.0,0.0,6.0,5.0,0.0,Matches,372.0,dk DEN,FW,28.0,4.6,13.0,2.84,7.0,0.0,3.0,2.0,1.0,0.0,2.0,0.44,1.0,0.0,0.0,0.0,1.0,0.0,Matches,,,,,,,,,,,,,,,,,,,,,,,,,,,,,,,,,,,,,,,,,,,,,,,,,,,,,,,,372.0,dk DEN,FW,28.0,4.6,1.0,0.0,0.0,10.0,9.0,2.0,4.0,0.0,4.0,0.0,0.0,0.0,21.0,27.0,12.0,69.2,Matches,372.0,dk DEN,FW,28.0,4.6,126.0,120.0,5.0,0.0,3.0,0.0,4.0,3.0,0.0,0.0,0.0,0.0,69.0,1.0,2.0,Matches,372.0,dk DEN,FW,28.0,4.6,69.0,126.0,54.8,844.0,220.0,40.0,61.0,65.6,14.0,37.0,37.8,4.0,9.0,44.4,1.0,1.8,1.6,-0.8,8.0,7.0,2.0,1.0,7.0,Matches,436,dk DEN,FW,28,19,411.0,22.0,13.4,4.6,3,61.0,0,16,14.0,5,2.05,13.0,3.0,10.0,2.19,1.75,10.5,5.8,4.7,1.03,0.33,Matches,372.0,dk DEN,FW,28.0,4.6,198.0,6.0,17.0,102.0,80.0,28.0,198.0,9.0,6.0,66.7,3.0,33.3,125.0,616.0,271.0,10.0,3.0,3.0,27.0,10.0,165.0,40.0,Matches,372.0,dk DEN,FW,28.0,4.6,2.0,13.0,6.0,46.2,2.85,1.31,0.15,0.33,13.4,0.0,0.0,0.0,1.3,1.3,0.1,0.7,0.7,Matches,372.0,dk DEN,FW,28.0,19.0,3.0,411.0,4.6,2.0,1.0,3.0,2.0,0.0,0.0,1.0,0.0,1.3,1.3,1.8,3.1,10.0,7.0,40.0,0.44,0.22,0.66,0.44,0.66,0.29,0.39,0.68,0.29,0.68,Matches,Yussuf Poulsen,S R,28,138,145,"Denmark,Tanzania",RB Leipzig,6,9,12,13,12,7,14,9,11,7,11,10,9,11,18,11,18,11,14,12,13,16,13,11,16,7,17,18,13,11,15,17,17,14,15,16,14,8,15,12,8,2,1,4,3,1,2,3,4,1,3,2,15,17,9,8,12,13,15,9,1,1,1,1,1,1,1,10,1,15,10,8,15,20,192,84,12,20,5207341,6900,6900,6100,Mixed_Race,136,11,1994/6/15,68,11,64923.0,,27051813
115,Eduardo Quaresma,Hoffenheim,2002,375.0,pt POR,DF,20.0,1.0,5.0,3.0,3.0,2.0,0.0,1.0,3.0,33.3,2.0,3.0,2.0,1.0,0.0,5.0,3.0,0.0,Matches,375.0,pt POR,DF,20.0,1.0,2.0,2.05,1.0,0.0,0.0,0.0,1.0,0.0,0.0,0.0,0.0,0.0,0.0,0.0,0.0,0.0,Matches,,,,,,,,,,,,,,,,,,,,,,,,,,,,,,,,,,,,,,,,,,,,,,,,,,,,,,,,375.0,pt POR,DF,20.0,1.0,0.0,0.0,0.0,1.0,1.0,0.0,0.0,0.0,3.0,0.0,0.0,0.0,10.0,1.0,1.0,50.0,Matches,375.0,pt POR,DF,20.0,1.0,68.0,67.0,1.0,0.0,0.0,0.0,0.0,1.0,0.0,0.0,0.0,0.0,60.0,0.0,0.0,Matches,375.0,pt POR,DF,20.0,1.0,60.0,68.0,88.2,1119.0,317.0,21.0,24.0,87.5,36.0,39.0,92.3,3.0,5.0,60.0,0.0,0.0,0.0,0.0,0.0,5.0,1.0,0.0,10.0,Matches,439,pt POR,DF,20,4,88.0,22.0,2.9,1.0,1,45.0,0,3,14.0,7,1.0,1.0,3.0,-2.0,-2.05,-1.83,1.7,1.3,0.4,0.37,0.47,Matches,375.0,pt POR,DF,20.0,1.0,81.0,4.0,25.0,53.0,4.0,1.0,81.0,2.0,1.0,50.0,0.0,0.0,56.0,228.0,133.0,4.0,1.0,0.0,1.0,0.0,51.0,0.0,Matches,375.0,pt POR,DF,20.0,1.0,0.0,0.0,0.0,,0.0,0.0,,,,0.0,0.0,0.0,0.0,0.0,,0.0,0.0,Matches,375.0,pt POR,DF,20.0,4.0,1.0,88.0,1.0,0.0,0.0,0.0,0.0,0.0,0.0,0.0,0.0,0.0,0.0,0.0,0.0,4.0,10.0,0.0,0.0,0.0,0.0,0.0,0.0,0.0,0.0,0.0,0.0,0.0,Matches,Eduardo Quaresma,D C,20,117,-8,Portugal,Sporting Clube de Portugal,5,9,12,8,12,6,11,6,11,12,13,11,16,12,13,13,15,11,8,11,9,12,5,12,8,13,12,14,13,13,14,12,14,13,14,13,14,11,14,4,10,3,1,4,1,2,1,1,3,2,3,2,18,9,11,14,8,9,13,14,1,1,20,14,1,10,13,1,1,1,1,1,1,1,185,78,12,20,26662501,5792,5792,4053,Mediterranean_Hispanic,118,4,2002/3/2,0,0,5028.0,TSG Hoffenheim,83261917
116,Rocco Reitz,Gladbach,2002,380.0,de GER,MF,20.0,0.0,0.0,0.0,0.0,0.0,0.0,0.0,0.0,,0.0,0.0,0.0,0.0,0.0,0.0,0.0,0.0,Matches,380.0,de GER,MF,20.0,0.0,0.0,0.0,0.0,0.0,0.0,0.0,0.0,0.0,0.0,0.0,0.0,0.0,0.0,0.0,0.0,0.0,Matches,,,,,,,,,,,,,,,,,,,,,,,,,,,,,,,,,,,,,,,,,,,,,,,,,,,,,,,,380.0,de GER,MF,20.0,0.0,0.0,0.0,0.0,0.0,0.0,0.0,0.0,0.0,0.0,0.0,0.0,0.0,0.0,0.0,0.0,,Matches,380.0,de GER,MF,20.0,0.0,2.0,2.0,0.0,0.0,0.0,0.0,0.0,0.0,0.0,0.0,0.0,0.0,2.0,0.0,0.0,Matches,380.0,de GER,MF,20.0,0.0,2.0,2.0,100.0,30.0,0.0,1.0,1.0,100.0,1.0,1.0,100.0,0.0,0.0,,0.0,0.0,0.0,0.0,0.0,0.0,0.0,0.0,0.0,Matches,445,de GER,MF,20,1,3.0,3.0,0.1,0.0,0,,0,1,3.0,12,0.0,0.0,0.0,0.0,0.0,0.09,0.0,0.0,0.0,0.0,0.04,Matches,380.0,de GER,MF,20.0,0.0,2.0,0.0,0.0,2.0,0.0,0.0,2.0,0.0,0.0,,0.0,,2.0,10.0,2.0,0.0,0.0,0.0,0.0,0.0,2.0,0.0,Matches,380.0,de GER,MF,20.0,0.0,0.0,0.0,0.0,,0.0,0.0,,,,0.0,0.0,0.0,0.0,0.0,,0.0,0.0,Matches,380.0,de GER,MF,20.0,1.0,0.0,3.0,0.0,0.0,0.0,0.0,0.0,0.0,0.0,0.0,0.0,0.0,0.0,0.0,0.0,0.0,0.0,0.0,0.0,0.0,0.0,0.0,0.0,0.0,0.0,0.0,0.0,0.0,Matches,Rocco Reitz,M C,20,108,139,Germany,Borussia Mönchengladbach,12,11,11,9,13,12,6,11,3,11,13,8,12,14,13,11,12,12,10,13,11,12,12,6,12,11,12,12,12,11,12,7,13,12,13,8,11,9,11,7,10,1,3,2,3,4,3,3,1,1,2,3,10,12,4,14,9,12,10,9,1,1,1,1,1,1,15,12,20,12,10,15,10,8,176,72,11,20,3775000,5400,5400,3900,Northern_European,108,2,2002/5/29,0,0,7671.0,,91206105
117,Merlin Röhl,Freiburg,2002,388.0,de GER,MFFW,20.0,0.6,1.0,0.0,1.0,0.0,0.0,0.0,0.0,,0.0,0.0,0.0,0.0,0.0,1.0,1.0,0.0,Matches,388.0,de GER,MFFW,20.0,0.6,2.0,3.16,2.0,0.0,0.0,0.0,0.0,0.0,1.0,1.58,1.0,0.0,0.0,0.0,0.0,0.0,Matches,,,,,,,,,,,,,,,,,,,,,,,,,,,,,,,,,,,,,,,,,,,,,,,,,,,,,,,,388.0,de GER,MFFW,20.0,0.6,0.0,0.0,0.0,1.0,4.0,0.0,0.0,0.0,0.0,0.0,0.0,0.0,6.0,1.0,0.0,100.0,Matches,388.0,de GER,MFFW,20.0,0.6,18.0,18.0,0.0,0.0,0.0,0.0,0.0,0.0,0.0,0.0,0.0,0.0,13.0,0.0,2.0,Matches,388.0,de GER,MFFW,20.0,0.6,13.0,18.0,72.2,158.0,41.0,8.0,9.0,88.9,4.0,5.0,80.0,0.0,0.0,,1.0,0.5,0.2,0.5,3.0,1.0,1.0,0.0,1.0,Matches,454,de GER,MFFW,20,3,57.0,19.0,1.9,0.6,0,,0,3,19.0,8,1.33,1.0,1.0,0.0,0.0,-0.21,1.0,0.9,0.1,0.18,0.21,Matches,388.0,de GER,MFFW,20.0,0.6,30.0,0.0,6.0,16.0,8.0,3.0,30.0,1.0,0.0,0.0,0.0,0.0,20.0,87.0,39.0,2.0,1.0,0.0,2.0,4.0,20.0,4.0,Matches,388.0,de GER,MFFW,20.0,0.6,0.0,0.0,0.0,,0.0,0.0,,,,0.0,0.0,0.0,0.0,0.0,,0.0,0.0,Matches,388.0,de GER,MFFW,20.0,3.0,0.0,57.0,0.6,0.0,1.0,1.0,0.0,0.0,0.0,0.0,0.0,0.0,0.0,0.5,0.5,2.0,1.0,4.0,0.0,1.58,1.58,0.0,1.58,0.0,0.73,0.73,0.0,0.73,Matches,Merlin Röhl,DM/M C,20,122,-75,Germany,Sport-Club Freiburg,7,8,10,11,12,9,12,10,4,11,13,10,12,11,14,12,11,12,12,12,11,15,7,11,10,10,14,14,12,11,11,15,15,12,15,12,11,10,12,7,15,4,3,2,3,1,1,3,2,1,2,3,19,12,7,12,10,11,12,11,1,1,12,1,1,12,20,1,20,12,1,15,10,1,191,0,15,20,59540001,5850,5850,4000,Northern_European,115,2,2002/7/5,0,0,767.0,,91204520
118,Tom Rothe,Dortmund,2004,390.0,de GER,DF,17.0,0.3,1.0,1.0,0.0,1.0,0.0,1.0,1.0,100.0,0.0,0.0,0.0,0.0,1.0,2.0,2.0,0.0,Matches,390.0,de GER,DF,17.0,0.3,0.0,0.0,0.0,0.0,0.0,0.0,0.0,0.0,0.0,0.0,0.0,0.0,0.0,0.0,0.0,0.0,Matches,,,,,,,,,,,,,,,,,,,,,,,,,,,,,,,,,,,,,,,,,,,,,,,,,,,,,,,,390.0,de GER,DF,17.0,0.3,0.0,0.0,0.0,2.0,0.0,0.0,2.0,1.0,1.0,0.0,0.0,0.0,4.0,0.0,0.0,,Matches,390.0,de GER,DF,17.0,0.3,18.0,14.0,4.0,2.0,0.0,0.0,2.0,2.0,0.0,0.0,0.0,0.0,15.0,0.0,0.0,Matches,390.0,de GER,DF,17.0,0.3,15.0,18.0,83.3,282.0,72.0,5.0,6.0,83.3,9.0,9.0,100.0,1.0,3.0,33.3,0.0,0.0,0.0,0.0,0.0,1.0,0.0,0.0,0.0,Matches,456,de GER,DF,17,2,26.0,13.0,0.8,0.3,0,,0,2,13.0,9,1.5,1.0,0.0,1.0,3.46,2.33,0.5,1.1,-0.6,-2.07,-2.92,Matches,390.0,de GER,DF,17.0,0.3,22.0,3.0,8.0,7.0,7.0,1.0,22.0,1.0,1.0,100.0,0.0,0.0,12.0,26.0,14.0,0.0,0.0,0.0,0.0,0.0,10.0,2.0,Matches,390.0,de GER,DF,17.0,0.3,0.0,1.0,0.0,0.0,3.46,0.0,0.0,,7.7,0.0,0.0,0.0,0.1,0.1,0.07,-0.1,-0.1,Matches,390.0,de GER,DF,17.0,2.0,0.0,26.0,0.3,0.0,0.0,0.0,0.0,0.0,0.0,0.0,0.0,0.1,0.1,0.0,0.1,0.0,0.0,2.0,0.0,0.0,0.0,0.0,0.0,0.26,0.0,0.26,0.26,0.26,Matches,Tom Rothe,D/WB/M L,17,110,-8,Germany,Borussia Dortmund,8,14,10,10,14,10,14,7,9,13,12,7,14,12,5,12,11,8,8,11,14,15,7,2,9,8,10,8,11,11,14,15,10,13,14,13,9,6,13,11,14,2,1,1,2,2,2,4,3,2,3,2,17,10,6,11,9,10,12,16,1,20,14,1,18,1,10,16,1,1,1,1,1,1,192,0,20,7,21000000,5500,5500,3510,Northern_European,107,0,2004/10/29,0,0,4424.0,,2000146948
119,Jérôme Roussillon,Wolfsburg,1993,391.0,fr FRA,MFDF,29.0,0.2,0.0,0.0,0.0,0.0,0.0,0.0,0.0,,0.0,0.0,0.0,0.0,0.0,0.0,0.0,0.0,Matches,391.0,fr FRA,MFDF,29.0,0.2,0.0,0.0,0.0,0.0,0.0,0.0,0.0,0.0,0.0,0.0,0.0,0.0,0.0,0.0,0.0,0.0,Matches,,,,,,,,,,,,,,,,,,,,,,,,,,,,,,,,,,,,,,,,,,,,,,,,,,,,,,,,391.0,fr FRA,MFDF,29.0,0.2,0.0,0.0,0.0,1.0,0.0,0.0,0.0,0.0,0.0,0.0,0.0,0.0,2.0,1.0,1.0,50.0,Matches,391.0,fr FRA,MFDF,29.0,0.2,7.0,6.0,1.0,0.0,0.0,0.0,0.0,1.0,0.0,0.0,0.0,0.0,3.0,0.0,0.0,Matches,391.0,fr FRA,MFDF,29.0,0.2,3.0,7.0,42.9,40.0,5.0,2.0,3.0,66.7,1.0,3.0,33.3,0.0,0.0,,0.0,0.0,0.0,0.0,1.0,0.0,0.0,0.0,0.0,Matches,457,fr FRA,MFDF,29,4,22.0,6.0,0.7,0.2,0,,0,4,6.0,1,2.5,1.0,0.0,1.0,4.09,3.85,0.5,0.4,0.0,0.12,0.12,Matches,391.0,fr FRA,MFDF,29.0,0.2,11.0,0.0,0.0,4.0,7.0,0.0,11.0,1.0,0.0,0.0,1.0,100.0,7.0,21.0,5.0,0.0,0.0,0.0,2.0,2.0,7.0,2.0,Matches,391.0,fr FRA,MFDF,29.0,0.2,0.0,0.0,0.0,,0.0,0.0,,,,0.0,0.0,0.0,0.0,0.0,,0.0,0.0,Matches,391.0,fr FRA,MFDF,29.0,4.0,0.0,22.0,0.2,0.0,0.0,0.0,0.0,0.0,0.0,0.0,0.0,0.0,0.0,0.0,0.0,0.0,0.0,2.0,0.0,0.0,0.0,0.0,0.0,0.0,0.08,0.08,0.0,0.08,Matches,Jérôme Roussillon,D/WB L,29,128,140,"France,Guadeloupe",VfL Wolfsburg,6,13,13,9,11,6,8,10,12,11,12,7,12,12,13,12,14,11,10,11,10,13,13,8,14,11,12,12,16,12,14,7,14,16,14,13,11,10,14,10,9,1,2,4,3,2,1,3,3,2,1,2,11,13,10,12,12,13,15,15,1,20,1,12,18,10,1,12,1,10,12,1,1,1,175,80,20,11,2419346,6400,6650,5500,African_Caribbean,118,17,1993/1/6,0,0,72876.0,,85057004
120,Sebastian Rudy,Hoffenheim,1990,393.0,de GER,MF,32.0,8.8,26.0,12.0,10.0,16.0,0.0,13.0,27.0,48.1,14.0,27.0,7.0,20.0,11.0,37.0,13.0,0.0,Matches,393.0,de GER,MF,32.0,8.8,23.0,2.6,11.0,12.0,0.0,0.0,0.0,0.0,2.0,0.23,2.0,0.0,0.0,0.0,0.0,0.0,Matches,,,,,,,,,,,,,,,,,,,,,,,,,,,,,,,,,,,,,,,,,,,,,,,,,,,,,,,,393.0,de GER,MF,32.0,8.8,3.0,0.0,0.0,22.0,9.0,0.0,41.0,11.0,12.0,0.0,0.0,0.0,54.0,7.0,10.0,41.2,Matches,393.0,de GER,MF,32.0,8.8,442.0,387.0,53.0,21.0,0.0,1.0,41.0,0.0,30.0,7.0,13.0,2.0,330.0,2.0,8.0,Matches,393.0,de GER,MF,32.0,8.8,330.0,442.0,74.7,6007.0,2289.0,146.0,171.0,85.4,132.0,159.0,83.0,43.0,81.0,53.1,1.0,0.8,1.6,0.2,14.0,32.0,7.0,4.0,42.0,Matches,459,de GER,MF,32,22,794.0,36.0,25.9,8.8,6,68.0,1,16,24.0,9,1.18,13.0,13.0,0.0,0.0,0.36,12.5,11.5,1.0,0.11,0.28,Matches,393.0,de GER,MF,32.0,8.8,547.0,25.0,141.0,296.0,112.0,4.0,547.0,3.0,0.0,0.0,3.0,100.0,247.0,1017.0,461.0,7.0,5.0,0.0,12.0,8.0,306.0,7.0,Matches,393.0,de GER,MF,32.0,8.8,0.0,5.0,2.0,40.0,0.57,0.23,0.0,0.0,29.1,0.0,0.0,0.0,0.2,0.2,0.03,-0.2,-0.2,Matches,393.0,de GER,MF,32.0,22.0,6.0,794.0,8.8,0.0,1.0,1.0,0.0,0.0,0.0,3.0,0.0,0.2,0.2,0.8,0.9,7.0,42.0,7.0,0.0,0.11,0.11,0.0,0.11,0.02,0.09,0.11,0.02,0.11,Matches,Sebastian Rudy,DM/M RC,32,134,148,Germany,TSG Hoffenheim,12,12,10,8,14,10,7,13,8,13,14,11,12,14,10,14,10,15,14,14,14,10,8,13,9,14,18,13,12,12,10,9,13,12,13,11,14,8,10,8,14,2,1,2,1,2,3,2,2,2,1,1,7,14,3,13,11,15,17,19,1,1,12,15,1,12,20,10,20,11,10,12,11,1,180,74,11,20,3146982,6700,7200,5750,Northern_European,131,2,1990/2/28,28,1,76711.0,,29022542
121,Marcel Sabitzer,Bayern Munich,1994,398.0,at AUT,MF,28.0,7.0,27.0,14.0,11.0,10.0,6.0,10.0,17.0,58.8,7.0,3.0,0.0,3.0,10.0,37.0,9.0,0.0,Matches,398.0,at AUT,MF,28.0,7.0,11.0,1.58,9.0,0.0,0.0,0.0,0.0,2.0,1.0,0.14,1.0,0.0,0.0,0.0,0.0,0.0,Matches,,,,,,,,,,,,,,,,,,,,,,,,,,,,,,,,,,,,,,,,,,,,,,,,,,,,,,,,398.0,at AUT,MF,28.0,7.0,2.0,0.0,0.0,7.0,1.0,1.0,5.0,10.0,14.0,0.0,0.0,0.0,47.0,8.0,11.0,42.1,Matches,398.0,at AUT,MF,28.0,7.0,466.0,451.0,12.0,6.0,1.0,2.0,5.0,4.0,1.0,1.0,0.0,0.0,402.0,3.0,3.0,Matches,398.0,at AUT,MF,28.0,7.0,402.0,466.0,86.3,6205.0,1668.0,210.0,230.0,91.3,159.0,181.0,87.8,19.0,32.0,59.4,1.0,0.4,0.6,0.6,6.0,36.0,5.0,0.0,52.0,Matches,464,at AUT,MF,28,15,628.0,42.0,20.5,7.0,7,67.0,2,8,20.0,3,2.27,22.0,3.0,19.0,2.72,1.43,16.9,3.7,13.2,1.89,0.97,Matches,398.0,at AUT,MF,28.0,7.0,548.0,10.0,88.0,323.0,141.0,9.0,548.0,3.0,1.0,33.3,2.0,66.7,312.0,1283.0,572.0,7.0,8.0,0.0,6.0,3.0,368.0,19.0,Matches,398.0,at AUT,MF,28.0,7.0,1.0,15.0,5.0,33.3,2.15,0.72,0.07,0.2,21.7,0.0,0.0,0.0,1.1,1.1,0.07,-0.1,-0.1,Matches,398.0,at AUT,MF,28.0,15.0,7.0,628.0,7.0,1.0,1.0,2.0,1.0,0.0,0.0,2.0,0.0,1.1,1.1,0.4,1.4,7.0,52.0,19.0,0.14,0.14,0.29,0.14,0.29,0.15,0.05,0.2,0.15,0.2,Matches,Marcel Sabitzer,M RC,28,148,156,Austria,FC Bayern München,11,12,12,12,13,15,11,16,4,12,14,16,14,13,16,14,15,13,13,14,13,17,13,13,16,14,16,17,12,12,12,9,16,14,16,12,15,12,14,8,19,3,3,2,3,1,3,1,2,2,1,3,13,16,13,7,16,16,8,10,1,10,1,10,10,10,15,10,20,10,12,15,15,10,178,76,12,20,21613401,7399,7399,6899,Northern_European,146,4,1994/3/17,64,12,191781.0,,16045721
122,Sidi Sané,Schalke 04,2003,403.0,de GER,FW,19.0,0.3,1.0,1.0,1.0,0.0,0.0,1.0,1.0,100.0,0.0,0.0,0.0,0.0,0.0,1.0,0.0,0.0,Matches,403.0,de GER,FW,19.0,0.3,0.0,0.0,0.0,0.0,0.0,0.0,0.0,0.0,0.0,0.0,0.0,0.0,0.0,0.0,0.0,0.0,Matches,,,,,,,,,,,,,,,,,,,,,,,,,,,,,,,,,,,,,,,,,,,,,,,,,,,,,,,,403.0,de GER,FW,19.0,0.3,0.0,0.0,0.0,0.0,0.0,0.0,0.0,0.0,1.0,0.0,0.0,0.0,1.0,0.0,0.0,,Matches,403.0,de GER,FW,19.0,0.3,7.0,7.0,0.0,0.0,0.0,0.0,0.0,0.0,0.0,0.0,0.0,0.0,7.0,0.0,0.0,Matches,403.0,de GER,FW,19.0,0.3,7.0,7.0,100.0,103.0,6.0,1.0,1.0,100.0,3.0,3.0,100.0,1.0,1.0,100.0,0.0,0.0,0.0,0.0,0.0,0.0,0.0,0.0,0.0,Matches,469,de GER,FW,19,1,25.0,25.0,0.8,0.3,0,,0,1,25.0,4,0.0,0.0,0.0,0.0,0.0,1.07,0.0,0.6,-0.6,-2.21,-1.71,Matches,403.0,de GER,FW,19.0,0.3,10.0,1.0,1.0,4.0,5.0,0.0,10.0,1.0,0.0,0.0,0.0,0.0,5.0,15.0,12.0,0.0,0.0,0.0,1.0,0.0,6.0,0.0,Matches,403.0,de GER,FW,19.0,0.3,0.0,0.0,0.0,,0.0,0.0,,,,0.0,0.0,0.0,0.0,0.0,,0.0,0.0,Matches,403.0,de GER,FW,19.0,1.0,0.0,25.0,0.3,0.0,0.0,0.0,0.0,0.0,0.0,0.0,0.0,0.0,0.0,0.0,0.0,0.0,0.0,0.0,0.0,0.0,0.0,0.0,0.0,0.0,0.0,0.0,0.0,0.0,Matches,Sidi Sané,M/AM RL,19,102,-75,"Germany,France,Senegal",FC Schalke 04,4,8,12,10,11,11,11,8,5,11,11,12,11,12,6,9,10,9,9,11,8,12,14,3,11,12,12,9,14,12,11,13,12,15,12,10,11,2,14,11,18,1,4,3,3,2,3,3,3,3,1,4,7,11,6,14,9,11,15,17,1,1,14,10,1,12,1,12,1,18,15,10,20,14,187,71,8,20,3923999,5100,5100,3611,African_Caribbean,99,16,2003/4/21,0,0,7671.0,,2000065710
123,Bouna Sarr,Bayern Munich,1992,404.0,sn SEN,FW,30.0,0.0,0.0,0.0,0.0,0.0,0.0,0.0,0.0,,0.0,0.0,0.0,0.0,0.0,0.0,0.0,0.0,Matches,404.0,sn SEN,FW,30.0,0.0,0.0,0.0,0.0,0.0,0.0,0.0,0.0,0.0,0.0,0.0,0.0,0.0,0.0,0.0,0.0,0.0,Matches,,,,,,,,,,,,,,,,,,,,,,,,,,,,,,,,,,,,,,,,,,,,,,,,,,,,,,,,404.0,sn SEN,FW,30.0,0.0,0.0,0.0,0.0,0.0,0.0,0.0,0.0,0.0,0.0,0.0,0.0,0.0,0.0,0.0,0.0,,Matches,404.0,sn SEN,FW,30.0,0.0,2.0,2.0,0.0,0.0,0.0,0.0,0.0,0.0,0.0,0.0,0.0,0.0,1.0,0.0,0.0,Matches,404.0,sn SEN,FW,30.0,0.0,1.0,2.0,50.0,17.0,3.0,0.0,0.0,,1.0,2.0,50.0,0.0,0.0,,0.0,0.0,0.0,0.0,0.0,0.0,0.0,0.0,0.0,Matches,470,sn SEN,FW,30,1,3.0,3.0,0.1,0.0,0,,0,1,3.0,12,3.0,0.0,0.0,0.0,0.0,-1.59,0.0,0.1,-0.1,-1.62,-2.74,Matches,404.0,sn SEN,FW,30.0,0.0,2.0,0.0,1.0,1.0,0.0,0.0,2.0,0.0,0.0,,0.0,,0.0,0.0,0.0,0.0,0.0,0.0,0.0,0.0,0.0,0.0,Matches,404.0,sn SEN,FW,30.0,0.0,0.0,0.0,0.0,,0.0,0.0,,,,0.0,0.0,0.0,0.0,0.0,,0.0,0.0,Matches,404.0,sn SEN,FW,30.0,1.0,0.0,3.0,0.0,0.0,0.0,0.0,0.0,0.0,0.0,0.0,0.0,0.0,0.0,0.0,0.0,0.0,0.0,0.0,0.0,0.0,0.0,0.0,0.0,0.0,0.0,0.0,0.0,0.0,Matches,Bouna Sarr,D/WB R,30,128,140,"Senegal,France,Guinea",FC Bayern München,12,11,13,8,12,11,7,8,12,10,12,9,12,13,12,12,12,11,10,11,10,12,13,4,13,11,13,15,15,14,11,8,13,15,14,10,12,9,14,12,18,3,1,3,2,3,2,2,3,3,1,2,7,13,11,12,11,13,10,10,1,12,1,20,12,18,1,12,10,15,12,10,15,8,178,71,10,20,571810,6400,6250,5250,African_Caribbean,114,16,1992/1/31,13,0,47944.0,,85072773
124,Kevin Schade,Freiburg,2001,406.0,de GER,FWMF,20.0,2.0,6.0,4.0,3.0,2.0,1.0,3.0,5.0,60.0,2.0,0.0,0.0,0.0,0.0,6.0,2.0,0.0,Matches,406.0,de GER,FWMF,20.0,2.0,1.0,0.49,0.0,0.0,0.0,0.0,1.0,0.0,0.0,0.0,0.0,0.0,0.0,0.0,0.0,0.0,Matches,,,,,,,,,,,,,,,,,,,,,,,,,,,,,,,,,,,,,,,,,,,,,,,,,,,,,,,,406.0,de GER,FWMF,20.0,2.0,0.0,0.0,0.0,4.0,6.0,0.0,3.0,0.0,4.0,0.0,0.0,0.0,7.0,17.0,12.0,58.6,Matches,406.0,de GER,FWMF,20.0,2.0,55.0,54.0,1.0,0.0,0.0,0.0,3.0,0.0,0.0,0.0,0.0,0.0,26.0,0.0,4.0,Matches,406.0,de GER,FWMF,20.0,2.0,26.0,55.0,47.3,326.0,84.0,14.0,25.0,56.0,8.0,13.0,61.5,0.0,1.0,0.0,0.0,0.0,0.5,0.0,0.0,5.0,1.0,0.0,3.0,Matches,472,de GER,FWMF,20,8,182.0,23.0,5.9,2.0,1,56.0,0,7,18.0,2,1.5,2.0,6.0,-4.0,-1.98,-2.32,0.6,4.3,-3.6,-1.8,-1.89,Matches,406.0,de GER,FWMF,20.0,2.0,100.0,3.0,12.0,37.0,52.0,13.0,100.0,12.0,3.0,25.0,8.0,66.7,48.0,319.0,129.0,7.0,3.0,5.0,8.0,6.0,68.0,20.0,Matches,406.0,de GER,FWMF,20.0,2.0,1.0,4.0,1.0,25.0,1.98,0.49,0.25,1.0,15.0,0.0,0.0,0.0,0.2,0.2,0.06,0.8,0.8,Matches,406.0,de GER,FWMF,20.0,8.0,1.0,182.0,2.0,1.0,0.0,1.0,1.0,0.0,0.0,0.0,0.0,0.2,0.2,0.0,0.2,7.0,3.0,20.0,0.49,0.0,0.49,0.49,0.49,0.12,0.0,0.12,0.12,0.12,Matches,Kevin Schade,AM/S RLC,20,133,-8,Germany,Sport-Club Freiburg,9,11,14,12,14,6,14,8,3,3,11,11,4,14,13,12,11,10,10,10,11,13,14,4,14,4,10,11,16,13,10,12,12,16,11,9,12,5,11,8,11,1,2,4,3,1,1,3,2,3,2,2,12,15,4,10,13,12,9,17,1,1,1,1,1,1,1,10,1,10,18,16,20,18,183,73,14,20,74423995,6350,6350,4005,Mixed_Race,121,13,2001/11/27,0,0,4060.0,,91208050
125,András Schäfer,Union Berlin,1999,407.0,hu HUN,MF,23.0,9.6,21.0,9.0,7.0,12.0,2.0,6.0,14.0,42.9,8.0,12.0,2.0,10.0,4.0,25.0,11.0,0.0,Matches,407.0,hu HUN,MF,23.0,9.6,10.0,1.05,8.0,0.0,0.0,0.0,2.0,0.0,2.0,0.21,1.0,0.0,0.0,0.0,1.0,0.0,Matches,,,,,,,,,,,,,,,,,,,,,,,,,,,,,,,,,,,,,,,,,,,,,,,,,,,,,,,,407.0,hu HUN,MF,23.0,9.6,0.0,0.0,0.0,14.0,15.0,1.0,8.0,4.0,9.0,0.0,0.0,0.0,65.0,11.0,14.0,44.0,Matches,407.0,hu HUN,MF,23.0,9.6,274.0,261.0,13.0,2.0,1.0,0.0,8.0,1.0,0.0,0.0,0.0,0.0,205.0,0.0,14.0,Matches,407.0,hu HUN,MF,23.0,9.6,205.0,274.0,74.8,3141.0,695.0,108.0,131.0,82.4,81.0,97.0,83.5,9.0,23.0,39.1,0.0,0.2,0.6,-0.2,3.0,22.0,4.0,1.0,26.0,Matches,473,hu HUN,MF,23,16,860.0,54.0,28.1,9.6,10,73.0,1,6,23.0,1,2.06,12.0,6.0,6.0,0.63,0.34,8.6,8.6,0.0,0.0,0.19,Matches,407.0,hu HUN,MF,23.0,9.6,391.0,15.0,90.0,189.0,125.0,14.0,391.0,32.0,9.0,28.1,14.0,43.8,203.0,1157.0,523.0,15.0,12.0,4.0,21.0,13.0,212.0,18.0,Matches,407.0,hu HUN,MF,23.0,9.6,0.0,7.0,1.0,14.3,0.73,0.1,0.0,0.0,23.5,0.0,0.0,0.0,0.4,0.4,0.06,-0.4,-0.4,Matches,407.0,hu HUN,MF,23.0,16.0,10.0,860.0,9.6,0.0,0.0,0.0,0.0,0.0,0.0,0.0,0.0,0.4,0.4,0.2,0.6,15.0,26.0,18.0,0.0,0.0,0.0,0.0,0.0,0.05,0.02,0.07,0.05,0.07,Matches,András Schäfer,DM/M C,23,135,142,Hungary,1. FC Union Berlin,9,10,12,11,13,8,9,11,4,8,12,9,11,13,11,16,15,11,15,15,17,14,12,11,13,12,15,16,13,13,11,8,13,12,11,10,12,4,10,5,13,1,2,1,1,3,1,1,4,4,3,2,12,12,4,12,13,15,14,15,1,1,1,1,1,1,17,14,20,1,10,1,1,1,179,67,14,20,4497930,6397,6497,4797,Northern_European,131,1,1999/4/13,20,3,26694.0,,38045397
126,Keven Schlotterbeck,Freiburg,1997,412.0,de GER,DF,25.0,0.2,0.0,0.0,0.0,0.0,0.0,0.0,0.0,,0.0,1.0,1.0,0.0,2.0,2.0,2.0,0.0,Matches,412.0,de GER,DF,25.0,0.2,0.0,0.0,0.0,0.0,0.0,0.0,0.0,0.0,0.0,0.0,0.0,0.0,0.0,0.0,0.0,0.0,Matches,,,,,,,,,,,,,,,,,,,,,,,,,,,,,,,,,,,,,,,,,,,,,,,,,,,,,,,,412.0,de GER,DF,25.0,0.2,0.0,0.0,0.0,0.0,1.0,0.0,0.0,2.0,0.0,0.0,0.0,0.0,0.0,2.0,0.0,100.0,Matches,412.0,de GER,DF,25.0,0.2,6.0,5.0,1.0,1.0,0.0,0.0,0.0,0.0,0.0,0.0,0.0,0.0,6.0,0.0,0.0,Matches,412.0,de GER,DF,25.0,0.2,6.0,6.0,100.0,87.0,17.0,3.0,3.0,100.0,3.0,3.0,100.0,0.0,0.0,,0.0,0.0,0.0,0.0,0.0,0.0,0.0,0.0,0.0,Matches,480,de GER,DF,25,2,14.0,7.0,0.5,0.2,0,,0,2,7.0,13,3.0,0.0,0.0,0.0,0.0,-0.21,0.2,0.3,-0.1,-0.81,-0.79,Matches,412.0,de GER,DF,25.0,0.2,11.0,2.0,8.0,3.0,0.0,0.0,11.0,0.0,0.0,,0.0,,2.0,3.0,3.0,0.0,0.0,0.0,0.0,0.0,2.0,0.0,Matches,412.0,de GER,DF,25.0,0.2,0.0,0.0,0.0,,0.0,0.0,,,,0.0,0.0,0.0,0.0,0.0,,0.0,0.0,Matches,412.0,de GER,DF,25.0,2.0,0.0,14.0,0.2,0.0,0.0,0.0,0.0,0.0,0.0,0.0,0.0,0.0,0.0,0.0,0.0,0.0,0.0,0.0,0.0,0.0,0.0,0.0,0.0,0.0,0.0,0.0,0.0,0.0,Matches,Keven Schlotterbeck,D/DM C,25,125,135,Germany,Sport-Club Freiburg,4,6,8,8,10,8,15,12,6,14,13,12,15,11,16,11,16,14,11,12,14,13,11,12,7,12,14,12,11,8,13,15,11,12,13,14,14,12,14,4,5,4,1,2,2,3,4,3,2,4,3,3,5,10,8,13,14,12,12,14,1,1,20,1,1,1,16,1,1,1,1,1,1,1,189,85,20,10,1819703,6041,6041,4591,Northern_European,124,4,1997/4/28,0,0,2749.0,,90087316
127,Jonathan Schmid,Freiburg,1990,415.0,fr FRA,DF,32.0,0.5,1.0,1.0,1.0,0.0,0.0,0.0,0.0,,0.0,1.0,0.0,1.0,1.0,2.0,1.0,1.0,Matches,415.0,fr FRA,DF,32.0,0.5,2.0,4.5,1.0,0.0,1.0,0.0,0.0,0.0,0.0,0.0,0.0,0.0,0.0,0.0,0.0,0.0,Matches,,,,,,,,,,,,,,,,,,,,,,,,,,,,,,,,,,,,,,,,,,,,,,,,,,,,,,,,415.0,fr FRA,DF,32.0,0.5,0.0,0.0,0.0,1.0,0.0,0.0,4.0,1.0,1.0,0.0,0.0,0.0,4.0,0.0,0.0,,Matches,415.0,fr FRA,DF,32.0,0.5,28.0,25.0,3.0,1.0,0.0,0.0,4.0,2.0,0.0,0.0,0.0,0.0,23.0,0.0,1.0,Matches,415.0,fr FRA,DF,32.0,0.5,23.0,28.0,82.1,365.0,121.0,14.0,16.0,87.5,6.0,8.0,75.0,3.0,4.0,75.0,0.0,0.1,0.1,-0.1,1.0,1.0,2.0,2.0,1.0,Matches,483,fr FRA,DF,32,3,41.0,14.0,1.3,0.5,0,,0,3,14.0,9,1.33,0.0,1.0,-1.0,-2.2,-2.43,1.0,1.5,-0.4,-0.93,-0.92,Matches,415.0,fr FRA,DF,32.0,0.5,34.0,2.0,8.0,15.0,11.0,2.0,34.0,1.0,1.0,100.0,0.0,0.0,10.0,39.0,16.0,1.0,0.0,1.0,1.0,0.0,18.0,6.0,Matches,415.0,fr FRA,DF,32.0,0.5,0.0,1.0,1.0,100.0,2.2,2.2,0.0,0.0,13.9,0.0,0.0,0.0,0.3,0.3,0.3,-0.3,-0.3,Matches,415.0,fr FRA,DF,32.0,3.0,0.0,41.0,0.5,0.0,0.0,0.0,0.0,0.0,0.0,0.0,0.0,0.3,0.3,0.1,0.4,1.0,1.0,6.0,0.0,0.0,0.0,0.0,0.0,0.68,0.19,0.88,0.68,0.88,Matches,Jonathan Schmid,D/WB/M/AM RL,32,136,136,France,Sport-Club Freiburg,13,14,12,13,11,15,8,10,13,10,12,10,11,12,16,12,14,10,12,10,11,16,13,8,14,10,14,16,14,13,15,11,17,13,14,11,13,8,14,6,16,1,4,3,2,2,1,2,1,2,2,3,14,14,8,12,12,14,11,13,1,10,1,20,10,20,1,18,1,16,18,1,16,1,180,81,10,20,1899195,6544,5966,4922,Northern_European,120,4,1990/6/22,0,0,15384.0,,91016490
128,Paul Seguin,Union Berlin,1995,422.0,de GER,MF,27.0,7.7,17.0,8.0,9.0,4.0,4.0,8.0,18.0,44.4,10.0,6.0,0.0,6.0,6.0,23.0,7.0,0.0,Matches,422.0,de GER,MF,27.0,7.7,21.0,2.74,19.0,0.0,0.0,1.0,0.0,1.0,3.0,0.39,3.0,0.0,0.0,0.0,0.0,0.0,Matches,,,,,,,,,,,,,,,,,,,,,,,,,,,,,,,,,,,,,,,,,,,,,,,,,,,,,,,,422.0,de GER,MF,27.0,7.7,4.0,0.0,0.0,13.0,3.0,0.0,18.0,6.0,8.0,0.0,1.0,0.0,54.0,13.0,11.0,54.2,Matches,422.0,de GER,MF,27.0,7.7,326.0,310.0,14.0,0.0,4.0,1.0,18.0,0.0,6.0,0.0,0.0,0.0,223.0,2.0,8.0,Matches,422.0,de GER,MF,27.0,7.7,223.0,326.0,68.4,3821.0,1157.0,95.0,121.0,78.5,98.0,130.0,75.4,20.0,48.0,41.7,3.0,2.0,2.4,1.0,10.0,26.0,16.0,8.0,49.0,Matches,493,de GER,MF,27,20,691.0,35.0,22.6,7.7,4,85.0,2,16,22.0,4,1.75,13.0,11.0,2.0,0.26,-0.16,11.8,10.6,1.2,0.16,0.38,Matches,422.0,de GER,MF,27.0,7.7,417.0,7.0,81.0,187.0,150.0,11.0,417.0,14.0,7.0,50.0,6.0,42.9,219.0,1030.0,458.0,13.0,10.0,1.0,8.0,6.0,250.0,28.0,Matches,422.0,de GER,MF,27.0,7.7,1.0,15.0,4.0,26.7,1.95,0.52,0.07,0.25,23.1,0.0,0.0,0.0,1.2,1.2,0.08,-0.2,-0.2,Matches,422.0,de GER,MF,27.0,20.0,4.0,691.0,7.7,1.0,3.0,4.0,1.0,0.0,0.0,4.0,0.0,1.2,1.2,2.0,3.2,13.0,49.0,28.0,0.13,0.39,0.52,0.13,0.52,0.16,0.26,0.41,0.16,0.41,Matches,Paul Seguin,DM/M C,27,128,134,Germany,1. FC Union Berlin,9,11,10,9,13,11,9,13,9,11,14,12,11,14,11,12,14,14,13,12,12,11,9,10,12,12,17,15,13,12,12,13,14,12,15,12,13,10,14,8,15,3,2,4,3,2,2,3,1,3,1,3,10,12,5,14,11,15,13,17,1,1,1,13,1,13,20,1,20,10,1,7,1,1,186,79,10,20,2414311,6400,6400,4002,Northern_European,125,4,1995/3/29,0,0,6499.0,,91137950
129,Davie Selke,Hertha BSC,1995,423.0,de GER,FW,27.0,3.1,2.0,1.0,1.0,1.0,0.0,0.0,1.0,0.0,1.0,3.0,1.0,2.0,1.0,3.0,5.0,0.0,Matches,423.0,de GER,FW,27.0,3.1,8.0,2.55,4.0,0.0,1.0,1.0,2.0,0.0,3.0,0.96,1.0,0.0,1.0,0.0,1.0,0.0,Matches,,,,,,,,,,,,,,,,,,,,,,,,,,,,,,,,,,,,,,,,,,,,,,,,,,,,,,,,423.0,de GER,FW,27.0,3.1,1.0,0.0,0.0,7.0,6.0,0.0,2.0,1.0,1.0,1.0,0.0,0.0,6.0,22.0,24.0,47.8,Matches,423.0,de GER,FW,27.0,3.1,68.0,67.0,1.0,0.0,0.0,0.0,2.0,0.0,0.0,0.0,0.0,0.0,41.0,0.0,6.0,Matches,423.0,de GER,FW,27.0,3.1,41.0,68.0,60.3,456.0,160.0,25.0,33.0,75.8,9.0,16.0,56.3,0.0,1.0,0.0,1.0,0.9,0.6,0.1,4.0,5.0,0.0,0.0,5.0,Matches,495,de GER,FW,27,13,282.0,22.0,9.2,3.1,3,59.0,0,10,10.0,1,0.92,4.0,9.0,-5.0,-1.6,-0.88,4.0,5.7,-1.8,-0.57,0.04,Matches,423.0,de GER,FW,27.0,3.1,108.0,7.0,14.0,49.0,47.0,12.0,107.0,4.0,1.0,25.0,3.0,75.0,54.0,260.0,137.0,3.0,4.0,2.0,8.0,4.0,82.0,22.0,Matches,423.0,de GER,FW,27.0,3.1,1.0,5.0,3.0,60.0,1.6,0.96,0.0,0.0,17.6,0.0,1.0,1.0,1.2,0.4,0.08,-0.2,-0.4,Matches,423.0,de GER,FW,27.0,13.0,3.0,282.0,3.1,1.0,1.0,2.0,0.0,1.0,1.0,1.0,0.0,1.2,0.4,0.9,1.3,3.0,5.0,22.0,0.32,0.32,0.64,0.0,0.32,0.39,0.28,0.66,0.14,0.41,Matches,Davie Selke,S,27,127,135,Germany,Hertha Berlin,6,8,11,11,10,7,13,9,8,8,10,13,8,10,19,10,18,8,13,11,9,17,11,13,10,10,16,18,16,11,16,17,17,16,17,15,15,8,17,9,6,3,1,1,2,1,3,2,2,4,4,1,11,18,13,8,13,15,8,8,1,1,1,1,1,1,1,1,1,1,10,1,10,20,194,84,10,20,4913339,6550,6550,5100,Mixed_Race,122,10,1995/1/20,0,0,47944.0,,91108866
130,Daley Sinkgraven,Leverkusen,1995,430.0,nl NED,DFMF,27.0,3.8,10.0,7.0,7.0,3.0,0.0,7.0,9.0,77.8,2.0,8.0,4.0,4.0,5.0,15.0,7.0,0.0,Matches,430.0,nl NED,DFMF,27.0,3.8,9.0,2.34,7.0,0.0,1.0,1.0,0.0,0.0,3.0,0.78,2.0,0.0,0.0,1.0,0.0,0.0,Matches,,,,,,,,,,,,,,,,,,,,,,,,,,,,,,,,,,,,,,,,,,,,,,,,,,,,,,,,430.0,nl NED,DFMF,27.0,3.8,1.0,0.0,0.0,6.0,4.0,0.0,3.0,5.0,7.0,0.0,0.0,0.0,17.0,3.0,5.0,37.5,Matches,430.0,nl NED,DFMF,27.0,3.8,209.0,174.0,35.0,2.0,0.0,1.0,3.0,33.0,0.0,0.0,0.0,0.0,159.0,0.0,5.0,Matches,430.0,nl NED,DFMF,27.0,3.8,159.0,209.0,76.1,2513.0,753.0,94.0,106.0,88.7,48.0,63.0,76.2,15.0,33.0,45.5,2.0,1.3,0.3,0.7,6.0,12.0,1.0,1.0,8.0,Matches,504,nl NED,DFMF,27,12,344.0,29.0,11.2,3.8,4,69.0,0,8,9.0,17,1.83,9.0,9.0,0.0,0.0,-0.27,6.0,4.5,1.4,0.38,0.14,Matches,430.0,nl NED,DFMF,27.0,3.8,260.0,13.0,81.0,119.0,61.0,7.0,260.0,6.0,3.0,50.0,3.0,50.0,129.0,606.0,300.0,8.0,6.0,1.0,4.0,7.0,161.0,17.0,Matches,430.0,nl NED,DFMF,27.0,3.8,0.0,4.0,1.0,25.0,1.05,0.26,0.0,0.0,18.9,0.0,0.0,0.0,0.2,0.2,0.04,-0.2,-0.2,Matches,430.0,nl NED,DFMF,27.0,12.0,4.0,344.0,3.8,0.0,2.0,2.0,0.0,0.0,0.0,1.0,0.0,0.2,0.2,1.3,1.4,8.0,8.0,17.0,0.0,0.52,0.52,0.0,0.52,0.04,0.33,0.37,0.04,0.37,Matches,Daley Sinkgraven,D/WB/M/AM LC,27,128,132,Holland,Bayer 04 Leverkusen,12,13,13,6,14,12,9,8,7,9,14,8,10,15,10,10,7,12,9,13,12,11,12,12,14,8,16,13,13,14,12,10,13,13,13,9,11,5,11,14,17,3,4,1,2,3,1,1,2,3,2,3,12,14,7,9,8,13,15,11,1,18,3,1,19,1,10,17,20,1,16,16,1,1,179,70,20,10,2414311,6400,5756,5001,Northern_European,116,5,1995/7/4,0,0,28747.0,,37041911
131,Tobias Sippel,Gladbach,1988,431.0,de GER,GK,34.0,5.7,0.0,0.0,0.0,0.0,0.0,0.0,0.0,,0.0,0.0,0.0,0.0,0.0,0.0,1.0,1.0,Matches,431.0,de GER,GK,34.0,5.7,0.0,0.0,0.0,0.0,0.0,0.0,0.0,0.0,0.0,0.0,0.0,0.0,0.0,0.0,0.0,0.0,Matches,29.0,de GER,GK,34.0,5.7,12.0,1.0,0.0,3.0,0.0,11.6,0.33,-0.4,-0.08,25.0,106.0,23.6,212.0,23.0,33.5,32.7,48.0,72.9,53.1,88.0,2.0,2.3,4.0,0.71,13.1,Matches,29.0,de GER,GK,34.0,6.0,5.0,510.0,5.7,12.0,2.12,33.0,21.0,66.7,1.0,1.0,3.0,1.0,20.0,1.0,1.0,0.0,0.0,0.0,Matches,431.0,de GER,GK,34.0,5.7,1.0,0.0,0.0,0.0,0.0,0.0,0.0,0.0,0.0,0.0,0.0,0.0,7.0,2.0,1.0,66.7,Matches,431.0,de GER,GK,34.0,5.7,260.0,193.0,67.0,19.0,0.0,0.0,0.0,0.0,0.0,0.0,0.0,0.0,174.0,0.0,0.0,Matches,431.0,de GER,GK,34.0,5.7,174.0,260.0,66.9,4274.0,3193.0,44.0,45.0,97.8,85.0,86.0,98.8,43.0,127.0,33.9,0.0,0.0,0.0,0.0,0.0,3.0,0.0,0.0,0.0,Matches,505,de GER,GK,34,6,510.0,85.0,16.7,5.7,5,90.0,5,1,60.0,12,0.67,5.0,12.0,-7.0,-1.24,-1.38,6.6,8.4,-1.8,-0.33,-0.34,Matches,431.0,de GER,GK,34.0,5.7,272.0,229.0,272.0,0.0,0.0,0.0,272.0,0.0,0.0,,0.0,,141.0,635.0,441.0,0.0,0.0,0.0,0.0,0.0,147.0,0.0,Matches,431.0,de GER,GK,34.0,5.7,0.0,0.0,0.0,,0.0,0.0,,,,0.0,0.0,0.0,0.0,0.0,,0.0,0.0,Matches,431.0,de GER,GK,34.0,6.0,5.0,510.0,5.7,0.0,0.0,0.0,0.0,0.0,0.0,1.0,0.0,0.0,0.0,0.0,0.0,0.0,0.0,0.0,0.0,0.0,0.0,0.0,0.0,0.0,0.0,0.0,0.0,0.0,Matches,Tobias Sippel,GK,34,124,127,Germany,Borussia Mönchengladbach,4,1,2,2,9,7,8,3,1,2,8,3,3,9,13,13,12,12,13,8,12,12,5,13,1,14,13,10,11,12,13,13,17,10,12,12,12,7,13,4,11,11,11,14,12,13,12,16,16,14,12,9,6,10,10,18,12,15,12,9,20,1,1,1,1,1,1,1,1,1,1,1,1,1,183,80,9,20,800866,6195,6195,4200,Northern_European,123,3,1988/3/22,0,0,15341.0,,35006814
132,Hugo Siquet,Freiburg,2002,432.0,be BEL,DF,20.0,0.2,2.0,2.0,2.0,0.0,0.0,2.0,2.0,100.0,0.0,1.0,0.0,1.0,0.0,2.0,0.0,0.0,Matches,432.0,be BEL,DF,20.0,0.2,0.0,0.0,0.0,0.0,0.0,0.0,0.0,0.0,0.0,0.0,0.0,0.0,0.0,0.0,0.0,0.0,Matches,,,,,,,,,,,,,,,,,,,,,,,,,,,,,,,,,,,,,,,,,,,,,,,,,,,,,,,,432.0,be BEL,DF,20.0,0.2,0.0,0.0,0.0,0.0,1.0,0.0,0.0,0.0,2.0,0.0,0.0,0.0,0.0,0.0,0.0,,Matches,432.0,be BEL,DF,20.0,0.2,7.0,5.0,2.0,0.0,0.0,0.0,0.0,2.0,0.0,0.0,0.0,0.0,5.0,0.0,0.0,Matches,432.0,be BEL,DF,20.0,0.2,5.0,7.0,71.4,59.0,44.0,4.0,4.0,100.0,1.0,3.0,33.3,0.0,0.0,,0.0,0.0,0.0,0.0,0.0,0.0,0.0,0.0,0.0,Matches,506,be BEL,DF,20,2,17.0,9.0,0.6,0.2,0,,0,2,9.0,3,3.0,0.0,0.0,0.0,0.0,-0.21,0.0,0.1,-0.1,-0.41,-0.39,Matches,432.0,be BEL,DF,20.0,0.2,11.0,2.0,4.0,7.0,0.0,0.0,11.0,0.0,0.0,,0.0,,3.0,8.0,0.0,0.0,0.0,0.0,1.0,1.0,5.0,0.0,Matches,432.0,be BEL,DF,20.0,0.2,0.0,0.0,0.0,,0.0,0.0,,,,0.0,0.0,0.0,0.0,0.0,,0.0,0.0,Matches,432.0,be BEL,DF,20.0,2.0,0.0,17.0,0.2,0.0,0.0,0.0,0.0,0.0,0.0,0.0,0.0,0.0,0.0,0.0,0.0,0.0,0.0,0.0,0.0,0.0,0.0,0.0,0.0,0.0,0.0,0.0,0.0,0.0,Matches,Hugo Siquet,D/WB RC,20,119,-8,Belgium,Sport-Club Freiburg,13,14,11,8,10,11,8,10,12,11,11,10,12,12,15,12,14,10,12,11,11,10,13,12,13,8,14,11,15,10,9,8,15,15,15,8,11,12,14,5,13,2,4,2,1,2,3,1,1,4,1,1,18,12,6,12,10,11,10,15,1,1,17,20,1,19,11,1,1,10,1,1,1,1,180,66,8,20,60800000,5999,5999,3752,Northern_European,108,2,2002/7/9,0,0,7499.0,,18114980
133,Hrvoje Smolčić,Eint Frankfurt,2000,437.0,hr CRO,DF,21.0,5.2,8.0,7.0,6.0,2.0,0.0,5.0,10.0,50.0,5.0,11.0,4.0,7.0,6.0,14.0,38.0,0.0,Matches,437.0,hr CRO,DF,21.0,5.2,1.0,0.19,1.0,0.0,0.0,0.0,0.0,0.0,0.0,0.0,0.0,0.0,0.0,0.0,0.0,0.0,Matches,,,,,,,,,,,,,,,,,,,,,,,,,,,,,,,,,,,,,,,,,,,,,,,,,,,,,,,,437.0,hr CRO,DF,21.0,5.2,0.0,0.0,0.0,0.0,5.0,0.0,0.0,6.0,7.0,0.0,0.0,0.0,31.0,27.0,13.0,67.5,Matches,437.0,hr CRO,DF,21.0,5.2,355.0,340.0,15.0,11.0,0.0,0.0,0.0,2.0,0.0,0.0,0.0,0.0,287.0,0.0,3.0,Matches,437.0,hr CRO,DF,21.0,5.2,287.0,355.0,80.8,5494.0,2389.0,96.0,111.0,86.5,166.0,188.0,88.3,23.0,45.0,51.1,0.0,0.0,0.1,0.0,0.0,8.0,0.0,0.0,18.0,Matches,512,hr CRO,DF,21,9,471.0,52.0,15.4,5.2,4,90.0,4,5,22.0,15,1.89,8.0,5.0,3.0,0.57,0.47,7.7,8.9,-1.1,-0.22,-0.55,Matches,437.0,hr CRO,DF,21.0,5.2,432.0,72.0,234.0,188.0,12.0,4.0,432.0,2.0,2.0,100.0,0.0,0.0,231.0,1099.0,609.0,0.0,3.0,0.0,3.0,1.0,254.0,1.0,Matches,437.0,hr CRO,DF,21.0,5.2,0.0,3.0,0.0,0.0,0.57,0.0,0.0,,12.7,0.0,0.0,0.0,0.2,0.2,0.06,-0.2,-0.2,Matches,437.0,hr CRO,DF,21.0,9.0,4.0,471.0,5.2,0.0,0.0,0.0,0.0,0.0,0.0,0.0,0.0,0.2,0.2,0.0,0.2,0.0,18.0,1.0,0.0,0.0,0.0,0.0,0.0,0.03,0.0,0.03,0.03,0.03,Matches,Hrvoje Smolčić,D LC,21,122,152,Croatia,Eintracht Frankfurt,4,12,8,6,11,5,13,7,11,13,12,8,15,10,12,14,14,14,12,6,13,13,6,15,7,12,14,12,11,11,12,13,13,12,13,15,12,6,10,7,12,1,3,3,2,1,1,2,1,3,1,2,10,13,6,12,16,13,12,14,1,17,20,13,12,10,1,10,1,8,1,1,1,1,185,80,20,9,9720000,5996,5896,4746,Mediterranean_Hispanic,122,3,2000/8/17,0,0,691.0,,24057195
134,Nikola Soldo,Köln,2001,439.0,hr CRO,DF,21.0,6.6,15.0,9.0,8.0,7.0,0.0,7.0,11.0,63.6,4.0,7.0,6.0,1.0,7.0,22.0,28.0,0.0,Matches,439.0,hr CRO,DF,21.0,6.6,4.0,0.61,3.0,0.0,0.0,1.0,0.0,0.0,0.0,0.0,0.0,0.0,0.0,0.0,0.0,0.0,Matches,,,,,,,,,,,,,,,,,,,,,,,,,,,,,,,,,,,,,,,,,,,,,,,,,,,,,,,,439.0,hr CRO,DF,21.0,6.6,1.0,0.0,0.0,5.0,2.0,0.0,1.0,7.0,9.0,0.0,0.0,0.0,44.0,7.0,9.0,43.8,Matches,439.0,hr CRO,DF,21.0,6.6,348.0,333.0,12.0,11.0,0.0,2.0,1.0,1.0,0.0,0.0,0.0,0.0,270.0,3.0,6.0,Matches,439.0,hr CRO,DF,21.0,6.6,270.0,348.0,77.6,5661.0,1561.0,61.0,74.0,82.4,174.0,191.0,91.1,35.0,72.0,48.6,0.0,0.0,0.0,0.0,1.0,11.0,1.0,0.0,15.0,Matches,514,hr CRO,DF,21,7,593.0,85.0,19.4,6.6,6,90.0,6,1,53.0,13,0.43,4.0,13.0,-9.0,-1.37,-1.51,6.6,7.6,-1.0,-0.16,-0.39,Matches,439.0,hr CRO,DF,21.0,6.6,421.0,47.0,230.0,182.0,13.0,7.0,421.0,3.0,0.0,0.0,3.0,100.0,236.0,1193.0,722.0,3.0,2.0,0.0,1.0,0.0,261.0,0.0,Matches,439.0,hr CRO,DF,21.0,6.6,0.0,6.0,0.0,0.0,0.91,0.0,0.0,,15.2,0.0,0.0,0.0,0.6,0.6,0.11,-0.6,-0.6,Matches,439.0,hr CRO,DF,21.0,7.0,6.0,593.0,6.6,0.0,0.0,0.0,0.0,0.0,0.0,1.0,0.0,0.6,0.6,0.0,0.7,3.0,15.0,0.0,0.0,0.0,0.0,0.0,0.0,0.1,0.0,0.1,0.1,0.1,Matches,Nikola Soldo,D C,21,109,142,Croatia,1. FC Köln,3,5,8,4,12,3,13,7,7,13,12,7,13,12,11,13,12,10,11,10,11,12,6,9,6,14,14,10,9,10,11,14,10,12,13,14,9,7,12,8,14,1,3,3,4,2,3,1,1,1,2,1,8,13,5,12,13,14,13,14,1,10,20,14,1,1,13,1,8,1,1,1,1,1,189,89,10,20,3324999,5450,5350,3450,Northern_European,108,6,2001/1/25,0,0,3618.0,,24065214
135,Josip Stanišić,Bayern Munich,2000,448.0,hr CRO,DF,22.0,6.4,19.0,11.0,14.0,2.0,3.0,12.0,17.0,70.6,5.0,9.0,1.0,8.0,7.0,26.0,11.0,3.0,Matches,448.0,hr CRO,DF,22.0,6.4,12.0,1.87,11.0,0.0,0.0,0.0,0.0,1.0,1.0,0.16,1.0,0.0,0.0,0.0,0.0,0.0,Matches,,,,,,,,,,,,,,,,,,,,,,,,,,,,,,,,,,,,,,,,,,,,,,,,,,,,,,,,448.0,hr CRO,DF,22.0,6.4,1.0,0.0,0.0,5.0,3.0,0.0,8.0,7.0,11.0,0.0,0.0,0.0,33.0,6.0,3.0,66.7,Matches,448.0,hr CRO,DF,22.0,6.4,633.0,583.0,50.0,4.0,0.0,1.0,8.0,45.0,1.0,0.0,0.0,0.0,577.0,0.0,4.0,Matches,448.0,hr CRO,DF,22.0,6.4,577.0,633.0,91.2,9398.0,2772.0,294.0,312.0,94.2,238.0,253.0,94.1,38.0,55.0,69.1,0.0,0.4,0.7,-0.4,4.0,43.0,11.0,3.0,66.0,Matches,523,hr CRO,DF,22,14,579.0,41.0,18.9,6.4,4,87.0,2,10,23.0,16,1.93,13.0,10.0,3.0,0.47,-1.38,14.3,7.3,7.1,1.1,-0.02,Matches,448.0,hr CRO,DF,22.0,6.4,689.0,29.0,206.0,370.0,117.0,5.0,689.0,9.0,5.0,55.6,2.0,22.2,452.0,2116.0,1180.0,12.0,15.0,1.0,7.0,3.0,506.0,35.0,Matches,448.0,hr CRO,DF,22.0,6.4,0.0,0.0,0.0,,0.0,0.0,,,,0.0,0.0,0.0,0.0,0.0,,0.0,0.0,Matches,448.0,hr CRO,DF,22.0,14.0,4.0,579.0,6.4,0.0,0.0,0.0,0.0,0.0,0.0,1.0,0.0,0.0,0.0,0.4,0.4,12.0,66.0,35.0,0.0,0.0,0.0,0.0,0.0,0.0,0.07,0.07,0.0,0.07,Matches,Josip Stanišić,D RLC,22,131,149,"Croatia,Germany",FC Bayern München,4,12,12,7,11,3,13,6,12,13,13,6,15,11,14,12,15,12,12,12,12,16,11,6,12,13,16,15,12,10,12,13,13,15,14,13,15,8,14,9,18,3,1,3,1,1,1,1,3,2,2,3,13,14,6,13,10,16,10,12,1,18,20,18,14,15,12,1,12,1,1,1,1,1,187,77,12,20,8279999,6600,6400,5500,Northern_European,124,4,2000/4/2,5,0,19177.0,,91190673
136,Pascal Stenzel,Stuttgart,1996,450.0,de GER,DF,26.0,3.7,12.0,8.0,8.0,4.0,0.0,5.0,9.0,55.6,4.0,9.0,2.0,7.0,5.0,17.0,6.0,0.0,Matches,450.0,de GER,DF,26.0,3.7,13.0,3.51,5.0,8.0,0.0,0.0,0.0,0.0,1.0,0.27,1.0,0.0,0.0,0.0,0.0,0.0,Matches,,,,,,,,,,,,,,,,,,,,,,,,,,,,,,,,,,,,,,,,,,,,,,,,,,,,,,,,450.0,de GER,DF,26.0,3.7,0.0,0.0,0.0,3.0,2.0,0.0,21.0,5.0,8.0,0.0,0.0,0.0,29.0,1.0,2.0,33.3,Matches,450.0,de GER,DF,26.0,3.7,223.0,172.0,51.0,8.0,0.0,6.0,21.0,34.0,9.0,2.0,7.0,0.0,174.0,0.0,3.0,Matches,450.0,de GER,DF,26.0,3.7,174.0,223.0,78.0,3784.0,1405.0,71.0,78.0,91.0,58.0,72.0,80.6,44.0,67.0,65.7,1.0,0.6,0.6,0.4,8.0,11.0,4.0,2.0,13.0,Matches,525,de GER,DF,26,12,333.0,28.0,10.9,3.7,3,77.0,1,9,11.0,16,1.33,7.0,8.0,-1.0,-0.27,0.09,7.8,4.6,3.2,0.87,0.9,Matches,450.0,de GER,DF,26.0,3.7,259.0,14.0,90.0,117.0,54.0,2.0,259.0,4.0,0.0,0.0,3.0,75.0,109.0,410.0,221.0,3.0,5.0,2.0,5.0,0.0,131.0,5.0,Matches,450.0,de GER,DF,26.0,3.7,0.0,2.0,0.0,0.0,0.54,0.0,0.0,,17.5,0.0,0.0,0.0,0.0,0.0,0.02,0.0,0.0,Matches,450.0,de GER,DF,26.0,12.0,3.0,333.0,3.7,0.0,1.0,1.0,0.0,0.0,0.0,0.0,0.0,0.0,0.0,0.6,0.6,3.0,13.0,5.0,0.0,0.27,0.27,0.0,0.27,0.01,0.16,0.17,0.01,0.17,Matches,Pascal Stenzel,D/WB/DM RC,26,125,129,Germany,VfB Stuttgart,6,10,10,5,12,8,12,8,12,12,13,11,12,13,11,13,14,13,13,11,13,15,6,12,10,13,18,13,11,11,12,12,16,12,15,10,13,8,13,5,15,2,3,3,3,3,1,3,1,1,1,2,10,14,5,10,12,15,13,13,1,1,18,20,1,17,17,1,15,12,1,1,1,1,183,74,9,20,2911999,6250,6250,4750,Northern_European,118,3,1996/3/20,0,0,17260.0,,92065838
137,Angelo Stiller,Hoffenheim,2001,451.0,de GER,MF,21.0,7.8,26.0,12.0,9.0,13.0,4.0,8.0,12.0,66.7,4.0,12.0,2.0,10.0,10.0,36.0,14.0,0.0,Matches,451.0,de GER,MF,21.0,7.8,16.0,2.04,14.0,1.0,0.0,0.0,1.0,0.0,3.0,0.38,3.0,0.0,0.0,0.0,0.0,0.0,Matches,,,,,,,,,,,,,,,,,,,,,,,,,,,,,,,,,,,,,,,,,,,,,,,,,,,,,,,,451.0,de GER,MF,21.0,7.8,1.0,0.0,0.0,11.0,3.0,0.0,6.0,10.0,12.0,0.0,0.0,0.0,51.0,16.0,10.0,61.5,Matches,451.0,de GER,MF,21.0,7.8,363.0,353.0,8.0,3.0,2.0,3.0,6.0,3.0,1.0,0.0,1.0,0.0,279.0,2.0,13.0,Matches,451.0,de GER,MF,21.0,7.8,279.0,363.0,76.9,4425.0,1193.0,154.0,183.0,84.2,93.0,111.0,83.8,22.0,34.0,64.7,1.0,0.5,0.6,0.5,3.0,26.0,5.0,0.0,34.0,Matches,526,de GER,MF,21,20,704.0,35.0,23.0,7.8,6,81.0,2,14,16.0,6,1.24,14.0,14.0,0.0,0.0,0.34,10.8,11.1,-0.4,-0.05,0.05,Matches,451.0,de GER,MF,21.0,7.8,466.0,17.0,106.0,243.0,121.0,11.0,466.0,7.0,3.0,42.9,3.0,42.9,226.0,951.0,357.0,4.0,7.0,0.0,15.0,11.0,266.0,16.0,Matches,451.0,de GER,MF,21.0,7.8,1.0,7.0,3.0,42.9,0.89,0.38,0.14,0.33,22.1,0.0,0.0,0.0,0.3,0.3,0.04,0.7,0.7,Matches,451.0,de GER,MF,21.0,20.0,6.0,704.0,7.8,1.0,1.0,2.0,1.0,0.0,0.0,1.0,0.0,0.3,0.3,0.5,0.8,4.0,34.0,16.0,0.13,0.13,0.26,0.13,0.26,0.04,0.06,0.1,0.04,0.1,Matches,Angelo Stiller,DM/M C,21,124,150,Germany,TSG Hoffenheim,13,13,12,8,15,14,7,10,6,11,15,8,11,14,12,13,11,15,12,14,12,15,13,13,12,12,13,14,11,12,13,10,14,10,14,11,16,8,13,5,8,2,2,2,3,2,2,3,3,3,1,3,12,17,8,14,13,15,9,11,1,1,1,1,1,1,20,1,18,1,1,1,1,1,183,75,20,10,8999999,6099,6099,4399,Northern_European,120,4,2001/4/4,0,0,14999.0,,91184426
138,Alexander Sørloth,RB Leipzig,1995,458.0,no NOR,FW,26.0,0.1,0.0,0.0,0.0,0.0,0.0,0.0,0.0,,0.0,0.0,0.0,0.0,0.0,0.0,0.0,0.0,Matches,458.0,no NOR,FW,26.0,0.1,1.0,15.0,1.0,0.0,0.0,0.0,0.0,0.0,0.0,0.0,0.0,0.0,0.0,0.0,0.0,0.0,Matches,,,,,,,,,,,,,,,,,,,,,,,,,,,,,,,,,,,,,,,,,,,,,,,,,,,,,,,,458.0,no NOR,FW,26.0,0.1,1.0,0.0,0.0,1.0,0.0,0.0,0.0,0.0,0.0,0.0,0.0,0.0,0.0,0.0,0.0,,Matches,458.0,no NOR,FW,26.0,0.1,2.0,2.0,0.0,0.0,0.0,0.0,0.0,0.0,0.0,0.0,0.0,0.0,2.0,0.0,0.0,Matches,458.0,no NOR,FW,26.0,0.1,2.0,2.0,100.0,21.0,0.0,2.0,2.0,100.0,0.0,0.0,,0.0,0.0,,0.0,0.0,0.0,0.0,0.0,0.0,0.0,0.0,0.0,Matches,534,no NOR,FW,26,1,6.0,6.0,0.2,0.1,0,,0,1,6.0,1,1.0,0.0,0.0,0.0,0.0,-0.68,0.2,0.0,0.2,2.77,2.02,Matches,458.0,no NOR,FW,26.0,0.1,3.0,0.0,0.0,0.0,3.0,3.0,3.0,1.0,0.0,0.0,1.0,100.0,1.0,2.0,0.0,0.0,0.0,0.0,0.0,0.0,1.0,1.0,Matches,458.0,no NOR,FW,26.0,0.1,0.0,0.0,0.0,,0.0,0.0,,,,0.0,0.0,0.0,0.0,0.0,,0.0,0.0,Matches,458.0,no NOR,FW,26.0,1.0,0.0,6.0,0.1,0.0,0.0,0.0,0.0,0.0,0.0,1.0,0.0,0.0,0.0,0.0,0.0,0.0,0.0,1.0,0.0,0.0,0.0,0.0,0.0,0.0,0.0,0.0,0.0,0.0,Matches,Alexander Sørloth,S,26,142,148,Norway,RB Leipzig,7,7,13,15,13,10,15,12,6,6,11,13,5,13,13,13,14,14,13,13,13,13,10,9,12,5,15,13,13,13,16,16,14,15,14,16,13,11,14,4,10,3,3,3,2,1,2,1,4,1,2,2,12,13,5,14,12,14,10,7,1,1,1,1,1,1,1,1,1,1,8,10,8,20,194,90,20,12,19060367,7100,7100,5750,Northern_European,141,4,1995/12/5,42,15,57692.0,Real San Sebastián,53063430
139,Niklas Tauer,Mainz 05,2001,461.0,de GER,DFMF,21.0,1.0,2.0,1.0,2.0,0.0,0.0,1.0,3.0,33.3,2.0,2.0,1.0,1.0,2.0,4.0,4.0,0.0,Matches,461.0,de GER,DFMF,21.0,1.0,1.0,0.97,1.0,0.0,0.0,0.0,0.0,0.0,0.0,0.0,0.0,0.0,0.0,0.0,0.0,0.0,Matches,,,,,,,,,,,,,,,,,,,,,,,,,,,,,,,,,,,,,,,,,,,,,,,,,,,,,,,,461.0,de GER,DFMF,21.0,1.0,0.0,0.0,0.0,1.0,0.0,0.0,1.0,2.0,1.0,0.0,0.0,0.0,3.0,2.0,1.0,66.7,Matches,461.0,de GER,DFMF,21.0,1.0,56.0,55.0,1.0,0.0,0.0,0.0,1.0,1.0,0.0,0.0,0.0,0.0,50.0,0.0,1.0,Matches,461.0,de GER,DFMF,21.0,1.0,50.0,56.0,89.3,757.0,260.0,30.0,33.0,90.9,19.0,20.0,95.0,1.0,2.0,50.0,0.0,0.0,0.1,0.0,0.0,5.0,2.0,1.0,6.0,Matches,537,de GER,DFMF,21,3,93.0,31.0,3.0,1.0,0,,0,3,31.0,10,1.0,1.0,4.0,-3.0,-2.9,-2.96,1.0,2.6,-1.5,-1.49,-1.34,Matches,461.0,de GER,DFMF,21.0,1.0,70.0,5.0,23.0,38.0,10.0,1.0,70.0,0.0,0.0,,0.0,,40.0,205.0,100.0,1.0,2.0,0.0,1.0,1.0,47.0,4.0,Matches,461.0,de GER,DFMF,21.0,1.0,0.0,1.0,0.0,0.0,0.97,0.0,0.0,,9.7,0.0,0.0,0.0,0.1,0.1,0.07,-0.1,-0.1,Matches,461.0,de GER,DFMF,21.0,3.0,0.0,93.0,1.0,0.0,0.0,0.0,0.0,0.0,0.0,0.0,0.0,0.1,0.1,0.0,0.1,1.0,6.0,4.0,0.0,0.0,0.0,0.0,0.0,0.07,0.0,0.07,0.07,0.07,Matches,Niklas Tauer,D/DM/M C,21,119,139,Germany,1. FSV Mainz 05,4,8,11,8,11,4,13,10,6,13,13,7,14,11,16,12,16,12,12,12,11,16,10,8,11,13,17,15,13,11,13,12,14,13,13,12,13,13,13,6,12,3,2,2,2,1,1,2,1,1,3,2,7,12,6,18,13,12,10,9,1,1,16,12,1,12,20,1,18,12,1,10,1,1,183,72,10,20,3999999,6000,6000,4259,Northern_European,117,3,2001/2/17,0,0,12466.0,,91190772
140,Mathys Tel,Bayern Munich,2005,462.0,fr FRA,FW,17.0,4.6,2.0,2.0,0.0,1.0,1.0,1.0,1.0,100.0,0.0,5.0,1.0,4.0,0.0,2.0,2.0,0.0,Matches,462.0,fr FRA,FW,17.0,4.6,16.0,3.46,12.0,0.0,1.0,3.0,0.0,0.0,2.0,0.43,1.0,0.0,1.0,0.0,0.0,0.0,Matches,,,,,,,,,,,,,,,,,,,,,,,,,,,,,,,,,,,,,,,,,,,,,,,,,,,,,,,,462.0,fr FRA,FW,17.0,4.6,2.0,0.0,0.0,9.0,6.0,4.0,4.0,0.0,2.0,0.0,0.0,0.0,16.0,8.0,11.0,42.1,Matches,462.0,fr FRA,FW,17.0,4.6,157.0,152.0,5.0,1.0,0.0,0.0,4.0,0.0,0.0,0.0,0.0,0.0,126.0,0.0,5.0,Matches,462.0,fr FRA,FW,17.0,4.6,126.0,157.0,80.3,1824.0,257.0,72.0,83.0,86.7,48.0,57.0,84.2,4.0,4.0,100.0,0.0,0.7,0.4,-0.7,6.0,7.0,5.0,3.0,11.0,Matches,539,fr FRA,FW,17,22,417.0,19.0,13.6,4.6,1,60.0,0,21,17.0,9,2.0,16.0,8.0,8.0,1.73,0.16,11.5,5.2,6.3,1.36,0.28,Matches,462.0,fr FRA,FW,17.0,4.6,240.0,4.0,11.0,98.0,132.0,37.0,240.0,30.0,10.0,33.3,18.0,60.0,164.0,948.0,372.0,12.0,7.0,6.0,24.0,11.0,189.0,59.0,Matches,462.0,fr FRA,FW,17.0,4.6,5.0,20.0,11.0,55.0,4.32,2.37,0.25,0.45,15.0,0.0,0.0,0.0,2.7,2.7,0.13,2.3,2.3,Matches,462.0,fr FRA,FW,17.0,22.0,1.0,417.0,4.6,5.0,0.0,5.0,5.0,0.0,0.0,2.0,0.0,2.7,2.7,0.7,3.3,12.0,11.0,59.0,1.08,0.0,1.08,1.08,1.08,0.58,0.14,0.72,0.58,0.72,Matches,Mathys Tel,AM/S RL,17,120,-9,France,FC Bayern München,11,8,14,12,12,12,12,11,3,5,12,13,6,14,8,11,10,11,10,12,9,16,16,11,13,6,11,11,15,12,12,12,15,15,11,12,13,6,14,5,17,1,3,1,3,3,1,3,3,3,1,1,12,17,7,11,13,11,15,16,1,1,5,1,1,1,1,10,8,10,18,11,15,20,183,77,11,20,75392000,6000,5257,5006,African_Caribbean,116,16,2005/4/27,0,0,76711.0,,2000104850
141,Malick Thiaw,Schalke 04,2001,465.0,de GER,DF,20.0,3.0,3.0,1.0,2.0,1.0,0.0,1.0,2.0,50.0,1.0,4.0,3.0,1.0,9.0,12.0,24.0,1.0,Matches,465.0,de GER,DF,20.0,3.0,1.0,0.33,0.0,0.0,1.0,0.0,0.0,0.0,0.0,0.0,0.0,0.0,0.0,0.0,0.0,0.0,Matches,,,,,,,,,,,,,,,,,,,,,,,,,,,,,,,,,,,,,,,,,,,,,,,,,,,,,,,,465.0,de GER,DF,20.0,3.0,2.0,0.0,0.0,3.0,0.0,0.0,0.0,9.0,1.0,0.0,0.0,0.0,11.0,10.0,5.0,66.7,Matches,465.0,de GER,DF,20.0,3.0,123.0,121.0,2.0,2.0,0.0,1.0,0.0,0.0,0.0,0.0,0.0,0.0,108.0,0.0,0.0,Matches,465.0,de GER,DF,20.0,3.0,108.0,123.0,87.8,2266.0,690.0,25.0,30.0,83.3,72.0,79.0,91.1,11.0,14.0,78.6,0.0,0.0,0.0,0.0,0.0,4.0,0.0,0.0,3.0,Matches,542,de GER,DF,20,3,270.0,90.0,8.8,3.0,3,90.0,3,0,,1,0.67,3.0,8.0,-5.0,-1.67,-0.67,4.3,3.7,0.7,0.22,0.81,Matches,465.0,de GER,DF,20.0,3.0,171.0,36.0,105.0,62.0,4.0,3.0,171.0,2.0,1.0,50.0,1.0,50.0,76.0,243.0,117.0,1.0,0.0,0.0,0.0,0.0,91.0,0.0,Matches,465.0,de GER,DF,20.0,3.0,0.0,2.0,1.0,50.0,0.67,0.33,0.0,0.0,8.8,0.0,0.0,0.0,0.2,0.2,0.12,-0.2,-0.2,Matches,465.0,de GER,DF,20.0,3.0,3.0,270.0,3.0,0.0,0.0,0.0,0.0,0.0,0.0,2.0,0.0,0.2,0.2,0.0,0.2,1.0,3.0,0.0,0.0,0.0,0.0,0.0,0.0,0.08,0.0,0.08,0.08,0.08,Matches,Malick Thiaw,D C,20,125,159,"Germany,Finland,Senegal",AC Milan,2,7,11,7,12,3,13,7,4,13,13,10,14,12,14,12,13,13,13,12,11,16,12,12,8,13,12,12,13,11,14,16,15,13,12,13,15,8,14,6,12,3,1,2,3,2,1,2,3,2,4,2,16,15,5,15,15,16,12,10,1,12,20,12,1,1,15,1,12,1,1,1,1,1,194,89,13,20,16030000,6250,6250,4500,Mixed_Race,124,12,2001/8/8,0,0,19808.0,,91206164
142,Jan Thielmann,Köln,2002,466.0,de GER,FW,20.0,9.7,9.0,8.0,3.0,4.0,2.0,2.0,11.0,18.2,9.0,16.0,3.0,13.0,9.0,18.0,7.0,0.0,Matches,466.0,de GER,FW,20.0,9.7,29.0,3.0,20.0,0.0,4.0,1.0,4.0,0.0,6.0,0.62,3.0,0.0,1.0,0.0,2.0,0.0,Matches,,,,,,,,,,,,,,,,,,,,,,,,,,,,,,,,,,,,,,,,,,,,,,,,,,,,,,,,466.0,de GER,FW,20.0,9.7,5.0,0.0,0.0,14.0,19.0,9.0,37.0,9.0,8.0,1.0,0.0,0.0,39.0,13.0,24.0,35.1,Matches,466.0,de GER,FW,20.0,9.7,249.0,233.0,14.0,1.0,0.0,3.0,37.0,13.0,0.0,0.0,0.0,0.0,158.0,2.0,20.0,Matches,466.0,de GER,FW,20.0,9.7,158.0,249.0,63.5,2625.0,624.0,80.0,109.0,73.4,64.0,83.0,77.1,10.0,23.0,43.5,2.0,0.9,2.1,1.1,10.0,10.0,11.0,7.0,19.0,Matches,543,de GER,FW,20,23,869.0,38.0,28.4,9.7,6,72.0,2,17,26.0,0,1.3,16.0,11.0,5.0,0.52,0.93,15.5,10.0,5.4,0.56,0.57,Matches,466.0,de GER,FW,20.0,9.7,373.0,7.0,46.0,146.0,192.0,31.0,373.0,35.0,19.0,54.3,13.0,37.1,230.0,1616.0,654.0,27.0,15.0,9.0,38.0,12.0,245.0,66.0,Matches,466.0,de GER,FW,20.0,9.7,2.0,13.0,7.0,53.8,1.35,0.72,0.15,0.29,18.1,0.0,0.0,0.0,1.1,1.1,0.08,0.9,0.9,Matches,466.0,de GER,FW,20.0,23.0,6.0,869.0,9.7,2.0,2.0,4.0,2.0,0.0,0.0,5.0,0.0,1.1,1.1,0.9,1.9,27.0,19.0,66.0,0.21,0.21,0.41,0.21,0.41,0.11,0.09,0.2,0.11,0.2,Matches,Jan Thielmann,M/AM/S RLC,20,132,-8,Germany,1. FC Köln,7,12,11,12,10,10,8,12,7,7,12,12,8,12,14,11,15,11,10,12,11,17,14,6,12,6,15,17,15,12,12,9,12,13,15,11,11,7,12,7,12,1,3,1,1,1,2,3,4,1,1,2,7,18,5,14,15,17,15,13,1,1,1,1,1,1,1,16,12,17,18,16,20,17,178,72,10,20,63839995,6600,6600,5000,Northern_European,119,3,2002/5/26,0,0,14383.0,,91185080
143,Morten Thorsby,Union Berlin,1996,467.0,no NOR,MF,26.0,9.3,22.0,10.0,9.0,11.0,2.0,13.0,21.0,61.9,8.0,11.0,5.0,6.0,3.0,25.0,20.0,0.0,Matches,467.0,no NOR,MF,26.0,9.3,10.0,1.08,7.0,0.0,0.0,1.0,1.0,1.0,4.0,0.43,1.0,0.0,0.0,1.0,1.0,1.0,Matches,,,,,,,,,,,,,,,,,,,,,,,,,,,,,,,,,,,,,,,,,,,,,,,,,,,,,,,,467.0,no NOR,MF,26.0,9.3,3.0,0.0,0.0,21.0,6.0,0.0,3.0,3.0,10.0,0.0,0.0,0.0,37.0,21.0,25.0,45.7,Matches,467.0,no NOR,MF,26.0,9.3,191.0,178.0,11.0,1.0,0.0,1.0,3.0,0.0,0.0,0.0,0.0,0.0,119.0,2.0,4.0,Matches,467.0,no NOR,MF,26.0,9.3,119.0,191.0,62.3,1640.0,566.0,70.0,98.0,71.4,35.0,60.0,58.3,5.0,13.0,38.5,1.0,0.5,0.3,0.5,7.0,12.0,4.0,1.0,15.0,Matches,544,no NOR,MF,26,24,833.0,35.0,27.2,9.3,8,66.0,1,16,19.0,3,1.58,15.0,16.0,-1.0,-0.11,-0.67,10.2,17.8,-7.6,-0.82,-0.94,Matches,467.0,no NOR,MF,26.0,9.3,297.0,28.0,85.0,118.0,94.0,23.0,297.0,2.0,0.0,0.0,2.0,100.0,115.0,385.0,116.0,0.0,2.0,0.0,15.0,15.0,127.0,21.0,Matches,467.0,no NOR,MF,26.0,9.3,1.0,9.0,3.0,33.3,0.97,0.32,0.11,0.33,13.7,0.0,0.0,0.0,0.8,0.8,0.09,0.2,0.2,Matches,467.0,no NOR,MF,26.0,24.0,8.0,833.0,9.3,1.0,1.0,2.0,1.0,0.0,0.0,3.0,0.0,0.8,0.8,0.5,1.3,0.0,15.0,21.0,0.11,0.11,0.22,0.11,0.22,0.09,0.05,0.14,0.09,0.14,Matches,Morten Thorsby,DM/M C,26,129,135,Norway,1. FC Union Berlin,4,6,10,10,11,4,16,6,4,13,11,10,15,11,15,12,15,15,15,12,12,20,9,11,13,15,18,16,12,10,12,16,16,12,19,16,10,12,10,4,15,2,3,2,1,4,2,1,1,3,3,1,12,13,3,13,13,20,15,16,1,1,1,1,11,11,16,13,20,13,1,1,1,1,189,79,11,20,2991157,6450,6750,5600,Northern_European,127,3,1996/5/5,9,0,19999.0,,53098756
144,Almamy Touré,Eint Frankfurt,1996,472.0,ml MLI,DF,26.0,4.4,13.0,7.0,7.0,5.0,1.0,5.0,9.0,55.6,4.0,9.0,2.0,7.0,10.0,23.0,8.0,0.0,Matches,472.0,ml MLI,DF,26.0,4.4,5.0,1.13,4.0,0.0,0.0,0.0,0.0,1.0,2.0,0.45,2.0,0.0,0.0,0.0,0.0,0.0,Matches,,,,,,,,,,,,,,,,,,,,,,,,,,,,,,,,,,,,,,,,,,,,,,,,,,,,,,,,472.0,ml MLI,DF,26.0,4.4,1.0,0.0,0.0,5.0,1.0,1.0,5.0,10.0,7.0,0.0,0.0,0.0,32.0,14.0,11.0,56.0,Matches,472.0,ml MLI,DF,26.0,4.4,232.0,223.0,9.0,7.0,0.0,3.0,5.0,2.0,0.0,0.0,0.0,0.0,188.0,0.0,5.0,Matches,472.0,ml MLI,DF,26.0,4.4,188.0,232.0,81.0,3407.0,1258.0,68.0,76.0,89.5,99.0,115.0,86.1,17.0,28.0,60.7,1.0,0.6,0.5,0.4,1.0,11.0,1.0,0.0,17.0,Matches,550,ml MLI,DF,26,7,398.0,57.0,13.0,4.4,5,77.0,2,2,7.0,8,1.57,10.0,12.0,-2.0,-0.45,-0.72,8.3,9.6,-1.3,-0.3,-0.63,Matches,472.0,ml MLI,DF,26.0,4.4,286.0,14.0,114.0,146.0,26.0,5.0,286.0,8.0,6.0,75.0,2.0,25.0,152.0,584.0,269.0,2.0,2.0,2.0,4.0,0.0,178.0,8.0,Matches,472.0,ml MLI,DF,26.0,4.4,0.0,3.0,1.0,33.3,0.68,0.23,0.0,0.0,14.0,0.0,0.0,0.0,0.5,0.5,0.17,-0.5,-0.5,Matches,472.0,ml MLI,DF,26.0,7.0,5.0,398.0,4.4,0.0,1.0,1.0,0.0,0.0,0.0,1.0,0.0,0.5,0.5,0.6,1.1,2.0,17.0,8.0,0.0,0.23,0.23,0.0,0.23,0.12,0.14,0.25,0.12,0.25,Matches,Almamy Touré,D/WB/M RC,26,133,140,"France,Mali",Eintracht Frankfurt,7,13,11,7,12,7,11,8,13,14,13,10,15,13,11,14,13,13,11,12,12,13,10,9,11,13,15,12,14,13,15,13,13,14,13,14,12,7,14,12,16,3,3,1,2,1,3,2,1,3,4,3,10,15,6,14,12,15,17,17,1,12,15,20,11,19,10,10,1,19,1,1,1,1,183,72,8,20,4065928,6600,6250,5250,African_Caribbean,130,15,1996/4/28,0,0,34614.0,,85122415
145,Sven Ulreich,Bayern Munich,1988,477.0,de GER,GK,33.0,3.0,1.0,1.0,1.0,0.0,0.0,1.0,1.0,100.0,0.0,0.0,0.0,0.0,0.0,1.0,0.0,1.0,Matches,477.0,de GER,GK,33.0,3.0,0.0,0.0,0.0,0.0,0.0,0.0,0.0,0.0,0.0,0.0,0.0,0.0,0.0,0.0,0.0,0.0,Matches,33.0,de GER,GK,33.0,3.0,2.0,0.0,0.0,1.0,0.0,2.4,0.18,0.4,0.13,9.0,26.0,34.6,112.0,21.0,20.5,26.0,18.0,16.7,23.4,34.0,2.0,5.9,4.0,1.33,17.5,Matches,33.0,de GER,GK,33.0,3.0,3.0,270.0,3.0,2.0,0.67,8.0,5.0,75.0,3.0,0.0,0.0,2.0,66.7,1.0,0.0,1.0,0.0,100.0,Matches,477.0,de GER,GK,33.0,3.0,1.0,0.0,0.0,1.0,1.0,0.0,0.0,0.0,1.0,0.0,1.0,0.0,5.0,0.0,0.0,,Matches,477.0,de GER,GK,33.0,3.0,131.0,110.0,20.0,2.0,0.0,0.0,0.0,0.0,0.0,0.0,0.0,0.0,110.0,1.0,0.0,Matches,477.0,de GER,GK,33.0,3.0,110.0,131.0,84.0,2282.0,1531.0,41.0,41.0,100.0,53.0,54.0,98.1,16.0,35.0,45.7,0.0,0.0,0.0,0.0,0.0,0.0,0.0,0.0,0.0,Matches,555,de GER,GK,33,3,270.0,90.0,8.8,3.0,3,90.0,3,0,,30,3.0,15.0,2.0,13.0,4.33,3.01,7.6,3.3,4.4,1.45,0.38,Matches,477.0,de GER,GK,33.0,3.0,139.0,123.0,139.0,1.0,0.0,0.0,139.0,0.0,0.0,,0.0,,97.0,441.0,217.0,0.0,0.0,0.0,0.0,0.0,80.0,0.0,Matches,477.0,de GER,GK,33.0,3.0,0.0,0.0,0.0,,0.0,0.0,,,,0.0,0.0,0.0,0.0,0.0,,0.0,0.0,Matches,477.0,de GER,GK,33.0,3.0,3.0,270.0,3.0,0.0,0.0,0.0,0.0,0.0,0.0,1.0,0.0,0.0,0.0,0.0,0.0,0.0,0.0,0.0,0.0,0.0,0.0,0.0,0.0,0.0,0.0,0.0,0.0,0.0,Matches,Sven Ulreich,GK,33,128,137,Germany,FC Bayern München,5,1,2,2,7,8,5,2,1,1,8,3,3,7,10,13,13,12,13,6,12,10,7,11,1,12,14,10,11,14,14,15,13,10,13,15,12,3,12,6,12,11,12,14,8,15,10,15,15,11,13,12,5,7,6,12,11,17,14,16,20,1,1,1,1,1,1,1,1,1,1,1,1,1,192,87,8,20,1177042,6400,6400,3755,Northern_European,127,3,1988/8/3,0,0,38355.0,,35008097
146,Jere Uronen,Schalke 04,1994,481.0,fi FIN,DF,28.0,7.5,14.0,10.0,6.0,6.0,2.0,6.0,10.0,60.0,4.0,5.0,2.0,3.0,8.0,22.0,13.0,0.0,Matches,481.0,fi FIN,DF,28.0,7.5,18.0,2.39,12.0,3.0,1.0,0.0,2.0,0.0,0.0,0.0,0.0,0.0,0.0,0.0,0.0,0.0,Matches,,,,,,,,,,,,,,,,,,,,,,,,,,,,,,,,,,,,,,,,,,,,,,,,,,,,,,,,481.0,fi FIN,DF,28.0,7.5,2.0,0.0,0.0,5.0,13.0,0.0,30.0,8.0,10.0,0.0,0.0,0.0,45.0,16.0,10.0,61.5,Matches,481.0,fi FIN,DF,28.0,7.5,373.0,285.0,85.0,10.0,0.0,0.0,30.0,71.0,4.0,1.0,3.0,0.0,275.0,3.0,8.0,Matches,481.0,fi FIN,DF,28.0,7.5,275.0,373.0,73.7,4885.0,2048.0,130.0,149.0,87.2,106.0,134.0,79.1,33.0,64.0,51.6,0.0,0.9,0.9,-0.9,9.0,19.0,7.0,7.0,30.0,Matches,561,fi FIN,DF,28,11,676.0,61.0,22.1,7.5,9,72.0,3,2,16.0,0,1.18,3.0,17.0,-14.0,-1.86,-1.03,9.2,13.4,-4.2,-0.56,-0.06,Matches,481.0,fi FIN,DF,28.0,7.5,447.0,23.0,113.0,229.0,109.0,1.0,447.0,10.0,1.0,10.0,8.0,80.0,186.0,780.0,354.0,9.0,5.0,0.0,12.0,3.0,210.0,17.0,Matches,481.0,fi FIN,DF,28.0,7.5,0.0,4.0,0.0,0.0,0.53,0.0,0.0,,33.0,0.0,0.0,0.0,0.1,0.1,0.02,-0.1,-0.1,Matches,481.0,fi FIN,DF,28.0,11.0,9.0,676.0,7.5,0.0,0.0,0.0,0.0,0.0,0.0,2.0,0.0,0.1,0.1,0.9,1.0,9.0,30.0,17.0,0.0,0.0,0.0,0.0,0.0,0.01,0.12,0.13,0.01,0.13,Matches,Jere Uronen,D/WB L,28,123,130,Finland,Stade Brestois 29,14,14,11,6,12,11,7,11,10,11,14,8,13,12,12,10,12,10,13,12,13,14,11,7,12,11,15,14,12,12,13,8,14,13,15,12,12,7,14,10,8,2,3,1,3,3,1,2,4,2,1,2,15,12,8,12,13,14,13,14,1,20,1,1,17,1,1,14,1,1,13,1,1,1,177,74,20,12,1660112,6050,6150,3754,Northern_European,120,4,1994/7/13,60,1,18000.0,,167261
147,Mark Uth,Köln,1991,482.0,de GER,MFFW,30.0,0.5,0.0,0.0,0.0,0.0,0.0,0.0,0.0,,0.0,0.0,0.0,0.0,0.0,0.0,0.0,0.0,Matches,482.0,de GER,MFFW,30.0,0.5,1.0,1.96,0.0,0.0,1.0,0.0,0.0,0.0,1.0,1.96,0.0,0.0,1.0,0.0,0.0,0.0,Matches,,,,,,,,,,,,,,,,,,,,,,,,,,,,,,,,,,,,,,,,,,,,,,,,,,,,,,,,482.0,de GER,MFFW,30.0,0.5,2.0,0.0,0.0,2.0,1.0,0.0,2.0,0.0,0.0,0.0,0.0,0.0,0.0,1.0,0.0,100.0,Matches,482.0,de GER,MFFW,30.0,0.5,15.0,12.0,3.0,1.0,0.0,0.0,2.0,0.0,1.0,0.0,1.0,0.0,11.0,0.0,0.0,Matches,482.0,de GER,MFFW,30.0,0.5,11.0,15.0,73.3,181.0,42.0,5.0,7.0,71.4,5.0,5.0,100.0,1.0,3.0,33.3,0.0,0.0,0.0,0.0,0.0,2.0,0.0,0.0,1.0,Matches,562,de GER,MFFW,30,3,46.0,15.0,1.5,0.5,0,,0,3,15.0,1,1.0,2.0,7.0,-5.0,-9.78,-9.78,0.6,1.2,-0.6,-1.25,-1.43,Matches,482.0,de GER,MFFW,30.0,0.5,20.0,0.0,0.0,12.0,8.0,3.0,20.0,2.0,1.0,50.0,1.0,50.0,8.0,34.0,19.0,0.0,0.0,0.0,2.0,0.0,12.0,1.0,Matches,482.0,de GER,MFFW,30.0,0.5,0.0,1.0,1.0,100.0,1.96,1.96,0.0,0.0,13.2,0.0,0.0,0.0,0.1,0.1,0.07,-0.1,-0.1,Matches,482.0,de GER,MFFW,30.0,3.0,0.0,46.0,0.5,0.0,0.0,0.0,0.0,0.0,0.0,2.0,0.0,0.1,0.1,0.0,0.1,0.0,1.0,1.0,0.0,0.0,0.0,0.0,0.0,0.14,0.0,0.14,0.14,0.14,Matches,Mark Uth,S,30,130,140,Germany,1. FC Köln,7,10,13,13,13,13,11,11,7,6,12,14,7,12,12,11,10,14,12,9,11,9,13,11,16,7,11,12,15,14,11,11,13,15,13,12,11,5,13,6,10,3,2,2,2,1,2,2,4,1,3,1,10,14,10,11,14,12,9,12,1,1,1,1,1,1,1,1,1,1,10,14,10,20,185,72,20,12,3612408,6500,6500,4600,Northern_European,128,6,1991/8/24,1,0,34520.0,,91014816
148,Renato Veiga,Augsburg,2003,485.0,pt POR,DF,19.0,7.1,9.0,6.0,4.0,3.0,2.0,7.0,9.0,77.8,2.0,20.0,6.0,14.0,7.0,16.0,29.0,1.0,Matches,485.0,pt POR,DF,19.0,7.1,6.0,0.85,5.0,0.0,0.0,1.0,0.0,0.0,0.0,0.0,0.0,0.0,0.0,0.0,0.0,0.0,Matches,,,,,,,,,,,,,,,,,,,,,,,,,,,,,,,,,,,,,,,,,,,,,,,,,,,,,,,,485.0,pt POR,DF,19.0,7.1,3.0,0.0,0.0,9.0,4.0,0.0,7.0,7.0,6.0,0.0,0.0,0.0,60.0,12.0,14.0,46.2,Matches,485.0,pt POR,DF,19.0,7.1,318.0,271.0,47.0,9.0,0.0,2.0,7.0,38.0,0.0,0.0,0.0,0.0,210.0,0.0,3.0,Matches,485.0,pt POR,DF,19.0,7.1,210.0,318.0,66.0,4306.0,1261.0,64.0,85.0,75.3,105.0,131.0,80.2,35.0,88.0,39.8,0.0,0.2,0.2,-0.2,2.0,7.0,4.0,1.0,14.0,Matches,565,pt POR,DF,19,13,639.0,49.0,20.9,7.1,7,71.0,3,6,24.0,2,1.0,5.0,16.0,-11.0,-1.55,-1.18,4.6,15.4,-10.9,-1.53,-1.04,Matches,485.0,pt POR,DF,19.0,7.1,416.0,57.0,206.0,171.0,47.0,7.0,416.0,15.0,10.0,66.7,4.0,26.7,199.0,1070.0,528.0,11.0,3.0,3.0,7.0,4.0,199.0,6.0,Matches,485.0,pt POR,DF,19.0,7.1,0.0,8.0,0.0,0.0,1.13,0.0,0.0,,26.6,1.0,0.0,0.0,0.2,0.2,0.02,-0.2,-0.2,Matches,485.0,pt POR,DF,19.0,13.0,7.0,639.0,7.1,0.0,0.0,0.0,0.0,0.0,0.0,3.0,0.0,0.2,0.2,0.2,0.4,11.0,14.0,6.0,0.0,0.0,0.0,0.0,0.0,0.03,0.03,0.05,0.03,0.05,Matches,Renato Veiga,DM/M C,18,86,-75,"Portugal,Cape Verde Islands",Sporting Clube de Portugal,7,7,7,3,13,7,8,9,1,9,14,6,11,9,9,7,8,7,9,12,14,10,5,9,8,14,8,12,14,14,7,8,12,14,7,6,8,5,7,7,16,1,2,2,3,3,2,2,3,3,1,2,14,10,8,10,12,13,10,12,1,1,14,1,1,1,20,1,17,1,1,1,1,1,186,72,20,7,12090000,4296,4296,2296,African_Caribbean,84,10,2003/7/29,0,0,1456.0,,83320123
149,Aster Vranckx,Wolfsburg,2002,490.0,be BEL,MF,19.0,0.1,0.0,0.0,0.0,0.0,0.0,0.0,0.0,,0.0,0.0,0.0,0.0,0.0,0.0,1.0,0.0,Matches,490.0,be BEL,MF,19.0,0.1,0.0,0.0,0.0,0.0,0.0,0.0,0.0,0.0,0.0,0.0,0.0,0.0,0.0,0.0,0.0,0.0,Matches,,,,,,,,,,,,,,,,,,,,,,,,,,,,,,,,,,,,,,,,,,,,,,,,,,,,,,,,490.0,be BEL,MF,19.0,0.1,0.0,0.0,0.0,0.0,1.0,0.0,0.0,0.0,0.0,0.0,0.0,0.0,3.0,0.0,0.0,,Matches,490.0,be BEL,MF,19.0,0.1,3.0,3.0,0.0,0.0,0.0,0.0,0.0,0.0,0.0,0.0,0.0,0.0,2.0,0.0,0.0,Matches,490.0,be BEL,MF,19.0,0.1,2.0,3.0,66.7,32.0,10.0,1.0,1.0,100.0,1.0,2.0,50.0,0.0,0.0,,0.0,0.0,0.0,0.0,0.0,0.0,0.0,0.0,0.0,Matches,571,be BEL,MF,19,1,8.0,8.0,0.3,0.1,0,,0,1,8.0,1,0.0,0.0,0.0,0.0,0.0,-0.27,0.1,0.1,0.0,-0.24,-0.25,Matches,490.0,be BEL,MF,19.0,0.1,4.0,2.0,2.0,1.0,1.0,0.0,4.0,0.0,0.0,,0.0,,2.0,5.0,3.0,0.0,0.0,0.0,0.0,0.0,0.0,0.0,Matches,490.0,be BEL,MF,19.0,0.1,0.0,0.0,0.0,,0.0,0.0,,,,0.0,0.0,0.0,0.0,0.0,,0.0,0.0,Matches,490.0,be BEL,MF,19.0,1.0,0.0,8.0,0.1,0.0,0.0,0.0,0.0,0.0,0.0,0.0,0.0,0.0,0.0,0.0,0.0,0.0,0.0,0.0,0.0,0.0,0.0,0.0,0.0,0.0,0.0,0.0,0.0,0.0,Matches,Aster Vranckx,DM/M C,19,126,-85,"Belgium,Democratic Republic of Congo",VfL Wolfsburg,11,9,13,11,12,12,8,11,4,12,13,7,14,14,15,13,14,12,12,12,12,16,13,12,14,12,15,16,12,12,12,11,14,12,13,12,13,12,12,6,13,1,3,1,1,3,3,1,3,3,1,2,13,15,10,11,13,11,12,9,1,1,1,10,1,10,16,10,20,12,10,15,9,1,183,78,13,20,70880000,6299,5999,5749,Mixed_Race,126,11,2002/10/4,0,0,28766.0,AC Milan,18113140
150,Robert Wagner,Freiburg,2003,491.0,de GER,MF,19.0,0.4,0.0,0.0,0.0,0.0,0.0,0.0,0.0,,0.0,2.0,0.0,2.0,0.0,0.0,2.0,0.0,Matches,491.0,de GER,MF,19.0,0.4,1.0,2.31,0.0,0.0,0.0,1.0,0.0,0.0,0.0,0.0,0.0,0.0,0.0,0.0,0.0,0.0,Matches,,,,,,,,,,,,,,,,,,,,,,,,,,,,,,,,,,,,,,,,,,,,,,,,,,,,,,,,491.0,de GER,MF,19.0,0.4,1.0,0.0,0.0,0.0,1.0,0.0,0.0,0.0,0.0,0.0,0.0,0.0,3.0,2.0,2.0,50.0,Matches,491.0,de GER,MF,19.0,0.4,15.0,15.0,0.0,0.0,0.0,0.0,0.0,0.0,0.0,0.0,0.0,0.0,7.0,0.0,1.0,Matches,491.0,de GER,MF,19.0,0.4,7.0,15.0,46.7,99.0,35.0,2.0,5.0,40.0,4.0,6.0,66.7,0.0,1.0,0.0,0.0,0.0,0.0,0.0,0.0,0.0,0.0,0.0,0.0,Matches,572,de GER,MF,19,4,38.0,10.0,1.2,0.4,0,,0,4,10.0,8,2.25,1.0,2.0,-1.0,-2.37,-2.61,2.2,1.7,0.5,1.18,1.22,Matches,491.0,de GER,MF,19.0,0.4,26.0,3.0,6.0,10.0,10.0,2.0,26.0,1.0,0.0,0.0,1.0,100.0,7.0,30.0,12.0,0.0,2.0,0.0,1.0,1.0,10.0,2.0,Matches,491.0,de GER,MF,19.0,0.4,0.0,2.0,0.0,0.0,4.74,0.0,0.0,,17.2,0.0,0.0,0.0,0.2,0.2,0.12,-0.2,-0.2,Matches,491.0,de GER,MF,19.0,4.0,0.0,38.0,0.4,0.0,0.0,0.0,0.0,0.0,0.0,1.0,0.0,0.2,0.2,0.0,0.2,0.0,0.0,2.0,0.0,0.0,0.0,0.0,0.0,0.54,0.0,0.54,0.54,0.54,Matches,Robert Wagner,M/AM RLC,19,109,-8,Germany,Sport-Club Freiburg,9,10,12,10,13,8,9,12,9,7,13,9,10,13,15,10,11,9,12,12,11,12,6,10,9,10,14,14,12,10,9,12,15,11,14,11,12,16,12,3,12,3,1,3,3,2,1,3,1,1,1,3,13,14,10,13,11,10,12,10,1,1,1,1,1,1,1,17,20,15,15,18,15,10,184,0,10,20,53600001,5290,5290,3056,Northern_European,103,2,2003/7/14,0,0,2000.0,,2000068513
151,Luca Waldschmidt,Wolfsburg,1996,492.0,de GER,FWMF,26.0,5.8,5.0,2.0,2.0,1.0,2.0,2.0,10.0,20.0,8.0,6.0,0.0,6.0,3.0,8.0,5.0,0.0,Matches,492.0,de GER,FWMF,26.0,5.8,9.0,1.55,7.0,0.0,0.0,2.0,0.0,0.0,1.0,0.17,1.0,0.0,0.0,0.0,0.0,0.0,Matches,,,,,,,,,,,,,,,,,,,,,,,,,,,,,,,,,,,,,,,,,,,,,,,,,,,,,,,,492.0,de GER,FWMF,26.0,5.8,0.0,0.0,0.0,14.0,4.0,1.0,3.0,3.0,2.0,0.0,1.0,0.0,21.0,1.0,9.0,10.0,Matches,492.0,de GER,FWMF,26.0,5.8,153.0,143.0,10.0,0.0,1.0,0.0,3.0,1.0,1.0,1.0,0.0,0.0,117.0,0.0,4.0,Matches,492.0,de GER,FWMF,26.0,5.8,117.0,153.0,76.5,1524.0,260.0,73.0,85.0,85.9,34.0,44.0,77.3,4.0,11.0,36.4,0.0,0.0,0.5,0.0,1.0,9.0,2.0,0.0,12.0,Matches,573,de GER,FWMF,26,18,523.0,29.0,17.1,5.8,4,61.0,0,14,20.0,12,1.28,11.0,12.0,-1.0,-0.17,-0.53,9.9,11.4,-1.5,-0.26,-0.32,Matches,492.0,de GER,FWMF,26.0,5.8,202.0,4.0,28.0,110.0,64.0,15.0,201.0,2.0,1.0,50.0,1.0,50.0,106.0,449.0,191.0,5.0,1.0,0.0,12.0,3.0,146.0,26.0,Matches,492.0,de GER,FWMF,26.0,5.8,4.0,10.0,5.0,50.0,1.72,0.86,0.3,0.6,14.2,0.0,1.0,1.0,3.5,1.9,0.19,0.5,1.1,Matches,492.0,de GER,FWMF,26.0,18.0,4.0,523.0,5.8,4.0,0.0,4.0,3.0,1.0,1.0,0.0,0.0,3.5,1.9,0.0,1.9,5.0,12.0,26.0,0.69,0.0,0.69,0.52,0.52,0.6,0.01,0.6,0.32,0.33,Matches,Luca Waldschmidt,AM/S RLC,26,134,145,Germany,VfL Wolfsburg,12,12,12,13,15,13,11,14,4,5,14,17,6,15,9,13,8,14,10,15,13,11,14,6,14,7,12,10,14,12,14,11,11,13,12,11,10,4,13,14,11,2,3,2,4,2,3,1,1,1,1,1,6,16,12,7,10,11,14,11,1,1,1,1,1,1,1,10,1,10,15,20,15,20,181,73,20,12,5138439,6699,6699,5499,Northern_European,130,4,1996/5/19,7,2,72876.0,,91119468
152,Paul Wanner,Bayern Munich,2005,493.0,de GER,MF,16.0,0.3,3.0,1.0,1.0,2.0,0.0,1.0,1.0,100.0,0.0,0.0,0.0,0.0,0.0,3.0,1.0,0.0,Matches,493.0,de GER,MF,16.0,0.3,1.0,3.6,1.0,0.0,0.0,0.0,0.0,0.0,0.0,0.0,0.0,0.0,0.0,0.0,0.0,0.0,Matches,,,,,,,,,,,,,,,,,,,,,,,,,,,,,,,,,,,,,,,,,,,,,,,,,,,,,,,,493.0,de GER,MF,16.0,0.3,1.0,0.0,0.0,1.0,0.0,0.0,0.0,0.0,1.0,0.0,0.0,0.0,1.0,1.0,0.0,100.0,Matches,493.0,de GER,MF,16.0,0.3,9.0,9.0,0.0,0.0,0.0,0.0,0.0,0.0,0.0,0.0,0.0,0.0,7.0,0.0,0.0,Matches,493.0,de GER,MF,16.0,0.3,7.0,9.0,77.8,86.0,27.0,4.0,5.0,80.0,2.0,3.0,66.7,0.0,0.0,,0.0,0.1,0.1,-0.1,1.0,0.0,1.0,0.0,1.0,Matches,574,de GER,MF,16,2,25.0,13.0,0.8,0.3,0,,0,2,13.0,8,3.0,0.0,1.0,-1.0,-3.6,-5.23,0.2,0.2,0.0,0.04,-1.08,Matches,493.0,de GER,MF,16.0,0.3,13.0,1.0,3.0,6.0,4.0,2.0,13.0,2.0,2.0,100.0,0.0,0.0,10.0,67.0,22.0,1.0,1.0,1.0,0.0,4.0,11.0,4.0,Matches,493.0,de GER,MF,16.0,0.3,0.0,0.0,0.0,,0.0,0.0,,,,0.0,0.0,0.0,0.0,0.0,,0.0,0.0,Matches,493.0,de GER,MF,16.0,2.0,0.0,25.0,0.3,0.0,0.0,0.0,0.0,0.0,0.0,1.0,0.0,0.0,0.0,0.1,0.1,1.0,1.0,4.0,0.0,0.0,0.0,0.0,0.0,0.0,0.25,0.25,0.0,0.25,Matches,Paul Wanner,M/AM RC,16,112,-9,"Germany,Austria",FC Bayern München,12,11,13,11,14,12,6,11,4,7,13,12,7,15,6,9,8,12,9,13,10,13,16,4,11,7,11,11,14,13,12,11,14,14,10,7,14,4,13,4,16,2,3,2,3,1,3,2,1,3,3,3,8,19,2,14,16,15,14,17,1,11,1,1,14,8,10,12,18,12,14,20,15,10,185,72,20,12,46050001,5747,5747,4003,Northern_European,111,1,2005/12/23,0,0,64.0,,2000138516
153,Nelson Weiper,Mainz 05,2005,495.0,de GER,FWDF,17.0,1.1,2.0,0.0,0.0,0.0,2.0,1.0,3.0,33.3,2.0,2.0,0.0,2.0,0.0,2.0,1.0,0.0,Matches,495.0,de GER,FWDF,17.0,1.1,1.0,0.91,1.0,0.0,0.0,0.0,0.0,0.0,0.0,0.0,0.0,0.0,0.0,0.0,0.0,0.0,Matches,,,,,,,,,,,,,,,,,,,,,,,,,,,,,,,,,,,,,,,,,,,,,,,,,,,,,,,,495.0,de GER,FWDF,17.0,1.1,0.0,0.0,0.0,2.0,2.0,3.0,2.0,0.0,0.0,0.0,0.0,0.0,5.0,7.0,7.0,50.0,Matches,495.0,de GER,FWDF,17.0,1.1,40.0,38.0,2.0,0.0,0.0,0.0,2.0,0.0,0.0,0.0,0.0,0.0,27.0,0.0,3.0,Matches,495.0,de GER,FWDF,17.0,1.1,27.0,40.0,67.5,339.0,47.0,17.0,21.0,81.0,8.0,13.0,61.5,0.0,0.0,,0.0,0.1,0.1,-0.1,2.0,0.0,1.0,1.0,1.0,Matches,576,de GER,FWDF,17,9,99.0,11.0,3.2,1.1,0,,0,9,11.0,7,1.22,5.0,4.0,1.0,0.91,0.97,3.8,4.6,-0.8,-0.72,-0.55,Matches,495.0,de GER,FWDF,17.0,1.1,61.0,1.0,4.0,14.0,44.0,12.0,61.0,7.0,0.0,0.0,5.0,71.4,33.0,220.0,86.0,5.0,3.0,2.0,2.0,1.0,45.0,19.0,Matches,495.0,de GER,FWDF,17.0,1.1,2.0,5.0,4.0,80.0,4.55,3.64,0.4,0.5,7.3,0.0,0.0,0.0,1.7,1.7,0.33,0.3,0.3,Matches,495.0,de GER,FWDF,17.0,9.0,0.0,99.0,1.1,2.0,0.0,2.0,2.0,0.0,0.0,0.0,0.0,1.7,1.7,0.1,1.8,5.0,1.0,19.0,1.82,0.0,1.82,1.82,1.82,1.52,0.13,1.65,1.52,1.65,Matches,Nelson Weiper,S,17,102,-8,"Germany,Albania",1. FSV Mainz 05,1,7,11,13,13,6,13,8,4,5,11,15,6,12,11,10,11,10,8,11,8,17,13,8,13,6,12,12,12,11,12,14,14,12,11,12,16,6,14,5,4,3,1,1,3,3,3,1,1,1,1,1,12,16,2,16,16,16,14,15,1,1,1,1,1,1,1,1,1,1,14,14,14,20,192,0,12,20,29000001,5100,5100,3600,Northern_European,102,2,2005/3/17,0,0,6711.0,,2000170587
154,Noah Weißhaupt,Freiburg,2001,497.0,de GER,MFDF,20.0,4.7,11.0,6.0,3.0,7.0,1.0,2.0,7.0,28.6,5.0,4.0,0.0,4.0,6.0,17.0,8.0,0.0,Matches,497.0,de GER,MFDF,20.0,4.7,13.0,2.72,8.0,1.0,2.0,0.0,2.0,0.0,1.0,0.21,1.0,0.0,0.0,0.0,0.0,0.0,Matches,,,,,,,,,,,,,,,,,,,,,,,,,,,,,,,,,,,,,,,,,,,,,,,,,,,,,,,,497.0,de GER,MFDF,20.0,4.7,0.0,0.0,0.0,2.0,20.0,1.0,15.0,6.0,6.0,0.0,0.0,0.0,30.0,4.0,5.0,44.4,Matches,497.0,de GER,MFDF,20.0,4.7,162.0,156.0,5.0,2.0,1.0,3.0,15.0,3.0,0.0,0.0,0.0,0.0,111.0,1.0,7.0,Matches,497.0,de GER,MFDF,20.0,4.7,111.0,162.0,68.5,1810.0,410.0,57.0,71.0,80.3,36.0,50.0,72.0,13.0,27.0,48.1,1.0,1.0,0.8,0.0,8.0,9.0,6.0,2.0,14.0,Matches,578,de GER,MFDF,20,18,427.0,24.0,14.0,4.7,3,64.0,0,15,16.0,14,1.5,5.0,6.0,-1.0,-0.21,-0.48,6.2,7.8,-1.5,-0.32,-0.35,Matches,497.0,de GER,MFDF,20.0,4.7,214.0,14.0,59.0,98.0,58.0,8.0,214.0,16.0,7.0,43.8,5.0,31.3,132.0,763.0,359.0,14.0,4.0,4.0,12.0,3.0,136.0,31.0,Matches,497.0,de GER,MFDF,20.0,4.7,0.0,2.0,1.0,50.0,0.42,0.21,0.0,0.0,14.4,0.0,0.0,0.0,0.2,0.2,0.08,-0.2,-0.2,Matches,497.0,de GER,MFDF,20.0,18.0,3.0,427.0,4.7,0.0,1.0,1.0,0.0,0.0,0.0,0.0,0.0,0.2,0.2,1.0,1.2,14.0,14.0,31.0,0.0,0.21,0.21,0.0,0.21,0.03,0.21,0.24,0.03,0.24,Matches,Noah Weißhaupt,WB/M/AM RL,20,112,-75,Germany,Sport-Club Freiburg,7,11,13,9,12,4,6,8,3,8,11,6,9,11,6,7,10,8,8,10,7,15,13,8,10,9,13,13,13,11,12,8,12,14,14,6,10,3,14,6,15,3,1,3,3,3,1,1,3,1,4,1,11,14,6,17,12,13,10,4,1,10,1,10,18,20,1,15,1,17,20,10,20,1,182,0,15,20,60800000,5249,5249,3249,Northern_European,90,4,2001/9/20,0,0,1500.0,,91190768
155,Marcel Wenig,Eint Frankfurt,2004,498.0,de GER,MF,18.0,0.0,0.0,0.0,0.0,0.0,0.0,0.0,0.0,,0.0,0.0,0.0,0.0,0.0,0.0,0.0,0.0,Matches,498.0,de GER,MF,18.0,0.0,0.0,0.0,0.0,0.0,0.0,0.0,0.0,0.0,0.0,0.0,0.0,0.0,0.0,0.0,0.0,0.0,Matches,,,,,,,,,,,,,,,,,,,,,,,,,,,,,,,,,,,,,,,,,,,,,,,,,,,,,,,,498.0,de GER,MF,18.0,0.0,0.0,0.0,0.0,0.0,0.0,0.0,0.0,0.0,0.0,0.0,0.0,0.0,0.0,0.0,0.0,,Matches,498.0,de GER,MF,18.0,0.0,10.0,10.0,0.0,0.0,0.0,0.0,0.0,0.0,0.0,0.0,0.0,0.0,9.0,0.0,0.0,Matches,498.0,de GER,MF,18.0,0.0,9.0,10.0,90.0,120.0,11.0,7.0,7.0,100.0,1.0,2.0,50.0,1.0,1.0,100.0,0.0,0.0,0.0,0.0,0.0,0.0,0.0,0.0,0.0,Matches,579,de GER,MF,18,1,4.0,4.0,0.1,0.0,0,,0,1,4.0,10,3.0,0.0,0.0,0.0,0.0,-0.18,0.0,0.0,0.0,0.0,-0.25,Matches,498.0,de GER,MF,18.0,0.0,13.0,0.0,2.0,8.0,3.0,1.0,13.0,0.0,0.0,,0.0,,7.0,27.0,2.0,0.0,0.0,1.0,1.0,0.0,11.0,0.0,Matches,498.0,de GER,MF,18.0,0.0,0.0,0.0,0.0,,0.0,0.0,,,,0.0,0.0,0.0,0.0,0.0,,0.0,0.0,Matches,498.0,de GER,MF,18.0,1.0,0.0,4.0,0.0,0.0,0.0,0.0,0.0,0.0,0.0,0.0,0.0,0.0,0.0,0.0,0.0,0.0,0.0,0.0,0.0,0.0,0.0,0.0,0.0,0.0,0.0,0.0,0.0,0.0,Matches,Marcel Wenig,M/AM C,18,95,-75,"Germany,Greece",Eintracht Frankfurt,10,10,12,11,13,11,9,12,3,7,13,10,7,14,9,9,8,11,7,13,8,13,14,7,11,8,11,11,12,11,12,13,14,12,11,11,13,3,8,5,13,3,2,1,1,2,4,1,1,3,3,2,15,14,7,14,11,11,11,19,1,1,1,1,1,1,10,14,18,14,14,20,14,1,188,79,8,20,15080000,4744,4744,3251,Northern_European,96,3,2004/5/4,0,0,5768.0,,2000066000
156,Frederik Winther,Augsburg,2001,503.0,dk DEN,DF,21.0,1.0,2.0,2.0,1.0,1.0,0.0,0.0,2.0,0.0,2.0,1.0,1.0,0.0,0.0,2.0,7.0,0.0,Matches,503.0,dk DEN,DF,21.0,1.0,1.0,1.0,1.0,0.0,0.0,0.0,0.0,0.0,1.0,1.0,1.0,0.0,0.0,0.0,0.0,0.0,Matches,,,,,,,,,,,,,,,,,,,,,,,,,,,,,,,,,,,,,,,,,,,,,,,,,,,,,,,,503.0,dk DEN,DF,21.0,1.0,0.0,0.0,0.0,0.0,0.0,0.0,0.0,0.0,2.0,0.0,0.0,0.0,2.0,6.0,3.0,66.7,Matches,503.0,dk DEN,DF,21.0,1.0,35.0,33.0,2.0,2.0,0.0,1.0,0.0,0.0,0.0,0.0,0.0,0.0,22.0,0.0,0.0,Matches,503.0,dk DEN,DF,21.0,1.0,22.0,35.0,62.9,456.0,203.0,5.0,8.0,62.5,12.0,15.0,80.0,4.0,8.0,50.0,1.0,0.1,0.0,0.9,1.0,1.0,1.0,0.0,1.0,Matches,584,dk DEN,DF,21,1,90.0,90.0,2.9,1.0,1,90.0,1,0,,7,0.0,2.0,3.0,-1.0,-1.0,-0.39,0.4,1.5,-1.0,-1.04,-0.35,Matches,503.0,dk DEN,DF,21.0,1.0,49.0,11.0,31.0,16.0,2.0,0.0,49.0,0.0,0.0,,0.0,,15.0,94.0,50.0,0.0,0.0,0.0,0.0,0.0,18.0,0.0,Matches,503.0,dk DEN,DF,21.0,1.0,0.0,0.0,0.0,,0.0,0.0,,,,0.0,0.0,0.0,0.0,0.0,,0.0,0.0,Matches,503.0,dk DEN,DF,21.0,1.0,1.0,90.0,1.0,0.0,1.0,1.0,0.0,0.0,0.0,0.0,0.0,0.0,0.0,0.1,0.1,0.0,1.0,0.0,0.0,1.0,1.0,0.0,1.0,0.0,0.1,0.1,0.0,0.1,Matches,Frederik Winther,D C,21,106,-75,Denmark,FC Augsburg,6,6,8,5,12,6,12,5,9,12,12,8,12,11,11,12,13,14,11,13,13,12,5,11,10,14,15,10,8,9,11,13,12,10,11,13,12,8,11,4,9,1,4,2,1,1,1,2,2,3,2,3,8,10,5,15,12,12,12,15,1,12,20,8,1,1,1,1,1,1,1,1,1,1,186,77,20,10,26400001,5243,5243,3254,Northern_European,106,4,2001/1/4,0,0,2777.0,,27143691
157,Hannes Wolf,Gladbach,1999,505.0,at AUT,FW,23.0,5.0,11.0,8.0,4.0,5.0,2.0,5.0,13.0,38.5,8.0,3.0,0.0,3.0,3.0,14.0,9.0,0.0,Matches,505.0,at AUT,FW,23.0,5.0,13.0,2.61,10.0,0.0,1.0,1.0,1.0,0.0,1.0,0.2,1.0,0.0,0.0,0.0,0.0,0.0,Matches,,,,,,,,,,,,,,,,,,,,,,,,,,,,,,,,,,,,,,,,,,,,,,,,,,,,,,,,505.0,at AUT,FW,23.0,5.0,0.0,0.0,0.0,7.0,12.0,1.0,2.0,3.0,8.0,0.0,0.0,0.0,31.0,4.0,8.0,33.3,Matches,505.0,at AUT,FW,23.0,5.0,179.0,171.0,7.0,0.0,1.0,1.0,2.0,7.0,0.0,0.0,0.0,0.0,146.0,1.0,6.0,Matches,505.0,at AUT,FW,23.0,5.0,146.0,179.0,81.6,1927.0,322.0,83.0,94.0,88.3,43.0,46.0,93.5,6.0,10.0,60.0,1.0,0.3,0.2,0.7,6.0,8.0,2.0,0.0,13.0,Matches,586,at AUT,FW,23,18,449.0,25.0,14.7,5.0,4,66.0,0,14,13.0,8,1.39,8.0,13.0,-5.0,-1.0,-1.07,6.7,11.0,-4.2,-0.85,-0.95,Matches,505.0,at AUT,FW,23.0,5.0,251.0,8.0,41.0,119.0,95.0,17.0,251.0,24.0,6.0,25.0,15.0,62.5,149.0,723.0,382.0,12.0,7.0,5.0,8.0,13.0,185.0,37.0,Matches,505.0,at AUT,FW,23.0,5.0,1.0,8.0,3.0,37.5,1.6,0.6,0.13,0.33,13.8,0.0,0.0,0.0,1.4,1.4,0.18,-0.4,-0.4,Matches,505.0,at AUT,FW,23.0,18.0,4.0,449.0,5.0,1.0,1.0,2.0,1.0,0.0,0.0,0.0,0.0,1.4,1.4,0.3,1.7,12.0,13.0,37.0,0.2,0.2,0.4,0.2,0.4,0.29,0.05,0.34,0.29,0.34,Matches,Hannes Wolf,AM RLC,23,127,138,Austria,Borussia Mönchengladbach,12,11,13,11,12,12,7,9,6,9,11,12,11,13,16,12,15,11,9,13,9,16,13,6,13,10,14,16,15,13,8,8,12,13,14,8,11,10,12,12,18,3,2,1,3,3,2,3,2,1,3,2,13,12,13,8,9,10,9,7,1,13,1,10,14,10,1,12,12,12,15,20,15,10,179,71,20,17,3363364,6350,6400,5350,Northern_European,125,4,1999/4/16,0,0,38355.0,,16184663
158,Kelvin Yeboah,Augsburg,2000,508.0,it ITA,FWMF,22.0,3.9,6.0,4.0,2.0,4.0,0.0,2.0,5.0,40.0,3.0,7.0,0.0,7.0,1.0,7.0,2.0,0.0,Matches,508.0,it ITA,FWMF,22.0,3.9,14.0,3.57,7.0,0.0,1.0,3.0,2.0,1.0,2.0,0.51,1.0,0.0,0.0,1.0,0.0,0.0,Matches,,,,,,,,,,,,,,,,,,,,,,,,,,,,,,,,,,,,,,,,,,,,,,,,,,,,,,,,508.0,it ITA,FWMF,22.0,3.9,0.0,0.0,0.0,11.0,11.0,1.0,6.0,1.0,4.0,0.0,0.0,0.0,19.0,14.0,22.0,38.9,Matches,508.0,it ITA,FWMF,22.0,3.9,59.0,58.0,0.0,0.0,0.0,1.0,6.0,0.0,0.0,0.0,0.0,0.0,28.0,1.0,8.0,Matches,508.0,it ITA,FWMF,22.0,3.9,28.0,59.0,47.5,461.0,166.0,13.0,21.0,61.9,12.0,20.0,60.0,3.0,5.0,60.0,1.0,0.4,0.5,0.6,5.0,4.0,3.0,1.0,6.0,Matches,590,it ITA,FWMF,22,13,353.0,27.0,11.5,3.9,3,53.0,0,10,19.0,2,1.23,3.0,2.0,1.0,0.25,0.99,4.2,5.1,-0.9,-0.22,0.55,Matches,508.0,it ITA,FWMF,22.0,3.9,139.0,3.0,17.0,47.0,82.0,22.0,139.0,28.0,15.0,53.6,10.0,35.7,76.0,536.0,299.0,13.0,6.0,6.0,14.0,10.0,84.0,25.0,Matches,508.0,it ITA,FWMF,22.0,3.9,1.0,13.0,2.0,15.4,3.31,0.51,0.08,0.5,12.8,0.0,0.0,0.0,1.4,1.4,0.11,-0.4,-0.4,Matches,508.0,it ITA,FWMF,22.0,13.0,3.0,353.0,3.9,1.0,1.0,2.0,1.0,0.0,0.0,0.0,0.0,1.4,1.4,0.4,1.8,13.0,6.0,25.0,0.25,0.25,0.51,0.25,0.51,0.36,0.1,0.46,0.36,0.46,Matches,Kelvin Yeboah,S L,22,125,147,"Italy,Ghana",Genoa CFC,4,8,12,13,11,5,10,7,2,5,10,12,5,12,9,12,10,13,11,10,10,14,13,7,14,4,12,12,17,14,11,13,14,16,13,12,12,5,10,4,11,3,3,2,1,3,3,4,3,2,1,3,14,14,5,12,13,14,7,15,1,1,1,1,1,1,1,1,1,1,15,5,14,20,185,77,12,20,5291733,6250,6250,5000,African_Caribbean,120,14,2000/5/6,0,0,2320.0,,43322599
159,Naouirou Ahamada,Crystal Palace,2002,7.0,fr FRA,MFFW,20.0,1.0,3.0,2.0,3.0,0.0,0.0,1.0,3.0,33.3,2.0,2.0,0.0,2.0,0.0,3.0,0.0,0.0,Matches,7.0,fr FRA,MFFW,20.0,1.0,2.0,1.91,1.0,0.0,0.0,1.0,0.0,0.0,0.0,0.0,0.0,0.0,0.0,0.0,0.0,0.0,Matches,,,,,,,,,,,,,,,,,,,,,,,,,,,,,,,,,,,,,,,,,,,,,,,,,,,,,,,,7.0,fr FRA,MFFW,20.0,1.0,1.0,0.0,0.0,2.0,0.0,2.0,2.0,0.0,2.0,0.0,0.0,0.0,8.0,0.0,1.0,0.0,Matches,7.0,fr FRA,MFFW,20.0,1.0,46.0,45.0,1.0,0.0,0.0,0.0,2.0,0.0,0.0,0.0,0.0,0.0,37.0,0.0,0.0,Matches,7.0,fr FRA,MFFW,20.0,1.0,37.0,46.0,80.4,550.0,179.0,19.0,23.0,82.6,15.0,17.0,88.2,1.0,3.0,33.3,0.0,0.1,0.0,-0.1,1.0,3.0,0.0,0.0,2.0,Matches,11,fr FRA,MFFW,20,8,94.0,12.0,2.7,1.0,0,,0,8,12.0,3,0.38,0.0,2.0,-2.0,-1.91,-1.73,1.1,1.8,-0.7,-0.69,-0.47,Matches,7.0,fr FRA,MFFW,20.0,1.0,63.0,0.0,12.0,35.0,16.0,4.0,63.0,2.0,1.0,50.0,1.0,50.0,32.0,179.0,70.0,1.0,2.0,1.0,5.0,1.0,39.0,11.0,Matches,7.0,fr FRA,MFFW,20.0,1.0,0.0,3.0,0.0,0.0,2.87,0.0,0.0,,15.9,0.0,0.0,0.0,0.2,0.2,0.05,-0.2,-0.2,Matches,7.0,fr FRA,MFFW,20.0,8.0,0.0,94.0,1.0,0.0,0.0,0.0,0.0,0.0,0.0,1.0,0.0,0.2,0.2,0.1,0.2,1.0,2.0,11.0,0.0,0.0,0.0,0.0,0.0,0.15,0.07,0.22,0.15,0.22,Matches,Naouirou Ahamada,DM/M C,20,115,-75,"France,Comoros",VfB Stuttgart,5,8,13,8,13,6,8,10,5,12,14,6,11,15,14,11,13,12,12,12,12,15,14,7,1,12,12,15,13,13,12,11,12,13,13,13,11,8,10,10,8,2,1,3,3,3,3,2,3,2,1,1,12,13,8,11,10,14,10,10,1,1,1,1,1,1,18,1,20,1,1,14,1,1,183,73,10,20,54000001,5996,4412,4096,African_Caribbean,112,16,2002/3/29,0,0,14383.0,,49048373
160,Kristoffer Ajer,Brentford,1998,9.0,no NOR,DF,24.0,8.5,11.0,8.0,5.0,4.0,2.0,9.0,16.0,56.3,7.0,6.0,5.0,1.0,7.0,18.0,22.0,0.0,Matches,9.0,no NOR,DF,24.0,8.5,4.0,0.47,4.0,0.0,0.0,0.0,0.0,0.0,0.0,0.0,0.0,0.0,0.0,0.0,0.0,0.0,Matches,,,,,,,,,,,,,,,,,,,,,,,,,,,,,,,,,,,,,,,,,,,,,,,,,,,,,,,,9.0,no NOR,DF,24.0,8.5,0.0,0.0,0.0,5.0,8.0,0.0,6.0,7.0,8.0,0.0,1.0,0.0,36.0,15.0,11.0,57.7,Matches,9.0,no NOR,DF,24.0,8.5,345.0,293.0,51.0,7.0,0.0,4.0,6.0,44.0,0.0,0.0,0.0,0.0,259.0,1.0,8.0,Matches,9.0,no NOR,DF,24.0,8.5,259.0,345.0,75.1,4480.0,1887.0,131.0,159.0,82.4,102.0,128.0,79.7,23.0,40.0,57.5,0.0,0.0,0.1,0.0,1.0,20.0,3.0,1.0,31.0,Matches,13,no NOR,DF,24,9,763.0,85.0,22.3,8.5,9,85.0,6,0,,10,1.11,7.0,14.0,-7.0,-0.83,-1.47,9.4,11.1,-1.6,-0.19,-0.48,Matches,9.0,no NOR,DF,24.0,8.5,412.0,45.0,184.0,167.0,64.0,9.0,412.0,9.0,3.0,33.3,4.0,44.4,213.0,1123.0,613.0,10.0,5.0,0.0,3.0,8.0,231.0,12.0,Matches,9.0,no NOR,DF,24.0,8.5,0.0,1.0,0.0,0.0,0.12,0.0,0.0,,6.0,0.0,0.0,0.0,0.0,0.0,0.04,0.0,0.0,Matches,9.0,no NOR,DF,24.0,9.0,9.0,763.0,8.5,0.0,0.0,0.0,0.0,0.0,0.0,0.0,0.0,0.0,0.0,0.0,0.1,10.0,31.0,12.0,0.0,0.0,0.0,0.0,0.0,0.0,0.0,0.01,0.0,0.01,Matches,Kristoffer Ajer,D/DM C,24,141,151,Norway,Brentford,6,8,12,11,12,7,15,10,10,14,13,11,14,13,16,14,15,14,13,14,12,18,7,15,11,13,16,15,13,11,13,16,15,14,13,14,16,10,14,4,15,2,1,1,3,1,3,3,2,1,2,2,16,16,8,15,16,16,14,13,1,1,20,14,1,1,18,1,15,1,1,1,1,1,196,92,9,20,37377754,7050,7050,6000,Northern_European,140,4,1998/4/17,26,0,52196.0,,53110135
161,Marc Albrighton,Leicester City,1989,12.0,eng ENG,FWMF,32.0,2.6,4.0,1.0,0.0,2.0,2.0,1.0,8.0,12.5,7.0,6.0,2.0,4.0,1.0,5.0,5.0,0.0,Matches,12.0,eng ENG,FWMF,32.0,2.6,7.0,2.66,5.0,2.0,0.0,0.0,0.0,0.0,0.0,0.0,0.0,0.0,0.0,0.0,0.0,0.0,Matches,,,,,,,,,,,,,,,,,,,,,,,,,,,,,,,,,,,,,,,,,,,,,,,,,,,,,,,,12.0,eng ENG,FWMF,32.0,2.6,0.0,0.0,0.0,2.0,2.0,1.0,28.0,1.0,1.0,0.0,0.0,0.0,13.0,1.0,1.0,50.0,Matches,12.0,eng ENG,FWMF,32.0,2.6,148.0,130.0,17.0,1.0,1.0,0.0,28.0,7.0,7.0,1.0,3.0,2.0,89.0,1.0,10.0,Matches,12.0,eng ENG,FWMF,32.0,2.6,89.0,148.0,60.1,1440.0,551.0,48.0,60.0,80.0,23.0,34.0,67.6,12.0,34.0,35.3,0.0,0.9,0.4,-0.9,6.0,6.0,5.0,2.0,7.0,Matches,16,eng ENG,FWMF,32,6,237.0,40.0,6.9,2.6,1,67.0,0,5,34.0,13,1.67,4.0,3.0,1.0,0.38,0.89,4.9,4.3,0.6,0.24,0.62,Matches,12.0,eng ENG,FWMF,32.0,2.6,173.0,6.0,33.0,61.0,79.0,5.0,173.0,2.0,2.0,100.0,0.0,0.0,83.0,391.0,147.0,4.0,4.0,0.0,4.0,2.0,116.0,18.0,Matches,12.0,eng ENG,FWMF,32.0,2.6,1.0,2.0,1.0,50.0,0.76,0.38,0.5,1.0,8.0,0.0,0.0,0.0,0.3,0.3,0.17,0.7,0.7,Matches,12.0,eng ENG,FWMF,32.0,6.0,1.0,237.0,2.6,1.0,0.0,1.0,1.0,0.0,0.0,0.0,0.0,0.3,0.3,0.9,1.3,4.0,7.0,18.0,0.38,0.0,0.38,0.38,0.38,0.13,0.34,0.48,0.13,0.48,Matches,Marc Albrighton,WB/M/AM RL,32,139,142,England,Leicester City,15,17,13,12,14,12,5,10,7,8,14,10,12,13,14,12,14,12,16,14,10,14,12,13,13,14,17,18,12,12,11,6,15,12,16,9,14,10,13,5,14,4,1,2,3,1,1,3,3,1,1,3,12,12,3,16,10,16,16,17,1,10,1,13,16,18,1,16,10,16,16,4,20,5,175,74,8,20,21643701,6950,6950,5500,Northern_European,130,1,1989/11/18,0,0,75395.0,,29010506
162,Dele Alli,Everton,1996,17.0,eng ENG,MF,26.0,0.4,0.0,0.0,0.0,0.0,0.0,0.0,0.0,,0.0,0.0,0.0,0.0,0.0,0.0,0.0,0.0,Matches,17.0,eng ENG,MF,26.0,0.4,0.0,0.0,0.0,0.0,0.0,0.0,0.0,0.0,0.0,0.0,0.0,0.0,0.0,0.0,0.0,0.0,Matches,,,,,,,,,,,,,,,,,,,,,,,,,,,,,,,,,,,,,,,,,,,,,,,,,,,,,,,,17.0,eng ENG,MF,26.0,0.4,0.0,0.0,0.0,0.0,1.0,0.0,0.0,0.0,0.0,0.0,0.0,0.0,2.0,1.0,2.0,33.3,Matches,17.0,eng ENG,MF,26.0,0.4,15.0,13.0,2.0,1.0,0.0,0.0,0.0,0.0,0.0,0.0,0.0,0.0,12.0,0.0,0.0,Matches,17.0,eng ENG,MF,26.0,0.4,12.0,15.0,80.0,123.0,10.0,6.0,8.0,75.0,4.0,5.0,80.0,0.0,0.0,,0.0,0.0,0.0,0.0,0.0,2.0,0.0,0.0,1.0,Matches,23,eng ENG,MF,26,2,40.0,20.0,1.2,0.4,0,,0,2,20.0,1,0.0,1.0,1.0,0.0,0.0,0.61,1.0,1.7,-0.7,-1.57,-1.05,Matches,17.0,eng ENG,MF,26.0,0.4,20.0,0.0,1.0,8.0,11.0,2.0,20.0,1.0,0.0,0.0,1.0,100.0,11.0,30.0,3.0,0.0,0.0,0.0,3.0,1.0,14.0,1.0,Matches,17.0,eng ENG,MF,26.0,0.4,0.0,0.0,0.0,,0.0,0.0,,,,0.0,0.0,0.0,0.0,0.0,,0.0,0.0,Matches,17.0,eng ENG,MF,26.0,2.0,0.0,40.0,0.4,0.0,0.0,0.0,0.0,0.0,0.0,0.0,0.0,0.0,0.0,0.0,0.0,0.0,1.0,1.0,0.0,0.0,0.0,0.0,0.0,0.0,0.0,0.0,0.0,0.0,Matches,Dele Alli,AM LC,26,139,160,"England,Nigeria",Everton,8,12,14,15,14,10,12,13,8,10,14,14,11,15,14,15,12,15,11,14,12,12,17,7,13,11,13,12,11,13,13,12,18,12,16,12,13,14,13,4,16,2,3,1,3,2,3,2,2,3,2,2,11,14,7,14,12,14,6,9,1,1,1,1,1,1,10,8,15,11,17,20,12,15,188,80,12,20,56140000,7100,7000,7000,Mixed_Race,136,12,1996/4/11,37,3,115992.0,Beşiktaş A.Ş.,29085579
163,Elliot Anderson,Newcastle Utd,2002,23.0,sct SCO,MFFW,19.0,4.6,11.0,5.0,5.0,3.0,3.0,6.0,12.0,50.0,6.0,11.0,2.0,9.0,6.0,17.0,2.0,0.0,Matches,23.0,sct SCO,MFFW,19.0,4.6,22.0,4.83,16.0,0.0,2.0,0.0,4.0,0.0,1.0,0.22,1.0,0.0,0.0,0.0,0.0,0.0,Matches,,,,,,,,,,,,,,,,,,,,,,,,,,,,,,,,,,,,,,,,,,,,,,,,,,,,,,,,23.0,sct SCO,MFFW,19.0,4.6,0.0,0.0,0.0,6.0,10.0,1.0,9.0,6.0,5.0,0.0,0.0,0.0,29.0,11.0,5.0,68.8,Matches,23.0,sct SCO,MFFW,19.0,4.6,198.0,193.0,3.0,0.0,1.0,0.0,9.0,2.0,1.0,0.0,0.0,0.0,150.0,2.0,10.0,Matches,23.0,sct SCO,MFFW,19.0,4.6,150.0,198.0,75.8,2043.0,599.0,90.0,104.0,86.5,44.0,56.0,78.6,5.0,10.0,50.0,1.0,1.3,1.5,-0.3,9.0,15.0,4.0,0.0,24.0,Matches,32,sct SCO,MFFW,19,22,410.0,19.0,12.0,4.6,3,58.0,0,19,12.0,12,1.82,8.0,7.0,1.0,0.22,-0.8,11.7,5.5,6.2,1.37,0.59,Matches,23.0,sct SCO,MFFW,19.0,4.6,286.0,7.0,44.0,99.0,151.0,39.0,286.0,29.0,10.0,34.5,13.0,44.8,160.0,970.0,522.0,23.0,15.0,12.0,9.0,10.0,182.0,35.0,Matches,23.0,sct SCO,MFFW,19.0,4.6,0.0,11.0,4.0,36.4,2.41,0.88,0.0,0.0,16.0,0.0,0.0,0.0,1.0,1.0,0.09,-1.0,-1.0,Matches,23.0,sct SCO,MFFW,19.0,22.0,3.0,410.0,4.6,0.0,1.0,1.0,0.0,0.0,0.0,0.0,0.0,1.0,1.0,1.3,2.3,23.0,24.0,35.0,0.0,0.22,0.22,0.0,0.22,0.22,0.28,0.5,0.22,0.5,Matches,Elliot Anderson,M/AM RLC,19,123,-85,"Scotland,England",Newcastle United,10,11,13,12,13,12,9,12,3,8,12,11,10,12,14,12,14,13,11,12,12,5,13,8,11,12,14,15,12,12,13,8,11,12,13,12,11,11,10,10,11,2,1,4,2,2,1,4,3,1,4,3,13,13,4,10,10,13,10,10,1,1,1,1,1,1,8,1,18,1,18,20,15,1,179,0,15,20,72541231,6150,6150,4260,Northern_European,123,0,2002/11/6,0,0,11599.0,,28127254
164,Cameron Archer,Aston Villa,2001,27.0,eng ENG,FWMF,21.0,0.5,0.0,0.0,0.0,0.0,0.0,0.0,0.0,,0.0,0.0,0.0,0.0,0.0,0.0,0.0,0.0,Matches,27.0,eng ENG,FWMF,21.0,0.5,0.0,0.0,0.0,0.0,0.0,0.0,0.0,0.0,0.0,0.0,0.0,0.0,0.0,0.0,0.0,0.0,Matches,,,,,,,,,,,,,,,,,,,,,,,,,,,,,,,,,,,,,,,,,,,,,,,,,,,,,,,,27.0,eng ENG,FWMF,21.0,0.5,0.0,0.0,0.0,2.0,1.0,1.0,1.0,0.0,0.0,0.0,0.0,0.0,2.0,0.0,0.0,,Matches,27.0,eng ENG,FWMF,21.0,0.5,12.0,11.0,1.0,1.0,0.0,0.0,1.0,0.0,0.0,0.0,0.0,0.0,8.0,0.0,1.0,Matches,27.0,eng ENG,FWMF,21.0,0.5,8.0,12.0,66.7,108.0,44.0,5.0,5.0,100.0,3.0,5.0,60.0,0.0,0.0,,0.0,0.0,0.0,0.0,0.0,2.0,0.0,0.0,0.0,Matches,36,eng ENG,FWMF,21,6,49.0,8.0,1.4,0.5,0,,0,6,8.0,8,1.17,0.0,1.0,-1.0,-1.84,-2.0,0.2,0.4,-0.1,-0.25,-0.19,Matches,27.0,eng ENG,FWMF,21.0,0.5,15.0,0.0,1.0,8.0,7.0,3.0,15.0,1.0,1.0,100.0,0.0,0.0,15.0,114.0,72.0,3.0,1.0,1.0,2.0,3.0,13.0,3.0,Matches,27.0,eng ENG,FWMF,21.0,0.5,0.0,0.0,0.0,,0.0,0.0,,,,0.0,0.0,0.0,0.0,0.0,,0.0,0.0,Matches,27.0,eng ENG,FWMF,21.0,6.0,0.0,49.0,0.5,0.0,0.0,0.0,0.0,0.0,0.0,0.0,0.0,0.0,0.0,0.0,0.0,3.0,0.0,3.0,0.0,0.0,0.0,0.0,0.0,0.0,0.0,0.0,0.0,0.0,Matches,Cameron Archer,S,20,118,-75,"England,Jamaica",Aston Villa,4,7,11,15,12,7,11,9,3,4,8,10,4,12,9,10,10,14,11,10,11,16,13,8,14,11,10,14,15,13,10,11,13,14,12,12,10,7,9,8,9,2,2,3,3,1,2,1,1,1,3,2,12,12,4,12,10,12,11,13,1,1,1,1,1,1,1,1,1,1,1,1,1,20,171,71,10,20,65883306,5900,5900,3500,African_Caribbean,115,14,2001/12/9,0,0,11599.0,,29219088
165,Alphonse Areola,West Ham,1993,28.0,fr FRA,GK,29.0,3.4,0.0,0.0,0.0,0.0,0.0,0.0,0.0,,0.0,0.0,0.0,0.0,0.0,0.0,0.0,0.0,Matches,28.0,fr FRA,GK,29.0,3.4,0.0,0.0,0.0,0.0,0.0,0.0,0.0,0.0,0.0,0.0,0.0,0.0,0.0,0.0,0.0,0.0,Matches,2.0,fr FRA,GK,29.0,3.4,7.0,2.0,0.0,1.0,0.0,7.3,0.33,0.3,0.09,14.0,37.0,37.8,61.0,14.0,39.3,33.4,30.0,43.3,33.0,47.0,2.0,4.3,1.0,0.29,10.3,Matches,2.0,fr FRA,GK,29.0,5.0,2.0,309.0,3.4,7.0,2.04,16.0,9.0,68.8,0.0,1.0,1.0,1.0,50.0,2.0,2.0,0.0,0.0,0.0,Matches,28.0,fr FRA,GK,29.0,3.4,0.0,0.0,0.0,1.0,0.0,0.0,0.0,0.0,0.0,0.0,1.0,0.0,1.0,0.0,0.0,,Matches,28.0,fr FRA,GK,29.0,3.4,92.0,59.0,32.0,2.0,0.0,0.0,0.0,0.0,0.0,0.0,0.0,0.0,67.0,1.0,0.0,Matches,28.0,fr FRA,GK,29.0,3.4,67.0,92.0,72.8,1737.0,1323.0,25.0,25.0,100.0,22.0,22.0,100.0,19.0,43.0,44.2,0.0,0.0,0.0,0.0,0.0,0.0,0.0,0.0,0.0,Matches,37,fr FRA,GK,29,5,309.0,62.0,9.0,3.4,2,90.0,2,3,43.0,30,0.8,5.0,7.0,-2.0,-0.58,-0.26,5.3,7.5,-2.2,-0.64,-0.59,Matches,28.0,fr FRA,GK,29.0,3.4,98.0,91.0,98.0,0.0,0.0,0.0,98.0,0.0,0.0,,0.0,,53.0,253.0,153.0,0.0,0.0,0.0,0.0,0.0,42.0,0.0,Matches,28.0,fr FRA,GK,29.0,3.4,0.0,0.0,0.0,,0.0,0.0,,,,0.0,0.0,0.0,0.0,0.0,,0.0,0.0,Matches,28.0,fr FRA,GK,29.0,5.0,2.0,309.0,3.4,0.0,0.0,0.0,0.0,0.0,0.0,0.0,0.0,0.0,0.0,0.0,0.0,0.0,0.0,0.0,0.0,0.0,0.0,0.0,0.0,0.0,0.0,0.0,0.0,0.0,Matches,Alphonse Areola,GK,29,143,154,"France,Philippines",West Ham United,2,3,2,1,10,4,1,12,2,1,10,5,3,10,8,14,13,15,14,9,12,14,8,10,8,14,15,13,12,14,17,15,15,12,15,14,14,8,12,7,1,14,12,13,8,14,14,14,15,12,12,13,11,15,5,15,12,16,17,17,20,1,1,1,1,1,1,1,1,1,1,1,1,1,195,94,8,20,30033738,7144,7144,6244,African_Caribbean,141,12,1993/2/27,3,0,139190.0,,85027976
166,Pierre-Emerick Aubameyang,Chelsea,1989,33.0,ga GAB,FW,33.0,6.2,1.0,0.0,1.0,0.0,0.0,0.0,1.0,0.0,1.0,2.0,0.0,2.0,2.0,3.0,4.0,2.0,Matches,33.0,ga GAB,FW,33.0,6.2,8.0,1.3,6.0,0.0,0.0,2.0,0.0,0.0,0.0,0.0,0.0,0.0,0.0,0.0,0.0,0.0,Matches,,,,,,,,,,,,,,,,,,,,,,,,,,,,,,,,,,,,,,,,,,,,,,,,,,,,,,,,33.0,ga GAB,FW,33.0,6.2,1.0,0.0,0.0,5.0,1.0,0.0,3.0,2.0,0.0,0.0,0.0,0.0,11.0,3.0,11.0,21.4,Matches,33.0,ga GAB,FW,33.0,6.2,111.0,101.0,10.0,0.0,0.0,0.0,3.0,0.0,0.0,0.0,0.0,0.0,82.0,0.0,5.0,Matches,33.0,ga GAB,FW,33.0,6.2,82.0,111.0,73.9,1053.0,203.0,56.0,70.0,80.0,22.0,26.0,84.6,2.0,4.0,50.0,0.0,0.4,0.2,-0.4,4.0,2.0,2.0,1.0,3.0,Matches,44,ga GAB,FW,33,15,554.0,37.0,16.2,6.2,5,62.0,0,10,24.0,5,1.07,3.0,8.0,-5.0,-0.81,-0.69,6.0,8.5,-2.5,-0.41,-0.39,Matches,33.0,ga GAB,FW,33.0,6.2,161.0,7.0,16.0,69.0,79.0,23.0,161.0,5.0,3.0,60.0,2.0,40.0,86.0,529.0,259.0,9.0,6.0,4.0,11.0,4.0,116.0,29.0,Matches,33.0,ga GAB,FW,33.0,6.2,1.0,16.0,7.0,43.8,2.6,1.14,0.06,0.14,13.7,0.0,0.0,0.0,1.5,1.5,0.09,-0.5,-0.5,Matches,33.0,ga GAB,FW,33.0,15.0,5.0,554.0,6.2,1.0,0.0,1.0,1.0,0.0,0.0,1.0,0.0,1.5,1.5,0.4,1.9,9.0,3.0,29.0,0.16,0.0,0.16,0.16,0.16,0.24,0.07,0.3,0.24,0.3,Matches,Pierre-Emerick Aubameyang,AM/S RL,33,147,170,"Gabon,France",Chelsea,5,10,14,15,14,11,12,14,2,5,12,15,6,14,12,15,12,14,12,13,13,10,17,13,17,8,12,11,15,14,15,14,13,15,14,12,12,8,13,8,14,2,2,3,1,1,1,2,1,1,2,3,15,14,14,11,9,9,14,16,1,1,1,1,1,1,1,10,1,12,19,1,15,20,187,80,10,20,16382481,7500,8000,7500,Mixed_Race,145,13,1989/6/18,73,30,197186.0,,43017197
167,Ludwig Augustinsson,Aston Villa,1994,34.0,se SWE,DF,28.0,0.9,1.0,1.0,1.0,0.0,0.0,0.0,0.0,,0.0,0.0,0.0,0.0,0.0,1.0,1.0,0.0,Matches,34.0,se SWE,DF,28.0,0.9,0.0,0.0,0.0,0.0,0.0,0.0,0.0,0.0,0.0,0.0,0.0,0.0,0.0,0.0,0.0,0.0,Matches,,,,,,,,,,,,,,,,,,,,,,,,,,,,,,,,,,,,,,,,,,,,,,,,,,,,,,,,34.0,se SWE,DF,28.0,0.9,1.0,0.0,0.0,1.0,3.0,0.0,5.0,0.0,1.0,0.0,0.0,0.0,9.0,4.0,1.0,80.0,Matches,34.0,se SWE,DF,28.0,0.9,43.0,34.0,9.0,1.0,0.0,0.0,5.0,8.0,0.0,0.0,0.0,0.0,26.0,0.0,0.0,Matches,34.0,se SWE,DF,28.0,0.9,26.0,43.0,60.5,421.0,176.0,13.0,16.0,81.3,10.0,16.0,62.5,2.0,8.0,25.0,0.0,0.0,0.0,0.0,0.0,0.0,0.0,0.0,0.0,Matches,45,se SWE,DF,28,3,77.0,26.0,2.3,0.9,1,44.0,0,2,17.0,9,1.67,1.0,0.0,1.0,1.17,1.06,2.5,0.8,1.6,1.92,2.02,Matches,34.0,se SWE,DF,28.0,0.9,51.0,3.0,19.0,15.0,17.0,2.0,51.0,1.0,0.0,0.0,1.0,100.0,29.0,180.0,27.0,0.0,2.0,0.0,0.0,0.0,21.0,3.0,Matches,34.0,se SWE,DF,28.0,0.9,0.0,2.0,1.0,50.0,2.34,1.17,0.0,0.0,12.7,0.0,0.0,0.0,0.1,0.1,0.04,-0.1,-0.1,Matches,34.0,se SWE,DF,28.0,3.0,1.0,77.0,0.9,0.0,0.0,0.0,0.0,0.0,0.0,1.0,0.0,0.1,0.1,0.0,0.1,0.0,0.0,3.0,0.0,0.0,0.0,0.0,0.0,0.1,0.0,0.1,0.1,0.1,Matches,Ludwig Augustinsson,D/WB L,28,134,141,Sweden,Sevilla,15,16,10,8,12,14,8,12,10,12,13,10,14,13,10,14,10,15,14,12,15,15,8,8,12,13,15,14,13,12,12,10,16,13,14,12,16,6,16,5,6,2,2,2,2,1,2,1,3,2,2,3,12,16,3,13,13,18,14,16,1,20,1,1,20,1,1,13,1,1,13,1,1,1,181,74,20,8,8746776,6700,6700,5750,Northern_European,132,4,1994/4/21,46,2,16706.0,Aston Villa,93024775
168,Yasin Ayari,Brighton,2003,37.0,se SWE,MF,18.0,0.7,2.0,2.0,1.0,1.0,0.0,0.0,4.0,0.0,4.0,1.0,0.0,1.0,0.0,2.0,0.0,0.0,Matches,37.0,se SWE,MF,18.0,0.7,4.0,5.37,3.0,0.0,0.0,0.0,1.0,0.0,0.0,0.0,0.0,0.0,0.0,0.0,0.0,0.0,Matches,,,,,,,,,,,,,,,,,,,,,,,,,,,,,,,,,,,,,,,,,,,,,,,,,,,,,,,,37.0,se SWE,MF,18.0,0.7,0.0,0.0,0.0,0.0,3.0,0.0,0.0,0.0,2.0,0.0,0.0,0.0,3.0,0.0,1.0,0.0,Matches,37.0,se SWE,MF,18.0,0.7,23.0,22.0,0.0,0.0,1.0,0.0,0.0,0.0,0.0,0.0,0.0,0.0,20.0,1.0,0.0,Matches,37.0,se SWE,MF,18.0,0.7,20.0,23.0,87.0,386.0,133.0,10.0,12.0,83.3,6.0,6.0,100.0,4.0,4.0,100.0,0.0,0.1,0.3,-0.1,2.0,4.0,1.0,0.0,2.0,Matches,49,se SWE,MF,18,3,67.0,22.0,2.0,0.7,1,45.0,0,2,11.0,12,2.0,2.0,2.0,0.0,0.0,-0.51,2.7,1.5,1.3,1.72,1.13,Matches,37.0,se SWE,MF,18.0,0.7,30.0,0.0,5.0,18.0,8.0,1.0,30.0,1.0,0.0,0.0,0.0,0.0,19.0,76.0,44.0,0.0,0.0,0.0,2.0,0.0,25.0,2.0,Matches,37.0,se SWE,MF,18.0,0.7,0.0,1.0,0.0,0.0,1.34,0.0,0.0,,29.7,0.0,0.0,0.0,0.0,0.0,0.02,0.0,0.0,Matches,37.0,se SWE,MF,18.0,3.0,1.0,67.0,0.7,0.0,0.0,0.0,0.0,0.0,0.0,0.0,0.0,0.0,0.0,0.1,0.2,0.0,2.0,2.0,0.0,0.0,0.0,0.0,0.0,0.03,0.18,0.21,0.03,0.21,Matches,Yasin Ayari,M/AM RLC,18,111,-75,"Sweden,Tunisia",AIK,8,10,12,9,13,9,8,11,5,9,12,8,13,13,11,13,12,11,11,12,11,13,11,7,13,11,11,11,13,13,10,7,11,12,12,10,13,7,12,5,13,2,2,1,1,1,3,3,3,3,4,1,14,12,7,14,12,12,12,12,1,7,1,10,10,12,12,15,20,15,15,18,15,7,172,0,10,20,1882430,5550,5550,1250,North_African__Middle_Eastern,107,8,2003/10/6,0,0,1118.0,,93142470
169,André Ayew,Nott'ham Forest,1989,38.0,gh GHA,FWMF,32.0,3.5,5.0,3.0,0.0,4.0,1.0,2.0,4.0,50.0,2.0,6.0,1.0,5.0,0.0,5.0,7.0,0.0,Matches,38.0,gh GHA,FWMF,32.0,3.5,3.0,0.86,2.0,1.0,0.0,0.0,0.0,0.0,0.0,0.0,0.0,0.0,0.0,0.0,0.0,0.0,Matches,,,,,,,,,,,,,,,,,,,,,,,,,,,,,,,,,,,,,,,,,,,,,,,,,,,,,,,,38.0,gh GHA,FWMF,32.0,3.5,1.0,0.0,0.0,3.0,8.0,1.0,1.0,0.0,3.0,0.0,0.0,0.0,9.0,14.0,22.0,38.9,Matches,38.0,gh GHA,FWMF,32.0,3.5,73.0,68.0,5.0,0.0,0.0,0.0,1.0,0.0,1.0,0.0,0.0,0.0,53.0,0.0,0.0,Matches,38.0,gh GHA,FWMF,32.0,3.5,53.0,73.0,72.6,686.0,146.0,38.0,46.0,82.6,13.0,21.0,61.9,0.0,1.0,0.0,0.0,0.0,0.0,0.0,1.0,3.0,1.0,0.0,11.0,Matches,50,gh GHA,FWMF,32,13,316.0,24.0,9.2,3.5,1,78.0,0,12,20.0,5,0.69,5.0,10.0,-5.0,-1.42,-0.7,4.7,7.2,-2.6,-0.73,-0.09,Matches,38.0,gh GHA,FWMF,32.0,3.5,106.0,11.0,15.0,49.0,42.0,8.0,105.0,6.0,1.0,16.7,4.0,66.7,40.0,271.0,102.0,3.0,3.0,2.0,3.0,4.0,62.0,16.0,Matches,38.0,gh GHA,FWMF,32.0,3.5,0.0,3.0,1.0,33.3,0.85,0.28,0.0,0.0,19.3,0.0,0.0,1.0,1.0,0.3,0.09,-1.0,-0.3,Matches,38.0,gh GHA,FWMF,32.0,13.0,1.0,316.0,3.5,0.0,0.0,0.0,0.0,0.0,1.0,1.0,0.0,1.0,0.3,0.0,0.3,3.0,11.0,16.0,0.0,0.0,0.0,0.0,0.0,0.3,0.01,0.31,0.07,0.08,Matches,André Ayew,AM/S RL,32,128,140,"Ghana,France",Al-Sadd Sports Club,9,10,16,15,15,11,15,12,5,6,9,14,7,14,13,15,17,16,14,8,10,15,15,18,12,7,11,14,12,14,16,10,15,11,15,13,13,13,15,7,15,3,1,2,1,2,3,2,1,2,2,3,17,16,12,8,15,15,4,5,1,1,1,1,1,1,1,10,1,12,16,12,20,19,175,72,20,5,4784259,6250,7000,4350,African_Caribbean,123,13,1989/12/17,107,23,48315.0,,8442448
170,Shandon Baptiste,Brentford,1998,47.0,gd GRN,MF,24.0,6.9,15.0,9.0,6.0,6.0,3.0,7.0,17.0,41.2,10.0,10.0,2.0,8.0,7.0,22.0,10.0,0.0,Matches,47.0,gd GRN,MF,24.0,6.9,18.0,2.63,11.0,1.0,2.0,2.0,2.0,0.0,4.0,0.58,3.0,0.0,0.0,0.0,1.0,0.0,Matches,,,,,,,,,,,,,,,,,,,,,,,,,,,,,,,,,,,,,,,,,,,,,,,,,,,,,,,,47.0,gd GRN,MF,24.0,6.9,3.0,1.0,1.0,11.0,12.0,1.0,11.0,7.0,9.0,0.0,0.0,0.0,45.0,6.0,7.0,46.2,Matches,47.0,gd GRN,MF,24.0,6.9,295.0,287.0,6.0,1.0,2.0,0.0,11.0,3.0,2.0,2.0,0.0,0.0,247.0,2.0,7.0,Matches,47.0,gd GRN,MF,24.0,6.9,247.0,295.0,83.7,4143.0,1121.0,127.0,142.0,89.4,92.0,104.0,88.5,21.0,32.0,65.6,1.0,1.1,0.5,-0.1,10.0,22.0,8.0,2.0,39.0,Matches,62,gd GRN,MF,24,23,618.0,27.0,18.1,6.9,4,68.0,0,19,18.0,5,1.35,12.0,6.0,6.0,0.87,0.68,9.8,8.1,1.7,0.25,0.09,Matches,47.0,gd GRN,MF,24.0,6.9,373.0,12.0,87.0,196.0,97.0,7.0,373.0,13.0,6.0,46.2,3.0,23.1,240.0,1097.0,507.0,8.0,12.0,3.0,16.0,8.0,247.0,23.0,Matches,47.0,gd GRN,MF,24.0,6.9,0.0,4.0,1.0,25.0,0.58,0.15,0.0,0.0,15.9,0.0,0.0,0.0,0.4,0.4,0.09,-0.4,-0.4,Matches,47.0,gd GRN,MF,24.0,23.0,4.0,618.0,6.9,0.0,1.0,1.0,0.0,0.0,0.0,3.0,1.0,0.4,0.4,1.1,1.4,8.0,39.0,23.0,0.0,0.15,0.15,0.0,0.15,0.05,0.16,0.21,0.05,0.21,Matches,Shandon Baptiste,M/AM C,24,127,148,"Grenada,England",Brentford,8,9,13,11,14,9,11,11,5,9,13,10,11,13,12,13,13,14,12,14,12,15,12,12,14,12,13,13,13,13,14,9,14,13,14,12,14,9,12,10,12,1,2,2,3,2,3,2,2,4,4,3,13,14,6,10,14,15,12,12,1,1,1,1,1,1,15,1,20,1,1,17,1,1,175,0,10,20,9437331,6350,6350,4750,African_Caribbean,126,17,1998/4/8,3,1,32478.0,,29158694
171,Mads Bech Sørensen,Brentford,1999,50.0,dk DEN,DFMF,23.0,0.2,0.0,0.0,0.0,0.0,0.0,0.0,0.0,,0.0,0.0,0.0,0.0,1.0,1.0,1.0,0.0,Matches,50.0,dk DEN,DFMF,23.0,0.2,1.0,4.29,1.0,0.0,0.0,0.0,0.0,0.0,0.0,0.0,0.0,0.0,0.0,0.0,0.0,0.0,Matches,,,,,,,,,,,,,,,,,,,,,,,,,,,,,,,,,,,,,,,,,,,,,,,,,,,,,,,,50.0,dk DEN,DFMF,23.0,0.2,0.0,0.0,0.0,0.0,0.0,0.0,0.0,1.0,0.0,0.0,0.0,0.0,0.0,1.0,0.0,100.0,Matches,50.0,dk DEN,DFMF,23.0,0.2,11.0,7.0,4.0,0.0,0.0,0.0,0.0,4.0,0.0,0.0,0.0,0.0,7.0,0.0,0.0,Matches,50.0,dk DEN,DFMF,23.0,0.2,7.0,11.0,63.6,142.0,49.0,3.0,3.0,100.0,3.0,4.0,75.0,1.0,4.0,25.0,0.0,0.0,0.0,0.0,0.0,2.0,0.0,0.0,1.0,Matches,65,dk DEN,DFMF,23,4,21.0,5.0,0.6,0.2,0,,0,4,5.0,3,2.0,1.0,0.0,1.0,4.29,3.99,0.3,0.3,0.0,0.15,-0.02,Matches,50.0,dk DEN,DFMF,23.0,0.2,14.0,1.0,4.0,8.0,2.0,0.0,14.0,0.0,0.0,,0.0,,2.0,3.0,0.0,0.0,0.0,0.0,0.0,0.0,5.0,0.0,Matches,50.0,dk DEN,DFMF,23.0,0.2,0.0,0.0,0.0,,0.0,0.0,,,,0.0,0.0,0.0,0.0,0.0,,0.0,0.0,Matches,50.0,dk DEN,DFMF,23.0,4.0,0.0,21.0,0.2,0.0,0.0,0.0,0.0,0.0,0.0,0.0,0.0,0.0,0.0,0.0,0.0,0.0,1.0,0.0,0.0,0.0,0.0,0.0,0.0,0.0,0.0,0.0,0.0,0.0,Matches,Mads Bech Sørensen,D LC,23,130,145,Denmark,Brentford,6,8,10,7,12,7,13,8,19,13,13,6,14,12,14,13,13,14,14,12,13,14,9,12,7,14,13,14,11,11,13,16,15,11,14,14,13,7,12,5,14,2,1,3,2,2,3,1,3,4,1,1,13,14,8,16,13,14,14,13,1,15,20,1,8,1,10,1,1,1,1,1,1,1,193,0,20,8,11602489,6499,6249,4999,Northern_European,129,1,1999/1/7,0,0,34798.0,OGC Nice,27114700
172,Jan Bednarek,Aston Villa,1996,52.0,pl POL,DF,26.0,1.1,3.0,3.0,0.0,3.0,0.0,1.0,1.0,100.0,0.0,3.0,1.0,2.0,2.0,5.0,5.0,0.0,Matches,52.0,pl POL,DF,26.0,1.1,0.0,0.0,0.0,0.0,0.0,0.0,0.0,0.0,0.0,0.0,0.0,0.0,0.0,0.0,0.0,0.0,Matches,,,,,,,,,,,,,,,,,,,,,,,,,,,,,,,,,,,,,,,,,,,,,,,,,,,,,,,,52.0,pl POL,DF,26.0,1.1,0.0,0.0,0.0,1.0,1.0,0.0,0.0,2.0,3.0,0.0,0.0,0.0,4.0,0.0,0.0,,Matches,52.0,pl POL,DF,26.0,1.1,66.0,64.0,2.0,2.0,0.0,0.0,0.0,0.0,0.0,0.0,0.0,0.0,60.0,0.0,1.0,Matches,52.0,pl POL,DF,26.0,1.1,60.0,66.0,90.9,1249.0,418.0,16.0,17.0,94.1,33.0,35.0,94.3,10.0,12.0,83.3,0.0,0.0,0.0,0.0,0.0,4.0,0.0,0.0,5.0,Matches,67,pl POL,DF,26,3,100.0,33.0,2.9,1.1,1,45.0,0,2,28.0,10,1.33,0.0,1.0,-1.0,-0.9,-1.06,2.5,1.1,1.3,1.19,1.28,Matches,52.0,pl POL,DF,26.0,1.1,79.0,9.0,39.0,40.0,1.0,0.0,79.0,0.0,0.0,,0.0,,47.0,291.0,177.0,1.0,0.0,0.0,0.0,0.0,53.0,0.0,Matches,52.0,pl POL,DF,26.0,1.1,0.0,0.0,0.0,,0.0,0.0,,,,0.0,0.0,0.0,0.0,0.0,,0.0,0.0,Matches,52.0,pl POL,DF,26.0,3.0,1.0,100.0,1.1,0.0,0.0,0.0,0.0,0.0,0.0,0.0,0.0,0.0,0.0,0.0,0.0,1.0,5.0,0.0,0.0,0.0,0.0,0.0,0.0,0.0,0.0,0.0,0.0,0.0,Matches,Jan Bednarek,D C,26,140,145,Poland,Southampton,2,7,9,7,11,3,14,5,5,15,12,5,14,13,12,14,17,13,14,9,14,13,8,13,5,14,14,15,13,12,13,14,17,13,17,15,13,5,13,9,9,2,3,2,3,2,2,1,3,4,3,3,12,13,4,14,13,12,12,10,1,1,20,13,1,1,13,1,1,1,1,1,1,1,189,77,11,20,35991161,6995,6264,5654,Northern_European,140,4,1996/4/12,42,1,69595.0,Aston Villa,96047750
173,Donny van de Beek,Manchester Utd,1997,53.0,nl NED,MF,25.0,1.9,0.0,0.0,0.0,0.0,0.0,0.0,1.0,0.0,1.0,2.0,1.0,1.0,1.0,1.0,1.0,0.0,Matches,53.0,nl NED,MF,25.0,1.9,6.0,3.23,6.0,0.0,0.0,0.0,0.0,0.0,0.0,0.0,0.0,0.0,0.0,0.0,0.0,0.0,Matches,,,,,,,,,,,,,,,,,,,,,,,,,,,,,,,,,,,,,,,,,,,,,,,,,,,,,,,,53.0,nl NED,MF,25.0,1.9,0.0,0.0,0.0,4.0,2.0,1.0,0.0,1.0,0.0,0.0,0.0,0.0,3.0,3.0,3.0,50.0,Matches,53.0,nl NED,MF,25.0,1.9,61.0,56.0,3.0,0.0,0.0,0.0,0.0,0.0,1.0,0.0,0.0,0.0,46.0,2.0,4.0,Matches,53.0,nl NED,MF,25.0,1.9,46.0,61.0,75.4,502.0,115.0,31.0,34.0,91.2,8.0,8.0,100.0,1.0,2.0,50.0,0.0,0.1,0.1,-0.1,3.0,0.0,4.0,0.0,6.0,Matches,68,nl NED,MF,25,7,167.0,24.0,4.9,1.9,2,55.0,0,5,12.0,4,1.71,3.0,3.0,0.0,0.0,-0.42,2.4,1.5,0.9,0.46,0.0,Matches,53.0,nl NED,MF,25.0,1.9,72.0,1.0,3.0,23.0,46.0,11.0,72.0,3.0,2.0,66.7,1.0,33.3,39.0,148.0,85.0,2.0,3.0,0.0,2.0,2.0,53.0,20.0,Matches,53.0,nl NED,MF,25.0,1.9,0.0,2.0,0.0,0.0,1.08,0.0,0.0,,10.1,0.0,0.0,0.0,0.1,0.1,0.05,-0.1,-0.1,Matches,53.0,nl NED,MF,25.0,7.0,2.0,167.0,1.9,0.0,0.0,0.0,0.0,0.0,0.0,0.0,0.0,0.1,0.1,0.1,0.2,2.0,6.0,20.0,0.0,0.0,0.0,0.0,0.0,0.05,0.06,0.11,0.05,0.11,Matches,Donny van de Beek,M/AM C,25,142,160,Holland,Manchester UFC,13,13,13,14,15,13,11,13,8,10,15,11,11,15,10,13,12,14,14,15,12,15,13,13,15,9,16,17,11,14,13,13,15,12,15,10,12,6,11,3,15,3,3,3,3,3,1,2,1,2,1,3,8,14,4,14,13,15,15,11,1,1,1,1,1,1,14,1,19,1,1,20,1,1,184,67,12,20,33405620,7100,7300,6500,Northern_European,143,0,1997/4/18,19,3,162388.0,,37048153
174,Asmir Begović,Everton,1987,54.0,ba BIH,GK,35.0,1.0,0.0,0.0,0.0,0.0,0.0,0.0,0.0,,0.0,0.0,0.0,0.0,0.0,0.0,1.0,0.0,Matches,54.0,ba BIH,GK,35.0,1.0,0.0,0.0,0.0,0.0,0.0,0.0,0.0,0.0,0.0,0.0,0.0,0.0,0.0,0.0,0.0,0.0,Matches,5.0,ba BIH,GK,35.0,1.0,0.0,0.0,0.0,0.0,0.0,0.5,0.12,0.5,0.49,4.0,13.0,30.8,22.0,5.0,36.4,34.9,8.0,62.5,46.8,23.0,1.0,4.3,0.0,0.0,5.0,Matches,5.0,ba BIH,GK,35.0,1.0,1.0,90.0,1.0,0.0,0.0,4.0,4.0,100.0,1.0,0.0,0.0,1.0,100.0,0.0,0.0,0.0,0.0,,Matches,54.0,ba BIH,GK,35.0,1.0,0.0,0.0,0.0,0.0,0.0,0.0,0.0,0.0,0.0,0.0,0.0,0.0,0.0,1.0,0.0,100.0,Matches,54.0,ba BIH,GK,35.0,1.0,30.0,21.0,9.0,1.0,0.0,0.0,0.0,0.0,0.0,0.0,0.0,0.0,21.0,0.0,0.0,Matches,54.0,ba BIH,GK,35.0,1.0,21.0,30.0,70.0,584.0,423.0,3.0,3.0,100.0,10.0,10.0,100.0,8.0,17.0,47.1,0.0,0.0,0.0,0.0,0.0,0.0,0.0,0.0,0.0,Matches,69,ba BIH,GK,35,1,90.0,90.0,2.6,1.0,1,90.0,1,0,,37,3.0,1.0,0.0,1.0,1.0,1.65,0.4,1.0,-0.7,-0.67,-0.14,Matches,54.0,ba BIH,GK,35.0,1.0,33.0,31.0,33.0,0.0,0.0,0.0,33.0,0.0,0.0,,0.0,,19.0,75.0,47.0,0.0,0.0,0.0,0.0,0.0,13.0,0.0,Matches,54.0,ba BIH,GK,35.0,1.0,0.0,0.0,0.0,,0.0,0.0,,,,0.0,0.0,0.0,0.0,0.0,,0.0,0.0,Matches,54.0,ba BIH,GK,35.0,1.0,1.0,90.0,1.0,0.0,0.0,0.0,0.0,0.0,0.0,0.0,0.0,0.0,0.0,0.0,0.0,0.0,0.0,0.0,0.0,0.0,0.0,0.0,0.0,0.0,0.0,0.0,0.0,0.0,Matches,Asmir Begović,GK,35,131,150,"Bosnia and Herzegovina,Canada,England",Everton,1,3,5,1,8,1,6,3,8,1,13,7,6,8,11,14,13,11,13,5,12,17,7,11,2,15,12,13,7,15,10,15,16,9,12,14,14,8,13,4,1,15,15,15,12,14,13,13,14,15,8,11,16,13,10,11,14,16,12,8,20,1,1,1,1,1,1,1,1,1,1,1,1,1,199,101,7,20,4290625,6550,6000,5500,Mediterranean_Hispanic,133,4,1987/6/20,63,0,46397.0,,5123112
175,Giulian Biancone,Nott'ham Forest,2000,61.0,fr FRA,DF,22.0,0.2,2.0,1.0,2.0,0.0,0.0,1.0,1.0,100.0,0.0,0.0,0.0,0.0,1.0,3.0,0.0,0.0,Matches,61.0,fr FRA,DF,22.0,0.2,1.0,5.29,1.0,0.0,0.0,0.0,0.0,0.0,0.0,0.0,0.0,0.0,0.0,0.0,0.0,0.0,Matches,,,,,,,,,,,,,,,,,,,,,,,,,,,,,,,,,,,,,,,,,,,,,,,,,,,,,,,,61.0,fr FRA,DF,22.0,0.2,0.0,0.0,0.0,0.0,0.0,0.0,1.0,1.0,1.0,0.0,0.0,0.0,5.0,2.0,0.0,100.0,Matches,61.0,fr FRA,DF,22.0,0.2,21.0,19.0,2.0,0.0,0.0,0.0,1.0,2.0,0.0,0.0,0.0,0.0,15.0,0.0,0.0,Matches,61.0,fr FRA,DF,22.0,0.2,15.0,21.0,71.4,253.0,126.0,6.0,7.0,85.7,8.0,10.0,80.0,1.0,3.0,33.3,0.0,0.0,0.0,0.0,0.0,0.0,0.0,0.0,0.0,Matches,78,fr FRA,DF,22,2,17.0,9.0,0.5,0.2,0,,0,2,9.0,8,0.5,0.0,1.0,-1.0,-5.29,-4.53,0.3,0.5,-0.3,-1.38,-0.73,Matches,61.0,fr FRA,DF,22.0,0.2,25.0,2.0,19.0,5.0,1.0,0.0,25.0,0.0,0.0,,0.0,,10.0,76.0,61.0,2.0,1.0,0.0,0.0,0.0,13.0,1.0,Matches,61.0,fr FRA,DF,22.0,0.2,0.0,0.0,0.0,,0.0,0.0,,,,0.0,0.0,0.0,0.0,0.0,,0.0,0.0,Matches,61.0,fr FRA,DF,22.0,2.0,0.0,17.0,0.2,0.0,0.0,0.0,0.0,0.0,0.0,0.0,0.0,0.0,0.0,0.0,0.0,2.0,0.0,1.0,0.0,0.0,0.0,0.0,0.0,0.0,0.0,0.0,0.0,0.0,Matches,Giulian Biancone,D/DM RC,22,110,135,"France,Italy",Nottingham Forest,8,9,9,7,10,6,11,10,12,13,10,9,12,10,13,12,12,11,10,11,10,14,8,11,10,12,13,12,13,11,14,11,13,13,14,11,12,11,12,5,14,1,2,3,1,3,4,2,1,3,1,1,14,12,5,13,13,14,13,17,1,1,19,20,1,12,17,1,14,1,1,1,1,1,186,79,8,20,7609058,5493,5493,3243,Northern_European,104,4,2000/3/31,0,0,23198.0,,49045308
176,Willy Boly,Nott'ham Forest,1991,64.0,ci CIV,DF,31.0,7.6,13.0,6.0,8.0,3.0,2.0,8.0,13.0,61.5,5.0,13.0,4.0,9.0,12.0,25.0,45.0,0.0,Matches,64.0,ci CIV,DF,31.0,7.6,5.0,0.66,5.0,0.0,0.0,0.0,0.0,0.0,1.0,0.13,1.0,0.0,0.0,0.0,0.0,0.0,Matches,,,,,,,,,,,,,,,,,,,,,,,,,,,,,,,,,,,,,,,,,,,,,,,,,,,,,,,,64.0,ci CIV,DF,31.0,7.6,2.0,0.0,0.0,5.0,5.0,3.0,0.0,12.0,6.0,0.0,0.0,0.0,40.0,15.0,9.0,62.5,Matches,64.0,ci CIV,DF,31.0,7.6,258.0,254.0,4.0,3.0,0.0,0.0,0.0,1.0,0.0,0.0,0.0,0.0,194.0,0.0,3.0,Matches,64.0,ci CIV,DF,31.0,7.6,194.0,258.0,75.2,3706.0,1660.0,63.0,77.0,81.8,107.0,126.0,84.9,20.0,47.0,42.6,1.0,0.2,0.3,0.8,1.0,8.0,0.0,0.0,12.0,Matches,84,ci CIV,DF,31,11,685.0,62.0,20.0,7.6,9,74.0,5,2,11.0,9,1.64,6.0,10.0,-4.0,-0.53,0.33,6.8,10.2,-3.5,-0.46,0.25,Matches,64.0,ci CIV,DF,31.0,7.6,353.0,69.0,239.0,101.0,15.0,9.0,353.0,2.0,1.0,50.0,0.0,0.0,171.0,769.0,355.0,1.0,1.0,0.0,2.0,0.0,182.0,0.0,Matches,64.0,ci CIV,DF,31.0,7.6,0.0,2.0,1.0,50.0,0.26,0.13,0.0,0.0,16.7,0.0,0.0,0.0,0.0,0.0,0.02,0.0,0.0,Matches,64.0,ci CIV,DF,31.0,11.0,9.0,685.0,7.6,0.0,1.0,1.0,0.0,0.0,0.0,2.0,0.0,0.0,0.0,0.2,0.2,1.0,12.0,0.0,0.0,0.13,0.13,0.0,0.13,0.01,0.03,0.03,0.01,0.03,Matches,Willy Boly,D C,31,137,150,"Ivory Coast,France",Nottingham Forest,2,4,12,9,11,3,16,9,5,13,13,5,15,13,17,15,14,13,11,11,12,13,13,12,9,15,13,13,12,11,16,17,10,12,11,17,12,13,13,17,6,3,1,3,1,4,2,1,2,1,1,1,13,15,8,9,14,11,14,14,1,1,20,1,1,1,1,1,1,1,1,1,1,1,195,97,8,20,347975206,6900,5833,5833,African_Caribbean,134,17,1991/2/3,13,1,57996.0,,85009974
177,Armando Broja,Chelsea,2001,68.0,al ALB,FW,20.0,3.3,4.0,1.0,0.0,3.0,1.0,1.0,1.0,100.0,0.0,10.0,1.0,9.0,1.0,5.0,1.0,0.0,Matches,68.0,al ALB,FW,20.0,3.3,4.0,1.22,2.0,0.0,0.0,0.0,2.0,0.0,2.0,0.61,1.0,0.0,0.0,0.0,1.0,0.0,Matches,,,,,,,,,,,,,,,,,,,,,,,,,,,,,,,,,,,,,,,,,,,,,,,,,,,,,,,,68.0,al ALB,FW,20.0,3.3,0.0,0.0,0.0,2.0,6.0,3.0,0.0,1.0,1.0,1.0,0.0,0.0,15.0,9.0,21.0,30.0,Matches,68.0,al ALB,FW,20.0,3.3,53.0,51.0,2.0,0.0,0.0,1.0,0.0,0.0,0.0,0.0,0.0,0.0,33.0,0.0,0.0,Matches,68.0,al ALB,FW,20.0,3.3,33.0,53.0,62.3,466.0,54.0,21.0,33.0,63.6,9.0,15.0,60.0,2.0,3.0,66.7,0.0,0.1,0.1,-0.1,1.0,1.0,1.0,0.0,4.0,Matches,89,al ALB,FW,20,12,294.0,25.0,8.6,3.3,2,67.0,0,10,16.0,1,1.5,5.0,5.0,0.0,0.0,0.26,2.8,4.4,-1.6,-0.49,-0.45,Matches,68.0,al ALB,FW,20.0,3.3,110.0,2.0,7.0,41.0,63.0,16.0,110.0,15.0,8.0,53.3,5.0,33.3,54.0,399.0,199.0,8.0,1.0,5.0,15.0,9.0,71.0,17.0,Matches,68.0,al ALB,FW,20.0,3.3,1.0,6.0,5.0,83.3,1.84,1.53,0.17,0.2,11.0,0.0,0.0,0.0,0.8,0.8,0.14,0.2,0.2,Matches,68.0,al ALB,FW,20.0,12.0,2.0,294.0,3.3,1.0,0.0,1.0,1.0,0.0,0.0,0.0,0.0,0.8,0.8,0.1,0.9,8.0,4.0,17.0,0.31,0.0,0.31,0.31,0.31,0.26,0.02,0.27,0.26,0.27,Matches,Armando Broja,AM/S RL,20,135,-85,"Albania,England",Chelsea,7,8,15,14,12,7,12,8,7,5,7,8,8,13,14,13,11,14,8,9,12,12,13,11,14,6,11,13,16,12,15,14,14,16,13,14,10,7,10,6,11,1,2,1,2,2,3,1,3,1,2,1,13,10,6,10,12,12,12,12,1,1,1,1,1,1,1,1,1,1,15,14,16,20,191,75,10,20,75046653,6750,6750,5500,Mediterranean_Hispanic,130,2,2001/9/10,14,4,86994.0,,28121369
178,David Brooks,Bournemouth,1997,69.0,wls WAL,FWMF,25.0,1.9,1.0,0.0,1.0,0.0,0.0,0.0,1.0,0.0,1.0,2.0,0.0,2.0,2.0,3.0,5.0,0.0,Matches,69.0,wls WAL,FWMF,25.0,1.9,8.0,4.19,5.0,0.0,1.0,1.0,1.0,0.0,0.0,0.0,0.0,0.0,0.0,0.0,0.0,0.0,Matches,,,,,,,,,,,,,,,,,,,,,,,,,,,,,,,,,,,,,,,,,,,,,,,,,,,,,,,,69.0,wls WAL,FWMF,25.0,1.9,1.0,0.0,0.0,3.0,1.0,0.0,6.0,2.0,0.0,0.0,0.0,0.0,4.0,2.0,3.0,40.0,Matches,69.0,wls WAL,FWMF,25.0,1.9,63.0,61.0,2.0,0.0,0.0,0.0,6.0,0.0,2.0,1.0,1.0,0.0,46.0,0.0,3.0,Matches,69.0,wls WAL,FWMF,25.0,1.9,46.0,63.0,73.0,640.0,140.0,30.0,32.0,93.8,13.0,16.0,81.3,2.0,9.0,22.2,0.0,0.2,0.2,-0.2,2.0,4.0,1.0,0.0,11.0,Matches,90,wls WAL,FWMF,25,6,173.0,29.0,5.1,1.9,2,55.0,0,4,16.0,5,0.0,0.0,4.0,-4.0,-2.08,-1.25,1.0,4.5,-3.5,-1.83,-1.23,Matches,69.0,wls WAL,FWMF,25.0,1.9,93.0,8.0,19.0,35.0,39.0,9.0,93.0,9.0,2.0,22.2,7.0,77.8,61.0,270.0,120.0,5.0,2.0,2.0,4.0,4.0,65.0,10.0,Matches,69.0,wls WAL,FWMF,25.0,1.9,0.0,5.0,1.0,20.0,2.6,0.52,0.0,0.0,20.6,1.0,0.0,0.0,0.3,0.3,0.05,-0.3,-0.3,Matches,69.0,wls WAL,FWMF,25.0,6.0,2.0,173.0,1.9,0.0,0.0,0.0,0.0,0.0,0.0,1.0,0.0,0.3,0.3,0.2,0.5,5.0,11.0,10.0,0.0,0.0,0.0,0.0,0.0,0.13,0.11,0.25,0.13,0.25,Matches,David Brooks,M/AM RC,25,132,164,"Wales,England",AFC Bournemouth,9,11,15,13,14,10,8,8,4,7,14,8,9,15,6,14,6,14,9,15,13,14,18,5,15,8,12,15,14,16,15,6,11,15,12,7,12,3,9,10,6,2,1,3,3,3,3,1,1,3,3,1,10,16,4,14,14,14,13,13,1,1,1,1,1,1,1,1,13,18,1,20,20,13,173,65,20,9,21585132,6600,6750,5500,Northern_European,130,5,1997/7/8,21,2,40597.0,,28095352
179,Lewis Brunt,Leicester City,2000,70.0,eng ENG,DF,21.0,0.3,0.0,0.0,0.0,0.0,0.0,0.0,0.0,,0.0,0.0,0.0,0.0,0.0,0.0,2.0,0.0,Matches,70.0,eng ENG,DF,21.0,0.3,0.0,0.0,0.0,0.0,0.0,0.0,0.0,0.0,0.0,0.0,0.0,0.0,0.0,0.0,0.0,0.0,Matches,,,,,,,,,,,,,,,,,,,,,,,,,,,,,,,,,,,,,,,,,,,,,,,,,,,,,,,,70.0,eng ENG,DF,21.0,0.3,0.0,0.0,0.0,0.0,1.0,0.0,0.0,0.0,0.0,0.0,0.0,0.0,1.0,0.0,0.0,,Matches,70.0,eng ENG,DF,21.0,0.3,21.0,16.0,5.0,0.0,0.0,0.0,0.0,5.0,0.0,0.0,0.0,0.0,17.0,0.0,1.0,Matches,70.0,eng ENG,DF,21.0,0.3,17.0,21.0,81.0,283.0,57.0,7.0,8.0,87.5,10.0,11.0,90.9,0.0,1.0,0.0,0.0,0.0,0.0,0.0,0.0,0.0,0.0,0.0,0.0,Matches,91,eng ENG,DF,21,1,23.0,23.0,0.7,0.3,0,,0,1,23.0,6,0.0,0.0,1.0,-1.0,-3.91,-3.49,0.0,0.8,-0.8,-3.31,-3.0,Matches,70.0,eng ENG,DF,21.0,0.3,23.0,1.0,8.0,12.0,3.0,0.0,23.0,0.0,0.0,,0.0,,9.0,30.0,4.0,0.0,0.0,0.0,0.0,0.0,13.0,2.0,Matches,70.0,eng ENG,DF,21.0,0.3,0.0,0.0,0.0,,0.0,0.0,,,,0.0,0.0,0.0,0.0,0.0,,0.0,0.0,Matches,70.0,eng ENG,DF,21.0,1.0,0.0,23.0,0.3,0.0,0.0,0.0,0.0,0.0,0.0,0.0,0.0,0.0,0.0,0.0,0.0,0.0,0.0,2.0,0.0,0.0,0.0,0.0,0.0,0.0,0.0,0.0,0.0,0.0,Matches,Lewis Brunt,D/DM/M C,21,103,-75,England,Leicester City,7,8,9,5,10,6,11,9,3,11,12,8,12,11,11,12,12,13,11,10,11,13,8,11,13,11,13,14,11,10,12,12,13,12,12,12,11,9,7,7,10,3,3,1,1,3,1,1,1,1,3,3,8,12,5,13,14,13,11,12,1,10,19,12,1,1,20,1,17,1,1,8,1,1,187,71,10,20,40829091,5149,5149,2749,Northern_European,98,1,2000/11/6,0,0,11599.0,,29193664
180,Facundo Buonanotte,Brighton,2004,73.0,ar ARG,FWMF,17.0,6.3,2.0,1.0,1.0,1.0,0.0,1.0,22.0,4.5,21.0,5.0,2.0,3.0,4.0,6.0,3.0,0.0,Matches,73.0,ar ARG,FWMF,17.0,6.3,14.0,2.23,12.0,0.0,2.0,0.0,0.0,0.0,1.0,0.16,1.0,0.0,0.0,0.0,0.0,0.0,Matches,,,,,,,,,,,,,,,,,,,,,,,,,,,,,,,,,,,,,,,,,,,,,,,,,,,,,,,,73.0,ar ARG,FWMF,17.0,6.3,2.0,0.0,0.0,9.0,7.0,3.0,7.0,4.0,1.0,0.0,0.0,0.0,25.0,2.0,4.0,33.3,Matches,73.0,ar ARG,FWMF,17.0,6.3,194.0,190.0,4.0,1.0,0.0,1.0,7.0,1.0,2.0,2.0,0.0,0.0,157.0,0.0,5.0,Matches,73.0,ar ARG,FWMF,17.0,6.3,157.0,194.0,80.9,2407.0,525.0,101.0,114.0,88.6,36.0,46.0,78.3,17.0,21.0,81.0,1.0,0.5,0.4,0.5,6.0,9.0,10.0,2.0,13.0,Matches,94,ar ARG,FWMF,17,13,565.0,43.0,16.5,6.3,6,69.0,1,7,22.0,6,1.54,11.0,12.0,-1.0,-0.16,-0.79,11.6,11.9,-0.3,-0.05,-0.79,Matches,73.0,ar ARG,FWMF,17.0,6.3,258.0,8.0,33.0,114.0,115.0,19.0,258.0,19.0,7.0,36.8,9.0,47.4,182.0,1018.0,424.0,9.0,5.0,2.0,10.0,2.0,202.0,42.0,Matches,73.0,ar ARG,FWMF,17.0,6.3,1.0,11.0,3.0,27.3,1.75,0.48,0.09,0.33,16.9,0.0,0.0,0.0,1.4,1.4,0.13,-0.4,-0.4,Matches,73.0,ar ARG,FWMF,17.0,13.0,6.0,565.0,6.3,1.0,1.0,2.0,1.0,0.0,0.0,2.0,0.0,1.4,1.4,0.5,1.9,9.0,13.0,42.0,0.16,0.16,0.32,0.16,0.32,0.22,0.09,0.31,0.22,0.31,Matches,Facundo Buonanotte,M/AM RLC,17,118,-85,"Argentina,Italy",Club Atlético Rosario Central,11,11,12,11,13,11,9,13,10,9,12,13,10,13,12,11,11,13,12,13,11,9,14,10,14,8,12,13,14,13,13,7,9,12,14,10,14,6,13,12,9,1,1,3,3,1,2,2,2,2,2,3,13,11,5,12,12,13,9,14,1,1,1,1,1,1,1,1,12,20,15,15,18,1,174,66,20,10,6535507,5787,5787,3073,Mediterranean_Hispanic,119,1,2004/12/23,0,0,5244.0,,2000051578
181,Chem Campbell,Wolves,2002,80.0,wls WAL,FWMF,19.0,0.8,2.0,1.0,1.0,1.0,0.0,0.0,1.0,0.0,1.0,2.0,0.0,2.0,1.0,3.0,0.0,0.0,Matches,80.0,wls WAL,FWMF,19.0,0.8,2.0,2.43,1.0,0.0,1.0,0.0,0.0,0.0,0.0,0.0,0.0,0.0,0.0,0.0,0.0,0.0,Matches,,,,,,,,,,,,,,,,,,,,,,,,,,,,,,,,,,,,,,,,,,,,,,,,,,,,,,,,80.0,wls WAL,FWMF,19.0,0.8,0.0,0.0,0.0,0.0,1.0,0.0,4.0,1.0,1.0,0.0,0.0,0.0,4.0,2.0,1.0,66.7,Matches,80.0,wls WAL,FWMF,19.0,0.8,32.0,31.0,1.0,0.0,0.0,0.0,4.0,0.0,1.0,1.0,0.0,0.0,23.0,0.0,1.0,Matches,80.0,wls WAL,FWMF,19.0,0.8,23.0,32.0,71.9,344.0,64.0,10.0,11.0,90.9,13.0,14.0,92.9,0.0,5.0,0.0,0.0,0.0,0.0,0.0,0.0,2.0,0.0,0.0,4.0,Matches,105,wls WAL,FWMF,19,5,74.0,15.0,2.2,0.8,0,,0,5,15.0,9,0.0,0.0,2.0,-2.0,-2.43,-1.76,0.2,1.0,-0.8,-1.01,-0.42,Matches,80.0,wls WAL,FWMF,19.0,0.8,47.0,1.0,6.0,19.0,23.0,5.0,47.0,5.0,3.0,60.0,2.0,40.0,39.0,303.0,70.0,2.0,6.0,1.0,3.0,5.0,36.0,10.0,Matches,80.0,wls WAL,FWMF,19.0,0.8,0.0,2.0,0.0,0.0,2.43,0.0,0.0,,11.3,0.0,0.0,0.0,0.1,0.1,0.05,-0.1,-0.1,Matches,80.0,wls WAL,FWMF,19.0,5.0,0.0,74.0,0.8,0.0,0.0,0.0,0.0,0.0,0.0,0.0,0.0,0.1,0.1,0.0,0.1,2.0,4.0,10.0,0.0,0.0,0.0,0.0,0.0,0.12,0.0,0.12,0.12,0.12,Matches,Chem Campbell,AM RL,19,95,-75,"Wales,England,Jamaica",Wolverhampton Wanderers,8,11,13,9,8,13,8,13,8,7,14,5,7,12,14,12,1,8,8,10,10,12,14,13,12,8,9,13,15,14,9,8,15,13,8,8,10,15,17,11,11,2,2,1,1,2,2,2,2,2,2,3,18,10,12,13,11,11,9,5,1,1,1,1,1,5,1,15,1,15,20,13,18,1,180,72,12,20,23592719,4748,4748,2510,Northern_European,99,12,2002/12/30,0,0,5800.0,,28127368
182,Diego Carlos,Aston Villa,1993,84.0,br BRA,DF,29.0,2.3,1.0,0.0,0.0,1.0,0.0,0.0,1.0,0.0,1.0,2.0,2.0,0.0,1.0,2.0,2.0,0.0,Matches,84.0,br BRA,DF,29.0,2.3,3.0,1.32,2.0,0.0,0.0,1.0,0.0,0.0,0.0,0.0,0.0,0.0,0.0,0.0,0.0,0.0,Matches,,,,,,,,,,,,,,,,,,,,,,,,,,,,,,,,,,,,,,,,,,,,,,,,,,,,,,,,84.0,br BRA,DF,29.0,2.3,0.0,0.0,0.0,2.0,0.0,0.0,1.0,1.0,0.0,0.0,0.0,0.0,14.0,6.0,3.0,66.7,Matches,84.0,br BRA,DF,29.0,2.3,142.0,136.0,5.0,4.0,0.0,1.0,1.0,1.0,0.0,0.0,0.0,0.0,112.0,1.0,1.0,Matches,84.0,br BRA,DF,29.0,2.3,112.0,142.0,78.9,2338.0,881.0,35.0,41.0,85.4,60.0,71.0,84.5,17.0,28.0,60.7,0.0,0.0,0.1,0.0,1.0,9.0,1.0,0.0,11.0,Matches,109,br BRA,DF,29,3,205.0,68.0,6.0,2.3,2,90.0,1,1,26.0,11,1.0,2.0,3.0,-1.0,-0.44,-0.61,3.6,1.9,1.7,0.74,0.85,Matches,84.0,br BRA,DF,29.0,2.3,156.0,11.0,54.0,94.0,11.0,4.0,156.0,0.0,0.0,,0.0,,100.0,348.0,193.0,1.0,3.0,0.0,2.0,0.0,111.0,0.0,Matches,84.0,br BRA,DF,29.0,2.3,0.0,4.0,0.0,0.0,1.76,0.0,0.0,,15.7,0.0,0.0,0.0,0.4,0.4,0.09,-0.4,-0.4,Matches,84.0,br BRA,DF,29.0,3.0,2.0,205.0,2.3,0.0,0.0,0.0,0.0,0.0,0.0,0.0,0.0,0.4,0.4,0.0,0.4,1.0,11.0,0.0,0.0,0.0,0.0,0.0,0.0,0.16,0.02,0.18,0.16,0.18,Matches,Diego Carlos,D C,29,150,153,Brazil,Aston Villa,3,5,7,5,11,9,15,8,10,16,12,10,15,12,16,15,19,13,14,8,14,15,9,9,8,15,13,14,13,12,15,14,18,14,15,18,15,12,13,6,8,2,2,1,1,1,1,1,2,1,4,3,13,15,11,11,12,16,12,10,1,1,20,1,1,1,14,1,1,1,1,1,1,1,185,79,9,20,35493471,7500,7500,6000,Mixed_Race,149,11,1993/3/15,0,0,115992.0,,19188567
183,Nathaniel Chalobah,Fulham,1994,90.0,eng ENG,MF,27.0,0.1,1.0,1.0,1.0,0.0,0.0,1.0,1.0,100.0,0.0,0.0,0.0,0.0,0.0,1.0,2.0,0.0,Matches,90.0,eng ENG,MF,27.0,0.1,0.0,0.0,0.0,0.0,0.0,0.0,0.0,0.0,0.0,0.0,0.0,0.0,0.0,0.0,0.0,0.0,Matches,,,,,,,,,,,,,,,,,,,,,,,,,,,,,,,,,,,,,,,,,,,,,,,,,,,,,,,,90.0,eng ENG,MF,27.0,0.1,0.0,1.0,0.0,2.0,0.0,0.0,0.0,0.0,1.0,0.0,0.0,0.0,0.0,1.0,2.0,33.3,Matches,90.0,eng ENG,MF,27.0,0.1,5.0,5.0,0.0,0.0,0.0,0.0,0.0,0.0,0.0,0.0,0.0,0.0,4.0,0.0,0.0,Matches,90.0,eng ENG,MF,27.0,0.1,4.0,5.0,80.0,67.0,9.0,2.0,2.0,100.0,2.0,2.0,100.0,0.0,0.0,,0.0,0.0,0.0,0.0,0.0,1.0,0.0,0.0,0.0,Matches,117,eng ENG,MF,27,4,12.0,3.0,0.4,0.1,1,7.0,0,3,2.0,10,1.5,0.0,0.0,0.0,0.0,-0.05,0.1,0.4,-0.3,-1.94,-1.49,Matches,90.0,eng ENG,MF,27.0,0.1,11.0,4.0,5.0,3.0,3.0,1.0,11.0,0.0,0.0,,0.0,,6.0,16.0,8.0,0.0,1.0,0.0,1.0,1.0,8.0,0.0,Matches,90.0,eng ENG,MF,27.0,0.1,0.0,1.0,1.0,100.0,7.5,7.5,0.0,0.0,10.1,0.0,0.0,0.0,0.1,0.1,0.09,-0.1,-0.1,Matches,90.0,eng ENG,MF,27.0,4.0,1.0,12.0,0.1,0.0,0.0,0.0,0.0,0.0,0.0,0.0,1.0,0.1,0.1,0.0,0.1,0.0,0.0,0.0,0.0,0.0,0.0,0.0,0.0,0.71,0.0,0.71,0.71,0.71,Matches,Nathaniel Chalobah,DM/M C,27,126,156,"England,Sierra Leone",Fulham,7,6,9,9,14,11,12,13,4,10,13,10,12,14,10,10,10,14,10,13,13,14,11,14,9,13,14,14,13,12,15,12,16,12,14,14,11,4,11,7,13,3,1,3,1,2,2,4,2,3,1,2,11,14,2,12,12,12,16,14,1,1,12,7,1,7,20,1,20,9,1,8,1,1,185,73,12,20,6668649,6299,6299,5649,African_Caribbean,124,15,1994/12/12,1,0,40597.0,,28058513
184,Calum Chambers,Aston Villa,1995,92.0,eng ENG,DFMF,27.0,3.9,9.0,6.0,7.0,2.0,0.0,6.0,8.0,75.0,2.0,5.0,4.0,1.0,7.0,16.0,10.0,1.0,Matches,92.0,eng ENG,DFMF,27.0,3.9,6.0,1.53,5.0,0.0,0.0,0.0,0.0,1.0,0.0,0.0,0.0,0.0,0.0,0.0,0.0,0.0,Matches,,,,,,,,,,,,,,,,,,,,,,,,,,,,,,,,,,,,,,,,,,,,,,,,,,,,,,,,92.0,eng ENG,DFMF,27.0,3.9,2.0,0.0,0.0,7.0,2.0,0.0,4.0,7.0,6.0,0.0,0.0,0.0,23.0,3.0,6.0,33.3,Matches,92.0,eng ENG,DFMF,27.0,3.9,207.0,191.0,13.0,4.0,0.0,1.0,4.0,9.0,0.0,0.0,0.0,0.0,157.0,3.0,1.0,Matches,92.0,eng ENG,DFMF,27.0,3.9,157.0,207.0,75.8,2924.0,1310.0,66.0,76.0,86.8,77.0,94.0,81.9,14.0,31.0,45.2,0.0,0.3,0.2,-0.3,2.0,9.0,2.0,1.0,16.0,Matches,119,eng ENG,DFMF,27,14,353.0,25.0,10.3,3.9,2,90.0,2,12,14.0,22,2.07,4.0,4.0,0.0,0.0,-0.15,3.5,5.6,-2.1,-0.53,-0.53,Matches,92.0,eng ENG,DFMF,27.0,3.9,245.0,30.0,119.0,96.0,32.0,2.0,245.0,0.0,0.0,,0.0,,139.0,794.0,540.0,6.0,4.0,0.0,2.0,1.0,149.0,2.0,Matches,92.0,eng ENG,DFMF,27.0,3.9,0.0,2.0,0.0,0.0,0.51,0.0,0.0,,21.6,0.0,0.0,0.0,0.1,0.1,0.06,-0.1,-0.1,Matches,92.0,eng ENG,DFMF,27.0,14.0,2.0,353.0,3.9,0.0,0.0,0.0,0.0,0.0,0.0,2.0,0.0,0.1,0.1,0.3,0.4,6.0,16.0,2.0,0.0,0.0,0.0,0.0,0.0,0.03,0.07,0.1,0.03,0.1,Matches,Calum Chambers,D/WB/DM RC,27,138,150,England,Aston Villa,6,12,12,9,13,6,14,10,12,14,13,7,14,13,13,13,14,14,14,12,13,13,9,10,11,13,15,15,13,13,14,14,11,13,14,13,13,11,12,11,16,2,1,1,1,2,1,3,3,1,1,3,14,12,8,14,12,13,13,13,1,1,18,20,1,18,17,1,10,1,1,1,1,1,183,73,8,20,29282114,6900,6900,5750,Northern_European,134,4,1995/1/20,3,0,57996.0,,29076103
185,Carney Chukwuemeka,Chelsea,2003,96.0,eng ENG,MFFW,18.0,3.9,13.0,7.0,7.0,6.0,0.0,3.0,5.0,60.0,2.0,7.0,0.0,7.0,6.0,19.0,1.0,0.0,Matches,96.0,eng ENG,MFFW,18.0,3.9,16.0,4.07,13.0,0.0,0.0,1.0,0.0,2.0,0.0,0.0,0.0,0.0,0.0,0.0,0.0,0.0,Matches,,,,,,,,,,,,,,,,,,,,,,,,,,,,,,,,,,,,,,,,,,,,,,,,,,,,,,,,96.0,eng ENG,MFFW,18.0,3.9,0.0,0.0,0.0,2.0,5.0,1.0,3.0,6.0,7.0,0.0,0.0,0.0,22.0,1.0,6.0,14.3,Matches,96.0,eng ENG,MFFW,18.0,3.9,203.0,202.0,1.0,0.0,0.0,2.0,3.0,0.0,0.0,0.0,0.0,0.0,179.0,0.0,6.0,Matches,96.0,eng ENG,MFFW,18.0,3.9,179.0,203.0,88.2,2291.0,502.0,126.0,140.0,90.0,33.0,37.0,89.2,8.0,8.0,100.0,0.0,0.6,0.6,-0.6,8.0,11.0,7.0,2.0,23.0,Matches,125,eng ENG,MFFW,18,14,354.0,25.0,10.4,3.9,2,72.0,0,12,18.0,7,1.29,2.0,7.0,-5.0,-1.27,-1.15,6.0,8.2,-2.2,-0.55,-0.53,Matches,96.0,eng ENG,MFFW,18.0,3.9,262.0,5.0,47.0,106.0,112.0,17.0,262.0,11.0,6.0,54.5,5.0,45.5,154.0,1165.0,718.0,21.0,14.0,3.0,11.0,3.0,184.0,21.0,Matches,96.0,eng ENG,MFFW,18.0,3.9,0.0,5.0,1.0,20.0,1.27,0.25,0.0,0.0,17.2,0.0,0.0,0.0,0.4,0.4,0.08,-0.4,-0.4,Matches,96.0,eng ENG,MFFW,18.0,14.0,2.0,354.0,3.9,0.0,0.0,0.0,0.0,0.0,0.0,0.0,0.0,0.4,0.4,0.6,1.0,21.0,23.0,21.0,0.0,0.0,0.0,0.0,0.0,0.1,0.16,0.26,0.1,0.26,Matches,Carney Chukwuemeka,M/AM C,18,120,-85,"England,Nigeria,Austria",Chelsea,5,6,13,11,14,5,11,11,6,8,13,7,10,14,10,12,14,15,10,11,12,17,14,9,9,10,9,12,13,13,12,11,12,14,13,13,11,9,10,8,11,3,1,1,1,3,2,4,1,1,1,3,12,18,6,10,10,10,10,14,1,1,1,1,1,1,1,1,20,1,1,18,1,1,185,70,13,20,66718446,6000,6000,4750,African_Caribbean,117,17,2003/10/20,0,0,115992.0,,28127875
186,Bobby Clark,Liverpool,2005,97.0,eng ENG,MF,17.0,0.1,0.0,0.0,0.0,0.0,0.0,0.0,0.0,,0.0,2.0,0.0,2.0,0.0,0.0,0.0,0.0,Matches,97.0,eng ENG,MF,17.0,0.1,0.0,0.0,0.0,0.0,0.0,0.0,0.0,0.0,0.0,0.0,0.0,0.0,0.0,0.0,0.0,0.0,Matches,,,,,,,,,,,,,,,,,,,,,,,,,,,,,,,,,,,,,,,,,,,,,,,,,,,,,,,,97.0,eng ENG,MF,17.0,0.1,0.0,0.0,0.0,1.0,0.0,0.0,0.0,0.0,0.0,0.0,0.0,0.0,0.0,0.0,0.0,,Matches,97.0,eng ENG,MF,17.0,0.1,1.0,1.0,0.0,0.0,0.0,0.0,0.0,0.0,0.0,0.0,0.0,0.0,1.0,0.0,0.0,Matches,97.0,eng ENG,MF,17.0,0.1,1.0,1.0,100.0,29.0,17.0,0.0,0.0,,1.0,1.0,100.0,0.0,0.0,,0.0,0.0,0.1,0.0,0.0,0.0,1.0,0.0,1.0,Matches,126,eng ENG,MF,17,1,8.0,8.0,0.2,0.1,0,,0,1,8.0,5,3.0,1.0,0.0,1.0,11.25,10.54,0.3,0.0,0.3,3.13,2.57,Matches,97.0,eng ENG,MF,17.0,0.1,7.0,0.0,0.0,0.0,7.0,1.0,7.0,1.0,0.0,0.0,1.0,100.0,3.0,3.0,0.0,0.0,0.0,0.0,2.0,0.0,3.0,2.0,Matches,97.0,eng ENG,MF,17.0,0.1,0.0,0.0,0.0,,0.0,0.0,,,,0.0,0.0,0.0,0.0,0.0,,0.0,0.0,Matches,97.0,eng ENG,MF,17.0,1.0,0.0,8.0,0.1,0.0,0.0,0.0,0.0,0.0,0.0,0.0,0.0,0.0,0.0,0.0,0.0,0.0,1.0,2.0,0.0,0.0,0.0,0.0,0.0,0.0,0.0,0.0,0.0,0.0,Matches,Bobby Clark,AM RLC,17,81,-8,England,Liverpool,7,9,8,9,14,7,3,9,5,6,14,7,8,10,14,7,8,10,8,13,13,15,11,1,14,8,13,9,9,12,8,8,17,11,5,4,11,5,5,13,10,4,3,1,1,3,3,2,2,3,1,1,20,12,4,10,9,10,12,10,1,1,1,1,1,1,1,1,14,1,18,20,18,15,178,0,10,20,35052702,4042,4042,1992,Northern_European,74,0,2005/2/7,0,0,892.0,,2000047196
187,Maxwel Cornet,West Ham,1996,107.0,ci CIV,FW,25.0,2.7,7.0,3.0,5.0,0.0,2.0,4.0,6.0,66.7,2.0,6.0,0.0,6.0,2.0,9.0,3.0,0.0,Matches,107.0,ci CIV,FW,25.0,2.7,6.0,2.23,4.0,0.0,1.0,0.0,0.0,1.0,0.0,0.0,0.0,0.0,0.0,0.0,0.0,0.0,Matches,,,,,,,,,,,,,,,,,,,,,,,,,,,,,,,,,,,,,,,,,,,,,,,,,,,,,,,,107.0,ci CIV,FW,25.0,2.7,0.0,0.0,0.0,2.0,2.0,9.0,6.0,2.0,3.0,0.0,0.0,0.0,15.0,6.0,11.0,35.3,Matches,107.0,ci CIV,FW,25.0,2.7,97.0,93.0,2.0,0.0,0.0,0.0,6.0,1.0,0.0,0.0,0.0,0.0,72.0,2.0,7.0,Matches,107.0,ci CIV,FW,25.0,2.7,72.0,97.0,74.2,942.0,166.0,47.0,54.0,87.0,19.0,27.0,70.4,2.0,2.0,100.0,0.0,0.1,0.1,-0.1,1.0,3.0,1.0,1.0,5.0,Matches,137,ci CIV,FW,25,14,245.0,18.0,7.2,2.7,2,46.0,0,12,13.0,6,0.79,2.0,5.0,-3.0,-1.1,-0.82,3.1,4.4,-1.3,-0.48,-0.41,Matches,107.0,ci CIV,FW,25.0,2.7,140.0,3.0,18.0,50.0,72.0,11.0,140.0,5.0,2.0,40.0,3.0,60.0,83.0,310.0,140.0,9.0,2.0,5.0,9.0,5.0,103.0,26.0,Matches,107.0,ci CIV,FW,25.0,2.7,0.0,9.0,2.0,22.2,3.31,0.73,0.0,0.0,12.5,0.0,0.0,0.0,1.3,1.3,0.14,-1.3,-1.3,Matches,107.0,ci CIV,FW,25.0,14.0,2.0,245.0,2.7,0.0,0.0,0.0,0.0,0.0,0.0,0.0,0.0,1.3,1.3,0.1,1.3,9.0,5.0,26.0,0.0,0.0,0.0,0.0,0.0,0.47,0.02,0.49,0.47,0.49,Matches,Maxwel Cornet,D/WB/M/AM RL,25,139,143,"Ivory Coast,France",West Ham United,12,11,12,14,12,11,11,10,10,11,12,10,11,12,8,12,13,12,10,11,10,14,12,6,13,10,13,14,15,12,12,10,15,15,13,12,12,9,13,7,17,2,2,3,3,3,3,1,2,3,3,3,14,13,6,13,10,13,14,14,1,19,1,1,18,1,1,18,1,1,20,1,15,13,179,69,20,12,29751880,6950,6950,5500,African_Caribbean,126,17,1996/9/27,28,5,75395.0,,85117459
188,Philippe Coutinho,Aston Villa,1992,110.0,br BRA,MFFW,30.0,8.8,19.0,14.0,8.0,8.0,3.0,9.0,15.0,60.0,6.0,11.0,1.0,10.0,4.0,23.0,2.0,0.0,Matches,110.0,br BRA,MFFW,30.0,8.8,24.0,2.74,19.0,1.0,3.0,1.0,0.0,0.0,0.0,0.0,0.0,0.0,0.0,0.0,0.0,0.0,Matches,,,,,,,,,,,,,,,,,,,,,,,,,,,,,,,,,,,,,,,,,,,,,,,,,,,,,,,,110.0,br BRA,MFFW,30.0,8.8,3.0,0.0,0.0,16.0,14.0,2.0,19.0,4.0,14.0,0.0,0.0,0.0,41.0,3.0,13.0,18.8,Matches,110.0,br BRA,MFFW,30.0,8.8,384.0,352.0,30.0,13.0,5.0,1.0,19.0,5.0,6.0,3.0,1.0,0.0,288.0,2.0,7.0,Matches,110.0,br BRA,MFFW,30.0,8.8,288.0,384.0,75.0,4081.0,976.0,180.0,210.0,85.7,82.0,112.0,73.2,17.0,36.0,47.2,0.0,0.5,0.8,-0.5,8.0,30.0,8.0,2.0,48.0,Matches,140,br BRA,MFFW,30,20,788.0,39.0,23.0,8.8,7,72.0,1,13,22.0,2,1.1,9.0,9.0,0.0,0.0,-0.17,9.3,8.3,0.9,0.11,0.21,Matches,110.0,br BRA,MFFW,30.0,8.8,500.0,2.0,34.0,259.0,213.0,24.0,500.0,34.0,14.0,41.2,15.0,44.1,309.0,1747.0,739.0,18.0,28.0,5.0,23.0,17.0,369.0,68.0,Matches,110.0,br BRA,MFFW,30.0,8.8,1.0,21.0,8.0,38.1,2.4,0.91,0.05,0.13,21.6,2.0,0.0,0.0,1.4,1.4,0.07,-0.4,-0.4,Matches,110.0,br BRA,MFFW,30.0,20.0,7.0,788.0,8.8,1.0,0.0,1.0,1.0,0.0,0.0,3.0,0.0,1.4,1.4,0.5,1.8,18.0,48.0,68.0,0.11,0.0,0.11,0.11,0.11,0.16,0.05,0.21,0.16,0.21,Matches,Philippe Coutinho,M/AM LC,30,153,170,"Brazil,Portugal",Aston Villa,13,14,18,12,17,16,9,16,4,5,15,13,6,19,10,13,9,14,11,17,13,12,18,10,16,7,11,12,14,15,12,7,10,11,13,10,10,7,14,14,15,2,2,1,2,2,2,2,1,1,2,4,14,13,9,10,11,15,14,12,1,1,1,1,1,1,1,18,15,14,18,20,14,10,172,71,15,20,52822636,7650,8150,7250,Mediterranean_Hispanic,150,11,1992/6/12,63,18,144990.0,,19046041
189,Conor Coventry,West Ham,2000,111.0,ie IRL,MFFW,22.0,0.0,0.0,0.0,0.0,0.0,0.0,0.0,0.0,,0.0,0.0,0.0,0.0,0.0,0.0,0.0,0.0,Matches,111.0,ie IRL,MFFW,22.0,0.0,0.0,0.0,0.0,0.0,0.0,0.0,0.0,0.0,0.0,0.0,0.0,0.0,0.0,0.0,0.0,0.0,Matches,,,,,,,,,,,,,,,,,,,,,,,,,,,,,,,,,,,,,,,,,,,,,,,,,,,,,,,,111.0,ie IRL,MFFW,22.0,0.0,0.0,0.0,0.0,0.0,0.0,0.0,0.0,0.0,0.0,0.0,0.0,0.0,0.0,0.0,0.0,,Matches,111.0,ie IRL,MFFW,22.0,0.0,0.0,0.0,0.0,0.0,0.0,0.0,0.0,0.0,0.0,0.0,0.0,0.0,0.0,0.0,0.0,Matches,111.0,ie IRL,MFFW,22.0,0.0,0.0,0.0,,0.0,0.0,0.0,0.0,,0.0,0.0,,0.0,0.0,,0.0,0.0,0.0,0.0,0.0,0.0,0.0,0.0,0.0,Matches,141,ie IRL,MFFW,22,1,1.0,1.0,0.0,0.0,0,,0,1,1.0,10,0.0,0.0,0.0,0.0,0.0,0.34,0.0,0.0,0.0,0.0,0.1,Matches,111.0,ie IRL,MFFW,22.0,0.0,0.0,0.0,0.0,0.0,0.0,0.0,0.0,0.0,0.0,,0.0,,0.0,0.0,0.0,0.0,0.0,0.0,0.0,0.0,0.0,0.0,Matches,111.0,ie IRL,MFFW,22.0,0.0,0.0,0.0,0.0,,0.0,0.0,,,,0.0,0.0,0.0,0.0,0.0,,0.0,0.0,Matches,111.0,ie IRL,MFFW,22.0,1.0,0.0,1.0,0.0,0.0,0.0,0.0,0.0,0.0,0.0,0.0,0.0,0.0,0.0,0.0,0.0,0.0,0.0,0.0,0.0,0.0,0.0,0.0,0.0,0.0,0.0,0.0,0.0,0.0,Matches,Conor Coventry,DM/M C,22,111,140,"Republic of Ireland,England",West Ham United,11,12,11,11,12,13,8,11,6,10,12,4,12,11,14,13,12,12,11,11,12,17,8,12,11,13,12,14,12,11,13,8,13,11,14,9,13,5,11,9,15,2,1,1,1,3,2,2,3,1,2,1,12,13,8,10,12,10,11,17,1,1,1,1,1,1,19,1,20,1,1,10,1,1,177,65,11,20,7284281,5547,5847,3247,Northern_European,109,3,2000/3/25,0,0,5800.0,,28110180
190,Arnaut Danjuma,Tottenham,1997,120.0,nl NED,FWMF,25.0,1.9,2.0,0.0,1.0,1.0,0.0,0.0,0.0,,0.0,1.0,0.0,1.0,0.0,2.0,0.0,0.0,Matches,120.0,nl NED,FWMF,25.0,1.9,4.0,2.13,4.0,0.0,0.0,0.0,0.0,0.0,0.0,0.0,0.0,0.0,0.0,0.0,0.0,0.0,Matches,,,,,,,,,,,,,,,,,,,,,,,,,,,,,,,,,,,,,,,,,,,,,,,,,,,,,,,,120.0,nl NED,FWMF,25.0,1.9,0.0,0.0,0.0,0.0,1.0,1.0,2.0,0.0,0.0,0.0,0.0,0.0,1.0,1.0,2.0,33.3,Matches,120.0,nl NED,FWMF,25.0,1.9,56.0,56.0,0.0,0.0,0.0,0.0,2.0,0.0,0.0,0.0,0.0,0.0,39.0,0.0,4.0,Matches,120.0,nl NED,FWMF,25.0,1.9,39.0,56.0,69.6,514.0,107.0,29.0,35.0,82.9,8.0,10.0,80.0,2.0,2.0,100.0,0.0,0.0,0.1,0.0,1.0,5.0,2.0,2.0,2.0,Matches,154,nl NED,FWMF,25,9,169.0,19.0,4.9,1.9,1,65.0,0,8,13.0,8,0.78,6.0,5.0,1.0,0.53,0.37,4.3,2.4,1.9,1.0,0.84,Matches,120.0,nl NED,FWMF,25.0,1.9,72.0,1.0,5.0,35.0,32.0,8.0,72.0,6.0,3.0,50.0,3.0,50.0,44.0,233.0,128.0,5.0,2.0,2.0,1.0,3.0,58.0,19.0,Matches,120.0,nl NED,FWMF,25.0,1.9,1.0,6.0,3.0,50.0,3.2,1.6,0.17,0.33,14.2,0.0,0.0,0.0,0.8,0.8,0.14,0.2,0.2,Matches,120.0,nl NED,FWMF,25.0,9.0,1.0,169.0,1.9,1.0,0.0,1.0,1.0,0.0,0.0,0.0,0.0,0.8,0.8,0.0,0.9,5.0,2.0,19.0,0.53,0.0,0.53,0.53,0.53,0.43,0.02,0.45,0.43,0.45,Matches,Arnaut Danjuma,M/AM RL,25,151,160,"Holland,Nigeria",Villarreal,12,14,17,14,16,13,11,11,11,6,12,8,7,17,14,13,15,14,14,14,14,15,16,4,13,6,13,11,17,14,13,10,14,16,13,9,12,12,14,14,16,1,3,2,1,1,1,2,1,1,3,3,7,18,16,5,13,10,11,12,1,1,1,1,1,1,1,17,11,11,20,14,15,11,178,74,8,20,29803798,7300,7300,5750,African_Caribbean,149,14,1997/1/31,6,2,35606.0,,37051305
191,Tom Davies,Everton,1998,124.0,eng ENG,MF,24.0,6.0,15.0,9.0,5.0,9.0,1.0,7.0,14.0,50.0,7.0,10.0,1.0,9.0,4.0,19.0,7.0,1.0,Matches,124.0,eng ENG,MF,24.0,6.0,6.0,1.0,5.0,0.0,0.0,1.0,0.0,0.0,0.0,0.0,0.0,0.0,0.0,0.0,0.0,0.0,Matches,,,,,,,,,,,,,,,,,,,,,,,,,,,,,,,,,,,,,,,,,,,,,,,,,,,,,,,,124.0,eng ENG,MF,24.0,6.0,3.0,0.0,0.0,10.0,6.0,1.0,2.0,4.0,9.0,0.0,0.0,0.0,28.0,7.0,13.0,35.0,Matches,124.0,eng ENG,MF,24.0,6.0,234.0,227.0,6.0,5.0,3.0,3.0,2.0,1.0,0.0,0.0,0.0,0.0,173.0,1.0,6.0,Matches,124.0,eng ENG,MF,24.0,6.0,173.0,234.0,73.9,2879.0,850.0,87.0,111.0,78.4,64.0,76.0,84.2,16.0,29.0,55.2,0.0,0.2,0.3,-0.2,2.0,25.0,2.0,0.0,30.0,Matches,160,eng ENG,MF,24,19,538.0,28.0,15.7,6.0,4,66.0,1,15,18.0,15,1.0,3.0,9.0,-6.0,-1.0,-0.47,6.1,11.3,-5.2,-0.88,-0.4,Matches,124.0,eng ENG,MF,24.0,6.0,309.0,13.0,74.0,183.0,54.0,15.0,309.0,6.0,3.0,50.0,3.0,50.0,150.0,616.0,253.0,2.0,1.0,0.0,17.0,4.0,201.0,13.0,Matches,124.0,eng ENG,MF,24.0,6.0,0.0,9.0,2.0,22.2,1.51,0.33,0.0,0.0,15.7,0.0,0.0,0.0,1.2,1.2,0.13,-1.2,-1.2,Matches,124.0,eng ENG,MF,24.0,19.0,4.0,538.0,6.0,0.0,0.0,0.0,0.0,0.0,0.0,3.0,0.0,1.2,1.2,0.2,1.3,2.0,30.0,13.0,0.0,0.0,0.0,0.0,0.0,0.19,0.03,0.22,0.19,0.22,Matches,Tom Davies,DM/M C,24,131,144,England,Everton,9,10,12,8,13,10,10,7,2,10,13,8,14,14,15,14,16,13,14,11,11,14,14,9,13,14,15,17,14,15,13,10,15,12,17,13,13,13,11,7,14,1,2,1,2,3,3,1,1,3,2,1,16,7,4,9,12,14,13,12,1,1,1,10,1,14,18,1,20,14,1,12,1,1,179,70,9,20,13755657,6498,6498,5348,Northern_European,129,1,1998/6/30,0,0,48717.0,,28100152
192,Craig Dawson,West Ham,1990,125.0,eng ENG,DF,32.0,8.0,11.0,7.0,9.0,2.0,0.0,5.0,7.0,71.4,2.0,9.0,6.0,3.0,6.0,17.0,26.0,0.0,Matches,125.0,eng ENG,DF,32.0,8.0,12.0,1.5,10.0,0.0,0.0,1.0,1.0,0.0,1.0,0.12,0.0,0.0,0.0,0.0,1.0,0.0,Matches,,,,,,,,,,,,,,,,,,,,,,,,,,,,,,,,,,,,,,,,,,,,,,,,,,,,,,,,125.0,eng ENG,DF,32.0,8.0,2.0,0.0,0.0,6.0,3.0,0.0,2.0,6.0,7.0,1.0,1.0,0.0,45.0,14.0,7.0,66.7,Matches,125.0,eng ENG,DF,32.0,8.0,310.0,299.0,9.0,8.0,0.0,2.0,2.0,1.0,0.0,0.0,0.0,0.0,245.0,2.0,3.0,Matches,125.0,eng ENG,DF,32.0,8.0,245.0,310.0,79.0,5404.0,2170.0,74.0,86.0,86.0,121.0,137.0,88.3,48.0,79.0,60.8,0.0,0.1,0.1,-0.1,1.0,25.0,0.0,0.0,18.0,Matches,161,eng ENG,DF,32,8,720.0,90.0,21.1,8.0,8,90.0,8,0,,1,0.88,9.0,13.0,-4.0,-0.5,-0.2,9.8,10.8,-1.0,-0.12,-0.03,Matches,125.0,eng ENG,DF,32.0,8.0,380.0,53.0,211.0,142.0,28.0,14.0,380.0,1.0,0.0,0.0,1.0,100.0,193.0,1042.0,600.0,0.0,5.0,0.0,2.0,4.0,216.0,1.0,Matches,125.0,eng ENG,DF,32.0,8.0,0.0,6.0,1.0,16.7,0.75,0.12,0.0,0.0,15.1,0.0,0.0,0.0,0.5,0.5,0.08,-0.5,-0.5,Matches,125.0,eng ENG,DF,32.0,8.0,8.0,720.0,8.0,0.0,0.0,0.0,0.0,0.0,0.0,2.0,0.0,0.5,0.5,0.1,0.6,0.0,18.0,1.0,0.0,0.0,0.0,0.0,0.0,0.06,0.01,0.07,0.06,0.07,Matches,Craig Dawson,D C,32,138,140,England,West Ham United,2,12,9,10,12,2,18,6,4,15,11,10,15,11,15,13,17,11,13,7,13,17,7,13,6,15,15,12,11,10,11,16,18,11,15,15,14,4,14,2,8,3,3,3,1,3,1,2,2,1,1,3,6,18,3,4,10,7,9,8,1,1,20,12,1,1,1,1,1,1,1,1,1,1,188,83,10,20,17487441,6900,6900,4750,Northern_European,135,1,1990/5/6,0,0,57996.0,,90000708
193,Siriki Dembélé,Bournemouth,1996,128.0,ci CIV,FWMF,25.0,1.2,3.0,1.0,2.0,1.0,0.0,0.0,1.0,0.0,1.0,1.0,0.0,1.0,1.0,4.0,1.0,0.0,Matches,128.0,ci CIV,FWMF,25.0,1.2,5.0,4.09,5.0,0.0,0.0,0.0,0.0,0.0,0.0,0.0,0.0,0.0,0.0,0.0,0.0,0.0,Matches,,,,,,,,,,,,,,,,,,,,,,,,,,,,,,,,,,,,,,,,,,,,,,,,,,,,,,,,128.0,ci CIV,FWMF,25.0,1.2,0.0,0.0,0.0,1.0,2.0,0.0,3.0,1.0,1.0,0.0,0.0,0.0,9.0,0.0,4.0,0.0,Matches,128.0,ci CIV,FWMF,25.0,1.2,47.0,45.0,2.0,0.0,0.0,0.0,3.0,2.0,0.0,0.0,0.0,0.0,37.0,0.0,1.0,Matches,128.0,ci CIV,FWMF,25.0,1.2,37.0,47.0,78.7,543.0,223.0,22.0,29.0,75.9,10.0,13.0,76.9,2.0,2.0,100.0,0.0,0.3,0.2,-0.3,4.0,2.0,3.0,2.0,4.0,Matches,165,ci CIV,FWMF,25,6,110.0,18.0,3.2,1.2,0,,0,6,18.0,9,0.17,0.0,2.0,-2.0,-1.64,-0.77,1.4,2.4,-1.0,-0.82,-0.16,Matches,128.0,ci CIV,FWMF,25.0,1.2,71.0,1.0,10.0,30.0,33.0,3.0,71.0,10.0,6.0,60.0,3.0,30.0,47.0,311.0,160.0,5.0,2.0,1.0,9.0,5.0,50.0,11.0,Matches,128.0,ci CIV,FWMF,25.0,1.2,0.0,2.0,2.0,100.0,1.64,1.64,0.0,0.0,16.6,0.0,0.0,0.0,0.2,0.2,0.09,-0.2,-0.2,Matches,128.0,ci CIV,FWMF,25.0,6.0,0.0,110.0,1.2,0.0,0.0,0.0,0.0,0.0,0.0,0.0,0.0,0.2,0.2,0.3,0.5,5.0,4.0,11.0,0.0,0.0,0.0,0.0,0.0,0.15,0.25,0.41,0.15,0.41,Matches,Siriki Dembélé,AM/S RL,25,121,136,"Scotland,Ivory Coast,England",AFC Bournemouth,8,11,16,11,11,7,5,9,2,5,11,9,6,15,12,10,10,11,8,10,6,11,17,5,11,6,10,11,16,15,14,6,12,15,10,8,9,3,12,8,8,1,2,1,2,1,2,1,3,1,3,3,13,12,5,7,11,14,11,11,1,1,1,1,1,1,1,15,1,15,20,13,18,17,173,0,10,20,3727276,6046,5377,3817,African_Caribbean,107,16,1996/9/7,0,0,23198.0,,29199843
194,Leander Dendoncker,Aston Villa,1995,129.0,be BEL,MF,27.0,7.7,19.0,9.0,11.0,6.0,2.0,11.0,22.0,50.0,11.0,19.0,4.0,15.0,10.0,29.0,12.0,0.0,Matches,129.0,be BEL,MF,27.0,7.7,8.0,1.03,6.0,0.0,0.0,1.0,0.0,1.0,0.0,0.0,0.0,0.0,0.0,0.0,0.0,0.0,Matches,,,,,,,,,,,,,,,,,,,,,,,,,,,,,,,,,,,,,,,,,,,,,,,,,,,,,,,,129.0,be BEL,MF,27.0,7.7,0.0,0.0,0.0,1.0,1.0,0.0,2.0,10.0,9.0,0.0,0.0,0.0,36.0,10.0,8.0,55.6,Matches,129.0,be BEL,MF,27.0,7.7,284.0,278.0,5.0,4.0,0.0,0.0,2.0,1.0,0.0,0.0,0.0,0.0,248.0,1.0,5.0,Matches,129.0,be BEL,MF,27.0,7.7,248.0,284.0,87.3,3948.0,809.0,119.0,128.0,93.0,111.0,121.0,91.7,11.0,18.0,61.1,0.0,0.5,0.1,-0.5,5.0,17.0,0.0,0.0,18.0,Matches,167,be BEL,MF,27,20,697.0,35.0,20.4,7.7,7,75.0,2,13,13.0,7,1.55,13.0,11.0,2.0,0.26,0.16,10.7,11.0,-0.4,-0.05,0.02,Matches,129.0,be BEL,MF,27.0,7.7,365.0,21.0,102.0,219.0,46.0,7.0,365.0,5.0,3.0,60.0,2.0,40.0,171.0,852.0,271.0,1.0,6.0,1.0,8.0,3.0,207.0,2.0,Matches,129.0,be BEL,MF,27.0,7.7,0.0,2.0,0.0,0.0,0.26,0.0,0.0,,26.9,0.0,0.0,0.0,0.1,0.1,0.03,-0.1,-0.1,Matches,129.0,be BEL,MF,27.0,20.0,7.0,697.0,7.7,0.0,0.0,0.0,0.0,0.0,0.0,0.0,0.0,0.1,0.1,0.5,0.5,1.0,18.0,2.0,0.0,0.0,0.0,0.0,0.0,0.01,0.06,0.07,0.01,0.07,Matches,Leander Dendoncker,DM/M C,27,135,147,Belgium,Aston Villa,9,9,11,8,11,10,16,11,10,13,14,10,14,11,14,15,14,12,15,11,14,12,10,12,12,13,15,15,13,13,14,15,12,12,14,12,16,12,14,8,13,1,3,2,1,2,2,1,2,1,3,1,15,14,12,10,11,14,11,19,1,1,15,1,1,1,18,1,20,1,1,1,1,1,188,76,9,20,31404762,6950,6600,6000,Northern_European,128,2,1995/4/15,29,1,86994.0,,18057380
195,Emmanuel Dennis,Nott'ham Forest,1997,131.0,ng NGA,FWMF,24.0,8.0,17.0,11.0,5.0,5.0,7.0,8.0,18.0,44.4,10.0,13.0,1.0,12.0,2.0,19.0,6.0,0.0,Matches,131.0,ng NGA,FWMF,24.0,8.0,25.0,3.12,14.0,1.0,2.0,2.0,6.0,0.0,3.0,0.37,2.0,0.0,0.0,0.0,1.0,0.0,Matches,,,,,,,,,,,,,,,,,,,,,,,,,,,,,,,,,,,,,,,,,,,,,,,,,,,,,,,,131.0,ng NGA,FWMF,24.0,8.0,3.0,0.0,0.0,15.0,29.0,4.0,11.0,2.0,11.0,0.0,0.0,0.0,38.0,13.0,16.0,44.8,Matches,131.0,ng NGA,FWMF,24.0,8.0,183.0,178.0,4.0,0.0,0.0,0.0,11.0,3.0,0.0,0.0,0.0,0.0,124.0,1.0,14.0,Matches,131.0,ng NGA,FWMF,24.0,8.0,124.0,183.0,67.8,1860.0,382.0,72.0,93.0,77.4,40.0,58.0,69.0,8.0,11.0,72.7,2.0,0.6,0.4,1.4,7.0,7.0,4.0,2.0,17.0,Matches,169,ng NGA,FWMF,24,19,720.0,38.0,21.1,8.0,6,72.0,0,13,22.0,12,0.26,7.0,17.0,-10.0,-1.25,-0.58,8.1,13.3,-5.2,-0.64,0.02,Matches,131.0,ng NGA,FWMF,24.0,8.0,335.0,5.0,55.0,118.0,177.0,40.0,335.0,54.0,19.0,35.2,26.0,48.1,211.0,1512.0,840.0,24.0,15.0,8.0,32.0,25.0,219.0,63.0,Matches,131.0,ng NGA,FWMF,24.0,8.0,2.0,21.0,7.0,33.3,2.62,0.87,0.1,0.29,13.2,2.0,0.0,0.0,1.9,1.9,0.09,0.1,0.1,Matches,131.0,ng NGA,FWMF,24.0,19.0,6.0,720.0,8.0,2.0,2.0,4.0,2.0,0.0,0.0,3.0,0.0,1.9,1.9,0.6,2.4,24.0,17.0,63.0,0.25,0.25,0.5,0.25,0.5,0.23,0.07,0.3,0.23,0.3,Matches,Emmanuel Dennis,AM RL,24,136,145,Nigeria,Nottingham Forest,9,12,14,13,13,9,9,10,5,6,12,14,8,14,14,12,16,14,10,7,9,12,14,8,10,5,10,10,18,15,12,7,13,18,13,13,8,12,12,5,10,1,3,3,2,3,3,4,4,1,1,3,12,16,8,8,11,7,8,9,1,1,1,1,1,14,1,1,1,15,17,14,20,14,175,66,6,20,21927753,6800,6800,5250,African_Caribbean,130,17,1997/11/15,7,1,46397.0,,71099020
196,Halil Dervişoğlu,Brentford,1999,132.0,tr TUR,MF,22.0,0.1,0.0,0.0,0.0,0.0,0.0,0.0,1.0,0.0,1.0,0.0,0.0,0.0,0.0,0.0,0.0,0.0,Matches,132.0,tr TUR,MF,22.0,0.1,1.0,11.25,0.0,0.0,0.0,1.0,0.0,0.0,1.0,11.25,0.0,0.0,0.0,1.0,0.0,0.0,Matches,,,,,,,,,,,,,,,,,,,,,,,,,,,,,,,,,,,,,,,,,,,,,,,,,,,,,,,,132.0,tr TUR,MF,22.0,0.1,0.0,0.0,0.0,0.0,0.0,0.0,0.0,0.0,0.0,0.0,0.0,0.0,0.0,0.0,0.0,,Matches,132.0,tr TUR,MF,22.0,0.1,0.0,0.0,0.0,0.0,0.0,0.0,0.0,0.0,0.0,0.0,0.0,0.0,0.0,0.0,0.0,Matches,132.0,tr TUR,MF,22.0,0.1,0.0,0.0,,0.0,0.0,0.0,0.0,,0.0,0.0,,0.0,0.0,,0.0,0.0,0.0,0.0,0.0,0.0,0.0,0.0,0.0,Matches,171,tr TUR,MF,22,1,8.0,8.0,0.2,0.1,0,,0,1,8.0,1,1.0,1.0,0.0,1.0,11.25,10.96,0.1,0.1,0.0,-0.25,-0.42,Matches,132.0,tr TUR,MF,22.0,0.1,1.0,0.0,0.0,0.0,1.0,0.0,1.0,0.0,0.0,,0.0,,2.0,13.0,0.0,0.0,0.0,1.0,0.0,1.0,2.0,0.0,Matches,132.0,tr TUR,MF,22.0,0.1,0.0,1.0,0.0,0.0,11.25,0.0,0.0,,31.9,0.0,0.0,0.0,0.0,0.0,0.03,0.0,0.0,Matches,132.0,tr TUR,MF,22.0,1.0,0.0,8.0,0.1,0.0,0.0,0.0,0.0,0.0,0.0,0.0,0.0,0.0,0.0,0.0,0.0,0.0,0.0,0.0,0.0,0.0,0.0,0.0,0.0,0.31,0.0,0.31,0.31,0.31,Matches,Halil Dervişoğlu,AM/S RLC,22,125,144,"Turkey,Holland",Brentford,8,8,15,11,17,8,11,11,5,5,13,11,5,15,9,12,7,13,9,13,12,12,17,7,12,7,12,11,12,13,13,10,13,12,11,11,12,8,12,5,12,1,1,2,3,2,4,3,2,1,3,1,10,13,6,11,13,12,12,12,1,1,1,1,1,1,1,1,1,1,15,18,15,20,183,75,15,20,17027587,6500,6500,5850,North_African__Middle_Eastern,118,3,1999/12/8,13,6,17399.0,Burnley,37071106
197,Ibrahima Diallo,Southampton,1999,134.0,fr FRA,MF,23.0,9.1,25.0,15.0,14.0,10.0,1.0,8.0,14.0,57.1,6.0,11.0,1.0,10.0,6.0,31.0,11.0,0.0,Matches,134.0,fr FRA,MF,23.0,9.1,10.0,1.1,8.0,0.0,1.0,0.0,0.0,1.0,0.0,0.0,0.0,0.0,0.0,0.0,0.0,0.0,Matches,,,,,,,,,,,,,,,,,,,,,,,,,,,,,,,,,,,,,,,,,,,,,,,,,,,,,,,,134.0,fr FRA,MF,23.0,9.1,4.0,0.0,0.0,18.0,7.0,0.0,4.0,6.0,15.0,0.0,0.0,0.0,82.0,15.0,9.0,62.5,Matches,134.0,fr FRA,MF,23.0,9.1,402.0,395.0,7.0,7.0,0.0,2.0,4.0,0.0,0.0,0.0,0.0,0.0,317.0,0.0,9.0,Matches,134.0,fr FRA,MF,23.0,9.1,317.0,402.0,78.9,4768.0,1064.0,181.0,206.0,87.9,112.0,139.0,80.6,16.0,34.0,47.1,0.0,0.1,0.1,-0.1,4.0,24.0,2.0,0.0,28.0,Matches,174,fr FRA,MF,23,18,819.0,46.0,23.9,9.1,11,67.0,4,7,12.0,12,0.83,5.0,19.0,-14.0,-1.54,-0.74,6.2,14.2,-8.0,-0.88,-0.35,Matches,134.0,fr FRA,MF,23.0,9.1,499.0,18.0,128.0,308.0,74.0,4.0,499.0,13.0,8.0,61.5,5.0,38.5,287.0,1445.0,710.0,9.0,4.0,0.0,16.0,9.0,294.0,6.0,Matches,134.0,fr FRA,MF,23.0,9.1,0.0,6.0,0.0,0.0,0.66,0.0,0.0,,28.4,0.0,0.0,0.0,0.2,0.2,0.03,-0.2,-0.2,Matches,134.0,fr FRA,MF,23.0,18.0,11.0,819.0,9.1,0.0,0.0,0.0,0.0,0.0,0.0,4.0,0.0,0.2,0.2,0.1,0.3,9.0,28.0,6.0,0.0,0.0,0.0,0.0,0.0,0.02,0.01,0.04,0.02,0.04,Matches,Ibrahima Diallo,DM/M C,23,132,144,"France,Senegal",Southampton,7,11,13,7,14,7,10,8,7,13,14,8,14,12,12,14,16,13,14,13,13,12,10,8,10,13,15,15,13,14,15,9,17,14,17,12,12,10,10,6,11,1,2,3,3,2,2,3,2,3,3,1,8,14,8,12,9,13,13,18,1,1,10,1,1,1,20,1,18,1,1,1,1,1,179,68,8,20,26913989,6600,6250,5400,African_Caribbean,133,14,1999/3/8,0,0,46397.0,,48036506
198,Ben Doak,Liverpool,2005,141.0,sct SCO,FW,16.0,0.3,3.0,2.0,1.0,2.0,0.0,1.0,1.0,100.0,0.0,1.0,0.0,1.0,0.0,3.0,0.0,0.0,Matches,141.0,sct SCO,FW,16.0,0.3,0.0,0.0,0.0,0.0,0.0,0.0,0.0,0.0,0.0,0.0,0.0,0.0,0.0,0.0,0.0,0.0,Matches,,,,,,,,,,,,,,,,,,,,,,,,,,,,,,,,,,,,,,,,,,,,,,,,,,,,,,,,141.0,sct SCO,FW,16.0,0.3,0.0,0.0,0.0,1.0,1.0,0.0,0.0,0.0,2.0,0.0,0.0,0.0,5.0,0.0,0.0,,Matches,141.0,sct SCO,FW,16.0,0.3,14.0,14.0,0.0,0.0,0.0,0.0,0.0,0.0,0.0,0.0,0.0,0.0,10.0,0.0,1.0,Matches,141.0,sct SCO,FW,16.0,0.3,10.0,14.0,71.4,86.0,17.0,9.0,10.0,90.0,0.0,1.0,0.0,0.0,1.0,0.0,0.0,0.0,0.0,0.0,0.0,0.0,0.0,0.0,1.0,Matches,182,sct SCO,FW,16,2,26.0,13.0,0.8,0.3,0,,0,2,13.0,2,1.5,0.0,1.0,-1.0,-3.46,-4.23,0.1,0.8,-0.6,-2.17,-2.76,Matches,141.0,sct SCO,FW,16.0,0.3,22.0,0.0,4.0,10.0,10.0,2.0,22.0,4.0,0.0,0.0,4.0,100.0,16.0,182.0,51.0,1.0,3.0,2.0,1.0,0.0,15.0,4.0,Matches,141.0,sct SCO,FW,16.0,0.3,0.0,0.0,0.0,,0.0,0.0,,,,0.0,0.0,0.0,0.0,0.0,,0.0,0.0,Matches,141.0,sct SCO,FW,16.0,2.0,0.0,26.0,0.3,0.0,0.0,0.0,0.0,0.0,0.0,0.0,0.0,0.0,0.0,0.0,0.0,1.0,1.0,4.0,0.0,0.0,0.0,0.0,0.0,0.0,0.0,0.0,0.0,0.0,Matches,Ben Doak,M/AM RL,16,83,-9,Scotland,Liverpool,6,9,12,7,13,6,5,6,6,6,11,1,8,13,12,6,8,6,8,8,8,16,13,2,10,2,7,8,13,11,7,8,13,13,8,5,16,12,20,9,12,3,3,1,3,2,3,2,2,2,1,1,19,12,8,11,11,13,10,15,1,1,1,1,1,12,1,1,1,18,15,1,20,1,181,0,9,20,44564025,4164,4164,2028,Northern_European,67,2,2005/11/11,0,0,203.0,,2000164850
199,Matt Doherty,Tottenham,1992,142.0,ie IRL,DFMF,30.0,7.4,16.0,10.0,12.0,3.0,1.0,8.0,10.0,80.0,2.0,11.0,6.0,5.0,8.0,24.0,14.0,1.0,Matches,142.0,ie IRL,DFMF,30.0,7.4,18.0,2.43,13.0,0.0,2.0,2.0,1.0,0.0,3.0,0.41,2.0,0.0,0.0,1.0,0.0,0.0,Matches,,,,,,,,,,,,,,,,,,,,,,,,,,,,,,,,,,,,,,,,,,,,,,,,,,,,,,,,142.0,ie IRL,DFMF,30.0,7.4,0.0,0.0,0.0,11.0,4.0,0.0,18.0,8.0,10.0,0.0,0.0,0.0,31.0,20.0,13.0,60.6,Matches,142.0,ie IRL,DFMF,30.0,7.4,408.0,345.0,61.0,2.0,0.0,1.0,18.0,59.0,0.0,0.0,0.0,0.0,329.0,2.0,8.0,Matches,142.0,ie IRL,DFMF,30.0,7.4,329.0,408.0,80.6,4896.0,1222.0,190.0,204.0,93.1,107.0,137.0,78.1,18.0,35.0,51.4,0.0,0.3,0.3,-0.3,6.0,14.0,5.0,3.0,20.0,Matches,183,ie IRL,DFMF,30,12,667.0,56.0,19.5,7.4,7,82.0,2,5,18.0,9,1.33,12.0,9.0,3.0,0.4,0.27,9.0,8.6,0.4,0.06,-0.17,Matches,142.0,ie IRL,DFMF,30.0,7.4,500.0,27.0,144.0,184.0,172.0,24.0,500.0,12.0,5.0,41.7,4.0,33.3,247.0,953.0,443.0,16.0,5.0,2.0,12.0,3.0,306.0,57.0,Matches,142.0,ie IRL,DFMF,30.0,7.4,1.0,10.0,2.0,20.0,1.35,0.27,0.1,0.5,12.1,0.0,0.0,0.0,0.8,0.8,0.08,0.2,0.2,Matches,142.0,ie IRL,DFMF,30.0,12.0,7.0,667.0,7.4,1.0,0.0,1.0,1.0,0.0,0.0,0.0,0.0,0.8,0.8,0.3,1.0,16.0,20.0,57.0,0.13,0.0,0.13,0.13,0.13,0.1,0.04,0.14,0.1,0.14,Matches,Matt Doherty,D/WB R,30,138,152,Republic of Ireland,Tottenham Hotspur,7,12,15,12,13,10,13,10,13,13,13,8,13,13,11,13,13,13,14,13,14,14,12,12,16,13,14,13,13,11,13,13,15,13,15,14,15,11,12,10,13,3,1,1,4,1,1,1,3,3,2,2,10,12,9,15,13,13,11,10,1,10,10,20,1,20,1,1,1,8,1,1,1,1,186,89,10,20,21514367,6898,7098,5798,Northern_European,137,3,1992/1/17,29,1,86994.0,,52032335
200,Flynn Downes,West Ham,1999,145.0,eng ENG,MF,23.0,8.5,16.0,9.0,4.0,10.0,2.0,6.0,12.0,50.0,6.0,15.0,2.0,13.0,7.0,23.0,6.0,0.0,Matches,145.0,eng ENG,MF,23.0,8.5,13.0,1.54,8.0,0.0,0.0,3.0,2.0,0.0,0.0,0.0,0.0,0.0,0.0,0.0,0.0,0.0,Matches,,,,,,,,,,,,,,,,,,,,,,,,,,,,,,,,,,,,,,,,,,,,,,,,,,,,,,,,145.0,eng ENG,MF,23.0,8.5,2.0,0.0,0.0,8.0,12.0,0.0,3.0,7.0,9.0,0.0,0.0,0.0,44.0,9.0,12.0,42.9,Matches,145.0,eng ENG,MF,23.0,8.5,331.0,323.0,7.0,2.0,0.0,2.0,3.0,0.0,0.0,0.0,0.0,0.0,289.0,1.0,6.0,Matches,145.0,eng ENG,MF,23.0,8.5,289.0,331.0,87.3,4062.0,921.0,183.0,194.0,94.3,86.0,97.0,88.7,10.0,14.0,71.4,0.0,0.1,0.1,-0.1,2.0,25.0,1.0,0.0,22.0,Matches,186,eng ENG,MF,23,21,762.0,36.0,22.3,8.5,7,82.0,2,14,14.0,16,1.19,2.0,14.0,-12.0,-1.42,-1.38,7.4,13.5,-6.2,-0.73,-0.81,Matches,145.0,eng ENG,MF,23.0,8.5,405.0,14.0,74.0,265.0,68.0,5.0,405.0,2.0,1.0,50.0,0.0,0.0,224.0,1041.0,364.0,3.0,5.0,1.0,11.0,6.0,276.0,11.0,Matches,145.0,eng ENG,MF,23.0,8.5,0.0,4.0,1.0,25.0,0.47,0.12,0.0,0.0,14.6,0.0,0.0,0.0,0.4,0.4,0.11,-0.4,-0.4,Matches,145.0,eng ENG,MF,23.0,21.0,7.0,762.0,8.5,0.0,0.0,0.0,0.0,0.0,0.0,2.0,0.0,0.4,0.4,0.1,0.5,3.0,22.0,11.0,0.0,0.0,0.0,0.0,0.0,0.05,0.01,0.06,0.05,0.06,Matches,Flynn Downes,DM/M C,23,124,148,England,West Ham United,9,7,13,8,14,8,9,7,8,12,12,8,14,13,16,15,13,15,13,12,13,15,8,10,9,14,13,15,13,12,14,10,14,13,14,13,15,14,9,11,8,1,3,3,2,3,2,1,2,1,3,1,11,16,14,7,10,15,9,7,1,1,8,1,1,1,18,1,20,1,1,1,1,1,182,0,7,20,12327674,6199,6199,4499,Northern_European,121,6,1999/1/20,0,0,34798.0,,29156436
201,Cody Drameh,Leeds United,2001,147.0,eng ENG,DF,20.0,0.8,5.0,4.0,0.0,4.0,1.0,2.0,3.0,66.7,1.0,0.0,0.0,0.0,1.0,6.0,1.0,0.0,Matches,147.0,eng ENG,DF,20.0,0.8,1.0,1.3,1.0,0.0,0.0,0.0,0.0,0.0,0.0,0.0,0.0,0.0,0.0,0.0,0.0,0.0,Matches,,,,,,,,,,,,,,,,,,,,,,,,,,,,,,,,,,,,,,,,,,,,,,,,,,,,,,,,147.0,eng ENG,DF,20.0,0.8,0.0,0.0,0.0,1.0,0.0,0.0,1.0,1.0,4.0,0.0,0.0,0.0,5.0,1.0,0.0,100.0,Matches,147.0,eng ENG,DF,20.0,0.8,38.0,31.0,7.0,1.0,0.0,0.0,1.0,6.0,0.0,0.0,0.0,0.0,30.0,0.0,1.0,Matches,147.0,eng ENG,DF,20.0,0.8,30.0,38.0,78.9,457.0,153.0,17.0,21.0,81.0,11.0,12.0,91.7,2.0,5.0,40.0,0.0,0.0,0.0,0.0,0.0,2.0,0.0,0.0,2.0,Matches,188,eng ENG,DF,20,1,69.0,69.0,2.0,0.8,1,69.0,0,0,,5,0.0,1.0,3.0,-2.0,-2.61,-1.86,0.5,1.3,-0.8,-1.05,-0.54,Matches,147.0,eng ENG,DF,20.0,0.8,44.0,1.0,7.0,26.0,11.0,0.0,44.0,1.0,1.0,100.0,0.0,0.0,17.0,48.0,10.0,0.0,1.0,0.0,1.0,1.0,23.0,3.0,Matches,147.0,eng ENG,DF,20.0,0.8,0.0,0.0,0.0,,0.0,0.0,,,,0.0,0.0,0.0,0.0,0.0,,0.0,0.0,Matches,147.0,eng ENG,DF,20.0,1.0,1.0,69.0,0.8,0.0,0.0,0.0,0.0,0.0,0.0,0.0,0.0,0.0,0.0,0.0,0.0,0.0,2.0,3.0,0.0,0.0,0.0,0.0,0.0,0.0,0.0,0.0,0.0,0.0,Matches,Cody Drameh,D/WB R,20,118,-75,"England,The Gambia",Leeds United,10,11,12,8,11,6,6,7,9,10,10,9,13,11,12,10,12,11,9,10,9,12,12,11,12,11,12,13,15,12,14,11,16,15,14,11,11,10,8,5,13,1,3,2,2,1,1,3,1,3,2,1,10,9,2,11,11,12,12,12,1,14,1,18,1,20,1,1,1,14,1,1,1,1,175,69,10,20,49412479,5900,5900,3767,African_Caribbean,111,14,2001/12/8,0,0,4640.0,,28122190
202,Martin Dúbravka,Newcastle Utd,1989,148.0,sk SVK,GK,33.0,1.7,0.0,0.0,0.0,0.0,0.0,0.0,1.0,0.0,1.0,0.0,0.0,0.0,0.0,0.0,1.0,0.0,Matches,148.0,sk SVK,GK,33.0,1.7,0.0,0.0,0.0,0.0,0.0,0.0,0.0,0.0,0.0,0.0,0.0,0.0,0.0,0.0,0.0,0.0,Matches,7.0,sk SVK,GK,33.0,1.7,1.0,0.0,0.0,0.0,1.0,1.9,0.21,1.9,1.07,6.0,10.0,60.0,39.0,14.0,10.3,20.7,15.0,40.0,35.3,30.0,1.0,3.3,0.0,0.0,12.4,Matches,7.0,sk SVK,GK,33.0,2.0,1.0,157.0,1.7,1.0,0.57,9.0,9.0,88.9,0.0,1.0,0.0,0.0,0.0,0.0,0.0,0.0,0.0,,Matches,148.0,sk SVK,GK,33.0,1.7,0.0,0.0,0.0,0.0,0.0,0.0,0.0,0.0,0.0,0.0,0.0,0.0,0.0,0.0,0.0,,Matches,148.0,sk SVK,GK,33.0,1.7,54.0,38.0,16.0,1.0,0.0,0.0,0.0,0.0,0.0,0.0,0.0,0.0,49.0,0.0,0.0,Matches,148.0,sk SVK,GK,33.0,1.7,49.0,54.0,90.7,1046.0,696.0,21.0,21.0,100.0,19.0,19.0,100.0,8.0,13.0,61.5,0.0,0.0,0.0,0.0,0.0,1.0,0.0,0.0,0.0,Matches,191,sk SVK,GK,33,2,157.0,79.0,4.6,1.7,1,90.0,1,1,67.0,22,0.5,1.0,1.0,0.0,0.0,-0.97,3.5,3.2,0.3,0.18,-0.7,Matches,148.0,sk SVK,GK,33.0,1.7,59.0,55.0,59.0,0.0,0.0,0.0,59.0,0.0,0.0,,0.0,,38.0,190.0,103.0,0.0,0.0,0.0,0.0,0.0,23.0,0.0,Matches,148.0,sk SVK,GK,33.0,1.7,0.0,0.0,0.0,,0.0,0.0,,,,0.0,0.0,0.0,0.0,0.0,,0.0,0.0,Matches,148.0,sk SVK,GK,33.0,2.0,1.0,157.0,1.7,0.0,0.0,0.0,0.0,0.0,0.0,0.0,0.0,0.0,0.0,0.0,0.0,0.0,0.0,0.0,0.0,0.0,0.0,0.0,0.0,0.0,0.0,0.0,0.0,0.0,Matches,Martin Dúbravka,GK,33,139,150,Slovakia,Newcastle United,1,1,1,1,11,2,3,2,5,5,12,3,3,10,9,15,14,12,10,12,11,15,14,13,3,15,12,10,13,12,13,15,14,9,10,12,15,10,14,8,1,15,14,13,5,14,14,16,17,14,11,11,16,14,4,12,12,15,16,12,20,1,1,1,1,1,1,1,1,1,1,1,1,1,190,83,10,20,12724386,6550,7000,5750,Northern_European,138,4,1989/1/15,29,0,52196.0,Manchester UFC,63002306
203,Shane Duffy,Fulham,1992,149.0,ie IRL,DFFW,30.0,0.2,0.0,0.0,0.0,0.0,0.0,0.0,0.0,,0.0,0.0,0.0,0.0,0.0,0.0,0.0,1.0,Matches,149.0,ie IRL,DFFW,30.0,0.2,0.0,0.0,0.0,0.0,0.0,0.0,0.0,0.0,0.0,0.0,0.0,0.0,0.0,0.0,0.0,0.0,Matches,,,,,,,,,,,,,,,,,,,,,,,,,,,,,,,,,,,,,,,,,,,,,,,,,,,,,,,,149.0,ie IRL,DFFW,30.0,0.2,0.0,0.0,0.0,0.0,1.0,0.0,0.0,0.0,0.0,0.0,0.0,0.0,2.0,2.0,1.0,66.7,Matches,149.0,ie IRL,DFFW,30.0,0.2,20.0,19.0,1.0,0.0,0.0,0.0,0.0,0.0,0.0,0.0,0.0,0.0,16.0,0.0,0.0,Matches,149.0,ie IRL,DFFW,30.0,0.2,16.0,20.0,80.0,308.0,61.0,5.0,5.0,100.0,9.0,10.0,90.0,2.0,4.0,50.0,0.0,0.0,0.0,0.0,0.0,0.0,0.0,0.0,0.0,Matches,192,ie IRL,DFFW,30,5,20.0,4.0,0.6,0.2,0,,0,5,4.0,25,2.0,0.0,4.0,-4.0,-18.0,-18.16,0.3,1.5,-1.2,-5.61,-5.18,Matches,149.0,ie IRL,DFFW,30.0,0.2,22.0,3.0,13.0,9.0,1.0,1.0,22.0,1.0,1.0,100.0,0.0,0.0,9.0,41.0,18.0,0.0,0.0,0.0,1.0,0.0,12.0,0.0,Matches,149.0,ie IRL,DFFW,30.0,0.2,0.0,1.0,0.0,0.0,4.5,0.0,0.0,,6.1,0.0,0.0,0.0,0.2,0.2,0.16,-0.2,-0.2,Matches,149.0,ie IRL,DFFW,30.0,5.0,0.0,20.0,0.2,0.0,0.0,0.0,0.0,0.0,0.0,0.0,0.0,0.2,0.2,0.0,0.2,0.0,0.0,0.0,0.0,0.0,0.0,0.0,0.0,0.7,0.0,0.7,0.7,0.7,Matches,Shane Duffy,D C,30,128,140,"Republic of Ireland,Northern Ireland",Brighton & Hove Albion,3,4,5,7,8,5,16,6,7,14,9,6,16,8,15,14,18,8,14,7,14,17,4,15,6,15,14,15,8,8,8,18,14,9,16,16,15,7,14,2,7,1,1,2,1,3,2,3,1,3,2,2,13,15,13,9,15,13,11,13,1,1,20,1,1,1,1,1,1,1,1,1,1,1,193,77,8,20,6463668,6400,6800,5000,Northern_European,126,2,1992/1/1,55,7,63795.0,Fulham,28027621
204,Jhon Durán,Aston Villa,2003,151.0,co COL,FWMF,18.0,1.5,2.0,2.0,0.0,1.0,1.0,1.0,4.0,25.0,3.0,0.0,0.0,0.0,2.0,4.0,2.0,0.0,Matches,151.0,co COL,FWMF,18.0,1.5,5.0,3.31,3.0,0.0,0.0,1.0,0.0,1.0,0.0,0.0,0.0,0.0,0.0,0.0,0.0,0.0,Matches,,,,,,,,,,,,,,,,,,,,,,,,,,,,,,,,,,,,,,,,,,,,,,,,,,,,,,,,151.0,co COL,FWMF,18.0,1.5,1.0,0.0,0.0,9.0,3.0,3.0,2.0,2.0,2.0,0.0,0.0,0.0,5.0,7.0,10.0,41.2,Matches,151.0,co COL,FWMF,18.0,1.5,29.0,26.0,3.0,0.0,0.0,0.0,2.0,1.0,0.0,0.0,0.0,0.0,16.0,0.0,1.0,Matches,151.0,co COL,FWMF,18.0,1.5,16.0,29.0,55.2,264.0,47.0,8.0,12.0,66.7,7.0,12.0,58.3,1.0,2.0,50.0,0.0,0.0,0.0,0.0,1.0,1.0,1.0,0.0,4.0,Matches,195,co COL,FWMF,18,12,136.0,11.0,4.0,1.5,0,,0,12,11.0,5,1.42,3.0,4.0,-1.0,-0.66,-0.83,1.7,3.8,-2.2,-1.45,-1.45,Matches,151.0,co COL,FWMF,18.0,1.5,57.0,3.0,3.0,26.0,29.0,6.0,57.0,2.0,1.0,50.0,1.0,50.0,33.0,205.0,123.0,4.0,5.0,1.0,8.0,3.0,41.0,13.0,Matches,151.0,co COL,FWMF,18.0,1.5,0.0,7.0,2.0,28.6,4.63,1.32,0.0,0.0,19.8,0.0,0.0,0.0,0.6,0.6,0.08,-0.6,-0.6,Matches,151.0,co COL,FWMF,18.0,12.0,0.0,136.0,1.5,0.0,0.0,0.0,0.0,0.0,0.0,1.0,0.0,0.6,0.6,0.0,0.6,4.0,4.0,13.0,0.0,0.0,0.0,0.0,0.0,0.37,0.02,0.39,0.37,0.39,Matches,Jhon Durán,S,18,108,-85,Colombia,Chicago Fire FC,10,11,12,13,12,10,11,11,4,10,11,7,8,12,13,12,10,10,11,11,11,11,12,12,13,10,12,13,13,13,11,14,13,14,12,14,8,10,11,12,14,1,2,2,3,2,2,1,1,1,2,2,11,10,16,8,12,10,8,12,1,1,1,1,1,1,1,1,1,1,12,1,10,20,185,73,20,8,5911475,5464,5040,3290,African_Caribbean,115,17,2003/12/13,2,0,3238.0,,76063258
205,Malcolm Ebiowei,Crystal Palace,2003,152.0,eng ENG,MFFW,18.0,0.4,1.0,1.0,1.0,0.0,0.0,0.0,1.0,0.0,1.0,2.0,0.0,2.0,0.0,1.0,0.0,0.0,Matches,152.0,eng ENG,MFFW,18.0,0.4,1.0,2.65,1.0,0.0,0.0,0.0,0.0,0.0,0.0,0.0,0.0,0.0,0.0,0.0,0.0,0.0,Matches,,,,,,,,,,,,,,,,,,,,,,,,,,,,,,,,,,,,,,,,,,,,,,,,,,,,,,,,152.0,eng ENG,MFFW,18.0,0.4,0.0,0.0,0.0,0.0,1.0,0.0,3.0,0.0,1.0,0.0,0.0,0.0,0.0,0.0,0.0,,Matches,152.0,eng ENG,MFFW,18.0,0.4,10.0,10.0,0.0,0.0,0.0,0.0,3.0,0.0,0.0,0.0,0.0,0.0,5.0,0.0,2.0,Matches,152.0,eng ENG,MFFW,18.0,0.4,5.0,10.0,50.0,98.0,16.0,2.0,4.0,50.0,2.0,2.0,100.0,1.0,2.0,50.0,0.0,0.0,0.0,0.0,0.0,0.0,0.0,0.0,2.0,Matches,196,eng ENG,MFFW,18,3,34.0,11.0,1.0,0.4,0,,0,3,11.0,14,0.0,0.0,1.0,-1.0,-2.65,-2.43,0.3,0.2,0.1,0.39,0.62,Matches,152.0,eng ENG,MFFW,18.0,0.4,21.0,0.0,1.0,8.0,12.0,2.0,21.0,5.0,2.0,40.0,3.0,60.0,14.0,107.0,30.0,2.0,1.0,0.0,5.0,0.0,15.0,9.0,Matches,152.0,eng ENG,MFFW,18.0,0.4,0.0,0.0,0.0,,0.0,0.0,,,,0.0,0.0,0.0,0.0,0.0,,0.0,0.0,Matches,152.0,eng ENG,MFFW,18.0,3.0,0.0,34.0,0.4,0.0,0.0,0.0,0.0,0.0,0.0,0.0,0.0,0.0,0.0,0.0,0.0,2.0,2.0,9.0,0.0,0.0,0.0,0.0,0.0,0.0,0.0,0.0,0.0,0.0,Matches,Malcolm Ebiowei,AM RL,18,113,-8,"England,Holland,Nigeria",Crystal Palace,10,9,14,10,9,12,8,8,5,6,10,8,9,14,13,11,11,10,10,8,10,14,16,6,9,8,10,10,15,15,14,11,14,15,13,10,12,13,9,7,8,1,2,1,2,3,1,3,1,2,1,3,12,11,4,12,14,13,8,13,1,1,1,1,1,1,1,12,1,14,16,12,20,13,185,74,20,8,25750165,5649,5649,3606,African_Caribbean,108,19,2003/9/4,0,0,11599.0,,2000012801
206,Samuel Edozie,Southampton,2003,155.0,eng ENG,FWMF,19.0,6.3,17.0,10.0,6.0,10.0,1.0,3.0,8.0,37.5,5.0,7.0,0.0,7.0,6.0,23.0,6.0,0.0,Matches,155.0,eng ENG,FWMF,19.0,6.3,20.0,3.18,13.0,0.0,3.0,0.0,4.0,0.0,0.0,0.0,0.0,0.0,0.0,0.0,0.0,0.0,Matches,,,,,,,,,,,,,,,,,,,,,,,,,,,,,,,,,,,,,,,,,,,,,,,,,,,,,,,,155.0,eng ENG,FWMF,19.0,6.3,0.0,0.0,0.0,1.0,22.0,1.0,11.0,6.0,10.0,1.0,0.0,0.0,30.0,6.0,12.0,33.3,Matches,155.0,eng ENG,FWMF,19.0,6.3,164.0,163.0,0.0,0.0,1.0,0.0,11.0,0.0,0.0,0.0,0.0,0.0,111.0,1.0,12.0,Matches,155.0,eng ENG,FWMF,19.0,6.3,111.0,164.0,67.7,1348.0,354.0,75.0,93.0,80.6,22.0,34.0,64.7,5.0,10.0,50.0,0.0,0.4,0.4,-0.4,8.0,6.0,6.0,1.0,13.0,Matches,199,eng ENG,FWMF,19,17,567.0,33.0,16.6,6.3,5,69.0,0,12,19.0,2,0.29,5.0,9.0,-4.0,-0.63,0.41,8.1,7.3,0.8,0.13,0.89,Matches,155.0,eng ENG,FWMF,19.0,6.3,278.0,4.0,48.0,86.0,148.0,32.0,278.0,37.0,12.0,32.4,16.0,43.2,183.0,1551.0,741.0,26.0,21.0,13.0,24.0,12.0,188.0,39.0,Matches,155.0,eng ENG,FWMF,19.0,6.3,0.0,8.0,3.0,37.5,1.27,0.48,0.0,0.0,16.5,0.0,0.0,0.0,0.9,0.9,0.11,-0.9,-0.9,Matches,155.0,eng ENG,FWMF,19.0,17.0,5.0,567.0,6.3,0.0,0.0,0.0,0.0,0.0,0.0,0.0,0.0,0.9,0.9,0.4,1.3,26.0,13.0,39.0,0.0,0.0,0.0,0.0,0.0,0.14,0.06,0.2,0.14,0.2,Matches,Samuel Edozie,AM RL,19,115,-8,"England,Nigeria",Southampton,9,10,15,11,9,11,6,8,4,7,12,7,10,13,5,6,7,7,12,10,12,8,16,6,12,9,12,15,15,14,13,11,13,16,15,9,11,8,8,11,19,3,2,2,2,3,3,2,4,2,4,3,10,9,3,10,9,14,11,13,1,1,1,1,1,1,1,13,1,13,20,1,15,13,183,0,10,20,44192851,5750,5750,4250,Mixed_Race,118,11,2003/1/28,0,0,5800.0,,28126246
207,Anthony Elanga,Manchester Utd,2002,156.0,se SWE,FW,20.0,4.7,3.0,0.0,0.0,2.0,1.0,1.0,2.0,50.0,1.0,4.0,0.0,4.0,2.0,5.0,4.0,0.0,Matches,156.0,se SWE,FW,20.0,4.7,17.0,3.59,13.0,0.0,0.0,3.0,1.0,0.0,1.0,0.21,1.0,0.0,0.0,0.0,0.0,0.0,Matches,,,,,,,,,,,,,,,,,,,,,,,,,,,,,,,,,,,,,,,,,,,,,,,,,,,,,,,,156.0,se SWE,FW,20.0,4.7,0.0,0.0,0.0,3.0,7.0,3.0,7.0,2.0,0.0,0.0,0.0,0.0,17.0,8.0,11.0,42.1,Matches,156.0,se SWE,FW,20.0,4.7,130.0,127.0,3.0,0.0,0.0,1.0,7.0,2.0,0.0,0.0,0.0,0.0,95.0,0.0,2.0,Matches,156.0,se SWE,FW,20.0,4.7,95.0,130.0,73.1,1201.0,298.0,65.0,86.0,75.6,23.0,32.0,71.9,3.0,3.0,100.0,1.0,0.9,1.0,0.1,6.0,3.0,3.0,0.0,8.0,Matches,200,se SWE,FW,20,16,426.0,27.0,12.5,4.7,5,59.0,0,11,12.0,11,2.13,8.0,2.0,6.0,1.27,1.0,9.5,4.7,4.8,1.01,0.63,Matches,156.0,se SWE,FW,20.0,4.7,197.0,4.0,26.0,71.0,100.0,28.0,197.0,15.0,5.0,33.3,7.0,46.7,109.0,656.0,276.0,12.0,3.0,7.0,13.0,7.0,139.0,28.0,Matches,156.0,se SWE,FW,20.0,4.7,0.0,10.0,4.0,40.0,2.11,0.85,0.0,0.0,13.8,0.0,0.0,0.0,0.7,0.7,0.07,-0.7,-0.7,Matches,156.0,se SWE,FW,20.0,16.0,5.0,426.0,4.7,0.0,1.0,1.0,0.0,0.0,0.0,0.0,0.0,0.7,0.7,0.9,1.6,12.0,8.0,28.0,0.0,0.21,0.21,0.0,0.21,0.15,0.19,0.34,0.15,0.34,Matches,Anthony Elanga,M/AM RL,20,130,-75,"Sweden,Cameroon,England",Manchester UFC,5,8,14,13,12,4,10,12,2,1,10,10,6,13,12,10,8,10,9,6,9,4,16,3,13,5,13,14,18,14,11,10,15,18,14,10,12,4,13,6,17,2,2,2,2,4,1,3,1,1,3,1,15,12,6,10,10,11,11,19,1,1,1,1,1,1,1,18,1,15,20,1,16,13,180,71,12,20,65883306,6746,6396,4496,African_Caribbean,122,15,2002/4/27,5,1,46397.0,,28121568
208,Mohamed Elneny,Arsenal,1992,158.0,eg EGY,MF,30.0,1.3,1.0,1.0,1.0,0.0,0.0,1.0,1.0,100.0,0.0,0.0,0.0,0.0,0.0,1.0,0.0,0.0,Matches,158.0,eg EGY,MF,30.0,1.3,0.0,0.0,0.0,0.0,0.0,0.0,0.0,0.0,0.0,0.0,0.0,0.0,0.0,0.0,0.0,0.0,Matches,,,,,,,,,,,,,,,,,,,,,,,,,,,,,,,,,,,,,,,,,,,,,,,,,,,,,,,,158.0,eg EGY,MF,30.0,1.3,0.0,0.0,0.0,1.0,1.0,0.0,0.0,0.0,1.0,0.0,0.0,0.0,10.0,0.0,2.0,0.0,Matches,158.0,eg EGY,MF,30.0,1.3,60.0,58.0,2.0,2.0,0.0,0.0,0.0,0.0,0.0,0.0,0.0,0.0,57.0,0.0,1.0,Matches,158.0,eg EGY,MF,30.0,1.3,57.0,60.0,95.0,1031.0,224.0,23.0,23.0,100.0,27.0,29.0,93.1,6.0,6.0,100.0,0.0,0.0,0.0,0.0,0.0,3.0,2.0,0.0,2.0,Matches,202,eg EGY,MF,30,5,113.0,23.0,3.3,1.3,1,90.0,1,4,6.0,4,3.0,2.0,2.0,0.0,0.0,-1.22,2.6,1.3,1.4,1.09,0.32,Matches,158.0,eg EGY,MF,30.0,1.3,63.0,2.0,11.0,42.0,11.0,0.0,63.0,0.0,0.0,,0.0,,38.0,134.0,37.0,1.0,0.0,0.0,0.0,0.0,49.0,1.0,Matches,158.0,eg EGY,MF,30.0,1.3,0.0,0.0,0.0,,0.0,0.0,,,,0.0,0.0,0.0,0.0,0.0,,0.0,0.0,Matches,158.0,eg EGY,MF,30.0,5.0,1.0,113.0,1.3,0.0,0.0,0.0,0.0,0.0,0.0,0.0,0.0,0.0,0.0,0.0,0.0,1.0,2.0,1.0,0.0,0.0,0.0,0.0,0.0,0.0,0.0,0.0,0.0,0.0,Matches,Mohamed Elneny,DM/M C,30,139,155,Egypt,Arsenal,8,7,11,8,14,8,12,14,8,13,13,13,15,14,12,14,14,14,14,12,14,14,8,11,11,13,18,16,12,12,15,13,18,12,16,15,13,8,12,6,8,3,1,3,3,2,1,1,3,3,2,2,14,14,4,14,14,16,14,17,1,1,12,1,1,1,18,1,20,1,1,1,1,1,180,77,8,20,9837033,6800,7729,6233,North_African__Middle_Eastern,137,11,1992/7/11,92,8,57996.0,,12065054
209,Julio Enciso,Brighton,2004,161.0,py PAR,FWMF,18.0,9.0,13.0,4.0,3.0,6.0,4.0,8.0,13.0,61.5,5.0,9.0,0.0,9.0,4.0,17.0,2.0,0.0,Matches,161.0,py PAR,FWMF,18.0,9.0,45.0,5.02,28.0,0.0,9.0,6.0,2.0,0.0,7.0,0.78,3.0,0.0,2.0,1.0,1.0,0.0,Matches,,,,,,,,,,,,,,,,,,,,,,,,,,,,,,,,,,,,,,,,,,,,,,,,,,,,,,,,161.0,py PAR,FWMF,18.0,9.0,1.0,0.0,0.0,13.0,15.0,3.0,12.0,4.0,4.0,0.0,0.0,0.0,36.0,6.0,8.0,42.9,Matches,161.0,py PAR,FWMF,18.0,9.0,258.0,249.0,8.0,0.0,3.0,1.0,12.0,3.0,0.0,0.0,0.0,0.0,179.0,1.0,5.0,Matches,161.0,py PAR,FWMF,18.0,9.0,179.0,258.0,69.4,2242.0,548.0,126.0,167.0,75.4,45.0,66.0,68.2,3.0,8.0,37.5,2.0,1.7,1.4,0.3,13.0,14.0,9.0,0.0,31.0,Matches,205,py PAR,FWMF,18,20,806.0,40.0,23.6,9.0,7,67.0,1,13,26.0,11,1.75,21.0,12.0,9.0,1.0,0.66,21.4,14.7,6.7,0.75,0.18,Matches,161.0,py PAR,FWMF,18.0,9.0,396.0,2.0,22.0,155.0,228.0,49.0,396.0,64.0,32.0,50.0,25.0,39.1,241.0,1768.0,1013.0,39.0,29.0,17.0,19.0,20.0,292.0,74.0,Matches,161.0,py PAR,FWMF,18.0,9.0,4.0,38.0,18.0,47.4,4.24,2.01,0.11,0.22,19.6,0.0,0.0,0.0,4.0,4.0,0.11,0.0,0.0,Matches,161.0,py PAR,FWMF,18.0,20.0,7.0,806.0,9.0,4.0,2.0,6.0,4.0,0.0,0.0,1.0,0.0,4.0,4.0,1.7,5.7,39.0,31.0,74.0,0.45,0.22,0.67,0.45,0.67,0.45,0.19,0.64,0.45,0.64,Matches,Julio Enciso,AM RL,18,115,-8,Paraguay,Brighton & Hove Albion,9,12,16,11,12,9,7,13,10,6,12,12,6,12,7,6,9,11,9,9,8,11,14,6,11,7,6,13,16,15,10,7,12,13,11,9,8,8,12,5,11,1,2,1,1,3,1,2,3,3,1,1,13,12,8,11,12,11,6,12,1,1,1,1,1,1,1,7,5,7,20,11,15,14,174,72,12,20,69502248,5744,5344,3257,Mediterranean_Hispanic,110,6,2004/1/23,5,0,17399.0,,79034187
210,Wesley Fofana,Leicester City,2000,177.0,fr FRA,DF,21.0,2.0,4.0,2.0,1.0,2.0,1.0,1.0,3.0,33.3,2.0,1.0,1.0,0.0,9.0,13.0,5.0,0.0,Matches,177.0,fr FRA,DF,21.0,2.0,2.0,1.0,1.0,0.0,0.0,0.0,0.0,1.0,0.0,0.0,0.0,0.0,0.0,0.0,0.0,0.0,Matches,,,,,,,,,,,,,,,,,,,,,,,,,,,,,,,,,,,,,,,,,,,,,,,,,,,,,,,,177.0,fr FRA,DF,21.0,2.0,1.0,0.0,0.0,2.0,3.0,1.0,0.0,9.0,2.0,0.0,0.0,0.0,10.0,5.0,6.0,45.5,Matches,177.0,fr FRA,DF,21.0,2.0,140.0,138.0,1.0,1.0,0.0,0.0,0.0,0.0,0.0,0.0,0.0,0.0,117.0,1.0,3.0,Matches,177.0,fr FRA,DF,21.0,2.0,117.0,140.0,83.6,1995.0,559.0,44.0,44.0,100.0,64.0,74.0,86.5,6.0,13.0,46.2,0.0,0.0,0.0,0.0,0.0,16.0,0.0,0.0,6.0,Matches,222,fr FRA,DF,21,2,180.0,90.0,5.3,2.0,2,90.0,2,0,,0,0.5,4.0,6.0,-2.0,-1.0,-0.58,1.1,3.5,-2.4,-1.22,-0.93,Matches,177.0,fr FRA,DF,21.0,2.0,169.0,11.0,68.0,97.0,7.0,3.0,169.0,3.0,2.0,66.7,0.0,0.0,116.0,647.0,365.0,3.0,5.0,2.0,3.0,0.0,115.0,1.0,Matches,177.0,fr FRA,DF,21.0,2.0,0.0,2.0,1.0,50.0,1.0,0.5,0.0,0.0,10.1,0.0,0.0,0.0,0.1,0.1,0.06,-0.1,-0.1,Matches,177.0,fr FRA,DF,21.0,2.0,2.0,180.0,2.0,0.0,0.0,0.0,0.0,0.0,0.0,1.0,0.0,0.1,0.1,0.0,0.1,3.0,6.0,1.0,0.0,0.0,0.0,0.0,0.0,0.06,0.0,0.06,0.06,0.06,Matches,Wesley Fofana,D C,21,151,180,"France,Mali,Ivory Coast",Chelsea,11,6,12,7,12,10,16,5,12,15,12,5,15,14,12,14,13,14,13,12,12,16,10,10,12,15,13,13,15,13,10,16,16,16,15,15,15,10,15,8,8,3,1,1,4,3,4,2,3,1,2,3,14,16,13,8,12,11,12,12,1,1,20,12,1,1,1,1,1,1,1,1,1,1,190,76,10,20,145047192,7650,7250,5750,African_Caribbean,149,15,2000/12/17,0,0,266781.0,,49037900
211,Adam Forshaw,Leeds United,1991,180.0,eng ENG,MF,30.0,5.3,12.0,9.0,5.0,7.0,0.0,7.0,17.0,41.2,10.0,9.0,1.0,8.0,4.0,16.0,2.0,0.0,Matches,180.0,eng ENG,MF,30.0,5.3,16.0,3.0,10.0,6.0,0.0,0.0,0.0,0.0,0.0,0.0,0.0,0.0,0.0,0.0,0.0,0.0,Matches,,,,,,,,,,,,,,,,,,,,,,,,,,,,,,,,,,,,,,,,,,,,,,,,,,,,,,,,180.0,eng ENG,MF,30.0,5.3,0.0,0.0,0.0,6.0,5.0,0.0,20.0,4.0,9.0,0.0,0.0,0.0,37.0,2.0,6.0,25.0,Matches,180.0,eng ENG,MF,30.0,5.3,244.0,222.0,22.0,7.0,0.0,2.0,20.0,2.0,9.0,6.0,2.0,0.0,196.0,0.0,4.0,Matches,180.0,eng ENG,MF,30.0,5.3,196.0,244.0,80.3,3318.0,1127.0,102.0,111.0,91.9,59.0,67.0,88.1,28.0,51.0,54.9,0.0,0.9,0.6,-0.9,8.0,30.0,4.0,2.0,33.0,Matches,225,eng ENG,MF,30,12,479.0,40.0,14.0,5.3,5,68.0,1,7,20.0,4,0.5,4.0,13.0,-9.0,-1.69,-1.05,4.4,12.1,-7.7,-1.45,-1.08,Matches,180.0,eng ENG,MF,30.0,5.3,293.0,7.0,64.0,171.0,62.0,1.0,293.0,11.0,8.0,72.7,3.0,27.3,179.0,1085.0,360.0,4.0,8.0,0.0,6.0,8.0,186.0,7.0,Matches,180.0,eng ENG,MF,30.0,5.3,0.0,1.0,0.0,0.0,0.19,0.0,0.0,,26.4,0.0,0.0,0.0,0.0,0.0,0.03,0.0,0.0,Matches,180.0,eng ENG,MF,30.0,12.0,5.0,479.0,5.3,0.0,0.0,0.0,0.0,0.0,0.0,0.0,0.0,0.0,0.0,0.9,0.9,4.0,33.0,7.0,0.0,0.0,0.0,0.0,0.0,0.01,0.16,0.17,0.01,0.17,Matches,Adam Forshaw,DM/M C,30,132,135,England,Leeds United,11,10,12,5,15,12,6,9,3,10,14,11,11,14,15,16,14,16,14,14,16,16,7,11,13,14,15,15,10,15,14,8,12,10,12,10,13,7,13,17,13,2,3,2,1,3,3,2,3,2,3,1,12,11,7,14,11,15,13,12,1,1,1,1,1,1,18,10,20,12,1,12,7,1,177,71,11,20,11444279,6600,6600,4800,Northern_European,131,1,1991/10/8,0,0,28998.0,,28027622
212,Ryan Fraser,Newcastle Utd,1994,183.0,sct SCO,FW,28.0,3.5,2.0,2.0,0.0,0.0,2.0,2.0,5.0,40.0,3.0,3.0,1.0,2.0,0.0,2.0,3.0,0.0,Matches,183.0,sct SCO,FW,28.0,3.5,8.0,2.3,6.0,1.0,0.0,1.0,0.0,0.0,0.0,0.0,0.0,0.0,0.0,0.0,0.0,0.0,Matches,,,,,,,,,,,,,,,,,,,,,,,,,,,,,,,,,,,,,,,,,,,,,,,,,,,,,,,,183.0,sct SCO,FW,28.0,3.5,1.0,0.0,0.0,3.0,10.0,1.0,13.0,0.0,2.0,0.0,0.0,0.0,14.0,0.0,2.0,0.0,Matches,183.0,sct SCO,FW,28.0,3.5,122.0,112.0,7.0,2.0,0.0,0.0,13.0,2.0,3.0,0.0,1.0,0.0,85.0,3.0,4.0,Matches,183.0,sct SCO,FW,28.0,3.5,85.0,122.0,69.7,1228.0,289.0,50.0,59.0,84.7,28.0,41.0,68.3,3.0,8.0,37.5,0.0,0.4,0.3,-0.4,5.0,4.0,4.0,1.0,9.0,Matches,229,sct SCO,FW,28,8,313.0,39.0,9.2,3.5,3,67.0,0,5,22.0,8,1.63,3.0,3.0,0.0,0.0,-1.01,5.8,3.3,2.5,0.71,-0.15,Matches,183.0,sct SCO,FW,28.0,3.5,147.0,1.0,18.0,51.0,80.0,9.0,147.0,2.0,1.0,50.0,0.0,0.0,94.0,600.0,322.0,8.0,7.0,1.0,7.0,1.0,107.0,23.0,Matches,183.0,sct SCO,FW,28.0,3.5,0.0,6.0,1.0,16.7,1.73,0.29,0.0,0.0,16.6,0.0,0.0,0.0,0.3,0.3,0.05,-0.3,-0.3,Matches,183.0,sct SCO,FW,28.0,8.0,3.0,313.0,3.5,0.0,0.0,0.0,0.0,0.0,0.0,1.0,0.0,0.3,0.3,0.4,0.7,8.0,9.0,23.0,0.0,0.0,0.0,0.0,0.0,0.09,0.11,0.2,0.09,0.2,Matches,Ryan Fraser,M/AM RL,28,134,150,Scotland,Newcastle United,13,14,13,13,13,12,2,12,2,6,14,6,7,12,7,13,13,12,10,11,12,13,12,10,15,10,15,17,15,13,14,3,12,15,12,12,11,5,10,13,16,2,3,3,2,2,1,1,1,3,3,3,11,12,3,12,9,12,13,8,1,1,1,1,10,12,1,18,1,18,20,13,20,13,163,70,9,20,11906084,6695,7095,5495,Northern_European,129,4,1994/2/24,22,4,75395.0,,61036775
213,Ryan Fredericks,Bournemouth,1992,185.0,eng ENG,DF,29.0,5.9,3.0,2.0,2.0,0.0,1.0,1.0,4.0,25.0,3.0,7.0,2.0,5.0,1.0,4.0,27.0,0.0,Matches,185.0,eng ENG,DF,29.0,5.9,5.0,0.84,4.0,0.0,1.0,0.0,0.0,0.0,1.0,0.17,1.0,0.0,0.0,0.0,0.0,0.0,Matches,,,,,,,,,,,,,,,,,,,,,,,,,,,,,,,,,,,,,,,,,,,,,,,,,,,,,,,,185.0,eng ENG,DF,29.0,5.9,1.0,0.0,0.0,3.0,1.0,0.0,15.0,1.0,2.0,0.0,0.0,0.0,13.0,5.0,10.0,33.3,Matches,185.0,eng ENG,DF,29.0,5.9,220.0,177.0,43.0,1.0,0.0,0.0,15.0,42.0,0.0,0.0,0.0,0.0,149.0,0.0,11.0,Matches,185.0,eng ENG,DF,29.0,5.9,149.0,220.0,67.7,2139.0,735.0,85.0,96.0,88.5,55.0,88.0,62.5,4.0,15.0,26.7,0.0,0.1,0.3,-0.1,1.0,5.0,6.0,1.0,15.0,Matches,231,eng ENG,DF,29,12,533.0,44.0,15.6,5.9,5,74.0,1,7,23.0,2,1.0,11.0,11.0,0.0,0.0,1.06,6.7,10.0,-3.3,-0.55,0.14,Matches,185.0,eng ENG,DF,29.0,5.9,279.0,33.0,88.0,109.0,84.0,7.0,279.0,10.0,3.0,30.0,5.0,50.0,120.0,725.0,395.0,13.0,9.0,2.0,4.0,3.0,152.0,28.0,Matches,185.0,eng ENG,DF,29.0,5.9,0.0,0.0,0.0,,0.0,0.0,,,,0.0,0.0,0.0,0.0,0.0,,0.0,0.0,Matches,185.0,eng ENG,DF,29.0,12.0,5.0,533.0,5.9,0.0,0.0,0.0,0.0,0.0,0.0,1.0,0.0,0.0,0.0,0.1,0.1,13.0,15.0,28.0,0.0,0.0,0.0,0.0,0.0,0.0,0.02,0.02,0.0,0.02,Matches,Ryan Fredericks,D/WB/M R,29,129,138,"England,Guyana,Scotland",AFC Bournemouth,5,14,14,7,9,6,10,7,12,11,12,6,13,11,14,12,10,11,12,8,12,12,14,10,14,10,12,14,18,15,10,8,12,17,13,9,12,11,11,8,15,3,1,3,4,3,4,3,1,3,2,2,7,10,11,8,11,11,11,13,1,1,1,20,1,19,1,1,1,16,1,1,15,1,181,80,5,20,11102201,6450,6450,4750,Northern_European,116,11,1992/10/10,0,0,40597.0,,28049316
214,Alejandro Garnacho,Manchester Utd,2004,190.0,ar ARG,FWMF,18.0,6.3,5.0,2.0,2.0,0.0,3.0,1.0,11.0,9.1,10.0,5.0,0.0,5.0,5.0,10.0,3.0,0.0,Matches,190.0,ar ARG,FWMF,18.0,6.3,22.0,3.48,17.0,0.0,3.0,1.0,1.0,0.0,6.0,0.95,5.0,0.0,1.0,0.0,0.0,0.0,Matches,,,,,,,,,,,,,,,,,,,,,,,,,,,,,,,,,,,,,,,,,,,,,,,,,,,,,,,,190.0,ar ARG,FWMF,18.0,6.3,3.0,0.0,0.0,8.0,8.0,3.0,2.0,5.0,2.0,0.0,0.0,0.0,28.0,3.0,10.0,23.1,Matches,190.0,ar ARG,FWMF,18.0,6.3,187.0,187.0,0.0,0.0,0.0,2.0,2.0,0.0,0.0,0.0,0.0,0.0,150.0,0.0,7.0,Matches,190.0,ar ARG,FWMF,18.0,6.3,150.0,187.0,80.2,1802.0,233.0,113.0,131.0,86.3,27.0,30.0,90.0,4.0,5.0,80.0,2.0,1.0,0.9,1.0,3.0,2.0,2.0,0.0,12.0,Matches,238,ar ARG,FWMF,18,19,569.0,30.0,16.6,6.3,5,56.0,0,14,21.0,9,2.05,16.0,13.0,3.0,0.47,0.1,16.9,8.2,8.6,1.37,1.09,Matches,190.0,ar ARG,FWMF,18.0,6.3,305.0,3.0,29.0,84.0,196.0,59.0,305.0,44.0,12.0,27.3,27.0,61.4,220.0,1666.0,896.0,33.0,27.0,28.0,27.0,14.0,235.0,85.0,Matches,190.0,ar ARG,FWMF,18.0,6.3,3.0,24.0,9.0,37.5,3.8,1.42,0.13,0.33,16.3,0.0,0.0,0.0,3.0,3.0,0.13,0.0,0.0,Matches,190.0,ar ARG,FWMF,18.0,19.0,5.0,569.0,6.3,3.0,2.0,5.0,3.0,0.0,0.0,3.0,0.0,3.0,3.0,1.0,4.1,33.0,12.0,85.0,0.47,0.32,0.79,0.47,0.79,0.48,0.16,0.64,0.48,0.64,Matches,Alejandro Garnacho,AM RL,18,119,-85,"Argentina,Spain",Manchester UFC,5,7,15,13,14,5,6,6,2,2,11,11,2,14,10,8,7,13,8,7,9,2,16,4,11,2,8,10,16,14,10,9,8,16,12,8,11,5,13,4,14,3,3,2,4,2,1,2,2,2,3,2,7,13,6,10,10,9,10,19,1,1,1,1,1,1,1,14,1,13,20,14,18,15,180,64,14,20,59851735,6250,5750,4015,Mediterranean_Hispanic,106,2,2004/7/1,0,0,1450.0,,2000035036
215,James Garner,Everton,2001,191.0,eng ENG,MFDF,21.0,8.9,16.0,13.0,4.0,8.0,4.0,9.0,19.0,47.4,10.0,9.0,1.0,8.0,12.0,28.0,13.0,0.0,Matches,191.0,eng ENG,MFDF,21.0,8.9,19.0,2.13,13.0,3.0,1.0,1.0,1.0,0.0,2.0,0.22,2.0,0.0,0.0,0.0,0.0,0.0,Matches,,,,,,,,,,,,,,,,,,,,,,,,,,,,,,,,,,,,,,,,,,,,,,,,,,,,,,,,191.0,eng ENG,MFDF,21.0,8.9,3.0,0.0,0.0,16.0,10.0,1.0,37.0,12.0,13.0,0.0,0.0,0.0,68.0,12.0,10.0,54.5,Matches,191.0,eng ENG,MFDF,21.0,8.9,353.0,310.0,41.0,6.0,0.0,2.0,37.0,16.0,17.0,15.0,2.0,0.0,256.0,2.0,9.0,Matches,191.0,eng ENG,MFDF,21.0,8.9,256.0,353.0,72.5,4066.0,1400.0,131.0,152.0,86.2,99.0,124.0,79.8,16.0,50.0,32.0,1.0,0.5,0.5,0.5,7.0,22.0,6.0,2.0,33.0,Matches,240,eng ENG,MFDF,21,16,804.0,50.0,23.5,8.9,7,88.0,6,9,21.0,5,0.88,12.0,13.0,-1.0,-0.11,0.64,13.3,15.3,-2.1,-0.23,0.4,Matches,191.0,eng ENG,MFDF,21.0,8.9,441.0,22.0,97.0,201.0,150.0,9.0,441.0,14.0,7.0,50.0,6.0,42.9,216.0,1185.0,564.0,8.0,9.0,1.0,11.0,3.0,225.0,18.0,Matches,191.0,eng ENG,MFDF,21.0,8.9,0.0,9.0,3.0,33.3,1.01,0.34,0.0,0.0,22.3,1.0,0.0,0.0,0.8,0.8,0.08,-0.8,-0.8,Matches,191.0,eng ENG,MFDF,21.0,16.0,7.0,804.0,8.9,0.0,1.0,1.0,0.0,0.0,0.0,3.0,0.0,0.8,0.8,0.5,1.3,8.0,33.0,18.0,0.0,0.11,0.11,0.0,0.11,0.09,0.06,0.14,0.09,0.14,Matches,James Garner,DM/M C,21,130,-8,England,Everton,12,13,6,11,14,12,8,13,2,8,15,10,12,14,10,14,11,14,14,14,13,16,5,11,12,13,16,14,11,12,13,12,15,12,16,11,14,7,13,4,14,1,2,1,2,2,3,3,2,2,3,1,7,14,2,13,12,15,14,12,1,1,5,1,1,1,17,1,20,1,1,10,1,1,182,77,10,20,91198502,6500,6500,4500,Northern_European,130,1,2001/3/13,0,0,46397.0,,28115831
216,Joe Gelhardt,Leeds United,2002,193.0,eng ENG,FW,20.0,2.4,6.0,2.0,1.0,3.0,2.0,3.0,5.0,60.0,2.0,5.0,0.0,5.0,0.0,6.0,4.0,0.0,Matches,193.0,eng ENG,FW,20.0,2.4,4.0,1.7,4.0,0.0,0.0,0.0,0.0,0.0,2.0,0.85,2.0,0.0,0.0,0.0,0.0,0.0,Matches,,,,,,,,,,,,,,,,,,,,,,,,,,,,,,,,,,,,,,,,,,,,,,,,,,,,,,,,193.0,eng ENG,FW,20.0,2.4,1.0,0.0,0.0,6.0,8.0,0.0,1.0,0.0,2.0,0.0,0.0,0.0,9.0,5.0,11.0,31.3,Matches,193.0,eng ENG,FW,20.0,2.4,67.0,62.0,3.0,0.0,1.0,0.0,1.0,0.0,0.0,0.0,0.0,0.0,43.0,2.0,4.0,Matches,193.0,eng ENG,FW,20.0,2.4,43.0,67.0,64.2,518.0,118.0,23.0,30.0,76.7,11.0,17.0,64.7,2.0,2.0,100.0,2.0,0.5,0.4,1.5,2.0,3.0,1.0,0.0,6.0,Matches,243,eng ENG,FW,20,15,212.0,14.0,6.2,2.4,1,58.0,0,14,11.0,2,0.8,6.0,3.0,3.0,1.27,2.2,3.7,2.7,1.0,0.43,1.02,Matches,193.0,eng ENG,FW,20.0,2.4,115.0,4.0,10.0,52.0,54.0,14.0,115.0,9.0,1.0,11.1,7.0,77.8,68.0,189.0,66.0,2.0,2.0,2.0,9.0,7.0,84.0,21.0,Matches,193.0,eng ENG,FW,20.0,2.4,0.0,10.0,2.0,20.0,4.25,0.85,0.0,0.0,23.5,1.0,0.0,0.0,0.8,0.8,0.08,-0.8,-0.8,Matches,193.0,eng ENG,FW,20.0,15.0,1.0,212.0,2.4,0.0,2.0,2.0,0.0,0.0,0.0,1.0,0.0,0.8,0.8,0.5,1.3,2.0,6.0,21.0,0.0,0.85,0.85,0.0,0.85,0.36,0.2,0.55,0.36,0.55,Matches,Joe Gelhardt,S C,20,121,-85,England,Leeds United,8,11,14,13,13,10,8,13,4,4,12,10,5,15,15,13,15,14,10,13,12,15,17,4,13,5,13,14,14,13,14,7,11,13,13,13,10,14,9,6,12,3,1,1,3,3,1,3,4,1,1,3,10,14,6,14,14,14,9,11,1,1,1,1,1,1,1,1,8,1,14,15,14,20,176,0,20,12,60199711,6400,6050,4600,Northern_European,121,2,2002/5/4,0,0,5800.0,,222724
217,Saman Ghoddos,Brentford,1993,194.0,ir IRN,MFFW,28.0,1.5,2.0,1.0,0.0,1.0,1.0,1.0,3.0,33.3,2.0,5.0,1.0,4.0,4.0,6.0,2.0,0.0,Matches,194.0,ir IRN,MFFW,28.0,1.5,4.0,2.57,1.0,2.0,0.0,1.0,0.0,0.0,0.0,0.0,0.0,0.0,0.0,0.0,0.0,0.0,Matches,,,,,,,,,,,,,,,,,,,,,,,,,,,,,,,,,,,,,,,,,,,,,,,,,,,,,,,,194.0,ir IRN,MFFW,28.0,1.5,0.0,0.0,0.0,3.0,3.0,0.0,7.0,4.0,1.0,0.0,0.0,0.0,24.0,5.0,4.0,55.6,Matches,194.0,ir IRN,MFFW,28.0,1.5,79.0,68.0,11.0,3.0,1.0,0.0,7.0,3.0,4.0,1.0,3.0,0.0,59.0,0.0,1.0,Matches,194.0,ir IRN,MFFW,28.0,1.5,59.0,79.0,74.7,953.0,286.0,32.0,36.0,88.9,21.0,25.0,84.0,6.0,17.0,35.3,0.0,0.4,0.3,-0.4,4.0,5.0,1.0,0.0,8.0,Matches,244,ir IRN,MFFW,28,15,139.0,9.0,4.1,1.5,0,,0,15,9.0,19,1.53,3.0,5.0,-2.0,-1.29,-1.68,2.6,4.4,-1.8,-1.16,-1.39,Matches,194.0,ir IRN,MFFW,28.0,1.5,98.0,7.0,23.0,38.0,40.0,3.0,98.0,2.0,0.0,0.0,2.0,100.0,42.0,164.0,92.0,1.0,2.0,0.0,3.0,1.0,44.0,6.0,Matches,194.0,ir IRN,MFFW,28.0,1.5,0.0,1.0,1.0,100.0,0.65,0.65,0.0,0.0,19.2,0.0,0.0,0.0,0.0,0.0,0.05,0.0,0.0,Matches,194.0,ir IRN,MFFW,28.0,15.0,0.0,139.0,1.5,0.0,0.0,0.0,0.0,0.0,0.0,0.0,0.0,0.0,0.0,0.4,0.5,1.0,8.0,6.0,0.0,0.0,0.0,0.0,0.0,0.03,0.27,0.3,0.03,0.3,Matches,Saman Ghoddos,AM RLC,28,123,131,"Iran,Sweden",Brentford,13,13,14,12,14,15,7,14,5,6,13,12,6,14,11,12,10,14,13,13,12,13,13,5,13,8,12,11,14,13,13,8,11,13,12,12,11,9,11,10,14,2,3,2,3,2,3,2,2,3,3,2,14,15,4,8,13,13,13,13,1,1,1,1,6,1,1,12,12,12,18,20,17,12,176,75,8,20,3416093,6149,6499,4999,North_African__Middle_Eastern,121,9,1993/9/6,31,2,34798.0,,93033389
218,Morgan Gibbs-White,Wolves,2000,195.0,eng ENG,FWMF,22.0,2.0,3.0,1.0,3.0,0.0,0.0,2.0,4.0,50.0,2.0,2.0,0.0,2.0,1.0,4.0,3.0,0.0,Matches,195.0,eng ENG,FWMF,22.0,2.0,4.0,2.0,2.0,1.0,1.0,0.0,0.0,0.0,0.0,0.0,0.0,0.0,0.0,0.0,0.0,0.0,Matches,,,,,,,,,,,,,,,,,,,,,,,,,,,,,,,,,,,,,,,,,,,,,,,,,,,,,,,,195.0,eng ENG,FWMF,22.0,2.0,1.0,0.0,0.0,3.0,3.0,0.0,8.0,1.0,1.0,0.0,0.0,0.0,14.0,2.0,5.0,28.6,Matches,195.0,eng ENG,FWMF,22.0,2.0,95.0,88.0,7.0,2.0,0.0,1.0,8.0,1.0,4.0,0.0,3.0,0.0,75.0,0.0,2.0,Matches,195.0,eng ENG,FWMF,22.0,2.0,75.0,95.0,78.9,1122.0,345.0,47.0,58.0,81.0,17.0,21.0,81.0,7.0,9.0,77.8,0.0,0.1,0.2,-0.1,1.0,10.0,1.0,0.0,12.0,Matches,245,eng ENG,FWMF,22,2,180.0,90.0,5.3,2.0,2,90.0,2,0,,0,0.5,1.0,2.0,-1.0,-0.5,0.22,2.2,2.3,0.0,-0.02,0.62,Matches,195.0,eng ENG,FWMF,22.0,2.0,119.0,1.0,18.0,53.0,49.0,4.0,119.0,8.0,2.0,25.0,5.0,62.5,62.0,257.0,137.0,4.0,3.0,1.0,3.0,1.0,82.0,12.0,Matches,195.0,eng ENG,FWMF,22.0,2.0,0.0,3.0,1.0,33.3,1.5,0.5,0.0,0.0,11.5,0.0,0.0,0.0,0.7,0.7,0.24,-0.7,-0.7,Matches,195.0,eng ENG,FWMF,22.0,2.0,2.0,180.0,2.0,0.0,0.0,0.0,0.0,0.0,0.0,1.0,0.0,0.7,0.7,0.1,0.8,4.0,12.0,12.0,0.0,0.0,0.0,0.0,0.0,0.36,0.04,0.4,0.36,0.4,Matches,Morgan Gibbs-White,M/AM RC,22,129,155,England,Nottingham Forest,13,12,14,11,14,8,9,11,5,6,15,10,9,15,12,13,9,13,12,16,12,13,16,8,14,8,13,14,13,15,14,10,11,14,12,12,11,11,12,10,12,1,2,3,3,1,2,3,2,3,2,1,11,13,13,13,12,11,12,14,1,1,1,1,1,1,1,1,20,1,12,20,15,10,178,72,8,20,33331385,6450,6450,4750,Mixed_Race,126,12,2000/1/27,0,0,57996.0,,29175220
219,Bryan Gil,Tottenham,2001,197.0,es ESP,MFFW,21.0,1.6,3.0,1.0,3.0,0.0,0.0,0.0,3.0,0.0,3.0,3.0,0.0,3.0,1.0,4.0,1.0,0.0,Matches,197.0,es ESP,MFFW,21.0,1.6,5.0,3.04,4.0,0.0,1.0,0.0,0.0,0.0,3.0,1.82,3.0,0.0,0.0,0.0,0.0,0.0,Matches,,,,,,,,,,,,,,,,,,,,,,,,,,,,,,,,,,,,,,,,,,,,,,,,,,,,,,,,197.0,es ESP,MFFW,21.0,1.6,1.0,0.0,0.0,2.0,2.0,1.0,2.0,1.0,1.0,0.0,0.0,0.0,3.0,0.0,2.0,0.0,Matches,197.0,es ESP,MFFW,21.0,1.6,60.0,57.0,3.0,1.0,0.0,0.0,2.0,1.0,0.0,0.0,0.0,0.0,47.0,0.0,3.0,Matches,197.0,es ESP,MFFW,21.0,1.6,47.0,60.0,78.3,638.0,92.0,26.0,32.0,81.3,14.0,16.0,87.5,2.0,4.0,50.0,1.0,0.2,0.1,0.8,2.0,3.0,2.0,0.0,5.0,Matches,247,es ESP,MFFW,21,4,148.0,37.0,4.3,1.6,2,69.0,0,2,5.0,12,1.5,5.0,1.0,4.0,2.43,2.35,2.3,1.0,1.3,0.79,0.62,Matches,197.0,es ESP,MFFW,21.0,1.6,80.0,1.0,13.0,30.0,37.0,2.0,80.0,5.0,2.0,40.0,3.0,60.0,55.0,337.0,145.0,4.0,3.0,0.0,5.0,3.0,61.0,15.0,Matches,197.0,es ESP,MFFW,21.0,1.6,0.0,2.0,1.0,50.0,1.22,0.61,0.0,0.0,19.4,0.0,0.0,0.0,0.1,0.1,0.05,-0.1,-0.1,Matches,197.0,es ESP,MFFW,21.0,4.0,2.0,148.0,1.6,0.0,1.0,1.0,0.0,0.0,0.0,1.0,0.0,0.1,0.1,0.2,0.3,4.0,5.0,15.0,0.0,0.61,0.61,0.0,0.61,0.06,0.11,0.17,0.06,0.17,Matches,Bryan Gil,M/AM RLC,21,135,-85,Spain,Tottenham Hotspur,10,14,16,13,13,10,8,11,6,6,12,10,5,14,10,13,9,11,11,13,12,15,17,7,14,5,10,12,16,15,14,7,12,14,13,8,12,7,12,10,11,1,1,3,1,3,3,2,3,3,1,2,8,14,6,14,16,16,15,10,1,13,1,1,14,1,1,19,1,14,20,18,15,8,175,69,20,9,82446926,6750,6750,6000,Mediterranean_Hispanic,129,2,2001/2/11,4,0,92793.0,,67260440
220,Billy Gilmour,Brighton,2001,198.0,sct SCO,MF,21.0,5.6,5.0,2.0,2.0,2.0,1.0,2.0,8.0,25.0,6.0,5.0,2.0,3.0,6.0,11.0,5.0,0.0,Matches,198.0,sct SCO,MF,21.0,5.6,14.0,2.48,12.0,0.0,0.0,0.0,1.0,1.0,3.0,0.53,3.0,0.0,0.0,0.0,0.0,0.0,Matches,,,,,,,,,,,,,,,,,,,,,,,,,,,,,,,,,,,,,,,,,,,,,,,,,,,,,,,,198.0,sct SCO,MF,21.0,5.6,1.0,0.0,0.0,8.0,3.0,0.0,2.0,6.0,2.0,0.0,0.0,0.0,35.0,5.0,5.0,50.0,Matches,198.0,sct SCO,MF,21.0,5.6,408.0,403.0,2.0,2.0,2.0,1.0,2.0,0.0,0.0,0.0,0.0,0.0,364.0,3.0,3.0,Matches,198.0,sct SCO,MF,21.0,5.6,364.0,408.0,89.2,5781.0,1399.0,188.0,205.0,91.7,144.0,152.0,94.7,26.0,37.0,70.3,1.0,0.2,0.8,0.8,2.0,30.0,6.0,0.0,35.0,Matches,251,sct SCO,MF,21,14,507.0,36.0,14.8,5.6,7,68.0,2,7,5.0,16,1.79,14.0,8.0,6.0,1.07,0.66,12.5,9.8,2.7,0.48,-0.15,Matches,198.0,sct SCO,MF,21.0,5.6,453.0,15.0,112.0,276.0,71.0,4.0,453.0,6.0,2.0,33.3,2.0,33.3,248.0,1157.0,583.0,5.0,8.0,1.0,6.0,5.0,350.0,4.0,Matches,198.0,sct SCO,MF,21.0,5.6,0.0,6.0,1.0,16.7,1.07,0.18,0.0,0.0,20.1,0.0,0.0,0.0,0.5,0.5,0.09,-0.5,-0.5,Matches,198.0,sct SCO,MF,21.0,14.0,7.0,507.0,5.6,0.0,1.0,1.0,0.0,0.0,0.0,1.0,0.0,0.5,0.5,0.2,0.8,5.0,35.0,4.0,0.0,0.18,0.18,0.0,0.18,0.09,0.04,0.13,0.09,0.13,Matches,Billy Gilmour,DM/M C,21,125,-85,Scotland,Brighton & Hove Albion,13,9,10,9,15,13,6,10,9,6,15,15,11,16,11,15,9,16,12,16,13,15,8,12,11,11,12,13,13,12,9,6,9,12,12,7,11,3,4,9,4,3,3,2,1,3,3,1,2,2,4,1,9,15,2,11,11,16,14,15,1,1,1,1,1,1,19,10,20,12,12,14,14,1,170,65,12,20,65883306,6250,6250,5500,Northern_European,125,4,2001/6/11,15,0,40597.0,,61078265
221,Ben Godfrey,Everton,1998,200.0,eng ENG,DF,24.0,8.9,20.0,11.0,13.0,5.0,2.0,11.0,29.0,37.9,18.0,12.0,6.0,6.0,8.0,28.0,33.0,1.0,Matches,200.0,eng ENG,DF,24.0,8.9,4.0,0.45,4.0,0.0,0.0,0.0,0.0,0.0,2.0,0.22,2.0,0.0,0.0,0.0,0.0,0.0,Matches,,,,,,,,,,,,,,,,,,,,,,,,,,,,,,,,,,,,,,,,,,,,,,,,,,,,,,,,200.0,eng ENG,DF,24.0,8.9,2.0,0.0,0.0,10.0,5.0,1.0,7.0,8.0,11.0,0.0,0.0,0.0,35.0,15.0,17.0,46.9,Matches,200.0,eng ENG,DF,24.0,8.9,281.0,232.0,48.0,1.0,0.0,0.0,7.0,47.0,0.0,0.0,0.0,0.0,182.0,1.0,9.0,Matches,200.0,eng ENG,DF,24.0,8.9,182.0,281.0,64.8,3067.0,1252.0,90.0,111.0,81.1,73.0,111.0,65.8,16.0,41.0,39.0,1.0,0.2,0.1,0.8,3.0,24.0,1.0,1.0,19.0,Matches,253,eng ENG,DF,24,13,802.0,62.0,23.5,8.9,10,75.0,6,3,18.0,5,0.62,10.0,18.0,-8.0,-0.9,-0.38,10.0,17.2,-7.2,-0.81,-0.36,Matches,200.0,eng ENG,DF,24.0,8.9,391.0,55.0,159.0,175.0,63.0,8.0,391.0,8.0,3.0,37.5,3.0,37.5,162.0,830.0,426.0,9.0,8.0,0.0,12.0,3.0,159.0,7.0,Matches,200.0,eng ENG,DF,24.0,8.9,0.0,6.0,0.0,0.0,0.67,0.0,0.0,,13.1,0.0,0.0,0.0,1.2,1.2,0.21,-1.2,-1.2,Matches,200.0,eng ENG,DF,24.0,13.0,10.0,802.0,8.9,0.0,1.0,1.0,0.0,0.0,0.0,2.0,0.0,1.2,1.2,0.2,1.4,9.0,19.0,7.0,0.0,0.11,0.11,0.0,0.11,0.14,0.02,0.16,0.14,0.16,Matches,Ben Godfrey,D RC,24,134,155,England,Everton,5,8,8,9,13,5,13,12,7,13,13,7,15,13,14,11,14,12,13,12,9,15,7,12,11,12,14,17,16,14,15,13,15,17,16,16,11,7,13,5,14,2,1,1,4,1,2,3,1,3,2,1,13,16,1,15,12,17,11,15,1,13,20,16,1,14,15,1,12,1,1,1,1,1,183,77,5,20,33849938,6700,6950,5500,Mixed_Race,130,12,1998/1/15,2,0,75395.0,,29142372
222,João Gomes,Wolves,2001,201.0,br BRA,MF,21.0,7.3,29.0,13.0,14.0,14.0,1.0,13.0,23.0,56.5,10.0,12.0,3.0,9.0,4.0,33.0,11.0,0.0,Matches,201.0,br BRA,MF,21.0,7.3,14.0,1.93,9.0,0.0,1.0,2.0,2.0,0.0,2.0,0.28,1.0,0.0,0.0,1.0,0.0,0.0,Matches,,,,,,,,,,,,,,,,,,,,,,,,,,,,,,,,,,,,,,,,,,,,,,,,,,,,,,,,201.0,br BRA,MF,21.0,7.3,5.0,0.0,0.0,17.0,16.0,0.0,8.0,4.0,13.0,0.0,0.0,0.0,59.0,7.0,4.0,63.6,Matches,201.0,br BRA,MF,21.0,7.3,322.0,307.0,14.0,11.0,0.0,3.0,8.0,1.0,1.0,0.0,0.0,0.0,250.0,1.0,9.0,Matches,201.0,br BRA,MF,21.0,7.3,250.0,322.0,77.6,3832.0,878.0,138.0,159.0,86.8,91.0,121.0,75.2,14.0,24.0,58.3,0.0,0.2,0.1,-0.2,5.0,18.0,0.0,0.0,19.0,Matches,257,br BRA,MF,21,11,653.0,59.0,19.1,7.3,7,80.0,4,4,23.0,6,1.18,10.0,18.0,-8.0,-1.1,-0.48,8.5,14.9,-6.4,-0.89,-0.35,Matches,201.0,br BRA,MF,21.0,7.3,409.0,19.0,118.0,212.0,80.0,5.0,409.0,19.0,8.0,42.1,7.0,36.8,185.0,922.0,416.0,7.0,6.0,1.0,7.0,5.0,223.0,8.0,Matches,201.0,br BRA,MF,21.0,7.3,1.0,4.0,2.0,50.0,0.55,0.28,0.25,0.5,20.7,0.0,0.0,0.0,0.3,0.3,0.08,0.7,0.7,Matches,201.0,br BRA,MF,21.0,11.0,7.0,653.0,7.3,1.0,0.0,1.0,1.0,0.0,0.0,5.0,0.0,0.3,0.3,0.2,0.4,7.0,19.0,8.0,0.14,0.0,0.14,0.14,0.14,0.04,0.02,0.06,0.04,0.06,Matches,João Gomes,DM/M C,21,130,155,Brazil,FLA,10,10,13,11,13,12,10,12,11,14,14,10,15,13,16,13,16,14,13,12,12,16,14,8,14,14,15,15,13,13,12,12,11,13,13,12,12,10,1,10,16,3,1,1,1,1,1,2,3,3,3,1,15,14,5,14,15,14,12,12,1,1,1,12,1,1,20,14,19,12,1,1,1,1,173,74,6,20,11738884,6304,6304,4142,Mixed_Race,132,10,2001/2/12,0,0,11182.0,,19371031
223,Sergio Gómez,Manchester City,2000,204.0,es ESP,DFMF,21.0,3.9,9.0,4.0,6.0,1.0,2.0,5.0,8.0,62.5,3.0,5.0,3.0,2.0,2.0,11.0,9.0,1.0,Matches,204.0,es ESP,DFMF,21.0,3.9,7.0,1.81,6.0,1.0,0.0,0.0,0.0,0.0,1.0,0.26,1.0,0.0,0.0,0.0,0.0,0.0,Matches,,,,,,,,,,,,,,,,,,,,,,,,,,,,,,,,,,,,,,,,,,,,,,,,,,,,,,,,204.0,es ESP,DFMF,21.0,3.9,0.0,0.0,0.0,1.0,2.0,0.0,8.0,2.0,4.0,0.0,0.0,0.0,19.0,3.0,10.0,23.1,Matches,204.0,es ESP,DFMF,21.0,3.9,317.0,287.0,30.0,5.0,0.0,0.0,8.0,22.0,3.0,0.0,3.0,0.0,279.0,0.0,7.0,Matches,204.0,es ESP,DFMF,21.0,3.9,279.0,317.0,88.0,4074.0,977.0,154.0,165.0,93.3,105.0,114.0,92.1,11.0,17.0,64.7,1.0,1.2,1.1,-0.2,5.0,24.0,3.0,0.0,18.0,Matches,260,es ESP,DFMF,21,12,349.0,29.0,10.2,3.9,2,84.0,1,10,18.0,20,2.58,5.0,6.0,-1.0,-0.26,-2.07,6.1,6.7,-0.6,-0.14,-1.52,Matches,204.0,es ESP,DFMF,21.0,3.9,358.0,16.0,75.0,198.0,87.0,10.0,358.0,3.0,0.0,0.0,3.0,100.0,203.0,1018.0,520.0,10.0,10.0,1.0,7.0,3.0,274.0,20.0,Matches,204.0,es ESP,DFMF,21.0,3.9,0.0,7.0,0.0,0.0,1.81,0.0,0.0,,22.1,0.0,0.0,0.0,0.4,0.4,0.05,-0.4,-0.4,Matches,204.0,es ESP,DFMF,21.0,12.0,2.0,349.0,3.9,0.0,1.0,1.0,0.0,0.0,0.0,0.0,0.0,0.4,0.4,1.2,1.5,10.0,18.0,20.0,0.0,0.26,0.26,0.0,0.26,0.09,0.3,0.39,0.09,0.39,Matches,Sergio Gómez,D/WB/AM RL,21,133,158,Spain,Manchester City,15,17,13,10,16,15,5,11,9,10,15,15,9,15,7,10,14,13,13,14,11,12,16,8,12,12,14,15,14,13,7,6,12,14,13,8,10,6,10,8,15,2,3,3,1,2,1,3,2,1,1,2,11,15,7,7,14,13,10,9,1,20,1,1,19,1,1,10,1,8,19,14,15,1,171,68,20,7,37349339,6400,6500,4750,Northern_European,117,3,2000/9/4,0,0,46397.0,,67258414
224,Anthony Gordon,Newcastle Utd,2001,205.0,eng ENG,FWMF,21.0,5.4,14.0,12.0,5.0,7.0,2.0,9.0,20.0,45.0,11.0,9.0,1.0,8.0,2.0,16.0,1.0,1.0,Matches,205.0,eng ENG,FWMF,21.0,5.4,16.0,2.96,10.0,1.0,1.0,1.0,2.0,1.0,1.0,0.18,1.0,0.0,0.0,0.0,0.0,0.0,Matches,,,,,,,,,,,,,,,,,,,,,,,,,,,,,,,,,,,,,,,,,,,,,,,,,,,,,,,,205.0,eng ENG,FWMF,21.0,5.4,1.0,0.0,0.0,7.0,8.0,1.0,9.0,2.0,12.0,0.0,0.0,0.0,25.0,0.0,3.0,0.0,Matches,205.0,eng ENG,FWMF,21.0,5.4,198.0,191.0,4.0,1.0,2.0,0.0,9.0,1.0,2.0,2.0,0.0,0.0,162.0,3.0,4.0,Matches,205.0,eng ENG,FWMF,21.0,5.4,162.0,198.0,81.8,2222.0,547.0,105.0,115.0,91.3,44.0,54.0,81.5,7.0,12.0,58.3,0.0,0.9,0.9,-0.9,6.0,11.0,5.0,0.0,15.0,Matches,263,eng ENG,FWMF,21,16,487.0,30.0,14.2,5.4,4,57.0,0,12,22.0,0,1.63,7.0,5.0,2.0,0.37,-0.64,9.3,7.1,2.2,0.41,-0.52,Matches,205.0,eng ENG,FWMF,21.0,5.4,275.0,5.0,30.0,112.0,135.0,27.0,275.0,21.0,7.0,33.3,13.0,61.9,169.0,1192.0,516.0,20.0,13.0,11.0,19.0,5.0,196.0,45.0,Matches,205.0,eng ENG,FWMF,21.0,5.4,1.0,8.0,2.0,25.0,1.48,0.37,0.13,0.5,14.0,0.0,0.0,0.0,1.7,1.7,0.21,-0.7,-0.7,Matches,205.0,eng ENG,FWMF,21.0,16.0,4.0,487.0,5.4,1.0,0.0,1.0,1.0,0.0,0.0,1.0,0.0,1.7,1.7,0.9,2.6,20.0,15.0,45.0,0.18,0.0,0.18,0.18,0.18,0.31,0.17,0.48,0.31,0.48,Matches,Anthony Gordon,AM RLC,21,131,154,"England,Republic of Ireland,Scotland",Everton,11,13,14,11,13,12,7,13,5,8,12,12,11,13,11,10,10,12,10,11,12,17,15,9,10,6,11,15,15,14,7,11,10,14,14,9,10,7,8,11,5,1,1,3,1,1,1,1,2,1,1,3,9,16,8,12,12,14,12,13,1,1,1,1,1,1,1,1,1,1,18,17,20,15,183,0,10,20,59569003,6996,6996,5496,Northern_European,125,1,2001/2/24,0,0,11599.0,,28116386
225,Sam Greenwood,Leeds United,2002,209.0,eng ENG,MFFW,20.0,4.7,15.0,7.0,7.0,8.0,0.0,8.0,21.0,38.1,13.0,10.0,2.0,8.0,1.0,16.0,1.0,0.0,Matches,209.0,eng ENG,MFFW,20.0,4.7,24.0,5.11,5.0,18.0,0.0,1.0,0.0,0.0,3.0,0.64,0.0,2.0,0.0,1.0,0.0,0.0,Matches,,,,,,,,,,,,,,,,,,,,,,,,,,,,,,,,,,,,,,,,,,,,,,,,,,,,,,,,209.0,eng ENG,MFFW,20.0,4.7,1.0,0.0,0.0,11.0,3.0,0.0,43.0,1.0,7.0,0.0,0.0,0.0,31.0,1.0,7.0,12.5,Matches,209.0,eng ENG,MFFW,20.0,4.7,186.0,143.0,43.0,15.0,0.0,1.0,43.0,2.0,26.0,13.0,13.0,0.0,107.0,0.0,2.0,Matches,209.0,eng ENG,MFFW,20.0,4.7,107.0,186.0,57.5,1951.0,888.0,55.0,64.0,85.9,28.0,58.0,48.3,21.0,57.0,36.8,2.0,1.1,1.1,0.9,13.0,14.0,1.0,0.0,15.0,Matches,270,eng ENG,MFFW,20,18,424.0,24.0,12.4,4.7,3,70.0,1,15,14.0,18,0.72,10.0,11.0,-1.0,-0.21,0.66,8.5,11.4,-2.9,-0.62,-0.12,Matches,209.0,eng ENG,MFFW,20.0,4.7,255.0,7.0,45.0,112.0,103.0,5.0,255.0,8.0,3.0,37.5,4.0,50.0,117.0,578.0,305.0,7.0,8.0,1.0,6.0,7.0,119.0,10.0,Matches,209.0,eng ENG,MFFW,20.0,4.7,1.0,12.0,2.0,16.7,2.55,0.42,0.08,0.5,24.2,5.0,0.0,0.0,0.7,0.7,0.06,0.3,0.3,Matches,209.0,eng ENG,MFFW,20.0,18.0,3.0,424.0,4.7,1.0,2.0,3.0,1.0,0.0,0.0,1.0,0.0,0.7,0.7,1.1,1.8,7.0,15.0,10.0,0.21,0.42,0.64,0.21,0.64,0.15,0.24,0.39,0.15,0.39,Matches,Sam Greenwood,M/AM/S RLC,20,120,-75,England,Leeds United,11,9,11,14,12,14,10,10,3,6,12,13,7,12,12,11,11,11,11,10,8,13,13,8,13,9,13,12,14,12,10,10,13,13,13,8,12,7,9,5,14,1,1,3,2,2,2,2,2,2,2,3,19,11,5,13,14,12,11,11,1,1,1,1,1,1,4,1,17,1,15,16,16,20,180,0,16,20,41652632,6000,6000,4000,Northern_European,112,2,2002/1/26,0,0,3480.0,,28122040
226,Gonçalo Guedes,Wolves,1996,212.0,pt POR,FWMF,25.0,7.9,8.0,6.0,4.0,3.0,1.0,5.0,8.0,62.5,3.0,4.0,0.0,4.0,1.0,9.0,2.0,0.0,Matches,212.0,pt POR,FWMF,25.0,7.9,27.0,3.44,15.0,3.0,1.0,2.0,5.0,1.0,1.0,0.13,1.0,0.0,0.0,0.0,0.0,0.0,Matches,,,,,,,,,,,,,,,,,,,,,,,,,,,,,,,,,,,,,,,,,,,,,,,,,,,,,,,,212.0,pt POR,FWMF,25.0,7.9,1.0,0.0,0.0,11.0,24.0,5.0,27.0,1.0,6.0,0.0,0.0,0.0,34.0,7.0,11.0,38.9,Matches,212.0,pt POR,FWMF,25.0,7.9,201.0,182.0,19.0,2.0,0.0,4.0,27.0,2.0,14.0,3.0,8.0,2.0,138.0,0.0,8.0,Matches,212.0,pt POR,FWMF,25.0,7.9,138.0,201.0,68.7,2297.0,526.0,82.0,97.0,84.5,40.0,56.0,71.4,13.0,26.0,50.0,1.0,0.5,0.5,0.5,9.0,11.0,8.0,2.0,16.0,Matches,274,pt POR,FWMF,25,13,707.0,54.0,20.7,7.9,8,71.0,1,5,27.0,4,0.77,4.0,12.0,-8.0,-1.02,-0.39,5.7,11.7,-6.0,-0.76,-0.2,Matches,212.0,pt POR,FWMF,25.0,7.9,280.0,3.0,28.0,105.0,153.0,30.0,280.0,15.0,5.0,33.3,7.0,46.7,174.0,1303.0,644.0,20.0,12.0,7.0,17.0,7.0,199.0,54.0,Matches,212.0,pt POR,FWMF,25.0,7.9,1.0,19.0,6.0,31.6,2.42,0.76,0.05,0.17,18.4,1.0,0.0,0.0,1.2,1.2,0.06,-0.2,-0.2,Matches,212.0,pt POR,FWMF,25.0,13.0,8.0,707.0,7.9,1.0,1.0,2.0,1.0,0.0,0.0,1.0,0.0,1.2,1.2,0.5,1.7,20.0,16.0,54.0,0.13,0.13,0.25,0.13,0.25,0.15,0.06,0.22,0.15,0.22,Matches,Gonçalo Guedes,M/AM/S RLC,25,156,162,Portugal,Wolverhampton Wanderers,10,13,14,13,12,12,8,15,12,7,13,13,7,14,12,13,13,11,12,12,11,13,15,7,14,12,11,13,16,15,13,10,15,16,15,12,12,8,10,10,11,3,2,3,3,1,1,2,3,2,2,1,13,13,7,15,9,13,17,13,1,1,1,1,1,1,1,19,1,17,20,18,18,18,179,68,10,20,82934091,7800,7500,5750,Mediterranean_Hispanic,142,6,1996/11/29,32,7,104393.0,,55041710
227,Darko Gyabi,Leeds United,2004,216.0,eng ENG,FW,18.0,0.1,2.0,2.0,1.0,1.0,0.0,0.0,0.0,,0.0,2.0,0.0,2.0,0.0,2.0,0.0,0.0,Matches,216.0,eng ENG,FW,18.0,0.1,0.0,0.0,0.0,0.0,0.0,0.0,0.0,0.0,0.0,0.0,0.0,0.0,0.0,0.0,0.0,0.0,Matches,,,,,,,,,,,,,,,,,,,,,,,,,,,,,,,,,,,,,,,,,,,,,,,,,,,,,,,,216.0,eng ENG,FW,18.0,0.1,0.0,0.0,0.0,0.0,1.0,0.0,0.0,0.0,2.0,0.0,0.0,0.0,3.0,0.0,0.0,,Matches,216.0,eng ENG,FW,18.0,0.1,4.0,4.0,0.0,0.0,0.0,0.0,0.0,0.0,0.0,0.0,0.0,0.0,4.0,0.0,0.0,Matches,216.0,eng ENG,FW,18.0,0.1,4.0,4.0,100.0,72.0,17.0,1.0,1.0,100.0,3.0,3.0,100.0,0.0,0.0,,0.0,0.0,0.0,0.0,0.0,0.0,0.0,0.0,2.0,Matches,278,eng ENG,FW,18,1,8.0,8.0,0.2,0.1,0,,0,1,8.0,12,0.0,0.0,0.0,0.0,0.0,0.79,0.1,0.3,-0.2,-2.3,-1.79,Matches,216.0,eng ENG,FW,18.0,0.1,8.0,0.0,1.0,4.0,3.0,1.0,8.0,1.0,0.0,0.0,0.0,0.0,4.0,5.0,3.0,0.0,0.0,0.0,1.0,0.0,2.0,0.0,Matches,216.0,eng ENG,FW,18.0,0.1,0.0,1.0,0.0,0.0,11.25,0.0,0.0,,17.8,0.0,0.0,0.0,0.1,0.1,0.06,-0.1,-0.1,Matches,216.0,eng ENG,FW,18.0,1.0,0.0,8.0,0.1,0.0,0.0,0.0,0.0,0.0,0.0,0.0,0.0,0.1,0.1,0.0,0.1,0.0,2.0,0.0,0.0,0.0,0.0,0.0,0.0,0.72,0.0,0.72,0.72,0.72,Matches,Darko Gyabi,M C,18,90,-75,England,Leeds United,7,7,11,11,13,5,3,8,2,5,13,7,11,8,15,11,9,9,9,9,13,12,8,1,12,11,12,12,13,10,5,12,13,13,11,6,11,13,18,12,15,1,3,1,4,1,2,1,1,1,2,1,20,11,8,10,11,11,11,12,1,1,1,1,1,1,13,1,20,1,1,15,1,1,195,0,12,20,20252157,4491,4491,2242,African_Caribbean,86,19,2004/2/18,0,0,5800.0,,2000017219
228,Lewis Hall,Chelsea,2004,218.0,eng ENG,DF,17.0,7.3,23.0,12.0,19.0,4.0,0.0,15.0,22.0,68.2,7.0,8.0,0.0,8.0,11.0,34.0,11.0,1.0,Matches,218.0,eng ENG,DF,17.0,7.3,25.0,3.44,13.0,6.0,2.0,2.0,2.0,0.0,0.0,0.0,0.0,0.0,0.0,0.0,0.0,0.0,Matches,,,,,,,,,,,,,,,,,,,,,,,,,,,,,,,,,,,,,,,,,,,,,,,,,,,,,,,,218.0,eng ENG,DF,17.0,7.3,1.0,0.0,0.0,3.0,11.0,1.0,34.0,11.0,12.0,0.0,0.0,0.0,48.0,7.0,5.0,58.3,Matches,218.0,eng ENG,DF,17.0,7.3,427.0,369.0,57.0,7.0,0.0,3.0,34.0,37.0,13.0,12.0,0.0,0.0,343.0,1.0,8.0,Matches,218.0,eng ENG,DF,17.0,7.3,343.0,427.0,80.3,5932.0,1759.0,182.0,202.0,90.1,121.0,150.0,80.7,38.0,58.0,65.5,0.0,2.2,1.4,-2.2,14.0,25.0,9.0,4.0,25.0,Matches,280,eng ENG,DF,17,9,654.0,73.0,19.1,7.3,8,79.0,3,1,23.0,5,0.67,6.0,11.0,-5.0,-0.69,-0.56,10.6,13.1,-2.5,-0.34,-0.33,Matches,218.0,eng ENG,DF,17.0,7.3,533.0,22.0,165.0,207.0,167.0,21.0,533.0,27.0,11.0,40.7,13.0,48.1,320.0,1627.0,848.0,19.0,9.0,6.0,16.0,7.0,351.0,40.0,Matches,218.0,eng ENG,DF,17.0,7.3,0.0,11.0,5.0,45.5,1.51,0.69,0.0,0.0,15.0,0.0,0.0,0.0,0.9,0.9,0.08,-0.9,-0.9,Matches,218.0,eng ENG,DF,17.0,9.0,8.0,654.0,7.3,0.0,0.0,0.0,0.0,0.0,0.0,1.0,0.0,0.9,0.9,2.2,3.1,19.0,25.0,40.0,0.0,0.0,0.0,0.0,0.0,0.12,0.3,0.42,0.12,0.42,Matches,Lewis Hall,WB/DM/M LC,17,103,-8,England,Chelsea,10,11,8,9,11,13,11,11,7,8,12,16,12,10,10,9,14,12,10,12,12,7,9,10,8,8,13,15,13,7,10,8,15,12,10,9,16,8,12,11,13,1,3,3,3,3,3,1,3,4,3,1,19,12,4,10,9,11,12,20,1,15,15,1,17,1,18,13,20,1,13,15,1,1,177,0,20,10,43148926,5149,5149,4256,Northern_European,93,1,2004/9/8,0,0,11599.0,,2000108691
229,Luke Harris,Fulham,2005,219.0,wls WAL,MFFW,17.0,0.1,0.0,0.0,0.0,0.0,0.0,0.0,0.0,,0.0,0.0,0.0,0.0,0.0,0.0,0.0,0.0,Matches,219.0,wls WAL,MFFW,17.0,0.1,0.0,0.0,0.0,0.0,0.0,0.0,0.0,0.0,0.0,0.0,0.0,0.0,0.0,0.0,0.0,0.0,Matches,,,,,,,,,,,,,,,,,,,,,,,,,,,,,,,,,,,,,,,,,,,,,,,,,,,,,,,,219.0,wls WAL,MFFW,17.0,0.1,0.0,0.0,0.0,1.0,0.0,0.0,1.0,0.0,0.0,0.0,0.0,0.0,0.0,0.0,0.0,,Matches,219.0,wls WAL,MFFW,17.0,0.1,14.0,14.0,0.0,0.0,0.0,0.0,1.0,0.0,0.0,0.0,0.0,0.0,13.0,0.0,0.0,Matches,219.0,wls WAL,MFFW,17.0,0.1,13.0,14.0,92.9,172.0,25.0,9.0,9.0,100.0,4.0,5.0,80.0,0.0,0.0,,0.0,0.0,0.0,0.0,0.0,1.0,0.0,0.0,1.0,Matches,282,wls WAL,MFFW,17,3,13.0,4.0,0.4,0.1,0,,0,3,4.0,20,2.0,0.0,1.0,-1.0,-6.92,-7.0,0.3,1.2,-0.8,-5.88,-5.44,Matches,219.0,wls WAL,MFFW,17.0,0.1,14.0,0.0,0.0,8.0,6.0,0.0,14.0,0.0,0.0,,0.0,,9.0,46.0,14.0,0.0,0.0,0.0,0.0,1.0,13.0,0.0,Matches,219.0,wls WAL,MFFW,17.0,0.1,0.0,0.0,0.0,,0.0,0.0,,,,0.0,0.0,0.0,0.0,0.0,,0.0,0.0,Matches,219.0,wls WAL,MFFW,17.0,3.0,0.0,13.0,0.1,0.0,0.0,0.0,0.0,0.0,0.0,0.0,0.0,0.0,0.0,0.0,0.0,0.0,1.0,0.0,0.0,0.0,0.0,0.0,0.0,0.0,0.0,0.0,0.0,0.0,Matches,Luke Harris,M/AM C,17,93,-8,"Wales,England",Fulham,12,11,12,14,8,10,5,10,4,8,13,9,8,10,5,10,9,10,11,10,10,15,12,10,11,6,10,12,15,7,11,9,11,12,11,10,10,10,10,5,16,1,1,3,4,1,3,2,1,2,1,2,12,12,4,11,13,10,13,17,1,1,1,1,1,1,1,1,16,1,12,20,12,1,177,0,11,20,38509256,4650,4650,2500,Northern_European,91,5,2005/4/3,0,0,2320.0,,2000141316
230,Jan Paul van Hecke,Brighton,2000,222.0,nl NED,DF,22.0,3.3,8.0,6.0,3.0,4.0,1.0,5.0,5.0,100.0,0.0,8.0,5.0,3.0,6.0,14.0,9.0,0.0,Matches,222.0,nl NED,DF,22.0,3.3,2.0,0.61,2.0,0.0,0.0,0.0,0.0,0.0,0.0,0.0,0.0,0.0,0.0,0.0,0.0,0.0,Matches,,,,,,,,,,,,,,,,,,,,,,,,,,,,,,,,,,,,,,,,,,,,,,,,,,,,,,,,222.0,nl NED,DF,22.0,3.3,2.0,0.0,0.0,7.0,4.0,0.0,0.0,6.0,6.0,0.0,0.0,0.0,15.0,6.0,15.0,28.6,Matches,222.0,nl NED,DF,22.0,3.3,248.0,242.0,5.0,4.0,0.0,0.0,0.0,1.0,0.0,0.0,0.0,0.0,232.0,1.0,3.0,Matches,222.0,nl NED,DF,22.0,3.3,232.0,248.0,93.5,4285.0,1480.0,72.0,76.0,94.7,144.0,148.0,97.3,12.0,15.0,80.0,0.0,0.0,0.0,0.0,0.0,22.0,0.0,0.0,21.0,Matches,286,nl NED,DF,22,8,295.0,37.0,8.6,3.3,3,86.0,2,5,8.0,24,1.5,3.0,7.0,-4.0,-1.22,-1.88,4.6,6.9,-2.3,-0.7,-1.43,Matches,222.0,nl NED,DF,22.0,3.3,288.0,27.0,120.0,155.0,13.0,2.0,288.0,0.0,0.0,,0.0,,187.0,1104.0,635.0,3.0,5.0,0.0,1.0,0.0,213.0,0.0,Matches,222.0,nl NED,DF,22.0,3.3,0.0,2.0,0.0,0.0,0.61,0.0,0.0,,16.3,0.0,0.0,0.0,0.6,0.6,0.3,-0.6,-0.6,Matches,222.0,nl NED,DF,22.0,8.0,3.0,295.0,3.3,0.0,0.0,0.0,0.0,0.0,0.0,2.0,0.0,0.6,0.6,0.0,0.6,3.0,21.0,0.0,0.0,0.0,0.0,0.0,0.0,0.18,0.0,0.18,0.18,0.18,Matches,Jan Paul van Hecke,D C,22,124,156,Holland,Brighton & Hove Albion,3,5,11,5,11,3,15,3,5,15,12,5,17,12,17,11,15,14,11,10,11,15,7,12,6,14,12,12,11,12,14,15,14,12,14,14,13,13,13,4,7,3,2,1,4,3,3,2,2,1,3,3,11,13,5,10,15,15,15,13,1,1,20,11,1,6,10,1,1,1,1,1,1,1,189,78,7,20,23940694,6193,6193,3994,Northern_European,122,1,2000/6/8,0,0,4640.0,,37076335
231,Rob Holding,Arsenal,1995,232.0,eng ENG,DF,26.0,6.3,8.0,5.0,4.0,4.0,0.0,3.0,6.0,50.0,3.0,6.0,5.0,1.0,3.0,11.0,27.0,1.0,Matches,232.0,eng ENG,DF,26.0,6.3,6.0,0.95,4.0,0.0,1.0,1.0,0.0,0.0,0.0,0.0,0.0,0.0,0.0,0.0,0.0,0.0,Matches,,,,,,,,,,,,,,,,,,,,,,,,,,,,,,,,,,,,,,,,,,,,,,,,,,,,,,,,232.0,eng ENG,DF,26.0,6.3,0.0,0.0,0.0,5.0,2.0,0.0,0.0,3.0,5.0,0.0,1.0,0.0,40.0,22.0,17.0,56.4,Matches,232.0,eng ENG,DF,26.0,6.3,442.0,430.0,10.0,8.0,1.0,2.0,0.0,2.0,0.0,0.0,0.0,0.0,382.0,2.0,3.0,Matches,232.0,eng ENG,DF,26.0,6.3,382.0,442.0,86.4,7494.0,2701.0,141.0,152.0,92.8,191.0,207.0,92.3,46.0,69.0,66.7,0.0,0.0,0.1,0.0,0.0,23.0,1.0,0.0,24.0,Matches,298,eng ENG,DF,26,14,566.0,40.0,16.5,6.3,6,90.0,6,8,3.0,24,2.36,17.0,13.0,4.0,0.64,-0.66,13.5,11.5,2.0,0.32,-0.56,Matches,232.0,eng ENG,DF,26.0,6.3,499.0,58.0,240.0,245.0,15.0,7.0,499.0,1.0,1.0,100.0,0.0,0.0,319.0,1466.0,881.0,3.0,1.0,1.0,3.0,0.0,339.0,2.0,Matches,232.0,eng ENG,DF,26.0,6.3,1.0,5.0,2.0,40.0,0.8,0.32,0.2,0.5,12.8,0.0,0.0,0.0,0.3,0.3,0.07,0.7,0.7,Matches,232.0,eng ENG,DF,26.0,14.0,6.0,566.0,6.3,1.0,0.0,1.0,1.0,0.0,0.0,0.0,0.0,0.3,0.3,0.0,0.3,3.0,24.0,2.0,0.16,0.0,0.16,0.16,0.16,0.05,0.0,0.05,0.05,0.05,Matches,Rob Holding,D C,26,136,155,England,Arsenal,2,6,10,5,13,6,14,5,11,15,12,5,15,12,13,14,15,13,13,12,13,14,8,13,5,14,16,15,13,13,14,15,14,13,15,13,13,12,12,10,10,2,1,3,1,4,2,2,3,4,2,1,11,12,5,12,14,14,14,14,1,1,20,10,1,8,1,1,1,1,1,1,1,1,188,0,8,20,20183497,6800,6800,6000,Northern_European,137,6,1995/9/20,0,0,46397.0,,29108071
232,Mason Holgate,Everton,1996,233.0,eng ENG,DF,25.0,5.6,11.0,7.0,8.0,3.0,0.0,3.0,11.0,27.3,8.0,7.0,3.0,4.0,7.0,18.0,28.0,0.0,Matches,233.0,eng ENG,DF,25.0,5.6,11.0,1.95,8.0,2.0,0.0,1.0,0.0,0.0,2.0,0.36,2.0,0.0,0.0,0.0,0.0,0.0,Matches,,,,,,,,,,,,,,,,,,,,,,,,,,,,,,,,,,,,,,,,,,,,,,,,,,,,,,,,233.0,eng ENG,DF,25.0,5.6,3.0,1.0,1.0,9.0,4.0,0.0,2.0,7.0,7.0,0.0,0.0,0.0,23.0,9.0,10.0,47.4,Matches,233.0,eng ENG,DF,25.0,5.6,217.0,191.0,24.0,7.0,1.0,5.0,2.0,17.0,0.0,0.0,0.0,0.0,143.0,2.0,2.0,Matches,233.0,eng ENG,DF,25.0,5.6,143.0,217.0,65.9,2843.0,831.0,51.0,63.0,81.0,69.0,87.0,79.3,21.0,58.0,36.2,0.0,0.4,0.2,-0.4,6.0,12.0,3.0,1.0,14.0,Matches,299,eng ENG,DF,25,8,507.0,63.0,14.8,5.6,5,76.0,2,3,42.0,20,0.5,4.0,9.0,-5.0,-0.89,-0.33,6.8,8.6,-1.7,-0.31,0.26,Matches,233.0,eng ENG,DF,25.0,5.6,286.0,35.0,120.0,139.0,27.0,5.0,286.0,3.0,3.0,100.0,0.0,0.0,100.0,450.0,279.0,4.0,3.0,0.0,6.0,0.0,141.0,5.0,Matches,233.0,eng ENG,DF,25.0,5.6,0.0,4.0,0.0,0.0,0.71,0.0,0.0,,11.5,0.0,0.0,0.0,1.0,1.0,0.25,-1.0,-1.0,Matches,233.0,eng ENG,DF,25.0,8.0,5.0,507.0,5.6,0.0,0.0,0.0,0.0,0.0,0.0,3.0,1.0,1.0,1.0,0.4,1.4,4.0,14.0,5.0,0.0,0.0,0.0,0.0,0.0,0.18,0.07,0.25,0.18,0.25,Matches,Mason Holgate,D RC,25,130,150,England,Everton,5,8,9,6,11,6,14,5,7,13,12,8,14,13,15,13,15,12,11,12,12,13,9,10,9,14,13,13,15,13,14,13,15,14,15,15,13,10,11,6,13,1,2,1,1,3,2,2,3,2,2,1,17,16,5,8,15,12,13,12,1,1,20,17,1,14,14,1,9,1,1,1,1,1,184,64,8,20,13261934,6497,6497,5497,African_Caribbean,130,13,1996/10/22,0,0,84094.0,,29128167
233,Will Hughes,Crystal Palace,1995,234.0,eng ENG,MF,27.0,9.4,29.0,16.0,11.0,16.0,2.0,11.0,20.0,55.0,9.0,16.0,7.0,9.0,16.0,45.0,9.0,0.0,Matches,234.0,eng ENG,MF,27.0,9.4,17.0,1.82,12.0,2.0,0.0,2.0,1.0,0.0,1.0,0.11,0.0,0.0,0.0,1.0,0.0,0.0,Matches,,,,,,,,,,,,,,,,,,,,,,,,,,,,,,,,,,,,,,,,,,,,,,,,,,,,,,,,234.0,eng ENG,MF,27.0,9.4,4.0,0.0,0.0,19.0,7.0,0.0,12.0,16.0,16.0,0.0,1.0,0.0,66.0,5.0,13.0,27.8,Matches,234.0,eng ENG,MF,27.0,9.4,373.0,355.0,16.0,7.0,1.0,0.0,12.0,2.0,4.0,2.0,2.0,0.0,296.0,2.0,12.0,Matches,234.0,eng ENG,MF,27.0,9.4,296.0,373.0,79.4,4161.0,1158.0,176.0,201.0,87.6,98.0,121.0,81.0,12.0,25.0,48.0,1.0,0.9,0.7,0.1,6.0,29.0,6.0,0.0,32.0,Matches,301,eng ENG,MF,27,27,842.0,31.0,24.6,9.4,7,79.0,1,20,15.0,6,1.15,7.0,11.0,-4.0,-0.43,-0.25,11.2,12.8,-1.6,-0.17,0.08,Matches,234.0,eng ENG,MF,27.0,9.4,474.0,27.0,101.0,250.0,131.0,13.0,474.0,7.0,3.0,42.9,4.0,57.1,234.0,1162.0,636.0,14.0,10.0,3.0,14.0,10.0,262.0,23.0,Matches,234.0,eng ENG,MF,27.0,9.4,1.0,6.0,4.0,66.7,0.64,0.43,0.17,0.25,17.2,0.0,0.0,0.0,0.3,0.3,0.06,0.7,0.7,Matches,234.0,eng ENG,MF,27.0,27.0,7.0,842.0,9.4,1.0,1.0,2.0,1.0,0.0,0.0,4.0,0.0,0.3,0.3,0.9,1.2,14.0,32.0,23.0,0.11,0.11,0.21,0.11,0.21,0.04,0.1,0.13,0.04,0.13,Matches,Will Hughes,DM/M RC,27,130,155,England,Crystal Palace,11,10,12,9,13,12,9,10,6,13,13,11,14,13,16,14,15,14,13,13,13,15,11,12,11,13,15,17,10,14,13,13,13,11,14,12,13,15,12,10,15,2,2,1,1,3,1,1,3,2,1,4,13,14,3,10,13,16,10,13,1,1,1,1,1,1,20,11,20,15,1,11,11,1,185,74,20,9,8978346,6499,6499,5599,Northern_European,130,1,1995/4/17,0,0,57996.0,,29086005
234,Omari Hutchinson,Chelsea,2003,235.0,eng ENG,FW,18.0,0.3,0.0,0.0,0.0,0.0,0.0,0.0,0.0,,0.0,0.0,0.0,0.0,1.0,1.0,0.0,0.0,Matches,235.0,eng ENG,FW,18.0,0.3,2.0,7.83,2.0,0.0,0.0,0.0,0.0,0.0,0.0,0.0,0.0,0.0,0.0,0.0,0.0,0.0,Matches,,,,,,,,,,,,,,,,,,,,,,,,,,,,,,,,,,,,,,,,,,,,,,,,,,,,,,,,235.0,eng ENG,FW,18.0,0.3,0.0,0.0,0.0,0.0,0.0,0.0,2.0,1.0,0.0,0.0,0.0,0.0,1.0,0.0,0.0,,Matches,235.0,eng ENG,FW,18.0,0.3,13.0,13.0,0.0,0.0,0.0,0.0,2.0,0.0,0.0,0.0,0.0,0.0,9.0,0.0,1.0,Matches,235.0,eng ENG,FW,18.0,0.3,9.0,13.0,69.2,124.0,9.0,7.0,8.0,87.5,1.0,1.0,100.0,1.0,2.0,50.0,0.0,0.0,0.1,0.0,1.0,0.0,0.0,0.0,0.0,Matches,303,eng ENG,FW,18,1,23.0,23.0,0.7,0.3,0,,0,1,23.0,4,0.0,0.0,0.0,0.0,0.0,0.24,0.1,0.6,-0.5,-1.88,-1.81,Matches,235.0,eng ENG,FW,18.0,0.3,16.0,0.0,0.0,4.0,12.0,3.0,16.0,0.0,0.0,,0.0,,11.0,61.0,23.0,1.0,0.0,1.0,1.0,1.0,12.0,2.0,Matches,235.0,eng ENG,FW,18.0,0.3,0.0,0.0,0.0,,0.0,0.0,,,,0.0,0.0,0.0,0.0,0.0,,0.0,0.0,Matches,235.0,eng ENG,FW,18.0,1.0,0.0,23.0,0.3,0.0,0.0,0.0,0.0,0.0,0.0,0.0,0.0,0.0,0.0,0.0,0.0,1.0,0.0,2.0,0.0,0.0,0.0,0.0,0.0,0.0,0.18,0.18,0.0,0.18,Matches,Omari Hutchinson,AM RLC,18,97,-8,"England,Jamaica",Chelsea,10,10,14,10,12,10,4,12,1,4,12,9,7,13,8,9,7,8,7,12,7,11,16,4,12,5,11,12,15,14,12,4,14,13,9,5,18,10,11,11,18,2,1,3,3,3,3,2,2,2,2,1,15,13,6,10,15,10,10,17,1,1,1,1,12,1,1,13,15,1,16,20,17,1,169,0,20,10,30900198,4853,4853,2506,African_Caribbean,92,10,2003/10/29,0,0,17399.0,,2000047221
235,Danny Ings,West Ham,1992,238.0,eng ENG,FW,30.0,8.6,9.0,8.0,0.0,4.0,5.0,5.0,14.0,35.7,9.0,8.0,2.0,6.0,3.0,12.0,5.0,0.0,Matches,238.0,eng ENG,FW,30.0,8.6,12.0,1.4,11.0,0.0,1.0,0.0,0.0,0.0,3.0,0.35,3.0,0.0,0.0,0.0,0.0,0.0,Matches,,,,,,,,,,,,,,,,,,,,,,,,,,,,,,,,,,,,,,,,,,,,,,,,,,,,,,,,238.0,eng ENG,FW,30.0,8.6,1.0,0.0,0.0,8.0,9.0,5.0,0.0,3.0,8.0,0.0,0.0,0.0,27.0,9.0,25.0,26.5,Matches,238.0,eng ENG,FW,30.0,8.6,148.0,146.0,2.0,0.0,3.0,1.0,0.0,0.0,0.0,0.0,0.0,0.0,92.0,0.0,8.0,Matches,238.0,eng ENG,FW,30.0,8.6,92.0,148.0,62.2,1111.0,302.0,62.0,89.0,69.7,15.0,23.0,65.2,5.0,13.0,38.5,2.0,1.0,0.9,1.0,6.0,11.0,2.0,0.0,12.0,Matches,306,eng ENG,FW,30,17,775.0,46.0,22.7,8.6,7,79.0,1,10,22.0,2,1.24,11.0,13.0,-2.0,-0.23,0.14,11.0,13.7,-2.7,-0.32,-0.28,Matches,238.0,eng ENG,FW,30.0,8.6,229.0,8.0,22.0,105.0,105.0,37.0,229.0,18.0,5.0,27.8,12.0,66.7,129.0,554.0,260.0,9.0,8.0,3.0,11.0,10.0,157.0,44.0,Matches,238.0,eng ENG,FW,30.0,8.6,2.0,15.0,4.0,26.7,1.74,0.46,0.13,0.5,11.2,0.0,0.0,0.0,3.0,3.0,0.2,-1.0,-1.0,Matches,238.0,eng ENG,FW,30.0,17.0,7.0,775.0,8.6,2.0,2.0,4.0,2.0,0.0,0.0,1.0,0.0,3.0,3.0,1.0,4.0,9.0,12.0,44.0,0.23,0.23,0.46,0.23,0.46,0.35,0.12,0.47,0.35,0.47,Matches,Danny Ings,S,30,143,160,England,Aston Villa,4,11,13,16,13,10,13,12,3,8,13,13,11,16,13,14,14,14,14,14,12,18,14,14,14,10,16,15,14,14,15,11,13,13,14,14,14,5,10,13,9,1,4,2,1,2,2,2,2,2,1,2,13,17,8,15,14,18,13,16,1,1,1,1,1,1,1,1,1,1,10,12,12,20,178,74,10,20,38207678,7147,7147,5997,Northern_European,142,5,1992/7/23,3,1,144990.0,,29030379
236,Daniel James,Leeds United,1997,243.0,wls WAL,FW,24.0,2.2,6.0,2.0,1.0,3.0,2.0,3.0,6.0,50.0,3.0,4.0,0.0,4.0,2.0,8.0,2.0,0.0,Matches,243.0,wls WAL,FW,24.0,2.2,4.0,1.82,3.0,0.0,0.0,0.0,1.0,0.0,0.0,0.0,0.0,0.0,0.0,0.0,0.0,0.0,Matches,,,,,,,,,,,,,,,,,,,,,,,,,,,,,,,,,,,,,,,,,,,,,,,,,,,,,,,,243.0,wls WAL,FW,24.0,2.2,0.0,0.0,0.0,2.0,6.0,0.0,6.0,2.0,2.0,0.0,0.0,0.0,7.0,0.0,4.0,0.0,Matches,243.0,wls WAL,FW,24.0,2.2,40.0,40.0,0.0,0.0,0.0,0.0,6.0,0.0,0.0,0.0,0.0,0.0,24.0,0.0,4.0,Matches,243.0,wls WAL,FW,24.0,2.2,24.0,40.0,60.0,256.0,66.0,18.0,22.0,81.8,5.0,10.0,50.0,0.0,3.0,0.0,0.0,0.3,0.3,-0.3,1.0,1.0,3.0,1.0,3.0,Matches,315,wls WAL,FW,24,4,198.0,50.0,5.8,2.2,2,64.0,0,2,36.0,0,1.25,5.0,2.0,3.0,1.36,2.29,3.9,4.1,-0.2,-0.1,0.44,Matches,243.0,wls WAL,FW,24.0,2.2,66.0,1.0,9.0,26.0,32.0,6.0,66.0,6.0,1.0,16.7,2.0,33.3,35.0,233.0,112.0,6.0,2.0,3.0,3.0,1.0,39.0,9.0,Matches,243.0,wls WAL,FW,24.0,2.2,0.0,3.0,1.0,33.3,1.36,0.45,0.0,0.0,17.6,0.0,0.0,0.0,0.3,0.3,0.09,-0.3,-0.3,Matches,243.0,wls WAL,FW,24.0,4.0,2.0,198.0,2.2,0.0,0.0,0.0,0.0,0.0,0.0,0.0,0.0,0.3,0.3,0.3,0.6,6.0,3.0,9.0,0.0,0.0,0.0,0.0,0.0,0.12,0.15,0.27,0.12,0.27,Matches,Daniel James,M/AM RL,24,129,149,"Wales,England",Leeds United,4,11,13,7,11,4,5,8,2,5,8,10,6,11,14,10,16,6,9,7,5,15,12,4,12,6,16,18,19,16,12,6,15,19,16,5,9,12,13,5,12,1,3,3,3,3,1,3,3,2,3,3,5,15,5,12,14,14,11,14,1,1,1,1,1,1,1,19,1,18,20,9,19,11,171,76,8,20,12334360,6550,6950,5550,Northern_European,117,4,1997/11/10,36,5,57996.0,Fulham,28094856
237,Pontus Jansson,Brentford,1991,247.0,se SWE,DF,31.0,8.0,5.0,3.0,4.0,1.0,0.0,3.0,5.0,60.0,2.0,13.0,9.0,4.0,9.0,14.0,38.0,0.0,Matches,247.0,se SWE,DF,31.0,8.0,2.0,0.25,1.0,0.0,0.0,1.0,0.0,0.0,1.0,0.12,1.0,0.0,0.0,0.0,0.0,0.0,Matches,,,,,,,,,,,,,,,,,,,,,,,,,,,,,,,,,,,,,,,,,,,,,,,,,,,,,,,,247.0,se SWE,DF,31.0,8.0,0.0,0.0,0.0,2.0,1.0,1.0,0.0,9.0,3.0,0.0,0.0,0.0,25.0,24.0,12.0,66.7,Matches,247.0,se SWE,DF,31.0,8.0,321.0,309.0,11.0,6.0,1.0,0.0,0.0,5.0,0.0,0.0,0.0,0.0,257.0,1.0,3.0,Matches,247.0,se SWE,DF,31.0,8.0,257.0,321.0,80.1,5004.0,1738.0,81.0,98.0,82.7,147.0,167.0,88.0,28.0,45.0,62.2,0.0,0.0,0.1,0.0,0.0,11.0,0.0,0.0,14.0,Matches,319,se SWE,DF,31,12,724.0,60.0,21.2,8.0,9,79.0,7,3,5.0,3,1.33,17.0,14.0,3.0,0.37,0.07,10.6,13.0,-2.5,-0.31,-0.61,Matches,247.0,se SWE,DF,31.0,8.0,393.0,73.0,243.0,137.0,13.0,8.0,393.0,2.0,2.0,100.0,0.0,0.0,192.0,734.0,310.0,1.0,1.0,0.0,2.0,1.0,217.0,0.0,Matches,247.0,se SWE,DF,31.0,8.0,1.0,4.0,2.0,50.0,0.5,0.25,0.25,0.5,9.9,0.0,0.0,0.0,0.3,0.3,0.08,0.7,0.7,Matches,247.0,se SWE,DF,31.0,12.0,9.0,724.0,8.0,1.0,0.0,1.0,1.0,0.0,0.0,0.0,0.0,0.3,0.3,0.0,0.3,1.0,14.0,0.0,0.12,0.0,0.12,0.12,0.12,0.04,0.0,0.04,0.04,0.04,Matches,Pontus Jansson,D C,31,132,139,Sweden,Brentford,2,6,11,6,12,2,14,5,8,14,12,4,15,13,16,14,18,13,11,11,13,17,9,15,6,14,13,14,12,10,14,17,14,12,14,15,13,14,12,9,10,2,2,2,1,1,2,3,3,1,3,2,18,13,18,17,14,16,4,5,1,1,20,1,1,1,1,1,1,1,1,1,1,1,194,89,8,20,13093480,6740,6640,5240,Northern_European,132,1,1991/2/13,27,0,46397.0,,68008625
238,Raúl Jiménez,Wolves,1991,250.0,mx MEX,FW,31.0,9.4,9.0,6.0,3.0,5.0,1.0,3.0,6.0,50.0,3.0,9.0,0.0,9.0,0.0,9.0,8.0,0.0,Matches,250.0,mx MEX,FW,31.0,9.4,18.0,1.92,12.0,0.0,1.0,3.0,2.0,0.0,2.0,0.21,1.0,0.0,0.0,1.0,0.0,0.0,Matches,,,,,,,,,,,,,,,,,,,,,,,,,,,,,,,,,,,,,,,,,,,,,,,,,,,,,,,,250.0,mx MEX,FW,31.0,9.4,0.0,0.0,0.0,14.0,14.0,9.0,5.0,0.0,6.0,0.0,0.0,0.0,21.0,24.0,25.0,49.0,Matches,250.0,mx MEX,FW,31.0,9.4,198.0,173.0,25.0,0.0,1.0,2.0,5.0,4.0,0.0,0.0,0.0,0.0,140.0,0.0,5.0,Matches,250.0,mx MEX,FW,31.0,9.4,140.0,198.0,70.7,1933.0,349.0,86.0,109.0,78.9,35.0,50.0,70.0,10.0,18.0,55.6,1.0,1.7,0.6,-0.7,8.0,8.0,7.0,1.0,14.0,Matches,322,mx MEX,FW,31,15,846.0,56.0,24.7,9.4,8,82.0,5,7,27.0,5,0.8,7.0,18.0,-11.0,-1.17,-0.61,10.6,16.6,-6.0,-0.64,-0.04,Matches,250.0,mx MEX,FW,31.0,9.4,293.0,11.0,28.0,139.0,127.0,44.0,293.0,10.0,5.0,50.0,4.0,40.0,146.0,626.0,241.0,5.0,3.0,2.0,23.0,14.0,219.0,45.0,Matches,250.0,mx MEX,FW,31.0,9.4,0.0,20.0,9.0,45.0,2.13,0.96,0.0,0.0,14.5,0.0,0.0,0.0,2.6,2.6,0.13,-2.6,-2.6,Matches,250.0,mx MEX,FW,31.0,15.0,8.0,846.0,9.4,0.0,1.0,1.0,0.0,0.0,0.0,0.0,0.0,2.6,2.6,1.7,4.3,5.0,14.0,45.0,0.0,0.11,0.11,0.0,0.11,0.27,0.18,0.46,0.27,0.46,Matches,Raúl Jiménez,S,31,150,155,Mexico,Wolverhampton Wanderers,6,11,14,15,12,8,16,13,6,8,13,20,9,14,17,13,16,15,14,11,12,16,9,8,15,10,15,18,14,12,14,15,14,14,14,13,13,8,11,9,12,1,2,3,1,3,2,3,4,1,3,1,10,10,6,14,13,17,14,15,1,1,1,1,1,1,1,1,1,1,10,13,13,20,190,76,13,20,347975206,7600,7250,6500,Mediterranean_Hispanic,149,12,1991/5/5,96,30,115992.0,,51013463
239,Ben Johnson,West Ham,2000,252.0,eng ENG,DF,22.0,9.6,20.0,14.0,12.0,4.0,4.0,12.0,18.0,66.7,6.0,12.0,4.0,8.0,9.0,29.0,28.0,1.0,Matches,252.0,eng ENG,DF,22.0,9.6,8.0,0.83,7.0,0.0,1.0,0.0,0.0,0.0,0.0,0.0,0.0,0.0,0.0,0.0,0.0,0.0,Matches,,,,,,,,,,,,,,,,,,,,,,,,,,,,,,,,,,,,,,,,,,,,,,,,,,,,,,,,252.0,eng ENG,DF,22.0,9.6,0.0,0.0,0.0,3.0,5.0,1.0,16.0,9.0,14.0,0.0,0.0,0.0,67.0,16.0,9.0,64.0,Matches,252.0,eng ENG,DF,22.0,9.6,535.0,463.0,71.0,7.0,0.0,7.0,16.0,62.0,0.0,0.0,0.0,0.0,395.0,1.0,12.0,Matches,252.0,eng ENG,DF,22.0,9.6,395.0,535.0,73.8,6958.0,2496.0,177.0,202.0,87.6,175.0,217.0,80.6,35.0,85.0,41.2,0.0,0.2,0.4,-0.2,3.0,27.0,10.0,5.0,37.0,Matches,324,eng ENG,DF,22,17,866.0,51.0,25.3,9.6,9,82.0,8,8,16.0,10,1.24,8.0,13.0,-5.0,-0.52,-0.24,12.9,15.2,-2.4,-0.25,-0.2,Matches,252.0,eng ENG,DF,22.0,9.6,627.0,43.0,256.0,289.0,87.0,2.0,627.0,17.0,8.0,47.1,6.0,35.3,276.0,1449.0,650.0,15.0,6.0,1.0,7.0,7.0,335.0,22.0,Matches,252.0,eng ENG,DF,22.0,9.6,0.0,2.0,1.0,50.0,0.21,0.1,0.0,0.0,21.2,0.0,0.0,0.0,0.1,0.1,0.03,-0.1,-0.1,Matches,252.0,eng ENG,DF,22.0,17.0,9.0,866.0,9.6,0.0,0.0,0.0,0.0,0.0,0.0,0.0,0.0,0.1,0.1,0.2,0.3,15.0,37.0,22.0,0.0,0.0,0.0,0.0,0.0,0.01,0.02,0.03,0.01,0.03,Matches,Ben Johnson,D RL,22,135,150,England,West Ham United,6,13,12,10,12,5,11,9,11,14,10,3,14,12,12,14,14,13,14,10,13,14,8,11,13,15,15,14,13,14,13,12,11,13,14,12,11,5,12,13,15,2,2,1,1,1,1,2,2,2,3,2,14,12,5,12,10,15,13,15,1,15,1,20,12,11,1,1,1,1,1,1,1,1,183,67,13,20,36309034,6733,6733,5233,African_Caribbean,134,15,2000/1/24,0,0,34798.0,,28111063
240,Sam Johnstone,Crystal Palace,1993,254.0,eng ENG,GK,29.0,9.0,0.0,0.0,0.0,0.0,0.0,0.0,0.0,,0.0,0.0,0.0,0.0,0.0,0.0,5.0,0.0,Matches,254.0,eng ENG,GK,29.0,9.0,0.0,0.0,0.0,0.0,0.0,0.0,0.0,0.0,0.0,0.0,0.0,0.0,0.0,0.0,0.0,0.0,Matches,16.0,eng ENG,GK,29.0,9.0,10.0,2.0,0.0,4.0,1.0,10.0,0.24,1.0,0.11,30.0,99.0,30.3,233.0,41.0,31.8,31.8,46.0,54.3,42.8,104.0,2.0,1.9,11.0,1.22,15.4,Matches,16.0,eng ENG,GK,29.0,9.0,9.0,810.0,9.0,10.0,1.11,34.0,25.0,76.5,4.0,3.0,2.0,3.0,33.3,2.0,2.0,0.0,0.0,0.0,Matches,254.0,eng ENG,GK,29.0,9.0,1.0,0.0,0.0,1.0,0.0,0.0,0.0,0.0,0.0,0.0,1.0,0.0,12.0,3.0,0.0,100.0,Matches,254.0,eng ENG,GK,29.0,9.0,280.0,213.0,66.0,20.0,0.0,0.0,0.0,0.0,0.0,0.0,0.0,0.0,207.0,1.0,0.0,Matches,254.0,eng ENG,GK,29.0,9.0,207.0,280.0,73.9,5239.0,3382.0,41.0,41.0,100.0,117.0,118.0,99.2,49.0,120.0,40.8,0.0,0.0,0.0,0.0,0.0,3.0,0.0,0.0,0.0,Matches,326,eng ENG,GK,29,9,810.0,90.0,23.7,9.0,9,90.0,9,0,,21,1.67,16.0,10.0,6.0,0.67,1.18,12.1,8.5,3.6,0.4,0.83,Matches,254.0,eng ENG,GK,29.0,9.0,298.0,242.0,297.0,1.0,0.0,0.0,298.0,0.0,0.0,,0.0,,188.0,1018.0,662.0,0.0,0.0,0.0,1.0,0.0,156.0,0.0,Matches,254.0,eng ENG,GK,29.0,9.0,0.0,0.0,0.0,,0.0,0.0,,,,0.0,0.0,0.0,0.0,0.0,,0.0,0.0,Matches,254.0,eng ENG,GK,29.0,9.0,9.0,810.0,9.0,0.0,0.0,0.0,0.0,0.0,0.0,1.0,0.0,0.0,0.0,0.0,0.0,0.0,0.0,0.0,0.0,0.0,0.0,0.0,0.0,0.0,0.0,0.0,0.0,0.0,Matches,Sam Johnstone,GK,29,136,140,England,Crystal Palace,2,3,2,3,10,1,3,1,1,2,9,2,2,9,9,12,14,9,13,8,12,15,4,10,8,15,12,11,10,15,10,17,12,8,10,11,15,9,11,6,2,14,13,11,9,17,12,14,16,12,15,13,8,14,2,10,8,14,12,12,20,1,1,1,1,1,1,1,1,1,1,1,1,1,193,85,7,20,20274604,6789,6789,5489,Northern_European,131,1,1993/3/25,3,0,52196.0,,28037204
241,Jorginho,Arsenal,1991,256.0,it ITA,MF,30.0,9.5,18.0,13.0,6.0,10.0,2.0,5.0,24.0,20.8,19.0,7.0,2.0,5.0,9.0,27.0,8.0,0.0,Matches,256.0,it ITA,MF,30.0,9.5,21.0,2.21,19.0,0.0,0.0,0.0,0.0,2.0,5.0,0.53,4.0,0.0,0.0,0.0,0.0,1.0,Matches,,,,,,,,,,,,,,,,,,,,,,,,,,,,,,,,,,,,,,,,,,,,,,,,,,,,,,,,256.0,it ITA,MF,30.0,9.5,0.0,0.0,0.0,6.0,18.0,0.0,2.0,9.0,13.0,0.0,0.0,0.0,69.0,10.0,8.0,55.6,Matches,256.0,it ITA,MF,30.0,9.5,736.0,718.0,16.0,16.0,5.0,2.0,2.0,0.0,0.0,0.0,0.0,0.0,641.0,2.0,8.0,Matches,256.0,it ITA,MF,30.0,9.5,641.0,736.0,87.1,10809.0,3031.0,279.0,311.0,89.7,305.0,334.0,91.3,41.0,61.0,67.2,1.0,0.2,0.6,0.8,5.0,84.0,12.0,0.0,99.0,Matches,328,it ITA,MF,30,14,855.0,61.0,25.0,9.5,9,81.0,6,5,25.0,5,1.79,20.0,11.0,9.0,0.95,-0.32,14.1,8.5,5.7,0.6,-0.25,Matches,256.0,it ITA,MF,30.0,9.5,807.0,27.0,159.0,476.0,175.0,8.0,807.0,10.0,3.0,30.0,5.0,50.0,523.0,2399.0,1252.0,15.0,12.0,0.0,8.0,8.0,629.0,8.0,Matches,256.0,it ITA,MF,30.0,9.5,0.0,6.0,0.0,0.0,0.63,0.0,0.0,,22.3,0.0,0.0,0.0,0.2,0.2,0.04,-0.2,-0.2,Matches,256.0,it ITA,MF,30.0,14.0,9.0,855.0,9.5,0.0,1.0,1.0,0.0,0.0,0.0,0.0,0.0,0.2,0.2,0.2,0.4,15.0,99.0,8.0,0.0,0.11,0.11,0.0,0.11,0.02,0.02,0.04,0.02,0.04,Matches,Jorginho,DM/M C,30,164,165,"Italy,Brazil",Chelsea,11,12,12,8,18,9,7,9,2,10,18,18,14,16,10,16,14,19,15,18,18,15,13,15,15,14,17,17,11,14,14,9,14,12,17,9,15,10,15,8,6,1,3,2,1,1,2,2,3,1,2,2,11,15,7,12,13,17,13,12,1,1,1,1,1,1,20,1,20,1,1,10,1,1,180,65,9,20,193594995,8199,7749,7249,Mediterranean_Hispanic,158,4,1991/12/20,44,5,127591.0,,43036641
242,Mateo Joseph,Leeds United,2003,258.0,es ESP,FWMF,18.0,0.3,0.0,0.0,0.0,0.0,0.0,0.0,0.0,,0.0,1.0,0.0,1.0,0.0,0.0,1.0,0.0,Matches,258.0,es ESP,FWMF,18.0,0.3,0.0,0.0,0.0,0.0,0.0,0.0,0.0,0.0,0.0,0.0,0.0,0.0,0.0,0.0,0.0,0.0,Matches,,,,,,,,,,,,,,,,,,,,,,,,,,,,,,,,,,,,,,,,,,,,,,,,,,,,,,,,258.0,es ESP,FWMF,18.0,0.3,0.0,0.0,0.0,0.0,0.0,0.0,0.0,0.0,0.0,0.0,0.0,0.0,0.0,0.0,0.0,,Matches,258.0,es ESP,FWMF,18.0,0.3,3.0,3.0,0.0,0.0,0.0,0.0,0.0,0.0,0.0,0.0,0.0,0.0,2.0,0.0,0.0,Matches,258.0,es ESP,FWMF,18.0,0.3,2.0,3.0,66.7,13.0,0.0,1.0,2.0,50.0,0.0,0.0,,0.0,0.0,,0.0,0.0,0.0,0.0,0.0,0.0,0.0,0.0,0.0,Matches,330,es ESP,FWMF,18,3,26.0,9.0,0.8,0.3,0,,0,3,9.0,5,0.33,0.0,0.0,0.0,0.0,0.8,0.6,0.3,0.4,1.23,1.76,Matches,258.0,es ESP,FWMF,18.0,0.3,9.0,1.0,1.0,5.0,3.0,1.0,9.0,1.0,0.0,0.0,1.0,100.0,5.0,13.0,0.0,0.0,0.0,0.0,1.0,3.0,6.0,2.0,Matches,258.0,es ESP,FWMF,18.0,0.3,0.0,1.0,1.0,100.0,3.46,3.46,0.0,0.0,15.4,0.0,0.0,0.0,0.1,0.1,0.12,-0.1,-0.1,Matches,258.0,es ESP,FWMF,18.0,3.0,0.0,26.0,0.3,0.0,0.0,0.0,0.0,0.0,0.0,0.0,0.0,0.1,0.1,0.0,0.1,0.0,0.0,2.0,0.0,0.0,0.0,0.0,0.0,0.4,0.0,0.4,0.4,0.4,Matches,Mateo Joseph,S,18,90,-75,"Spain,England",Leeds United,10,8,10,13,11,10,8,9,8,3,7,10,4,12,8,12,8,12,7,8,8,11,13,2,13,6,10,9,12,13,12,8,13,13,12,7,10,6,6,5,10,2,1,3,2,1,1,3,1,2,1,1,14,13,8,8,10,11,11,10,1,1,1,1,1,1,1,1,1,1,1,1,1,20,171,0,11,20,20252157,4495,4495,2245,Mixed_Race,88,8,2003/10/19,0,0,1740.0,,2000108513
243,N'Golo Kanté,Chelsea,1991,266.0,fr FRA,MF,31.0,5.8,16.0,10.0,4.0,10.0,2.0,4.0,8.0,50.0,4.0,11.0,0.0,11.0,6.0,22.0,2.0,0.0,Matches,266.0,fr FRA,MF,31.0,5.8,24.0,4.17,22.0,0.0,1.0,1.0,0.0,0.0,2.0,0.35,2.0,0.0,0.0,0.0,0.0,0.0,Matches,,,,,,,,,,,,,,,,,,,,,,,,,,,,,,,,,,,,,,,,,,,,,,,,,,,,,,,,266.0,fr FRA,MF,31.0,5.8,1.0,0.0,0.0,5.0,2.0,1.0,11.0,6.0,10.0,0.0,0.0,0.0,55.0,2.0,4.0,33.3,Matches,266.0,fr FRA,MF,31.0,5.8,338.0,336.0,0.0,0.0,2.0,1.0,11.0,0.0,0.0,0.0,0.0,0.0,271.0,2.0,12.0,Matches,266.0,fr FRA,MF,31.0,5.8,271.0,338.0,80.2,3935.0,1033.0,168.0,190.0,88.4,84.0,100.0,84.0,12.0,24.0,50.0,1.0,1.9,0.8,-0.9,13.0,23.0,11.0,3.0,34.0,Matches,339,fr FRA,MF,31,7,518.0,74.0,15.1,5.8,6,81.0,3,1,34.0,1,1.14,5.0,7.0,-2.0,-0.35,-0.13,8.0,4.9,3.1,0.54,0.73,Matches,266.0,fr FRA,MF,31.0,5.8,404.0,11.0,53.0,195.0,163.0,16.0,404.0,18.0,12.0,66.7,4.0,22.2,230.0,1408.0,800.0,19.0,15.0,2.0,13.0,5.0,279.0,36.0,Matches,266.0,fr FRA,MF,31.0,5.8,0.0,8.0,1.0,12.5,1.39,0.17,0.0,0.0,20.9,0.0,0.0,0.0,0.3,0.3,0.04,-0.3,-0.3,Matches,266.0,fr FRA,MF,31.0,7.0,6.0,518.0,5.8,0.0,1.0,1.0,0.0,0.0,0.0,1.0,0.0,0.3,0.3,1.9,2.2,19.0,34.0,36.0,0.0,0.17,0.17,0.0,0.17,0.05,0.32,0.38,0.05,0.38,Matches,N'Golo Kanté,DM/M C,31,167,170,"France,Mali",Chelsea,6,12,11,10,14,8,10,10,6,12,15,9,19,14,15,20,15,14,16,14,16,19,13,5,15,15,20,20,14,13,15,7,18,14,18,11,19,5,20,8,10,1,3,2,2,1,3,3,1,2,3,2,18,13,1,17,15,20,15,15,1,1,1,1,1,1,18,12,20,12,10,14,12,1,168,72,8,20,48067182,8350,8200,8000,African_Caribbean,156,17,1991/3/29,53,2,336376.0,,85081880
244,Neeskens Kebano,Fulham,1992,268.0,cd COD,FW,30.0,8.5,17.0,9.0,8.0,6.0,3.0,9.0,18.0,50.0,9.0,14.0,0.0,14.0,1.0,18.0,8.0,0.0,Matches,268.0,cd COD,FW,30.0,8.5,24.0,2.83,16.0,2.0,0.0,2.0,3.0,1.0,5.0,0.59,4.0,0.0,0.0,1.0,0.0,0.0,Matches,,,,,,,,,,,,,,,,,,,,,,,,,,,,,,,,,,,,,,,,,,,,,,,,,,,,,,,,268.0,cd COD,FW,30.0,8.5,0.0,0.0,0.0,8.0,16.0,2.0,24.0,1.0,9.0,0.0,0.0,0.0,47.0,2.0,12.0,14.3,Matches,268.0,cd COD,FW,30.0,8.5,212.0,206.0,6.0,2.0,0.0,1.0,24.0,0.0,4.0,0.0,1.0,0.0,155.0,0.0,16.0,Matches,268.0,cd COD,FW,30.0,8.5,155.0,212.0,73.1,2079.0,517.0,93.0,106.0,87.7,43.0,58.0,74.1,6.0,13.0,46.2,3.0,1.5,0.9,1.5,13.0,2.0,9.0,3.0,24.0,Matches,342,cd COD,FW,30,17,764.0,45.0,22.3,8.5,9,74.0,1,8,13.0,3,1.47,13.0,10.0,3.0,0.35,0.39,11.3,11.7,-0.4,-0.05,0.53,Matches,268.0,cd COD,FW,30.0,8.5,321.0,10.0,49.0,92.0,188.0,30.0,321.0,30.0,11.0,36.7,13.0,43.3,200.0,1502.0,841.0,39.0,14.0,11.0,16.0,12.0,216.0,68.0,Matches,268.0,cd COD,FW,30.0,8.5,0.0,9.0,2.0,22.2,1.06,0.24,0.0,0.0,15.2,0.0,0.0,0.0,0.5,0.5,0.05,-0.5,-0.5,Matches,268.0,cd COD,FW,30.0,17.0,9.0,764.0,8.5,0.0,3.0,3.0,0.0,0.0,0.0,0.0,0.0,0.5,0.5,1.5,2.0,39.0,24.0,68.0,0.0,0.35,0.35,0.0,0.35,0.06,0.18,0.23,0.06,0.23,Matches,Neeskens Kebano,M/AM/S RLC,30,130,130,"Democratic Republic of Congo,France",Fulham,13,12,15,11,14,14,8,12,5,7,13,11,4,15,12,12,13,12,11,11,13,16,16,6,11,7,12,11,15,14,12,6,12,14,13,10,12,10,14,16,12,3,3,1,3,1,2,1,1,2,3,3,20,16,5,14,13,7,15,15,1,1,1,1,1,1,1,10,16,10,20,18,18,17,172,72,7,20,8041837,6500,6500,4250,African_Caribbean,123,17,1992/3/10,32,6,37117.0,,29022616
245,Naby Keïta,Liverpool,1995,270.0,gn GUI,MF,27.0,3.3,5.0,4.0,2.0,3.0,0.0,1.0,4.0,25.0,3.0,1.0,0.0,1.0,2.0,7.0,3.0,0.0,Matches,270.0,gn GUI,MF,27.0,3.3,12.0,3.67,10.0,0.0,0.0,2.0,0.0,0.0,0.0,0.0,0.0,0.0,0.0,0.0,0.0,0.0,Matches,,,,,,,,,,,,,,,,,,,,,,,,,,,,,,,,,,,,,,,,,,,,,,,,,,,,,,,,270.0,gn GUI,MF,27.0,3.3,1.0,0.0,0.0,12.0,2.0,0.0,2.0,2.0,4.0,0.0,0.0,0.0,29.0,3.0,7.0,30.0,Matches,270.0,gn GUI,MF,27.0,3.3,168.0,161.0,6.0,1.0,0.0,0.0,2.0,1.0,0.0,0.0,0.0,0.0,129.0,1.0,7.0,Matches,270.0,gn GUI,MF,27.0,3.3,129.0,168.0,76.8,1820.0,590.0,75.0,87.0,86.2,43.0,54.0,79.6,6.0,8.0,75.0,0.0,0.7,0.2,-0.7,8.0,15.0,2.0,0.0,15.0,Matches,344,gn GUI,MF,27,8,293.0,37.0,8.6,3.3,3,57.0,0,5,24.0,2,1.38,2.0,4.0,-2.0,-0.61,-1.48,5.0,3.7,1.2,0.37,-0.22,Matches,270.0,gn GUI,MF,27.0,3.3,206.0,5.0,34.0,114.0,59.0,11.0,206.0,4.0,3.0,75.0,0.0,0.0,111.0,536.0,220.0,5.0,6.0,0.0,12.0,7.0,140.0,21.0,Matches,270.0,gn GUI,MF,27.0,3.3,0.0,10.0,0.0,0.0,3.07,0.0,0.0,,20.6,0.0,0.0,0.0,0.6,0.6,0.06,-0.6,-0.6,Matches,270.0,gn GUI,MF,27.0,8.0,3.0,293.0,3.3,0.0,0.0,0.0,0.0,0.0,0.0,1.0,0.0,0.6,0.6,0.7,1.4,5.0,15.0,21.0,0.0,0.0,0.0,0.0,0.0,0.2,0.22,0.41,0.2,0.41,Matches,Naby Keïta,DM/M C,27,155,164,Guinea,Liverpool,8,12,16,11,15,10,7,11,6,12,15,9,13,16,13,17,12,15,14,15,14,14,15,7,16,14,16,15,15,16,17,8,12,14,17,11,14,10,14,14,11,2,3,3,3,3,3,2,2,1,2,3,14,16,12,10,13,13,10,13,1,1,1,1,1,1,18,14,20,14,1,14,1,1,172,64,9,20,37465328,7750,7750,6750,African_Caribbean,156,16,1995/2/10,50,11,150789.0,,85140676
246,Jakub Kiwior,Arsenal,2000,274.0,pl POL,DF,22.0,4.7,7.0,5.0,6.0,1.0,0.0,5.0,8.0,62.5,3.0,5.0,3.0,2.0,6.0,13.0,10.0,0.0,Matches,274.0,pl POL,DF,22.0,4.7,1.0,0.21,1.0,0.0,0.0,0.0,0.0,0.0,0.0,0.0,0.0,0.0,0.0,0.0,0.0,0.0,Matches,,,,,,,,,,,,,,,,,,,,,,,,,,,,,,,,,,,,,,,,,,,,,,,,,,,,,,,,274.0,pl POL,DF,22.0,4.7,0.0,0.0,0.0,1.0,1.0,0.0,1.0,6.0,5.0,0.0,0.0,0.0,20.0,8.0,10.0,44.4,Matches,274.0,pl POL,DF,22.0,4.7,205.0,192.0,13.0,5.0,1.0,1.0,1.0,8.0,0.0,0.0,0.0,0.0,177.0,0.0,4.0,Matches,274.0,pl POL,DF,22.0,4.7,177.0,205.0,86.3,3030.0,924.0,62.0,70.0,88.6,104.0,109.0,95.4,7.0,15.0,46.7,0.0,0.0,0.0,0.0,1.0,6.0,0.0,0.0,6.0,Matches,348,pl POL,DF,22,7,427.0,61.0,12.5,4.7,5,82.0,3,2,8.0,11,1.86,10.0,6.0,4.0,0.84,-0.39,6.6,6.5,0.1,0.02,-0.87,Matches,274.0,pl POL,DF,22.0,4.7,248.0,31.0,124.0,103.0,22.0,3.0,248.0,1.0,1.0,100.0,0.0,0.0,141.0,530.0,171.0,0.0,3.0,0.0,0.0,0.0,148.0,6.0,Matches,274.0,pl POL,DF,22.0,4.7,1.0,1.0,1.0,100.0,0.21,0.21,1.0,1.0,10.0,0.0,0.0,0.0,0.1,0.1,0.09,0.9,0.9,Matches,274.0,pl POL,DF,22.0,7.0,5.0,427.0,4.7,1.0,0.0,1.0,1.0,0.0,0.0,0.0,0.0,0.1,0.1,0.0,0.1,0.0,6.0,6.0,0.21,0.0,0.21,0.21,0.21,0.02,0.01,0.03,0.02,0.03,Matches,Jakub Kiwior,D/DM LC,22,131,159,Poland,Spezia Calcio,9,11,12,7,12,12,13,8,7,14,12,8,13,13,12,15,13,13,14,12,12,14,9,11,7,15,15,13,12,12,11,14,15,13,13,12,14,11,12,5,11,3,3,2,1,3,2,2,1,3,2,1,15,14,1,10,12,15,9,12,1,15,20,1,14,1,17,1,10,1,1,1,1,1,188,78,20,8,10016000,6550,6100,2006,Northern_European,129,5,2000/2/15,2,0,25443.0,,96102946
247,Mateusz Klich,Leeds United,1990,275.0,pl POL,MFFW,32.0,3.1,12.0,8.0,3.0,4.0,5.0,7.0,13.0,53.8,6.0,4.0,0.0,4.0,0.0,12.0,1.0,0.0,Matches,275.0,pl POL,MFFW,32.0,3.1,7.0,2.26,7.0,0.0,0.0,0.0,0.0,0.0,0.0,0.0,0.0,0.0,0.0,0.0,0.0,0.0,Matches,,,,,,,,,,,,,,,,,,,,,,,,,,,,,,,,,,,,,,,,,,,,,,,,,,,,,,,,275.0,pl POL,MFFW,32.0,3.1,2.0,0.0,0.0,10.0,3.0,0.0,8.0,0.0,8.0,0.0,0.0,0.0,24.0,1.0,2.0,33.3,Matches,275.0,pl POL,MFFW,32.0,3.1,148.0,139.0,9.0,2.0,0.0,0.0,8.0,4.0,3.0,1.0,1.0,0.0,108.0,0.0,7.0,Matches,275.0,pl POL,MFFW,32.0,3.1,108.0,148.0,73.0,1411.0,387.0,61.0,69.0,88.4,28.0,34.0,82.4,5.0,17.0,29.4,0.0,0.2,0.2,-0.2,5.0,6.0,5.0,0.0,16.0,Matches,350,pl POL,MFFW,32,14,280.0,20.0,8.2,3.1,0,,0,14,20.0,2,0.79,5.0,5.0,0.0,0.0,0.86,6.3,4.5,1.8,0.57,1.19,Matches,275.0,pl POL,MFFW,32.0,3.1,189.0,3.0,25.0,82.0,85.0,9.0,189.0,6.0,2.0,33.3,4.0,66.7,110.0,385.0,149.0,5.0,5.0,2.0,11.0,1.0,124.0,21.0,Matches,275.0,pl POL,MFFW,32.0,3.1,0.0,4.0,1.0,25.0,1.29,0.32,0.0,0.0,21.7,0.0,0.0,0.0,0.2,0.2,0.04,-0.2,-0.2,Matches,275.0,pl POL,MFFW,32.0,14.0,0.0,280.0,3.1,0.0,0.0,0.0,0.0,0.0,0.0,2.0,0.0,0.2,0.2,0.2,0.4,5.0,16.0,21.0,0.0,0.0,0.0,0.0,0.0,0.05,0.06,0.12,0.05,0.12,Matches,Mateusz Klich,M/AM C,32,135,145,Poland,Leeds United,10,10,9,12,13,11,7,13,4,10,14,16,11,13,15,13,15,13,12,14,12,17,12,13,13,11,16,20,11,10,13,11,18,12,19,11,13,10,14,4,10,2,2,1,1,3,3,3,1,3,3,3,14,11,17,17,14,13,3,8,1,1,1,1,1,1,11,1,20,1,1,17,1,10,183,84,11,20,347975206,6750,7050,5750,Northern_European,132,6,1990/6/13,40,2,40597.0,,54005896
248,Cheikhou Kouyaté,Nott'ham Forest,1989,280.0,sn SEN,MF,32.0,9.8,29.0,21.0,18.0,8.0,3.0,9.0,13.0,69.2,4.0,14.0,2.0,12.0,10.0,39.0,24.0,0.0,Matches,280.0,sn SEN,MF,32.0,9.8,10.0,1.02,10.0,0.0,0.0,0.0,0.0,0.0,0.0,0.0,0.0,0.0,0.0,0.0,0.0,0.0,Matches,,,,,,,,,,,,,,,,,,,,,,,,,,,,,,,,,,,,,,,,,,,,,,,,,,,,,,,,280.0,sn SEN,MF,32.0,9.8,3.0,0.0,0.0,22.0,12.0,1.0,0.0,10.0,21.0,0.0,0.0,0.0,56.0,18.0,8.0,69.2,Matches,280.0,sn SEN,MF,32.0,9.8,246.0,241.0,4.0,4.0,0.0,1.0,0.0,0.0,0.0,0.0,0.0,0.0,185.0,1.0,7.0,Matches,280.0,sn SEN,MF,32.0,9.8,185.0,246.0,75.2,2908.0,882.0,90.0,120.0,75.0,62.0,74.0,83.8,18.0,25.0,72.0,0.0,0.7,0.3,-0.7,7.0,13.0,2.0,0.0,19.0,Matches,356,sn SEN,MF,32,21,882.0,42.0,25.8,9.8,10,68.0,1,11,18.0,1,1.05,9.0,23.0,-14.0,-1.43,-0.86,9.3,16.7,-7.4,-0.75,-0.13,Matches,280.0,sn SEN,MF,32.0,9.8,363.0,39.0,136.0,166.0,64.0,14.0,363.0,10.0,7.0,70.0,1.0,10.0,160.0,725.0,304.0,7.0,4.0,3.0,15.0,9.0,175.0,14.0,Matches,280.0,sn SEN,MF,32.0,9.8,1.0,6.0,5.0,83.3,0.61,0.51,0.17,0.2,19.4,0.0,0.0,0.0,0.4,0.4,0.06,0.6,0.6,Matches,280.0,sn SEN,MF,32.0,21.0,10.0,882.0,9.8,1.0,0.0,1.0,1.0,0.0,0.0,3.0,0.0,0.4,0.4,0.7,1.1,7.0,19.0,14.0,0.1,0.0,0.1,0.1,0.1,0.04,0.07,0.11,0.04,0.11,Matches,Cheikhou Kouyaté,D/DM/M C,32,134,141,"Senegal,Belgium",Nottingham Forest,4,8,10,7,12,5,14,7,10,14,12,10,15,12,16,13,15,13,12,10,12,14,10,12,9,14,13,16,13,13,13,16,15,12,14,15,13,14,14,7,13,2,2,2,1,2,2,1,2,3,2,1,13,12,5,10,13,11,10,9,1,1,17,1,1,1,20,1,20,1,1,1,1,1,192,83,7,20,9008852,6700,6700,5800,African_Caribbean,123,18,1989/12/21,77,4,46397.0,,18022052
249,Emil Krafth,Newcastle Utd,1994,282.0,se SWE,DF,27.0,0.0,0.0,0.0,0.0,0.0,0.0,0.0,0.0,,0.0,0.0,0.0,0.0,0.0,0.0,0.0,0.0,Matches,282.0,se SWE,DF,27.0,0.0,0.0,0.0,0.0,0.0,0.0,0.0,0.0,0.0,0.0,0.0,0.0,0.0,0.0,0.0,0.0,0.0,Matches,,,,,,,,,,,,,,,,,,,,,,,,,,,,,,,,,,,,,,,,,,,,,,,,,,,,,,,,282.0,se SWE,DF,27.0,0.0,0.0,0.0,0.0,0.0,0.0,0.0,0.0,0.0,0.0,0.0,0.0,0.0,0.0,0.0,0.0,,Matches,282.0,se SWE,DF,27.0,0.0,0.0,0.0,0.0,0.0,0.0,0.0,0.0,0.0,0.0,0.0,0.0,0.0,0.0,0.0,0.0,Matches,282.0,se SWE,DF,27.0,0.0,0.0,0.0,,0.0,0.0,0.0,0.0,,0.0,0.0,,0.0,0.0,,0.0,0.0,0.0,0.0,0.0,0.0,0.0,0.0,0.0,Matches,359,se SWE,DF,27,1,1.0,1.0,0.0,0.0,0,,0,1,1.0,0,1.0,0.0,0.0,0.0,0.0,-0.92,0.0,0.1,-0.1,-8.84,-9.7,Matches,282.0,se SWE,DF,27.0,0.0,1.0,0.0,1.0,0.0,0.0,0.0,1.0,0.0,0.0,,0.0,,0.0,0.0,0.0,0.0,0.0,0.0,0.0,0.0,0.0,0.0,Matches,282.0,se SWE,DF,27.0,0.0,0.0,0.0,0.0,,0.0,0.0,,,,0.0,0.0,0.0,0.0,0.0,,0.0,0.0,Matches,282.0,se SWE,DF,27.0,1.0,0.0,1.0,0.0,0.0,0.0,0.0,0.0,0.0,0.0,0.0,0.0,0.0,0.0,0.0,0.0,0.0,0.0,0.0,0.0,0.0,0.0,0.0,0.0,0.0,0.0,0.0,0.0,0.0,Matches,Emil Krafth,D/WB R,27,129,129,Sweden,Newcastle United,8,13,11,7,11,9,12,10,10,12,12,7,13,13,11,13,13,12,12,14,12,13,8,8,12,13,13,14,14,13,15,12,12,15,14,13,13,8,11,11,9,3,4,1,3,1,2,3,3,2,2,2,10,12,2,12,13,16,14,15,1,8,14,20,8,18,1,1,1,12,1,1,5,1,184,83,8,20,2114704,6450,6300,5250,Northern_European,128,4,1994/8/2,42,0,40597.0,,93031462
250,Layvin Kurzawa,Fulham,1992,285.0,fr FRA,DF,29.0,1.5,3.0,2.0,1.0,1.0,1.0,3.0,3.0,100.0,0.0,1.0,1.0,0.0,2.0,5.0,4.0,0.0,Matches,285.0,fr FRA,DF,29.0,1.5,0.0,0.0,0.0,0.0,0.0,0.0,0.0,0.0,0.0,0.0,0.0,0.0,0.0,0.0,0.0,0.0,Matches,,,,,,,,,,,,,,,,,,,,,,,,,,,,,,,,,,,,,,,,,,,,,,,,,,,,,,,,285.0,fr FRA,DF,29.0,1.5,1.0,0.0,0.0,1.0,0.0,0.0,2.0,2.0,2.0,0.0,0.0,0.0,5.0,0.0,2.0,0.0,Matches,285.0,fr FRA,DF,29.0,1.5,41.0,29.0,12.0,0.0,0.0,0.0,2.0,12.0,0.0,0.0,0.0,0.0,28.0,0.0,2.0,Matches,285.0,fr FRA,DF,29.0,1.5,28.0,41.0,68.3,408.0,135.0,12.0,13.0,92.3,14.0,19.0,73.7,0.0,3.0,0.0,0.0,0.0,0.0,0.0,0.0,1.0,1.0,1.0,2.0,Matches,362,fr FRA,DF,29,3,135.0,45.0,3.9,1.5,2,67.0,1,1,1.0,6,0.33,0.0,4.0,-4.0,-2.67,-2.83,1.1,4.4,-3.3,-2.21,-1.82,Matches,285.0,fr FRA,DF,29.0,1.5,64.0,8.0,35.0,18.0,11.0,0.0,64.0,4.0,2.0,50.0,2.0,50.0,29.0,100.0,20.0,1.0,0.0,0.0,3.0,1.0,24.0,2.0,Matches,285.0,fr FRA,DF,29.0,1.5,0.0,0.0,0.0,,0.0,0.0,,,,0.0,0.0,0.0,0.0,0.0,,0.0,0.0,Matches,285.0,fr FRA,DF,29.0,3.0,2.0,135.0,1.5,0.0,0.0,0.0,0.0,0.0,0.0,1.0,0.0,0.0,0.0,0.0,0.0,1.0,2.0,2.0,0.0,0.0,0.0,0.0,0.0,0.0,0.0,0.0,0.0,0.0,Matches,Layvin Kurzawa,D/WB L,29,133,145,"France,Martinique",Paris Saint-Germain,10,13,12,10,14,10,12,10,13,10,13,13,12,14,10,12,12,14,12,12,10,14,12,10,15,10,14,15,14,14,14,13,12,14,15,13,10,9,12,13,10,1,2,2,3,2,2,2,2,1,1,3,9,12,10,13,12,12,15,13,1,20,1,10,18,1,1,10,1,1,10,1,1,1,182,74,20,8,3561730,6650,6150,5250,Mixed_Race,129,11,1992/9/4,13,1,103561.0,Fulham,85010869
251,Adam Lallana,Brighton,1988,286.0,eng ENG,MFFW,34.0,8.0,9.0,4.0,6.0,2.0,1.0,0.0,7.0,0.0,7.0,6.0,0.0,6.0,2.0,11.0,1.0,0.0,Matches,286.0,eng ENG,MFFW,34.0,8.0,22.0,2.75,22.0,0.0,0.0,0.0,0.0,0.0,2.0,0.25,2.0,0.0,0.0,0.0,0.0,0.0,Matches,,,,,,,,,,,,,,,,,,,,,,,,,,,,,,,,,,,,,,,,,,,,,,,,,,,,,,,,286.0,eng ENG,MFFW,34.0,8.0,0.0,0.0,0.0,2.0,7.0,0.0,3.0,2.0,4.0,0.0,0.0,0.0,25.0,8.0,9.0,47.1,Matches,286.0,eng ENG,MFFW,34.0,8.0,317.0,304.0,11.0,2.0,0.0,0.0,3.0,2.0,1.0,0.0,0.0,0.0,262.0,2.0,5.0,Matches,286.0,eng ENG,MFFW,34.0,8.0,262.0,317.0,82.6,3033.0,656.0,173.0,194.0,89.2,57.0,74.0,77.0,6.0,9.0,66.7,1.0,1.0,1.2,0.0,14.0,23.0,9.0,1.0,33.0,Matches,363,eng ENG,MFFW,34,16,722.0,45.0,21.1,8.0,12,55.0,0,4,15.0,0,1.56,16.0,10.0,6.0,0.75,0.31,12.0,10.7,1.3,0.16,-0.56,Matches,286.0,eng ENG,MFFW,34.0,8.0,373.0,6.0,43.0,180.0,151.0,33.0,373.0,6.0,3.0,50.0,3.0,50.0,206.0,839.0,420.0,10.0,4.0,4.0,15.0,11.0,295.0,43.0,Matches,286.0,eng ENG,MFFW,34.0,8.0,2.0,8.0,5.0,62.5,1.0,0.62,0.25,0.4,13.3,0.0,0.0,0.0,0.9,0.9,0.11,1.1,1.1,Matches,286.0,eng ENG,MFFW,34.0,16.0,12.0,722.0,8.0,2.0,1.0,3.0,2.0,0.0,0.0,0.0,0.0,0.9,0.9,1.0,1.9,10.0,33.0,43.0,0.25,0.12,0.37,0.25,0.37,0.11,0.12,0.23,0.11,0.23,Matches,Adam Lallana,DM/M/AM C,34,142,159,England,Brighton & Hove Albion,11,13,16,8,16,7,6,7,4,11,15,9,9,18,11,15,12,16,15,15,15,15,16,14,16,11,16,14,10,13,13,6,14,10,11,9,15,7,16,15,12,2,3,1,3,1,3,3,1,3,2,1,16,15,8,15,15,18,13,15,1,1,1,1,1,1,17,14,19,14,14,20,14,1,173,73,14,20,5797608,7099,7099,6249,Northern_European,134,4,1988/5/10,34,3,77714.0,,5125012
252,Tariq Lamptey,Brighton,2000,287.0,gh GHA,DF,21.0,5.0,11.0,6.0,6.0,4.0,1.0,5.0,7.0,71.4,2.0,7.0,3.0,4.0,7.0,18.0,2.0,0.0,Matches,287.0,gh GHA,DF,21.0,5.0,14.0,2.78,12.0,0.0,1.0,0.0,1.0,0.0,0.0,0.0,0.0,0.0,0.0,0.0,0.0,0.0,Matches,,,,,,,,,,,,,,,,,,,,,,,,,,,,,,,,,,,,,,,,,,,,,,,,,,,,,,,,287.0,gh GHA,DF,21.0,5.0,1.0,0.0,0.0,6.0,14.0,0.0,31.0,7.0,6.0,0.0,0.0,0.0,31.0,2.0,7.0,22.2,Matches,287.0,gh GHA,DF,21.0,5.0,302.0,258.0,44.0,5.0,1.0,1.0,31.0,39.0,0.0,0.0,0.0,0.0,239.0,0.0,6.0,Matches,287.0,gh GHA,DF,21.0,5.0,239.0,302.0,79.1,3509.0,854.0,130.0,149.0,87.2,96.0,116.0,82.8,5.0,21.0,23.8,0.0,0.2,0.7,-0.2,4.0,14.0,8.0,5.0,26.0,Matches,364,gh GHA,DF,21,20,453.0,23.0,13.2,5.0,3,60.0,1,17,16.0,3,1.6,6.0,7.0,-1.0,-0.2,-0.81,7.5,6.5,1.0,0.2,-0.47,Matches,287.0,gh GHA,DF,21.0,5.0,376.0,15.0,80.0,138.0,161.0,17.0,376.0,28.0,8.0,28.6,13.0,46.4,232.0,1451.0,808.0,28.0,12.0,7.0,16.0,2.0,256.0,58.0,Matches,287.0,gh GHA,DF,21.0,5.0,0.0,5.0,0.0,0.0,0.99,0.0,0.0,,20.1,0.0,0.0,0.0,0.2,0.2,0.04,-0.2,-0.2,Matches,287.0,gh GHA,DF,21.0,20.0,3.0,453.0,5.0,0.0,0.0,0.0,0.0,0.0,0.0,1.0,0.0,0.2,0.2,0.2,0.4,28.0,26.0,58.0,0.0,0.0,0.0,0.0,0.0,0.04,0.04,0.08,0.04,0.08,Matches,Tariq Lamptey,D/WB RL,21,142,167,"Ghana,England",Brighton & Hove Albion,6,11,14,8,12,6,7,7,6,7,12,9,11,12,10,12,14,13,12,10,11,14,11,8,12,9,12,14,20,16,15,2,8,16,14,6,18,8,15,7,13,2,2,1,3,3,3,2,1,3,2,3,15,12,5,11,15,14,11,14,1,17,1,20,17,20,1,14,1,15,13,1,13,1,164,62,10,20,79412582,7100,7100,5500,African_Caribbean,117,18,2000/9/30,0,0,52196.0,,28112993
253,Manuel Lanzini,West Ham,1993,288.0,ar ARG,MFFW,29.0,2.8,2.0,2.0,1.0,1.0,0.0,2.0,6.0,33.3,4.0,2.0,0.0,2.0,2.0,4.0,0.0,0.0,Matches,288.0,ar ARG,MFFW,29.0,2.8,4.0,1.43,3.0,0.0,0.0,1.0,0.0,0.0,0.0,0.0,0.0,0.0,0.0,0.0,0.0,0.0,Matches,,,,,,,,,,,,,,,,,,,,,,,,,,,,,,,,,,,,,,,,,,,,,,,,,,,,,,,,288.0,ar ARG,MFFW,29.0,2.8,0.0,0.0,0.0,1.0,2.0,2.0,2.0,2.0,2.0,0.0,0.0,0.0,21.0,1.0,2.0,33.3,Matches,288.0,ar ARG,MFFW,29.0,2.8,175.0,173.0,2.0,0.0,0.0,0.0,2.0,0.0,0.0,0.0,0.0,0.0,146.0,0.0,5.0,Matches,288.0,ar ARG,MFFW,29.0,2.8,146.0,175.0,83.4,2221.0,522.0,82.0,94.0,87.2,48.0,53.0,90.6,11.0,17.0,64.7,0.0,0.2,0.3,-0.2,1.0,13.0,3.0,0.0,19.0,Matches,365,ar ARG,MFFW,29,10,252.0,25.0,7.4,2.8,2,73.0,1,8,13.0,28,0.7,2.0,5.0,-3.0,-1.07,-0.79,3.0,5.8,-2.7,-0.98,-0.95,Matches,288.0,ar ARG,MFFW,29.0,2.8,192.0,3.0,32.0,111.0,50.0,3.0,192.0,3.0,1.0,33.3,0.0,0.0,116.0,524.0,203.0,2.0,6.0,0.0,2.0,3.0,150.0,6.0,Matches,288.0,ar ARG,MFFW,29.0,2.8,1.0,3.0,1.0,33.3,1.07,0.36,0.33,1.0,23.1,0.0,0.0,0.0,0.5,0.5,0.18,0.5,0.5,Matches,288.0,ar ARG,MFFW,29.0,10.0,2.0,252.0,2.8,1.0,0.0,1.0,1.0,0.0,0.0,0.0,0.0,0.5,0.5,0.2,0.7,2.0,19.0,6.0,0.36,0.0,0.36,0.36,0.36,0.19,0.06,0.25,0.19,0.25,Matches,Manuel Lanzini,M/AM C,29,140,150,"Argentina,Italy",West Ham United,13,12,15,13,16,13,8,13,2,6,14,10,5,16,12,15,9,15,11,13,14,12,15,10,15,7,13,12,15,14,13,5,12,14,13,8,13,8,15,13,12,2,1,3,1,3,1,1,1,3,1,1,14,13,8,13,8,13,7,13,1,1,1,1,1,1,14,10,18,1,14,20,12,8,167,59,13,20,27606033,7000,7000,5500,Mediterranean_Hispanic,140,8,1993/2/15,5,1,81194.0,,14025513
254,Juan Larios,Southampton,2004,290.0,es ESP,DF,18.0,1.7,7.0,6.0,6.0,1.0,0.0,5.0,5.0,100.0,0.0,2.0,0.0,2.0,3.0,10.0,4.0,0.0,Matches,290.0,es ESP,DF,18.0,1.7,1.0,0.59,1.0,0.0,0.0,0.0,0.0,0.0,1.0,0.59,1.0,0.0,0.0,0.0,0.0,0.0,Matches,,,,,,,,,,,,,,,,,,,,,,,,,,,,,,,,,,,,,,,,,,,,,,,,,,,,,,,,290.0,es ESP,DF,18.0,1.7,0.0,0.0,0.0,1.0,0.0,0.0,4.0,3.0,6.0,0.0,0.0,0.0,9.0,2.0,5.0,28.6,Matches,290.0,es ESP,DF,18.0,1.7,82.0,59.0,23.0,0.0,0.0,0.0,4.0,23.0,0.0,0.0,0.0,0.0,63.0,0.0,2.0,Matches,290.0,es ESP,DF,18.0,1.7,63.0,82.0,76.8,881.0,326.0,40.0,46.0,87.0,21.0,27.0,77.8,2.0,4.0,50.0,0.0,0.0,0.0,0.0,0.0,5.0,0.0,0.0,4.0,Matches,367,es ESP,DF,18,5,152.0,30.0,4.4,1.7,2,46.0,0,3,20.0,4,0.6,1.0,2.0,-1.0,-0.59,0.4,1.4,2.5,-1.1,-0.66,-0.05,Matches,290.0,es ESP,DF,18.0,1.7,106.0,10.0,32.0,55.0,20.0,2.0,106.0,4.0,3.0,75.0,1.0,25.0,38.0,338.0,201.0,10.0,2.0,1.0,3.0,2.0,47.0,1.0,Matches,290.0,es ESP,DF,18.0,1.7,0.0,0.0,0.0,,0.0,0.0,,,,0.0,0.0,0.0,0.0,0.0,,0.0,0.0,Matches,290.0,es ESP,DF,18.0,5.0,2.0,152.0,1.7,0.0,0.0,0.0,0.0,0.0,0.0,0.0,0.0,0.0,0.0,0.0,0.0,10.0,4.0,1.0,0.0,0.0,0.0,0.0,0.0,0.0,0.0,0.0,0.0,0.0,Matches,Juan Larios,D/WB L,18,115,-8,Spain,Southampton,10,12,13,7,12,8,8,7,9,11,13,7,12,14,12,7,12,12,10,8,9,15,10,9,9,9,14,14,16,15,13,7,12,14,14,8,12,10,13,8,16,1,1,1,2,2,3,4,2,2,1,1,8,9,1,13,9,10,12,18,1,20,1,12,17,12,1,1,1,1,1,1,1,1,171,0,20,8,32709669,6150,5750,4250,Mediterranean_Hispanic,106,8,2004/1/12,0,0,6960.0,,2000030287
255,Jamaal Lascelles,Newcastle Utd,1993,291.0,eng ENG,DF,28.0,2.4,1.0,0.0,1.0,0.0,0.0,1.0,1.0,100.0,0.0,3.0,2.0,1.0,0.0,1.0,17.0,0.0,Matches,291.0,eng ENG,DF,28.0,2.4,1.0,0.41,0.0,0.0,0.0,1.0,0.0,0.0,0.0,0.0,0.0,0.0,0.0,0.0,0.0,0.0,Matches,,,,,,,,,,,,,,,,,,,,,,,,,,,,,,,,,,,,,,,,,,,,,,,,,,,,,,,,291.0,eng ENG,DF,28.0,2.4,4.0,0.0,0.0,6.0,2.0,0.0,0.0,0.0,0.0,0.0,0.0,0.0,5.0,5.0,3.0,62.5,Matches,291.0,eng ENG,DF,28.0,2.4,93.0,93.0,0.0,0.0,0.0,0.0,0.0,0.0,0.0,0.0,0.0,0.0,79.0,0.0,0.0,Matches,291.0,eng ENG,DF,28.0,2.4,79.0,93.0,84.9,1445.0,580.0,29.0,34.0,85.3,40.0,44.0,90.9,7.0,11.0,63.6,0.0,0.0,0.0,0.0,0.0,4.0,0.0,0.0,3.0,Matches,368,eng ENG,DF,28,7,218.0,31.0,6.4,2.4,2,90.0,2,5,8.0,21,1.89,2.0,5.0,-3.0,-1.24,-2.31,2.6,4.3,-1.7,-0.69,-1.65,Matches,291.0,eng ENG,DF,28.0,2.4,118.0,27.0,68.0,47.0,4.0,4.0,118.0,0.0,0.0,,0.0,,64.0,269.0,103.0,0.0,0.0,0.0,0.0,0.0,75.0,0.0,Matches,291.0,eng ENG,DF,28.0,2.4,0.0,2.0,0.0,0.0,0.83,0.0,0.0,,9.7,0.0,0.0,0.0,0.1,0.1,0.05,-0.1,-0.1,Matches,291.0,eng ENG,DF,28.0,7.0,2.0,218.0,2.4,0.0,0.0,0.0,0.0,0.0,0.0,4.0,0.0,0.1,0.1,0.0,0.1,0.0,3.0,0.0,0.0,0.0,0.0,0.0,0.0,0.04,0.0,0.04,0.04,0.04,Matches,Jamaal Lascelles,D C,28,125,148,England,Newcastle United,3,4,8,5,10,3,15,3,3,14,10,3,15,10,15,13,15,11,11,4,12,14,4,17,8,12,15,15,11,10,11,15,16,13,14,16,13,9,16,5,10,1,3,3,2,1,3,3,2,3,3,1,13,13,5,13,13,15,12,13,1,1,20,1,1,1,1,1,1,1,1,1,1,1,188,89,13,20,4769912,6250,6250,5250,Northern_European,123,12,1993/11/11,0,0,63795.0,,28059634
256,Jamal Lewis,Newcastle Utd,1998,298.0,nir NIR,DFFW,24.0,0.1,0.0,0.0,0.0,0.0,0.0,0.0,0.0,,0.0,0.0,0.0,0.0,0.0,0.0,0.0,0.0,Matches,298.0,nir NIR,DFFW,24.0,0.1,0.0,0.0,0.0,0.0,0.0,0.0,0.0,0.0,0.0,0.0,0.0,0.0,0.0,0.0,0.0,0.0,Matches,,,,,,,,,,,,,,,,,,,,,,,,,,,,,,,,,,,,,,,,,,,,,,,,,,,,,,,,298.0,nir NIR,DFFW,24.0,0.1,0.0,0.0,0.0,0.0,0.0,0.0,0.0,0.0,0.0,0.0,0.0,0.0,2.0,0.0,1.0,0.0,Matches,298.0,nir NIR,DFFW,24.0,0.1,14.0,14.0,0.0,0.0,0.0,0.0,0.0,0.0,0.0,0.0,0.0,0.0,12.0,0.0,1.0,Matches,298.0,nir NIR,DFFW,24.0,0.1,12.0,14.0,85.7,192.0,71.0,3.0,3.0,100.0,8.0,9.0,88.9,0.0,0.0,,0.0,0.0,0.0,0.0,0.0,0.0,0.0,0.0,1.0,Matches,375,nir NIR,DFFW,24,2,11.0,6.0,0.3,0.1,0,,0,2,6.0,20,2.0,0.0,1.0,-1.0,-8.18,-9.13,0.1,1.0,-1.0,-7.94,-8.82,Matches,298.0,nir NIR,DFFW,24.0,0.1,15.0,0.0,6.0,4.0,5.0,2.0,15.0,0.0,0.0,,0.0,,10.0,40.0,10.0,0.0,1.0,0.0,0.0,0.0,13.0,1.0,Matches,298.0,nir NIR,DFFW,24.0,0.1,0.0,0.0,0.0,,0.0,0.0,,,,0.0,0.0,0.0,0.0,0.0,,0.0,0.0,Matches,298.0,nir NIR,DFFW,24.0,2.0,0.0,11.0,0.1,0.0,0.0,0.0,0.0,0.0,0.0,0.0,0.0,0.0,0.0,0.0,0.0,0.0,1.0,1.0,0.0,0.0,0.0,0.0,0.0,0.0,0.0,0.0,0.0,0.0,Matches,Jamal Lewis,D/WB L,24,124,154,"Northern Ireland,England",Newcastle United,4,11,12,6,12,6,11,8,5,12,12,6,12,13,10,12,12,12,12,10,11,14,5,2,11,11,13,14,14,13,15,10,18,15,16,10,12,2,13,7,10,3,4,2,3,3,3,2,1,2,3,1,12,16,2,12,10,17,12,10,1,20,9,1,20,1,1,15,1,1,15,1,1,1,178,70,20,8,7633048,6200,6200,4750,African_Caribbean,114,14,1998/1/25,26,0,57996.0,,28105687
257,Keane Lewis-Potter,Brentford,2001,300.0,eng ENG,FWMF,21.0,3.6,1.0,0.0,0.0,1.0,0.0,0.0,0.0,,0.0,5.0,1.0,4.0,0.0,1.0,2.0,0.0,Matches,300.0,eng ENG,FWMF,21.0,3.6,8.0,2.24,2.0,0.0,2.0,4.0,0.0,0.0,2.0,0.56,0.0,0.0,0.0,2.0,0.0,0.0,Matches,,,,,,,,,,,,,,,,,,,,,,,,,,,,,,,,,,,,,,,,,,,,,,,,,,,,,,,,300.0,eng ENG,FWMF,21.0,3.6,0.0,0.0,0.0,1.0,4.0,1.0,8.0,0.0,0.0,0.0,0.0,0.0,20.0,4.0,4.0,50.0,Matches,300.0,eng ENG,FWMF,21.0,3.6,86.0,83.0,3.0,0.0,1.0,1.0,8.0,2.0,0.0,0.0,0.0,0.0,49.0,0.0,3.0,Matches,300.0,eng ENG,FWMF,21.0,3.6,49.0,86.0,57.0,600.0,118.0,33.0,50.0,66.0,12.0,17.0,70.6,1.0,10.0,10.0,1.0,1.2,0.3,-0.2,5.0,2.0,3.0,1.0,6.0,Matches,377,eng ENG,FWMF,21,10,321.0,32.0,9.4,3.6,3,61.0,0,7,20.0,9,1.5,10.0,4.0,6.0,1.68,1.51,7.2,4.1,3.2,0.89,0.79,Matches,300.0,eng ENG,FWMF,21.0,3.6,138.0,4.0,24.0,48.0,69.0,18.0,138.0,14.0,4.0,28.6,10.0,71.4,93.0,652.0,336.0,8.0,6.0,3.0,11.0,8.0,91.0,39.0,Matches,300.0,eng ENG,FWMF,21.0,3.6,0.0,7.0,2.0,28.6,1.96,0.56,0.0,0.0,14.1,0.0,0.0,0.0,0.5,0.5,0.07,-0.5,-0.5,Matches,300.0,eng ENG,FWMF,21.0,10.0,3.0,321.0,3.6,0.0,1.0,1.0,0.0,0.0,0.0,0.0,0.0,0.5,0.5,1.2,1.7,8.0,6.0,39.0,0.0,0.28,0.28,0.0,0.28,0.14,0.35,0.49,0.14,0.49,Matches,Keane Lewis-Potter,M/AM RLC,21,128,151,England,Brentford,11,13,14,14,13,12,13,14,9,7,13,13,7,12,11,13,10,14,11,13,12,17,13,6,12,7,10,14,14,14,13,10,14,14,13,9,12,6,14,4,14,2,3,1,1,1,3,2,2,3,4,3,13,14,4,13,13,16,14,13,1,1,1,1,10,10,1,16,1,15,20,18,19,14,170,0,7,20,34519140,6400,6400,4250,Northern_European,126,4,2001/2/22,0,0,40597.0,,28113414
258,Diego Llorente,Leeds United,1993,304.0,es ESP,DF,28.0,7.2,13.0,10.0,8.0,5.0,0.0,4.0,8.0,50.0,4.0,6.0,2.0,4.0,15.0,28.0,24.0,2.0,Matches,304.0,es ESP,DF,28.0,7.2,6.0,0.83,5.0,0.0,0.0,1.0,0.0,0.0,1.0,0.14,1.0,0.0,0.0,0.0,0.0,0.0,Matches,,,,,,,,,,,,,,,,,,,,,,,,,,,,,,,,,,,,,,,,,,,,,,,,,,,,,,,,304.0,es ESP,DF,28.0,7.2,1.0,0.0,0.0,6.0,2.0,0.0,1.0,15.0,10.0,0.0,0.0,0.0,57.0,18.0,7.0,72.0,Matches,304.0,es ESP,DF,28.0,7.2,429.0,417.0,11.0,10.0,0.0,4.0,1.0,0.0,0.0,0.0,0.0,0.0,356.0,1.0,2.0,Matches,304.0,es ESP,DF,28.0,7.2,356.0,429.0,83.0,6969.0,2284.0,118.0,130.0,90.8,203.0,228.0,89.0,33.0,59.0,55.9,0.0,0.0,0.0,0.0,0.0,17.0,0.0,0.0,27.0,Matches,381,es ESP,DF,28,8,649.0,81.0,19.0,7.2,7,90.0,7,1,19.0,11,1.0,11.0,12.0,-1.0,-0.14,0.8,10.9,10.4,0.5,0.07,0.73,Matches,304.0,es ESP,DF,28.0,7.2,506.0,59.0,283.0,210.0,15.0,6.0,506.0,3.0,2.0,66.7,1.0,33.3,303.0,1566.0,721.0,2.0,1.0,0.0,6.0,1.0,312.0,1.0,Matches,304.0,es ESP,DF,28.0,7.2,0.0,6.0,0.0,0.0,0.83,0.0,0.0,,12.5,0.0,0.0,0.0,0.7,0.7,0.12,-0.7,-0.7,Matches,304.0,es ESP,DF,28.0,8.0,7.0,649.0,7.2,0.0,0.0,0.0,0.0,0.0,0.0,1.0,0.0,0.7,0.7,0.0,0.7,2.0,27.0,1.0,0.0,0.0,0.0,0.0,0.0,0.1,0.0,0.1,0.1,0.1,Matches,Diego Llorente,D C,28,129,153,Spain,Leeds United,3,6,10,6,13,3,13,6,10,13,14,9,15,14,13,15,17,14,11,14,12,12,8,10,9,13,15,15,12,10,9,13,13,15,14,13,9,12,10,14,14,3,1,1,2,1,1,2,1,3,3,1,14,14,8,12,12,14,13,12,1,12,20,12,1,10,12,1,1,1,1,1,1,1,186,75,13,20,8060759,6450,6900,6000,Mediterranean_Hispanic,128,6,1993/8/16,10,0,63795.0,,67011217
259,Jamal Lowe,Bournemouth,1994,309.0,jm JAM,MFFW,28.0,0.1,0.0,0.0,0.0,0.0,0.0,0.0,0.0,,0.0,0.0,0.0,0.0,0.0,0.0,0.0,0.0,Matches,309.0,jm JAM,MFFW,28.0,0.1,0.0,0.0,0.0,0.0,0.0,0.0,0.0,0.0,0.0,0.0,0.0,0.0,0.0,0.0,0.0,0.0,Matches,,,,,,,,,,,,,,,,,,,,,,,,,,,,,,,,,,,,,,,,,,,,,,,,,,,,,,,,309.0,jm JAM,MFFW,28.0,0.1,0.0,0.0,0.0,0.0,0.0,0.0,0.0,0.0,0.0,0.0,0.0,0.0,0.0,0.0,0.0,,Matches,309.0,jm JAM,MFFW,28.0,0.1,4.0,4.0,0.0,0.0,0.0,0.0,0.0,0.0,0.0,0.0,0.0,0.0,2.0,0.0,1.0,Matches,309.0,jm JAM,MFFW,28.0,0.1,2.0,4.0,50.0,18.0,3.0,1.0,1.0,100.0,0.0,0.0,,0.0,1.0,0.0,0.0,0.0,0.0,0.0,0.0,0.0,1.0,0.0,1.0,Matches,387,jm JAM,MFFW,28,2,12.0,6.0,0.4,0.1,0,,0,2,6.0,8,0.0,0.0,0.0,0.0,0.0,0.9,0.1,0.7,-0.7,-4.95,-4.3,Matches,309.0,jm JAM,MFFW,28.0,0.1,4.0,0.0,0.0,3.0,1.0,0.0,4.0,0.0,0.0,,0.0,,2.0,7.0,1.0,0.0,0.0,0.0,0.0,0.0,3.0,0.0,Matches,309.0,jm JAM,MFFW,28.0,0.1,0.0,0.0,0.0,,0.0,0.0,,,,0.0,0.0,0.0,0.0,0.0,,0.0,0.0,Matches,309.0,jm JAM,MFFW,28.0,2.0,0.0,12.0,0.1,0.0,0.0,0.0,0.0,0.0,0.0,0.0,0.0,0.0,0.0,0.0,0.0,0.0,1.0,0.0,0.0,0.0,0.0,0.0,0.0,0.0,0.0,0.0,0.0,0.0,Matches,Jamal Lowe,AM/S RL,28,124,131,"Jamaica,England",AFC Bournemouth,8,11,14,12,12,7,8,12,5,7,11,8,6,13,10,12,9,12,9,11,11,12,15,6,11,8,11,14,13,12,15,11,17,14,15,13,13,3,13,2,12,2,1,3,1,1,3,1,2,3,3,3,11,12,2,12,15,14,9,9,1,1,1,1,1,1,1,1,1,1,20,14,18,19,183,75,10,20,8041836,6200,6200,3812,African_Caribbean,117,14,1994/7/21,4,2,28998.0,,29085571
260,Saša Lukić,Fulham,1996,311.0,rs SRB,MF,25.0,4.6,8.0,3.0,1.0,4.0,3.0,3.0,7.0,42.9,4.0,6.0,2.0,4.0,5.0,13.0,3.0,0.0,Matches,311.0,rs SRB,MF,25.0,4.6,5.0,1.09,4.0,0.0,0.0,0.0,0.0,1.0,1.0,0.22,0.0,0.0,0.0,0.0,0.0,1.0,Matches,,,,,,,,,,,,,,,,,,,,,,,,,,,,,,,,,,,,,,,,,,,,,,,,,,,,,,,,311.0,rs SRB,MF,25.0,4.6,1.0,0.0,0.0,13.0,10.0,0.0,2.0,5.0,3.0,0.0,0.0,0.0,28.0,4.0,5.0,44.4,Matches,311.0,rs SRB,MF,25.0,4.6,218.0,211.0,7.0,7.0,0.0,0.0,2.0,0.0,0.0,0.0,0.0,0.0,192.0,0.0,0.0,Matches,311.0,rs SRB,MF,25.0,4.6,192.0,218.0,88.1,3180.0,681.0,86.0,97.0,88.7,91.0,99.0,91.9,12.0,16.0,75.0,0.0,0.0,0.1,0.0,0.0,20.0,2.0,1.0,13.0,Matches,389,rs SRB,MF,25,12,412.0,34.0,12.0,4.6,4,75.0,1,8,14.0,4,1.33,3.0,10.0,-7.0,-1.53,-1.8,4.8,9.8,-5.0,-1.1,-0.73,Matches,311.0,rs SRB,MF,25.0,4.6,253.0,9.0,49.0,155.0,52.0,3.0,253.0,5.0,4.0,80.0,1.0,20.0,146.0,875.0,413.0,8.0,7.0,1.0,3.0,1.0,171.0,5.0,Matches,311.0,rs SRB,MF,25.0,4.6,0.0,5.0,1.0,20.0,1.09,0.22,0.0,0.0,27.1,0.0,0.0,0.0,0.1,0.1,0.02,-0.1,-0.1,Matches,311.0,rs SRB,MF,25.0,12.0,4.0,412.0,4.6,0.0,0.0,0.0,0.0,0.0,0.0,1.0,0.0,0.1,0.1,0.0,0.1,8.0,13.0,5.0,0.0,0.0,0.0,0.0,0.0,0.03,0.0,0.03,0.03,0.03,Matches,Saša Lukić,DM/M/AM C,25,137,143,Serbia,Torino,12,11,13,11,14,7,11,13,4,10,15,14,14,14,15,13,12,14,13,13,13,14,14,10,13,13,14,13,13,12,14,11,14,13,14,13,13,14,13,9,11,2,2,2,3,1,1,1,2,3,2,1,12,13,9,12,12,15,13,13,1,1,1,1,1,1,17,1,20,1,1,17,1,1,182,77,12,20,9337307,6850,6900,5200,Mediterranean_Hispanic,137,3,1996/8/13,30,1,25000.0,,62124117
261,Noni Madueke,Chelsea,2002,315.0,eng ENG,FW,20.0,7.1,12.0,8.0,5.0,4.0,3.0,6.0,13.0,46.2,7.0,13.0,2.0,11.0,4.0,16.0,7.0,0.0,Matches,315.0,eng ENG,FW,20.0,7.1,24.0,3.36,19.0,0.0,4.0,1.0,0.0,0.0,1.0,0.14,1.0,0.0,0.0,0.0,0.0,0.0,Matches,,,,,,,,,,,,,,,,,,,,,,,,,,,,,,,,,,,,,,,,,,,,,,,,,,,,,,,,315.0,eng ENG,FW,20.0,7.1,0.0,0.0,0.0,4.0,15.0,2.0,19.0,4.0,8.0,0.0,0.0,0.0,30.0,2.0,5.0,28.6,Matches,315.0,eng ENG,FW,20.0,7.1,286.0,278.0,8.0,0.0,0.0,0.0,19.0,7.0,1.0,1.0,0.0,0.0,223.0,0.0,9.0,Matches,315.0,eng ENG,FW,20.0,7.1,223.0,286.0,78.0,2972.0,771.0,137.0,162.0,84.6,66.0,86.0,76.7,8.0,12.0,66.7,0.0,0.5,0.7,-0.5,13.0,11.0,13.0,0.0,36.0,Matches,393,eng ENG,FW,20,12,643.0,54.0,18.8,7.1,7,75.0,0,5,24.0,4,0.83,6.0,13.0,-7.0,-0.98,-0.91,8.1,12.5,-4.4,-0.62,-0.66,Matches,315.0,eng ENG,FW,20.0,7.1,405.0,11.0,45.0,133.0,233.0,62.0,405.0,63.0,33.0,52.4,24.0,38.1,278.0,2090.0,1203.0,48.0,21.0,26.0,17.0,13.0,315.0,100.0,Matches,315.0,eng ENG,FW,20.0,7.1,1.0,12.0,6.0,50.0,1.68,0.84,0.08,0.17,15.6,0.0,0.0,0.0,0.9,0.9,0.08,0.1,0.1,Matches,315.0,eng ENG,FW,20.0,12.0,7.0,643.0,7.1,1.0,0.0,1.0,1.0,0.0,0.0,0.0,0.0,0.9,0.9,0.5,1.5,48.0,36.0,100.0,0.14,0.0,0.14,0.14,0.14,0.13,0.07,0.2,0.13,0.2,Matches,Noni Madueke,M/AM RLC,20,139,-9,"England,Nigeria",PSV Eindhoven,12,11,17,13,15,10,11,11,11,3,12,11,5,15,10,10,14,15,11,8,11,12,16,5,12,5,10,12,15,15,14,12,15,16,11,14,9,13,6,17,14,3,2,1,4,1,3,3,3,2,3,2,12,11,6,12,11,12,11,13,1,1,1,1,1,1,1,16,12,18,17,16,20,10,176,0,20,10,134930875,7000,6500,5000,African_Caribbean,132,15,2002/3/10,0,0,14383.0,,37076092
262,Harry Maguire,Manchester Utd,1993,317.0,eng ENG,DF,29.0,8.5,8.0,6.0,6.0,1.0,1.0,4.0,5.0,80.0,1.0,18.0,11.0,7.0,13.0,21.0,41.0,0.0,Matches,317.0,eng ENG,DF,29.0,8.5,5.0,0.59,5.0,0.0,0.0,0.0,0.0,0.0,1.0,0.12,1.0,0.0,0.0,0.0,0.0,0.0,Matches,,,,,,,,,,,,,,,,,,,,,,,,,,,,,,,,,,,,,,,,,,,,,,,,,,,,,,,,317.0,eng ENG,DF,29.0,8.5,4.0,0.0,0.0,8.0,4.0,0.0,1.0,13.0,6.0,0.0,0.0,0.0,55.0,25.0,22.0,53.2,Matches,317.0,eng ENG,DF,29.0,8.5,577.0,564.0,12.0,11.0,0.0,9.0,1.0,1.0,0.0,0.0,0.0,0.0,491.0,1.0,3.0,Matches,317.0,eng ENG,DF,29.0,8.5,491.0,577.0,85.1,9892.0,3056.0,147.0,165.0,89.1,276.0,304.0,90.8,58.0,93.0,62.4,0.0,0.0,0.1,0.0,1.0,31.0,0.0,0.0,26.0,Matches,395,eng ENG,DF,29,16,767.0,48.0,22.4,8.5,8,90.0,8,8,6.0,15,2.5,15.0,7.0,8.0,0.94,0.7,18.5,10.8,7.7,0.9,0.58,Matches,317.0,eng ENG,DF,29.0,8.5,672.0,77.0,353.0,291.0,32.0,9.0,672.0,3.0,2.0,66.7,1.0,33.3,414.0,2286.0,1449.0,8.0,6.0,1.0,1.0,0.0,448.0,4.0,Matches,317.0,eng ENG,DF,29.0,8.5,0.0,3.0,0.0,0.0,0.35,0.0,0.0,,9.0,0.0,0.0,0.0,0.3,0.3,0.12,-0.3,-0.3,Matches,317.0,eng ENG,DF,29.0,16.0,8.0,767.0,8.5,0.0,0.0,0.0,0.0,0.0,0.0,4.0,0.0,0.3,0.3,0.0,0.4,8.0,26.0,4.0,0.0,0.0,0.0,0.0,0.0,0.04,0.0,0.04,0.04,0.04,Matches,Harry Maguire,D C,29,145,158,England,Manchester UFC,4,6,10,8,13,6,17,7,7,15,13,10,16,13,14,15,17,13,12,12,12,11,12,15,7,16,14,12,10,8,13,17,17,12,17,17,12,12,13,5,8,1,2,3,4,2,3,1,1,4,1,1,15,15,5,13,11,16,14,17,1,1,20,10,1,1,1,1,1,1,1,1,1,1,194,100,10,20,57546395,7250,7800,7000,Northern_European,143,0,1993/3/5,46,7,231983.0,,28049740
263,Kobbie Mainoo,Manchester Utd,2005,319.0,eng ENG,MF,17.0,0.1,0.0,0.0,0.0,0.0,0.0,0.0,0.0,,0.0,1.0,1.0,0.0,0.0,0.0,0.0,0.0,Matches,319.0,eng ENG,MF,17.0,0.1,2.0,16.36,2.0,0.0,0.0,0.0,0.0,0.0,0.0,0.0,0.0,0.0,0.0,0.0,0.0,0.0,Matches,,,,,,,,,,,,,,,,,,,,,,,,,,,,,,,,,,,,,,,,,,,,,,,,,,,,,,,,319.0,eng ENG,MF,17.0,0.1,0.0,0.0,0.0,0.0,0.0,0.0,0.0,0.0,0.0,0.0,0.0,0.0,0.0,0.0,0.0,,Matches,319.0,eng ENG,MF,17.0,0.1,8.0,8.0,0.0,0.0,0.0,0.0,0.0,0.0,0.0,0.0,0.0,0.0,7.0,0.0,0.0,Matches,319.0,eng ENG,MF,17.0,0.1,7.0,8.0,87.5,83.0,31.0,5.0,6.0,83.3,2.0,2.0,100.0,0.0,0.0,,0.0,0.0,0.1,0.0,0.0,1.0,1.0,0.0,1.0,Matches,397,eng ENG,MF,17,1,11.0,11.0,0.3,0.1,0,,0,1,11.0,7,3.0,0.0,0.0,0.0,0.0,-0.4,0.6,0.3,0.3,2.37,1.92,Matches,319.0,eng ENG,MF,17.0,0.1,11.0,0.0,2.0,4.0,5.0,3.0,11.0,1.0,0.0,0.0,1.0,100.0,5.0,64.0,48.0,2.0,0.0,0.0,0.0,0.0,6.0,1.0,Matches,319.0,eng ENG,MF,17.0,0.1,0.0,0.0,0.0,,0.0,0.0,,,,0.0,0.0,0.0,0.0,0.0,,0.0,0.0,Matches,319.0,eng ENG,MF,17.0,1.0,0.0,11.0,0.1,0.0,0.0,0.0,0.0,0.0,0.0,0.0,0.0,0.0,0.0,0.0,0.0,2.0,1.0,1.0,0.0,0.0,0.0,0.0,0.0,0.0,0.0,0.0,0.0,0.0,Matches,Kobbie Mainoo,DM/M C,17,100,-85,"England,Ghana",Manchester UFC,5,8,12,8,14,5,6,7,4,8,13,7,10,14,14,11,10,15,12,10,11,2,10,6,11,10,12,12,14,13,12,8,15,13,12,10,10,5,6,3,14,1,3,3,1,3,2,3,3,4,4,2,13,11,4,10,10,12,10,20,1,1,1,1,1,1,18,1,20,13,1,14,1,1,180,66,11,20,44076859,5248,4751,2254,African_Caribbean,105,16,2005/4/19,0,0,1392.0,,2000123586
264,Marquinhos,Arsenal,2003,327.0,br BRA,MF,19.0,0.0,0.0,0.0,0.0,0.0,0.0,0.0,0.0,,0.0,0.0,0.0,0.0,0.0,0.0,0.0,0.0,Matches,327.0,br BRA,MF,19.0,0.0,0.0,0.0,0.0,0.0,0.0,0.0,0.0,0.0,0.0,0.0,0.0,0.0,0.0,0.0,0.0,0.0,Matches,,,,,,,,,,,,,,,,,,,,,,,,,,,,,,,,,,,,,,,,,,,,,,,,,,,,,,,,327.0,br BRA,MF,19.0,0.0,0.0,0.0,0.0,0.0,0.0,0.0,0.0,0.0,0.0,0.0,0.0,0.0,0.0,0.0,0.0,,Matches,327.0,br BRA,MF,19.0,0.0,3.0,3.0,0.0,0.0,0.0,0.0,0.0,0.0,0.0,0.0,0.0,0.0,2.0,0.0,0.0,Matches,327.0,br BRA,MF,19.0,0.0,2.0,3.0,66.7,34.0,5.0,1.0,2.0,50.0,1.0,1.0,100.0,0.0,0.0,,0.0,0.0,0.0,0.0,0.0,0.0,0.0,0.0,0.0,Matches,406,br BRA,MF,19,1,1.0,1.0,0.0,0.0,0,,0,1,1.0,14,3.0,0.0,0.0,0.0,0.0,-1.18,0.0,0.0,0.0,0.0,-0.78,Matches,327.0,br BRA,MF,19.0,0.0,3.0,0.0,0.0,2.0,1.0,0.0,3.0,0.0,0.0,,0.0,,2.0,6.0,1.0,0.0,0.0,0.0,0.0,0.0,3.0,0.0,Matches,327.0,br BRA,MF,19.0,0.0,0.0,0.0,0.0,,0.0,0.0,,,,0.0,0.0,0.0,0.0,0.0,,0.0,0.0,Matches,327.0,br BRA,MF,19.0,1.0,0.0,1.0,0.0,0.0,0.0,0.0,0.0,0.0,0.0,0.0,0.0,0.0,0.0,0.0,0.0,0.0,0.0,0.0,0.0,0.0,0.0,0.0,0.0,0.0,0.0,0.0,0.0,0.0,Matches,Marquinhos,D/DM C,28,164,165,"Brazil,Portugal",Paris Saint-Germain,4,11,10,8,14,4,15,10,7,16,14,8,16,14,14,17,15,17,17,13,16,17,10,15,8,16,17,15,13,13,16,13,15,14,16,14,15,8,15,8,15,1,1,3,1,3,3,3,1,1,1,3,15,16,7,15,14,18,15,16,1,1,20,14,1,1,16,1,1,1,1,1,1,1,183,75,10,20,191688462,8195,8595,7645,Mixed_Race,164,12,1994/5/14,69,4,276164.0,,19163495
265,Pape Matar Sarr,Tottenham,2002,332.0,sn SEN,MFFW,19.0,2.4,7.0,6.0,4.0,2.0,1.0,4.0,8.0,50.0,4.0,3.0,2.0,1.0,6.0,13.0,6.0,0.0,Matches,332.0,sn SEN,MFFW,19.0,2.4,4.0,1.65,4.0,0.0,0.0,0.0,0.0,0.0,2.0,0.83,2.0,0.0,0.0,0.0,0.0,0.0,Matches,,,,,,,,,,,,,,,,,,,,,,,,,,,,,,,,,,,,,,,,,,,,,,,,,,,,,,,,332.0,sn SEN,MFFW,19.0,2.4,1.0,0.0,0.0,4.0,3.0,0.0,0.0,6.0,6.0,0.0,1.0,0.0,22.0,3.0,5.0,37.5,Matches,332.0,sn SEN,MFFW,19.0,2.4,154.0,150.0,4.0,2.0,0.0,1.0,0.0,0.0,0.0,0.0,0.0,0.0,141.0,0.0,0.0,Matches,332.0,sn SEN,MFFW,19.0,2.4,141.0,154.0,91.6,2130.0,449.0,70.0,73.0,95.9,62.0,65.0,95.4,3.0,8.0,37.5,1.0,0.3,0.0,0.7,2.0,9.0,0.0,0.0,13.0,Matches,412,sn SEN,MFFW,19,11,218.0,20.0,6.4,2.4,2,49.0,0,9,13.0,15,1.45,6.0,11.0,-5.0,-2.06,-2.4,4.5,5.9,-1.5,-0.6,-0.85,Matches,332.0,sn SEN,MFFW,19.0,2.4,190.0,15.0,65.0,104.0,21.0,1.0,190.0,5.0,2.0,40.0,1.0,20.0,122.0,577.0,216.0,1.0,0.0,0.0,5.0,2.0,125.0,0.0,Matches,332.0,sn SEN,MFFW,19.0,2.4,0.0,2.0,0.0,0.0,0.83,0.0,0.0,,27.3,0.0,0.0,0.0,0.1,0.1,0.03,-0.1,-0.1,Matches,332.0,sn SEN,MFFW,19.0,11.0,2.0,218.0,2.4,0.0,1.0,1.0,0.0,0.0,0.0,1.0,0.0,0.1,0.1,0.3,0.4,1.0,13.0,0.0,0.0,0.41,0.41,0.0,0.41,0.03,0.14,0.17,0.03,0.17,Matches,Pape Matar Sarr,M C,19,115,-8,Senegal,Tottenham Hotspur,7,7,12,9,13,8,12,13,8,10,12,9,13,12,12,13,12,13,11,13,11,6,13,10,11,14,12,12,11,14,13,12,14,9,12,12,11,13,9,6,11,1,2,3,2,2,2,2,2,1,1,3,13,10,3,12,11,11,11,16,1,1,1,1,1,1,14,10,20,10,8,14,8,1,184,70,11,20,72842810,6197,6197,4255,African_Caribbean,114,17,2002/9/14,8,0,13919.0,,12080051
266,Jean-Philippe Mateta,Crystal Palace,1997,333.0,fr FRA,FW,25.0,8.6,7.0,1.0,2.0,4.0,1.0,1.0,3.0,33.3,2.0,3.0,1.0,2.0,3.0,10.0,18.0,0.0,Matches,333.0,fr FRA,FW,25.0,8.6,8.0,0.94,3.0,0.0,0.0,3.0,2.0,0.0,1.0,0.12,0.0,0.0,0.0,0.0,1.0,0.0,Matches,,,,,,,,,,,,,,,,,,,,,,,,,,,,,,,,,,,,,,,,,,,,,,,,,,,,,,,,333.0,fr FRA,FW,25.0,8.6,3.0,0.0,0.0,16.0,8.0,8.0,3.0,3.0,1.0,0.0,0.0,0.0,23.0,26.0,44.0,37.1,Matches,333.0,fr FRA,FW,25.0,8.6,149.0,143.0,6.0,0.0,0.0,0.0,3.0,0.0,0.0,0.0,0.0,0.0,104.0,0.0,9.0,Matches,333.0,fr FRA,FW,25.0,8.6,104.0,149.0,69.8,1196.0,155.0,70.0,92.0,76.1,19.0,28.0,67.9,4.0,5.0,80.0,0.0,0.6,0.2,-0.6,5.0,4.0,1.0,1.0,6.0,Matches,413,fr FRA,FW,25,29,770.0,27.0,22.5,8.6,6,65.0,0,23,17.0,8,1.1,5.0,10.0,-5.0,-0.58,-0.45,10.6,13.5,-3.0,-0.35,-0.15,Matches,333.0,fr FRA,FW,25.0,8.6,266.0,18.0,37.0,112.0,119.0,38.0,266.0,8.0,3.0,37.5,5.0,62.5,145.0,674.0,251.0,9.0,9.0,5.0,27.0,18.0,185.0,43.0,Matches,333.0,fr FRA,FW,25.0,8.6,2.0,27.0,7.0,25.9,3.16,0.82,0.07,0.29,12.2,0.0,0.0,0.0,3.4,3.4,0.13,-1.4,-1.4,Matches,333.0,fr FRA,FW,25.0,29.0,6.0,770.0,8.6,2.0,0.0,2.0,2.0,0.0,0.0,3.0,0.0,3.4,3.4,0.6,4.0,9.0,6.0,43.0,0.23,0.0,0.23,0.23,0.23,0.39,0.07,0.47,0.39,0.47,Matches,Jean-Philippe Mateta,S,25,137,148,"France,Democratic Republic of Congo",Crystal Palace,7,8,13,15,13,8,14,11,4,7,10,10,6,13,12,13,14,14,10,10,12,12,14,8,15,10,13,15,14,13,16,16,13,14,13,15,12,5,12,7,5,4,1,1,1,3,3,2,1,1,1,3,12,13,11,7,10,12,12,12,1,1,1,1,1,1,1,1,1,1,1,11,1,20,192,88,10,20,23662314,6850,6850,5500,African_Caribbean,137,16,1997/6/28,0,0,57996.0,,49034219
267,Kevin Mbabu,Fulham,1995,336.0,ch SUI,DFFW,27.0,1.6,3.0,2.0,2.0,1.0,0.0,1.0,3.0,33.3,2.0,2.0,0.0,2.0,3.0,6.0,3.0,0.0,Matches,336.0,ch SUI,DFFW,27.0,1.6,3.0,1.87,2.0,0.0,1.0,0.0,0.0,0.0,1.0,0.62,1.0,0.0,0.0,0.0,0.0,0.0,Matches,,,,,,,,,,,,,,,,,,,,,,,,,,,,,,,,,,,,,,,,,,,,,,,,,,,,,,,,336.0,ch SUI,DFFW,27.0,1.6,1.0,0.0,0.0,4.0,0.0,0.0,7.0,3.0,2.0,0.0,0.0,0.0,6.0,2.0,6.0,25.0,Matches,336.0,ch SUI,DFFW,27.0,1.6,94.0,71.0,23.0,0.0,0.0,1.0,7.0,23.0,0.0,0.0,0.0,0.0,68.0,0.0,2.0,Matches,336.0,ch SUI,DFFW,27.0,1.6,68.0,94.0,72.3,1051.0,383.0,40.0,43.0,93.0,24.0,35.0,68.6,4.0,9.0,44.4,1.0,0.4,0.4,0.6,2.0,4.0,5.0,3.0,8.0,Matches,417,ch SUI,DFFW,27,6,144.0,24.0,4.2,1.6,1,44.0,0,5,20.0,8,0.67,2.0,7.0,-5.0,-3.12,-3.32,1.4,6.8,-5.3,-3.34,-3.01,Matches,336.0,ch SUI,DFFW,27.0,1.6,114.0,4.0,38.0,40.0,38.0,0.0,114.0,6.0,4.0,66.7,2.0,33.3,57.0,273.0,159.0,4.0,2.0,0.0,1.0,2.0,59.0,11.0,Matches,336.0,ch SUI,DFFW,27.0,1.6,0.0,0.0,0.0,,0.0,0.0,,,,0.0,0.0,0.0,0.0,0.0,,0.0,0.0,Matches,336.0,ch SUI,DFFW,27.0,6.0,1.0,144.0,1.6,0.0,1.0,1.0,0.0,0.0,0.0,1.0,0.0,0.0,0.0,0.4,0.4,4.0,8.0,11.0,0.0,0.62,0.62,0.0,0.62,0.0,0.25,0.25,0.0,0.25,Matches,Kevin Mbabu,D/WB R,27,134,140,"Switzerland,Democratic Republic of Congo",Fulham,4,11,14,7,11,4,11,7,18,11,11,7,15,12,16,11,15,11,10,11,11,16,11,7,12,11,12,15,15,12,13,12,13,17,16,13,12,12,11,12,9,2,3,2,1,2,1,2,1,3,2,2,13,14,16,10,12,8,10,9,1,12,12,20,10,18,1,1,1,12,1,1,1,1,184,80,11,20,26756565,6700,7000,5750,Mixed_Race,126,12,1995/4/19,22,0,81194.0,,98029336
268,James McArthur,Crystal Palace,1987,338.0,sct SCO,MF,34.0,0.6,1.0,1.0,1.0,0.0,0.0,1.0,1.0,100.0,0.0,2.0,1.0,1.0,1.0,2.0,2.0,0.0,Matches,338.0,sct SCO,MF,34.0,0.6,0.0,0.0,0.0,0.0,0.0,0.0,0.0,0.0,0.0,0.0,0.0,0.0,0.0,0.0,0.0,0.0,Matches,,,,,,,,,,,,,,,,,,,,,,,,,,,,,,,,,,,,,,,,,,,,,,,,,,,,,,,,338.0,sct SCO,MF,34.0,0.6,0.0,0.0,0.0,0.0,1.0,0.0,0.0,1.0,1.0,0.0,0.0,0.0,5.0,0.0,0.0,,Matches,338.0,sct SCO,MF,34.0,0.6,52.0,49.0,3.0,3.0,1.0,0.0,0.0,0.0,0.0,0.0,0.0,0.0,41.0,0.0,1.0,Matches,338.0,sct SCO,MF,34.0,0.6,41.0,52.0,78.8,596.0,129.0,24.0,29.0,82.8,16.0,18.0,88.9,1.0,3.0,33.3,0.0,0.0,0.0,0.0,0.0,0.0,0.0,0.0,1.0,Matches,422,sct SCO,MF,34,4,54.0,14.0,1.6,0.6,0,,0,4,14.0,8,1.75,0.0,0.0,0.0,0.0,0.24,0.7,0.4,0.2,0.41,0.65,Matches,338.0,sct SCO,MF,34.0,0.6,60.0,5.0,22.0,29.0,9.0,0.0,60.0,2.0,1.0,50.0,0.0,0.0,36.0,168.0,84.0,0.0,2.0,0.0,1.0,3.0,40.0,0.0,Matches,338.0,sct SCO,MF,34.0,0.6,0.0,0.0,0.0,,0.0,0.0,,,,0.0,0.0,0.0,0.0,0.0,,0.0,0.0,Matches,338.0,sct SCO,MF,34.0,4.0,0.0,54.0,0.6,0.0,0.0,0.0,0.0,0.0,0.0,0.0,0.0,0.0,0.0,0.0,0.0,0.0,1.0,0.0,0.0,0.0,0.0,0.0,0.0,0.0,0.0,0.0,0.0,0.0,Matches,James McArthur,DM/M C,34,127,139,Scotland,Crystal Palace,9,11,13,10,14,11,10,8,6,13,12,8,13,14,13,15,16,12,14,12,14,16,4,14,11,14,16,17,11,10,11,9,10,10,14,12,12,9,13,16,12,1,1,1,2,1,4,1,1,2,1,2,7,13,2,17,11,17,13,14,1,1,1,1,1,1,18,7,20,8,1,9,1,1,178,69,10,20,570433,6350,6350,5500,Northern_European,123,1,1987/10/7,32,4,63795.0,,5217388
269,Alex McCarthy,Southampton,1989,339.0,eng ENG,GK,32.0,6.0,0.0,0.0,0.0,0.0,0.0,0.0,1.0,0.0,1.0,0.0,0.0,0.0,1.0,1.0,3.0,1.0,Matches,339.0,eng ENG,GK,32.0,6.0,1.0,0.17,1.0,0.0,0.0,0.0,0.0,0.0,0.0,0.0,0.0,0.0,0.0,0.0,0.0,0.0,Matches,21.0,eng ENG,GK,32.0,6.0,17.0,1.0,0.0,1.0,1.0,10.9,0.34,-5.1,-0.84,22.0,113.0,19.5,194.0,29.0,48.5,36.5,52.0,36.5,31.0,92.0,6.0,6.5,7.0,1.17,13.5,Matches,21.0,eng ENG,GK,32.0,6.0,6.0,540.0,6.0,17.0,2.83,30.0,14.0,46.7,0.0,1.0,5.0,0.0,0.0,1.0,1.0,0.0,0.0,0.0,Matches,339.0,eng ENG,GK,32.0,6.0,0.0,0.0,0.0,0.0,1.0,0.0,0.0,1.0,0.0,0.0,0.0,0.0,7.0,1.0,0.0,100.0,Matches,339.0,eng ENG,GK,32.0,6.0,249.0,178.0,68.0,16.0,0.0,1.0,0.0,0.0,0.0,0.0,0.0,0.0,150.0,3.0,0.0,Matches,339.0,eng ENG,GK,32.0,6.0,150.0,249.0,60.2,3585.0,2452.0,45.0,47.0,95.7,64.0,66.0,97.0,40.0,132.0,30.3,0.0,0.0,0.0,0.0,0.0,5.0,0.0,0.0,0.0,Matches,424,eng ENG,GK,32,6,540.0,90.0,15.8,6.0,6,90.0,6,0,,21,0.17,9.0,17.0,-8.0,-1.33,-0.43,7.2,15.0,-7.7,-1.29,-0.8,Matches,339.0,eng ENG,GK,32.0,6.0,261.0,205.0,260.0,1.0,0.0,0.0,261.0,0.0,0.0,,0.0,,139.0,546.0,264.0,0.0,0.0,0.0,0.0,0.0,133.0,0.0,Matches,339.0,eng ENG,GK,32.0,6.0,0.0,0.0,0.0,,0.0,0.0,,,,0.0,0.0,0.0,0.0,0.0,,0.0,0.0,Matches,339.0,eng ENG,GK,32.0,6.0,6.0,540.0,6.0,0.0,0.0,0.0,0.0,0.0,0.0,0.0,0.0,0.0,0.0,0.0,0.0,0.0,0.0,0.0,0.0,0.0,0.0,0.0,0.0,0.0,0.0,0.0,0.0,0.0,Matches,Alex McCarthy,GK,32,126,140,"England,Republic of Ireland",Southampton,3,3,1,2,10,8,5,2,2,3,11,4,2,14,7,13,12,10,10,9,12,15,3,7,2,15,12,11,9,14,12,17,13,9,13,15,11,1,10,9,12,14,13,11,5,14,14,15,14,11,18,11,15,15,5,12,11,16,15,18,20,1,1,1,1,1,1,1,1,1,1,1,1,1,194,79,9,20,6166941,6300,6300,5250,Northern_European,126,3,1989/12/3,1,0,57996.0,,8601160
270,Nampalys Mendy,Leicester City,1992,347.0,sn SEN,MF,30.0,8.4,13.0,9.0,7.0,6.0,0.0,8.0,15.0,53.3,7.0,20.0,4.0,16.0,13.0,26.0,2.0,0.0,Matches,347.0,sn SEN,MF,30.0,8.4,9.0,1.07,5.0,0.0,1.0,0.0,1.0,2.0,0.0,0.0,0.0,0.0,0.0,0.0,0.0,0.0,Matches,,,,,,,,,,,,,,,,,,,,,,,,,,,,,,,,,,,,,,,,,,,,,,,,,,,,,,,,347.0,sn SEN,MF,30.0,8.4,1.0,0.0,0.0,9.0,10.0,0.0,1.0,13.0,9.0,0.0,0.0,0.0,46.0,4.0,6.0,40.0,Matches,347.0,sn SEN,MF,30.0,8.4,413.0,399.0,12.0,8.0,1.0,2.0,1.0,1.0,0.0,0.0,0.0,0.0,362.0,2.0,11.0,Matches,347.0,sn SEN,MF,30.0,8.4,362.0,413.0,87.7,5580.0,1124.0,189.0,204.0,92.6,143.0,156.0,91.7,20.0,27.0,74.1,0.0,0.0,0.1,0.0,2.0,20.0,3.0,0.0,28.0,Matches,434,sn SEN,MF,30,19,757.0,40.0,22.1,8.4,7,72.0,2,12,21.0,14,1.42,12.0,13.0,-1.0,-0.12,0.42,14.6,12.9,1.7,0.2,0.69,Matches,347.0,sn SEN,MF,30.0,8.4,490.0,12.0,139.0,310.0,45.0,2.0,490.0,11.0,7.0,63.6,3.0,27.3,283.0,1352.0,468.0,2.0,5.0,0.0,7.0,1.0,333.0,4.0,Matches,347.0,sn SEN,MF,30.0,8.4,1.0,2.0,1.0,50.0,0.24,0.12,0.5,1.0,21.1,0.0,0.0,0.0,0.1,0.1,0.07,0.9,0.9,Matches,347.0,sn SEN,MF,30.0,19.0,7.0,757.0,8.4,1.0,0.0,1.0,1.0,0.0,0.0,1.0,0.0,0.1,0.1,0.0,0.2,2.0,28.0,4.0,0.12,0.0,0.12,0.12,0.12,0.02,0.0,0.02,0.02,0.02,Matches,Nampalys Mendy,DM/M C,30,136,140,"Senegal,France",Leicester City,8,11,12,8,14,7,8,7,6,13,14,11,15,13,13,15,14,15,13,12,15,13,8,7,8,14,16,16,13,14,14,5,15,12,17,12,14,11,14,9,12,2,3,3,3,2,3,2,2,1,3,3,18,14,6,14,12,14,14,14,1,1,1,1,1,1,20,1,18,1,1,1,1,1,167,73,8,20,17684528,6799,6799,5249,African_Caribbean,136,16,1992/6/23,17,0,57996.0,,85010871
271,Alex Mighten,Nott'ham Forest,2002,350.0,eng ENG,FW,20.0,0.1,0.0,0.0,0.0,0.0,0.0,0.0,1.0,0.0,1.0,0.0,0.0,0.0,0.0,0.0,0.0,0.0,Matches,350.0,eng ENG,FW,20.0,0.1,0.0,0.0,0.0,0.0,0.0,0.0,0.0,0.0,0.0,0.0,0.0,0.0,0.0,0.0,0.0,0.0,Matches,,,,,,,,,,,,,,,,,,,,,,,,,,,,,,,,,,,,,,,,,,,,,,,,,,,,,,,,350.0,eng ENG,FW,20.0,0.1,0.0,0.0,0.0,0.0,1.0,0.0,0.0,0.0,0.0,0.0,0.0,0.0,0.0,0.0,0.0,,Matches,350.0,eng ENG,FW,20.0,0.1,1.0,1.0,0.0,0.0,0.0,0.0,0.0,0.0,0.0,0.0,0.0,0.0,1.0,0.0,0.0,Matches,350.0,eng ENG,FW,20.0,0.1,1.0,1.0,100.0,11.0,0.0,1.0,1.0,100.0,0.0,0.0,,0.0,0.0,,0.0,0.0,0.0,0.0,0.0,0.0,0.0,0.0,0.0,Matches,437,eng ENG,FW,20,1,8.0,8.0,0.2,0.1,0,,0,1,8.0,5,0.0,0.0,0.0,0.0,0.0,0.79,0.0,0.2,-0.2,-2.55,-1.9,Matches,350.0,eng ENG,FW,20.0,0.1,4.0,0.0,1.0,0.0,3.0,0.0,4.0,3.0,0.0,0.0,2.0,66.7,4.0,27.0,10.0,0.0,0.0,0.0,0.0,0.0,4.0,1.0,Matches,350.0,eng ENG,FW,20.0,0.1,0.0,0.0,0.0,,0.0,0.0,,,,0.0,0.0,0.0,0.0,0.0,,0.0,0.0,Matches,350.0,eng ENG,FW,20.0,1.0,0.0,8.0,0.1,0.0,0.0,0.0,0.0,0.0,0.0,0.0,0.0,0.0,0.0,0.0,0.0,0.0,0.0,1.0,0.0,0.0,0.0,0.0,0.0,0.0,0.0,0.0,0.0,0.0,Matches,Alex Mighten,AM RL,20,110,135,"United States,England",Nottingham Forest,6,12,13,11,12,5,9,7,3,4,11,9,5,13,5,12,10,9,8,12,9,14,16,6,13,9,9,12,13,14,11,8,11,15,10,9,12,5,11,5,10,2,3,1,3,2,1,3,2,2,2,2,9,12,6,11,12,11,11,10,1,1,1,1,1,1,1,12,1,12,19,14,20,15,178,0,9,20,9613395,5499,5749,3019,African_Caribbean,101,16,2002/4/11,0,0,5800.0,Sheffield Wednesday,29219153
272,Luka Milivojević,Crystal Palace,1991,352.0,rs SRB,MF,31.0,5.7,13.0,7.0,7.0,4.0,2.0,7.0,10.0,70.0,3.0,13.0,4.0,9.0,12.0,25.0,10.0,1.0,Matches,352.0,rs SRB,MF,31.0,5.7,3.0,0.53,1.0,1.0,0.0,1.0,0.0,0.0,0.0,0.0,0.0,0.0,0.0,0.0,0.0,0.0,Matches,,,,,,,,,,,,,,,,,,,,,,,,,,,,,,,,,,,,,,,,,,,,,,,,,,,,,,,,352.0,rs SRB,MF,31.0,5.7,2.0,0.0,0.0,15.0,3.0,0.0,6.0,12.0,7.0,0.0,0.0,0.0,34.0,6.0,9.0,40.0,Matches,352.0,rs SRB,MF,31.0,5.7,260.0,248.0,11.0,8.0,0.0,2.0,6.0,1.0,2.0,2.0,0.0,0.0,207.0,1.0,0.0,Matches,352.0,rs SRB,MF,31.0,5.7,207.0,260.0,79.6,3587.0,1136.0,89.0,101.0,88.1,89.0,107.0,83.2,20.0,37.0,54.1,0.0,0.2,0.2,-0.2,2.0,17.0,2.0,1.0,20.0,Matches,439,rs SRB,MF,31,18,512.0,28.0,15.0,5.7,5,68.0,1,13,13.0,16,1.44,5.0,7.0,-2.0,-0.35,-0.13,4.4,7.7,-3.4,-0.59,-0.42,Matches,352.0,rs SRB,MF,31.0,5.7,321.0,28.0,117.0,153.0,55.0,1.0,321.0,1.0,1.0,100.0,0.0,0.0,162.0,697.0,263.0,2.0,3.0,0.0,4.0,6.0,178.0,2.0,Matches,352.0,rs SRB,MF,31.0,5.7,0.0,7.0,0.0,0.0,1.23,0.0,0.0,,25.1,1.0,0.0,0.0,0.3,0.3,0.05,-0.3,-0.3,Matches,352.0,rs SRB,MF,31.0,18.0,5.0,512.0,5.7,0.0,0.0,0.0,0.0,0.0,0.0,2.0,0.0,0.3,0.3,0.2,0.5,2.0,20.0,2.0,0.0,0.0,0.0,0.0,0.0,0.06,0.03,0.09,0.06,0.09,Matches,Luka Milivojević,DM/M C,31,126,146,Serbia,Crystal Palace,12,11,8,11,11,14,14,13,7,14,10,16,14,13,16,14,14,13,13,14,12,16,9,15,10,14,14,13,10,11,14,13,14,10,15,14,12,16,14,7,10,2,1,1,3,3,2,2,2,2,1,4,13,15,8,16,14,15,8,8,1,1,11,1,1,1,20,1,17,1,1,1,1,1,185,80,9,20,1837074,6298,6298,5748,Northern_European,126,1,1991/4/7,39,1,92793.0,,62028856
273,Yerry Mina,Everton,1994,354.0,co COL,DF,27.0,6.6,15.0,8.0,9.0,6.0,0.0,9.0,11.0,81.8,2.0,7.0,4.0,3.0,6.0,21.0,28.0,0.0,Matches,354.0,co COL,DF,27.0,6.6,8.0,1.21,5.0,0.0,0.0,1.0,2.0,0.0,1.0,0.15,0.0,0.0,0.0,0.0,1.0,0.0,Matches,,,,,,,,,,,,,,,,,,,,,,,,,,,,,,,,,,,,,,,,,,,,,,,,,,,,,,,,354.0,co COL,DF,27.0,6.6,2.0,0.0,0.0,6.0,10.0,0.0,1.0,6.0,8.0,0.0,0.0,0.0,31.0,19.0,15.0,55.9,Matches,354.0,co COL,DF,27.0,6.6,325.0,309.0,15.0,13.0,0.0,1.0,1.0,2.0,0.0,0.0,0.0,0.0,286.0,1.0,1.0,Matches,354.0,co COL,DF,27.0,6.6,286.0,325.0,88.0,4935.0,1808.0,117.0,125.0,93.6,146.0,161.0,90.7,17.0,27.0,63.0,0.0,0.1,0.2,-0.1,1.0,15.0,1.0,0.0,13.0,Matches,442,co COL,DF,27,7,594.0,85.0,17.4,6.6,7,85.0,5,0,,17,1.0,8.0,9.0,-1.0,-0.15,0.55,9.2,10.1,-0.9,-0.13,0.48,Matches,354.0,co COL,DF,27.0,6.6,402.0,58.0,198.0,176.0,30.0,16.0,402.0,2.0,1.0,50.0,0.0,0.0,217.0,1089.0,622.0,1.0,4.0,1.0,4.0,0.0,255.0,3.0,Matches,354.0,co COL,DF,27.0,6.6,2.0,8.0,4.0,50.0,1.21,0.61,0.25,0.5,8.4,0.0,0.0,0.0,1.5,1.5,0.18,0.5,0.5,Matches,354.0,co COL,DF,27.0,7.0,7.0,594.0,6.6,2.0,0.0,2.0,2.0,0.0,0.0,2.0,0.0,1.5,1.5,0.1,1.6,1.0,13.0,3.0,0.3,0.0,0.3,0.3,0.3,0.22,0.02,0.24,0.22,0.24,Matches,Yerry Mina,D C,27,139,154,Colombia,Everton,6,8,12,7,12,6,16,8,9,14,12,9,15,11,13,12,13,14,13,9,14,15,9,17,10,14,13,14,10,12,8,17,11,13,12,16,12,13,12,15,5,1,3,1,3,2,2,3,1,2,3,4,15,14,9,12,14,13,12,11,1,1,20,1,1,1,1,1,1,1,1,1,1,7,193,79,9,20,33999787,6950,7300,6000,African_Caribbean,138,16,1994/9/23,39,7,139190.0,,76037151
274,Andrew Moran,Brighton,2003,360.0,ie IRL,FW,18.0,0.1,0.0,0.0,0.0,0.0,0.0,0.0,0.0,,0.0,1.0,0.0,1.0,0.0,0.0,0.0,0.0,Matches,360.0,ie IRL,FW,18.0,0.1,0.0,0.0,0.0,0.0,0.0,0.0,0.0,0.0,0.0,0.0,0.0,0.0,0.0,0.0,0.0,0.0,Matches,,,,,,,,,,,,,,,,,,,,,,,,,,,,,,,,,,,,,,,,,,,,,,,,,,,,,,,,360.0,ie IRL,FW,18.0,0.1,0.0,0.0,0.0,0.0,0.0,0.0,0.0,0.0,0.0,0.0,0.0,0.0,0.0,0.0,0.0,,Matches,360.0,ie IRL,FW,18.0,0.1,2.0,1.0,1.0,0.0,0.0,0.0,0.0,0.0,0.0,0.0,0.0,0.0,1.0,0.0,0.0,Matches,360.0,ie IRL,FW,18.0,0.1,1.0,2.0,50.0,13.0,0.0,1.0,1.0,100.0,0.0,1.0,0.0,0.0,0.0,,0.0,0.0,0.0,0.0,0.0,0.0,0.0,0.0,0.0,Matches,449,ie IRL,FW,18,1,12.0,12.0,0.4,0.1,0,,0,1,12.0,12,3.0,0.0,1.0,-1.0,-7.5,-8.03,0.1,0.8,-0.7,-5.5,-6.13,Matches,360.0,ie IRL,FW,18.0,0.1,6.0,0.0,0.0,5.0,1.0,0.0,6.0,0.0,0.0,,0.0,,3.0,2.0,1.0,0.0,0.0,0.0,2.0,0.0,3.0,1.0,Matches,360.0,ie IRL,FW,18.0,0.1,0.0,0.0,0.0,,0.0,0.0,,,,0.0,0.0,0.0,0.0,0.0,,0.0,0.0,Matches,360.0,ie IRL,FW,18.0,1.0,0.0,12.0,0.1,0.0,0.0,0.0,0.0,0.0,0.0,0.0,0.0,0.0,0.0,0.0,0.0,0.0,0.0,1.0,0.0,0.0,0.0,0.0,0.0,0.0,0.0,0.0,0.0,0.0,Matches,Andrew Moran,AM RLC,18,105,-8,Republic of Ireland,Brighton & Hove Albion,10,10,14,10,9,9,9,10,3,7,11,7,8,11,7,9,9,11,9,12,9,3,13,7,11,7,11,11,15,12,10,8,12,14,14,7,10,10,16,12,13,2,1,2,2,3,1,2,1,1,4,1,17,13,4,9,12,12,12,17,1,1,1,1,1,1,1,1,14,1,17,20,15,14,171,0,8,20,46535884,5247,5247,2747,Northern_European,95,1,2003/10/15,0,0,2320.0,,52101143
275,Lucas Moura,Tottenham,1992,363.0,br BRA,MFDF,29.0,1.7,8.0,5.0,1.0,3.0,4.0,1.0,4.0,25.0,3.0,0.0,0.0,0.0,2.0,10.0,1.0,1.0,Matches,363.0,br BRA,MFDF,29.0,1.7,9.0,5.29,6.0,0.0,1.0,0.0,1.0,1.0,1.0,0.59,0.0,0.0,1.0,0.0,0.0,0.0,Matches,,,,,,,,,,,,,,,,,,,,,,,,,,,,,,,,,,,,,,,,,,,,,,,,,,,,,,,,363.0,br BRA,MFDF,29.0,1.7,0.0,1.0,0.0,3.0,3.0,0.0,9.0,2.0,5.0,0.0,0.0,0.0,9.0,5.0,4.0,55.6,Matches,363.0,br BRA,MFDF,29.0,1.7,89.0,83.0,6.0,0.0,1.0,0.0,9.0,5.0,1.0,0.0,0.0,0.0,62.0,0.0,6.0,Matches,363.0,br BRA,MFDF,29.0,1.7,62.0,89.0,69.7,831.0,264.0,39.0,50.0,78.0,21.0,26.0,80.8,0.0,3.0,0.0,0.0,0.3,0.4,-0.3,4.0,3.0,5.0,1.0,13.0,Matches,454,br BRA,MFDF,29,15,153.0,10.0,4.5,1.7,0,,0,15,10.0,7,1.53,6.0,4.0,2.0,1.18,1.04,4.0,2.4,1.7,0.97,0.81,Matches,363.0,br BRA,MFDF,29.0,1.7,118.0,0.0,15.0,47.0,58.0,12.0,118.0,11.0,5.0,45.5,6.0,54.5,65.0,387.0,169.0,4.0,8.0,2.0,6.0,5.0,83.0,15.0,Matches,363.0,br BRA,MFDF,29.0,1.7,1.0,4.0,1.0,25.0,2.35,0.59,0.25,1.0,10.9,0.0,0.0,0.0,0.5,0.5,0.13,0.5,0.5,Matches,363.0,br BRA,MFDF,29.0,15.0,0.0,153.0,1.7,1.0,0.0,1.0,1.0,0.0,0.0,0.0,1.0,0.5,0.5,0.3,0.9,4.0,13.0,15.0,0.59,0.0,0.59,0.59,0.59,0.32,0.2,0.51,0.32,0.51,Matches,Lucas Moura,M/AM RL,29,143,154,Brazil,Tottenham Hotspur,11,12,16,13,13,9,15,9,6,6,13,11,9,13,11,13,12,12,11,12,12,14,13,7,13,7,15,16,15,13,11,11,17,15,15,8,12,8,8,6,13,2,1,3,1,3,3,4,3,3,1,2,10,15,6,14,12,16,10,15,1,1,1,1,1,1,1,1,5,20,15,14,20,15,172,66,10,20,24727118,7150,7000,6250,Mediterranean_Hispanic,130,14,1992/8/13,36,4,92793.0,,19073564
276,Reiss Nelson,Arsenal,1999,372.0,eng ENG,FW,22.0,2.4,4.0,1.0,2.0,1.0,1.0,2.0,4.0,50.0,2.0,3.0,0.0,3.0,0.0,4.0,4.0,0.0,Matches,372.0,eng ENG,FW,22.0,2.4,19.0,8.07,13.0,0.0,3.0,2.0,1.0,0.0,5.0,2.12,3.0,0.0,0.0,2.0,0.0,0.0,Matches,,,,,,,,,,,,,,,,,,,,,,,,,,,,,,,,,,,,,,,,,,,,,,,,,,,,,,,,372.0,eng ENG,FW,22.0,2.4,0.0,0.0,0.0,8.0,4.0,0.0,12.0,0.0,1.0,0.0,0.0,0.0,16.0,2.0,5.0,28.6,Matches,372.0,eng ENG,FW,22.0,2.4,120.0,118.0,2.0,0.0,0.0,0.0,12.0,0.0,2.0,2.0,0.0,0.0,101.0,0.0,1.0,Matches,372.0,eng ENG,FW,22.0,2.4,101.0,120.0,84.2,1331.0,213.0,62.0,69.0,89.9,29.0,34.0,85.3,4.0,7.0,57.1,2.0,1.4,1.0,0.6,9.0,3.0,4.0,2.0,6.0,Matches,466,eng ENG,FW,22,11,212.0,19.0,6.2,2.4,0,,0,11,19.0,11,2.09,10.0,3.0,7.0,2.97,1.91,5.1,2.3,2.8,1.18,0.43,Matches,372.0,eng ENG,FW,22.0,2.4,157.0,5.0,25.0,35.0,99.0,23.0,157.0,9.0,7.0,77.8,2.0,22.2,99.0,710.0,439.0,19.0,5.0,8.0,3.0,9.0,112.0,34.0,Matches,372.0,eng ENG,FW,22.0,2.4,3.0,12.0,7.0,58.3,5.09,2.97,0.25,0.43,16.4,1.0,0.0,0.0,1.1,1.1,0.09,1.9,1.9,Matches,372.0,eng ENG,FW,22.0,11.0,0.0,212.0,2.4,3.0,2.0,5.0,3.0,0.0,0.0,0.0,0.0,1.1,1.1,1.4,2.5,19.0,6.0,34.0,1.27,0.85,2.12,1.27,2.12,0.46,0.58,1.04,0.46,1.04,Matches,Reiss Nelson,M/AM RL,22,134,155,"England,Zimbabwe",Arsenal,12,12,15,8,11,12,6,12,8,5,13,10,5,15,12,11,13,10,9,12,11,12,16,5,12,5,12,14,16,16,14,7,14,16,13,8,12,6,13,6,16,1,1,1,2,1,2,2,2,2,2,2,8,14,11,12,15,10,15,13,1,1,1,1,10,12,1,15,1,16,18,14,20,12,175,71,10,20,28533967,6749,6749,5749,Mixed_Race,128,13,1999/12/10,0,0,46397.0,,28107919
277,Lewis O'Brien,Nott'ham Forest,1998,382.0,eng ENG,MF,23.0,6.5,16.0,9.0,4.0,11.0,1.0,6.0,12.0,50.0,6.0,13.0,2.0,11.0,5.0,21.0,9.0,0.0,Matches,382.0,eng ENG,MF,23.0,6.5,21.0,3.24,14.0,0.0,1.0,1.0,3.0,2.0,0.0,0.0,0.0,0.0,0.0,0.0,0.0,0.0,Matches,,,,,,,,,,,,,,,,,,,,,,,,,,,,,,,,,,,,,,,,,,,,,,,,,,,,,,,,382.0,eng ENG,MF,23.0,6.5,2.0,0.0,0.0,5.0,15.0,0.0,4.0,5.0,9.0,0.0,0.0,0.0,51.0,2.0,6.0,25.0,Matches,382.0,eng ENG,MF,23.0,6.5,214.0,207.0,7.0,4.0,0.0,0.0,4.0,3.0,0.0,0.0,0.0,0.0,166.0,0.0,4.0,Matches,382.0,eng ENG,MF,23.0,6.5,166.0,214.0,77.6,2785.0,650.0,72.0,85.0,84.7,84.0,103.0,81.6,7.0,16.0,43.8,0.0,0.2,0.2,-0.2,4.0,19.0,3.0,0.0,21.0,Matches,476,eng ENG,MF,23,13,584.0,45.0,17.1,6.5,6,77.0,3,7,17.0,2,0.92,5.0,14.0,-9.0,-1.39,-0.72,6.7,13.7,-7.0,-1.08,-0.51,Matches,382.0,eng ENG,MF,23.0,6.5,297.0,19.0,72.0,161.0,71.0,3.0,297.0,17.0,7.0,41.2,3.0,17.6,157.0,947.0,518.0,13.0,9.0,2.0,12.0,7.0,166.0,3.0,Matches,382.0,eng ENG,MF,23.0,6.5,1.0,7.0,2.0,28.6,1.08,0.31,0.14,0.5,23.8,0.0,0.0,0.0,0.3,0.3,0.05,0.7,0.7,Matches,382.0,eng ENG,MF,23.0,13.0,6.0,584.0,6.5,1.0,0.0,1.0,1.0,0.0,0.0,2.0,0.0,0.3,0.3,0.2,0.5,13.0,21.0,3.0,0.15,0.0,0.15,0.15,0.15,0.05,0.03,0.08,0.05,0.08,Matches,Lewis O'Brien,DM/M C,23,126,140,England,Nottingham Forest,8,10,13,11,12,7,7,10,4,10,12,9,13,12,10,13,14,12,10,12,14,15,9,13,14,14,15,15,12,13,14,7,14,13,16,12,14,8,12,3,14,2,2,1,3,1,2,3,3,2,1,3,9,8,2,12,7,13,12,12,1,1,1,1,1,1,20,10,18,12,12,14,11,1,173,0,20,10,9276647,6300,6300,4500,Northern_European,125,0,1998/10/14,0,0,52196.0,,29156935
278,Robin Olsen,Aston Villa,1990,386.0,se SWE,GK,32.0,3.1,0.0,0.0,0.0,0.0,0.0,0.0,2.0,0.0,2.0,0.0,0.0,0.0,0.0,0.0,1.0,0.0,Matches,386.0,se SWE,GK,32.0,3.1,0.0,0.0,0.0,0.0,0.0,0.0,0.0,0.0,0.0,0.0,0.0,0.0,0.0,0.0,0.0,0.0,Matches,26.0,se SWE,GK,32.0,3.1,8.0,1.0,0.0,3.0,0.0,6.2,0.29,-1.8,-0.57,15.0,62.0,24.2,101.0,18.0,44.6,37.6,28.0,60.7,46.8,45.0,5.0,11.1,3.0,0.96,14.2,Matches,26.0,se SWE,GK,32.0,4.0,2.0,281.0,3.1,8.0,2.56,19.0,11.0,63.2,1.0,0.0,1.0,1.0,50.0,1.0,1.0,0.0,0.0,0.0,Matches,386.0,se SWE,GK,32.0,3.1,0.0,0.0,0.0,0.0,0.0,0.0,0.0,0.0,0.0,0.0,0.0,0.0,3.0,0.0,0.0,,Matches,386.0,se SWE,GK,32.0,3.1,131.0,89.0,40.0,12.0,0.0,1.0,0.0,0.0,0.0,0.0,0.0,0.0,74.0,2.0,1.0,Matches,386.0,se SWE,GK,32.0,3.1,74.0,131.0,56.5,2049.0,1522.0,17.0,18.0,94.4,30.0,30.0,100.0,27.0,80.0,33.8,0.0,0.0,0.0,0.0,0.0,2.0,0.0,0.0,0.0,Matches,483,se SWE,GK,32,4,281.0,70.0,8.2,3.1,2,90.0,2,2,51.0,30,1.0,4.0,8.0,-4.0,-1.28,-1.54,3.7,8.6,-4.9,-1.56,-1.64,Matches,386.0,se SWE,GK,32.0,3.1,141.0,119.0,139.0,2.0,0.0,0.0,141.0,0.0,0.0,,0.0,,80.0,405.0,198.0,0.0,0.0,0.0,1.0,0.0,57.0,0.0,Matches,386.0,se SWE,GK,32.0,3.1,0.0,0.0,0.0,,0.0,0.0,,,,0.0,0.0,0.0,0.0,0.0,,0.0,0.0,Matches,386.0,se SWE,GK,32.0,4.0,2.0,281.0,3.1,0.0,0.0,0.0,0.0,0.0,0.0,0.0,0.0,0.0,0.0,0.0,0.0,0.0,0.0,0.0,0.0,0.0,0.0,0.0,0.0,0.0,0.0,0.0,0.0,0.0,Matches,Robin Olsen,GK,32,134,141,"Sweden,Denmark",Aston Villa,2,3,2,3,11,1,3,1,1,3,10,4,3,10,13,12,14,13,14,8,13,10,2,10,1,14,12,10,11,12,13,17,13,10,10,13,11,8,13,4,13,17,13,11,6,14,12,13,15,11,9,13,13,11,4,8,13,16,16,16,20,1,1,1,1,1,1,1,1,1,1,1,1,1,198,89,8,20,8001917,6692,6992,5742,Northern_European,133,1,1990/1/8,60,0,40597.0,,68007215
279,Josh Onomah,Fulham,1997,388.0,eng ENG,MF,25.0,0.2,1.0,0.0,1.0,0.0,0.0,0.0,0.0,,0.0,1.0,0.0,1.0,0.0,1.0,0.0,0.0,Matches,388.0,eng ENG,MF,25.0,0.2,0.0,0.0,0.0,0.0,0.0,0.0,0.0,0.0,0.0,0.0,0.0,0.0,0.0,0.0,0.0,0.0,Matches,,,,,,,,,,,,,,,,,,,,,,,,,,,,,,,,,,,,,,,,,,,,,,,,,,,,,,,,388.0,eng ENG,MF,25.0,0.2,0.0,0.0,0.0,0.0,0.0,0.0,0.0,0.0,0.0,0.0,0.0,0.0,1.0,1.0,0.0,100.0,Matches,388.0,eng ENG,MF,25.0,0.2,6.0,6.0,0.0,0.0,0.0,0.0,0.0,0.0,0.0,0.0,0.0,0.0,4.0,0.0,1.0,Matches,388.0,eng ENG,MF,25.0,0.2,4.0,6.0,66.7,54.0,0.0,3.0,3.0,100.0,1.0,1.0,100.0,0.0,0.0,,0.0,0.0,0.0,0.0,0.0,0.0,0.0,0.0,0.0,Matches,485,eng ENG,MF,25,2,15.0,8.0,0.4,0.2,0,,0,2,8.0,3,0.0,0.0,2.0,-2.0,-12.0,-12.11,0.1,0.6,-0.5,-3.02,-2.57,Matches,388.0,eng ENG,MF,25.0,0.2,11.0,0.0,3.0,4.0,4.0,0.0,11.0,1.0,0.0,0.0,1.0,100.0,5.0,38.0,24.0,1.0,0.0,0.0,1.0,1.0,5.0,0.0,Matches,388.0,eng ENG,MF,25.0,0.2,0.0,0.0,0.0,,0.0,0.0,,,,0.0,0.0,0.0,0.0,0.0,,0.0,0.0,Matches,388.0,eng ENG,MF,25.0,2.0,0.0,15.0,0.2,0.0,0.0,0.0,0.0,0.0,0.0,0.0,0.0,0.0,0.0,0.0,0.0,1.0,0.0,0.0,0.0,0.0,0.0,0.0,0.0,0.0,0.0,0.0,0.0,0.0,Matches,Josh Onomah,M/AM C,25,126,139,"England,Nigeria",Fulham,9,11,14,11,12,11,9,12,4,11,13,9,12,14,9,12,12,14,10,13,12,13,15,5,11,11,13,11,15,12,14,10,14,14,13,14,11,3,8,5,13,1,1,1,3,3,1,3,3,2,3,3,7,11,7,9,12,12,12,12,1,1,1,1,1,1,1,1,20,1,14,20,14,1,185,83,10,20,4080819,6300,6300,4260,African_Caribbean,123,15,1997/4/27,0,0,34798.0,,29126225
280,Paul Onuachu,Southampton,1994,389.0,ng NGA,FW,28.0,4.5,3.0,2.0,1.0,1.0,1.0,1.0,3.0,33.3,2.0,4.0,1.0,3.0,0.0,3.0,4.0,0.0,Matches,389.0,ng NGA,FW,28.0,4.5,7.0,1.55,5.0,0.0,0.0,1.0,1.0,0.0,0.0,0.0,0.0,0.0,0.0,0.0,0.0,0.0,Matches,,,,,,,,,,,,,,,,,,,,,,,,,,,,,,,,,,,,,,,,,,,,,,,,,,,,,,,,389.0,ng NGA,FW,28.0,4.5,0.0,0.0,0.0,14.0,6.0,6.0,0.0,0.0,2.0,0.0,0.0,0.0,14.0,37.0,30.0,55.2,Matches,389.0,ng NGA,FW,28.0,4.5,91.0,90.0,1.0,1.0,0.0,2.0,0.0,0.0,0.0,0.0,0.0,0.0,55.0,0.0,4.0,Matches,389.0,ng NGA,FW,28.0,4.5,55.0,91.0,60.4,757.0,157.0,35.0,51.0,68.6,10.0,20.0,50.0,5.0,7.0,71.4,0.0,0.1,0.1,-0.1,4.0,4.0,2.0,0.0,7.0,Matches,486,ng NGA,FW,28,11,407.0,37.0,11.9,4.5,4,64.0,0,7,22.0,4,0.45,3.0,7.0,-4.0,-0.88,0.1,4.2,6.1,-1.9,-0.42,0.22,Matches,389.0,ng NGA,FW,28.0,4.5,153.0,5.0,17.0,66.0,73.0,25.0,153.0,14.0,9.0,64.3,4.0,28.6,72.0,274.0,78.0,1.0,1.0,0.0,22.0,9.0,115.0,22.0,Matches,389.0,ng NGA,FW,28.0,4.5,0.0,11.0,5.0,45.5,2.43,1.11,0.0,0.0,14.2,0.0,0.0,0.0,1.3,1.3,0.12,-1.3,-1.3,Matches,389.0,ng NGA,FW,28.0,11.0,4.0,407.0,4.5,0.0,0.0,0.0,0.0,0.0,0.0,0.0,0.0,1.3,1.3,0.1,1.4,1.0,7.0,22.0,0.0,0.0,0.0,0.0,0.0,0.28,0.03,0.31,0.28,0.31,Matches,Paul Onuachu,S,28,130,136,Nigeria,K Racing Club Genk,4,9,11,14,13,7,14,11,6,10,12,8,7,13,15,14,16,11,14,11,13,13,14,6,14,6,14,13,9,13,17,20,14,14,13,17,15,15,14,5,3,3,2,3,1,2,2,1,1,1,4,3,9,13,4,14,12,12,11,9,1,1,1,1,1,1,1,1,1,1,1,1,1,20,201,93,12,20,25765738,7001,6750,5501,African_Caribbean,133,18,1994/5/28,15,3,25000.0,,27091941
281,Frank Onyeka,Brentford,1998,390.0,ng NGA,MF,24.0,9.4,19.0,14.0,11.0,7.0,1.0,10.0,25.0,40.0,15.0,16.0,3.0,13.0,10.0,29.0,16.0,0.0,Matches,390.0,ng NGA,MF,24.0,9.4,23.0,2.44,16.0,0.0,0.0,1.0,6.0,0.0,7.0,0.74,5.0,0.0,0.0,0.0,2.0,0.0,Matches,,,,,,,,,,,,,,,,,,,,,,,,,,,,,,,,,,,,,,,,,,,,,,,,,,,,,,,,390.0,ng NGA,MF,24.0,9.4,0.0,0.0,0.0,15.0,26.0,2.0,2.0,10.0,14.0,0.0,0.0,0.0,50.0,7.0,15.0,31.8,Matches,390.0,ng NGA,MF,24.0,9.4,257.0,255.0,1.0,0.0,0.0,1.0,2.0,1.0,0.0,0.0,0.0,0.0,193.0,1.0,9.0,Matches,390.0,ng NGA,MF,24.0,9.4,193.0,257.0,75.1,2989.0,784.0,106.0,129.0,82.2,70.0,88.0,79.5,9.0,17.0,52.9,2.0,0.6,0.8,1.4,7.0,23.0,6.0,0.0,28.0,Matches,487,ng NGA,MF,24,21,848.0,40.0,24.8,9.4,8,65.0,0,13,25.0,6,1.71,12.0,11.0,1.0,0.11,-0.28,12.8,15.2,-2.4,-0.25,-0.57,Matches,390.0,ng NGA,MF,24.0,9.4,373.0,26.0,93.0,176.0,109.0,20.0,373.0,26.0,11.0,42.3,11.0,42.3,198.0,852.0,368.0,9.0,8.0,3.0,11.0,10.0,205.0,21.0,Matches,390.0,ng NGA,MF,24.0,9.4,0.0,9.0,4.0,44.4,0.96,0.42,0.0,0.0,17.4,0.0,0.0,0.0,1.0,1.0,0.11,-1.0,-1.0,Matches,390.0,ng NGA,MF,24.0,21.0,8.0,848.0,9.4,0.0,2.0,2.0,0.0,0.0,0.0,0.0,0.0,1.0,1.0,0.6,1.6,9.0,28.0,21.0,0.0,0.21,0.21,0.0,0.21,0.11,0.07,0.18,0.11,0.18,Matches,Frank Onyeka,DM/M C,24,130,148,Nigeria,Brentford,6,9,12,11,12,7,11,10,6,11,13,8,13,12,15,13,15,13,13,12,12,17,11,7,14,14,15,17,14,13,13,11,14,14,15,13,12,8,12,3,17,3,4,1,1,3,1,2,1,2,2,3,13,12,7,13,12,12,13,8,1,1,1,1,1,1,20,1,18,7,1,9,11,8,183,0,10,20,13107405,6500,6650,5500,African_Caribbean,130,14,1998/1/1,7,0,40597.0,,27129125
282,Mislav Oršić,Southampton,1992,391.0,hr CRO,MF,29.0,0.1,1.0,1.0,1.0,0.0,0.0,0.0,0.0,,0.0,0.0,0.0,0.0,0.0,1.0,0.0,0.0,Matches,391.0,hr CRO,MF,29.0,0.1,0.0,0.0,0.0,0.0,0.0,0.0,0.0,0.0,0.0,0.0,0.0,0.0,0.0,0.0,0.0,0.0,Matches,,,,,,,,,,,,,,,,,,,,,,,,,,,,,,,,,,,,,,,,,,,,,,,,,,,,,,,,391.0,hr CRO,MF,29.0,0.1,0.0,0.0,0.0,0.0,0.0,1.0,0.0,0.0,1.0,0.0,0.0,0.0,1.0,0.0,0.0,,Matches,391.0,hr CRO,MF,29.0,0.1,3.0,2.0,1.0,0.0,0.0,0.0,0.0,1.0,0.0,0.0,0.0,0.0,2.0,0.0,0.0,Matches,391.0,hr CRO,MF,29.0,0.1,2.0,3.0,66.7,16.0,0.0,2.0,2.0,100.0,0.0,0.0,,0.0,1.0,0.0,0.0,0.0,0.0,0.0,0.0,0.0,0.0,0.0,0.0,Matches,488,hr CRO,MF,29,1,7.0,7.0,0.2,0.1,0,,0,1,7.0,3,0.0,0.0,0.0,0.0,0.0,0.98,0.2,0.0,0.2,2.22,2.84,Matches,391.0,hr CRO,MF,29.0,0.1,4.0,0.0,2.0,0.0,2.0,0.0,4.0,0.0,0.0,,0.0,,2.0,10.0,7.0,0.0,0.0,0.0,0.0,0.0,1.0,0.0,Matches,391.0,hr CRO,MF,29.0,0.1,0.0,0.0,0.0,,0.0,0.0,,,,0.0,0.0,0.0,0.0,0.0,,0.0,0.0,Matches,391.0,hr CRO,MF,29.0,1.0,0.0,7.0,0.1,0.0,0.0,0.0,0.0,0.0,0.0,0.0,0.0,0.0,0.0,0.0,0.0,0.0,0.0,0.0,0.0,0.0,0.0,0.0,0.0,0.0,0.0,0.0,0.0,0.0,Matches,Mislav Oršić,M/AM/S L,29,141,142,Croatia,GNK Dinamo Zagreb,16,11,11,16,12,14,8,17,4,6,11,14,8,13,6,11,5,11,11,11,9,13,13,4,16,11,10,15,16,15,12,10,16,18,13,8,9,6,18,7,13,3,1,3,2,1,2,1,3,2,1,2,8,12,2,17,17,18,16,12,1,1,1,1,8,1,1,17,1,12,20,12,13,18,179,69,10,20,14716726,7249,6799,6249,Northern_European,131,4,1992/12/29,19,1,15341.0,,24014057
283,Stefan Ortega,Manchester City,1992,392.0,de GER,GK,29.0,3.0,0.0,0.0,0.0,0.0,0.0,0.0,0.0,,0.0,0.0,0.0,0.0,0.0,0.0,0.0,0.0,Matches,392.0,de GER,GK,29.0,3.0,0.0,0.0,0.0,0.0,0.0,0.0,0.0,0.0,0.0,0.0,0.0,0.0,0.0,0.0,0.0,0.0,Matches,27.0,de GER,GK,29.0,3.0,1.0,0.0,0.0,0.0,0.0,4.1,0.27,3.1,1.02,11.0,24.0,45.8,155.0,16.0,14.8,23.9,12.0,8.3,20.3,26.0,1.0,3.8,7.0,2.33,21.1,Matches,27.0,de GER,GK,29.0,3.0,3.0,270.0,3.0,1.0,0.33,15.0,14.0,93.3,2.0,1.0,0.0,2.0,66.7,0.0,0.0,0.0,0.0,,Matches,392.0,de GER,GK,29.0,3.0,0.0,0.0,0.0,0.0,0.0,0.0,0.0,0.0,0.0,0.0,0.0,0.0,7.0,1.0,0.0,100.0,Matches,392.0,de GER,GK,29.0,3.0,167.0,152.0,15.0,3.0,0.0,0.0,0.0,0.0,0.0,0.0,0.0,0.0,145.0,0.0,1.0,Matches,392.0,de GER,GK,29.0,3.0,145.0,167.0,86.8,3008.0,1895.0,57.0,58.0,98.3,61.0,62.0,98.4,27.0,46.0,58.7,0.0,0.0,0.0,0.0,0.0,1.0,0.0,0.0,0.0,Matches,489,de GER,GK,29,3,270.0,90.0,7.9,3.0,3,90.0,3,0,,35,2.33,5.0,1.0,4.0,1.33,-0.3,5.3,3.9,1.4,0.48,-0.81,Matches,392.0,de GER,GK,29.0,3.0,174.0,132.0,173.0,1.0,0.0,0.0,174.0,0.0,0.0,,0.0,,116.0,392.0,245.0,0.0,0.0,0.0,0.0,0.0,119.0,0.0,Matches,392.0,de GER,GK,29.0,3.0,0.0,0.0,0.0,,0.0,0.0,,,,0.0,0.0,0.0,0.0,0.0,,0.0,0.0,Matches,392.0,de GER,GK,29.0,3.0,3.0,270.0,3.0,0.0,0.0,0.0,0.0,0.0,0.0,0.0,0.0,0.0,0.0,0.0,0.0,0.0,0.0,0.0,0.0,0.0,0.0,0.0,0.0,0.0,0.0,0.0,0.0,0.0,Matches,Stefan Ortega,GK,29,129,134,"Germany,Spain",Manchester City,3,1,2,3,11,6,7,1,1,2,12,2,1,11,10,12,12,12,12,11,12,14,5,13,5,11,12,13,11,12,13,14,14,9,12,13,16,4,15,5,2,12,13,13,10,15,14,13,15,13,11,14,12,13,8,15,13,14,14,12,20,1,1,1,1,1,1,1,1,1,1,1,1,1,185,88,8,20,1383669,6440,6090,4340,Northern_European,128,4,1992/11/6,0,0,23198.0,,91100272
284,Alex Oxlade-Chamberlain,Liverpool,1993,394.0,eng ENG,FWMF,28.0,3.7,5.0,4.0,1.0,2.0,2.0,1.0,5.0,20.0,4.0,5.0,2.0,3.0,1.0,6.0,4.0,0.0,Matches,394.0,eng ENG,FWMF,28.0,3.7,10.0,2.69,8.0,0.0,1.0,1.0,0.0,0.0,0.0,0.0,0.0,0.0,0.0,0.0,0.0,0.0,Matches,,,,,,,,,,,,,,,,,,,,,,,,,,,,,,,,,,,,,,,,,,,,,,,,,,,,,,,,394.0,eng ENG,FWMF,28.0,3.7,0.0,0.0,0.0,3.0,4.0,1.0,2.0,1.0,4.0,0.0,0.0,0.0,20.0,1.0,4.0,20.0,Matches,394.0,eng ENG,FWMF,28.0,3.7,106.0,102.0,2.0,0.0,2.0,3.0,2.0,2.0,0.0,0.0,0.0,0.0,75.0,2.0,4.0,Matches,394.0,eng ENG,FWMF,28.0,3.7,75.0,106.0,70.8,1253.0,347.0,39.0,45.0,86.7,24.0,34.0,70.6,8.0,14.0,57.1,0.0,0.9,0.2,-0.9,5.0,8.0,2.0,0.0,14.0,Matches,491,eng ENG,FWMF,28,9,335.0,37.0,9.8,3.7,4,69.0,0,5,12.0,4,1.33,5.0,7.0,-2.0,-0.54,-1.41,7.0,6.4,0.6,0.17,-0.44,Matches,394.0,eng ENG,FWMF,28.0,3.7,152.0,4.0,20.0,69.0,67.0,17.0,152.0,14.0,6.0,42.9,7.0,50.0,90.0,719.0,258.0,11.0,8.0,3.0,12.0,10.0,110.0,28.0,Matches,394.0,eng ENG,FWMF,28.0,3.7,1.0,7.0,3.0,42.9,1.88,0.81,0.14,0.33,16.3,0.0,0.0,0.0,1.3,1.3,0.19,-0.3,-0.3,Matches,394.0,eng ENG,FWMF,28.0,9.0,4.0,335.0,3.7,1.0,0.0,1.0,1.0,0.0,0.0,0.0,0.0,1.3,1.3,0.9,2.2,11.0,14.0,28.0,0.27,0.0,0.27,0.27,0.27,0.35,0.23,0.58,0.35,0.58,Matches,Alex Oxlade-Chamberlain,M/AM RC,28,149,158,"England,Jamaica",Liverpool,11,14,15,12,15,11,8,14,12,11,15,12,11,15,11,13,12,14,13,14,13,14,15,9,15,12,15,14,14,15,15,9,13,15,14,14,12,6,13,14,15,2,2,1,2,3,1,3,3,3,3,2,16,14,9,14,12,16,14,14,1,1,1,1,1,14,8,12,20,15,14,16,17,12,176,72,9,20,29222958,7450,7150,6000,Mixed_Race,147,12,1993/8/15,35,7,144990.0,,28046572
285,David Ozoh,Crystal Palace,2005,395.0,eng ENG,FW,17.0,0.0,0.0,0.0,0.0,0.0,0.0,0.0,0.0,,0.0,0.0,0.0,0.0,0.0,0.0,0.0,0.0,Matches,395.0,eng ENG,FW,17.0,0.0,0.0,0.0,0.0,0.0,0.0,0.0,0.0,0.0,0.0,0.0,0.0,0.0,0.0,0.0,0.0,0.0,Matches,,,,,,,,,,,,,,,,,,,,,,,,,,,,,,,,,,,,,,,,,,,,,,,,,,,,,,,,395.0,eng ENG,FW,17.0,0.0,0.0,0.0,0.0,0.0,0.0,0.0,0.0,0.0,0.0,0.0,0.0,0.0,0.0,0.0,0.0,,Matches,395.0,eng ENG,FW,17.0,0.0,3.0,3.0,0.0,0.0,0.0,0.0,0.0,0.0,0.0,0.0,0.0,0.0,3.0,0.0,0.0,Matches,395.0,eng ENG,FW,17.0,0.0,3.0,3.0,100.0,24.0,0.0,3.0,3.0,100.0,0.0,0.0,,0.0,0.0,,0.0,0.0,0.0,0.0,0.0,0.0,0.0,0.0,0.0,Matches,492,eng ENG,FW,17,1,1.0,1.0,0.0,0.0,0,,0,1,1.0,3,1.0,0.0,0.0,0.0,0.0,0.24,0.0,0.0,0.0,0.0,0.23,Matches,395.0,eng ENG,FW,17.0,0.0,4.0,0.0,0.0,0.0,4.0,0.0,4.0,0.0,0.0,,0.0,,2.0,1.0,1.0,0.0,0.0,0.0,1.0,0.0,4.0,0.0,Matches,395.0,eng ENG,FW,17.0,0.0,0.0,0.0,0.0,,0.0,0.0,,,,0.0,0.0,0.0,0.0,0.0,,0.0,0.0,Matches,395.0,eng ENG,FW,17.0,1.0,0.0,1.0,0.0,0.0,0.0,0.0,0.0,0.0,0.0,0.0,0.0,0.0,0.0,0.0,0.0,0.0,0.0,0.0,0.0,0.0,0.0,0.0,0.0,0.0,0.0,0.0,0.0,0.0,Matches,David Ozoh,DM/M C,17,75,-75,"England,Spain,Nigeria",Crystal Palace,7,7,4,9,14,7,9,9,5,5,8,6,9,9,15,10,8,6,8,9,11,4,5,1,9,12,13,11,10,9,5,7,11,12,8,11,15,9,14,5,10,3,2,2,3,1,2,2,4,2,1,3,14,9,6,10,11,10,12,19,1,1,1,1,1,1,20,1,20,1,1,11,1,1,184,0,9,20,10216552,3745,3745,1745,African_Caribbean,65,19,2005/3/7,0,0,203.0,,2000140844
286,Cole Palmer,Manchester City,2002,397.0,eng ENG,MFFW,20.0,4.1,5.0,1.0,0.0,3.0,2.0,3.0,5.0,60.0,2.0,2.0,1.0,1.0,1.0,6.0,2.0,0.0,Matches,397.0,eng ENG,MFFW,20.0,4.1,20.0,4.86,11.0,0.0,3.0,4.0,2.0,0.0,1.0,0.24,1.0,0.0,0.0,0.0,0.0,0.0,Matches,,,,,,,,,,,,,,,,,,,,,,,,,,,,,,,,,,,,,,,,,,,,,,,,,,,,,,,,397.0,eng ENG,MFFW,20.0,4.1,1.0,0.0,0.0,1.0,6.0,1.0,7.0,1.0,1.0,0.0,0.0,0.0,20.0,1.0,3.0,25.0,Matches,397.0,eng ENG,MFFW,20.0,4.1,193.0,191.0,2.0,0.0,0.0,1.0,7.0,1.0,1.0,0.0,0.0,0.0,167.0,0.0,1.0,Matches,397.0,eng ENG,MFFW,20.0,4.1,167.0,193.0,86.5,2377.0,369.0,100.0,105.0,95.2,51.0,62.0,82.3,6.0,11.0,54.5,1.0,0.6,0.5,0.4,5.0,8.0,7.0,1.0,13.0,Matches,495,eng ENG,MFFW,20,14,370.0,26.0,10.8,4.1,2,90.0,2,12,16.0,17,2.64,3.0,4.0,-1.0,-0.24,-2.07,5.3,7.9,-2.6,-0.62,-2.07,Matches,397.0,eng ENG,MFFW,20.0,4.1,248.0,6.0,22.0,85.0,143.0,32.0,248.0,26.0,15.0,57.7,7.0,26.9,179.0,1222.0,639.0,29.0,8.0,15.0,13.0,8.0,202.0,40.0,Matches,397.0,eng ENG,MFFW,20.0,4.1,0.0,11.0,3.0,27.3,2.68,0.73,0.0,0.0,13.7,0.0,0.0,0.0,1.2,1.2,0.14,-1.2,-1.2,Matches,397.0,eng ENG,MFFW,20.0,14.0,2.0,370.0,4.1,0.0,1.0,1.0,0.0,0.0,0.0,1.0,0.0,1.2,1.2,0.6,1.8,29.0,13.0,40.0,0.0,0.24,0.24,0.0,0.24,0.3,0.14,0.44,0.3,0.44,Matches,Cole Palmer,AM RLC,20,135,-85,England,Manchester City,12,12,14,13,13,12,8,13,3,6,13,13,8,16,8,13,8,13,12,13,12,13,14,7,13,8,11,13,15,14,13,13,13,14,13,8,12,5,13,5,10,2,1,1,3,1,1,1,3,2,3,3,7,13,8,10,9,12,13,9,1,1,1,1,1,1,1,1,15,1,17,20,20,13,182,0,20,9,81310207,6742,6742,5742,Northern_European,127,5,2002/5/6,0,0,28998.0,,28120042
287,Ben Pearson,Bournemouth,1995,402.0,eng ENG,MF,27.0,3.2,7.0,3.0,3.0,3.0,1.0,1.0,3.0,33.3,2.0,4.0,0.0,4.0,2.0,9.0,6.0,0.0,Matches,402.0,eng ENG,MF,27.0,3.2,2.0,0.63,1.0,0.0,0.0,1.0,0.0,0.0,0.0,0.0,0.0,0.0,0.0,0.0,0.0,0.0,Matches,,,,,,,,,,,,,,,,,,,,,,,,,,,,,,,,,,,,,,,,,,,,,,,,,,,,,,,,402.0,eng ENG,MF,27.0,3.2,1.0,0.0,0.0,9.0,2.0,0.0,0.0,2.0,3.0,0.0,0.0,0.0,19.0,2.0,3.0,40.0,Matches,402.0,eng ENG,MF,27.0,3.2,134.0,130.0,4.0,3.0,0.0,1.0,0.0,0.0,0.0,0.0,0.0,0.0,108.0,0.0,1.0,Matches,402.0,eng ENG,MF,27.0,3.2,108.0,134.0,80.6,1814.0,501.0,50.0,58.0,86.2,45.0,55.0,81.8,8.0,15.0,53.3,0.0,0.0,0.0,0.0,0.0,8.0,0.0,0.0,5.0,Matches,503,eng ENG,MF,27,7,286.0,41.0,8.4,3.2,3,69.0,1,4,20.0,7,1.0,1.0,10.0,-9.0,-2.83,-2.11,1.3,5.8,-4.6,-1.43,-0.84,Matches,402.0,eng ENG,MF,27.0,3.2,162.0,8.0,56.0,90.0,17.0,0.0,162.0,1.0,0.0,0.0,0.0,0.0,72.0,242.0,103.0,2.0,0.0,0.0,6.0,0.0,100.0,4.0,Matches,402.0,eng ENG,MF,27.0,3.2,0.0,2.0,1.0,50.0,0.63,0.31,0.0,0.0,25.2,0.0,0.0,0.0,0.0,0.0,0.02,0.0,0.0,Matches,402.0,eng ENG,MF,27.0,7.0,3.0,286.0,3.2,0.0,0.0,0.0,0.0,0.0,0.0,1.0,0.0,0.0,0.0,0.0,0.0,2.0,5.0,4.0,0.0,0.0,0.0,0.0,0.0,0.01,0.0,0.01,0.01,0.01,Matches,Ben Pearson,DM/M C,27,124,140,England,AFC Bournemouth,8,8,9,7,14,8,9,7,3,12,15,10,14,13,17,13,14,14,12,14,13,18,11,11,11,15,15,16,11,12,12,9,11,11,12,13,14,15,12,5,10,1,1,1,3,1,3,1,3,3,3,1,12,16,4,11,11,11,6,2,1,1,1,1,1,1,20,1,20,1,1,1,1,1,174,71,10,20,7639743,6200,6200,3500,Northern_European,124,1,1995/1/4,0,0,28998.0,,28066818
288,Facundo Pellistri,Manchester Utd,2001,403.0,uy URU,FWMF,20.0,0.7,1.0,1.0,0.0,1.0,0.0,0.0,0.0,,0.0,0.0,0.0,0.0,0.0,1.0,3.0,0.0,Matches,403.0,uy URU,FWMF,20.0,0.7,1.0,1.41,1.0,0.0,0.0,0.0,0.0,0.0,1.0,1.41,1.0,0.0,0.0,0.0,0.0,0.0,Matches,,,,,,,,,,,,,,,,,,,,,,,,,,,,,,,,,,,,,,,,,,,,,,,,,,,,,,,,403.0,uy URU,FWMF,20.0,0.7,0.0,0.0,0.0,1.0,2.0,0.0,0.0,0.0,1.0,0.0,0.0,0.0,1.0,0.0,0.0,,Matches,403.0,uy URU,FWMF,20.0,0.7,16.0,15.0,1.0,0.0,0.0,0.0,0.0,1.0,0.0,0.0,0.0,0.0,15.0,0.0,0.0,Matches,403.0,uy URU,FWMF,20.0,0.7,15.0,16.0,93.8,180.0,17.0,8.0,9.0,88.9,5.0,5.0,100.0,0.0,0.0,,0.0,0.0,0.0,0.0,0.0,1.0,0.0,0.0,1.0,Matches,504,uy URU,FWMF,20,4,64.0,16.0,1.9,0.7,0,,0,4,16.0,19,1.25,2.0,1.0,1.0,1.41,1.03,1.3,1.0,0.3,0.47,0.02,Matches,403.0,uy URU,FWMF,20.0,0.7,24.0,0.0,9.0,7.0,8.0,1.0,24.0,3.0,2.0,66.7,1.0,33.3,12.0,148.0,45.0,1.0,0.0,0.0,2.0,1.0,14.0,2.0,Matches,403.0,uy URU,FWMF,20.0,0.7,0.0,0.0,0.0,,0.0,0.0,,,,0.0,0.0,0.0,0.0,0.0,,0.0,0.0,Matches,403.0,uy URU,FWMF,20.0,4.0,0.0,64.0,0.7,0.0,0.0,0.0,0.0,0.0,0.0,0.0,0.0,0.0,0.0,0.0,0.0,1.0,1.0,2.0,0.0,0.0,0.0,0.0,0.0,0.0,0.0,0.0,0.0,0.0,Matches,Facundo Pellistri,AM R,20,122,-8,"Uruguay,Spain",Manchester UFC,8,11,14,11,14,8,4,7,3,5,11,10,7,15,14,10,11,10,10,10,9,14,14,5,14,7,13,15,17,14,10,7,11,14,13,6,12,6,15,11,13,2,3,1,2,3,3,1,1,1,2,3,11,11,5,11,13,10,10,12,1,1,1,1,1,1,1,5,1,8,14,12,20,15,174,65,11,20,80266281,6250,6000,4250,Mediterranean_Hispanic,117,8,2001/12/20,6,0,28998.0,,78095389
289,Ricardo Pereira,Leicester City,1993,405.0,pt POR,DFMF,28.0,5.0,11.0,7.0,8.0,3.0,0.0,7.0,17.0,41.2,10.0,8.0,2.0,6.0,4.0,15.0,20.0,0.0,Matches,405.0,pt POR,DFMF,28.0,5.0,15.0,2.97,14.0,0.0,0.0,0.0,1.0,0.0,1.0,0.2,1.0,0.0,0.0,0.0,0.0,0.0,Matches,,,,,,,,,,,,,,,,,,,,,,,,,,,,,,,,,,,,,,,,,,,,,,,,,,,,,,,,405.0,pt POR,DFMF,28.0,5.0,2.0,0.0,0.0,4.0,4.0,0.0,16.0,4.0,7.0,0.0,0.0,0.0,30.0,5.0,11.0,31.3,Matches,405.0,pt POR,DFMF,28.0,5.0,322.0,259.0,61.0,9.0,0.0,0.0,16.0,50.0,0.0,0.0,0.0,0.0,252.0,2.0,14.0,Matches,405.0,pt POR,DFMF,28.0,5.0,252.0,322.0,78.3,4024.0,1552.0,130.0,147.0,88.4,105.0,125.0,84.0,12.0,27.0,44.4,1.0,0.6,0.6,0.4,7.0,25.0,10.0,3.0,27.0,Matches,507,pt POR,DFMF,28,10,454.0,45.0,13.3,5.0,5,79.0,3,5,12.0,2,0.7,3.0,11.0,-8.0,-1.59,-1.31,6.4,8.2,-1.7,-0.34,-0.01,Matches,405.0,pt POR,DFMF,28.0,5.0,383.0,23.0,116.0,183.0,90.0,4.0,383.0,7.0,5.0,71.4,1.0,14.3,174.0,605.0,323.0,5.0,9.0,2.0,7.0,3.0,217.0,14.0,Matches,405.0,pt POR,DFMF,28.0,5.0,1.0,2.0,1.0,50.0,0.4,0.2,0.5,1.0,17.8,0.0,0.0,0.0,0.1,0.1,0.06,0.9,0.9,Matches,405.0,pt POR,DFMF,28.0,10.0,5.0,454.0,5.0,1.0,1.0,2.0,1.0,0.0,0.0,2.0,0.0,0.1,0.1,0.6,0.7,5.0,27.0,14.0,0.2,0.2,0.4,0.2,0.4,0.02,0.12,0.14,0.02,0.14,Matches,Ricardo Pereira,D/WB/AM R,28,142,165,"Portugal,Cape Verde Islands",Leicester City,9,14,14,11,12,8,6,12,7,12,12,12,16,14,11,14,13,13,12,13,13,15,13,7,14,14,15,16,15,13,13,9,10,14,13,10,14,9,12,16,16,3,1,3,4,1,3,4,1,1,3,1,12,15,6,13,14,15,15,12,1,13,1,20,12,17,1,1,1,13,12,1,18,7,175,70,10,20,26028545,7100,7100,5750,African_Caribbean,133,13,1993/10/6,7,0,139190.0,,55062009
290,Ayoze Pérez,Leicester City,1993,406.0,es ESP,MFFW,29.0,4.2,11.0,8.0,5.0,4.0,2.0,8.0,19.0,42.1,11.0,6.0,0.0,6.0,2.0,13.0,3.0,0.0,Matches,406.0,es ESP,MFFW,29.0,4.2,14.0,3.29,11.0,2.0,0.0,0.0,1.0,0.0,2.0,0.47,1.0,0.0,0.0,0.0,1.0,0.0,Matches,,,,,,,,,,,,,,,,,,,,,,,,,,,,,,,,,,,,,,,,,,,,,,,,,,,,,,,,406.0,es ESP,MFFW,29.0,4.2,0.0,0.0,0.0,7.0,12.0,0.0,17.0,2.0,8.0,0.0,0.0,0.0,35.0,2.0,4.0,33.3,Matches,406.0,es ESP,MFFW,29.0,4.2,171.0,156.0,14.0,1.0,5.0,0.0,17.0,1.0,11.0,6.0,5.0,0.0,118.0,1.0,11.0,Matches,406.0,es ESP,MFFW,29.0,4.2,118.0,171.0,69.0,1698.0,468.0,75.0,89.0,84.3,28.0,43.0,65.1,9.0,18.0,50.0,1.0,1.5,0.6,-0.5,11.0,13.0,6.0,0.0,20.0,Matches,508,es ESP,MFFW,29,8,382.0,48.0,11.2,4.2,3,75.0,1,5,32.0,10,0.75,4.0,5.0,-1.0,-0.24,0.24,5.7,5.6,0.2,0.04,0.42,Matches,406.0,es ESP,MFFW,29.0,4.2,244.0,3.0,38.0,104.0,108.0,17.0,244.0,21.0,6.0,28.6,12.0,57.1,132.0,696.0,356.0,17.0,6.0,6.0,12.0,11.0,155.0,43.0,Matches,406.0,es ESP,MFFW,29.0,4.2,0.0,8.0,2.0,25.0,1.88,0.47,0.0,0.0,15.9,0.0,0.0,0.0,1.1,1.1,0.14,-1.1,-1.1,Matches,406.0,es ESP,MFFW,29.0,8.0,3.0,382.0,4.2,0.0,1.0,1.0,0.0,0.0,0.0,0.0,0.0,1.1,1.1,1.5,2.6,17.0,20.0,43.0,0.0,0.24,0.24,0.0,0.24,0.27,0.35,0.62,0.27,0.62,Matches,Ayoze Pérez,AM/S RC,28,136,142,Spain,Leicester City,7,12,15,14,15,9,11,9,4,5,13,11,10,14,6,14,10,12,12,13,13,13,15,10,15,8,14,16,12,14,13,8,15,13,14,9,11,7,14,8,16,3,2,3,1,2,1,1,3,3,1,3,13,15,5,12,13,13,12,14,1,1,1,1,1,1,1,1,1,15,13,20,19,18,178,72,12,20,16944171,6800,6800,5750,Mediterranean_Hispanic,130,10,1993/7/29,0,0,92793.0,,67172040
291,Máximo Perrone,Manchester City,2003,409.0,ar ARG,MF,19.0,0.2,0.0,0.0,0.0,0.0,0.0,0.0,0.0,,0.0,1.0,0.0,1.0,0.0,0.0,0.0,0.0,Matches,409.0,ar ARG,MF,19.0,0.2,1.0,4.74,1.0,0.0,0.0,0.0,0.0,0.0,0.0,0.0,0.0,0.0,0.0,0.0,0.0,0.0,Matches,,,,,,,,,,,,,,,,,,,,,,,,,,,,,,,,,,,,,,,,,,,,,,,,,,,,,,,,409.0,ar ARG,MF,19.0,0.2,0.0,0.0,0.0,0.0,0.0,0.0,0.0,0.0,0.0,0.0,0.0,0.0,3.0,0.0,0.0,,Matches,409.0,ar ARG,MF,19.0,0.2,21.0,20.0,0.0,0.0,0.0,0.0,0.0,0.0,0.0,0.0,0.0,0.0,18.0,1.0,1.0,Matches,409.0,ar ARG,MF,19.0,0.2,18.0,21.0,85.7,228.0,32.0,11.0,12.0,91.7,5.0,5.0,100.0,0.0,0.0,,0.0,0.0,0.0,0.0,0.0,0.0,0.0,0.0,2.0,Matches,512,ar ARG,MF,19,1,19.0,19.0,0.6,0.2,0,,0,1,19.0,4,3.0,0.0,1.0,-1.0,-4.74,-6.38,0.3,0.2,0.1,0.7,-0.53,Matches,409.0,ar ARG,MF,19.0,0.2,22.0,0.0,4.0,12.0,6.0,2.0,22.0,0.0,0.0,,0.0,,8.0,20.0,7.0,0.0,0.0,0.0,0.0,0.0,19.0,1.0,Matches,409.0,ar ARG,MF,19.0,0.2,0.0,0.0,0.0,,0.0,0.0,,,,0.0,0.0,0.0,0.0,0.0,,0.0,0.0,Matches,409.0,ar ARG,MF,19.0,1.0,0.0,19.0,0.2,0.0,0.0,0.0,0.0,0.0,0.0,0.0,0.0,0.0,0.0,0.0,0.0,0.0,2.0,1.0,0.0,0.0,0.0,0.0,0.0,0.0,0.0,0.0,0.0,0.0,Matches,Máximo Perrone,DM/M C,19,118,-8,Argentina,Club Atlético Vélez Sarsfield,6,7,12,9,13,10,11,12,10,12,14,11,12,13,12,13,13,13,13,13,13,12,13,12,12,12,13,12,12,13,13,10,13,12,13,9,12,13,14,6,13,1,3,1,3,1,1,3,2,2,1,3,16,14,6,14,12,12,13,13,1,1,1,1,1,1,20,1,18,1,1,10,1,1,178,67,20,8,5101247,6000,6000,3250,Mediterranean_Hispanic,118,6,2003/1/7,0,0,2097.0,,14227360
292,Kalvin Phillips,Manchester City,1995,411.0,eng ENG,MF,26.0,3.3,6.0,4.0,3.0,3.0,0.0,2.0,10.0,20.0,8.0,7.0,3.0,4.0,5.0,11.0,10.0,0.0,Matches,411.0,eng ENG,MF,26.0,3.3,7.0,2.1,5.0,0.0,0.0,2.0,0.0,0.0,1.0,0.3,1.0,0.0,0.0,0.0,0.0,0.0,Matches,,,,,,,,,,,,,,,,,,,,,,,,,,,,,,,,,,,,,,,,,,,,,,,,,,,,,,,,411.0,eng ENG,MF,26.0,3.3,1.0,0.0,0.0,10.0,2.0,0.0,0.0,5.0,4.0,0.0,0.0,0.0,19.0,5.0,2.0,71.4,Matches,411.0,eng ENG,MF,26.0,3.3,313.0,310.0,2.0,2.0,0.0,2.0,0.0,0.0,0.0,0.0,0.0,0.0,289.0,1.0,1.0,Matches,411.0,eng ENG,MF,26.0,3.3,289.0,313.0,92.3,5155.0,873.0,113.0,120.0,94.2,148.0,153.0,96.7,25.0,33.0,75.8,0.0,0.2,0.1,-0.2,3.0,32.0,0.0,0.0,18.0,Matches,514,eng ENG,MF,26,12,300.0,25.0,8.8,3.3,2,90.0,2,10,12.0,15,2.58,1.0,3.0,-2.0,-0.6,-2.42,4.1,5.8,-1.7,-0.52,-1.91,Matches,411.0,eng ENG,MF,26.0,3.3,354.0,16.0,64.0,243.0,49.0,6.0,354.0,2.0,1.0,50.0,0.0,0.0,228.0,1021.0,331.0,1.0,4.0,0.0,2.0,1.0,284.0,2.0,Matches,411.0,eng ENG,MF,26.0,3.3,0.0,6.0,0.0,0.0,1.8,0.0,0.0,,22.9,0.0,0.0,0.0,0.3,0.3,0.05,-0.3,-0.3,Matches,411.0,eng ENG,MF,26.0,12.0,2.0,300.0,3.3,0.0,0.0,0.0,0.0,0.0,0.0,1.0,0.0,0.3,0.3,0.2,0.5,1.0,18.0,2.0,0.0,0.0,0.0,0.0,0.0,0.1,0.05,0.14,0.1,0.14,Matches,Kalvin Phillips,DM/M C,26,152,156,England,Manchester City,13,12,11,9,13,13,11,11,5,13,15,10,16,13,16,15,16,13,14,14,13,16,10,10,11,15,15,18,13,13,14,11,18,14,17,14,14,13,13,10,13,2,2,4,3,1,1,3,2,2,2,3,16,13,1,17,15,16,11,18,1,1,12,1,1,1,20,1,17,1,1,9,1,1,178,72,11,20,48341458,7593,7593,6743,Northern_European,151,9,1995/12/2,23,0,185587.0,,29113879
293,Dennis Praet,Leicester City,1994,418.0,be BEL,MFFW,28.0,7.2,12.0,9.0,5.0,6.0,1.0,6.0,11.0,54.5,5.0,12.0,2.0,10.0,5.0,17.0,6.0,0.0,Matches,418.0,be BEL,MFFW,28.0,7.2,14.0,1.94,11.0,2.0,0.0,1.0,0.0,0.0,0.0,0.0,0.0,0.0,0.0,0.0,0.0,0.0,Matches,,,,,,,,,,,,,,,,,,,,,,,,,,,,,,,,,,,,,,,,,,,,,,,,,,,,,,,,418.0,be BEL,MFFW,28.0,7.2,1.0,0.0,0.0,9.0,8.0,1.0,15.0,5.0,9.0,0.0,0.0,0.0,48.0,1.0,11.0,8.3,Matches,418.0,be BEL,MFFW,28.0,7.2,270.0,254.0,14.0,2.0,2.0,0.0,15.0,5.0,2.0,0.0,0.0,0.0,200.0,2.0,15.0,Matches,418.0,be BEL,MFFW,28.0,7.2,200.0,270.0,74.1,2897.0,680.0,117.0,138.0,84.8,62.0,77.0,80.5,13.0,27.0,48.1,0.0,0.5,0.4,-0.5,3.0,10.0,5.0,1.0,17.0,Matches,525,be BEL,MFFW,28,22,649.0,30.0,19.0,7.2,6,49.0,0,16,22.0,12,1.18,9.0,10.0,-1.0,-0.14,0.38,9.4,11.7,-2.3,-0.31,0.03,Matches,418.0,be BEL,MFFW,28.0,7.2,342.0,11.0,67.0,163.0,118.0,14.0,342.0,14.0,6.0,42.9,7.0,50.0,177.0,902.0,357.0,15.0,7.0,1.0,11.0,10.0,217.0,42.0,Matches,418.0,be BEL,MFFW,28.0,7.2,1.0,5.0,2.0,40.0,0.69,0.28,0.2,0.5,13.6,0.0,0.0,0.0,1.0,1.0,0.2,0.0,0.0,Matches,418.0,be BEL,MFFW,28.0,22.0,6.0,649.0,7.2,1.0,0.0,1.0,1.0,0.0,0.0,1.0,0.0,1.0,1.0,0.5,1.5,15.0,17.0,42.0,0.14,0.0,0.14,0.14,0.14,0.14,0.06,0.21,0.14,0.21,Matches,Dennis Praet,M/AM C,28,138,148,Belgium,Leicester City,13,13,13,11,14,12,8,12,12,8,15,10,13,14,12,12,13,14,15,14,16,13,16,11,13,11,15,14,12,13,10,9,14,12,13,12,12,8,12,9,14,3,3,2,2,2,3,2,3,2,2,1,12,14,10,11,12,13,10,18,1,1,1,1,1,1,12,13,20,13,12,19,12,1,181,78,12,20,32690705,6899,7249,5849,Northern_European,137,2,1994/5/14,15,2,86994.0,,18045342
294,Christian Pulisic,Chelsea,1998,420.0,us USA,FWDF,23.0,9.1,11.0,6.0,3.0,6.0,2.0,3.0,5.0,60.0,2.0,8.0,1.0,7.0,4.0,15.0,4.0,0.0,Matches,420.0,us USA,FWDF,23.0,9.1,24.0,2.63,21.0,0.0,0.0,3.0,0.0,0.0,3.0,0.33,3.0,0.0,0.0,0.0,0.0,0.0,Matches,,,,,,,,,,,,,,,,,,,,,,,,,,,,,,,,,,,,,,,,,,,,,,,,,,,,,,,,420.0,us USA,FWDF,23.0,9.1,1.0,0.0,0.0,10.0,15.0,0.0,18.0,4.0,6.0,0.0,0.0,0.0,31.0,5.0,18.0,21.7,Matches,420.0,us USA,FWDF,23.0,9.1,301.0,294.0,4.0,0.0,1.0,0.0,18.0,4.0,0.0,0.0,0.0,0.0,238.0,3.0,8.0,Matches,420.0,us USA,FWDF,23.0,9.1,238.0,301.0,79.1,3262.0,556.0,154.0,177.0,87.0,66.0,84.0,78.6,10.0,18.0,55.6,1.0,0.7,0.4,0.3,12.0,14.0,3.0,1.0,23.0,Matches,527,us USA,FWDF,23,24,821.0,34.0,24.0,9.1,8,64.0,0,16,19.0,5,1.13,12.0,11.0,1.0,0.11,0.46,11.0,14.1,-3.0,-0.33,-0.33,Matches,420.0,us USA,FWDF,23.0,9.1,429.0,4.0,53.0,168.0,216.0,43.0,429.0,44.0,13.0,29.5,22.0,50.0,299.0,2126.0,1044.0,35.0,30.0,14.0,26.0,13.0,328.0,76.0,Matches,420.0,us USA,FWDF,23.0,9.1,1.0,19.0,6.0,31.6,2.08,0.66,0.05,0.17,16.8,0.0,0.0,0.0,1.7,1.7,0.09,-0.7,-0.7,Matches,420.0,us USA,FWDF,23.0,24.0,8.0,821.0,9.1,1.0,1.0,2.0,1.0,0.0,0.0,1.0,0.0,1.7,1.7,0.7,2.3,35.0,23.0,76.0,0.11,0.11,0.22,0.11,0.22,0.18,0.07,0.26,0.18,0.26,Matches,Christian Pulisic,M/AM RLC,23,154,170,"United States,Croatia",Chelsea,12,11,16,13,15,10,8,10,5,6,11,10,8,15,13,15,14,12,10,14,14,14,15,12,15,8,14,16,17,17,8,7,13,15,14,9,12,4,15,14,14,2,1,2,2,2,2,2,2,3,2,2,15,17,6,9,13,14,16,14,1,1,1,1,1,13,1,16,8,16,20,17,17,8,173,73,12,20,73283578,7500,7800,6750,Northern_European,149,4,1998/9/18,51,21,173988.0,,92074020
295,Nathan Redmond,Southampton,1994,426.0,eng ENG,DF,28.0,0.0,0.0,0.0,0.0,0.0,0.0,0.0,0.0,,0.0,0.0,0.0,0.0,0.0,0.0,0.0,0.0,Matches,426.0,eng ENG,DF,28.0,0.0,0.0,0.0,0.0,0.0,0.0,0.0,0.0,0.0,0.0,0.0,0.0,0.0,0.0,0.0,0.0,0.0,Matches,,,,,,,,,,,,,,,,,,,,,,,,,,,,,,,,,,,,,,,,,,,,,,,,,,,,,,,,426.0,eng ENG,DF,28.0,0.0,0.0,0.0,0.0,0.0,0.0,0.0,1.0,0.0,0.0,0.0,0.0,0.0,0.0,0.0,0.0,,Matches,426.0,eng ENG,DF,28.0,0.0,1.0,1.0,0.0,0.0,0.0,0.0,1.0,0.0,0.0,0.0,0.0,0.0,0.0,0.0,0.0,Matches,426.0,eng ENG,DF,28.0,0.0,0.0,1.0,0.0,0.0,0.0,0.0,0.0,,0.0,1.0,0.0,0.0,0.0,,0.0,0.0,0.0,0.0,0.0,0.0,0.0,0.0,0.0,Matches,536,eng ENG,DF,28,1,1.0,1.0,0.0,0.0,0,,0,1,1.0,0,0.0,0.0,0.0,0.0,0.0,0.97,0.0,0.0,0.0,-1.89,-1.28,Matches,426.0,eng ENG,DF,28.0,0.0,1.0,0.0,0.0,0.0,1.0,0.0,1.0,0.0,0.0,,0.0,,1.0,1.0,1.0,0.0,0.0,0.0,0.0,0.0,1.0,1.0,Matches,426.0,eng ENG,DF,28.0,0.0,0.0,0.0,0.0,,0.0,0.0,,,,0.0,0.0,0.0,0.0,0.0,,0.0,0.0,Matches,426.0,eng ENG,DF,28.0,1.0,0.0,1.0,0.0,0.0,0.0,0.0,0.0,0.0,0.0,0.0,0.0,0.0,0.0,0.0,0.0,0.0,0.0,1.0,0.0,0.0,0.0,0.0,0.0,0.0,0.0,0.0,0.0,0.0,Matches,Nathan Redmond,M/AM/S RLC,28,134,145,"England,Jamaica,Republic of Ireland",Beşiktaş A.Ş.,7,13,14,12,13,8,5,13,3,7,12,6,8,14,12,13,13,11,13,12,13,15,14,4,13,11,13,14,14,13,15,6,14,15,13,9,14,7,12,5,9,1,1,2,1,4,3,3,2,2,3,1,8,13,5,15,12,13,15,14,1,1,1,1,1,1,1,18,1,14,20,18,17,18,173,75,8,20,5983867,6800,6700,5700,Mixed_Race,124,12,1994/3/6,1,0,48076.0,,28053447
296,Chris Richards,Crystal Palace,2000,430.0,us USA,DF,22.0,5.0,9.0,6.0,8.0,1.0,0.0,5.0,7.0,71.4,2.0,10.0,1.0,9.0,8.0,17.0,31.0,0.0,Matches,430.0,us USA,DF,22.0,5.0,2.0,0.4,1.0,0.0,0.0,1.0,0.0,0.0,0.0,0.0,0.0,0.0,0.0,0.0,0.0,0.0,Matches,,,,,,,,,,,,,,,,,,,,,,,,,,,,,,,,,,,,,,,,,,,,,,,,,,,,,,,,430.0,us USA,DF,22.0,5.0,0.0,0.0,0.0,2.0,1.0,1.0,0.0,8.0,6.0,0.0,0.0,0.0,15.0,14.0,4.0,77.8,Matches,430.0,us USA,DF,22.0,5.0,203.0,190.0,13.0,5.0,0.0,0.0,0.0,8.0,0.0,0.0,0.0,0.0,169.0,0.0,1.0,Matches,430.0,us USA,DF,22.0,5.0,169.0,203.0,83.3,3129.0,991.0,66.0,79.0,83.5,84.0,96.0,87.5,19.0,27.0,70.4,0.0,0.3,0.0,-0.3,1.0,15.0,0.0,0.0,14.0,Matches,541,us USA,DF,22,9,447.0,50.0,13.1,5.0,4,90.0,4,5,17.0,18,0.78,2.0,11.0,-9.0,-1.81,-1.81,3.6,10.7,-7.1,-1.44,-1.39,Matches,430.0,us USA,DF,22.0,5.0,274.0,47.0,131.0,119.0,24.0,7.0,274.0,0.0,0.0,,0.0,,120.0,550.0,269.0,4.0,1.0,0.0,3.0,2.0,149.0,3.0,Matches,430.0,us USA,DF,22.0,5.0,0.0,4.0,0.0,0.0,0.81,0.0,0.0,,9.1,0.0,0.0,0.0,0.7,0.7,0.18,-0.7,-0.7,Matches,430.0,us USA,DF,22.0,9.0,4.0,447.0,5.0,0.0,0.0,0.0,0.0,0.0,0.0,0.0,0.0,0.7,0.7,0.3,1.0,4.0,14.0,3.0,0.0,0.0,0.0,0.0,0.0,0.14,0.05,0.2,0.14,0.2,Matches,Chris Richards,D RC,22,132,150,United States,Crystal Palace,3,11,11,6,12,4,15,6,6,13,13,6,14,12,11,12,15,12,13,11,12,15,11,6,11,13,14,13,13,12,13,16,13,15,13,13,14,6,13,8,14,2,4,1,2,1,2,2,3,2,3,4,19,14,2,10,14,14,12,12,1,14,20,17,12,14,1,1,1,1,1,1,1,1,188,78,15,20,20878512,6600,6250,5600,African_Caribbean,132,13,2000/3/28,8,0,57996.0,,72051563
297,Jaïro Riedewald,Crystal Palace,1996,432.0,nl NED,DFMF,25.0,0.7,2.0,1.0,2.0,0.0,0.0,0.0,1.0,0.0,1.0,2.0,0.0,2.0,0.0,2.0,4.0,0.0,Matches,432.0,nl NED,DFMF,25.0,0.7,0.0,0.0,0.0,0.0,0.0,0.0,0.0,0.0,0.0,0.0,0.0,0.0,0.0,0.0,0.0,0.0,Matches,,,,,,,,,,,,,,,,,,,,,,,,,,,,,,,,,,,,,,,,,,,,,,,,,,,,,,,,432.0,nl NED,DFMF,25.0,0.7,0.0,0.0,0.0,2.0,1.0,0.0,0.0,0.0,1.0,0.0,0.0,0.0,8.0,2.0,1.0,66.7,Matches,432.0,nl NED,DFMF,25.0,0.7,45.0,38.0,7.0,2.0,0.0,0.0,0.0,4.0,1.0,0.0,0.0,0.0,34.0,0.0,2.0,Matches,432.0,nl NED,DFMF,25.0,0.7,34.0,45.0,75.6,467.0,137.0,21.0,24.0,87.5,13.0,17.0,76.5,0.0,2.0,0.0,0.0,0.0,0.0,0.0,0.0,2.0,0.0,0.0,1.0,Matches,543,nl NED,DFMF,25,6,64.0,11.0,1.9,0.7,0,,0,6,11.0,24,1.83,0.0,0.0,0.0,0.0,0.24,0.5,0.9,-0.4,-0.57,-0.34,Matches,432.0,nl NED,DFMF,25.0,0.7,54.0,6.0,19.0,23.0,14.0,1.0,54.0,0.0,0.0,,0.0,,23.0,111.0,69.0,1.0,1.0,0.0,0.0,0.0,28.0,1.0,Matches,432.0,nl NED,DFMF,25.0,0.7,0.0,1.0,0.0,0.0,1.41,0.0,0.0,,14.7,0.0,0.0,0.0,0.1,0.1,0.07,-0.1,-0.1,Matches,432.0,nl NED,DFMF,25.0,6.0,0.0,64.0,0.7,0.0,0.0,0.0,0.0,0.0,0.0,0.0,0.0,0.1,0.1,0.0,0.1,1.0,1.0,1.0,0.0,0.0,0.0,0.0,0.0,0.1,0.0,0.1,0.1,0.1,Matches,Jaïro Riedewald,DM/M LC,25,121,149,"Holland,Suriname,Indonesia",Crystal Palace,8,9,11,7,13,8,10,6,8,13,13,8,13,11,8,13,10,12,12,13,12,9,10,8,10,12,12,11,12,14,13,11,13,14,13,15,10,6,11,5,15,1,2,2,2,1,3,3,2,3,2,1,13,14,5,7,11,13,10,9,1,15,13,1,12,1,20,6,18,1,1,1,1,1,182,82,20,11,2844447,6048,6048,5348,African_Caribbean,118,13,1996/9/9,3,0,52196.0,,37041918
298,Matt Ritchie,Newcastle Utd,1989,433.0,sct SCO,FWMF,32.0,0.4,1.0,1.0,0.0,1.0,0.0,1.0,3.0,33.3,2.0,0.0,0.0,0.0,1.0,2.0,0.0,0.0,Matches,433.0,sct SCO,FWMF,32.0,0.4,1.0,2.31,1.0,0.0,0.0,0.0,0.0,0.0,0.0,0.0,0.0,0.0,0.0,0.0,0.0,0.0,Matches,,,,,,,,,,,,,,,,,,,,,,,,,,,,,,,,,,,,,,,,,,,,,,,,,,,,,,,,433.0,sct SCO,FWMF,32.0,0.4,0.0,0.0,0.0,0.0,0.0,0.0,2.0,1.0,1.0,0.0,0.0,0.0,3.0,1.0,0.0,100.0,Matches,433.0,sct SCO,FWMF,32.0,0.4,31.0,31.0,0.0,0.0,0.0,0.0,2.0,0.0,0.0,0.0,0.0,0.0,24.0,0.0,3.0,Matches,433.0,sct SCO,FWMF,32.0,0.4,24.0,31.0,77.4,342.0,88.0,16.0,16.0,100.0,4.0,6.0,66.7,3.0,4.0,75.0,0.0,0.1,0.0,-0.1,1.0,0.0,0.0,0.0,1.0,Matches,544,sct SCO,FWMF,32,7,39.0,6.0,1.1,0.4,0,,0,7,6.0,18,2.29,1.0,0.0,1.0,2.31,1.4,1.9,0.7,1.2,2.78,1.95,Matches,433.0,sct SCO,FWMF,32.0,0.4,35.0,1.0,8.0,12.0,16.0,1.0,35.0,1.0,1.0,100.0,0.0,0.0,23.0,101.0,48.0,1.0,3.0,0.0,1.0,0.0,27.0,9.0,Matches,433.0,sct SCO,FWMF,32.0,0.4,0.0,0.0,0.0,,0.0,0.0,,,,0.0,0.0,0.0,0.0,0.0,,0.0,0.0,Matches,433.0,sct SCO,FWMF,32.0,7.0,0.0,39.0,0.4,0.0,0.0,0.0,0.0,0.0,0.0,0.0,0.0,0.0,0.0,0.1,0.1,1.0,1.0,9.0,0.0,0.0,0.0,0.0,0.0,0.0,0.24,0.24,0.0,0.24,Matches,Matt Ritchie,WB/M/AM RL,32,125,141,"Scotland,England",Newcastle United,12,15,11,13,12,13,8,12,5,10,13,15,12,12,15,11,15,12,12,12,12,14,10,15,11,12,15,18,11,11,13,6,16,11,13,11,14,11,14,7,15,2,1,3,2,1,2,1,1,1,4,4,13,13,5,13,10,12,11,10,1,13,1,1,17,1,1,20,1,18,17,13,16,1,172,76,20,8,1667574,6250,6250,5000,Northern_European,117,4,1989/9/10,16,3,52196.0,,151741
299,Joel Robles,Leeds United,1990,436.0,es ESP,GK,32.0,4.0,0.0,0.0,0.0,0.0,0.0,0.0,1.0,0.0,1.0,0.0,0.0,0.0,0.0,0.0,2.0,1.0,Matches,436.0,es ESP,GK,32.0,4.0,0.0,0.0,0.0,0.0,0.0,0.0,0.0,0.0,0.0,0.0,0.0,0.0,0.0,0.0,0.0,0.0,Matches,32.0,es ESP,GK,32.0,4.0,11.0,2.0,0.0,0.0,0.0,10.5,0.32,-0.5,-0.12,18.0,71.0,25.4,90.0,20.0,52.2,41.1,32.0,75.0,49.4,43.0,2.0,4.7,3.0,0.75,11.6,Matches,32.0,es ESP,GK,32.0,4.0,4.0,360.0,4.0,11.0,2.75,27.0,16.0,66.7,0.0,1.0,3.0,0.0,0.0,3.0,2.0,0.0,1.0,0.0,Matches,436.0,es ESP,GK,32.0,4.0,1.0,0.0,0.0,0.0,0.0,0.0,0.0,0.0,0.0,0.0,0.0,0.0,2.0,3.0,0.0,100.0,Matches,436.0,es ESP,GK,32.0,4.0,122.0,70.0,52.0,20.0,0.0,0.0,0.0,0.0,0.0,0.0,0.0,0.0,63.0,0.0,0.0,Matches,436.0,es ESP,GK,32.0,4.0,63.0,122.0,51.6,2048.0,1611.0,6.0,6.0,100.0,26.0,27.0,96.3,31.0,89.0,34.8,0.0,0.0,0.0,0.0,0.0,2.0,0.0,0.0,0.0,Matches,549,es ESP,GK,32,4,360.0,90.0,10.5,4.0,4,90.0,4,0,,23,0.25,5.0,11.0,-6.0,-1.5,-0.79,4.6,9.2,-4.6,-1.15,-0.7,Matches,436.0,es ESP,GK,32.0,4.0,136.0,101.0,129.0,8.0,0.0,0.0,136.0,0.0,0.0,,0.0,,57.0,337.0,251.0,0.0,0.0,0.0,0.0,0.0,44.0,0.0,Matches,436.0,es ESP,GK,32.0,4.0,0.0,0.0,0.0,,0.0,0.0,,,,0.0,0.0,0.0,0.0,0.0,,0.0,0.0,Matches,436.0,es ESP,GK,32.0,4.0,4.0,360.0,4.0,0.0,0.0,0.0,0.0,0.0,0.0,1.0,0.0,0.0,0.0,0.0,0.0,0.0,0.0,0.0,0.0,0.0,0.0,0.0,0.0,0.0,0.0,0.0,0.0,0.0,Matches,Joel Robles,GK,32,124,135,Spain,Leeds United,4,3,2,3,9,9,9,1,1,2,10,3,3,10,5,9,10,9,10,12,9,12,2,10,10,11,10,7,10,13,15,14,10,8,10,14,12,2,12,2,12,16,16,12,8,15,15,15,15,12,11,14,12,11,9,13,11,14,15,15,20,1,1,1,1,1,1,1,1,1,1,1,1,1,197,95,10,20,3844209,6550,6550,5000,Mediterranean_Hispanic,123,6,1990/6/17,0,0,45622.0,,67037306
300,Marek Rodák,Fulham,1996,438.0,sk SVK,GK,25.0,2.0,0.0,0.0,0.0,0.0,0.0,0.0,0.0,,0.0,0.0,0.0,0.0,0.0,0.0,1.0,1.0,Matches,438.0,sk SVK,GK,25.0,2.0,0.0,0.0,0.0,0.0,0.0,0.0,0.0,0.0,0.0,0.0,0.0,0.0,0.0,0.0,0.0,0.0,Matches,33.0,sk SVK,GK,25.0,2.0,2.0,0.0,0.0,0.0,0.0,2.0,0.51,0.0,0.01,16.0,47.0,34.0,46.0,3.0,73.9,46.0,15.0,86.7,60.0,26.0,1.0,3.8,2.0,1.0,14.0,Matches,33.0,sk SVK,GK,25.0,2.0,2.0,180.0,2.0,2.0,1.0,4.0,2.0,50.0,0.0,2.0,0.0,1.0,50.0,0.0,0.0,0.0,0.0,,Matches,438.0,sk SVK,GK,25.0,2.0,0.0,0.0,0.0,0.0,0.0,0.0,0.0,0.0,0.0,0.0,0.0,0.0,3.0,1.0,0.0,100.0,Matches,438.0,sk SVK,GK,25.0,2.0,61.0,38.0,23.0,8.0,0.0,0.0,0.0,0.0,0.0,0.0,0.0,0.0,29.0,0.0,0.0,Matches,438.0,sk SVK,GK,25.0,2.0,29.0,61.0,47.5,1170.0,1037.0,3.0,3.0,100.0,8.0,9.0,88.9,17.0,48.0,35.4,0.0,0.0,0.0,0.0,0.0,0.0,0.0,0.0,0.0,Matches,551,sk SVK,GK,25,2,180.0,90.0,5.3,2.0,2,90.0,2,0,,36,1.0,2.0,2.0,0.0,0.0,-0.06,2.7,2.1,0.6,0.3,0.8,Matches,438.0,sk SVK,GK,25.0,2.0,65.0,58.0,65.0,0.0,0.0,0.0,65.0,0.0,0.0,,0.0,,36.0,206.0,94.0,0.0,0.0,0.0,1.0,0.0,21.0,0.0,Matches,438.0,sk SVK,GK,25.0,2.0,0.0,0.0,0.0,,0.0,0.0,,,,0.0,0.0,0.0,0.0,0.0,,0.0,0.0,Matches,438.0,sk SVK,GK,25.0,2.0,2.0,180.0,2.0,0.0,0.0,0.0,0.0,0.0,0.0,0.0,0.0,0.0,0.0,0.0,0.0,0.0,0.0,0.0,0.0,0.0,0.0,0.0,0.0,0.0,0.0,0.0,0.0,0.0,Matches,Marek Rodák,GK,25,126,145,Slovakia,Fulham,2,1,2,1,10,6,2,3,3,3,12,3,1,10,11,12,14,11,10,5,13,13,1,7,2,14,12,13,8,15,14,15,14,8,9,12,12,5,13,5,2,13,13,14,8,13,13,14,15,13,17,13,12,12,1,9,11,13,13,14,20,1,1,1,1,1,1,1,1,1,1,1,1,1,195,85,6,20,4194632,6288,6288,4838,Northern_European,125,5,1996/12/13,17,0,17399.0,,28090964
301,Oriol Romeu,Southampton,1991,443.0,es ESP,MF,30.0,0.8,1.0,0.0,0.0,1.0,0.0,0.0,0.0,,0.0,1.0,0.0,1.0,1.0,2.0,1.0,0.0,Matches,443.0,es ESP,MF,30.0,0.8,3.0,3.65,2.0,0.0,0.0,0.0,1.0,0.0,0.0,0.0,0.0,0.0,0.0,0.0,0.0,0.0,Matches,,,,,,,,,,,,,,,,,,,,,,,,,,,,,,,,,,,,,,,,,,,,,,,,,,,,,,,,443.0,es ESP,MF,30.0,0.8,0.0,0.0,0.0,1.0,2.0,0.0,1.0,1.0,0.0,0.0,0.0,0.0,8.0,2.0,0.0,100.0,Matches,443.0,es ESP,MF,30.0,0.8,30.0,30.0,0.0,0.0,0.0,0.0,1.0,0.0,0.0,0.0,0.0,0.0,28.0,0.0,0.0,Matches,443.0,es ESP,MF,30.0,0.8,28.0,30.0,93.3,453.0,79.0,10.0,11.0,90.9,15.0,16.0,93.8,2.0,2.0,100.0,0.0,0.0,0.2,0.0,0.0,0.0,2.0,0.0,4.0,Matches,557,es ESP,MF,30,1,74.0,74.0,2.2,0.8,1,74.0,0,0,,3,0.0,1.0,4.0,-3.0,-3.65,-2.73,0.3,1.4,-1.1,-1.31,-0.72,Matches,443.0,es ESP,MF,30.0,0.8,37.0,2.0,5.0,19.0,14.0,1.0,37.0,1.0,1.0,100.0,0.0,0.0,18.0,128.0,66.0,2.0,1.0,0.0,1.0,0.0,20.0,0.0,Matches,443.0,es ESP,MF,30.0,0.8,0.0,0.0,0.0,,0.0,0.0,,,,0.0,0.0,0.0,0.0,0.0,,0.0,0.0,Matches,443.0,es ESP,MF,30.0,1.0,1.0,74.0,0.8,0.0,0.0,0.0,0.0,0.0,0.0,0.0,0.0,0.0,0.0,0.0,0.0,2.0,4.0,0.0,0.0,0.0,0.0,0.0,0.0,0.0,0.0,0.0,0.0,0.0,Matches,Oriol Romeu,DM/M C,30,142,145,Spain,Girona,7,8,9,9,14,6,12,9,10,14,14,8,17,14,15,16,17,16,15,14,16,12,6,13,7,16,18,17,7,10,13,12,18,7,18,16,16,8,12,11,12,1,3,3,3,3,3,3,2,1,3,1,13,16,8,10,13,14,10,12,1,1,14,8,1,8,20,1,20,1,1,1,1,1,182,79,9,20,12052989,7100,6400,5650,Mediterranean_Hispanic,142,7,1991/9/24,0,0,52196.0,,67043255
302,Cristiano Ronaldo,Manchester Utd,1985,444.0,pt POR,FW,37.0,5.8,2.0,2.0,1.0,0.0,1.0,1.0,2.0,50.0,1.0,0.0,0.0,0.0,1.0,3.0,9.0,0.0,Matches,444.0,pt POR,FW,37.0,5.8,10.0,1.71,9.0,0.0,0.0,0.0,1.0,0.0,0.0,0.0,0.0,0.0,0.0,0.0,0.0,0.0,Matches,,,,,,,,,,,,,,,,,,,,,,,,,,,,,,,,,,,,,,,,,,,,,,,,,,,,,,,,444.0,pt POR,FW,37.0,5.8,2.0,0.0,0.0,7.0,5.0,8.0,3.0,1.0,2.0,0.0,0.0,0.0,12.0,15.0,8.0,65.2,Matches,444.0,pt POR,FW,37.0,5.8,162.0,157.0,5.0,0.0,2.0,1.0,3.0,1.0,0.0,0.0,0.0,0.0,121.0,0.0,10.0,Matches,444.0,pt POR,FW,37.0,5.8,121.0,162.0,74.7,1412.0,258.0,85.0,97.0,87.6,27.0,39.0,69.2,1.0,5.0,20.0,0.0,0.4,0.2,-0.4,6.0,7.0,1.0,0.0,12.0,Matches,558,pt POR,FW,37,10,525.0,53.0,15.4,5.8,4,85.0,3,6,31.0,2,1.9,6.0,8.0,-2.0,-0.34,-0.87,6.0,5.8,0.2,0.03,-0.5,Matches,444.0,pt POR,FW,37.0,5.8,220.0,8.0,25.0,91.0,106.0,32.0,220.0,9.0,4.0,44.4,3.0,33.3,94.0,477.0,288.0,9.0,6.0,3.0,7.0,3.0,167.0,33.0,Matches,444.0,pt POR,FW,37.0,5.8,1.0,25.0,6.0,24.0,4.29,1.03,0.04,0.17,17.7,1.0,0.0,0.0,1.9,1.9,0.08,-0.9,-0.9,Matches,444.0,pt POR,FW,37.0,10.0,4.0,525.0,5.8,1.0,0.0,1.0,1.0,0.0,0.0,2.0,0.0,1.9,1.9,0.4,2.3,9.0,12.0,33.0,0.17,0.0,0.17,0.17,0.17,0.32,0.07,0.4,0.32,0.4,Matches,Cristiano Ronaldo,S,37,158,196,Portugal,Manchester UFC,10,11,11,19,15,10,19,15,5,3,13,19,2,15,6,18,12,15,14,11,12,20,17,18,17,2,5,7,12,10,13,17,16,13,13,15,13,12,16,8,9,3,3,1,1,2,2,1,3,4,2,3,19,20,14,13,19,20,7,7,1,1,1,1,1,1,1,1,1,1,13,10,12,20,187,84,15,20,17282189,8000,8912,7538,Mediterranean_Hispanic,155,6,1985/2/5,189,117,556760.0,,735216
303,Salomón Rondón,Everton,1989,446.0,ve VEN,FW,32.0,1.2,0.0,0.0,0.0,0.0,0.0,0.0,0.0,,0.0,1.0,1.0,0.0,0.0,0.0,0.0,0.0,Matches,446.0,ve VEN,FW,32.0,1.2,4.0,3.3,4.0,0.0,0.0,0.0,0.0,0.0,0.0,0.0,0.0,0.0,0.0,0.0,0.0,0.0,Matches,,,,,,,,,,,,,,,,,,,,,,,,,,,,,,,,,,,,,,,,,,,,,,,,,,,,,,,,446.0,ve VEN,FW,32.0,1.2,0.0,0.0,0.0,4.0,0.0,2.0,0.0,0.0,0.0,0.0,0.0,0.0,1.0,7.0,6.0,53.8,Matches,446.0,ve VEN,FW,32.0,1.2,29.0,28.0,1.0,0.0,0.0,0.0,0.0,1.0,0.0,0.0,0.0,0.0,22.0,0.0,0.0,Matches,446.0,ve VEN,FW,32.0,1.2,22.0,29.0,75.9,203.0,35.0,15.0,21.0,71.4,3.0,3.0,100.0,0.0,0.0,,0.0,0.2,0.1,-0.2,2.0,2.0,1.0,0.0,1.0,Matches,560,ve VEN,FW,32,7,109.0,16.0,3.2,1.2,1,56.0,0,6,9.0,3,1.14,1.0,2.0,-1.0,-0.83,-0.23,1.8,2.8,-1.0,-0.81,-0.28,Matches,446.0,ve VEN,FW,32.0,1.2,36.0,1.0,2.0,15.0,19.0,4.0,36.0,1.0,1.0,100.0,0.0,0.0,16.0,33.0,3.0,0.0,1.0,0.0,1.0,1.0,32.0,7.0,Matches,446.0,ve VEN,FW,32.0,1.2,0.0,4.0,1.0,25.0,3.3,0.83,0.0,0.0,19.3,0.0,0.0,0.0,0.8,0.8,0.2,-0.8,-0.8,Matches,446.0,ve VEN,FW,32.0,7.0,1.0,109.0,1.2,0.0,0.0,0.0,0.0,0.0,0.0,0.0,0.0,0.8,0.8,0.2,1.0,0.0,1.0,7.0,0.0,0.0,0.0,0.0,0.0,0.66,0.13,0.79,0.66,0.79,Matches,Salomón Rondón,S,32,126,148,Venezuela,Everton,5,10,10,14,11,11,16,10,5,6,10,11,6,13,14,13,15,13,13,10,13,12,11,11,12,7,14,14,11,12,16,13,15,12,15,18,14,11,12,5,11,3,1,1,2,2,2,1,3,1,1,2,12,16,9,10,11,14,12,10,1,1,1,1,1,1,1,1,1,1,7,7,7,20,186,85,10,20,2355328,6295,6990,5474,African_Caribbean,126,12,1989/9/16,88,35,52196.0,,67063933
304,Georginio Rutter,Leeds United,2002,448.0,fr FRA,FWMF,20.0,3.0,10.0,9.0,5.0,3.0,2.0,5.0,8.0,62.5,3.0,5.0,0.0,5.0,3.0,13.0,3.0,0.0,Matches,448.0,fr FRA,FWMF,20.0,3.0,6.0,1.99,5.0,0.0,0.0,0.0,1.0,0.0,1.0,0.33,1.0,0.0,0.0,0.0,0.0,0.0,Matches,,,,,,,,,,,,,,,,,,,,,,,,,,,,,,,,,,,,,,,,,,,,,,,,,,,,,,,,448.0,fr FRA,FWMF,20.0,3.0,0.0,0.0,0.0,5.0,6.0,1.0,0.0,3.0,9.0,0.0,0.0,0.0,7.0,11.0,9.0,55.0,Matches,448.0,fr FRA,FWMF,20.0,3.0,62.0,59.0,2.0,0.0,1.0,0.0,0.0,0.0,0.0,0.0,0.0,0.0,31.0,1.0,5.0,Matches,448.0,fr FRA,FWMF,20.0,3.0,31.0,62.0,50.0,439.0,97.0,19.0,33.0,57.6,9.0,16.0,56.3,2.0,2.0,100.0,1.0,0.3,0.2,0.7,4.0,1.0,2.0,0.0,6.0,Matches,562,fr FRA,FWMF,20,11,273.0,25.0,8.0,3.0,1,67.0,0,10,21.0,9,0.45,3.0,9.0,-6.0,-1.98,-1.29,2.5,5.6,-3.1,-1.03,-0.56,Matches,448.0,fr FRA,FWMF,20.0,3.0,124.0,4.0,13.0,47.0,65.0,20.0,124.0,25.0,9.0,36.0,13.0,52.0,76.0,351.0,126.0,5.0,1.0,3.0,15.0,14.0,86.0,21.0,Matches,448.0,fr FRA,FWMF,20.0,3.0,0.0,4.0,0.0,0.0,1.32,0.0,0.0,,14.0,0.0,0.0,0.0,0.4,0.4,0.1,-0.4,-0.4,Matches,448.0,fr FRA,FWMF,20.0,11.0,1.0,273.0,3.0,0.0,1.0,1.0,0.0,0.0,0.0,0.0,0.0,0.4,0.4,0.3,0.7,5.0,6.0,21.0,0.0,0.33,0.33,0.0,0.33,0.13,0.1,0.22,0.13,0.22,Matches,Georginio Rutter,AM/S R,20,131,160,"France,Martinique",TSG Hoffenheim,8,9,15,12,13,7,12,12,6,6,12,12,6,15,8,11,12,12,10,12,10,11,16,7,12,6,11,11,15,14,11,11,13,15,12,12,11,7,9,7,13,1,3,3,2,3,2,2,4,1,2,2,18,13,7,14,10,12,10,14,1,1,1,1,1,1,1,1,1,1,12,10,17,20,182,77,20,17,26400001,6550,5364,5197,African_Caribbean,128,13,2002/4/20,0,0,16781.0,,49048380
305,Albert Sambi Lokonga,Arsenal,1999,456.0,be BEL,MF,22.0,2.2,1.0,1.0,0.0,0.0,1.0,0.0,2.0,0.0,2.0,1.0,0.0,1.0,5.0,6.0,2.0,0.0,Matches,456.0,be BEL,MF,22.0,2.2,4.0,1.82,3.0,0.0,0.0,0.0,1.0,0.0,0.0,0.0,0.0,0.0,0.0,0.0,0.0,0.0,Matches,,,,,,,,,,,,,,,,,,,,,,,,,,,,,,,,,,,,,,,,,,,,,,,,,,,,,,,,456.0,be BEL,MF,22.0,2.2,0.0,0.0,0.0,1.0,5.0,0.0,0.0,5.0,1.0,0.0,0.0,0.0,14.0,3.0,2.0,60.0,Matches,456.0,be BEL,MF,22.0,2.2,140.0,135.0,5.0,5.0,1.0,1.0,0.0,0.0,0.0,0.0,0.0,0.0,132.0,0.0,1.0,Matches,456.0,be BEL,MF,22.0,2.2,132.0,140.0,94.3,2321.0,539.0,59.0,62.0,95.2,60.0,63.0,95.2,11.0,12.0,91.7,0.0,0.0,0.1,0.0,1.0,17.0,1.0,0.0,12.0,Matches,571,be BEL,MF,22,6,198.0,33.0,5.8,2.2,2,82.0,1,4,9.0,12,2.5,3.0,3.0,0.0,0.0,-1.26,4.0,1.7,2.2,1.01,0.24,Matches,456.0,be BEL,MF,22.0,2.2,154.0,6.0,32.0,95.0,29.0,0.0,154.0,2.0,1.0,50.0,0.0,0.0,96.0,393.0,145.0,0.0,6.0,0.0,1.0,1.0,113.0,2.0,Matches,456.0,be BEL,MF,22.0,2.2,0.0,0.0,0.0,,0.0,0.0,,,,0.0,0.0,0.0,0.0,0.0,,0.0,0.0,Matches,456.0,be BEL,MF,22.0,6.0,2.0,198.0,2.2,0.0,0.0,0.0,0.0,0.0,0.0,0.0,0.0,0.0,0.0,0.0,0.0,0.0,12.0,2.0,0.0,0.0,0.0,0.0,0.0,0.0,0.01,0.01,0.0,0.01,Matches,Albert Sambi Lokonga,DM/M C,22,137,165,"Belgium,Democratic Republic of Congo",Arsenal,10,10,13,8,15,10,10,12,10,11,14,11,13,14,13,14,12,14,14,13,12,15,14,12,13,11,16,15,13,13,11,10,14,14,14,12,12,12,14,14,12,3,1,2,1,3,1,3,3,3,3,1,14,14,6,14,12,14,12,14,1,1,1,1,1,1,19,1,20,1,1,12,1,1,184,0,12,20,42568967,6948,6948,5248,African_Caribbean,136,17,1999/10/22,1,0,57996.0,,18097160
306,Davinson Sánchez,Tottenham,1996,458.0,co COL,DF,26.0,9.5,24.0,11.0,17.0,6.0,1.0,14.0,20.0,70.0,6.0,16.0,10.0,6.0,12.0,36.0,41.0,0.0,Matches,458.0,co COL,DF,26.0,9.5,5.0,0.53,5.0,0.0,0.0,0.0,0.0,0.0,0.0,0.0,0.0,0.0,0.0,0.0,0.0,0.0,Matches,,,,,,,,,,,,,,,,,,,,,,,,,,,,,,,,,,,,,,,,,,,,,,,,,,,,,,,,458.0,co COL,DF,26.0,9.5,1.0,0.0,0.0,7.0,4.0,1.0,2.0,12.0,11.0,0.0,1.0,0.0,45.0,28.0,16.0,63.6,Matches,458.0,co COL,DF,26.0,9.5,594.0,583.0,10.0,7.0,0.0,1.0,2.0,3.0,0.0,0.0,0.0,0.0,515.0,1.0,10.0,Matches,458.0,co COL,DF,26.0,9.5,515.0,594.0,86.7,9178.0,2770.0,187.0,201.0,93.0,297.0,320.0,92.8,24.0,52.0,46.2,0.0,0.4,0.2,-0.4,2.0,35.0,1.0,1.0,35.0,Matches,575,co COL,DF,26,18,858.0,48.0,25.1,9.5,8,81.0,5,10,21.0,20,1.5,18.0,17.0,1.0,0.1,-0.11,14.9,12.6,2.3,0.24,0.06,Matches,458.0,co COL,DF,26.0,9.5,719.0,99.0,364.0,310.0,46.0,10.0,719.0,6.0,2.0,33.3,3.0,50.0,406.0,1607.0,788.0,5.0,2.0,0.0,3.0,2.0,473.0,4.0,Matches,458.0,co COL,DF,26.0,9.5,0.0,6.0,2.0,33.3,0.63,0.21,0.0,0.0,12.2,0.0,0.0,0.0,0.6,0.6,0.1,-0.6,-0.6,Matches,458.0,co COL,DF,26.0,18.0,8.0,858.0,9.5,0.0,0.0,0.0,0.0,0.0,0.0,1.0,0.0,0.6,0.6,0.4,1.0,5.0,35.0,4.0,0.0,0.0,0.0,0.0,0.0,0.07,0.04,0.11,0.07,0.11,Matches,Davinson Sánchez,D C,26,140,150,Colombia,Tottenham Hotspur,7,7,11,10,13,10,13,9,8,13,13,7,15,14,15,12,15,13,11,10,13,14,10,9,10,13,14,14,15,14,13,14,15,15,15,16,13,11,13,8,10,1,4,1,3,1,1,3,2,1,1,3,16,16,12,8,16,14,12,14,1,1,20,11,1,1,12,1,7,1,1,1,1,1,187,83,11,20,28016876,6994,7594,6136,African_Caribbean,140,16,1996/6/12,50,0,75393.0,,76023027
307,Morgan Sanson,Aston Villa,1994,461.0,fr FRA,MF,27.0,0.1,2.0,1.0,1.0,1.0,0.0,1.0,1.0,100.0,0.0,0.0,0.0,0.0,0.0,2.0,0.0,0.0,Matches,461.0,fr FRA,MF,27.0,0.1,0.0,0.0,0.0,0.0,0.0,0.0,0.0,0.0,0.0,0.0,0.0,0.0,0.0,0.0,0.0,0.0,Matches,,,,,,,,,,,,,,,,,,,,,,,,,,,,,,,,,,,,,,,,,,,,,,,,,,,,,,,,461.0,fr FRA,MF,27.0,0.1,0.0,0.0,0.0,0.0,2.0,0.0,0.0,0.0,1.0,0.0,0.0,0.0,1.0,0.0,1.0,0.0,Matches,461.0,fr FRA,MF,27.0,0.1,7.0,7.0,0.0,0.0,0.0,0.0,0.0,0.0,0.0,0.0,0.0,0.0,5.0,0.0,0.0,Matches,461.0,fr FRA,MF,27.0,0.1,5.0,7.0,71.4,55.0,12.0,3.0,4.0,75.0,1.0,2.0,50.0,0.0,0.0,,0.0,0.0,0.0,0.0,0.0,0.0,0.0,0.0,1.0,Matches,578,fr FRA,MF,27,2,11.0,6.0,0.3,0.1,0,,0,2,6.0,11,3.0,0.0,1.0,-1.0,-8.18,-8.34,0.0,0.4,-0.4,-3.44,-3.39,Matches,461.0,fr FRA,MF,27.0,0.1,9.0,1.0,1.0,4.0,4.0,0.0,9.0,0.0,0.0,,0.0,,5.0,11.0,9.0,0.0,0.0,0.0,1.0,0.0,5.0,0.0,Matches,461.0,fr FRA,MF,27.0,0.1,0.0,0.0,0.0,,0.0,0.0,,,,0.0,0.0,0.0,0.0,0.0,,0.0,0.0,Matches,461.0,fr FRA,MF,27.0,2.0,0.0,11.0,0.1,0.0,0.0,0.0,0.0,0.0,0.0,0.0,0.0,0.0,0.0,0.0,0.0,0.0,1.0,0.0,0.0,0.0,0.0,0.0,0.0,0.0,0.0,0.0,0.0,0.0,Matches,Morgan Sanson,M/AM C,27,136,145,France,Aston Villa,12,13,14,11,15,13,8,13,5,8,15,10,11,14,13,14,12,14,12,15,13,14,14,10,13,10,16,15,14,14,15,8,14,14,14,12,10,8,11,14,11,1,3,1,2,2,2,3,3,2,2,2,7,15,9,16,14,15,14,15,1,1,1,1,1,1,13,13,20,13,13,17,13,1,180,73,8,20,21278174,6799,6949,5499,Northern_European,137,6,1994/8/18,0,0,69595.0,,85046988
308,Pablo Sarabia,Wolves,1992,462.0,es ESP,FWMF,30.0,8.5,12.0,6.0,4.0,5.0,3.0,6.0,15.0,40.0,9.0,7.0,0.0,7.0,2.0,14.0,4.0,0.0,Matches,462.0,es ESP,FWMF,30.0,8.5,31.0,3.65,21.0,5.0,0.0,5.0,0.0,0.0,0.0,0.0,0.0,0.0,0.0,0.0,0.0,0.0,Matches,,,,,,,,,,,,,,,,,,,,,,,,,,,,,,,,,,,,,,,,,,,,,,,,,,,,,,,,462.0,es ESP,FWMF,30.0,8.5,3.0,0.0,0.0,13.0,8.0,3.0,46.0,2.0,6.0,0.0,0.0,0.0,42.0,3.0,13.0,18.8,Matches,462.0,es ESP,FWMF,30.0,8.5,365.0,324.0,39.0,8.0,2.0,3.0,46.0,3.0,28.0,18.0,5.0,0.0,252.0,2.0,15.0,Matches,462.0,es ESP,FWMF,30.0,8.5,252.0,365.0,69.0,3772.0,1260.0,151.0,176.0,85.8,66.0,92.0,71.7,22.0,59.0,37.3,0.0,0.8,0.8,-0.8,11.0,26.0,15.0,4.0,41.0,Matches,580,es ESP,FWMF,30,13,765.0,59.0,22.4,8.5,9,68.0,2,4,38.0,5,1.38,11.0,9.0,2.0,0.24,1.22,9.9,13.3,-3.4,-0.4,0.27,Matches,462.0,es ESP,FWMF,30.0,8.5,450.0,9.0,68.0,189.0,199.0,22.0,450.0,12.0,2.0,16.7,9.0,75.0,267.0,1195.0,522.0,17.0,15.0,4.0,9.0,14.0,312.0,54.0,Matches,462.0,es ESP,FWMF,30.0,8.5,1.0,20.0,5.0,25.0,2.35,0.59,0.05,0.2,14.8,1.0,0.0,0.0,3.1,3.1,0.15,-2.1,-2.1,Matches,462.0,es ESP,FWMF,30.0,13.0,9.0,765.0,8.5,1.0,0.0,1.0,1.0,0.0,0.0,3.0,0.0,3.1,3.1,0.8,3.9,17.0,41.0,54.0,0.12,0.0,0.12,0.12,0.12,0.36,0.09,0.46,0.36,0.46,Matches,Pablo Sarabia,AM RLC,30,154,156,Spain,Paris Saint-Germain,15,15,15,15,17,15,7,13,5,7,15,13,6,17,10,13,11,13,13,16,14,9,15,8,15,8,15,14,15,16,15,6,12,14,13,10,14,9,15,10,15,2,1,1,1,2,1,2,2,3,4,1,7,12,10,10,12,14,14,10,1,1,1,1,10,1,1,15,13,15,17,20,19,1,174,70,20,10,36552285,7700,7450,6750,Mediterranean_Hispanic,151,4,1992/5/11,22,9,103561.0,,67045428
309,Jeremy Sarmiento,Brighton,2002,463.0,ec ECU,MF,20.0,2.0,6.0,3.0,4.0,1.0,1.0,2.0,5.0,40.0,3.0,2.0,0.0,2.0,1.0,7.0,0.0,0.0,Matches,463.0,ec ECU,MF,20.0,2.0,10.0,5.11,6.0,0.0,1.0,2.0,1.0,0.0,2.0,1.02,2.0,0.0,0.0,0.0,0.0,0.0,Matches,,,,,,,,,,,,,,,,,,,,,,,,,,,,,,,,,,,,,,,,,,,,,,,,,,,,,,,,463.0,ec ECU,MF,20.0,2.0,1.0,0.0,0.0,4.0,4.0,0.0,3.0,1.0,3.0,0.0,0.0,0.0,4.0,0.0,4.0,0.0,Matches,463.0,ec ECU,MF,20.0,2.0,67.0,67.0,0.0,0.0,0.0,0.0,3.0,0.0,0.0,0.0,0.0,0.0,53.0,0.0,1.0,Matches,463.0,ec ECU,MF,20.0,2.0,53.0,67.0,79.1,694.0,191.0,32.0,38.0,84.2,16.0,19.0,84.2,1.0,2.0,50.0,1.0,0.2,0.3,0.8,2.0,4.0,5.0,1.0,11.0,Matches,582,ec ECU,MF,20,9,176.0,20.0,5.1,2.0,1,61.0,0,8,14.0,11,2.33,9.0,2.0,7.0,3.58,3.25,3.9,2.5,1.4,0.74,0.14,Matches,463.0,ec ECU,MF,20.0,2.0,100.0,0.0,13.0,39.0,48.0,10.0,100.0,11.0,6.0,54.5,4.0,36.4,69.0,386.0,129.0,5.0,3.0,1.0,6.0,7.0,77.0,20.0,Matches,463.0,ec ECU,MF,20.0,2.0,0.0,5.0,2.0,40.0,2.56,1.02,0.0,0.0,20.5,0.0,0.0,0.0,0.3,0.3,0.07,-0.3,-0.3,Matches,463.0,ec ECU,MF,20.0,9.0,1.0,176.0,2.0,0.0,1.0,1.0,0.0,0.0,0.0,1.0,0.0,0.3,0.3,0.2,0.5,5.0,11.0,20.0,0.0,0.51,0.51,0.0,0.51,0.17,0.11,0.28,0.17,0.28,Matches,Jeremy Sarmiento,AM RL,20,124,-8,"Ecuador,England,Spain",Brighton & Hove Albion,8,11,15,12,13,8,10,12,6,6,10,8,7,14,9,11,9,12,9,9,9,13,14,7,14,7,10,12,15,14,14,10,16,15,13,9,15,10,5,14,20,3,4,1,3,3,1,2,1,3,1,1,14,10,6,4,12,7,13,17,1,1,1,1,1,1,1,14,1,14,20,14,19,1,184,75,10,20,61522016,6199,6199,3249,Mediterranean_Hispanic,119,5,2002/6/16,9,0,13919.0,,83262111
310,Gustavo Scarpa,Nott'ham Forest,1994,465.0,br BRA,MFFW,28.0,2.0,5.0,2.0,3.0,1.0,1.0,2.0,5.0,40.0,3.0,4.0,0.0,4.0,0.0,5.0,3.0,0.0,Matches,465.0,br BRA,MFFW,28.0,2.0,10.0,4.97,3.0,1.0,1.0,1.0,3.0,1.0,0.0,0.0,0.0,0.0,0.0,0.0,0.0,0.0,Matches,,,,,,,,,,,,,,,,,,,,,,,,,,,,,,,,,,,,,,,,,,,,,,,,,,,,,,,,465.0,br BRA,MFFW,28.0,2.0,1.0,0.0,0.0,4.0,8.0,0.0,4.0,0.0,2.0,0.0,0.0,0.0,12.0,1.0,2.0,33.3,Matches,465.0,br BRA,MFFW,28.0,2.0,78.0,72.0,6.0,0.0,1.0,2.0,4.0,3.0,2.0,0.0,1.0,0.0,51.0,0.0,5.0,Matches,465.0,br BRA,MFFW,28.0,2.0,51.0,78.0,65.4,1112.0,454.0,16.0,19.0,84.2,26.0,31.0,83.9,8.0,18.0,44.4,0.0,0.0,0.0,0.0,1.0,10.0,0.0,0.0,12.0,Matches,585,br BRA,MFFW,28,6,181.0,30.0,5.3,2.0,2,55.0,0,4,18.0,3,1.17,1.0,1.0,0.0,0.0,0.83,2.4,2.8,-0.4,-0.2,0.48,Matches,465.0,br BRA,MFFW,28.0,2.0,108.0,3.0,24.0,58.0,27.0,1.0,108.0,4.0,1.0,25.0,2.0,50.0,67.0,515.0,313.0,9.0,5.0,0.0,1.0,0.0,71.0,4.0,Matches,465.0,br BRA,MFFW,28.0,2.0,0.0,7.0,1.0,14.3,3.48,0.5,0.0,0.0,26.9,0.0,0.0,0.0,0.3,0.3,0.04,-0.3,-0.3,Matches,465.0,br BRA,MFFW,28.0,6.0,2.0,181.0,2.0,0.0,0.0,0.0,0.0,0.0,0.0,1.0,0.0,0.3,0.3,0.0,0.3,9.0,12.0,4.0,0.0,0.0,0.0,0.0,0.0,0.13,0.02,0.14,0.13,0.14,Matches,Gustavo Scarpa,AM RLC,28,137,144,"Brazil,Italy",SEP,16,15,15,13,16,14,9,15,6,8,17,15,7,16,12,15,8,12,10,16,13,9,16,8,14,9,12,11,12,15,14,8,12,12,12,9,10,11,12,8,15,2,3,3,3,1,3,2,1,2,1,3,20,13,12,10,11,9,10,10,1,12,1,1,13,1,5,13,13,9,18,20,16,5,176,74,20,10,6649695,6836,6836,4260,Mixed_Race,136,10,1994/1/5,1,0,31288.0,,19139020
311,Antoine Semenyo,Bournemouth,2000,470.0,gh GHA,FWMF,22.0,2.9,1.0,0.0,0.0,0.0,1.0,1.0,6.0,16.7,5.0,10.0,1.0,9.0,2.0,3.0,4.0,0.0,Matches,470.0,gh GHA,FWMF,22.0,2.9,7.0,2.44,3.0,0.0,2.0,1.0,1.0,0.0,0.0,0.0,0.0,0.0,0.0,0.0,0.0,0.0,Matches,,,,,,,,,,,,,,,,,,,,,,,,,,,,,,,,,,,,,,,,,,,,,,,,,,,,,,,,470.0,gh GHA,FWMF,22.0,2.9,0.0,0.0,0.0,6.0,5.0,1.0,1.0,2.0,0.0,0.0,0.0,0.0,13.0,9.0,9.0,50.0,Matches,470.0,gh GHA,FWMF,22.0,2.9,57.0,53.0,4.0,0.0,0.0,1.0,1.0,0.0,0.0,0.0,0.0,0.0,38.0,0.0,2.0,Matches,470.0,gh GHA,FWMF,22.0,2.9,38.0,57.0,66.7,543.0,153.0,24.0,33.0,72.7,11.0,13.0,84.6,2.0,4.0,50.0,0.0,0.1,0.0,-0.1,2.0,5.0,0.0,0.0,5.0,Matches,591,gh GHA,FWMF,22,11,258.0,23.0,7.5,2.9,2,77.0,1,9,12.0,4,1.45,3.0,6.0,-3.0,-1.05,-0.16,3.6,6.8,-3.2,-1.13,-0.5,Matches,470.0,gh GHA,FWMF,22.0,2.9,102.0,8.0,24.0,43.0,39.0,5.0,102.0,6.0,3.0,50.0,2.0,33.3,58.0,508.0,239.0,5.0,9.0,4.0,12.0,6.0,64.0,11.0,Matches,470.0,gh GHA,FWMF,22.0,2.9,1.0,3.0,1.0,33.3,1.05,0.35,0.33,1.0,17.2,0.0,0.0,0.0,0.3,0.3,0.09,0.7,0.7,Matches,470.0,gh GHA,FWMF,22.0,11.0,2.0,258.0,2.9,1.0,0.0,1.0,1.0,0.0,0.0,0.0,0.0,0.3,0.3,0.1,0.4,5.0,5.0,11.0,0.35,0.0,0.35,0.35,0.35,0.09,0.03,0.12,0.09,0.12,Matches,Antoine Semenyo,M/AM/S RL,22,124,145,"Ghana,England,Togo",Bristol City,11,11,13,12,12,11,10,10,6,6,11,8,8,12,12,10,12,11,9,12,10,9,14,8,13,11,11,12,14,14,11,10,9,14,13,12,11,12,8,11,12,1,2,3,2,2,3,4,3,1,3,3,15,12,2,13,10,11,10,10,1,1,1,1,1,1,1,16,1,16,18,1,18,20,178,63,9,20,10216552,6200,6200,3500,African_Caribbean,111,14,2000/1/7,1,0,2900.0,,29194724
312,Ryan Sessegnon,Tottenham,2000,472.0,eng ENG,DF,22.0,9.0,16.0,11.0,9.0,7.0,0.0,6.0,12.0,50.0,6.0,8.0,1.0,7.0,6.0,22.0,17.0,1.0,Matches,472.0,eng ENG,DF,22.0,9.0,23.0,2.55,16.0,0.0,0.0,5.0,1.0,1.0,2.0,0.22,1.0,0.0,0.0,1.0,0.0,0.0,Matches,,,,,,,,,,,,,,,,,,,,,,,,,,,,,,,,,,,,,,,,,,,,,,,,,,,,,,,,472.0,eng ENG,DF,22.0,9.0,4.0,0.0,0.0,15.0,6.0,7.0,30.0,6.0,11.0,0.0,0.0,0.0,49.0,10.0,10.0,50.0,Matches,472.0,eng ENG,DF,22.0,9.0,390.0,318.0,72.0,2.0,2.0,1.0,30.0,70.0,0.0,0.0,0.0,0.0,280.0,0.0,19.0,Matches,472.0,eng ENG,DF,22.0,9.0,280.0,390.0,71.8,4093.0,1075.0,178.0,213.0,83.6,81.0,120.0,67.5,16.0,29.0,55.2,0.0,1.1,1.1,-1.1,6.0,16.0,11.0,3.0,22.0,Matches,593,eng ENG,DF,22,17,813.0,48.0,23.8,9.0,9,75.0,3,8,17.0,4,1.65,17.0,15.0,2.0,0.22,0.05,13.5,10.8,2.7,0.3,0.13,Matches,472.0,eng ENG,DF,22.0,9.0,493.0,29.0,157.0,170.0,168.0,27.0,493.0,11.0,5.0,45.5,4.0,36.4,233.0,1435.0,815.0,24.0,11.0,5.0,11.0,10.0,270.0,64.0,Matches,472.0,eng ENG,DF,22.0,9.0,2.0,18.0,6.0,33.3,1.99,0.66,0.11,0.33,14.6,0.0,0.0,0.0,1.6,1.6,0.09,0.4,0.4,Matches,472.0,eng ENG,DF,22.0,17.0,9.0,813.0,9.0,2.0,0.0,2.0,2.0,0.0,0.0,4.0,0.0,1.6,1.6,1.1,2.7,24.0,22.0,64.0,0.22,0.0,0.22,0.22,0.22,0.18,0.12,0.3,0.18,0.3,Matches,Ryan Sessegnon,D/WB/M/AM L,22,137,151,"England,Ivory Coast",Tottenham Hotspur,7,12,12,12,10,9,7,11,6,12,12,9,12,14,4,13,7,13,12,14,11,12,14,7,15,12,14,15,15,14,13,8,17,15,16,8,12,4,13,2,14,2,1,2,1,2,2,1,1,4,1,2,14,14,8,14,13,12,10,15,1,19,1,1,20,1,1,16,1,1,18,1,10,1,178,71,20,8,42777752,6842,6842,5742,African_Caribbean,127,17,2000/5/18,0,0,63795.0,,29165656
313,Jonjo Shelvey,Newcastle Utd,1992,474.0,eng ENG,MF,30.0,0.4,1.0,0.0,1.0,0.0,0.0,0.0,1.0,0.0,1.0,1.0,0.0,1.0,0.0,1.0,0.0,0.0,Matches,474.0,eng ENG,MF,30.0,0.4,0.0,0.0,0.0,0.0,0.0,0.0,0.0,0.0,0.0,0.0,0.0,0.0,0.0,0.0,0.0,0.0,Matches,,,,,,,,,,,,,,,,,,,,,,,,,,,,,,,,,,,,,,,,,,,,,,,,,,,,,,,,474.0,eng ENG,MF,30.0,0.4,0.0,0.0,0.0,1.0,0.0,0.0,0.0,0.0,0.0,0.0,0.0,0.0,4.0,0.0,0.0,,Matches,474.0,eng ENG,MF,30.0,0.4,26.0,23.0,3.0,2.0,0.0,2.0,0.0,0.0,0.0,0.0,0.0,0.0,19.0,0.0,0.0,Matches,474.0,eng ENG,MF,30.0,0.4,19.0,26.0,73.1,442.0,176.0,5.0,6.0,83.3,8.0,10.0,80.0,4.0,8.0,50.0,0.0,0.0,0.0,0.0,0.0,4.0,0.0,0.0,3.0,Matches,596,eng ENG,MF,30,3,37.0,12.0,1.1,0.4,0,,0,3,12.0,3,3.0,1.0,1.0,0.0,0.0,-0.93,0.5,0.6,-0.1,-0.28,-1.14,Matches,474.0,eng ENG,MF,30.0,0.4,28.0,0.0,8.0,18.0,2.0,0.0,28.0,0.0,0.0,,0.0,,10.0,63.0,19.0,0.0,0.0,0.0,0.0,0.0,17.0,0.0,Matches,474.0,eng ENG,MF,30.0,0.4,0.0,0.0,0.0,,0.0,0.0,,,,0.0,0.0,0.0,0.0,0.0,,0.0,0.0,Matches,474.0,eng ENG,MF,30.0,3.0,0.0,37.0,0.4,0.0,0.0,0.0,0.0,0.0,0.0,0.0,0.0,0.0,0.0,0.0,0.0,0.0,3.0,0.0,0.0,0.0,0.0,0.0,0.0,0.0,0.0,0.0,0.0,0.0,Matches,Jonjo Shelvey,DM C,30,133,145,"England,Republic of Ireland",Newcastle United,12,13,12,11,13,14,8,14,6,9,16,13,12,15,15,13,15,15,13,18,14,11,13,14,13,12,11,13,10,9,12,11,13,12,15,14,12,15,15,13,7,1,3,3,3,2,3,4,2,1,1,1,11,14,15,12,12,12,8,10,1,1,1,1,1,1,20,1,15,1,1,11,1,1,184,80,12,20,18310299,6650,6650,5750,Northern_European,133,6,1992/2/27,6,0,81194.0,,28011776
314,Luis Sinisterra,Leeds United,1999,479.0,co COL,FW,23.0,9.6,21.0,14.0,8.0,9.0,4.0,11.0,18.0,61.1,7.0,11.0,1.0,10.0,8.0,29.0,2.0,0.0,Matches,479.0,co COL,FW,23.0,9.6,33.0,3.43,26.0,0.0,2.0,2.0,2.0,1.0,2.0,0.21,0.0,0.0,1.0,0.0,0.0,1.0,Matches,,,,,,,,,,,,,,,,,,,,,,,,,,,,,,,,,,,,,,,,,,,,,,,,,,,,,,,,479.0,co COL,FW,23.0,9.6,3.0,1.0,1.0,14.0,12.0,5.0,7.0,8.0,14.0,0.0,1.0,0.0,65.0,18.0,18.0,50.0,Matches,479.0,co COL,FW,23.0,9.6,339.0,336.0,3.0,0.0,2.0,4.0,7.0,3.0,0.0,0.0,0.0,0.0,273.0,0.0,9.0,Matches,479.0,co COL,FW,23.0,9.6,273.0,339.0,80.5,3710.0,993.0,161.0,188.0,85.6,72.0,84.0,85.7,14.0,19.0,73.7,0.0,0.4,0.9,-0.4,9.0,18.0,17.0,2.0,39.0,Matches,603,co COL,FW,23,19,867.0,46.0,25.4,9.6,13,58.0,0,6,18.0,1,0.68,10.0,23.0,-13.0,-1.35,-0.75,13.4,15.7,-2.4,-0.25,0.37,Matches,479.0,co COL,FW,23.0,9.6,469.0,7.0,50.0,212.0,215.0,32.0,469.0,42.0,19.0,45.2,17.0,40.5,281.0,1740.0,931.0,30.0,17.0,8.0,16.0,23.0,341.0,84.0,Matches,479.0,co COL,FW,23.0,9.6,5.0,28.0,11.0,39.3,2.91,1.14,0.18,0.45,16.2,0.0,0.0,0.0,3.7,3.7,0.13,1.3,1.3,Matches,479.0,co COL,FW,23.0,19.0,13.0,867.0,9.6,5.0,0.0,5.0,5.0,0.0,0.0,3.0,1.0,3.7,3.7,0.4,4.2,30.0,39.0,84.0,0.52,0.0,0.52,0.52,0.52,0.39,0.04,0.43,0.39,0.43,Matches,Luis Sinisterra,M/AM RL,23,141,152,Colombia,Leeds United,11,13,16,13,14,13,11,13,2,5,11,6,4,14,10,13,11,12,10,10,12,13,17,5,13,5,12,13,16,16,14,10,17,16,12,9,13,5,15,6,13,3,3,3,4,1,2,2,3,3,1,2,15,11,9,14,12,11,10,10,1,1,1,1,1,1,1,19,1,18,20,1,19,13,172,66,11,20,36235818,7050,7050,5750,African_Caribbean,135,17,1999/6/17,7,3,81194.0,,76047347
315,Emile Smith Rowe,Arsenal,2000,482.0,eng ENG,MFFW,22.0,1.9,1.0,1.0,1.0,0.0,0.0,1.0,3.0,33.3,2.0,1.0,0.0,1.0,0.0,1.0,2.0,0.0,Matches,482.0,eng ENG,MFFW,22.0,1.9,9.0,4.68,6.0,1.0,0.0,2.0,0.0,0.0,1.0,0.52,1.0,0.0,0.0,0.0,0.0,0.0,Matches,,,,,,,,,,,,,,,,,,,,,,,,,,,,,,,,,,,,,,,,,,,,,,,,,,,,,,,,482.0,eng ENG,MFFW,22.0,1.9,0.0,0.0,0.0,1.0,1.0,1.0,5.0,0.0,1.0,0.0,0.0,0.0,8.0,0.0,2.0,0.0,Matches,482.0,eng ENG,MFFW,22.0,1.9,85.0,81.0,4.0,0.0,0.0,0.0,5.0,0.0,4.0,2.0,0.0,0.0,74.0,0.0,1.0,Matches,482.0,eng ENG,MFFW,22.0,1.9,74.0,85.0,87.1,1070.0,240.0,44.0,48.0,91.7,24.0,28.0,85.7,5.0,6.0,83.3,2.0,0.7,0.6,1.3,6.0,3.0,4.0,0.0,7.0,Matches,608,eng ENG,MFFW,22,12,172.0,14.0,5.0,1.9,0,,0,12,14.0,11,2.25,3.0,5.0,-2.0,-1.05,-2.35,3.1,2.7,0.4,0.19,-0.63,Matches,482.0,eng ENG,MFFW,22.0,1.9,102.0,1.0,14.0,37.0,51.0,9.0,102.0,5.0,2.0,40.0,3.0,60.0,68.0,303.0,119.0,2.0,1.0,0.0,0.0,4.0,71.0,11.0,Matches,482.0,eng ENG,MFFW,22.0,1.9,0.0,4.0,1.0,25.0,2.09,0.52,0.0,0.0,15.8,0.0,0.0,0.0,0.3,0.3,0.07,-0.3,-0.3,Matches,482.0,eng ENG,MFFW,22.0,12.0,0.0,172.0,1.9,0.0,2.0,2.0,0.0,0.0,0.0,0.0,0.0,0.3,0.3,0.7,1.0,2.0,7.0,11.0,0.0,1.05,1.05,0.0,1.05,0.14,0.36,0.5,0.14,0.5,Matches,Emile Smith Rowe,AM RLC,21,147,168,England,Arsenal,11,12,15,11,14,12,5,13,2,6,15,11,8,15,13,14,11,13,12,15,13,15,15,9,15,8,15,15,16,15,15,8,13,14,14,8,13,6,13,11,15,3,1,4,1,1,1,2,1,1,1,1,13,15,6,15,15,15,15,15,1,1,1,1,1,1,1,14,14,14,19,20,16,8,182,76,12,20,96746387,7350,7350,6250,Northern_European,144,6,2000/7/28,3,1,63795.0,,28109599
316,Manor Solomon,Fulham,1999,486.0,il ISR,FW,23.0,6.4,20.0,12.0,12.0,6.0,2.0,9.0,16.0,56.3,7.0,8.0,0.0,8.0,5.0,25.0,3.0,0.0,Matches,486.0,il ISR,FW,23.0,6.4,11.0,1.73,11.0,0.0,0.0,0.0,0.0,0.0,2.0,0.31,2.0,0.0,0.0,0.0,0.0,0.0,Matches,,,,,,,,,,,,,,,,,,,,,,,,,,,,,,,,,,,,,,,,,,,,,,,,,,,,,,,,486.0,il ISR,FW,23.0,6.4,0.0,0.0,0.0,5.0,4.0,2.0,4.0,5.0,12.0,0.0,0.0,0.0,46.0,3.0,3.0,50.0,Matches,486.0,il ISR,FW,23.0,6.4,207.0,202.0,4.0,1.0,1.0,0.0,4.0,3.0,0.0,0.0,0.0,0.0,175.0,1.0,4.0,Matches,486.0,il ISR,FW,23.0,6.4,175.0,207.0,84.5,2474.0,575.0,104.0,117.0,88.9,57.0,62.0,91.9,7.0,11.0,63.6,0.0,0.4,0.7,-0.4,6.0,5.0,8.0,1.0,24.0,Matches,613,il ISR,FW,23,19,572.0,30.0,16.7,6.4,4,76.0,1,15,18.0,3,1.16,6.0,11.0,-5.0,-0.79,-1.01,5.7,12.0,-6.3,-0.99,-0.63,Matches,486.0,il ISR,FW,23.0,6.4,292.0,9.0,62.0,91.0,147.0,11.0,292.0,37.0,19.0,51.4,15.0,40.5,191.0,1555.0,723.0,16.0,16.0,2.0,13.0,11.0,186.0,51.0,Matches,486.0,il ISR,FW,23.0,6.4,4.0,11.0,7.0,63.6,1.73,1.1,0.36,0.57,19.9,0.0,0.0,0.0,1.3,1.3,0.12,2.7,2.7,Matches,486.0,il ISR,FW,23.0,19.0,4.0,572.0,6.4,4.0,0.0,4.0,4.0,0.0,0.0,0.0,0.0,1.3,1.3,0.4,1.7,16.0,24.0,51.0,0.63,0.0,0.63,0.63,0.63,0.2,0.06,0.26,0.2,0.26,Matches,Manor Solomon,AM RLC,23,135,151,"Israel,Portugal",Shakhtar Donetsk,10,14,17,13,14,14,8,13,10,8,14,2,8,15,7,13,11,15,12,12,13,15,11,11,13,8,11,11,13,13,13,7,13,14,14,13,12,5,12,10,11,2,3,3,4,3,1,2,2,3,3,1,13,13,7,5,10,14,13,10,1,1,1,1,1,1,1,13,1,13,20,15,15,1,167,63,13,20,40484159,7500,7485,6237,North_African__Middle_Eastern,139,8,1999/7/24,31,6,28236.0,Fulham,42077304
317,Çağlar Söyüncü,Leicester City,1996,490.0,tr TUR,DF,26.0,5.9,14.0,9.0,10.0,4.0,0.0,7.0,10.0,70.0,3.0,9.0,8.0,1.0,7.0,21.0,30.0,0.0,Matches,490.0,tr TUR,DF,26.0,5.9,2.0,0.34,2.0,0.0,0.0,0.0,0.0,0.0,0.0,0.0,0.0,0.0,0.0,0.0,0.0,0.0,Matches,,,,,,,,,,,,,,,,,,,,,,,,,,,,,,,,,,,,,,,,,,,,,,,,,,,,,,,,490.0,tr TUR,DF,26.0,5.9,2.0,0.0,0.0,7.0,4.0,0.0,0.0,7.0,9.0,0.0,0.0,0.0,42.0,24.0,16.0,60.0,Matches,490.0,tr TUR,DF,26.0,5.9,309.0,292.0,14.0,12.0,0.0,5.0,0.0,0.0,0.0,0.0,0.0,0.0,241.0,3.0,2.0,Matches,490.0,tr TUR,DF,26.0,5.9,241.0,309.0,78.0,4320.0,1537.0,104.0,115.0,90.4,112.0,136.0,82.4,22.0,48.0,45.8,0.0,0.1,0.0,-0.1,1.0,9.0,0.0,0.0,12.0,Matches,618,tr TUR,DF,26,7,529.0,76.0,15.5,5.9,6,87.0,5,1,8.0,15,1.14,9.0,13.0,-4.0,-0.68,-0.28,13.2,9.9,3.3,0.56,1.06,Matches,490.0,tr TUR,DF,26.0,5.9,382.0,71.0,226.0,147.0,12.0,7.0,382.0,1.0,1.0,100.0,0.0,0.0,185.0,1096.0,601.0,5.0,1.0,0.0,2.0,0.0,203.0,0.0,Matches,490.0,tr TUR,DF,26.0,5.9,1.0,5.0,2.0,40.0,0.85,0.34,0.2,0.5,9.5,0.0,0.0,0.0,0.4,0.4,0.08,0.6,0.6,Matches,490.0,tr TUR,DF,26.0,7.0,6.0,529.0,5.9,1.0,0.0,1.0,1.0,0.0,0.0,2.0,0.0,0.4,0.4,0.1,0.5,5.0,12.0,0.0,0.17,0.0,0.17,0.17,0.17,0.07,0.01,0.08,0.07,0.08,Matches,Çağlar Söyüncü,D C,26,139,162,Turkey,Leicester City,4,7,12,7,12,5,14,8,8,15,10,8,16,10,12,14,17,12,11,13,10,16,9,12,7,14,13,15,14,12,15,16,13,12,13,16,10,13,15,9,7,2,1,3,1,1,1,3,2,1,3,2,12,15,5,9,14,12,11,7,1,1,20,1,1,1,10,1,10,1,1,1,1,1,185,82,14,20,30193113,7240,7490,5740,Northern_European,139,4,1996/5/23,48,2,52196.0,,70093800
318,Djed Spence,Tottenham,2000,491.0,eng ENG,FWDF,21.0,0.1,0.0,0.0,0.0,0.0,0.0,0.0,0.0,,0.0,0.0,0.0,0.0,0.0,0.0,0.0,0.0,Matches,491.0,eng ENG,FWDF,21.0,0.1,0.0,0.0,0.0,0.0,0.0,0.0,0.0,0.0,0.0,0.0,0.0,0.0,0.0,0.0,0.0,0.0,Matches,,,,,,,,,,,,,,,,,,,,,,,,,,,,,,,,,,,,,,,,,,,,,,,,,,,,,,,,491.0,eng ENG,FWDF,21.0,0.1,0.0,0.0,0.0,0.0,0.0,0.0,0.0,0.0,0.0,0.0,0.0,0.0,1.0,1.0,0.0,100.0,Matches,491.0,eng ENG,FWDF,21.0,0.1,9.0,9.0,0.0,0.0,0.0,0.0,0.0,0.0,0.0,0.0,0.0,0.0,5.0,0.0,2.0,Matches,491.0,eng ENG,FWDF,21.0,0.1,5.0,9.0,55.6,60.0,4.0,4.0,5.0,80.0,1.0,1.0,100.0,0.0,0.0,,0.0,0.0,0.0,0.0,0.0,0.0,0.0,0.0,0.0,Matches,619,eng ENG,FWDF,21,4,7.0,2.0,0.2,0.1,0,,0,4,2.0,8,1.5,0.0,0.0,0.0,0.0,-0.18,0.3,0.5,-0.2,-2.4,-2.6,Matches,491.0,eng ENG,FWDF,21.0,0.1,12.0,0.0,3.0,1.0,8.0,2.0,12.0,1.0,0.0,0.0,0.0,0.0,8.0,92.0,66.0,2.0,1.0,1.0,0.0,2.0,10.0,2.0,Matches,491.0,eng ENG,FWDF,21.0,0.1,0.0,1.0,0.0,0.0,12.86,0.0,0.0,,8.9,0.0,0.0,0.0,0.1,0.1,0.06,-0.1,-0.1,Matches,491.0,eng ENG,FWDF,21.0,4.0,0.0,7.0,0.1,0.0,0.0,0.0,0.0,0.0,0.0,0.0,0.0,0.1,0.1,0.0,0.1,2.0,0.0,2.0,0.0,0.0,0.0,0.0,0.0,0.83,0.0,0.83,0.83,0.83,Matches,Djed Spence,D/WB/M/AM R,21,130,152,"England,Kenya,Jamaica",Tottenham Hotspur,6,12,13,11,10,6,7,7,10,10,10,6,11,10,11,11,11,10,10,11,9,10,13,7,13,9,9,12,17,14,12,12,13,15,14,10,10,13,12,5,12,3,1,4,1,2,2,2,1,1,3,1,12,15,11,9,13,7,8,13,1,12,10,19,13,20,1,12,1,18,12,1,18,1,184,68,9,20,30795806,6498,6498,4648,African_Caribbean,110,15,2000/8/9,0,0,40597.0,,29178504
319,Jack Stacey,Bournemouth,1996,492.0,eng ENG,DF,26.0,3.3,5.0,4.0,3.0,1.0,1.0,2.0,5.0,40.0,3.0,3.0,1.0,2.0,5.0,10.0,15.0,0.0,Matches,492.0,eng ENG,DF,26.0,3.3,1.0,0.3,1.0,0.0,0.0,0.0,0.0,0.0,0.0,0.0,0.0,0.0,0.0,0.0,0.0,0.0,Matches,,,,,,,,,,,,,,,,,,,,,,,,,,,,,,,,,,,,,,,,,,,,,,,,,,,,,,,,492.0,eng ENG,DF,26.0,3.3,2.0,0.0,0.0,4.0,0.0,1.0,10.0,5.0,4.0,0.0,0.0,0.0,15.0,5.0,3.0,62.5,Matches,492.0,eng ENG,DF,26.0,3.3,130.0,106.0,23.0,0.0,0.0,0.0,10.0,23.0,0.0,0.0,0.0,0.0,74.0,1.0,7.0,Matches,492.0,eng ENG,DF,26.0,3.3,74.0,130.0,56.9,1088.0,392.0,42.0,53.0,79.2,27.0,50.0,54.0,3.0,12.0,25.0,0.0,0.0,0.0,0.0,0.0,6.0,1.0,1.0,2.0,Matches,620,eng ENG,DF,26,10,299.0,30.0,8.7,3.3,3,75.0,2,7,11.0,17,1.1,1.0,10.0,-9.0,-2.71,-1.99,1.1,6.1,-5.0,-1.51,-0.92,Matches,492.0,eng ENG,DF,26.0,3.3,174.0,17.0,67.0,62.0,47.0,2.0,174.0,8.0,3.0,37.5,5.0,62.5,74.0,462.0,221.0,9.0,4.0,1.0,3.0,4.0,78.0,15.0,Matches,492.0,eng ENG,DF,26.0,3.3,0.0,1.0,0.0,0.0,0.3,0.0,0.0,,16.0,0.0,0.0,0.0,0.1,0.1,0.09,-0.1,-0.1,Matches,492.0,eng ENG,DF,26.0,10.0,3.0,299.0,3.3,0.0,0.0,0.0,0.0,0.0,0.0,2.0,0.0,0.1,0.1,0.0,0.1,9.0,2.0,15.0,0.0,0.0,0.0,0.0,0.0,0.03,0.0,0.03,0.03,0.03,Matches,Jack Stacey,D/WB R,26,126,145,England,AFC Bournemouth,11,11,12,9,11,9,8,11,9,12,10,11,13,11,8,11,11,12,11,11,12,14,10,9,12,11,12,15,14,12,11,11,18,15,17,12,15,5,16,5,7,2,1,3,1,2,3,1,3,1,3,2,12,12,6,12,11,14,14,13,1,14,1,20,11,18,1,1,7,10,1,1,10,1,181,85,8,20,5974788,6300,6300,3754,Northern_European,119,4,1996/4/6,0,0,28998.0,,28086122
320,Junior Stanislas,Bournemouth,1989,493.0,eng ENG,MF,32.0,0.7,0.0,0.0,0.0,0.0,0.0,0.0,0.0,,0.0,2.0,1.0,1.0,0.0,0.0,0.0,0.0,Matches,493.0,eng ENG,MF,32.0,0.7,4.0,5.9,4.0,0.0,0.0,0.0,0.0,0.0,0.0,0.0,0.0,0.0,0.0,0.0,0.0,0.0,Matches,,,,,,,,,,,,,,,,,,,,,,,,,,,,,,,,,,,,,,,,,,,,,,,,,,,,,,,,493.0,eng ENG,MF,32.0,0.7,0.0,0.0,0.0,0.0,0.0,0.0,1.0,0.0,0.0,0.0,0.0,0.0,1.0,0.0,1.0,0.0,Matches,493.0,eng ENG,MF,32.0,0.7,28.0,27.0,1.0,0.0,0.0,1.0,1.0,0.0,1.0,0.0,0.0,0.0,22.0,0.0,1.0,Matches,493.0,eng ENG,MF,32.0,0.7,22.0,28.0,78.6,329.0,71.0,12.0,14.0,85.7,9.0,11.0,81.8,0.0,1.0,0.0,0.0,0.1,0.2,-0.1,2.0,3.0,0.0,0.0,4.0,Matches,621,eng ENG,MF,32,4,61.0,15.0,1.8,0.7,0,,0,4,15.0,5,0.75,0.0,1.0,-1.0,-1.48,-0.59,0.4,0.7,-0.3,-0.48,0.19,Matches,493.0,eng ENG,MF,32.0,0.7,34.0,0.0,3.0,15.0,16.0,3.0,34.0,0.0,0.0,,0.0,,18.0,92.0,13.0,0.0,1.0,0.0,1.0,1.0,27.0,5.0,Matches,493.0,eng ENG,MF,32.0,0.7,0.0,1.0,0.0,0.0,1.48,0.0,0.0,,24.5,0.0,0.0,0.0,0.0,0.0,0.04,0.0,0.0,Matches,493.0,eng ENG,MF,32.0,4.0,0.0,61.0,0.7,0.0,0.0,0.0,0.0,0.0,0.0,0.0,0.0,0.0,0.0,0.1,0.2,0.0,4.0,5.0,0.0,0.0,0.0,0.0,0.0,0.05,0.19,0.25,0.05,0.25,Matches,Junior Stanislas,M/AM RL,32,122,143,"England,Saint Lucia",AFC Bournemouth,15,11,12,11,13,14,7,10,7,7,13,10,8,13,7,14,4,12,10,12,12,13,12,5,12,9,14,12,14,13,13,9,15,14,14,10,15,6,11,13,14,1,3,1,2,3,3,3,2,2,1,2,12,14,3,13,10,16,8,9,1,1,1,1,1,1,1,17,1,17,20,13,20,1,183,77,9,20,2461823,6100,6100,4500,Mixed_Race,120,16,1989/11/26,0,0,28998.0,,28006277
321,Jay Stansfield,Fulham,2002,494.0,eng ENG,FW,19.0,1.0,0.0,0.0,0.0,0.0,0.0,0.0,2.0,0.0,2.0,4.0,1.0,3.0,1.0,1.0,1.0,0.0,Matches,494.0,eng ENG,FW,19.0,1.0,4.0,4.14,1.0,0.0,0.0,2.0,1.0,0.0,1.0,1.03,0.0,0.0,0.0,1.0,0.0,0.0,Matches,,,,,,,,,,,,,,,,,,,,,,,,,,,,,,,,,,,,,,,,,,,,,,,,,,,,,,,,494.0,eng ENG,FW,19.0,1.0,0.0,0.0,0.0,1.0,1.0,0.0,3.0,1.0,0.0,0.0,0.0,0.0,7.0,0.0,1.0,0.0,Matches,494.0,eng ENG,FW,19.0,1.0,23.0,23.0,0.0,0.0,0.0,0.0,3.0,0.0,0.0,0.0,0.0,0.0,9.0,0.0,3.0,Matches,494.0,eng ENG,FW,19.0,1.0,9.0,23.0,39.1,82.0,32.0,7.0,8.0,87.5,1.0,7.0,14.3,0.0,3.0,0.0,0.0,0.1,0.0,-0.1,1.0,0.0,0.0,0.0,0.0,Matches,622,eng ENG,FW,19,3,87.0,29.0,2.5,1.0,1,76.0,0,2,6.0,2,1.33,2.0,2.0,0.0,0.0,-0.05,2.2,1.8,0.4,0.44,0.92,Matches,494.0,eng ENG,FW,19.0,1.0,35.0,2.0,7.0,14.0,15.0,7.0,35.0,0.0,0.0,,0.0,,13.0,88.0,35.0,2.0,2.0,0.0,2.0,2.0,23.0,4.0,Matches,494.0,eng ENG,FW,19.0,1.0,0.0,2.0,0.0,0.0,2.07,0.0,0.0,,13.9,0.0,0.0,0.0,0.3,0.3,0.13,-0.3,-0.3,Matches,494.0,eng ENG,FW,19.0,3.0,1.0,87.0,1.0,0.0,0.0,0.0,0.0,0.0,0.0,0.0,0.0,0.3,0.3,0.1,0.3,2.0,0.0,4.0,0.0,0.0,0.0,0.0,0.0,0.26,0.09,0.35,0.26,0.35,Matches,Jay Stansfield,AM/S R,19,105,-75,England,Fulham,8,12,10,12,11,9,10,12,4,8,10,12,3,12,10,12,10,13,10,12,15,9,13,6,11,10,10,14,14,11,10,12,12,13,12,10,10,9,14,9,10,1,4,1,4,3,3,1,2,2,2,3,8,11,1,10,9,9,11,16,1,1,1,1,1,1,1,1,1,1,1,1,16,20,181,0,7,20,35122297,5250,5250,2752,Northern_European,105,3,2002/11/24,0,0,2320.0,Exeter City,29228687
322,Jack Stephens,Southampton,1994,496.0,eng ENG,DF,28.0,0.5,2.0,2.0,2.0,0.0,0.0,1.0,1.0,100.0,0.0,1.0,1.0,0.0,1.0,3.0,2.0,0.0,Matches,496.0,eng ENG,DF,28.0,0.5,0.0,0.0,0.0,0.0,0.0,0.0,0.0,0.0,0.0,0.0,0.0,0.0,0.0,0.0,0.0,0.0,Matches,,,,,,,,,,,,,,,,,,,,,,,,,,,,,,,,,,,,,,,,,,,,,,,,,,,,,,,,496.0,eng ENG,DF,28.0,0.5,0.0,0.0,0.0,1.0,0.0,0.0,0.0,1.0,2.0,0.0,0.0,0.0,0.0,1.0,0.0,100.0,Matches,496.0,eng ENG,DF,28.0,0.5,28.0,25.0,3.0,1.0,0.0,0.0,0.0,2.0,0.0,0.0,0.0,0.0,23.0,0.0,0.0,Matches,496.0,eng ENG,DF,28.0,0.5,23.0,28.0,82.1,398.0,107.0,9.0,10.0,90.0,13.0,17.0,76.5,1.0,1.0,100.0,0.0,0.0,0.0,0.0,0.0,3.0,0.0,0.0,3.0,Matches,624,eng ENG,DF,28,2,46.0,23.0,1.3,0.5,0,,0,2,23.0,0,0.5,0.0,2.0,-2.0,-3.91,-2.98,0.3,0.6,-0.4,-0.7,-0.09,Matches,496.0,eng ENG,DF,28.0,0.5,33.0,4.0,8.0,17.0,8.0,0.0,33.0,0.0,0.0,,0.0,,16.0,135.0,86.0,3.0,2.0,0.0,0.0,1.0,25.0,0.0,Matches,496.0,eng ENG,DF,28.0,0.5,0.0,0.0,0.0,,0.0,0.0,,,,0.0,0.0,0.0,0.0,0.0,,0.0,0.0,Matches,496.0,eng ENG,DF,28.0,2.0,0.0,46.0,0.5,0.0,0.0,0.0,0.0,0.0,0.0,0.0,0.0,0.0,0.0,0.0,0.0,3.0,3.0,0.0,0.0,0.0,0.0,0.0,0.0,0.0,0.0,0.0,0.0,0.0,Matches,Jack Stephens,D C,28,128,138,England,Southampton,9,10,11,7,13,10,14,8,10,14,13,9,14,13,13,14,14,14,13,12,12,14,11,14,10,13,13,12,11,11,11,14,13,11,13,14,12,6,11,6,16,1,4,2,2,1,3,1,2,1,1,1,12,10,11,12,12,14,14,12,1,1,20,14,1,14,15,1,10,10,1,1,1,1,185,84,9,20,9496935,6399,6399,4999,Northern_European,128,4,1994/1/27,0,0,52196.0,AFC Bournemouth,29071914
323,Sam Surridge,Nott'ham Forest,1998,503.0,eng ENG,FW,24.0,3.6,5.0,0.0,1.0,3.0,1.0,1.0,4.0,25.0,3.0,5.0,2.0,3.0,0.0,5.0,7.0,0.0,Matches,503.0,eng ENG,FW,24.0,3.6,4.0,1.11,3.0,0.0,0.0,1.0,0.0,0.0,1.0,0.28,1.0,0.0,0.0,0.0,0.0,0.0,Matches,,,,,,,,,,,,,,,,,,,,,,,,,,,,,,,,,,,,,,,,,,,,,,,,,,,,,,,,503.0,eng ENG,FW,24.0,3.6,2.0,0.0,0.0,12.0,10.0,3.0,3.0,0.0,0.0,0.0,1.0,0.0,17.0,13.0,16.0,44.8,Matches,503.0,eng ENG,FW,24.0,3.6,81.0,77.0,3.0,0.0,0.0,0.0,3.0,0.0,0.0,0.0,0.0,0.0,40.0,1.0,3.0,Matches,503.0,eng ENG,FW,24.0,3.6,40.0,81.0,49.4,551.0,168.0,25.0,45.0,55.6,13.0,24.0,54.2,1.0,3.0,33.3,0.0,0.1,0.0,-0.1,1.0,4.0,0.0,0.0,6.0,Matches,633,eng ENG,FW,24,20,323.0,16.0,9.4,3.6,1,62.0,0,19,14.0,16,1.15,5.0,5.0,0.0,0.0,0.87,5.8,8.4,-2.6,-0.72,-0.07,Matches,503.0,eng ENG,FW,24.0,3.6,137.0,9.0,27.0,55.0,59.0,15.0,137.0,5.0,2.0,40.0,2.0,40.0,71.0,361.0,140.0,2.0,5.0,1.0,13.0,4.0,93.0,17.0,Matches,503.0,eng ENG,FW,24.0,3.6,1.0,9.0,2.0,22.2,2.51,0.56,0.11,0.5,11.6,0.0,0.0,0.0,1.8,1.8,0.2,-0.8,-0.8,Matches,503.0,eng ENG,FW,24.0,20.0,1.0,323.0,3.6,1.0,0.0,1.0,1.0,0.0,0.0,2.0,0.0,1.8,1.8,0.1,1.8,2.0,6.0,17.0,0.28,0.0,0.28,0.28,0.28,0.5,0.02,0.51,0.5,0.51,Matches,Sam Surridge,S,23,113,136,England,Nottingham Forest,7,10,11,12,10,6,14,9,9,7,11,13,8,13,13,15,13,10,14,8,11,15,12,7,13,7,13,15,12,12,10,15,13,13,14,11,12,5,11,5,6,2,2,3,4,4,2,2,3,2,1,2,10,15,2,11,12,15,6,14,1,1,1,1,1,1,1,1,1,1,5,1,1,20,190,70,9,20,3522746,5646,5646,3746,Northern_European,113,4,1998/7/28,0,0,17399.0,,29141814
324,Japhet Tanganga,Tottenham,1999,504.0,eng ENG,DF,23.0,1.6,3.0,2.0,3.0,0.0,0.0,1.0,5.0,20.0,4.0,1.0,0.0,1.0,2.0,5.0,8.0,0.0,Matches,504.0,eng ENG,DF,23.0,1.6,0.0,0.0,0.0,0.0,0.0,0.0,0.0,0.0,0.0,0.0,0.0,0.0,0.0,0.0,0.0,0.0,Matches,,,,,,,,,,,,,,,,,,,,,,,,,,,,,,,,,,,,,,,,,,,,,,,,,,,,,,,,504.0,eng ENG,DF,23.0,1.6,0.0,0.0,0.0,3.0,3.0,0.0,1.0,2.0,2.0,0.0,0.0,0.0,8.0,6.0,2.0,75.0,Matches,504.0,eng ENG,DF,23.0,1.6,92.0,91.0,1.0,1.0,0.0,0.0,1.0,0.0,0.0,0.0,0.0,0.0,82.0,0.0,0.0,Matches,504.0,eng ENG,DF,23.0,1.6,82.0,92.0,89.1,1323.0,541.0,42.0,46.0,91.3,34.0,38.0,89.5,5.0,7.0,71.4,0.0,0.0,0.0,0.0,0.0,4.0,1.0,1.0,5.0,Matches,635,eng ENG,DF,23,4,146.0,37.0,4.3,1.6,2,71.0,0,2,3.0,26,1.25,2.0,5.0,-3.0,-1.85,-2.12,1.4,3.6,-2.2,-1.38,-1.64,Matches,504.0,eng ENG,DF,23.0,1.6,109.0,5.0,48.0,59.0,3.0,0.0,109.0,2.0,1.0,50.0,1.0,50.0,68.0,308.0,133.0,1.0,2.0,0.0,3.0,1.0,71.0,2.0,Matches,504.0,eng ENG,DF,23.0,1.6,0.0,0.0,0.0,,0.0,0.0,,,,0.0,0.0,0.0,0.0,0.0,,0.0,0.0,Matches,504.0,eng ENG,DF,23.0,4.0,2.0,146.0,1.6,0.0,0.0,0.0,0.0,0.0,0.0,0.0,0.0,0.0,0.0,0.0,0.0,1.0,5.0,2.0,0.0,0.0,0.0,0.0,0.0,0.0,0.0,0.0,0.0,0.0,Matches,Japhet Tanganga,D RC,23,135,146,"England,Democratic Republic of Congo",Tottenham Hotspur,4,10,9,7,12,5,14,7,11,13,10,5,14,13,14,13,15,13,12,10,13,15,9,9,13,14,13,14,13,13,12,15,15,14,15,15,12,7,1,10,12,3,4,4,1,1,3,3,1,1,3,2,14,14,5,9,14,14,12,15,1,14,20,18,1,13,1,1,1,1,1,1,1,1,186,83,10,20,20161253,6750,6750,5250,African_Caribbean,134,15,1999/3/31,0,0,28998.0,,28106874
325,Tetê,Leicester City,2000,508.0,br BRA,FW,22.0,8.2,14.0,8.0,5.0,7.0,2.0,6.0,21.0,28.6,15.0,9.0,0.0,9.0,2.0,16.0,3.0,0.0,Matches,508.0,br BRA,FW,22.0,8.2,28.0,3.43,15.0,3.0,7.0,2.0,1.0,0.0,2.0,0.25,0.0,0.0,2.0,0.0,0.0,0.0,Matches,,,,,,,,,,,,,,,,,,,,,,,,,,,,,,,,,,,,,,,,,,,,,,,,,,,,,,,,508.0,br BRA,FW,22.0,8.2,0.0,0.0,0.0,3.0,17.0,4.0,19.0,2.0,8.0,0.0,0.0,0.0,52.0,5.0,12.0,29.4,Matches,508.0,br BRA,FW,22.0,8.2,258.0,235.0,20.0,2.0,1.0,4.0,19.0,0.0,6.0,5.0,0.0,1.0,186.0,3.0,10.0,Matches,508.0,br BRA,FW,22.0,8.2,186.0,258.0,72.1,3000.0,637.0,102.0,127.0,80.3,56.0,76.0,73.7,19.0,30.0,63.3,0.0,0.4,0.3,-0.4,6.0,16.0,4.0,1.0,26.0,Matches,641,br BRA,FW,22,13,734.0,56.0,21.5,8.2,9,68.0,0,4,30.0,5,0.85,13.0,15.0,-2.0,-0.25,0.26,14.2,13.4,0.8,0.1,0.55,Matches,508.0,br BRA,FW,22.0,8.2,350.0,5.0,59.0,165.0,134.0,30.0,350.0,33.0,20.0,60.6,10.0,30.3,212.0,1624.0,708.0,22.0,11.0,15.0,19.0,13.0,237.0,55.0,Matches,508.0,br BRA,FW,22.0,8.2,1.0,15.0,1.0,6.7,1.84,0.12,0.07,1.0,19.8,0.0,0.0,0.0,1.8,1.8,0.12,-0.8,-0.8,Matches,508.0,br BRA,FW,22.0,13.0,9.0,734.0,8.2,1.0,0.0,1.0,1.0,0.0,0.0,0.0,0.0,1.8,1.8,0.4,2.2,22.0,26.0,55.0,0.12,0.0,0.12,0.12,0.12,0.22,0.05,0.27,0.22,0.27,Matches,Tetê,M/AM R,22,137,156,Brazil,Shakhtar Donetsk,11,12,14,13,16,11,7,8,5,3,12,13,8,17,7,12,11,13,14,13,12,13,14,8,14,9,11,11,16,15,13,9,13,16,13,12,13,7,11,9,13,1,3,1,3,4,1,2,3,1,1,1,16,16,3,6,12,13,14,12,1,1,1,1,1,1,1,1,1,17,1,13,20,1,175,73,20,5,65175826,7500,7000,6000,Mixed_Race,135,15,2000/2/15,0,0,28236.0,Olympique Lyonnais,19348859
326,Kieran Tierney,Arsenal,1997,512.0,sct SCO,DF,25.0,8.8,20.0,11.0,9.0,9.0,2.0,12.0,16.0,75.0,4.0,8.0,2.0,6.0,11.0,31.0,25.0,0.0,Matches,512.0,sct SCO,DF,25.0,8.8,12.0,1.36,10.0,0.0,1.0,1.0,0.0,0.0,4.0,0.45,4.0,0.0,0.0,0.0,0.0,0.0,Matches,,,,,,,,,,,,,,,,,,,,,,,,,,,,,,,,,,,,,,,,,,,,,,,,,,,,,,,,512.0,sct SCO,DF,25.0,8.8,0.0,0.0,0.0,5.0,9.0,1.0,24.0,11.0,11.0,0.0,0.0,0.0,43.0,6.0,18.0,25.0,Matches,512.0,sct SCO,DF,25.0,8.8,486.0,415.0,67.0,11.0,1.0,1.0,24.0,56.0,0.0,0.0,0.0,0.0,362.0,4.0,11.0,Matches,512.0,sct SCO,DF,25.0,8.8,362.0,486.0,74.5,6636.0,2048.0,152.0,172.0,88.4,170.0,215.0,79.1,35.0,69.0,50.7,1.0,0.3,0.4,0.7,4.0,35.0,9.0,1.0,36.0,Matches,645,sct SCO,DF,25,27,795.0,29.0,23.2,8.8,6,81.0,3,21,15.0,11,2.56,16.0,10.0,6.0,0.68,-0.66,15.2,10.8,4.4,0.5,-0.37,Matches,512.0,sct SCO,DF,25.0,8.8,579.0,23.0,153.0,244.0,183.0,15.0,579.0,12.0,3.0,25.0,3.0,25.0,316.0,1802.0,837.0,25.0,12.0,3.0,7.0,0.0,338.0,31.0,Matches,512.0,sct SCO,DF,25.0,8.8,0.0,7.0,2.0,28.6,0.79,0.23,0.0,0.0,23.1,0.0,0.0,0.0,0.3,0.3,0.05,-0.3,-0.3,Matches,512.0,sct SCO,DF,25.0,27.0,6.0,795.0,8.8,0.0,1.0,1.0,0.0,0.0,0.0,0.0,0.0,0.3,0.3,0.3,0.7,25.0,36.0,31.0,0.0,0.11,0.11,0.0,0.11,0.04,0.04,0.08,0.04,0.08,Matches,Kieran Tierney,D/WB LC,25,151,164,"Scotland,England",Arsenal,10,15,14,11,13,10,12,11,15,13,12,8,15,13,15,13,16,12,13,12,13,18,12,14,13,13,19,18,15,15,15,12,13,14,15,11,15,11,14,14,12,2,2,3,1,3,1,3,1,3,4,2,12,15,7,18,15,17,13,13,1,20,15,13,19,13,1,1,1,1,1,1,1,1,178,76,20,9,58707384,7541,7541,6741,Northern_European,148,2,1997/6/5,32,1,127591.0,,61070563
327,Takehiro Tomiyasu,Arsenal,1998,514.0,jp JPN,DF,23.0,7.4,27.0,18.0,12.0,10.0,5.0,13.0,18.0,72.2,5.0,7.0,0.0,7.0,14.0,41.0,15.0,1.0,Matches,514.0,jp JPN,DF,23.0,7.4,10.0,1.36,8.0,2.0,0.0,0.0,0.0,0.0,2.0,0.27,2.0,0.0,0.0,0.0,0.0,0.0,Matches,,,,,,,,,,,,,,,,,,,,,,,,,,,,,,,,,,,,,,,,,,,,,,,,,,,,,,,,514.0,jp JPN,DF,23.0,7.4,2.0,0.0,0.0,6.0,3.0,0.0,12.0,14.0,18.0,0.0,0.0,0.0,42.0,17.0,20.0,45.9,Matches,514.0,jp JPN,DF,23.0,7.4,474.0,420.0,53.0,4.0,2.0,2.0,12.0,49.0,0.0,0.0,0.0,0.0,384.0,1.0,9.0,Matches,514.0,jp JPN,DF,23.0,7.4,384.0,474.0,81.0,6453.0,2036.0,173.0,200.0,86.5,171.0,199.0,85.9,30.0,56.0,53.6,1.0,0.6,0.2,0.4,4.0,41.0,6.0,2.0,51.0,Matches,647,jp JPN,DF,23,21,663.0,32.0,19.4,7.4,6,77.0,3,15,14.0,2,2.38,17.0,11.0,6.0,0.81,-0.46,14.4,9.0,5.3,0.72,-0.07,Matches,514.0,jp JPN,DF,23.0,7.4,557.0,26.0,138.0,293.0,130.0,17.0,557.0,4.0,1.0,25.0,2.0,50.0,311.0,1380.0,624.0,14.0,7.0,1.0,7.0,4.0,344.0,28.0,Matches,514.0,jp JPN,DF,23.0,7.4,0.0,3.0,0.0,0.0,0.41,0.0,0.0,,12.1,0.0,0.0,0.0,0.2,0.2,0.07,-0.2,-0.2,Matches,514.0,jp JPN,DF,23.0,21.0,6.0,663.0,7.4,0.0,1.0,1.0,0.0,0.0,0.0,2.0,0.0,0.2,0.2,0.6,0.8,14.0,51.0,28.0,0.0,0.14,0.14,0.0,0.14,0.03,0.08,0.11,0.03,0.11,Matches,Takehiro Tomiyasu,D/WB RLC,23,148,160,Japan,Arsenal,7,11,13,9,12,7,12,9,11,13,12,7,15,13,13,15,15,14,14,12,13,15,13,7,12,14,16,17,13,14,13,14,16,13,16,13,15,10,12,6,16,2,1,3,1,1,3,2,2,3,2,1,18,14,4,15,14,17,17,14,1,17,15,20,15,16,10,1,1,1,1,1,1,1,188,78,13,20,114136796,7299,7099,5999,Asian,144,6,1998/11/5,28,1,75395.0,,45095490
328,James Tomkins,Crystal Palace,1989,515.0,eng ENG,DF,33.0,3.8,4.0,2.0,2.0,1.0,1.0,1.0,3.0,33.3,2.0,3.0,2.0,1.0,5.0,9.0,19.0,0.0,Matches,515.0,eng ENG,DF,33.0,3.8,0.0,0.0,0.0,0.0,0.0,0.0,0.0,0.0,0.0,0.0,0.0,0.0,0.0,0.0,0.0,0.0,Matches,,,,,,,,,,,,,,,,,,,,,,,,,,,,,,,,,,,,,,,,,,,,,,,,,,,,,,,,515.0,eng ENG,DF,33.0,3.8,3.0,1.0,1.0,3.0,1.0,1.0,0.0,5.0,2.0,0.0,0.0,0.0,21.0,6.0,6.0,50.0,Matches,515.0,eng ENG,DF,33.0,3.8,171.0,164.0,7.0,5.0,0.0,0.0,0.0,0.0,0.0,0.0,0.0,0.0,138.0,0.0,3.0,Matches,515.0,eng ENG,DF,33.0,3.8,138.0,171.0,80.7,2645.0,822.0,47.0,55.0,85.5,79.0,87.0,90.8,12.0,27.0,44.4,0.0,0.0,0.0,0.0,0.0,2.0,0.0,0.0,2.0,Matches,648,eng ENG,DF,33,6,338.0,56.0,9.9,3.8,3,79.0,2,3,34.0,16,0.67,2.0,8.0,-6.0,-1.6,-1.51,2.6,6.5,-3.9,-1.03,-0.89,Matches,515.0,eng ENG,DF,33.0,3.8,208.0,34.0,142.0,59.0,7.0,3.0,208.0,1.0,1.0,100.0,0.0,0.0,117.0,429.0,220.0,1.0,1.0,0.0,2.0,1.0,130.0,1.0,Matches,515.0,eng ENG,DF,33.0,3.8,1.0,3.0,2.0,66.7,0.8,0.53,0.33,0.5,12.7,0.0,0.0,0.0,1.0,1.0,0.34,0.0,0.0,Matches,515.0,eng ENG,DF,33.0,6.0,3.0,338.0,3.8,1.0,0.0,1.0,1.0,0.0,0.0,3.0,1.0,1.0,1.0,0.0,1.0,1.0,2.0,1.0,0.27,0.0,0.27,0.27,0.27,0.27,0.0,0.27,0.27,0.27,Matches,James Tomkins,D C,33,125,138,England,Crystal Palace,6,4,9,4,11,4,15,4,6,14,10,2,14,11,13,14,16,11,14,8,13,12,4,13,8,14,14,15,9,10,11,17,8,11,12,14,12,9,12,18,12,1,1,3,1,1,1,1,3,1,3,3,10,13,5,13,11,14,18,17,1,1,20,14,1,1,8,1,1,1,1,1,1,1,192,81,10,20,1003177,6250,6250,5500,Northern_European,124,1,1989/3/29,0,0,57996.0,,5129541
329,Bertrand Traoré,Aston Villa,1995,518.0,bf BFA,FWMF,26.0,2.6,1.0,1.0,1.0,0.0,0.0,1.0,4.0,25.0,3.0,5.0,0.0,5.0,2.0,3.0,0.0,0.0,Matches,518.0,bf BFA,FWMF,26.0,2.6,4.0,1.55,3.0,0.0,0.0,0.0,1.0,0.0,0.0,0.0,0.0,0.0,0.0,0.0,0.0,0.0,Matches,,,,,,,,,,,,,,,,,,,,,,,,,,,,,,,,,,,,,,,,,,,,,,,,,,,,,,,,518.0,bf BFA,FWMF,26.0,2.6,1.0,0.0,0.0,2.0,8.0,3.0,5.0,2.0,1.0,0.0,0.0,0.0,8.0,2.0,4.0,33.3,Matches,518.0,bf BFA,FWMF,26.0,2.6,75.0,72.0,2.0,0.0,0.0,2.0,5.0,1.0,1.0,1.0,0.0,0.0,59.0,1.0,5.0,Matches,518.0,bf BFA,FWMF,26.0,2.6,59.0,75.0,78.7,868.0,258.0,36.0,40.0,90.0,18.0,21.0,85.7,3.0,5.0,60.0,0.0,0.1,0.1,-0.1,1.0,1.0,5.0,3.0,9.0,Matches,651,bf BFA,FWMF,26,8,233.0,29.0,6.8,2.6,1,45.0,0,7,27.0,8,1.75,6.0,1.0,5.0,1.93,1.93,5.8,1.8,4.0,1.55,1.72,Matches,518.0,bf BFA,FWMF,26.0,2.6,114.0,0.0,8.0,41.0,66.0,13.0,114.0,4.0,1.0,25.0,3.0,75.0,81.0,462.0,246.0,9.0,3.0,5.0,8.0,7.0,89.0,28.0,Matches,518.0,bf BFA,FWMF,26.0,2.6,2.0,9.0,3.0,33.3,3.48,1.16,0.22,0.67,16.4,0.0,0.0,0.0,0.7,0.7,0.08,1.3,1.3,Matches,518.0,bf BFA,FWMF,26.0,8.0,1.0,233.0,2.6,2.0,0.0,2.0,2.0,0.0,0.0,1.0,0.0,0.7,0.7,0.1,0.8,9.0,9.0,28.0,0.77,0.0,0.77,0.77,0.77,0.28,0.03,0.3,0.28,0.3,Matches,Bertrand Traoré,AM/S RL,26,133,145,Burkina Faso,Aston Villa,13,12,14,14,15,12,12,13,4,6,12,8,5,14,8,12,9,10,10,11,9,13,14,7,13,10,9,11,16,16,10,10,12,16,12,10,9,10,12,13,13,2,3,4,1,2,3,3,2,3,1,3,13,14,9,12,13,12,14,14,1,1,1,1,1,1,1,15,1,15,17,1,20,19,181,73,20,6,19622844,6700,6900,5650,African_Caribbean,124,17,1995/9/6,64,12,69595.0,Başakşehir Futbol Kulübü,13112706
330,Boubacar Traoré,Wolves,2001,519.0,ml MLI,MF,20.0,4.6,12.0,5.0,4.0,5.0,3.0,3.0,7.0,42.9,4.0,4.0,2.0,2.0,7.0,19.0,1.0,0.0,Matches,519.0,ml MLI,MF,20.0,4.6,6.0,1.32,6.0,0.0,0.0,0.0,0.0,0.0,2.0,0.44,2.0,0.0,0.0,0.0,0.0,0.0,Matches,,,,,,,,,,,,,,,,,,,,,,,,,,,,,,,,,,,,,,,,,,,,,,,,,,,,,,,,519.0,ml MLI,MF,20.0,4.6,2.0,0.0,0.0,10.0,2.0,0.0,1.0,7.0,5.0,0.0,0.0,0.0,27.0,7.0,8.0,46.7,Matches,519.0,ml MLI,MF,20.0,4.6,149.0,146.0,0.0,0.0,0.0,0.0,1.0,0.0,0.0,0.0,0.0,0.0,118.0,3.0,2.0,Matches,519.0,ml MLI,MF,20.0,4.6,118.0,149.0,79.2,1952.0,617.0,56.0,66.0,84.8,55.0,63.0,87.3,6.0,11.0,54.5,1.0,0.2,0.1,0.8,1.0,16.0,1.0,0.0,8.0,Matches,652,ml MLI,MF,20,10,411.0,41.0,12.0,4.6,4,82.0,2,6,14.0,1,0.5,4.0,9.0,-5.0,-1.09,-0.44,3.2,7.6,-4.4,-0.97,-0.41,Matches,519.0,ml MLI,MF,20.0,4.6,185.0,6.0,51.0,110.0,26.0,2.0,185.0,9.0,4.0,44.4,4.0,44.4,90.0,529.0,267.0,4.0,3.0,0.0,3.0,3.0,104.0,2.0,Matches,519.0,ml MLI,MF,20.0,4.6,0.0,3.0,0.0,0.0,0.66,0.0,0.0,,29.3,0.0,0.0,0.0,0.1,0.1,0.02,-0.1,-0.1,Matches,519.0,ml MLI,MF,20.0,10.0,4.0,411.0,4.6,0.0,1.0,1.0,0.0,0.0,0.0,2.0,0.0,0.1,0.1,0.2,0.2,4.0,8.0,2.0,0.0,0.22,0.22,0.0,0.22,0.01,0.04,0.05,0.01,0.05,Matches,Boubacar Traoré,DM/M C,20,118,-75,Mali,FC Metz,8,6,12,8,13,8,11,13,9,9,13,12,11,12,13,14,14,13,12,13,13,13,10,9,14,10,12,15,12,14,13,13,13,10,12,12,12,12,11,8,14,1,2,1,1,3,3,3,1,2,2,2,9,13,3,12,12,11,11,20,1,1,1,1,1,1,18,1,20,1,1,10,1,1,183,67,9,20,11837999,5900,5900,3550,African_Caribbean,118,15,2001/8/20,0,0,6784.0,Wolverhampton Wanderers,12083693
331,Kostas Tsimikas,Liverpool,1996,524.0,gr GRE,DF,26.0,8.6,14.0,9.0,10.0,2.0,2.0,10.0,16.0,62.5,6.0,8.0,1.0,7.0,12.0,26.0,15.0,0.0,Matches,524.0,gr GRE,DF,26.0,8.6,27.0,3.14,12.0,13.0,0.0,2.0,0.0,0.0,4.0,0.47,3.0,1.0,0.0,0.0,0.0,0.0,Matches,,,,,,,,,,,,,,,,,,,,,,,,,,,,,,,,,,,,,,,,,,,,,,,,,,,,,,,,524.0,gr GRE,DF,26.0,8.6,3.0,0.0,0.0,13.0,9.0,0.0,85.0,12.0,9.0,0.0,0.0,0.0,50.0,7.0,7.0,50.0,Matches,524.0,gr GRE,DF,26.0,8.6,618.0,470.0,146.0,23.0,1.0,2.0,85.0,87.0,36.0,11.0,23.0,0.0,474.0,2.0,9.0,Matches,524.0,gr GRE,DF,26.0,8.6,474.0,618.0,76.7,8379.0,2366.0,223.0,255.0,87.5,185.0,225.0,82.2,56.0,111.0,50.5,4.0,1.6,1.3,2.4,18.0,20.0,7.0,4.0,26.0,Matches,658,gr GRE,DF,26,20,771.0,39.0,22.5,8.6,9,67.0,2,11,15.0,17,1.65,14.0,11.0,3.0,0.35,-0.5,14.9,13.7,1.2,0.14,-0.56,Matches,524.0,gr GRE,DF,26.0,8.6,713.0,23.0,170.0,281.0,268.0,22.0,713.0,15.0,4.0,26.7,8.0,53.3,355.0,1833.0,874.0,23.0,9.0,5.0,13.0,7.0,409.0,77.0,Matches,524.0,gr GRE,DF,26.0,8.6,0.0,7.0,2.0,28.6,0.82,0.23,0.0,0.0,15.5,0.0,0.0,0.0,0.6,0.6,0.09,-0.6,-0.6,Matches,524.0,gr GRE,DF,26.0,20.0,9.0,771.0,8.6,0.0,4.0,4.0,0.0,0.0,0.0,3.0,0.0,0.6,0.6,1.6,2.3,23.0,26.0,77.0,0.0,0.47,0.47,0.0,0.47,0.07,0.19,0.26,0.07,0.26,Matches,Kostas Tsimikas,D/WB L,26,152,159,Greece,Liverpool,14,16,15,6,15,11,9,9,12,14,15,12,15,15,15,15,14,15,14,14,14,15,13,9,14,14,16,16,15,14,14,10,14,15,15,12,15,8,14,8,10,2,1,3,2,3,2,1,1,3,2,2,15,15,6,14,14,16,13,15,1,18,1,1,20,1,1,14,1,1,7,1,1,1,175,67,20,6,58564227,7600,7600,6000,Mediterranean_Hispanic,155,2,1996/5/12,22,0,75395.0,,36096824
332,Deniz Undav,Brighton,1996,525.0,de GER,FWMF,26.0,7.0,7.0,4.0,2.0,2.0,3.0,2.0,8.0,25.0,6.0,4.0,1.0,3.0,0.0,7.0,1.0,0.0,Matches,525.0,de GER,FWMF,26.0,7.0,22.0,3.15,14.0,0.0,1.0,6.0,0.0,1.0,4.0,0.57,0.0,0.0,1.0,2.0,0.0,1.0,Matches,,,,,,,,,,,,,,,,,,,,,,,,,,,,,,,,,,,,,,,,,,,,,,,,,,,,,,,,525.0,de GER,FWMF,26.0,7.0,2.0,0.0,0.0,15.0,4.0,7.0,1.0,0.0,4.0,0.0,0.0,1.0,21.0,5.0,7.0,41.7,Matches,525.0,de GER,FWMF,26.0,7.0,164.0,159.0,4.0,0.0,3.0,1.0,1.0,0.0,0.0,0.0,0.0,0.0,122.0,1.0,4.0,Matches,525.0,de GER,FWMF,26.0,7.0,122.0,164.0,74.4,1504.0,325.0,84.0,100.0,84.0,25.0,36.0,69.4,5.0,10.0,50.0,0.0,1.1,1.1,-1.1,8.0,8.0,3.0,0.0,10.0,Matches,661,de GER,FWMF,26,22,628.0,29.0,18.4,7.0,6,71.0,0,16,13.0,14,1.41,14.0,9.0,5.0,0.72,0.27,15.0,9.2,5.9,0.84,0.28,Matches,525.0,de GER,FWMF,26.0,7.0,231.0,4.0,19.0,97.0,116.0,42.0,231.0,6.0,4.0,66.7,2.0,33.3,120.0,518.0,350.0,12.0,6.0,4.0,13.0,8.0,179.0,40.0,Matches,525.0,de GER,FWMF,26.0,7.0,5.0,27.0,12.0,44.4,3.87,1.72,0.19,0.42,13.8,0.0,0.0,0.0,4.5,4.5,0.18,0.5,0.5,Matches,525.0,de GER,FWMF,26.0,22.0,6.0,628.0,7.0,5.0,0.0,5.0,5.0,0.0,0.0,2.0,0.0,4.5,4.5,1.1,5.6,12.0,10.0,40.0,0.72,0.0,0.72,0.72,0.72,0.65,0.15,0.8,0.65,0.8,Matches,Deniz Undav,AM/S RL,26,130,135,"Germany,Turkey",Brighton & Hove Albion,7,9,13,17,13,8,14,9,4,5,10,11,7,12,10,11,16,13,11,12,9,15,10,6,13,12,12,11,13,12,16,11,9,13,13,15,15,10,10,10,11,2,2,1,3,1,3,1,3,1,4,1,6,14,14,7,13,8,7,10,1,1,1,1,1,1,1,12,1,14,19,14,15,20,178,86,9,20,5970952,6243,6243,4993,North_African__Middle_Eastern,123,6,1996/7/19,0,0,25000.0,,91157307
333,Matías Viña,Bournemouth,1997,532.0,uy URU,DF,24.0,5.1,19.0,11.0,9.0,8.0,2.0,14.0,30.0,46.7,16.0,13.0,1.0,12.0,4.0,23.0,22.0,0.0,Matches,532.0,uy URU,DF,24.0,5.1,8.0,1.57,7.0,0.0,1.0,0.0,0.0,0.0,2.0,0.39,2.0,0.0,0.0,0.0,0.0,0.0,Matches,,,,,,,,,,,,,,,,,,,,,,,,,,,,,,,,,,,,,,,,,,,,,,,,,,,,,,,,532.0,uy URU,DF,24.0,5.1,1.0,0.0,0.0,7.0,11.0,0.0,4.0,4.0,11.0,0.0,0.0,0.0,28.0,4.0,7.0,36.4,Matches,532.0,uy URU,DF,24.0,5.1,185.0,142.0,43.0,7.0,0.0,0.0,4.0,36.0,0.0,0.0,0.0,0.0,140.0,0.0,6.0,Matches,532.0,uy URU,DF,24.0,5.1,140.0,185.0,75.7,2103.0,870.0,84.0,93.0,90.3,49.0,63.0,77.8,5.0,14.0,35.7,0.0,0.2,0.1,-0.2,2.0,10.0,4.0,0.0,17.0,Matches,670,uy URU,DF,24,12,458.0,38.0,13.4,5.1,5,70.0,2,7,16.0,4,1.25,5.0,10.0,-5.0,-0.98,-0.1,6.0,7.7,-1.7,-0.33,0.39,Matches,532.0,uy URU,DF,24.0,5.1,289.0,27.0,114.0,105.0,74.0,11.0,289.0,24.0,10.0,41.7,11.0,45.8,122.0,686.0,434.0,10.0,6.0,5.0,11.0,6.0,136.0,19.0,Matches,532.0,uy URU,DF,24.0,5.1,2.0,9.0,6.0,66.7,1.77,1.18,0.22,0.33,18.6,0.0,0.0,0.0,0.9,0.9,0.1,1.1,1.1,Matches,532.0,uy URU,DF,24.0,12.0,5.0,458.0,5.1,2.0,0.0,2.0,2.0,0.0,0.0,1.0,0.0,0.9,0.9,0.2,1.0,10.0,17.0,19.0,0.39,0.0,0.39,0.39,0.39,0.17,0.03,0.2,0.17,0.2,Matches,Matías Viña,D/WB/M L,24,132,144,"Uruguay,Italy",Associazione Sportiva Roma,10,11,12,10,12,6,12,11,13,11,12,6,14,12,14,11,15,12,12,8,11,15,10,8,14,12,16,16,15,15,13,12,14,15,14,12,13,13,13,9,12,3,2,1,3,1,1,2,4,2,4,2,14,14,5,12,10,13,13,12,1,20,14,1,18,1,1,17,1,1,1,1,1,1,180,70,20,8,4404740,6600,6600,5250,Mediterranean_Hispanic,128,7,1997/11/9,24,0,29614.0,,78081848
334,Rúben Vinagre,Everton,1999,533.0,pt POR,DFMF,23.0,0.3,2.0,2.0,1.0,1.0,0.0,1.0,2.0,50.0,1.0,0.0,0.0,0.0,0.0,2.0,1.0,0.0,Matches,533.0,pt POR,DFMF,23.0,0.3,0.0,0.0,0.0,0.0,0.0,0.0,0.0,0.0,0.0,0.0,0.0,0.0,0.0,0.0,0.0,0.0,Matches,,,,,,,,,,,,,,,,,,,,,,,,,,,,,,,,,,,,,,,,,,,,,,,,,,,,,,,,533.0,pt POR,DFMF,23.0,0.3,0.0,0.0,0.0,0.0,3.0,0.0,2.0,0.0,2.0,0.0,0.0,0.0,4.0,0.0,1.0,0.0,Matches,533.0,pt POR,DFMF,23.0,0.3,24.0,19.0,5.0,1.0,0.0,0.0,2.0,4.0,0.0,0.0,0.0,0.0,15.0,0.0,1.0,Matches,533.0,pt POR,DFMF,23.0,0.3,15.0,24.0,62.5,223.0,26.0,7.0,10.0,70.0,7.0,10.0,70.0,0.0,0.0,,0.0,0.0,0.0,0.0,0.0,2.0,0.0,0.0,0.0,Matches,671,pt POR,DFMF,23,2,26.0,13.0,0.8,0.3,0,,0,2,13.0,19,0.5,0.0,0.0,0.0,0.0,0.61,0.1,0.3,-0.3,-0.88,-0.35,Matches,533.0,pt POR,DFMF,23.0,0.3,31.0,1.0,7.0,16.0,9.0,0.0,31.0,3.0,1.0,33.3,0.0,0.0,15.0,98.0,52.0,2.0,1.0,0.0,1.0,1.0,17.0,1.0,Matches,533.0,pt POR,DFMF,23.0,0.3,0.0,0.0,0.0,,0.0,0.0,,,,0.0,0.0,0.0,0.0,0.0,,0.0,0.0,Matches,533.0,pt POR,DFMF,23.0,2.0,0.0,26.0,0.3,0.0,0.0,0.0,0.0,0.0,0.0,0.0,0.0,0.0,0.0,0.0,0.0,2.0,0.0,1.0,0.0,0.0,0.0,0.0,0.0,0.0,0.0,0.0,0.0,0.0,Matches,Rúben Vinagre,D/WB/M/AM L,23,127,142,Portugal,Sporting Clube de Portugal,12,13,14,10,13,8,9,9,11,8,13,10,10,15,11,12,12,14,8,13,9,11,16,9,14,8,10,14,15,15,11,8,11,15,12,10,10,8,13,8,14,2,3,3,3,1,1,4,3,3,3,1,8,14,10,9,9,10,12,13,1,19,1,1,20,1,1,16,1,1,16,1,1,1,174,71,20,7,9323213,6350,6350,4850,Mediterranean_Hispanic,116,6,1999/4/9,0,0,23449.0,Everton,48036492
335,Wout Weghorst,Manchester Utd,1992,544.0,nl NED,FWMF,29.0,8.9,11.0,5.0,6.0,1.0,4.0,2.0,9.0,22.2,7.0,7.0,2.0,5.0,7.0,18.0,9.0,0.0,Matches,544.0,nl NED,FWMF,29.0,8.9,27.0,3.05,22.0,0.0,1.0,2.0,1.0,1.0,2.0,0.23,2.0,0.0,0.0,0.0,0.0,0.0,Matches,,,,,,,,,,,,,,,,,,,,,,,,,,,,,,,,,,,,,,,,,,,,,,,,,,,,,,,,544.0,nl NED,FWMF,29.0,8.9,1.0,0.0,0.0,14.0,9.0,5.0,0.0,7.0,5.0,0.0,0.0,0.0,34.0,15.0,25.0,37.5,Matches,544.0,nl NED,FWMF,29.0,8.9,207.0,206.0,1.0,0.0,4.0,1.0,0.0,0.0,0.0,0.0,0.0,0.0,151.0,0.0,6.0,Matches,544.0,nl NED,FWMF,29.0,8.9,151.0,207.0,72.9,1773.0,457.0,95.0,121.0,78.5,31.0,40.0,77.5,5.0,13.0,38.5,1.0,1.2,1.2,-0.2,14.0,8.0,1.0,0.0,17.0,Matches,686,nl NED,FWMF,29,17,797.0,47.0,23.3,8.9,10,67.0,3,7,18.0,3,1.65,11.0,11.0,0.0,0.0,-0.51,15.4,14.7,0.7,0.07,-0.5,Matches,544.0,nl NED,FWMF,29.0,8.9,291.0,16.0,45.0,151.0,97.0,26.0,291.0,12.0,4.0,33.3,7.0,58.3,161.0,462.0,156.0,3.0,7.0,0.0,15.0,12.0,206.0,41.0,Matches,544.0,nl NED,FWMF,29.0,8.9,0.0,14.0,5.0,35.7,1.58,0.56,0.0,0.0,12.5,0.0,0.0,0.0,2.0,2.0,0.14,-2.0,-2.0,Matches,544.0,nl NED,FWMF,29.0,17.0,10.0,797.0,8.9,0.0,1.0,1.0,0.0,0.0,0.0,1.0,0.0,2.0,2.0,1.2,3.2,3.0,17.0,41.0,0.0,0.11,0.11,0.0,0.11,0.23,0.13,0.36,0.23,0.36,Matches,Wout Weghorst,S,29,140,147,Holland,Burnley,3,8,10,16,14,5,15,8,5,6,12,14,6,12,14,15,18,14,11,12,12,18,10,14,14,7,12,16,10,11,15,18,17,12,17,17,13,8,13,3,5,1,2,1,2,3,3,1,3,1,1,2,16,16,17,12,15,13,7,10,1,1,1,1,1,1,1,1,1,1,1,10,1,20,197,84,12,20,33405620,7000,7000,6700,Northern_European,138,3,1992/8/7,13,3,51036.0,Beşiktaş A.Ş.,37026994
336,Harvey White,Tottenham,2001,547.0,eng ENG,MF,20.0,0.1,0.0,0.0,0.0,0.0,0.0,0.0,1.0,0.0,1.0,0.0,0.0,0.0,0.0,0.0,0.0,0.0,Matches,547.0,eng ENG,MF,20.0,0.1,0.0,0.0,0.0,0.0,0.0,0.0,0.0,0.0,0.0,0.0,0.0,0.0,0.0,0.0,0.0,0.0,Matches,,,,,,,,,,,,,,,,,,,,,,,,,,,,,,,,,,,,,,,,,,,,,,,,,,,,,,,,547.0,eng ENG,MF,20.0,0.1,0.0,0.0,0.0,0.0,0.0,0.0,3.0,0.0,0.0,0.0,0.0,0.0,0.0,1.0,0.0,100.0,Matches,547.0,eng ENG,MF,20.0,0.1,8.0,6.0,2.0,0.0,1.0,0.0,3.0,0.0,2.0,2.0,0.0,0.0,3.0,0.0,0.0,Matches,547.0,eng ENG,MF,20.0,0.1,3.0,8.0,37.5,54.0,21.0,2.0,3.0,66.7,0.0,2.0,0.0,1.0,3.0,33.3,0.0,0.0,0.0,0.0,0.0,0.0,1.0,1.0,0.0,Matches,692,eng ENG,MF,20,1,5.0,5.0,0.1,0.1,0,,0,1,5.0,2,3.0,0.0,0.0,0.0,0.0,-0.18,0.0,0.0,0.0,0.52,0.33,Matches,547.0,eng ENG,MF,20.0,0.1,8.0,0.0,0.0,4.0,4.0,0.0,8.0,0.0,0.0,,0.0,,5.0,11.0,4.0,0.0,0.0,0.0,0.0,0.0,5.0,1.0,Matches,547.0,eng ENG,MF,20.0,0.1,0.0,0.0,0.0,,0.0,0.0,,,,0.0,0.0,0.0,0.0,0.0,,0.0,0.0,Matches,547.0,eng ENG,MF,20.0,1.0,0.0,5.0,0.1,0.0,0.0,0.0,0.0,0.0,0.0,0.0,0.0,0.0,0.0,0.0,0.0,0.0,0.0,1.0,0.0,0.0,0.0,0.0,0.0,0.0,0.0,0.0,0.0,0.0,Matches,Harvey White,DM/M C,20,111,-8,England,Tottenham Hotspur,12,8,7,9,12,13,8,12,10,10,12,15,12,13,7,8,8,13,12,10,14,13,8,8,9,11,14,14,13,12,11,8,13,12,14,11,11,8,10,11,12,3,2,1,4,1,2,1,2,2,1,2,11,12,1,12,14,13,13,14,1,11,12,1,1,1,18,14,20,1,1,1,1,1,168,60,20,10,55676033,5594,5594,3506,Northern_European,111,3,2001/9/19,0,0,11599.0,,28122840
337,Chris Wood,Newcastle Utd,1991,556.0,nz NZL,FW,30.0,5.0,5.0,4.0,0.0,3.0,2.0,3.0,5.0,60.0,2.0,2.0,2.0,0.0,1.0,6.0,7.0,0.0,Matches,556.0,nz NZL,FW,30.0,5.0,5.0,1.01,4.0,0.0,0.0,1.0,0.0,0.0,0.0,0.0,0.0,0.0,0.0,0.0,0.0,0.0,Matches,,,,,,,,,,,,,,,,,,,,,,,,,,,,,,,,,,,,,,,,,,,,,,,,,,,,,,,,556.0,nz NZL,FW,30.0,5.0,0.0,0.0,0.0,4.0,4.0,3.0,0.0,1.0,4.0,0.0,0.0,0.0,17.0,23.0,23.0,50.0,Matches,556.0,nz NZL,FW,30.0,5.0,106.0,105.0,1.0,0.0,0.0,0.0,0.0,0.0,0.0,0.0,0.0,0.0,66.0,0.0,1.0,Matches,556.0,nz NZL,FW,30.0,5.0,66.0,106.0,62.3,786.0,149.0,40.0,67.0,59.7,16.0,25.0,64.0,4.0,5.0,80.0,0.0,0.3,0.3,-0.3,3.0,3.0,1.0,0.0,4.0,Matches,705,nz NZL,FW,30,18,446.0,25.0,13.0,5.0,4,72.0,0,14,11.0,1,1.94,8.0,3.0,5.0,1.01,0.1,6.8,4.1,2.6,0.53,-0.37,Matches,556.0,nz NZL,FW,30.0,5.0,149.0,8.0,19.0,70.0,60.0,16.0,148.0,2.0,1.0,50.0,0.0,0.0,52.0,159.0,62.0,1.0,1.0,0.0,12.0,5.0,101.0,23.0,Matches,556.0,nz NZL,FW,30.0,5.0,2.0,8.0,3.0,37.5,1.61,0.61,0.13,0.33,14.7,0.0,1.0,1.0,1.8,1.0,0.13,0.2,0.0,Matches,556.0,nz NZL,FW,30.0,18.0,4.0,446.0,5.0,2.0,0.0,2.0,1.0,1.0,1.0,0.0,0.0,1.8,1.0,0.3,1.3,1.0,4.0,23.0,0.4,0.0,0.4,0.2,0.2,0.37,0.06,0.43,0.21,0.27,Matches,Chris Wood,S,30,133,138,"New Zealand,England",Newcastle United,3,9,11,14,11,10,15,11,3,7,12,15,9,12,14,14,16,13,13,9,14,15,10,14,12,10,15,15,12,11,16,16,14,13,15,15,14,7,13,9,5,1,2,2,2,3,3,1,2,3,2,3,15,11,5,15,15,16,13,13,1,1,1,1,1,1,1,1,1,1,1,1,1,20,191,90,11,20,20728888,6650,6900,5500,Pacific_Islander,132,6,1991/12/7,70,33,92793.0,,5108293
338,Illia Zabarnyi,Bournemouth,2002,562.0,ua UKR,DF,19.0,3.3,4.0,2.0,4.0,0.0,0.0,3.0,7.0,42.9,4.0,7.0,2.0,5.0,3.0,7.0,14.0,0.0,Matches,562.0,ua UKR,DF,19.0,3.3,1.0,0.3,0.0,0.0,0.0,0.0,1.0,0.0,0.0,0.0,0.0,0.0,0.0,0.0,0.0,0.0,Matches,,,,,,,,,,,,,,,,,,,,,,,,,,,,,,,,,,,,,,,,,,,,,,,,,,,,,,,,562.0,ua UKR,DF,19.0,3.3,0.0,0.0,0.0,1.0,2.0,0.0,0.0,3.0,2.0,0.0,0.0,0.0,18.0,1.0,3.0,25.0,Matches,562.0,ua UKR,DF,19.0,3.3,200.0,197.0,2.0,2.0,0.0,0.0,0.0,0.0,0.0,0.0,0.0,0.0,184.0,1.0,0.0,Matches,562.0,ua UKR,DF,19.0,3.3,184.0,200.0,92.0,3523.0,1083.0,55.0,58.0,94.8,115.0,121.0,95.0,14.0,20.0,70.0,0.0,0.0,0.0,0.0,0.0,13.0,0.0,0.0,11.0,Matches,715,ua UKR,DF,19,5,299.0,60.0,8.7,3.3,3,90.0,3,2,15.0,6,0.6,0.0,5.0,-5.0,-1.51,-0.67,1.9,5.0,-3.2,-0.96,-0.32,Matches,562.0,ua UKR,DF,19.0,3.3,234.0,37.0,159.0,74.0,2.0,0.0,234.0,2.0,1.0,50.0,0.0,0.0,166.0,1013.0,654.0,1.0,1.0,0.0,3.0,2.0,174.0,0.0,Matches,562.0,ua UKR,DF,19.0,3.3,0.0,0.0,0.0,,0.0,0.0,,,,0.0,0.0,0.0,0.0,0.0,,0.0,0.0,Matches,562.0,ua UKR,DF,19.0,5.0,3.0,299.0,3.3,0.0,0.0,0.0,0.0,0.0,0.0,0.0,0.0,0.0,0.0,0.0,0.0,1.0,11.0,0.0,0.0,0.0,0.0,0.0,0.0,0.0,0.0,0.0,0.0,0.0,Matches,Illia Zabarnyi,D C,19,130,-85,Ukraine,Dynamo Kyiv,3,3,9,5,10,4,13,5,5,13,11,6,15,10,10,14,13,14,14,9,14,14,5,9,8,14,16,13,13,12,15,15,15,14,14,14,15,2,18,3,13,1,1,3,2,1,2,1,3,1,1,3,7,15,3,15,16,14,14,16,1,1,20,5,1,2,1,1,1,1,1,1,1,1,186,81,8,20,29419640,6500,6500,5000,Northern_European,130,2,2002/9/1,22,0,6918.0,,71113679
339,Denis Zakaria,Chelsea,1996,564.0,ch SUI,MF,25.0,4.6,9.0,5.0,5.0,2.0,2.0,2.0,8.0,25.0,6.0,4.0,1.0,3.0,3.0,12.0,10.0,0.0,Matches,564.0,ch SUI,MF,25.0,4.6,2.0,0.44,1.0,0.0,0.0,0.0,0.0,1.0,0.0,0.0,0.0,0.0,0.0,0.0,0.0,0.0,Matches,,,,,,,,,,,,,,,,,,,,,,,,,,,,,,,,,,,,,,,,,,,,,,,,,,,,,,,,564.0,ch SUI,MF,25.0,4.6,0.0,0.0,0.0,5.0,2.0,0.0,1.0,3.0,5.0,0.0,0.0,0.0,21.0,0.0,2.0,0.0,Matches,564.0,ch SUI,MF,25.0,4.6,179.0,177.0,2.0,2.0,1.0,1.0,1.0,0.0,0.0,0.0,0.0,0.0,158.0,0.0,5.0,Matches,564.0,ch SUI,MF,25.0,4.6,158.0,179.0,88.3,2222.0,571.0,90.0,98.0,91.8,54.0,56.0,96.4,5.0,6.0,83.3,0.0,0.0,0.1,0.0,1.0,8.0,0.0,0.0,6.0,Matches,717,ch SUI,MF,25,7,411.0,59.0,12.0,4.6,5,72.0,1,2,26.0,9,1.0,5.0,5.0,0.0,0.0,0.27,5.3,7.6,-2.3,-0.5,-0.48,Matches,564.0,ch SUI,MF,25.0,4.6,218.0,12.0,66.0,113.0,44.0,2.0,218.0,9.0,6.0,66.7,3.0,33.3,140.0,646.0,291.0,9.0,3.0,2.0,4.0,9.0,159.0,3.0,Matches,564.0,ch SUI,MF,25.0,4.6,0.0,2.0,0.0,0.0,0.44,0.0,0.0,,16.9,0.0,0.0,0.0,0.2,0.2,0.09,-0.2,-0.2,Matches,564.0,ch SUI,MF,25.0,7.0,5.0,411.0,4.6,0.0,0.0,0.0,0.0,0.0,0.0,0.0,0.0,0.2,0.2,0.0,0.2,9.0,6.0,3.0,0.0,0.0,0.0,0.0,0.0,0.04,0.01,0.05,0.04,0.05,Matches,Denis Zakaria,DM/M C,25,146,155,"Switzerland,Democratic Republic of Congo,South Sudan",Juventus,7,9,14,10,13,8,11,11,12,13,13,8,16,13,17,14,17,13,13,12,12,15,12,11,14,14,16,17,14,13,15,15,15,15,17,15,15,13,14,9,9,1,2,3,3,3,3,2,3,2,3,2,13,16,6,10,11,15,12,14,1,1,13,1,1,1,20,1,20,1,1,1,1,1,191,81,8,20,16647882,7300,7000,5750,African_Caribbean,145,13,1996/11/20,40,3,57808.0,Chelsea,98034601
340,Hakim Ziyech,Chelsea,1993,567.0,ma MAR,FWMF,29.0,7.3,20.0,12.0,12.0,5.0,3.0,4.0,9.0,44.4,5.0,8.0,0.0,8.0,5.0,25.0,5.0,1.0,Matches,567.0,ma MAR,FWMF,29.0,7.3,32.0,4.36,25.0,4.0,1.0,0.0,1.0,1.0,3.0,0.41,2.0,1.0,0.0,0.0,0.0,0.0,Matches,,,,,,,,,,,,,,,,,,,,,,,,,,,,,,,,,,,,,,,,,,,,,,,,,,,,,,,,567.0,ma MAR,FWMF,29.0,7.3,1.0,0.0,0.0,12.0,14.0,3.0,66.0,5.0,12.0,0.0,0.0,0.0,46.0,0.0,5.0,0.0,Matches,567.0,ma MAR,FWMF,29.0,7.3,400.0,349.0,47.0,12.0,4.0,3.0,66.0,14.0,20.0,12.0,4.0,1.0,258.0,4.0,15.0,Matches,567.0,ma MAR,FWMF,29.0,7.3,258.0,400.0,64.5,4222.0,1570.0,148.0,169.0,87.6,82.0,133.0,61.7,24.0,66.0,36.4,3.0,2.2,1.5,0.8,14.0,20.0,19.0,7.0,42.0,Matches,720,ma MAR,FWMF,29,18,661.0,37.0,19.3,7.3,6,76.0,2,12,17.0,13,0.78,6.0,7.0,-1.0,-0.14,0.12,8.4,9.3,-0.9,-0.12,-0.05,Matches,567.0,ma MAR,FWMF,29.0,7.3,505.0,12.0,74.0,184.0,251.0,17.0,505.0,33.0,14.0,42.4,15.0,45.5,303.0,1505.0,657.0,20.0,17.0,7.0,12.0,13.0,354.0,69.0,Matches,567.0,ma MAR,FWMF,29.0,7.3,0.0,16.0,3.0,18.8,2.18,0.41,0.0,0.0,22.7,0.0,0.0,0.0,0.6,0.6,0.04,-0.6,-0.6,Matches,567.0,ma MAR,FWMF,29.0,18.0,6.0,661.0,7.3,0.0,3.0,3.0,0.0,0.0,0.0,1.0,0.0,0.6,0.6,2.2,2.8,20.0,42.0,69.0,0.0,0.41,0.41,0.0,0.41,0.08,0.3,0.38,0.08,0.38,Matches,Hakim Ziyech,M/AM RLC,29,150,160,"Morocco,Holland",Chelsea,14,14,15,10,16,16,10,14,7,6,15,13,6,16,13,17,13,13,10,17,9,14,17,11,14,6,12,12,14,16,12,10,15,13,15,9,11,10,14,6,15,3,1,3,2,2,1,1,1,1,3,4,14,14,12,14,14,15,15,12,1,1,1,1,1,1,1,17,19,17,17,20,19,13,181,68,20,13,41548240,7490,7490,6490,North_African__Middle_Eastern,144,6,1993/3/19,40,17,115992.0,,37040604
341,Julen Agirrezabala,Athletic Club,2000,4.0,es ESP,GK,21.0,7.5,0.0,0.0,0.0,0.0,0.0,0.0,0.0,,0.0,0.0,0.0,0.0,0.0,0.0,2.0,0.0,Matches,4.0,es ESP,GK,21.0,7.5,0.0,0.0,0.0,0.0,0.0,0.0,0.0,0.0,0.0,0.0,0.0,0.0,0.0,0.0,0.0,0.0,Matches,2.0,es ESP,GK,21.0,7.5,6.0,0.0,0.0,0.0,0.0,5.5,0.3,-0.5,-0.06,37.0,101.0,36.6,179.0,33.0,29.6,30.5,62.0,77.4,55.4,96.0,11.0,11.5,10.0,1.33,15.4,Matches,2.0,es ESP,GK,21.0,8.0,7.0,675.0,7.5,6.0,0.8,19.0,13.0,68.4,1.0,3.0,3.0,2.0,28.6,0.0,0.0,0.0,0.0,,Matches,4.0,es ESP,GK,21.0,7.5,0.0,0.0,0.0,0.0,0.0,0.0,0.0,0.0,0.0,0.0,0.0,0.0,14.0,1.0,0.0,100.0,Matches,4.0,es ESP,GK,21.0,7.5,241.0,169.0,72.0,10.0,0.0,0.0,0.0,0.0,0.0,0.0,0.0,0.0,171.0,0.0,0.0,Matches,4.0,es ESP,GK,21.0,7.5,171.0,241.0,71.0,4890.0,3600.0,29.0,29.0,100.0,91.0,94.0,96.8,51.0,118.0,43.2,0.0,0.0,0.0,0.0,0.0,2.0,0.0,0.0,0.0,Matches,4,es ESP,GK,21,8,675.0,84.0,19.7,7.5,7,90.0,7,1,45.0,26,0.75,5.0,6.0,-1.0,-0.13,-0.3,10.2,6.9,3.3,0.43,-0.03,Matches,4.0,es ESP,GK,21.0,7.5,253.0,203.0,249.0,4.0,0.0,0.0,253.0,0.0,0.0,,0.0,,150.0,804.0,551.0,0.0,0.0,0.0,0.0,0.0,105.0,0.0,Matches,4.0,es ESP,GK,21.0,7.5,0.0,0.0,0.0,,0.0,0.0,,,,0.0,0.0,0.0,0.0,0.0,,0.0,0.0,Matches,4.0,es ESP,GK,21.0,8.0,7.0,675.0,7.5,0.0,0.0,0.0,0.0,0.0,0.0,0.0,0.0,0.0,0.0,0.0,0.0,0.0,0.0,0.0,0.0,0.0,0.0,0.0,0.0,0.0,0.0,0.0,0.0,0.0,Matches,Julen Agirrezabala,GK,21,124,151,"Spain,Pays Basque",A. Bilbao,7,3,3,1,9,9,2,3,1,3,9,1,1,9,7,13,15,10,12,9,14,13,1,3,2,14,11,10,13,13,7,15,10,13,5,13,14,14,11,9,12,14,12,12,5,12,10,13,15,8,9,12,12,11,4,11,9,11,12,14,20,1,1,1,1,1,1,1,1,1,1,1,1,1,187,0,20,8,11309999,6200,6200,4700,Mediterranean_Hispanic,123,5,2000/12/26,0,0,6932.0,,67277830
342,Paul Akouokou,Betis,1997,9.0,ci CIV,MFDF,24.0,5.0,16.0,9.0,13.0,3.0,0.0,13.0,20.0,65.0,7.0,2.0,2.0,0.0,12.0,28.0,17.0,1.0,Matches,9.0,ci CIV,MFDF,24.0,5.0,2.0,0.4,0.0,0.0,0.0,2.0,0.0,0.0,0.0,0.0,0.0,0.0,0.0,0.0,0.0,0.0,Matches,,,,,,,,,,,,,,,,,,,,,,,,,,,,,,,,,,,,,,,,,,,,,,,,,,,,,,,,9.0,ci CIV,MFDF,24.0,5.0,3.0,0.0,0.0,7.0,4.0,0.0,0.0,12.0,9.0,0.0,0.0,0.0,27.0,6.0,7.0,46.2,Matches,9.0,ci CIV,MFDF,24.0,5.0,174.0,168.0,4.0,2.0,1.0,2.0,0.0,2.0,0.0,0.0,0.0,0.0,160.0,2.0,3.0,Matches,9.0,ci CIV,MFDF,24.0,5.0,160.0,174.0,92.0,2670.0,645.0,71.0,73.0,97.3,66.0,69.0,95.7,14.0,18.0,77.8,0.0,0.0,0.1,0.0,0.0,13.0,1.0,0.0,10.0,Matches,9,ci CIV,MFDF,24,12,447.0,37.0,13.1,5.0,3,89.0,2,9,20.0,19,1.67,2.0,6.0,-4.0,-0.81,-1.08,3.5,8.9,-5.4,-1.08,-1.28,Matches,9.0,ci CIV,MFDF,24.0,5.0,233.0,33.0,102.0,117.0,16.0,1.0,233.0,5.0,3.0,60.0,2.0,40.0,116.0,369.0,122.0,1.0,2.0,0.0,5.0,0.0,136.0,1.0,Matches,9.0,ci CIV,MFDF,24.0,5.0,0.0,3.0,1.0,33.3,0.6,0.2,0.0,0.0,19.2,0.0,0.0,0.0,0.2,0.2,0.05,-0.2,-0.2,Matches,9.0,ci CIV,MFDF,24.0,12.0,3.0,447.0,5.0,0.0,0.0,0.0,0.0,0.0,0.0,3.0,0.0,0.2,0.2,0.0,0.2,1.0,10.0,1.0,0.0,0.0,0.0,0.0,0.0,0.03,0.0,0.03,0.03,0.03,Matches,Paul Akouokou,DM/M C,24,127,140,Ivory Coast,Real Hispalis,6,7,8,6,11,8,13,9,11,12,10,11,15,12,14,14,13,12,14,11,13,13,12,10,9,13,14,14,14,13,12,14,14,13,15,14,12,12,11,12,9,1,2,3,1,1,3,1,1,2,3,3,14,14,10,10,11,9,12,14,1,1,1,1,1,1,20,1,18,1,1,5,1,1,181,68,11,20,2926862,6249,4776,2767,African_Caribbean,127,16,1997/12/20,4,0,7386.0,,33066648
343,Ángel Alarcón,Barcelona,2004,11.0,es ESP,FW,18.0,0.3,,0.0,,,,,,,,,,,0.0,,,,Matches,11.0,es ESP,FW,18.0,0.3,,,,,,,,,,,,,,,,,Matches,,,,,,,,,,,,,,,,,,,,,,,,,,,,,,,,,,,,,,,,,,,,,,,,,,,,,,,,11.0,es ESP,FW,18.0,0.3,0.0,0.0,0.0,2.0,1.0,0.0,1.0,0.0,0.0,,,0.0,,,,,Matches,11.0,es ESP,FW,18.0,0.3,,,,,,,1.0,,,,,,,,,Matches,11.0,es ESP,FW,18.0,0.3,,,,,,,,,,,,,,,0.0,,,,,,,,,Matches,11,es ESP,FW,18,4,25.0,6.0,0.7,0.3,0,,0,4,6.0,10,2.25,0.0,0.0,0.0,0.0,-1.33,,,,,,Matches,11.0,es ESP,FW,18.0,0.3,,,,,,,,,,,,,,,,,,,,,,,Matches,11.0,es ESP,FW,18.0,0.3,0.0,1.0,1.0,100.0,3.6,3.6,0.0,0.0,,,0.0,0.0,,,,,,Matches,11.0,es ESP,FW,18.0,4.0,0.0,25.0,0.3,0.0,0.0,0.0,0.0,0.0,0.0,0.0,0.0,,,,,,,,0.0,0.0,0.0,0.0,0.0,,,,,,Matches,Ángel Alarcón,M/AM/S RL,18,100,-75,Spain,Barcelona,9,11,13,11,12,9,8,11,6,5,11,9,6,14,6,7,11,7,7,8,8,14,16,7,11,5,8,8,14,13,11,8,14,13,9,8,15,6,15,10,15,1,3,2,2,3,2,3,2,1,2,2,11,13,5,10,13,14,13,15,1,1,1,1,1,1,1,17,1,17,20,12,20,17,175,0,8,20,6000000,5000,5000,2500,Mediterranean_Hispanic,87,5,2004/5/15,0,0,1189.0,,2000049419
344,Tomás Alarcón,Cádiz,1999,12.0,cl CHI,MF,23.0,2.5,3.0,2.0,0.0,2.0,1.0,1.0,2.0,50.0,1.0,1.0,0.0,1.0,2.0,5.0,2.0,0.0,Matches,12.0,cl CHI,MF,23.0,2.5,4.0,1.61,2.0,1.0,0.0,0.0,1.0,0.0,0.0,0.0,0.0,0.0,0.0,0.0,0.0,0.0,Matches,,,,,,,,,,,,,,,,,,,,,,,,,,,,,,,,,,,,,,,,,,,,,,,,,,,,,,,,12.0,cl CHI,MF,23.0,2.5,2.0,1.0,1.0,4.0,3.0,0.0,6.0,2.0,2.0,0.0,0.0,0.0,14.0,3.0,1.0,75.0,Matches,12.0,cl CHI,MF,23.0,2.5,95.0,88.0,7.0,5.0,1.0,3.0,6.0,0.0,2.0,1.0,1.0,0.0,78.0,0.0,0.0,Matches,12.0,cl CHI,MF,23.0,2.5,78.0,95.0,82.1,1688.0,582.0,28.0,32.0,87.5,27.0,34.0,79.4,20.0,25.0,80.0,0.0,0.1,0.1,-0.1,2.0,11.0,1.0,0.0,9.0,Matches,12,cl CHI,MF,23,4,223.0,56.0,6.5,2.5,2,83.0,1,2,29.0,4,0.0,0.0,7.0,-7.0,-2.83,-2.37,1.2,5.3,-4.1,-1.67,-1.22,Matches,12.0,cl CHI,MF,23.0,2.5,113.0,3.0,20.0,68.0,25.0,1.0,113.0,0.0,0.0,,0.0,,62.0,267.0,81.0,2.0,0.0,0.0,3.0,4.0,74.0,6.0,Matches,12.0,cl CHI,MF,23.0,2.5,0.0,2.0,1.0,50.0,0.81,0.4,0.0,0.0,36.4,0.0,0.0,0.0,0.0,0.0,0.01,0.0,0.0,Matches,12.0,cl CHI,MF,23.0,4.0,2.0,223.0,2.5,0.0,0.0,0.0,0.0,0.0,0.0,2.0,1.0,0.0,0.0,0.1,0.1,2.0,9.0,6.0,0.0,0.0,0.0,0.0,0.0,0.01,0.03,0.04,0.01,0.04,Matches,Tomás Alarcón,DM/M C,23,122,136,Chile,Cádiz,11,10,8,6,13,12,11,10,7,13,14,13,14,9,14,13,14,12,14,12,14,12,8,12,9,15,16,14,11,9,13,12,14,11,15,13,9,12,12,6,8,3,3,1,2,1,1,2,3,2,2,3,9,14,5,13,8,14,15,12,1,1,9,1,1,1,16,1,20,1,1,1,1,1,181,0,10,20,2910180,6395,5895,2495,Native_American,119,10,1999/1/19,12,0,11568.0,,75041769
345,Carlos Álvarez,Sevilla,2003,24.0,es ESP,MF,18.0,0.1,1.0,1.0,0.0,1.0,0.0,0.0,0.0,,0.0,0.0,0.0,0.0,0.0,1.0,0.0,0.0,Matches,24.0,es ESP,MF,18.0,0.1,0.0,0.0,0.0,0.0,0.0,0.0,0.0,0.0,0.0,0.0,0.0,0.0,0.0,0.0,0.0,0.0,Matches,,,,,,,,,,,,,,,,,,,,,,,,,,,,,,,,,,,,,,,,,,,,,,,,,,,,,,,,24.0,es ESP,MF,18.0,0.1,1.0,0.0,0.0,1.0,0.0,0.0,0.0,0.0,1.0,0.0,0.0,0.0,0.0,0.0,0.0,,Matches,24.0,es ESP,MF,18.0,0.1,4.0,4.0,0.0,0.0,0.0,0.0,0.0,0.0,0.0,0.0,0.0,0.0,4.0,0.0,0.0,Matches,24.0,es ESP,MF,18.0,0.1,4.0,4.0,100.0,47.0,0.0,2.0,2.0,100.0,1.0,1.0,100.0,0.0,0.0,,0.0,0.0,0.0,0.0,0.0,0.0,0.0,0.0,0.0,Matches,26,es ESP,MF,18,1,10.0,10.0,0.3,0.1,0,,0,1,10.0,7,3.0,0.0,1.0,-1.0,-9.0,-8.84,0.1,0.2,-0.1,-0.67,-0.46,Matches,24.0,es ESP,MF,18.0,0.1,6.0,0.0,0.0,3.0,3.0,0.0,6.0,0.0,0.0,,0.0,,2.0,18.0,1.0,0.0,0.0,0.0,1.0,0.0,5.0,1.0,Matches,24.0,es ESP,MF,18.0,0.1,0.0,0.0,0.0,,0.0,0.0,,,,0.0,0.0,0.0,0.0,0.0,,0.0,0.0,Matches,24.0,es ESP,MF,18.0,1.0,0.0,10.0,0.1,0.0,0.0,0.0,0.0,0.0,0.0,1.0,0.0,0.0,0.0,0.0,0.0,0.0,0.0,1.0,0.0,0.0,0.0,0.0,0.0,0.0,0.0,0.0,0.0,0.0,Matches,Carlos Álvarez,AM/S RLC,18,101,-75,Spain,Sevilla,12,14,12,16,12,10,12,12,10,10,10,4,9,13,10,12,9,8,8,9,10,12,14,9,16,10,11,6,12,11,10,9,14,12,9,7,14,6,16,15,12,3,2,1,1,3,2,4,3,2,3,1,16,12,2,10,11,13,13,10,1,1,1,1,1,1,1,1,1,1,16,16,20,16,168,0,20,10,23437501,5050,5050,2000,Mediterranean_Hispanic,96,4,2003/8/6,0,0,1423.0,,67291985
346,Selim Amallah,Valladolid,1996,27.0,ma MAR,MFFW,25.0,3.0,15.0,9.0,7.0,8.0,0.0,5.0,8.0,62.5,3.0,2.0,0.0,2.0,5.0,20.0,2.0,0.0,Matches,27.0,ma MAR,MFFW,25.0,3.0,11.0,3.69,5.0,0.0,4.0,0.0,0.0,2.0,2.0,0.67,1.0,0.0,1.0,0.0,0.0,0.0,Matches,,,,,,,,,,,,,,,,,,,,,,,,,,,,,,,,,,,,,,,,,,,,,,,,,,,,,,,,27.0,ma MAR,MFFW,25.0,3.0,2.0,1.0,0.0,10.0,8.0,1.0,2.0,5.0,9.0,0.0,0.0,0.0,10.0,7.0,8.0,46.7,Matches,27.0,ma MAR,MFFW,25.0,3.0,83.0,80.0,3.0,0.0,0.0,1.0,2.0,2.0,0.0,0.0,0.0,0.0,63.0,0.0,1.0,Matches,27.0,ma MAR,MFFW,25.0,3.0,63.0,83.0,75.9,1030.0,268.0,30.0,38.0,78.9,23.0,30.0,76.7,6.0,8.0,75.0,1.0,0.3,0.2,0.7,3.0,7.0,2.0,0.0,10.0,Matches,32,ma MAR,MFFW,25,7,267.0,38.0,7.8,3.0,3,56.0,0,4,25.0,2,1.14,6.0,4.0,2.0,0.67,1.59,4.0,5.4,-1.5,-0.5,0.22,Matches,27.0,ma MAR,MFFW,25.0,3.0,138.0,2.0,21.0,77.0,44.0,11.0,138.0,25.0,11.0,44.0,12.0,48.0,80.0,507.0,254.0,11.0,7.0,3.0,6.0,10.0,84.0,9.0,Matches,27.0,ma MAR,MFFW,25.0,3.0,2.0,5.0,2.0,40.0,1.69,0.67,0.4,1.0,19.2,1.0,0.0,0.0,0.9,0.9,0.17,1.1,1.1,Matches,27.0,ma MAR,MFFW,25.0,7.0,3.0,267.0,3.0,2.0,1.0,3.0,2.0,0.0,0.0,2.0,1.0,0.9,0.9,0.3,1.1,11.0,10.0,9.0,0.67,0.34,1.01,0.67,1.01,0.29,0.09,0.38,0.29,0.38,Matches,Selim Amallah,DM/M/AM RLC,25,129,132,"Morocco,Belgium",R Standard de Liège,11,11,13,10,13,12,5,13,11,10,13,8,13,14,11,13,13,14,14,13,14,12,12,11,15,8,14,12,14,12,7,5,13,13,14,7,12,8,10,14,19,1,2,3,1,3,2,2,2,3,2,2,15,14,1,12,11,13,3,17,1,1,1,1,1,1,17,12,20,18,15,18,16,7,186,82,8,20,4942222,6297,6297,4030,North_African__Middle_Eastern,120,12,1996/11/16,22,4,8000.0,,18089862
347,Jordan Amavi,Getafe,1994,29.0,fr FRA,DF,28.0,2.2,3.0,2.0,3.0,0.0,0.0,1.0,3.0,33.3,2.0,3.0,0.0,3.0,4.0,7.0,7.0,0.0,Matches,29.0,fr FRA,DF,28.0,2.2,2.0,0.9,2.0,0.0,0.0,0.0,0.0,0.0,1.0,0.45,1.0,0.0,0.0,0.0,0.0,0.0,Matches,,,,,,,,,,,,,,,,,,,,,,,,,,,,,,,,,,,,,,,,,,,,,,,,,,,,,,,,29.0,fr FRA,DF,28.0,2.2,2.0,1.0,1.0,3.0,2.0,1.0,6.0,4.0,2.0,0.0,0.0,0.0,15.0,8.0,3.0,72.7,Matches,29.0,fr FRA,DF,28.0,2.2,96.0,69.0,27.0,1.0,0.0,0.0,6.0,26.0,0.0,0.0,0.0,0.0,51.0,0.0,5.0,Matches,29.0,fr FRA,DF,28.0,2.2,51.0,96.0,53.1,779.0,372.0,28.0,39.0,71.8,18.0,36.0,50.0,3.0,11.0,27.3,0.0,0.0,0.0,0.0,0.0,2.0,0.0,0.0,5.0,Matches,35,fr FRA,DF,28,5,200.0,40.0,5.8,2.2,1,58.0,0,4,36.0,23,0.8,2.0,2.0,0.0,0.0,0.31,0.6,1.5,-0.9,-0.39,-0.16,Matches,29.0,fr FRA,DF,28.0,2.2,119.0,8.0,33.0,65.0,23.0,1.0,119.0,1.0,0.0,0.0,1.0,100.0,42.0,255.0,121.0,4.0,5.0,1.0,2.0,0.0,44.0,5.0,Matches,29.0,fr FRA,DF,28.0,2.2,0.0,0.0,0.0,,0.0,0.0,,,,0.0,0.0,0.0,0.0,0.0,,0.0,0.0,Matches,29.0,fr FRA,DF,28.0,5.0,1.0,200.0,2.2,0.0,0.0,0.0,0.0,0.0,0.0,2.0,1.0,0.0,0.0,0.0,0.0,4.0,5.0,5.0,0.0,0.0,0.0,0.0,0.0,0.0,0.0,0.0,0.0,0.0,Matches,Jordan Amavi,D/WB L,28,122,140,France,Olympique de Marseille,5,13,13,6,13,5,13,10,12,11,13,8,13,13,10,14,13,13,14,10,12,14,12,8,13,11,13,15,12,13,12,10,13,13,13,13,12,10,13,13,10,1,2,1,4,1,3,1,1,1,2,3,10,15,7,14,11,15,14,13,1,20,1,1,17,1,1,15,1,1,10,1,1,1,176,70,20,10,974063,6100,6100,4000,African_Caribbean,122,13,1994/3/9,0,0,57533.0,Getafe,85126966
348,Marcos André,Valencia,1996,30.0,br BRA,FWMF,25.0,5.0,4.0,1.0,1.0,1.0,2.0,1.0,2.0,50.0,1.0,4.0,1.0,3.0,0.0,4.0,0.0,0.0,Matches,30.0,br BRA,FWMF,25.0,5.0,12.0,2.42,8.0,0.0,3.0,1.0,0.0,0.0,0.0,0.0,0.0,0.0,0.0,0.0,0.0,0.0,Matches,,,,,,,,,,,,,,,,,,,,,,,,,,,,,,,,,,,,,,,,,,,,,,,,,,,,,,,,30.0,br BRA,FWMF,25.0,5.0,2.0,1.0,0.0,9.0,12.0,1.0,1.0,0.0,1.0,0.0,0.0,0.0,9.0,10.0,15.0,40.0,Matches,30.0,br BRA,FWMF,25.0,5.0,64.0,58.0,6.0,0.0,1.0,1.0,1.0,0.0,0.0,0.0,0.0,0.0,43.0,0.0,1.0,Matches,30.0,br BRA,FWMF,25.0,5.0,43.0,64.0,67.2,631.0,160.0,21.0,32.0,65.6,18.0,23.0,78.3,1.0,4.0,25.0,0.0,0.4,0.2,-0.4,4.0,4.0,1.0,0.0,7.0,Matches,36,br BRA,FWMF,25,17,447.0,26.0,13.1,5.0,3,52.0,0,14,21.0,5,0.76,9.0,7.0,2.0,0.4,0.55,7.3,7.6,-0.3,-0.06,-0.24,Matches,30.0,br BRA,FWMF,25.0,5.0,125.0,1.0,8.0,50.0,69.0,23.0,125.0,17.0,9.0,52.9,4.0,23.5,78.0,353.0,124.0,2.0,3.0,0.0,21.0,5.0,94.0,20.0,Matches,30.0,br BRA,FWMF,25.0,5.0,1.0,17.0,2.0,11.8,3.42,0.4,0.06,0.5,14.6,0.0,0.0,0.0,1.5,1.3,0.08,-0.5,-0.3,Matches,30.0,br BRA,FWMF,25.0,17.0,3.0,447.0,5.0,1.0,0.0,1.0,1.0,0.0,0.0,2.0,1.0,1.5,1.3,0.4,1.8,2.0,7.0,20.0,0.2,0.0,0.2,0.2,0.2,0.29,0.09,0.38,0.27,0.36,Matches,Marcos André,S,25,130,148,"Brazil,Spain",Valencia,8,9,13,13,13,10,14,12,9,8,13,12,9,14,12,13,14,13,14,12,13,14,10,10,13,11,14,14,13,13,10,11,12,14,13,14,12,11,12,7,11,2,3,2,2,1,1,1,3,2,3,3,7,12,3,10,11,11,13,20,1,1,1,1,1,1,1,1,1,1,1,1,1,20,184,78,9,20,4719684,6500,5170,4653,North_African__Middle_Eastern,130,13,1996/10/20,0,0,14999.0,,19270874
349,Fabrizio Angileri,Getafe,1994,31.0,ar ARG,DF,28.0,6.5,12.0,9.0,8.0,3.0,1.0,10.0,17.0,58.8,7.0,8.0,3.0,5.0,7.0,19.0,10.0,0.0,Matches,31.0,ar ARG,DF,28.0,6.5,5.0,0.77,3.0,0.0,1.0,0.0,0.0,1.0,2.0,0.31,1.0,0.0,0.0,0.0,0.0,1.0,Matches,,,,,,,,,,,,,,,,,,,,,,,,,,,,,,,,,,,,,,,,,,,,,,,,,,,,,,,,31.0,ar ARG,DF,28.0,6.5,2.0,1.0,0.0,7.0,1.0,0.0,12.0,7.0,9.0,0.0,1.0,0.0,19.0,17.0,10.0,63.0,Matches,31.0,ar ARG,DF,28.0,6.5,260.0,190.0,70.0,3.0,0.0,2.0,12.0,67.0,0.0,0.0,0.0,0.0,153.0,0.0,13.0,Matches,31.0,ar ARG,DF,28.0,6.5,153.0,260.0,58.8,2800.0,936.0,67.0,87.0,77.0,65.0,109.0,59.6,17.0,42.0,40.5,0.0,0.0,0.1,0.0,0.0,13.0,1.0,0.0,16.0,Matches,37,ar ARG,DF,28,15,585.0,39.0,17.1,6.5,7,70.0,2,8,12.0,15,1.13,7.0,15.0,-8.0,-1.23,-1.14,5.2,10.1,-4.9,-0.75,-0.61,Matches,31.0,ar ARG,DF,28.0,6.5,324.0,17.0,88.0,157.0,80.0,3.0,324.0,11.0,4.0,36.4,6.0,54.5,123.0,554.0,220.0,4.0,7.0,0.0,4.0,4.0,145.0,14.0,Matches,31.0,ar ARG,DF,28.0,6.5,0.0,3.0,0.0,0.0,0.46,0.0,0.0,,23.6,0.0,0.0,0.0,0.1,0.1,0.04,-0.1,-0.1,Matches,31.0,ar ARG,DF,28.0,15.0,7.0,585.0,6.5,0.0,0.0,0.0,0.0,0.0,0.0,2.0,1.0,0.1,0.1,0.0,0.1,4.0,16.0,14.0,0.0,0.0,0.0,0.0,0.0,0.02,0.0,0.02,0.02,0.02,Matches,Fabrizio Angileri,D/WB L,28,130,135,"Argentina,Italy",Getafe,13,13,13,9,13,13,9,12,13,13,12,10,11,13,12,13,11,12,12,14,13,10,9,4,13,13,12,13,14,14,12,11,13,13,15,11,10,5,10,9,15,2,2,2,2,2,3,1,1,4,3,2,12,14,8,12,12,11,10,10,1,20,1,1,17,1,1,15,1,1,1,1,1,1,185,84,20,9,3003507,6494,6494,3994,Mediterranean_Hispanic,128,8,1994/3/15,0,0,10070.0,,14079839
350,Sergio Arribas,Real Madrid,2001,38.0,es ESP,MFFW,20.0,0.2,0.0,0.0,0.0,0.0,0.0,0.0,0.0,,0.0,1.0,0.0,1.0,0.0,0.0,0.0,0.0,Matches,38.0,es ESP,MFFW,20.0,0.2,3.0,14.21,2.0,1.0,0.0,0.0,0.0,0.0,0.0,0.0,0.0,0.0,0.0,0.0,0.0,0.0,Matches,,,,,,,,,,,,,,,,,,,,,,,,,,,,,,,,,,,,,,,,,,,,,,,,,,,,,,,,38.0,es ESP,MFFW,20.0,0.2,0.0,0.0,0.0,0.0,0.0,0.0,1.0,0.0,0.0,0.0,0.0,0.0,2.0,0.0,0.0,,Matches,38.0,es ESP,MFFW,20.0,0.2,11.0,9.0,2.0,0.0,0.0,0.0,1.0,0.0,2.0,1.0,0.0,0.0,9.0,0.0,0.0,Matches,38.0,es ESP,MFFW,20.0,0.2,9.0,11.0,81.8,131.0,35.0,6.0,6.0,100.0,3.0,5.0,60.0,0.0,0.0,,0.0,0.0,0.0,0.0,1.0,1.0,1.0,0.0,2.0,Matches,47,es ESP,MFFW,20,2,19.0,10.0,0.6,0.2,0,,0,2,10.0,1,1.5,0.0,1.0,-1.0,-4.74,-5.8,0.9,0.1,0.8,3.81,2.86,Matches,38.0,es ESP,MFFW,20.0,0.2,13.0,1.0,1.0,6.0,6.0,1.0,13.0,0.0,0.0,,0.0,,4.0,26.0,17.0,0.0,0.0,0.0,0.0,0.0,8.0,0.0,Matches,38.0,es ESP,MFFW,20.0,0.2,0.0,1.0,0.0,0.0,4.74,0.0,0.0,,16.3,0.0,0.0,0.0,0.2,0.2,0.16,-0.2,-0.2,Matches,38.0,es ESP,MFFW,20.0,2.0,0.0,19.0,0.2,0.0,0.0,0.0,0.0,0.0,0.0,0.0,0.0,0.2,0.2,0.0,0.2,0.0,2.0,0.0,0.0,0.0,0.0,0.0,0.0,0.74,0.14,0.88,0.74,0.88,Matches,Sergio Arribas,M/AM LC,20,125,155,Spain,R. Madrid,15,14,13,13,14,15,4,13,4,7,13,5,2,15,6,11,7,9,10,13,11,15,16,7,11,11,14,12,15,13,11,7,10,14,11,10,11,4,12,9,16,3,2,1,2,3,1,3,1,3,3,3,8,12,3,9,9,11,13,18,1,1,1,1,1,1,1,16,10,12,20,16,14,1,173,63,20,13,19650000,6250,6250,3750,Mediterranean_Hispanic,122,1,2001/9/30,0,0,8300.0,,67277465
351,Mikel Balenziaga,Athletic Club,1988,54.0,es ESP,DF,34.0,1.3,4.0,4.0,1.0,2.0,1.0,4.0,4.0,100.0,0.0,0.0,0.0,0.0,1.0,5.0,2.0,0.0,Matches,54.0,es ESP,DF,34.0,1.3,1.0,0.78,1.0,0.0,0.0,0.0,0.0,0.0,0.0,0.0,0.0,0.0,0.0,0.0,0.0,0.0,Matches,,,,,,,,,,,,,,,,,,,,,,,,,,,,,,,,,,,,,,,,,,,,,,,,,,,,,,,,54.0,es ESP,DF,34.0,1.3,0.0,0.0,0.0,3.0,0.0,0.0,3.0,1.0,4.0,0.0,0.0,0.0,6.0,0.0,0.0,,Matches,54.0,es ESP,DF,34.0,1.3,69.0,57.0,11.0,0.0,0.0,0.0,3.0,11.0,0.0,0.0,0.0,0.0,49.0,1.0,0.0,Matches,54.0,es ESP,DF,34.0,1.3,49.0,69.0,71.0,819.0,242.0,25.0,29.0,86.2,19.0,26.0,73.1,5.0,9.0,55.6,0.0,0.0,0.1,0.0,0.0,4.0,2.0,1.0,7.0,Matches,65,es ESP,DF,34,3,115.0,38.0,3.4,1.3,1,69.0,0,2,23.0,27,1.0,1.0,3.0,-2.0,-1.57,-1.73,0.8,1.5,-0.6,-0.5,-0.99,Matches,54.0,es ESP,DF,34.0,1.3,77.0,2.0,14.0,39.0,25.0,0.0,77.0,1.0,1.0,100.0,0.0,0.0,29.0,100.0,50.0,0.0,2.0,0.0,0.0,1.0,41.0,6.0,Matches,54.0,es ESP,DF,34.0,1.3,0.0,1.0,0.0,0.0,0.78,0.0,0.0,,24.4,0.0,0.0,0.0,0.0,0.0,0.03,0.0,0.0,Matches,54.0,es ESP,DF,34.0,3.0,1.0,115.0,1.3,0.0,0.0,0.0,0.0,0.0,0.0,0.0,0.0,0.0,0.0,0.0,0.0,0.0,7.0,6.0,0.0,0.0,0.0,0.0,0.0,0.02,0.0,0.02,0.02,0.02,Matches,Mikel Balenziaga,D/WB L,34,136,141,"Spain,Pays Basque",A. Bilbao,11,13,11,7,12,12,10,10,12,14,12,7,15,12,13,14,15,13,14,10,13,13,11,9,13,12,14,15,13,12,12,11,9,13,14,13,13,10,10,8,9,2,3,4,3,2,1,1,3,1,2,4,10,12,7,9,11,13,15,16,1,20,1,12,19,12,1,15,1,1,15,1,1,1,177,77,20,12,2630710,6800,6800,5300,Mediterranean_Hispanic,133,4,1988/2/29,0,0,17903.0,,67029321
352,Keidi Bare,Espanyol,1997,57.0,al ALB,MF,24.0,5.6,15.0,8.0,7.0,5.0,3.0,7.0,13.0,53.8,6.0,8.0,2.0,6.0,11.0,26.0,8.0,0.0,Matches,57.0,al ALB,MF,24.0,5.6,11.0,1.96,7.0,1.0,0.0,2.0,0.0,1.0,2.0,0.36,1.0,0.0,0.0,0.0,0.0,1.0,Matches,,,,,,,,,,,,,,,,,,,,,,,,,,,,,,,,,,,,,,,,,,,,,,,,,,,,,,,,57.0,al ALB,MF,24.0,5.6,0.0,0.0,0.0,11.0,13.0,0.0,6.0,11.0,8.0,0.0,0.0,0.0,25.0,5.0,9.0,35.7,Matches,57.0,al ALB,MF,24.0,5.6,267.0,260.0,7.0,3.0,0.0,2.0,6.0,0.0,1.0,1.0,0.0,0.0,221.0,0.0,6.0,Matches,57.0,al ALB,MF,24.0,5.6,221.0,267.0,82.8,3777.0,1040.0,106.0,122.0,86.9,93.0,104.0,89.4,20.0,31.0,64.5,1.0,0.2,0.2,0.8,3.0,25.0,1.0,0.0,28.0,Matches,69,al ALB,MF,24,18,503.0,28.0,14.7,5.6,4,60.0,0,14,19.0,7,0.89,5.0,12.0,-7.0,-1.25,-0.94,6.2,10.4,-4.2,-0.75,-0.52,Matches,57.0,al ALB,MF,24.0,5.6,336.0,15.0,67.0,207.0,62.0,5.0,336.0,6.0,2.0,33.3,3.0,50.0,181.0,1012.0,439.0,6.0,13.0,1.0,6.0,3.0,214.0,11.0,Matches,57.0,al ALB,MF,24.0,5.6,0.0,5.0,3.0,60.0,0.89,0.54,0.0,0.0,17.9,0.0,0.0,0.0,0.6,0.6,0.12,-0.6,-0.6,Matches,57.0,al ALB,MF,24.0,18.0,4.0,503.0,5.6,0.0,1.0,1.0,0.0,0.0,0.0,0.0,0.0,0.6,0.6,0.2,0.8,6.0,28.0,11.0,0.0,0.18,0.18,0.0,0.18,0.1,0.04,0.14,0.1,0.14,Matches,Keidi Bare,DM/M C,24,124,137,Albania,Espanyol,8,13,13,11,13,8,11,11,7,13,13,9,12,13,13,13,14,12,10,12,12,13,10,8,12,12,13,15,14,14,13,8,13,13,13,11,13,15,13,5,11,1,1,3,3,1,1,3,1,3,3,1,9,14,12,12,11,13,7,10,1,1,1,1,1,1,18,1,20,10,1,12,7,1,174,66,10,20,2537949,6200,5560,4708,Northern_European,124,3,1997/8/28,21,2,6377.0,,67228750
353,Ander Barrenetxea,Real Sociedad,2001,59.0,es ESP,FWDF,20.0,9.8,21.0,15.0,15.0,6.0,0.0,12.0,28.0,42.9,16.0,15.0,1.0,14.0,5.0,26.0,7.0,0.0,Matches,59.0,es ESP,FWDF,20.0,9.8,28.0,2.87,22.0,0.0,2.0,2.0,2.0,0.0,2.0,0.21,1.0,0.0,1.0,0.0,0.0,0.0,Matches,,,,,,,,,,,,,,,,,,,,,,,,,,,,,,,,,,,,,,,,,,,,,,,,,,,,,,,,59.0,es ESP,FWDF,20.0,9.8,4.0,0.0,0.0,23.0,14.0,0.0,13.0,5.0,15.0,0.0,0.0,0.0,74.0,11.0,15.0,42.3,Matches,59.0,es ESP,FWDF,20.0,9.8,376.0,343.0,32.0,5.0,1.0,1.0,13.0,25.0,2.0,0.0,0.0,0.0,288.0,1.0,19.0,Matches,59.0,es ESP,FWDF,20.0,9.8,288.0,376.0,76.6,4302.0,1117.0,162.0,187.0,86.6,95.0,113.0,84.1,19.0,33.0,57.6,1.0,1.2,1.1,-0.2,9.0,14.0,9.0,1.0,27.0,Matches,71,es ESP,FWDF,20,23,878.0,38.0,25.7,9.8,9,65.0,0,14,21.0,5,2.0,14.0,5.0,9.0,0.92,0.67,14.7,8.3,6.4,0.65,0.18,Matches,59.0,es ESP,FWDF,20.0,9.8,544.0,14.0,110.0,213.0,232.0,41.0,544.0,63.0,34.0,54.0,25.0,39.7,328.0,2099.0,994.0,36.0,15.0,17.0,36.0,18.0,348.0,72.0,Matches,59.0,es ESP,FWDF,20.0,9.8,3.0,18.0,12.0,66.7,1.85,1.23,0.17,0.25,14.9,2.0,0.0,0.0,3.0,3.0,0.17,0.0,0.0,Matches,59.0,es ESP,FWDF,20.0,23.0,9.0,878.0,9.8,3.0,1.0,4.0,3.0,0.0,0.0,4.0,0.0,3.0,3.0,1.2,4.2,36.0,27.0,72.0,0.31,0.1,0.41,0.31,0.41,0.31,0.12,0.43,0.31,0.43,Matches,Ander Barrenetxea,M/AM RL,20,141,154,"Spain,Pays Basque",Real San Sebastián,12,14,15,12,12,8,8,11,7,8,13,14,8,15,9,12,10,12,14,15,13,12,14,10,15,8,14,12,14,14,15,9,14,15,11,16,12,7,11,11,15,2,3,2,1,3,3,3,2,2,1,3,15,14,3,16,13,14,13,9,1,11,1,10,12,11,1,16,1,16,20,11,18,12,178,74,12,20,36877501,7050,7050,4600,Mediterranean_Hispanic,139,5,2001/12/27,0,0,24633.0,,67276482
354,Pablo Barrios,Atlético Madrid,2003,60.0,es ESP,MF,19.0,8.0,19.0,10.0,3.0,10.0,6.0,8.0,15.0,53.3,7.0,12.0,2.0,10.0,9.0,28.0,6.0,1.0,Matches,60.0,es ESP,MF,19.0,8.0,20.0,2.48,17.0,0.0,0.0,2.0,1.0,0.0,2.0,0.25,1.0,0.0,0.0,1.0,0.0,0.0,Matches,,,,,,,,,,,,,,,,,,,,,,,,,,,,,,,,,,,,,,,,,,,,,,,,,,,,,,,,60.0,es ESP,MF,19.0,8.0,4.0,0.0,0.0,7.0,12.0,0.0,6.0,9.0,10.0,0.0,0.0,0.0,49.0,6.0,9.0,40.0,Matches,60.0,es ESP,MF,19.0,8.0,450.0,438.0,9.0,7.0,1.0,5.0,6.0,2.0,0.0,0.0,0.0,0.0,368.0,3.0,12.0,Matches,60.0,es ESP,MF,19.0,8.0,368.0,450.0,81.8,5684.0,1671.0,198.0,217.0,91.2,134.0,161.0,83.2,22.0,38.0,57.9,1.0,0.7,0.5,0.3,4.0,46.0,3.0,0.0,51.0,Matches,72,es ESP,MF,19,21,724.0,34.0,21.2,8.0,6,64.0,1,15,23.0,5,2.05,13.0,9.0,4.0,0.5,-0.6,13.7,10.4,3.4,0.42,-0.16,Matches,60.0,es ESP,MF,19.0,8.0,554.0,12.0,106.0,314.0,140.0,12.0,554.0,30.0,15.0,50.0,12.0,40.0,320.0,1795.0,690.0,16.0,10.0,3.0,15.0,10.0,405.0,27.0,Matches,60.0,es ESP,MF,19.0,8.0,0.0,12.0,3.0,25.0,1.49,0.37,0.0,0.0,21.7,0.0,0.0,0.0,0.5,0.5,0.04,-0.5,-0.5,Matches,60.0,es ESP,MF,19.0,21.0,6.0,724.0,8.0,0.0,1.0,1.0,0.0,0.0,0.0,4.0,0.0,0.5,0.5,0.7,1.2,16.0,51.0,27.0,0.0,0.12,0.12,0.0,0.12,0.07,0.08,0.15,0.07,0.15,Matches,Pablo Barrios,M C,19,105,-8,Spain,A. Madrid,8,8,6,9,14,8,8,8,4,11,14,7,8,14,6,7,7,9,10,12,12,8,5,8,9,7,9,13,14,14,9,10,5,14,9,9,9,7,14,9,14,3,1,1,3,1,3,3,2,1,2,3,14,11,1,11,11,13,12,16,1,1,1,1,1,1,14,1,20,1,1,1,1,1,181,0,8,20,21960001,5250,5250,2250,Mediterranean_Hispanic,94,4,2003/6/15,0,0,1944.0,,2000125958
355,Rodrigo Battaglia,Mallorca,1991,61.0,ar ARG,MF,31.0,7.6,12.0,5.0,7.0,5.0,0.0,6.0,14.0,42.9,8.0,16.0,7.0,9.0,5.0,17.0,18.0,0.0,Matches,61.0,ar ARG,MF,31.0,7.6,4.0,0.53,3.0,0.0,0.0,0.0,1.0,0.0,0.0,0.0,0.0,0.0,0.0,0.0,0.0,0.0,Matches,,,,,,,,,,,,,,,,,,,,,,,,,,,,,,,,,,,,,,,,,,,,,,,,,,,,,,,,61.0,ar ARG,MF,31.0,7.6,5.0,0.0,0.0,11.0,11.0,0.0,1.0,5.0,5.0,0.0,2.0,0.0,29.0,11.0,8.0,57.9,Matches,61.0,ar ARG,MF,31.0,7.6,232.0,224.0,6.0,6.0,0.0,2.0,1.0,0.0,0.0,0.0,0.0,0.0,185.0,2.0,4.0,Matches,61.0,ar ARG,MF,31.0,7.6,185.0,232.0,79.7,2885.0,894.0,93.0,106.0,87.7,78.0,93.0,83.9,11.0,20.0,55.0,0.0,0.0,0.1,0.0,1.0,24.0,1.0,0.0,19.0,Matches,74,ar ARG,MF,31,15,686.0,46.0,20.1,7.6,8,73.0,2,7,14.0,9,1.47,5.0,7.0,-2.0,-0.26,-0.13,4.6,11.2,-6.7,-0.88,-0.72,Matches,61.0,ar ARG,MF,31.0,7.6,310.0,28.0,114.0,170.0,27.0,6.0,310.0,3.0,0.0,0.0,1.0,33.3,136.0,665.0,268.0,3.0,4.0,0.0,5.0,6.0,164.0,3.0,Matches,61.0,ar ARG,MF,31.0,7.6,0.0,2.0,0.0,0.0,0.26,0.0,0.0,,18.0,0.0,0.0,0.0,0.2,0.2,0.08,-0.2,-0.2,Matches,61.0,ar ARG,MF,31.0,15.0,8.0,686.0,7.6,0.0,0.0,0.0,0.0,0.0,0.0,5.0,0.0,0.2,0.2,0.0,0.2,3.0,19.0,3.0,0.0,0.0,0.0,0.0,0.0,0.02,0.01,0.03,0.02,0.03,Matches,Rodrigo Battaglia,DM/M C,31,128,142,"Argentina,Italy",Mallorca,6,8,11,8,12,7,11,11,6,13,13,10,14,11,17,13,15,11,16,12,12,15,13,14,12,14,16,16,11,12,13,15,8,12,12,14,14,14,12,14,18,1,1,2,1,3,3,2,2,1,2,1,13,13,14,16,12,15,13,12,1,1,1,13,1,12,20,1,20,12,1,1,1,1,187,79,12,20,347975206,6400,5752,4501,Mediterranean_Hispanic,128,7,1991/7/12,2,0,26786.0,,14025385
356,Héctor Bellerín,Barcelona,1995,63.0,es ESP,DF,27.0,1.6,2.0,0.0,0.0,2.0,0.0,2.0,3.0,66.7,1.0,2.0,0.0,2.0,3.0,5.0,2.0,0.0,Matches,63.0,es ESP,DF,27.0,1.6,5.0,3.15,5.0,0.0,0.0,0.0,0.0,0.0,0.0,0.0,0.0,0.0,0.0,0.0,0.0,0.0,Matches,,,,,,,,,,,,,,,,,,,,,,,,,,,,,,,,,,,,,,,,,,,,,,,,,,,,,,,,63.0,es ESP,DF,27.0,1.6,0.0,0.0,0.0,2.0,0.0,0.0,3.0,3.0,0.0,0.0,0.0,0.0,10.0,3.0,0.0,100.0,Matches,63.0,es ESP,DF,27.0,1.6,96.0,82.0,13.0,1.0,1.0,0.0,3.0,12.0,0.0,0.0,0.0,0.0,77.0,1.0,3.0,Matches,63.0,es ESP,DF,27.0,1.6,77.0,96.0,80.2,1146.0,419.0,48.0,52.0,92.3,21.0,25.0,84.0,5.0,8.0,62.5,0.0,0.1,0.5,-0.1,1.0,10.0,4.0,0.0,13.0,Matches,76,es ESP,DF,27,3,143.0,48.0,4.2,1.6,1,90.0,1,2,27.0,8,3.0,4.0,0.0,4.0,2.52,1.25,5.4,0.6,4.7,2.98,1.95,Matches,63.0,es ESP,DF,27.0,1.6,107.0,1.0,17.0,50.0,41.0,5.0,107.0,4.0,3.0,75.0,1.0,25.0,54.0,271.0,159.0,2.0,3.0,1.0,1.0,0.0,66.0,6.0,Matches,63.0,es ESP,DF,27.0,1.6,0.0,0.0,0.0,,0.0,0.0,,,,0.0,0.0,0.0,0.0,0.0,,0.0,0.0,Matches,63.0,es ESP,DF,27.0,3.0,1.0,143.0,1.6,0.0,0.0,0.0,0.0,0.0,0.0,0.0,0.0,0.0,0.0,0.1,0.1,2.0,13.0,6.0,0.0,0.0,0.0,0.0,0.0,0.0,0.06,0.06,0.0,0.06,Matches,Héctor Bellerín,D/WB R,27,143,162,Spain,Barcelona,7,12,13,9,12,5,10,10,12,12,11,8,14,13,12,14,15,13,13,10,14,13,12,12,14,12,15,15,16,14,15,9,16,16,15,10,14,8,14,8,14,2,1,2,1,1,2,3,2,3,3,1,15,14,5,14,14,14,15,15,1,1,1,20,1,19,1,1,1,10,1,1,8,1,177,74,10,20,9034927,7100,7100,6750,Mediterranean_Hispanic,139,7,1995/3/19,4,0,86994.0,,28066082
357,Antonio Blanco,Cádiz,2000,71.0,es ESP,MF,22.0,1.8,6.0,4.0,5.0,1.0,0.0,4.0,6.0,66.7,2.0,5.0,0.0,5.0,1.0,7.0,3.0,0.0,Matches,71.0,es ESP,MF,22.0,1.8,2.0,1.14,2.0,0.0,0.0,0.0,0.0,0.0,0.0,0.0,0.0,0.0,0.0,0.0,0.0,0.0,Matches,,,,,,,,,,,,,,,,,,,,,,,,,,,,,,,,,,,,,,,,,,,,,,,,,,,,,,,,71.0,es ESP,MF,22.0,1.8,0.0,0.0,0.0,2.0,1.0,0.0,0.0,1.0,4.0,0.0,0.0,0.0,7.0,3.0,0.0,100.0,Matches,71.0,es ESP,MF,22.0,1.8,61.0,61.0,0.0,0.0,0.0,1.0,0.0,0.0,0.0,0.0,0.0,0.0,57.0,0.0,0.0,Matches,71.0,es ESP,MF,22.0,1.8,57.0,61.0,93.4,818.0,137.0,31.0,33.0,93.9,22.0,24.0,91.7,1.0,1.0,100.0,0.0,0.0,0.1,0.0,1.0,3.0,1.0,0.0,2.0,Matches,87,es ESP,MF,22,3,158.0,53.0,4.6,1.8,2,67.0,0,1,25.0,9,0.0,1.0,6.0,-5.0,-2.85,-2.35,0.6,3.4,-2.8,-1.57,-1.09,Matches,71.0,es ESP,MF,22.0,1.8,82.0,4.0,20.0,46.0,16.0,0.0,82.0,1.0,0.0,0.0,1.0,100.0,40.0,166.0,57.0,1.0,1.0,0.0,2.0,3.0,53.0,2.0,Matches,71.0,es ESP,MF,22.0,1.8,0.0,0.0,0.0,,0.0,0.0,,,,0.0,0.0,0.0,0.0,0.0,,0.0,0.0,Matches,71.0,es ESP,MF,22.0,3.0,2.0,158.0,1.8,0.0,0.0,0.0,0.0,0.0,0.0,0.0,0.0,0.0,0.0,0.0,0.0,1.0,2.0,2.0,0.0,0.0,0.0,0.0,0.0,0.0,0.01,0.01,0.0,0.01,Matches,Antonio Blanco,DM/M C,22,124,160,Spain,R. Madrid,9,10,8,7,12,11,13,10,11,13,13,7,13,13,10,14,12,12,13,12,13,17,9,15,14,14,15,14,13,12,11,9,15,12,14,13,15,7,16,5,12,4,3,1,1,3,1,2,2,2,3,3,12,14,5,11,12,12,15,14,1,1,1,1,1,1,16,1,20,1,1,1,1,1,175,63,10,20,11309999,6200,6200,3002,Mediterranean_Hispanic,125,3,2000/7/23,1,0,7530.0,Cádiz,67256515
358,Lautaro Blanco,Elche,1999,72.0,ar ARG,DFMF,23.0,9.7,16.0,9.0,10.0,4.0,2.0,9.0,26.0,34.6,17.0,8.0,1.0,7.0,2.0,18.0,10.0,1.0,Matches,72.0,ar ARG,DFMF,23.0,9.7,23.0,2.37,17.0,2.0,3.0,0.0,0.0,1.0,2.0,0.21,2.0,0.0,0.0,0.0,0.0,0.0,Matches,,,,,,,,,,,,,,,,,,,,,,,,,,,,,,,,,,,,,,,,,,,,,,,,,,,,,,,,72.0,ar ARG,DFMF,23.0,9.7,2.0,0.0,0.0,7.0,2.0,2.0,86.0,2.0,9.0,0.0,0.0,0.0,49.0,0.0,8.0,0.0,Matches,72.0,ar ARG,DFMF,23.0,9.7,416.0,331.0,83.0,2.0,0.0,3.0,86.0,80.0,1.0,0.0,0.0,1.0,235.0,2.0,17.0,Matches,72.0,ar ARG,DFMF,23.0,9.7,235.0,416.0,56.5,4363.0,2284.0,117.0,141.0,83.0,85.0,139.0,61.2,32.0,107.0,29.9,2.0,1.5,1.3,0.5,12.0,19.0,17.0,10.0,28.0,Matches,88,ar ARG,DFMF,23,17,872.0,51.0,25.5,9.7,9,70.0,2,8,31.0,6,1.0,9.0,16.0,-7.0,-0.72,0.34,11.0,18.0,-7.0,-0.72,0.18,Matches,72.0,ar ARG,DFMF,23.0,9.7,494.0,12.0,127.0,163.0,209.0,6.0,494.0,23.0,10.0,43.5,13.0,56.5,261.0,1869.0,890.0,41.0,20.0,1.0,12.0,3.0,281.0,76.0,Matches,72.0,ar ARG,DFMF,23.0,9.7,0.0,1.0,1.0,100.0,0.1,0.1,0.0,0.0,21.7,0.0,0.0,0.0,0.0,0.0,0.03,0.0,0.0,Matches,72.0,ar ARG,DFMF,23.0,17.0,9.0,872.0,9.7,0.0,2.0,2.0,0.0,0.0,0.0,2.0,0.0,0.0,0.0,1.5,1.6,41.0,28.0,76.0,0.0,0.21,0.21,0.0,0.21,0.0,0.16,0.16,0.0,0.16,Matches,Lautaro Blanco,D/WB L,23,127,139,Argentina,Elche,13,13,12,10,13,7,10,9,12,13,13,9,13,13,12,13,12,12,14,13,14,13,8,14,13,13,13,13,14,12,12,8,13,13,13,12,14,13,12,5,11,3,1,1,1,2,3,1,3,3,3,3,8,13,9,12,12,12,12,13,1,20,1,1,18,1,1,15,1,1,1,1,1,1,176,81,20,8,3442072,6500,6500,3700,Mediterranean_Hispanic,128,2,1999/2/19,0,0,2471.0,Club Atlético Rosario Central,14207517
359,Alexander Callens,Girona,1992,86.0,pe PER,DF,30.0,1.3,3.0,3.0,2.0,1.0,0.0,3.0,4.0,75.0,1.0,3.0,1.0,2.0,1.0,4.0,9.0,0.0,Matches,86.0,pe PER,DF,30.0,1.3,1.0,0.75,1.0,0.0,0.0,0.0,0.0,0.0,0.0,0.0,0.0,0.0,0.0,0.0,0.0,0.0,Matches,,,,,,,,,,,,,,,,,,,,,,,,,,,,,,,,,,,,,,,,,,,,,,,,,,,,,,,,86.0,pe PER,DF,30.0,1.3,1.0,0.0,0.0,3.0,1.0,0.0,0.0,1.0,3.0,0.0,0.0,0.0,9.0,0.0,1.0,0.0,Matches,86.0,pe PER,DF,30.0,1.3,93.0,81.0,12.0,2.0,0.0,0.0,0.0,10.0,0.0,0.0,0.0,0.0,78.0,0.0,0.0,Matches,86.0,pe PER,DF,30.0,1.3,78.0,93.0,83.9,1206.0,505.0,35.0,40.0,87.5,38.0,47.0,80.9,1.0,2.0,50.0,0.0,0.0,0.0,0.0,0.0,5.0,1.0,0.0,6.0,Matches,103,pe PER,DF,30,6,120.0,20.0,3.5,1.3,0,,0,6,20.0,7,1.83,1.0,0.0,1.0,0.75,0.7,1.2,2.1,-0.9,-0.66,-0.57,Matches,86.0,pe PER,DF,30.0,1.3,111.0,11.0,53.0,53.0,5.0,0.0,111.0,0.0,0.0,,0.0,,76.0,361.0,213.0,5.0,3.0,0.0,2.0,1.0,72.0,1.0,Matches,86.0,pe PER,DF,30.0,1.3,0.0,0.0,0.0,,0.0,0.0,,,,0.0,0.0,0.0,0.0,0.0,,0.0,0.0,Matches,86.0,pe PER,DF,30.0,6.0,0.0,120.0,1.3,0.0,0.0,0.0,0.0,0.0,0.0,1.0,0.0,0.0,0.0,0.0,0.0,5.0,6.0,1.0,0.0,0.0,0.0,0.0,0.0,0.0,0.0,0.0,0.0,0.0,Matches,Alexander Callens,D LC,30,123,125,"Peru,Spain,United States",New York City FC,6,6,8,8,9,4,13,6,10,14,12,12,13,10,14,14,14,11,12,8,11,10,9,13,7,13,13,14,12,13,12,14,13,13,15,15,12,12,12,8,13,3,1,1,2,1,3,2,1,3,1,3,13,13,6,11,9,11,8,13,1,15,20,1,1,1,1,1,1,1,1,1,1,1,186,82,20,7,808736,6092,5911,4715,African_Caribbean,123,12,1992/5/4,33,1,14813.0,,77012995
360,Ander Capa,Athletic Club,1992,90.0,es ESP,DF,30.0,1.2,1.0,1.0,1.0,0.0,0.0,1.0,5.0,20.0,4.0,5.0,0.0,5.0,0.0,1.0,2.0,0.0,Matches,90.0,es ESP,DF,30.0,1.2,5.0,4.17,5.0,0.0,0.0,0.0,0.0,0.0,0.0,0.0,0.0,0.0,0.0,0.0,0.0,0.0,Matches,,,,,,,,,,,,,,,,,,,,,,,,,,,,,,,,,,,,,,,,,,,,,,,,,,,,,,,,90.0,es ESP,DF,30.0,1.2,1.0,0.0,0.0,4.0,0.0,0.0,4.0,0.0,1.0,0.0,0.0,0.0,10.0,4.0,0.0,100.0,Matches,90.0,es ESP,DF,30.0,1.2,91.0,67.0,22.0,1.0,0.0,1.0,4.0,21.0,0.0,0.0,0.0,0.0,74.0,2.0,0.0,Matches,90.0,es ESP,DF,30.0,1.2,74.0,91.0,81.3,1275.0,441.0,31.0,35.0,88.6,30.0,37.0,81.1,8.0,12.0,66.7,0.0,0.0,0.1,0.0,1.0,5.0,2.0,1.0,12.0,Matches,109,es ESP,DF,30,7,109.0,16.0,3.2,1.2,1,61.0,0,6,8.0,27,1.43,2.0,0.0,2.0,1.65,1.6,2.3,1.2,1.1,0.91,0.47,Matches,90.0,es ESP,DF,30.0,1.2,110.0,2.0,24.0,50.0,37.0,2.0,110.0,3.0,2.0,66.7,1.0,33.3,53.0,406.0,193.0,5.0,9.0,1.0,3.0,2.0,56.0,7.0,Matches,90.0,es ESP,DF,30.0,1.2,0.0,0.0,0.0,,0.0,0.0,,,,0.0,0.0,0.0,0.0,0.0,,0.0,0.0,Matches,90.0,es ESP,DF,30.0,7.0,1.0,109.0,1.2,0.0,0.0,0.0,0.0,0.0,0.0,1.0,0.0,0.0,0.0,0.0,0.0,5.0,12.0,7.0,0.0,0.0,0.0,0.0,0.0,0.0,0.04,0.04,0.0,0.04,Matches,Ander Capa,D/WB R,30,140,145,"Spain,Pays Basque",A. Bilbao,10,14,13,10,12,8,8,9,12,12,13,11,13,13,11,14,12,14,14,10,13,14,13,11,14,13,15,14,14,14,12,8,13,14,14,13,12,8,15,7,14,1,2,3,3,1,3,3,3,2,2,1,11,13,6,16,12,16,11,11,1,1,1,20,1,19,1,10,1,15,10,1,15,1,175,76,11,20,34345828,7000,7000,5500,Mediterranean_Hispanic,134,4,1992/2/8,0,0,22385.0,,67187680
361,José Carlos Lazo,Almería,1996,94.0,es ESP,MFFW,26.0,0.2,0.0,0.0,0.0,0.0,0.0,0.0,0.0,,0.0,0.0,0.0,0.0,0.0,0.0,0.0,0.0,Matches,94.0,es ESP,MFFW,26.0,0.2,3.0,13.5,1.0,0.0,0.0,1.0,1.0,0.0,0.0,0.0,0.0,0.0,0.0,0.0,0.0,0.0,Matches,,,,,,,,,,,,,,,,,,,,,,,,,,,,,,,,,,,,,,,,,,,,,,,,,,,,,,,,94.0,es ESP,MFFW,26.0,0.2,0.0,0.0,0.0,1.0,1.0,0.0,0.0,0.0,0.0,0.0,0.0,0.0,1.0,0.0,0.0,,Matches,94.0,es ESP,MFFW,26.0,0.2,4.0,4.0,0.0,0.0,0.0,0.0,0.0,0.0,0.0,0.0,0.0,0.0,3.0,0.0,0.0,Matches,94.0,es ESP,MFFW,26.0,0.2,3.0,4.0,75.0,49.0,2.0,2.0,3.0,66.7,1.0,1.0,100.0,0.0,0.0,,0.0,0.0,0.0,0.0,0.0,0.0,0.0,0.0,0.0,Matches,114,es ESP,MFFW,26,1,20.0,20.0,0.6,0.2,0,,0,1,20.0,1,0.0,0.0,1.0,-1.0,-4.5,-4.1,0.4,0.1,0.3,1.19,1.64,Matches,94.0,es ESP,MFFW,26.0,0.2,8.0,0.0,1.0,2.0,5.0,1.0,8.0,1.0,1.0,100.0,0.0,0.0,7.0,44.0,9.0,0.0,0.0,0.0,2.0,0.0,7.0,3.0,Matches,94.0,es ESP,MFFW,26.0,0.2,0.0,2.0,1.0,50.0,9.0,4.5,0.0,0.0,24.4,0.0,0.0,0.0,0.1,0.1,0.03,-0.1,-0.1,Matches,94.0,es ESP,MFFW,26.0,1.0,0.0,20.0,0.2,0.0,0.0,0.0,0.0,0.0,0.0,0.0,0.0,0.1,0.1,0.0,0.1,0.0,0.0,3.0,0.0,0.0,0.0,0.0,0.0,0.27,0.0,0.27,0.27,0.27,Matches,José Carlos Lazo,M/AM RLC,26,127,136,Spain,Espanyol,11,12,15,15,15,15,6,13,11,5,12,9,5,16,9,11,10,11,9,14,11,15,16,12,12,6,8,7,14,16,13,6,12,15,7,6,9,12,14,12,19,1,3,3,2,3,1,1,2,3,3,1,20,9,1,12,13,13,11,19,1,1,1,1,1,1,1,17,10,15,20,18,16,1,180,69,16,20,2968361,6250,6250,4250,Mediterranean_Hispanic,124,6,1996/2/16,0,0,7029.0,,67211906
362,Casemiro,Real Madrid,1992,101.0,br BRA,MF,30.0,0.1,0.0,0.0,0.0,0.0,0.0,0.0,0.0,,0.0,0.0,0.0,0.0,0.0,0.0,1.0,0.0,Matches,101.0,br BRA,MF,30.0,0.1,0.0,0.0,0.0,0.0,0.0,0.0,0.0,0.0,0.0,0.0,0.0,0.0,0.0,0.0,0.0,0.0,Matches,,,,,,,,,,,,,,,,,,,,,,,,,,,,,,,,,,,,,,,,,,,,,,,,,,,,,,,,101.0,br BRA,MF,30.0,0.1,0.0,0.0,0.0,1.0,0.0,0.0,0.0,0.0,0.0,0.0,0.0,0.0,1.0,0.0,0.0,,Matches,101.0,br BRA,MF,30.0,0.1,8.0,8.0,0.0,0.0,0.0,1.0,0.0,0.0,0.0,0.0,0.0,0.0,7.0,0.0,0.0,Matches,101.0,br BRA,MF,30.0,0.1,7.0,8.0,87.5,134.0,50.0,6.0,6.0,100.0,0.0,0.0,,1.0,2.0,50.0,0.0,0.0,0.0,0.0,0.0,1.0,0.0,0.0,0.0,Matches,124,br BRA,MF,30,1,8.0,8.0,0.2,0.1,0,,0,1,8.0,0,3.0,0.0,0.0,0.0,0.0,-1.03,0.0,0.3,-0.3,-3.45,-4.42,Matches,101.0,br BRA,MF,30.0,0.1,11.0,1.0,3.0,8.0,0.0,0.0,11.0,0.0,0.0,,0.0,,7.0,20.0,6.0,0.0,0.0,0.0,1.0,0.0,7.0,0.0,Matches,101.0,br BRA,MF,30.0,0.1,0.0,0.0,0.0,,0.0,0.0,,,,0.0,0.0,0.0,0.0,0.0,,0.0,0.0,Matches,101.0,br BRA,MF,30.0,1.0,0.0,8.0,0.1,0.0,0.0,0.0,0.0,0.0,0.0,0.0,0.0,0.0,0.0,0.0,0.0,0.0,0.0,0.0,0.0,0.0,0.0,0.0,0.0,0.0,0.0,0.0,0.0,0.0,Matches,Casemiro,DM/M C,30,161,170,"Brazil,Spain",Manchester UFC,10,11,12,11,14,10,13,14,10,14,14,11,15,14,18,14,16,15,14,12,15,17,12,15,12,18,17,18,11,12,15,13,15,12,17,17,14,17,15,5,12,2,1,1,2,1,2,1,1,2,2,1,13,15,14,10,15,16,10,11,1,1,9,1,1,1,20,1,19,1,1,1,1,1,185,84,13,20,209616868,8050,8500,7600,Mixed_Race,161,13,1992/2/23,63,5,347975.0,,19061518
363,Pep Chavarría,Rayo Vallecano,1998,109.0,es ESP,FWMF,24.0,4.1,6.0,4.0,2.0,1.0,3.0,1.0,5.0,20.0,4.0,8.0,0.0,8.0,2.0,8.0,8.0,0.0,Matches,109.0,es ESP,FWMF,24.0,4.1,19.0,4.68,15.0,4.0,0.0,0.0,0.0,0.0,2.0,0.49,2.0,0.0,0.0,0.0,0.0,0.0,Matches,,,,,,,,,,,,,,,,,,,,,,,,,,,,,,,,,,,,,,,,,,,,,,,,,,,,,,,,109.0,es ESP,FWMF,24.0,4.1,1.0,0.0,0.0,11.0,4.0,1.0,13.0,2.0,4.0,0.0,0.0,0.0,27.0,8.0,3.0,72.7,Matches,109.0,es ESP,FWMF,24.0,4.1,178.0,155.0,22.0,0.0,1.0,3.0,13.0,19.0,2.0,0.0,1.0,0.0,126.0,1.0,12.0,Matches,109.0,es ESP,FWMF,24.0,4.1,126.0,178.0,70.8,1933.0,743.0,65.0,77.0,84.4,45.0,57.0,78.9,8.0,18.0,44.4,2.0,0.7,0.5,1.3,11.0,7.0,8.0,2.0,19.0,Matches,134,es ESP,FWMF,24,16,366.0,23.0,10.7,4.1,2,68.0,0,14,17.0,18,1.75,7.0,7.0,0.0,0.0,0.24,5.6,4.6,1.0,0.24,0.46,Matches,109.0,es ESP,FWMF,24.0,4.1,229.0,8.0,37.0,75.0,120.0,8.0,229.0,16.0,7.0,43.8,8.0,50.0,113.0,658.0,365.0,13.0,6.0,1.0,7.0,4.0,122.0,25.0,Matches,109.0,es ESP,FWMF,24.0,4.1,0.0,2.0,0.0,0.0,0.49,0.0,0.0,,18.2,0.0,0.0,0.0,0.1,0.1,0.03,-0.1,-0.1,Matches,109.0,es ESP,FWMF,24.0,16.0,2.0,366.0,4.1,0.0,2.0,2.0,0.0,0.0,0.0,1.0,0.0,0.1,0.1,0.7,0.8,13.0,19.0,25.0,0.0,0.49,0.49,0.0,0.49,0.02,0.17,0.19,0.02,0.19,Matches,Pep Chavarría,D/WB/M L,24,126,136,Spain,Vallecano,11,13,13,5,13,8,8,7,9,12,12,7,13,13,12,10,13,13,11,11,13,6,9,10,13,11,13,13,15,15,12,11,14,15,14,9,13,8,11,7,10,3,2,3,2,3,2,1,2,2,3,3,12,13,7,11,11,13,12,12,1,20,1,1,18,1,1,17,1,1,10,1,1,1,174,72,20,7,2220334,6300,6300,4300,Mediterranean_Hispanic,121,1,1998/4/10,0,0,7258.0,,67277695
364,Álex Collado,Elche,1999,116.0,es ESP,MF,23.0,8.1,26.0,14.0,13.0,11.0,2.0,8.0,13.0,61.5,5.0,12.0,1.0,11.0,2.0,28.0,4.0,0.0,Matches,116.0,es ESP,MF,23.0,8.1,35.0,4.36,25.0,6.0,0.0,3.0,1.0,0.0,2.0,0.25,2.0,0.0,0.0,0.0,0.0,0.0,Matches,,,,,,,,,,,,,,,,,,,,,,,,,,,,,,,,,,,,,,,,,,,,,,,,,,,,,,,,116.0,es ESP,MF,23.0,8.1,1.0,0.0,0.0,9.0,10.0,1.0,18.0,2.0,14.0,0.0,0.0,0.0,33.0,4.0,8.0,33.3,Matches,116.0,es ESP,MF,23.0,8.1,336.0,317.0,19.0,3.0,1.0,5.0,18.0,4.0,12.0,7.0,1.0,0.0,276.0,0.0,13.0,Matches,116.0,es ESP,MF,23.0,8.1,276.0,336.0,82.1,4177.0,909.0,164.0,177.0,92.7,77.0,92.0,83.7,24.0,36.0,66.7,1.0,1.6,1.6,-0.6,20.0,25.0,10.0,2.0,34.0,Matches,142,es ESP,MF,23,16,729.0,46.0,21.3,8.1,8,64.0,2,8,27.0,11,0.5,6.0,17.0,-11.0,-1.36,-0.49,6.9,13.4,-6.5,-0.8,0.07,Matches,116.0,es ESP,MF,23.0,8.1,442.0,10.0,58.0,202.0,189.0,19.0,442.0,31.0,15.0,48.4,15.0,48.4,294.0,2052.0,943.0,24.0,23.0,6.0,16.0,9.0,334.0,43.0,Matches,116.0,es ESP,MF,23.0,8.1,1.0,17.0,6.0,35.3,2.1,0.74,0.06,0.17,22.9,0.0,0.0,0.0,0.6,0.6,0.04,0.4,0.4,Matches,116.0,es ESP,MF,23.0,16.0,8.0,729.0,8.1,1.0,1.0,2.0,1.0,0.0,0.0,1.0,0.0,0.6,0.6,1.6,2.2,24.0,34.0,43.0,0.12,0.12,0.25,0.12,0.25,0.08,0.2,0.28,0.08,0.28,Matches,Álex Collado,M/AM RLC,23,130,144,Spain,Barcelona,13,13,16,11,15,14,8,13,6,6,14,13,7,16,8,9,13,13,11,14,13,16,17,11,15,6,9,7,14,14,13,8,14,13,12,8,15,7,15,8,15,3,2,3,2,3,1,4,3,2,2,2,10,15,5,15,16,15,11,15,1,10,1,1,12,1,1,16,18,17,18,19,20,1,173,66,20,8,4280500,6500,6500,4050,Mediterranean_Hispanic,124,5,1999/4/22,0,0,17299.0,Elche,67246435
365,Diego Collado,Villarreal,2001,117.0,es ESP,FW,21.0,0.1,0.0,0.0,0.0,0.0,0.0,0.0,0.0,,0.0,0.0,0.0,0.0,0.0,0.0,0.0,0.0,Matches,117.0,es ESP,FW,21.0,0.1,0.0,0.0,0.0,0.0,0.0,0.0,0.0,0.0,0.0,0.0,0.0,0.0,0.0,0.0,0.0,0.0,Matches,,,,,,,,,,,,,,,,,,,,,,,,,,,,,,,,,,,,,,,,,,,,,,,,,,,,,,,,117.0,es ESP,FW,21.0,0.1,0.0,0.0,0.0,0.0,0.0,0.0,2.0,0.0,0.0,0.0,0.0,0.0,0.0,0.0,0.0,,Matches,117.0,es ESP,FW,21.0,0.1,7.0,7.0,0.0,0.0,0.0,0.0,2.0,0.0,0.0,0.0,0.0,0.0,5.0,0.0,1.0,Matches,117.0,es ESP,FW,21.0,0.1,5.0,7.0,71.4,111.0,15.0,2.0,3.0,66.7,2.0,2.0,100.0,1.0,1.0,100.0,0.0,0.0,0.0,0.0,0.0,0.0,0.0,0.0,1.0,Matches,143,es ESP,FW,21,2,6.0,3.0,0.2,0.1,0,,0,2,3.0,1,1.5,1.0,0.0,1.0,15.0,14.53,1.6,0.1,1.5,22.48,22.21,Matches,117.0,es ESP,FW,21.0,0.1,8.0,0.0,0.0,2.0,6.0,1.0,8.0,0.0,0.0,,0.0,,3.0,9.0,4.0,0.0,0.0,0.0,0.0,0.0,6.0,3.0,Matches,117.0,es ESP,FW,21.0,0.1,0.0,0.0,0.0,,0.0,0.0,,,,0.0,0.0,0.0,0.0,0.0,,0.0,0.0,Matches,117.0,es ESP,FW,21.0,2.0,0.0,6.0,0.1,0.0,0.0,0.0,0.0,0.0,0.0,0.0,0.0,0.0,0.0,0.0,0.0,0.0,1.0,3.0,0.0,0.0,0.0,0.0,0.0,0.0,0.0,0.0,0.0,0.0,Matches,Diego Collado,AM/S RL,21,116,139,Spain,Villarreal,10,8,14,12,15,10,11,12,10,10,11,8,7,15,8,15,9,10,11,7,12,8,13,9,12,10,11,11,15,12,15,10,12,14,6,8,8,7,14,5,13,3,4,3,2,2,3,2,3,1,3,2,13,10,6,11,13,13,10,19,1,1,1,1,1,1,1,1,1,1,20,1,16,16,183,0,10,20,4039999,5400,5400,2900,Mediterranean_Hispanic,110,6,2001/1/9,0,0,1681.0,,67287668
366,Francis Coquelin,Villarreal,1991,121.0,fr FRA,MF,31.0,8.3,18.0,13.0,7.0,9.0,2.0,7.0,7.0,100.0,0.0,8.0,2.0,6.0,9.0,27.0,7.0,0.0,Matches,121.0,fr FRA,MF,31.0,8.3,9.0,1.09,8.0,0.0,0.0,0.0,0.0,1.0,0.0,0.0,0.0,0.0,0.0,0.0,0.0,0.0,Matches,,,,,,,,,,,,,,,,,,,,,,,,,,,,,,,,,,,,,,,,,,,,,,,,,,,,,,,,121.0,fr FRA,MF,31.0,8.3,2.0,0.0,0.0,11.0,7.0,0.0,5.0,9.0,13.0,0.0,0.0,0.0,36.0,6.0,4.0,60.0,Matches,121.0,fr FRA,MF,31.0,8.3,311.0,300.0,7.0,7.0,1.0,3.0,5.0,0.0,0.0,0.0,0.0,0.0,265.0,4.0,5.0,Matches,121.0,fr FRA,MF,31.0,8.3,265.0,311.0,85.2,3778.0,803.0,152.0,167.0,91.0,80.0,88.0,90.9,14.0,20.0,70.0,0.0,1.0,1.2,-1.0,6.0,19.0,3.0,1.0,29.0,Matches,149,fr FRA,MF,31,16,748.0,47.0,21.9,8.3,9,68.0,1,7,19.0,1,1.38,10.0,6.0,4.0,0.48,-0.02,11.0,11.2,-0.2,-0.02,-0.42,Matches,121.0,fr FRA,MF,31.0,8.3,391.0,17.0,63.0,224.0,107.0,18.0,391.0,6.0,2.0,33.3,2.0,33.3,200.0,885.0,399.0,11.0,11.0,1.0,18.0,14.0,286.0,27.0,Matches,121.0,fr FRA,MF,31.0,8.3,1.0,7.0,1.0,14.3,0.84,0.12,0.14,1.0,15.5,0.0,0.0,0.0,1.0,1.0,0.14,0.0,0.0,Matches,121.0,fr FRA,MF,31.0,16.0,9.0,748.0,8.3,1.0,0.0,1.0,1.0,0.0,0.0,2.0,0.0,1.0,1.0,1.0,1.9,11.0,29.0,27.0,0.12,0.0,0.12,0.12,0.12,0.12,0.12,0.23,0.12,0.23,Matches,Francis Coquelin,DM/M RC,31,143,155,"France,Réunion",Villarreal,4,9,13,7,14,4,13,11,8,13,14,8,16,13,16,15,18,13,17,12,13,17,8,12,11,14,17,15,13,13,15,10,16,13,15,14,16,13,15,14,15,1,3,1,1,2,3,2,2,2,3,3,17,14,5,14,13,17,12,12,1,8,1,8,8,8,19,8,20,17,1,1,1,1,176,74,10,20,347975206,7100,6750,6250,Mixed_Race,138,12,1991/5/13,0,0,70000.0,,34012022
367,Jesús Corona,Sevilla,1993,122.0,mx MEX,FW,29.0,1.2,1.0,0.0,1.0,0.0,0.0,0.0,1.0,0.0,1.0,0.0,0.0,0.0,1.0,2.0,1.0,0.0,Matches,122.0,mx MEX,FW,29.0,1.2,5.0,4.02,4.0,0.0,1.0,0.0,0.0,0.0,1.0,0.8,0.0,0.0,1.0,0.0,0.0,0.0,Matches,,,,,,,,,,,,,,,,,,,,,,,,,,,,,,,,,,,,,,,,,,,,,,,,,,,,,,,,122.0,mx MEX,FW,29.0,1.2,0.0,0.0,0.0,2.0,5.0,1.0,3.0,1.0,0.0,0.0,0.0,0.0,5.0,0.0,2.0,0.0,Matches,122.0,mx MEX,FW,29.0,1.2,42.0,40.0,2.0,1.0,0.0,1.0,3.0,1.0,0.0,0.0,0.0,0.0,33.0,0.0,2.0,Matches,122.0,mx MEX,FW,29.0,1.2,33.0,42.0,78.6,446.0,40.0,22.0,22.0,100.0,8.0,13.0,61.5,2.0,4.0,50.0,0.0,0.2,0.2,-0.2,3.0,1.0,2.0,0.0,3.0,Matches,150,mx MEX,FW,29,4,111.0,28.0,3.2,1.2,1,62.0,0,3,16.0,9,0.75,3.0,2.0,1.0,0.81,1.03,1.5,1.3,0.2,0.14,0.36,Matches,122.0,mx MEX,FW,29.0,1.2,58.0,1.0,10.0,22.0,27.0,7.0,58.0,7.0,3.0,42.9,4.0,57.1,44.0,219.0,109.0,3.0,3.0,1.0,5.0,2.0,47.0,9.0,Matches,122.0,mx MEX,FW,29.0,1.2,1.0,1.0,1.0,100.0,0.81,0.81,1.0,1.0,11.8,0.0,0.0,0.0,0.5,0.5,0.46,0.5,0.5,Matches,122.0,mx MEX,FW,29.0,4.0,1.0,111.0,1.2,1.0,0.0,1.0,1.0,0.0,0.0,0.0,0.0,0.5,0.5,0.2,0.7,3.0,3.0,9.0,0.81,0.0,0.81,0.81,0.81,0.37,0.2,0.57,0.37,0.57,Matches,Jesús Corona,WB/AM RL,29,153,160,"Mexico,Portugal",Sevilla,13,13,18,10,16,10,5,8,9,6,15,10,11,17,13,12,11,11,10,16,12,14,18,10,12,8,8,13,15,17,10,4,16,15,13,6,11,12,15,5,12,3,3,1,4,3,3,2,2,3,2,3,13,13,10,12,14,13,10,8,1,1,1,14,1,17,1,14,1,14,19,14,20,5,173,66,15,20,67499999,7500,7700,6750,Mediterranean_Hispanic,143,10,1993/1/6,71,10,44571.0,,51012751
368,Juan Cruz,Betis,2000,130.0,es ESP,FW,22.0,2.0,1.0,0.0,0.0,1.0,0.0,1.0,3.0,33.3,2.0,1.0,0.0,1.0,0.0,1.0,0.0,0.0,Matches,130.0,es ESP,FW,22.0,2.0,3.0,1.52,3.0,0.0,0.0,0.0,0.0,0.0,0.0,0.0,0.0,0.0,0.0,0.0,0.0,0.0,Matches,,,,,,,,,,,,,,,,,,,,,,,,,,,,,,,,,,,,,,,,,,,,,,,,,,,,,,,,130.0,es ESP,FW,22.0,2.0,1.0,0.0,0.0,4.0,2.0,1.0,6.0,0.0,0.0,0.0,0.0,0.0,8.0,1.0,2.0,33.3,Matches,130.0,es ESP,FW,22.0,2.0,39.0,38.0,1.0,1.0,0.0,0.0,6.0,0.0,0.0,0.0,0.0,0.0,25.0,0.0,2.0,Matches,130.0,es ESP,FW,22.0,2.0,25.0,39.0,64.1,282.0,72.0,17.0,19.0,89.5,5.0,11.0,45.5,0.0,4.0,0.0,0.0,0.1,0.1,-0.1,2.0,0.0,0.0,0.0,1.0,Matches,160,es ESP,FW,22,6,178.0,30.0,5.2,2.0,1,63.0,0,5,23.0,12,1.33,5.0,2.0,3.0,1.52,1.46,3.6,1.6,2.0,1.02,1.04,Matches,130.0,es ESP,FW,22.0,2.0,63.0,0.0,6.0,19.0,39.0,8.0,63.0,7.0,3.0,42.9,3.0,42.9,38.0,308.0,194.0,7.0,4.0,3.0,4.0,2.0,39.0,15.0,Matches,130.0,es ESP,FW,22.0,2.0,1.0,5.0,2.0,40.0,2.53,1.01,0.2,0.5,16.4,0.0,0.0,0.0,0.5,0.5,0.09,0.5,0.5,Matches,130.0,es ESP,FW,22.0,6.0,1.0,178.0,2.0,1.0,0.0,1.0,1.0,0.0,0.0,1.0,0.0,0.5,0.5,0.1,0.6,7.0,1.0,15.0,0.51,0.0,0.51,0.51,0.51,0.23,0.07,0.3,0.23,0.3,Matches,Juan Cruz,D/WB/M LC,29,122,132,Spain,Atlético Pamplona,10,13,11,7,9,10,12,10,12,13,12,5,13,11,12,13,14,9,13,10,11,6,8,8,14,14,14,16,13,14,11,12,12,13,14,11,14,13,9,11,15,3,3,1,3,3,2,3,2,3,4,1,14,11,4,7,9,11,10,10,1,20,19,1,18,1,14,16,10,1,9,1,1,1,180,79,20,7,756930,5800,5800,3050,Mediterranean_Hispanic,119,8,1992/7/28,0,0,3030.0,,43077014
369,Jorge Cuenca,Villarreal,1999,131.0,es ESP,DF,22.0,5.6,9.0,7.0,7.0,2.0,0.0,4.0,7.0,57.1,3.0,10.0,8.0,2.0,6.0,15.0,44.0,0.0,Matches,131.0,es ESP,DF,22.0,5.6,5.0,0.89,4.0,0.0,0.0,1.0,0.0,0.0,0.0,0.0,0.0,0.0,0.0,0.0,0.0,0.0,Matches,,,,,,,,,,,,,,,,,,,,,,,,,,,,,,,,,,,,,,,,,,,,,,,,,,,,,,,,131.0,es ESP,DF,22.0,5.6,1.0,0.0,0.0,4.0,1.0,0.0,1.0,6.0,7.0,0.0,1.0,0.0,28.0,15.0,7.0,68.2,Matches,131.0,es ESP,DF,22.0,5.6,384.0,366.0,17.0,9.0,1.0,7.0,1.0,2.0,0.0,0.0,0.0,0.0,334.0,1.0,3.0,Matches,131.0,es ESP,DF,22.0,5.6,334.0,384.0,87.0,6357.0,2355.0,111.0,119.0,93.3,191.0,204.0,93.6,28.0,51.0,54.9,0.0,0.1,0.2,-0.1,1.0,21.0,2.0,0.0,26.0,Matches,161,es ESP,DF,22,10,506.0,51.0,14.8,5.6,5,84.0,4,5,17.0,28,1.4,5.0,7.0,-2.0,-0.36,-1.0,6.8,8.8,-2.0,-0.36,-0.79,Matches,131.0,es ESP,DF,22.0,5.6,461.0,65.0,232.0,219.0,10.0,5.0,461.0,0.0,0.0,,0.0,,280.0,1455.0,1030.0,7.0,1.0,0.0,2.0,0.0,308.0,1.0,Matches,131.0,es ESP,DF,22.0,5.6,0.0,4.0,0.0,0.0,0.71,0.0,0.0,,10.9,0.0,0.0,0.0,0.4,0.4,0.11,-0.4,-0.4,Matches,131.0,es ESP,DF,22.0,10.0,5.0,506.0,5.6,0.0,0.0,0.0,0.0,0.0,0.0,1.0,0.0,0.4,0.4,0.1,0.5,7.0,26.0,1.0,0.0,0.0,0.0,0.0,0.0,0.08,0.01,0.09,0.08,0.09,Matches,Jorge Cuenca,D C,22,136,161,Spain,Villarreal,6,6,7,6,14,6,14,8,9,14,12,6,15,12,12,14,13,13,13,11,14,14,7,9,7,15,13,13,14,11,12,14,14,14,12,15,12,9,12,8,5,1,1,1,3,1,3,1,1,2,3,2,13,14,5,10,14,15,13,15,1,10,20,5,1,1,10,1,1,1,1,1,1,1,189,76,20,9,27299998,6800,6800,4650,Mediterranean_Hispanic,136,5,1999/11/17,0,0,18738.0,,67248170
370,Braian Cufré,Mallorca,1996,132.0,ar ARG,DF,25.0,2.4,5.0,2.0,2.0,1.0,2.0,2.0,5.0,40.0,3.0,2.0,1.0,1.0,2.0,7.0,1.0,0.0,Matches,132.0,ar ARG,DF,25.0,2.4,3.0,1.23,2.0,0.0,0.0,0.0,1.0,0.0,0.0,0.0,0.0,0.0,0.0,0.0,0.0,0.0,Matches,,,,,,,,,,,,,,,,,,,,,,,,,,,,,,,,,,,,,,,,,,,,,,,,,,,,,,,,132.0,ar ARG,DF,25.0,2.4,0.0,0.0,0.0,5.0,3.0,2.0,1.0,2.0,2.0,0.0,0.0,0.0,13.0,0.0,1.0,0.0,Matches,132.0,ar ARG,DF,25.0,2.4,92.0,67.0,24.0,1.0,0.0,1.0,1.0,23.0,0.0,0.0,0.0,0.0,76.0,1.0,2.0,Matches,132.0,ar ARG,DF,25.0,2.4,76.0,92.0,82.6,1256.0,437.0,40.0,43.0,93.0,25.0,29.0,86.2,7.0,12.0,58.3,0.0,0.0,0.1,0.0,1.0,4.0,1.0,0.0,7.0,Matches,162,ar ARG,DF,25,5,220.0,44.0,6.4,2.4,2,90.0,2,3,13.0,13,0.8,2.0,2.0,0.0,0.0,0.17,4.1,1.1,3.0,1.21,1.61,Matches,132.0,ar ARG,DF,25.0,2.4,110.0,5.0,28.0,54.0,28.0,2.0,110.0,3.0,2.0,66.7,0.0,0.0,57.0,238.0,142.0,3.0,2.0,0.0,2.0,1.0,59.0,9.0,Matches,132.0,ar ARG,DF,25.0,2.4,0.0,3.0,0.0,0.0,1.23,0.0,0.0,,21.5,0.0,0.0,0.0,0.1,0.1,0.03,-0.1,-0.1,Matches,132.0,ar ARG,DF,25.0,5.0,2.0,220.0,2.4,0.0,0.0,0.0,0.0,0.0,0.0,0.0,0.0,0.1,0.1,0.0,0.1,3.0,7.0,9.0,0.0,0.0,0.0,0.0,0.0,0.04,0.01,0.05,0.04,0.05,Matches,Braian Cufré,D L,25,126,138,Argentina,Mallorca,11,10,12,8,12,12,8,13,13,11,13,10,10,13,13,13,14,13,12,13,13,13,12,8,13,12,14,14,14,13,12,9,15,15,15,12,13,12,9,8,15,1,1,1,2,3,3,3,2,3,1,3,19,11,9,11,12,13,11,9,1,20,1,1,14,1,13,12,14,1,1,1,1,1,178,79,20,8,2018485,6250,6250,3550,Mediterranean_Hispanic,126,7,1996/12/15,0,0,17000.0,,14131295
371,Matheus Cunha,Atlético Madrid,1999,133.0,br BRA,FWMF,23.0,4.2,4.0,1.0,1.0,3.0,0.0,0.0,3.0,0.0,3.0,4.0,1.0,3.0,2.0,6.0,3.0,0.0,Matches,133.0,br BRA,FWMF,23.0,4.2,10.0,2.38,8.0,0.0,0.0,2.0,0.0,0.0,2.0,0.48,2.0,0.0,0.0,0.0,0.0,0.0,Matches,,,,,,,,,,,,,,,,,,,,,,,,,,,,,,,,,,,,,,,,,,,,,,,,,,,,,,,,133.0,br BRA,FWMF,23.0,4.2,2.0,0.0,0.0,7.0,6.0,1.0,3.0,2.0,1.0,0.0,0.0,0.0,16.0,3.0,14.0,17.6,Matches,133.0,br BRA,FWMF,23.0,4.2,85.0,77.0,6.0,0.0,1.0,1.0,3.0,1.0,0.0,0.0,0.0,0.0,64.0,2.0,3.0,Matches,133.0,br BRA,FWMF,23.0,4.2,64.0,85.0,75.3,790.0,203.0,48.0,55.0,87.3,9.0,13.0,69.2,3.0,4.0,75.0,2.0,0.8,0.4,1.2,6.0,6.0,2.0,0.0,7.0,Matches,163,br BRA,FWMF,23,11,377.0,34.0,11.0,4.2,2,68.0,0,9,27.0,2,1.82,10.0,6.0,4.0,0.95,-0.02,8.1,5.9,2.2,0.52,-0.03,Matches,133.0,br BRA,FWMF,23.0,4.2,131.0,4.0,17.0,61.0,58.0,22.0,131.0,7.0,6.0,85.7,1.0,14.3,74.0,473.0,221.0,6.0,7.0,4.0,9.0,5.0,89.0,19.0,Matches,133.0,br BRA,FWMF,23.0,4.2,0.0,12.0,8.0,66.7,2.86,1.91,0.0,0.0,16.1,0.0,0.0,0.0,1.4,1.4,0.12,-1.4,-1.4,Matches,133.0,br BRA,FWMF,23.0,11.0,2.0,377.0,4.2,0.0,2.0,2.0,0.0,0.0,0.0,2.0,0.0,1.4,1.4,0.8,2.2,6.0,7.0,19.0,0.0,0.48,0.48,0.0,0.48,0.34,0.2,0.53,0.34,0.53,Matches,Matheus Cunha,AM/S RLC,23,143,162,Brazil,A. Madrid,12,12,17,15,15,13,11,16,5,4,14,13,6,17,16,11,15,12,6,11,8,16,17,10,12,5,7,12,15,15,14,12,12,15,13,12,10,14,14,6,14,2,3,3,3,1,3,2,2,2,1,2,14,17,13,7,12,9,5,6,1,1,1,1,1,1,1,10,1,12,17,20,15,17,183,76,14,20,26534113,7100,1887,7865,Mixed_Race,134,12,1999/5/27,7,0,76711.0,,19334410
372,Curro,Almería,1996,134.0,es ESP,MF,26.0,0.5,2.0,0.0,1.0,1.0,0.0,1.0,2.0,50.0,1.0,0.0,0.0,0.0,0.0,2.0,0.0,0.0,Matches,134.0,es ESP,MF,26.0,0.5,2.0,4.19,0.0,2.0,0.0,0.0,0.0,0.0,0.0,0.0,0.0,0.0,0.0,0.0,0.0,0.0,Matches,,,,,,,,,,,,,,,,,,,,,,,,,,,,,,,,,,,,,,,,,,,,,,,,,,,,,,,,134.0,es ESP,MF,26.0,0.5,1.0,0.0,0.0,1.0,0.0,0.0,1.0,0.0,0.0,0.0,0.0,0.0,3.0,0.0,2.0,0.0,Matches,134.0,es ESP,MF,26.0,0.5,28.0,24.0,3.0,1.0,0.0,0.0,1.0,0.0,2.0,0.0,1.0,0.0,21.0,1.0,1.0,Matches,134.0,es ESP,MF,26.0,0.5,21.0,28.0,75.0,310.0,133.0,10.0,12.0,83.3,4.0,6.0,66.7,3.0,4.0,75.0,0.0,0.2,0.2,-0.2,2.0,1.0,1.0,0.0,1.0,Matches,164,es ESP,MF,26,2,43.0,22.0,1.3,0.5,0,,0,2,22.0,1,1.5,0.0,2.0,-2.0,-4.19,-3.81,0.4,0.6,-0.3,-0.58,-0.13,Matches,134.0,es ESP,MF,26.0,0.5,34.0,0.0,3.0,18.0,13.0,1.0,34.0,0.0,0.0,,0.0,,15.0,63.0,36.0,1.0,3.0,0.0,1.0,0.0,22.0,1.0,Matches,134.0,es ESP,MF,26.0,0.5,0.0,1.0,1.0,100.0,2.09,2.09,0.0,0.0,15.9,0.0,0.0,0.0,0.1,0.1,0.09,-0.1,-0.1,Matches,134.0,es ESP,MF,26.0,2.0,0.0,43.0,0.5,0.0,0.0,0.0,0.0,0.0,0.0,1.0,0.0,0.1,0.1,0.2,0.3,1.0,1.0,1.0,0.0,0.0,0.0,0.0,0.0,0.19,0.44,0.63,0.19,0.63,Matches,Curro,M/AM RC,26,123,141,Spain,Burgos,16,10,13,11,14,12,8,12,5,8,15,12,9,14,9,9,10,10,11,15,13,13,15,12,13,7,8,9,12,14,10,8,12,13,13,10,14,14,13,8,13,3,1,2,1,1,3,3,2,3,3,1,12,9,7,9,11,11,13,20,1,1,1,1,1,1,1,10,18,15,14,19,20,1,176,70,20,14,2176797,6150,6150,4150,Mediterranean_Hispanic,119,5,1996/1/3,0,0,5471.0,,67184472
373,Alberto Del Moral,Villarreal,2000,138.0,es ESP,MF,22.0,0.1,0.0,0.0,0.0,0.0,0.0,0.0,0.0,,0.0,0.0,0.0,0.0,0.0,0.0,0.0,0.0,Matches,138.0,es ESP,MF,22.0,0.1,0.0,0.0,0.0,0.0,0.0,0.0,0.0,0.0,0.0,0.0,0.0,0.0,0.0,0.0,0.0,0.0,Matches,,,,,,,,,,,,,,,,,,,,,,,,,,,,,,,,,,,,,,,,,,,,,,,,,,,,,,,,138.0,es ESP,MF,22.0,0.1,0.0,0.0,0.0,0.0,0.0,0.0,0.0,0.0,0.0,0.0,0.0,0.0,0.0,0.0,0.0,,Matches,138.0,es ESP,MF,22.0,0.1,1.0,1.0,0.0,0.0,0.0,0.0,0.0,0.0,0.0,0.0,0.0,0.0,0.0,0.0,0.0,Matches,138.0,es ESP,MF,22.0,0.1,0.0,1.0,0.0,0.0,0.0,0.0,0.0,,0.0,0.0,,0.0,1.0,0.0,0.0,0.0,0.0,0.0,0.0,0.0,0.0,0.0,0.0,Matches,169,es ESP,MF,22,1,5.0,5.0,0.1,0.1,0,,0,1,5.0,1,0.0,0.0,0.0,0.0,0.0,-0.5,0.0,0.0,0.0,-0.6,-0.91,Matches,138.0,es ESP,MF,22.0,0.1,1.0,0.0,0.0,1.0,0.0,0.0,1.0,0.0,0.0,,0.0,,1.0,2.0,1.0,0.0,0.0,0.0,0.0,0.0,1.0,0.0,Matches,138.0,es ESP,MF,22.0,0.1,0.0,0.0,0.0,,0.0,0.0,,,,0.0,0.0,0.0,0.0,0.0,,0.0,0.0,Matches,138.0,es ESP,MF,22.0,1.0,0.0,5.0,0.1,0.0,0.0,0.0,0.0,0.0,0.0,0.0,0.0,0.0,0.0,0.0,0.0,0.0,0.0,0.0,0.0,0.0,0.0,0.0,0.0,0.0,0.0,0.0,0.0,0.0,Matches,Alberto Del Moral,DM/M C,22,114,147,Spain,Villarreal,7,6,7,8,14,6,13,10,7,11,14,6,12,16,11,12,7,14,13,14,12,12,7,11,11,12,12,13,12,7,16,13,14,13,12,11,13,5,6,5,12,3,1,4,1,2,3,3,1,2,2,4,13,10,1,13,13,13,11,10,1,1,1,1,1,1,20,1,17,1,1,1,1,1,185,70,11,20,4759999,5700,5700,3200,Mediterranean_Hispanic,111,4,2000/7/20,0,0,2671.0,,67290427
374,Fran Delgado,Betis,2001,140.0,es ESP,DF,21.0,0.1,0.0,0.0,0.0,0.0,0.0,0.0,0.0,,0.0,0.0,0.0,0.0,0.0,0.0,0.0,0.0,Matches,140.0,es ESP,DF,21.0,0.1,0.0,0.0,0.0,0.0,0.0,0.0,0.0,0.0,0.0,0.0,0.0,0.0,0.0,0.0,0.0,0.0,Matches,,,,,,,,,,,,,,,,,,,,,,,,,,,,,,,,,,,,,,,,,,,,,,,,,,,,,,,,140.0,es ESP,DF,21.0,0.1,0.0,0.0,0.0,0.0,0.0,0.0,1.0,0.0,0.0,0.0,0.0,0.0,0.0,0.0,0.0,,Matches,140.0,es ESP,DF,21.0,0.1,8.0,7.0,1.0,0.0,0.0,0.0,1.0,1.0,0.0,0.0,0.0,0.0,7.0,0.0,0.0,Matches,140.0,es ESP,DF,21.0,0.1,7.0,8.0,87.5,110.0,13.0,4.0,4.0,100.0,3.0,3.0,100.0,0.0,1.0,0.0,0.0,0.0,0.0,0.0,0.0,0.0,0.0,0.0,0.0,Matches,171,es ESP,DF,21,1,12.0,12.0,0.4,0.1,0,,0,1,12.0,3,3.0,0.0,0.0,0.0,0.0,-0.13,0.3,0.0,0.3,2.49,2.47,Matches,140.0,es ESP,DF,21.0,0.1,8.0,0.0,1.0,3.0,4.0,1.0,8.0,0.0,0.0,,0.0,,3.0,9.0,5.0,0.0,1.0,0.0,0.0,0.0,7.0,3.0,Matches,140.0,es ESP,DF,21.0,0.1,0.0,0.0,0.0,,0.0,0.0,,,,0.0,0.0,0.0,0.0,0.0,,0.0,0.0,Matches,140.0,es ESP,DF,21.0,1.0,0.0,12.0,0.1,0.0,0.0,0.0,0.0,0.0,0.0,0.0,0.0,0.0,0.0,0.0,0.0,0.0,0.0,3.0,0.0,0.0,0.0,0.0,0.0,0.0,0.0,0.0,0.0,0.0,Matches,Fran Delgado,D/WB R,21,98,135,Spain,Real Hispalis,8,10,10,7,9,7,8,8,10,8,10,9,9,12,10,11,10,10,12,10,12,8,7,9,10,8,11,13,14,12,10,11,14,12,14,9,8,6,9,5,9,1,1,3,2,3,2,3,1,1,2,1,10,9,5,12,8,12,10,12,1,1,1,17,10,20,1,1,1,1,1,1,13,1,177,62,7,20,1849999,5000,5000,2250,Mediterranean_Hispanic,95,4,2001/7/11,0,0,1294.0,,67258948
375,Radamel Falcao,Rayo Vallecano,1986,168.0,co COL,FWMF,36.0,6.8,4.0,4.0,1.0,3.0,0.0,1.0,8.0,12.5,7.0,5.0,1.0,4.0,2.0,6.0,10.0,0.0,Matches,168.0,co COL,FWMF,36.0,6.8,10.0,1.46,7.0,0.0,1.0,1.0,1.0,0.0,0.0,0.0,0.0,0.0,0.0,0.0,0.0,0.0,Matches,,,,,,,,,,,,,,,,,,,,,,,,,,,,,,,,,,,,,,,,,,,,,,,,,,,,,,,,168.0,co COL,FWMF,36.0,6.8,4.0,0.0,0.0,16.0,14.0,12.0,0.0,2.0,4.0,0.0,0.0,0.0,19.0,23.0,26.0,46.9,Matches,168.0,co COL,FWMF,36.0,6.8,167.0,157.0,9.0,0.0,0.0,1.0,0.0,0.0,1.0,0.0,0.0,0.0,123.0,1.0,5.0,Matches,168.0,co COL,FWMF,36.0,6.8,123.0,167.0,73.7,1625.0,211.0,81.0,100.0,81.0,34.0,40.0,85.0,4.0,7.0,57.1,0.0,0.1,0.2,-0.1,3.0,7.0,1.0,0.0,14.0,Matches,207,co COL,FWMF,36,27,616.0,23.0,18.0,6.8,3,75.0,1,24,16.0,5,1.11,6.0,9.0,-3.0,-0.44,-0.28,8.3,10.5,-2.2,-0.32,-0.18,Matches,168.0,co COL,FWMF,36.0,6.8,271.0,12.0,21.0,106.0,146.0,38.0,270.0,16.0,2.0,12.5,13.0,81.3,150.0,549.0,122.0,2.0,5.0,2.0,29.0,9.0,204.0,53.0,Matches,168.0,co COL,FWMF,36.0,6.8,2.0,20.0,4.0,20.0,2.92,0.58,0.05,0.25,16.2,0.0,1.0,1.0,2.9,2.1,0.1,-0.9,-1.1,Matches,168.0,co COL,FWMF,36.0,27.0,3.0,616.0,6.8,2.0,0.0,2.0,1.0,1.0,1.0,4.0,0.0,2.9,2.1,0.1,2.2,2.0,14.0,53.0,0.29,0.0,0.29,0.15,0.15,0.42,0.01,0.43,0.3,0.32,Matches,Radamel Falcao,S,36,134,176,Colombia,Vallecano,10,12,12,17,14,14,17,12,3,4,13,18,6,15,13,15,16,18,16,15,15,18,16,17,15,8,15,9,9,10,10,14,14,9,9,10,14,8,17,15,6,1,3,1,1,2,2,3,2,1,2,4,13,18,8,15,19,17,16,17,1,1,1,1,1,1,1,1,1,1,1,1,1,20,177,72,12,20,520621,6747,7818,5630,Mediterranean_Hispanic,133,8,1986/2/10,101,35,14585.0,,950975
376,Zouhair Feddal,Valladolid,1989,172.0,ma MAR,DF,33.0,4.2,4.0,2.0,1.0,3.0,0.0,3.0,4.0,75.0,1.0,9.0,9.0,0.0,5.0,9.0,27.0,0.0,Matches,172.0,ma MAR,DF,33.0,4.2,4.0,0.96,3.0,0.0,0.0,0.0,0.0,1.0,0.0,0.0,0.0,0.0,0.0,0.0,0.0,0.0,Matches,,,,,,,,,,,,,,,,,,,,,,,,,,,,,,,,,,,,,,,,,,,,,,,,,,,,,,,,172.0,ma MAR,DF,33.0,4.2,1.0,0.0,0.0,4.0,2.0,0.0,1.0,5.0,2.0,0.0,1.0,0.0,19.0,6.0,7.0,46.2,Matches,172.0,ma MAR,DF,33.0,4.2,201.0,187.0,13.0,11.0,0.0,5.0,1.0,0.0,0.0,0.0,0.0,0.0,159.0,1.0,1.0,Matches,172.0,ma MAR,DF,33.0,4.2,159.0,201.0,79.1,3405.0,1439.0,44.0,49.0,89.8,83.0,96.0,86.5,26.0,48.0,54.2,0.0,0.1,0.0,-0.1,2.0,6.0,1.0,0.0,5.0,Matches,212,ma MAR,DF,33,8,375.0,47.0,11.0,4.2,4,68.0,2,4,26.0,5,1.25,5.0,7.0,-2.0,-0.48,0.35,3.4,9.2,-5.9,-1.41,-0.79,Matches,172.0,ma MAR,DF,33.0,4.2,249.0,48.0,162.0,85.0,3.0,2.0,249.0,0.0,0.0,,0.0,,124.0,595.0,278.0,0.0,0.0,0.0,0.0,1.0,147.0,0.0,Matches,172.0,ma MAR,DF,33.0,4.2,0.0,1.0,0.0,0.0,0.24,0.0,0.0,,3.5,0.0,0.0,0.0,0.2,0.2,0.2,-0.2,-0.2,Matches,172.0,ma MAR,DF,33.0,8.0,4.0,375.0,4.2,0.0,0.0,0.0,0.0,0.0,0.0,1.0,0.0,0.2,0.2,0.1,0.3,0.0,5.0,0.0,0.0,0.0,0.0,0.0,0.0,0.05,0.03,0.08,0.05,0.08,Matches,Zouhair Feddal,D C,32,126,143,"Morocco,Spain",Valladolid,8,8,10,7,10,9,14,9,10,14,13,5,13,12,16,14,14,13,12,12,13,14,10,13,12,14,14,12,11,10,15,16,14,11,11,14,15,14,13,5,9,4,3,3,3,2,1,1,1,2,3,1,13,12,8,10,13,13,13,14,1,14,20,1,12,1,1,1,1,1,1,1,1,1,192,82,20,7,879861,6300,6800,5000,North_African__Middle_Eastern,126,8,1989/12/23,22,1,7258.0,,67087626
377,Felipe,Atlético Madrid,1989,174.0,br BRA,DF,33.0,2.2,3.0,2.0,1.0,2.0,0.0,2.0,4.0,50.0,2.0,2.0,2.0,0.0,0.0,3.0,7.0,0.0,Matches,174.0,br BRA,DF,33.0,2.2,1.0,0.46,1.0,0.0,0.0,0.0,0.0,0.0,0.0,0.0,0.0,0.0,0.0,0.0,0.0,0.0,Matches,,,,,,,,,,,,,,,,,,,,,,,,,,,,,,,,,,,,,,,,,,,,,,,,,,,,,,,,174.0,br BRA,DF,33.0,2.2,0.0,0.0,0.0,4.0,3.0,0.0,0.0,0.0,2.0,0.0,0.0,0.0,16.0,6.0,6.0,50.0,Matches,174.0,br BRA,DF,33.0,2.2,132.0,128.0,3.0,2.0,0.0,0.0,0.0,1.0,0.0,0.0,0.0,0.0,121.0,1.0,1.0,Matches,174.0,br BRA,DF,33.0,2.2,121.0,132.0,91.7,2265.0,847.0,44.0,45.0,97.8,66.0,72.0,91.7,10.0,12.0,83.3,0.0,0.0,0.0,0.0,1.0,15.0,0.0,0.0,20.0,Matches,214,br BRA,DF,33,3,194.0,65.0,5.7,2.2,2,90.0,2,1,14.0,11,0.33,1.0,3.0,-2.0,-0.93,-2.02,2.4,2.3,0.0,0.02,-0.56,Matches,174.0,br BRA,DF,33.0,2.2,149.0,9.0,56.0,90.0,5.0,2.0,149.0,2.0,1.0,50.0,1.0,50.0,102.0,581.0,332.0,2.0,0.0,0.0,0.0,0.0,98.0,1.0,Matches,174.0,br BRA,DF,33.0,2.2,0.0,1.0,0.0,0.0,0.46,0.0,0.0,,10.6,0.0,0.0,0.0,0.0,0.0,0.03,0.0,0.0,Matches,174.0,br BRA,DF,33.0,3.0,2.0,194.0,2.2,0.0,0.0,0.0,0.0,0.0,0.0,0.0,0.0,0.0,0.0,0.0,0.1,2.0,20.0,1.0,0.0,0.0,0.0,0.0,0.0,0.02,0.01,0.03,0.02,0.03,Matches,Felipe,D C,33,148,152,Brazil,A. Madrid,6,6,10,8,11,7,16,7,7,16,12,11,15,12,18,15,16,12,14,9,13,16,7,17,10,14,14,15,12,13,15,16,17,13,13,16,14,16,14,10,12,2,2,3,1,3,2,1,3,1,3,2,13,14,13,12,14,16,6,8,1,1,20,13,1,1,12,1,1,1,1,1,1,1,191,87,8,20,9281976,7300,7600,6100,Northern_European,147,5,1989/5/16,2,0,86538.0,,19162578
378,João Félix,Atlético Madrid,1999,176.0,pt POR,FWMF,22.0,7.2,10.0,7.0,2.0,3.0,5.0,1.0,6.0,16.7,5.0,1.0,0.0,1.0,3.0,13.0,2.0,0.0,Matches,176.0,pt POR,FWMF,22.0,7.2,29.0,4.02,22.0,0.0,3.0,3.0,0.0,1.0,5.0,0.69,4.0,0.0,0.0,1.0,0.0,0.0,Matches,,,,,,,,,,,,,,,,,,,,,,,,,,,,,,,,,,,,,,,,,,,,,,,,,,,,,,,,176.0,pt POR,FWMF,22.0,7.2,5.0,0.0,0.0,16.0,23.0,3.0,8.0,3.0,7.0,0.0,0.0,0.0,18.0,7.0,8.0,46.7,Matches,176.0,pt POR,FWMF,22.0,7.2,228.0,209.0,18.0,6.0,7.0,2.0,8.0,3.0,4.0,3.0,0.0,0.0,171.0,1.0,5.0,Matches,176.0,pt POR,FWMF,22.0,7.2,171.0,228.0,75.0,2307.0,680.0,98.0,113.0,86.7,42.0,60.0,70.0,11.0,29.0,37.9,3.0,1.4,1.0,1.6,10.0,14.0,10.0,1.0,27.0,Matches,216,pt POR,FWMF,22,14,650.0,46.0,19.0,7.2,7,74.0,1,7,18.0,1,1.86,11.0,8.0,3.0,0.42,-0.69,8.7,8.6,0.1,0.02,-0.65,Matches,176.0,pt POR,FWMF,22.0,7.2,322.0,3.0,23.0,158.0,142.0,21.0,322.0,24.0,6.0,25.0,14.0,58.3,211.0,1078.0,554.0,17.0,16.0,2.0,20.0,12.0,260.0,42.0,Matches,176.0,pt POR,FWMF,22.0,7.2,4.0,26.0,12.0,46.2,3.6,1.66,0.15,0.33,18.9,1.0,0.0,0.0,2.6,2.6,0.1,1.4,1.4,Matches,176.0,pt POR,FWMF,22.0,14.0,7.0,650.0,7.2,4.0,3.0,7.0,4.0,0.0,0.0,5.0,0.0,2.6,2.6,1.4,4.0,17.0,27.0,42.0,0.55,0.42,0.97,0.55,0.97,0.36,0.2,0.56,0.36,0.56,Matches,João Félix,AM/S RLC,22,159,177,Portugal,A. Madrid,11,12,17,15,16,12,12,13,4,4,17,14,7,18,14,15,11,15,13,16,16,16,19,7,18,6,12,11,13,15,13,9,14,12,12,9,12,14,15,9,8,2,1,2,1,1,3,1,2,1,4,2,15,18,13,8,17,15,10,10,1,1,1,1,1,1,1,12,10,12,18,20,15,19,178,74,15,20,95220000,7800,7800,7200,Mediterranean_Hispanic,152,8,1999/11/10,22,3,180287.0,,83169822
379,Carlos Fernández,Real Sociedad,1996,181.0,es ESP,FW,26.0,7.0,6.0,4.0,1.0,3.0,2.0,1.0,15.0,6.7,14.0,1.0,0.0,1.0,1.0,7.0,4.0,0.0,Matches,181.0,es ESP,FW,26.0,7.0,16.0,2.27,12.0,0.0,1.0,1.0,2.0,0.0,1.0,0.14,1.0,0.0,0.0,0.0,0.0,0.0,Matches,,,,,,,,,,,,,,,,,,,,,,,,,,,,,,,,,,,,,,,,,,,,,,,,,,,,,,,,181.0,es ESP,FW,26.0,7.0,6.0,0.0,0.0,17.0,15.0,9.0,0.0,1.0,4.0,0.0,0.0,0.0,35.0,25.0,23.0,52.1,Matches,181.0,es ESP,FW,26.0,7.0,148.0,143.0,5.0,0.0,1.0,0.0,0.0,1.0,0.0,0.0,0.0,0.0,96.0,0.0,1.0,Matches,181.0,es ESP,FW,26.0,7.0,96.0,148.0,64.9,1274.0,273.0,51.0,78.0,65.4,35.0,48.0,72.9,0.0,3.0,0.0,0.0,0.6,0.3,-0.6,7.0,4.0,4.0,0.0,13.0,Matches,221,es ESP,FW,26,24,631.0,26.0,18.5,7.0,8,54.0,0,16,13.0,4,1.79,7.0,8.0,-1.0,-0.14,-0.69,7.7,7.2,0.5,0.07,-0.55,Matches,181.0,es ESP,FW,26.0,7.0,231.0,5.0,25.0,92.0,120.0,42.0,231.0,20.0,13.0,65.0,5.0,25.0,141.0,798.0,284.0,9.0,8.0,4.0,19.0,12.0,181.0,54.0,Matches,181.0,es ESP,FW,26.0,7.0,1.0,21.0,5.0,23.8,3.0,0.71,0.05,0.2,13.1,0.0,0.0,0.0,2.4,2.4,0.11,-1.4,-1.4,Matches,181.0,es ESP,FW,26.0,24.0,8.0,631.0,7.0,1.0,0.0,1.0,1.0,0.0,0.0,6.0,0.0,2.4,2.4,0.6,2.9,9.0,13.0,54.0,0.14,0.0,0.14,0.14,0.14,0.34,0.08,0.42,0.34,0.42,Matches,Carlos Fernández,S C,26,135,145,Spain,Real San Sebastián,7,11,12,15,13,8,14,11,6,6,13,12,7,14,13,13,12,13,13,13,14,14,13,11,14,6,13,14,12,12,11,14,12,14,14,13,14,5,14,16,12,1,1,2,3,1,3,1,3,3,3,2,10,11,9,15,10,16,14,8,1,1,1,1,1,1,1,1,1,1,1,15,1,20,186,72,20,11,6456189,6650,6650,4750,Mediterranean_Hispanic,133,4,1996/5/22,0,0,14736.0,,67184485
380,Federico Fernández,Elche,1989,182.0,ar ARG,DF,33.0,1.0,1.0,1.0,1.0,0.0,0.0,1.0,1.0,100.0,0.0,0.0,0.0,0.0,2.0,3.0,12.0,0.0,Matches,182.0,ar ARG,DF,33.0,1.0,0.0,0.0,0.0,0.0,0.0,0.0,0.0,0.0,0.0,0.0,0.0,0.0,0.0,0.0,0.0,0.0,Matches,,,,,,,,,,,,,,,,,,,,,,,,,,,,,,,,,,,,,,,,,,,,,,,,,,,,,,,,182.0,ar ARG,DF,33.0,1.0,0.0,0.0,0.0,0.0,0.0,0.0,0.0,2.0,1.0,0.0,0.0,0.0,3.0,1.0,2.0,33.3,Matches,182.0,ar ARG,DF,33.0,1.0,14.0,13.0,1.0,1.0,0.0,0.0,0.0,0.0,0.0,0.0,0.0,0.0,8.0,0.0,0.0,Matches,182.0,ar ARG,DF,33.0,1.0,8.0,14.0,57.1,204.0,130.0,1.0,2.0,50.0,5.0,8.0,62.5,2.0,4.0,50.0,0.0,0.0,0.0,0.0,0.0,0.0,0.0,0.0,0.0,Matches,223,ar ARG,DF,33,1,90.0,90.0,2.6,1.0,1,90.0,1,0,,4,0.0,1.0,2.0,-1.0,-1.0,-0.03,1.1,0.9,0.3,0.29,1.18,Matches,182.0,ar ARG,DF,33.0,1.0,30.0,11.0,24.0,5.0,1.0,0.0,30.0,0.0,0.0,,0.0,,5.0,11.0,6.0,0.0,0.0,0.0,1.0,0.0,2.0,0.0,Matches,182.0,ar ARG,DF,33.0,1.0,0.0,0.0,0.0,,0.0,0.0,,,,0.0,0.0,0.0,0.0,0.0,,0.0,0.0,Matches,182.0,ar ARG,DF,33.0,1.0,1.0,90.0,1.0,0.0,0.0,0.0,0.0,0.0,0.0,0.0,0.0,0.0,0.0,0.0,0.0,0.0,0.0,0.0,0.0,0.0,0.0,0.0,0.0,0.0,0.0,0.0,0.0,0.0,Matches,Federico Fernández,D C,33,129,137,"Argentina,Italy",Elche,5,6,8,7,11,4,15,5,8,14,11,5,15,9,11,14,15,14,12,10,14,11,10,10,10,15,15,15,10,9,13,15,13,11,13,15,14,12,12,3,8,2,2,3,3,2,3,3,1,3,2,1,15,12,2,8,14,13,10,15,1,1,20,1,1,1,1,1,1,1,1,1,1,1,190,83,10,20,824452,6450,6650,5400,Mediterranean_Hispanic,129,6,1989/2/21,32,3,28998.0,,14011214
381,Joan García,Espanyol,2001,201.0,es ESP,GK,21.0,1.0,0.0,0.0,0.0,0.0,0.0,0.0,0.0,,0.0,0.0,0.0,0.0,0.0,0.0,0.0,0.0,Matches,201.0,es ESP,GK,21.0,1.0,0.0,0.0,0.0,0.0,0.0,0.0,0.0,0.0,0.0,0.0,0.0,0.0,0.0,0.0,0.0,0.0,Matches,14.0,es ESP,GK,21.0,1.0,3.0,1.0,0.0,0.0,0.0,1.8,0.21,-1.2,-1.16,2.0,6.0,33.3,27.0,4.0,14.8,21.7,3.0,66.7,47.3,16.0,2.0,12.5,1.0,1.0,13.0,Matches,14.0,es ESP,GK,21.0,1.0,1.0,90.0,1.0,3.0,3.0,4.0,1.0,50.0,0.0,1.0,0.0,0.0,0.0,1.0,1.0,0.0,0.0,0.0,Matches,201.0,es ESP,GK,21.0,1.0,0.0,0.0,0.0,0.0,0.0,0.0,0.0,0.0,0.0,0.0,0.0,0.0,3.0,0.0,0.0,,Matches,201.0,es ESP,GK,21.0,1.0,30.0,26.0,4.0,1.0,0.0,0.0,0.0,0.0,0.0,0.0,0.0,0.0,26.0,0.0,0.0,Matches,201.0,es ESP,GK,21.0,1.0,26.0,30.0,86.7,521.0,425.0,9.0,9.0,100.0,12.0,12.0,100.0,5.0,9.0,55.6,0.0,0.0,0.0,0.0,0.0,0.0,0.0,0.0,0.0,Matches,246,es ESP,GK,21,1,90.0,90.0,2.6,1.0,1,90.0,1,0,,35,1.0,3.0,3.0,0.0,0.0,0.46,0.6,1.8,-1.2,-1.2,-0.92,Matches,201.0,es ESP,GK,21.0,1.0,31.0,23.0,30.0,1.0,0.0,0.0,31.0,0.0,0.0,,0.0,,20.0,85.0,41.0,0.0,0.0,0.0,0.0,0.0,16.0,0.0,Matches,201.0,es ESP,GK,21.0,1.0,0.0,0.0,0.0,,0.0,0.0,,,,0.0,0.0,0.0,0.0,0.0,,0.0,0.0,Matches,201.0,es ESP,GK,21.0,1.0,1.0,90.0,1.0,0.0,0.0,0.0,0.0,0.0,0.0,0.0,0.0,0.0,0.0,0.0,0.0,0.0,0.0,0.0,0.0,0.0,0.0,0.0,0.0,0.0,0.0,0.0,0.0,0.0,Matches,Joan García,GK,21,120,156,Spain,Espanyol,3,1,3,3,1,8,1,1,3,1,11,2,3,3,9,13,15,9,10,9,14,12,3,9,2,11,4,4,13,15,10,9,12,11,8,7,10,7,11,6,13,12,14,12,5,14,14,7,13,5,13,11,15,11,1,11,12,11,13,10,20,1,1,1,1,1,1,1,1,1,1,1,1,1,181,79,12,20,8225999,5900,5900,1500,Mediterranean_Hispanic,114,3,2001/5/4,0,0,3459.0,,67277675
382,Aleix Garrido,Barcelona,2004,206.0,es ESP,FW,18.0,0.1,2.0,1.0,1.0,0.0,1.0,1.0,1.0,100.0,0.0,1.0,0.0,1.0,0.0,2.0,0.0,0.0,Matches,206.0,es ESP,FW,18.0,0.1,0.0,0.0,0.0,0.0,0.0,0.0,0.0,0.0,0.0,0.0,0.0,0.0,0.0,0.0,0.0,0.0,Matches,,,,,,,,,,,,,,,,,,,,,,,,,,,,,,,,,,,,,,,,,,,,,,,,,,,,,,,,206.0,es ESP,FW,18.0,0.1,0.0,0.0,0.0,0.0,0.0,0.0,1.0,0.0,1.0,0.0,0.0,0.0,1.0,0.0,0.0,,Matches,206.0,es ESP,FW,18.0,0.1,3.0,3.0,0.0,0.0,0.0,0.0,1.0,0.0,0.0,0.0,0.0,0.0,2.0,0.0,0.0,Matches,206.0,es ESP,FW,18.0,0.1,2.0,3.0,66.7,21.0,8.0,2.0,3.0,66.7,0.0,0.0,,0.0,0.0,,0.0,0.0,0.0,0.0,0.0,0.0,0.0,0.0,0.0,Matches,252,es ESP,FW,18,1,7.0,7.0,0.2,0.1,0,,0,1,7.0,2,3.0,0.0,0.0,0.0,0.0,-1.32,0.1,0.5,-0.4,-5.0,-6.13,Matches,206.0,es ESP,FW,18.0,0.1,7.0,0.0,4.0,0.0,3.0,1.0,7.0,1.0,0.0,0.0,1.0,100.0,4.0,30.0,18.0,0.0,0.0,0.0,0.0,0.0,3.0,0.0,Matches,206.0,es ESP,FW,18.0,0.1,0.0,0.0,0.0,,0.0,0.0,,,,0.0,0.0,0.0,0.0,0.0,,0.0,0.0,Matches,206.0,es ESP,FW,18.0,1.0,0.0,7.0,0.1,0.0,0.0,0.0,0.0,0.0,0.0,0.0,0.0,0.0,0.0,0.0,0.0,0.0,0.0,0.0,0.0,0.0,0.0,0.0,0.0,0.0,0.0,0.0,0.0,0.0,Matches,Aleix Garrido,DM/M C,18,95,-75,Spain,Barcelona,9,9,9,8,14,8,6,9,5,9,14,7,11,15,9,11,9,11,11,12,12,14,12,8,11,12,13,9,9,12,12,6,14,9,11,9,12,9,12,8,12,2,2,1,1,3,2,1,3,3,2,3,10,12,5,14,15,14,16,15,1,1,1,1,1,1,18,10,20,10,5,12,5,1,170,0,8,20,6000000,4750,4750,1250,Mediterranean_Hispanic,94,5,2004/2/22,0,0,624.0,,2000141739
383,Dani Gómez,Espanyol,1998,214.0,es ESP,MFFW,24.0,1.0,2.0,1.0,1.0,1.0,0.0,1.0,2.0,50.0,1.0,0.0,0.0,0.0,1.0,3.0,0.0,0.0,Matches,214.0,es ESP,MFFW,24.0,1.0,0.0,0.0,0.0,0.0,0.0,0.0,0.0,0.0,0.0,0.0,0.0,0.0,0.0,0.0,0.0,0.0,Matches,,,,,,,,,,,,,,,,,,,,,,,,,,,,,,,,,,,,,,,,,,,,,,,,,,,,,,,,214.0,es ESP,MFFW,24.0,1.0,2.0,0.0,0.0,3.0,2.0,4.0,2.0,1.0,1.0,0.0,0.0,0.0,5.0,1.0,0.0,100.0,Matches,214.0,es ESP,MFFW,24.0,1.0,17.0,16.0,1.0,0.0,0.0,0.0,2.0,1.0,0.0,0.0,0.0,0.0,13.0,0.0,2.0,Matches,214.0,es ESP,MFFW,24.0,1.0,13.0,17.0,76.5,196.0,28.0,9.0,9.0,100.0,4.0,6.0,66.7,0.0,0.0,,0.0,0.0,0.0,0.0,1.0,1.0,1.0,0.0,4.0,Matches,261,es ESP,MFFW,24,8,88.0,11.0,2.6,1.0,0,,0,8,11.0,18,0.38,2.0,1.0,1.0,1.02,1.51,2.8,1.6,1.1,1.13,1.47,Matches,214.0,es ESP,MFFW,24.0,1.0,32.0,0.0,4.0,12.0,17.0,4.0,32.0,3.0,1.0,33.3,2.0,66.7,20.0,124.0,22.0,1.0,2.0,0.0,3.0,2.0,21.0,9.0,Matches,214.0,es ESP,MFFW,24.0,1.0,0.0,0.0,0.0,,0.0,0.0,,,,0.0,0.0,0.0,0.0,0.0,,0.0,0.0,Matches,214.0,es ESP,MFFW,24.0,8.0,0.0,88.0,1.0,0.0,0.0,0.0,0.0,0.0,0.0,2.0,0.0,0.0,0.0,0.0,0.0,1.0,4.0,9.0,0.0,0.0,0.0,0.0,0.0,0.0,0.04,0.04,0.0,0.04,Matches,Dani Gómez,S,23,125,138,Spain,Levante,7,10,14,13,13,11,11,11,6,5,12,13,6,14,12,14,12,13,12,12,12,13,13,12,15,7,10,13,14,14,12,10,13,13,13,9,12,8,12,8,7,1,4,1,3,3,2,1,2,3,3,2,12,14,7,12,12,13,14,12,1,1,1,1,1,1,1,1,1,1,12,14,8,20,178,73,12,20,3836699,6300,6300,4250,Mediterranean_Hispanic,125,6,1998/7/30,0,0,10032.0,Espanyol,67231837
384,José Gragera,Espanyol,2000,226.0,es ESP,MFDF,21.0,5.1,19.0,9.0,11.0,6.0,2.0,6.0,11.0,54.5,5.0,10.0,4.0,6.0,7.0,26.0,18.0,0.0,Matches,226.0,es ESP,MFDF,21.0,5.1,2.0,0.39,1.0,0.0,0.0,1.0,0.0,0.0,1.0,0.2,0.0,0.0,0.0,1.0,0.0,0.0,Matches,,,,,,,,,,,,,,,,,,,,,,,,,,,,,,,,,,,,,,,,,,,,,,,,,,,,,,,,226.0,es ESP,MFDF,21.0,5.1,2.0,0.0,0.0,14.0,6.0,0.0,0.0,7.0,9.0,0.0,0.0,0.0,17.0,12.0,9.0,57.1,Matches,226.0,es ESP,MFDF,21.0,5.1,208.0,200.0,8.0,7.0,0.0,1.0,0.0,1.0,0.0,0.0,0.0,0.0,178.0,0.0,0.0,Matches,226.0,es ESP,MFDF,21.0,5.1,178.0,208.0,85.6,3239.0,1070.0,66.0,81.0,81.5,89.0,99.0,89.9,18.0,22.0,81.8,0.0,0.0,0.1,0.0,0.0,11.0,0.0,0.0,11.0,Matches,277,es ESP,MFDF,21,9,460.0,51.0,13.5,5.1,5,74.0,1,4,22.0,3,0.89,3.0,6.0,-3.0,-0.59,-0.16,4.1,6.8,-2.7,-0.53,-0.26,Matches,226.0,es ESP,MFDF,21.0,5.1,272.0,20.0,117.0,137.0,19.0,6.0,272.0,0.0,0.0,,0.0,,122.0,475.0,168.0,0.0,1.0,0.0,1.0,1.0,150.0,3.0,Matches,226.0,es ESP,MFDF,21.0,5.1,1.0,4.0,1.0,25.0,0.78,0.2,0.25,1.0,11.6,0.0,0.0,0.0,0.7,0.7,0.22,0.3,0.3,Matches,226.0,es ESP,MFDF,21.0,9.0,5.0,460.0,5.1,1.0,0.0,1.0,1.0,0.0,0.0,2.0,0.0,0.7,0.7,0.0,0.7,0.0,11.0,3.0,0.2,0.0,0.2,0.2,0.2,0.14,0.0,0.14,0.14,0.14,Matches,José Gragera,DM/M C,22,121,150,Spain,S. Gijón,7,8,11,8,14,7,16,10,7,12,14,7,13,16,11,14,11,10,12,13,11,13,8,6,7,14,14,11,13,14,10,16,9,12,12,12,9,8,11,7,7,3,3,1,1,2,2,2,2,1,1,3,16,12,6,14,8,13,13,13,1,1,10,1,1,1,20,1,19,1,1,1,1,1,187,81,10,20,3748499,6041,6041,4041,Mediterranean_Hispanic,121,4,2000/5/14,0,0,4966.0,,67263880
385,Dominik Greif,Mallorca,1997,228.0,sk SVK,GK,25.0,1.0,0.0,0.0,0.0,0.0,0.0,0.0,0.0,,0.0,0.0,0.0,0.0,0.0,0.0,0.0,0.0,Matches,228.0,sk SVK,GK,25.0,1.0,1.0,1.0,1.0,0.0,0.0,0.0,0.0,0.0,0.0,0.0,0.0,0.0,0.0,0.0,0.0,0.0,Matches,19.0,sk SVK,GK,25.0,1.0,3.0,0.0,0.0,0.0,0.0,2.2,0.28,-0.8,-0.76,19.0,34.0,55.9,23.0,2.0,87.0,54.9,15.0,93.3,64.5,19.0,2.0,10.5,0.0,0.0,4.0,Matches,19.0,sk SVK,GK,25.0,1.0,1.0,90.0,1.0,3.0,3.0,8.0,5.0,62.5,0.0,0.0,1.0,0.0,0.0,0.0,0.0,0.0,0.0,,Matches,228.0,sk SVK,GK,25.0,1.0,0.0,0.0,0.0,0.0,0.0,0.0,0.0,0.0,0.0,0.0,0.0,0.0,0.0,0.0,0.0,,Matches,228.0,sk SVK,GK,25.0,1.0,38.0,20.0,18.0,3.0,0.0,0.0,0.0,0.0,0.0,0.0,0.0,0.0,23.0,0.0,0.0,Matches,228.0,sk SVK,GK,25.0,1.0,23.0,38.0,60.5,1222.0,1170.0,0.0,0.0,,4.0,4.0,100.0,19.0,34.0,55.9,0.0,0.0,0.0,0.0,0.0,1.0,0.0,0.0,0.0,Matches,279,sk SVK,GK,25,1,90.0,90.0,2.6,1.0,1,90.0,1,0,,24,0.0,0.0,3.0,-3.0,-3.0,-2.92,0.1,3.6,-3.5,-3.52,-3.31,Matches,228.0,sk SVK,GK,25.0,1.0,40.0,37.0,40.0,0.0,0.0,0.0,40.0,0.0,0.0,,0.0,,16.0,125.0,50.0,0.0,0.0,0.0,0.0,0.0,12.0,0.0,Matches,228.0,sk SVK,GK,25.0,1.0,0.0,0.0,0.0,,0.0,0.0,,,,0.0,0.0,0.0,0.0,0.0,,0.0,0.0,Matches,228.0,sk SVK,GK,25.0,1.0,1.0,90.0,1.0,0.0,0.0,0.0,0.0,0.0,0.0,0.0,0.0,0.0,0.0,0.0,0.0,0.0,0.0,0.0,0.0,0.0,0.0,0.0,0.0,0.0,0.0,0.0,0.0,0.0,Matches,Dominik Greif,GK,25,125,145,Slovakia,Mallorca,3,3,2,2,8,6,1,3,2,3,11,3,3,6,7,14,16,12,10,11,12,15,3,6,1,16,12,10,11,8,12,19,13,10,11,16,11,15,13,11,12,15,12,12,5,13,12,14,14,11,10,9,18,14,6,8,10,12,14,15,20,1,1,1,1,1,1,1,1,1,1,1,1,1,197,82,12,20,1246710,6100,6100,4250,Northern_European,122,6,1997/4/6,4,0,4790.0,,63029157
386,Clément Grenier,Mallorca,1991,229.0,fr FRA,MF,31.0,8.0,20.0,8.0,6.0,12.0,2.0,10.0,20.0,50.0,10.0,9.0,1.0,8.0,6.0,26.0,7.0,0.0,Matches,229.0,fr FRA,MF,31.0,8.0,18.0,2.26,11.0,6.0,1.0,0.0,0.0,0.0,1.0,0.13,0.0,1.0,0.0,0.0,0.0,0.0,Matches,,,,,,,,,,,,,,,,,,,,,,,,,,,,,,,,,,,,,,,,,,,,,,,,,,,,,,,,229.0,fr FRA,MF,31.0,8.0,7.0,0.0,0.0,21.0,13.0,0.0,34.0,6.0,8.0,0.0,0.0,0.0,46.0,3.0,9.0,25.0,Matches,229.0,fr FRA,MF,31.0,8.0,356.0,311.0,42.0,19.0,0.0,9.0,34.0,0.0,19.0,7.0,10.0,0.0,256.0,3.0,5.0,Matches,229.0,fr FRA,MF,31.0,8.0,256.0,356.0,71.9,4406.0,1363.0,132.0,151.0,87.4,79.0,107.0,73.8,35.0,76.0,46.1,0.0,1.1,1.5,-1.1,12.0,31.0,6.0,2.0,40.0,Matches,280,fr FRA,MF,31,21,718.0,34.0,21.0,8.0,6,71.0,1,15,20.0,14,1.48,9.0,11.0,-2.0,-0.25,-0.12,7.2,13.1,-5.9,-0.74,-0.56,Matches,229.0,fr FRA,MF,31.0,8.0,432.0,11.0,62.0,240.0,131.0,4.0,432.0,7.0,3.0,42.9,2.0,28.6,216.0,807.0,314.0,4.0,5.0,1.0,17.0,7.0,277.0,26.0,Matches,229.0,fr FRA,MF,31.0,8.0,0.0,3.0,2.0,66.7,0.38,0.25,0.0,0.0,23.1,1.0,0.0,0.0,0.2,0.2,0.07,-0.2,-0.2,Matches,229.0,fr FRA,MF,31.0,21.0,6.0,718.0,8.0,0.0,0.0,0.0,0.0,0.0,0.0,7.0,0.0,0.2,0.2,1.1,1.3,4.0,40.0,26.0,0.0,0.0,0.0,0.0,0.0,0.03,0.14,0.17,0.03,0.17,Matches,Clément Grenier,DM/M C,31,130,136,France,Mallorca,13,12,14,9,16,14,11,12,5,7,15,11,7,15,8,13,10,13,14,15,14,14,14,10,13,10,15,12,11,14,14,10,12,11,12,11,12,9,15,13,7,4,1,3,2,1,1,1,2,1,1,1,12,15,8,16,10,12,15,12,1,1,1,1,1,1,18,1,20,1,1,14,10,1,187,79,12,20,347975206,6499,6499,4253,Northern_European,130,8,1991/1/7,5,0,9724.0,,34011686
387,Sergi Guardiola,Valladolid,1991,232.0,es ESP,FW,31.0,5.6,12.0,7.0,6.0,5.0,1.0,2.0,4.0,50.0,2.0,6.0,0.0,6.0,2.0,14.0,7.0,0.0,Matches,232.0,es ESP,FW,31.0,5.6,8.0,1.43,6.0,0.0,0.0,0.0,1.0,1.0,0.0,0.0,0.0,0.0,0.0,0.0,0.0,0.0,Matches,,,,,,,,,,,,,,,,,,,,,,,,,,,,,,,,,,,,,,,,,,,,,,,,,,,,,,,,232.0,es ESP,FW,31.0,5.6,1.0,0.0,0.0,14.0,9.0,4.0,3.0,2.0,7.0,0.0,0.0,0.0,14.0,9.0,14.0,39.1,Matches,232.0,es ESP,FW,31.0,5.6,117.0,108.0,8.0,0.0,0.0,0.0,3.0,0.0,0.0,0.0,0.0,0.0,74.0,1.0,6.0,Matches,232.0,es ESP,FW,31.0,5.6,74.0,117.0,63.2,948.0,149.0,47.0,65.0,72.3,18.0,26.0,69.2,3.0,5.0,60.0,0.0,0.1,0.2,-0.1,2.0,1.0,1.0,1.0,3.0,Matches,283,es ESP,FW,31,14,502.0,36.0,14.7,5.6,8,54.0,0,6,12.0,2,0.79,1.0,6.0,-5.0,-0.9,-0.13,3.1,10.0,-6.9,-1.23,-0.62,Matches,232.0,es ESP,FW,31.0,5.6,191.0,7.0,27.0,91.0,74.0,17.0,191.0,7.0,0.0,0.0,6.0,85.7,99.0,373.0,144.0,7.0,6.0,2.0,18.0,4.0,125.0,20.0,Matches,232.0,es ESP,FW,31.0,5.6,0.0,11.0,3.0,27.3,1.97,0.54,0.0,0.0,17.7,0.0,0.0,0.0,1.0,1.0,0.09,-1.0,-1.0,Matches,232.0,es ESP,FW,31.0,14.0,8.0,502.0,5.6,0.0,0.0,0.0,0.0,0.0,0.0,1.0,0.0,1.0,1.0,0.1,1.2,7.0,3.0,20.0,0.0,0.0,0.0,0.0,0.0,0.18,0.03,0.21,0.18,0.21,Matches,Sergi Guardiola,AM/S RLC,31,131,139,Spain,Valladolid,7,12,13,14,12,9,14,12,7,3,13,12,4,13,11,13,13,14,13,12,13,16,11,12,15,10,12,14,12,12,11,14,15,14,12,14,15,9,17,8,13,3,2,2,1,4,3,2,2,1,2,3,14,13,10,12,13,14,13,12,1,1,1,1,1,1,1,12,1,12,17,17,15,20,187,76,20,8,2685172,6550,6550,4550,Mediterranean_Hispanic,128,5,1991/5/29,0,0,5345.0,,67138759
388,Ander Guevara,Real Sociedad,1997,236.0,es ESP,MF,25.0,2.5,5.0,2.0,2.0,2.0,1.0,1.0,4.0,25.0,3.0,6.0,1.0,5.0,2.0,7.0,3.0,0.0,Matches,236.0,es ESP,MF,25.0,2.5,7.0,2.85,7.0,0.0,0.0,0.0,0.0,0.0,0.0,0.0,0.0,0.0,0.0,0.0,0.0,0.0,Matches,,,,,,,,,,,,,,,,,,,,,,,,,,,,,,,,,,,,,,,,,,,,,,,,,,,,,,,,236.0,es ESP,MF,25.0,2.5,2.0,0.0,0.0,5.0,3.0,0.0,0.0,2.0,2.0,0.0,0.0,0.0,19.0,3.0,2.0,60.0,Matches,236.0,es ESP,MF,25.0,2.5,179.0,178.0,0.0,0.0,1.0,0.0,0.0,0.0,0.0,0.0,0.0,0.0,161.0,1.0,2.0,Matches,236.0,es ESP,MF,25.0,2.5,161.0,179.0,89.9,2454.0,585.0,85.0,88.0,96.6,66.0,71.0,93.0,5.0,8.0,62.5,0.0,0.7,0.3,-0.7,4.0,23.0,1.0,0.0,15.0,Matches,288,es ESP,MF,25,8,221.0,28.0,6.5,2.5,2,55.0,0,6,19.0,23,2.75,5.0,1.0,4.0,1.63,1.29,5.1,1.5,3.6,1.46,1.0,Matches,236.0,es ESP,MF,25.0,2.5,200.0,2.0,28.0,127.0,49.0,0.0,200.0,4.0,3.0,75.0,1.0,25.0,122.0,577.0,311.0,4.0,4.0,0.0,1.0,1.0,147.0,3.0,Matches,236.0,es ESP,MF,25.0,2.5,0.0,1.0,0.0,0.0,0.41,0.0,0.0,,23.7,0.0,0.0,0.0,0.0,0.0,0.03,0.0,0.0,Matches,236.0,es ESP,MF,25.0,8.0,2.0,221.0,2.5,0.0,0.0,0.0,0.0,0.0,0.0,2.0,0.0,0.0,0.0,0.7,0.7,4.0,15.0,3.0,0.0,0.0,0.0,0.0,0.0,0.01,0.28,0.29,0.01,0.29,Matches,Ander Guevara,DM/M C,25,131,145,"Spain,Pays Basque",Real San Sebastián,9,8,12,10,12,8,11,14,8,14,14,8,13,14,14,13,14,10,12,14,10,13,8,10,9,13,16,16,12,14,13,10,14,11,15,13,12,15,12,11,18,3,3,2,1,3,3,3,3,1,2,1,14,9,7,15,13,14,11,12,1,1,1,1,1,1,20,1,20,1,1,1,1,1,180,73,13,20,7296605,6550,6550,4400,Mediterranean_Hispanic,130,0,1997/7/7,0,0,12466.0,,67246381
389,Haissem Hassan,Villarreal,2002,245.0,fr FRA,FWMF,20.0,0.6,0.0,0.0,0.0,0.0,0.0,0.0,2.0,0.0,2.0,0.0,0.0,0.0,1.0,1.0,0.0,0.0,Matches,245.0,fr FRA,FWMF,20.0,0.6,1.0,1.73,1.0,0.0,0.0,0.0,0.0,0.0,0.0,0.0,0.0,0.0,0.0,0.0,0.0,0.0,Matches,,,,,,,,,,,,,,,,,,,,,,,,,,,,,,,,,,,,,,,,,,,,,,,,,,,,,,,,245.0,fr FRA,FWMF,20.0,0.6,0.0,0.0,0.0,0.0,1.0,0.0,1.0,1.0,0.0,0.0,0.0,0.0,2.0,1.0,1.0,50.0,Matches,245.0,fr FRA,FWMF,20.0,0.6,20.0,20.0,0.0,0.0,0.0,1.0,1.0,0.0,0.0,0.0,0.0,0.0,15.0,0.0,0.0,Matches,245.0,fr FRA,FWMF,20.0,0.6,15.0,20.0,75.0,292.0,38.0,6.0,8.0,75.0,7.0,9.0,77.8,2.0,2.0,100.0,0.0,0.0,0.0,0.0,1.0,3.0,0.0,0.0,0.0,Matches,299,fr FRA,FWMF,20,2,52.0,26.0,1.5,0.6,0,,0,2,26.0,13,1.5,1.0,0.0,1.0,1.73,1.25,0.5,1.0,-0.5,-0.87,-1.2,Matches,245.0,fr FRA,FWMF,20.0,0.6,25.0,1.0,6.0,10.0,11.0,1.0,25.0,4.0,2.0,50.0,1.0,25.0,21.0,224.0,60.0,3.0,1.0,1.0,2.0,0.0,21.0,3.0,Matches,245.0,fr FRA,FWMF,20.0,0.6,0.0,0.0,0.0,,0.0,0.0,,,,0.0,0.0,0.0,0.0,0.0,,0.0,0.0,Matches,245.0,fr FRA,FWMF,20.0,2.0,0.0,52.0,0.6,0.0,0.0,0.0,0.0,0.0,0.0,0.0,0.0,0.0,0.0,0.0,0.0,3.0,0.0,3.0,0.0,0.0,0.0,0.0,0.0,0.0,0.04,0.04,0.0,0.04,Matches,Haissem Hassan,AM RL,20,109,-75,"France,Egypt,Tunisia",Villarreal,9,13,14,11,14,10,7,10,7,7,11,11,7,15,5,10,6,9,9,13,10,13,16,9,12,7,7,8,13,14,13,9,7,13,11,10,10,5,8,12,13,1,1,2,1,3,1,2,1,2,2,3,13,11,1,9,10,12,13,13,1,1,1,1,1,1,1,15,1,12,20,1,19,12,178,71,20,10,37500000,5450,5450,3950,North_African__Middle_Eastern,108,13,2002/2/8,0,0,1973.0,,49053388
390,Eden Hazard,Real Madrid,1991,246.0,be BEL,FW,31.0,2.2,0.0,0.0,0.0,0.0,0.0,0.0,2.0,0.0,2.0,1.0,0.0,1.0,1.0,1.0,0.0,0.0,Matches,246.0,be BEL,FW,31.0,2.2,16.0,7.35,12.0,1.0,0.0,1.0,2.0,0.0,1.0,0.46,1.0,0.0,0.0,0.0,0.0,0.0,Matches,,,,,,,,,,,,,,,,,,,,,,,,,,,,,,,,,,,,,,,,,,,,,,,,,,,,,,,,246.0,be BEL,FW,31.0,2.2,0.0,0.0,0.0,2.0,9.0,0.0,0.0,1.0,0.0,0.0,0.0,0.0,5.0,1.0,0.0,100.0,Matches,246.0,be BEL,FW,31.0,2.2,108.0,101.0,7.0,2.0,0.0,0.0,0.0,1.0,2.0,0.0,0.0,0.0,96.0,0.0,2.0,Matches,246.0,be BEL,FW,31.0,2.2,96.0,108.0,88.9,1184.0,231.0,60.0,68.0,88.2,21.0,22.0,95.5,4.0,4.0,100.0,1.0,0.5,0.5,0.5,7.0,6.0,3.0,0.0,8.0,Matches,300,be BEL,FW,31,6,196.0,33.0,5.7,2.2,2,59.0,0,4,20.0,27,3.0,5.0,1.0,4.0,1.84,0.86,4.4,1.8,2.6,1.21,0.26,Matches,246.0,be BEL,FW,31.0,2.2,128.0,0.0,5.0,44.0,82.0,13.0,127.0,6.0,2.0,33.3,2.0,33.3,95.0,516.0,268.0,6.0,8.0,1.0,9.0,2.0,112.0,25.0,Matches,246.0,be BEL,FW,31.0,2.2,0.0,2.0,0.0,0.0,0.92,0.0,0.0,,21.6,0.0,0.0,1.0,1.0,0.2,0.09,-1.0,-0.2,Matches,246.0,be BEL,FW,31.0,6.0,2.0,196.0,2.2,0.0,1.0,1.0,0.0,0.0,1.0,0.0,0.0,1.0,0.2,0.5,0.7,6.0,8.0,25.0,0.0,0.46,0.46,0.0,0.46,0.45,0.23,0.67,0.08,0.31,Matches,Eden Hazard,AM RLC,31,156,185,Belgium,R. Madrid,12,13,18,15,17,13,7,11,5,3,16,19,4,18,8,13,12,16,13,16,15,15,18,6,15,7,8,11,14,15,17,8,12,13,13,11,11,8,15,17,10,3,3,1,3,3,2,3,1,1,2,3,15,10,9,14,15,12,17,14,1,1,1,1,1,1,1,13,12,11,20,19,16,10,173,76,16,20,30749806,7800,7800,7550,Northern_European,153,5,1991/1/7,120,33,445204.0,,18004418
391,Ander Herrera,Athletic Club,1989,254.0,es ESP,MF,32.0,7.7,18.0,10.0,8.0,7.0,3.0,6.0,18.0,33.3,12.0,12.0,3.0,9.0,11.0,29.0,12.0,0.0,Matches,254.0,es ESP,MF,32.0,7.7,23.0,2.97,20.0,0.0,0.0,1.0,1.0,1.0,1.0,0.13,1.0,0.0,0.0,0.0,0.0,0.0,Matches,,,,,,,,,,,,,,,,,,,,,,,,,,,,,,,,,,,,,,,,,,,,,,,,,,,,,,,,254.0,es ESP,MF,32.0,7.7,4.0,1.0,0.0,20.0,11.0,0.0,7.0,11.0,10.0,0.0,0.0,0.0,53.0,7.0,5.0,58.3,Matches,254.0,es ESP,MF,32.0,7.7,455.0,444.0,9.0,8.0,6.0,0.0,7.0,0.0,1.0,0.0,0.0,0.0,376.0,2.0,4.0,Matches,254.0,es ESP,MF,32.0,7.7,376.0,455.0,82.6,5618.0,1359.0,210.0,239.0,87.9,128.0,153.0,83.7,22.0,35.0,62.9,1.0,0.9,0.9,0.1,11.0,32.0,7.0,0.0,40.0,Matches,309,es ESP,MF,32,17,697.0,41.0,20.4,7.7,9,59.0,0,8,21.0,5,1.47,10.0,10.0,0.0,0.0,-0.13,12.9,7.4,5.5,0.71,0.32,Matches,254.0,es ESP,MF,32.0,7.7,540.0,18.0,99.0,302.0,141.0,17.0,540.0,10.0,5.0,50.0,4.0,40.0,316.0,1009.0,452.0,8.0,8.0,1.0,6.0,8.0,387.0,14.0,Matches,254.0,es ESP,MF,32.0,7.7,0.0,10.0,1.0,10.0,1.29,0.13,0.0,0.0,20.9,2.0,0.0,0.0,0.5,0.5,0.05,-0.5,-0.5,Matches,254.0,es ESP,MF,32.0,17.0,9.0,697.0,7.7,0.0,1.0,1.0,0.0,0.0,0.0,4.0,1.0,0.5,0.5,0.9,1.4,8.0,40.0,14.0,0.0,0.13,0.13,0.0,0.13,0.07,0.11,0.18,0.07,0.18,Matches,Ander Herrera,DM/M C,32,145,156,"Spain,Pays Basque",Paris Saint-Germain,7,15,9,10,15,7,5,9,3,15,15,14,14,15,17,17,14,13,14,14,13,18,8,15,12,14,16,18,13,15,12,8,16,13,16,11,16,17,17,6,13,3,3,1,2,1,3,1,1,4,2,1,16,17,8,15,13,18,8,14,1,1,1,1,1,1,17,9,20,9,10,14,10,1,182,71,10,20,7979705,7250,7250,6250,Mediterranean_Hispanic,145,5,1989/8/14,2,0,149589.0,A. Bilbao,67009261
392,Omar El Hilali,Espanyol,2003,257.0,ma MAR,DFMF,18.0,1.0,3.0,2.0,3.0,0.0,0.0,1.0,2.0,50.0,1.0,1.0,0.0,1.0,1.0,4.0,6.0,0.0,Matches,257.0,ma MAR,DFMF,18.0,1.0,2.0,1.94,2.0,0.0,0.0,0.0,0.0,0.0,0.0,0.0,0.0,0.0,0.0,0.0,0.0,0.0,Matches,,,,,,,,,,,,,,,,,,,,,,,,,,,,,,,,,,,,,,,,,,,,,,,,,,,,,,,,257.0,ma MAR,DFMF,18.0,1.0,1.0,0.0,0.0,0.0,2.0,0.0,2.0,1.0,2.0,0.0,0.0,0.0,10.0,2.0,1.0,66.7,Matches,257.0,ma MAR,DFMF,18.0,1.0,35.0,28.0,7.0,0.0,0.0,0.0,2.0,7.0,0.0,0.0,0.0,0.0,21.0,0.0,1.0,Matches,257.0,ma MAR,DFMF,18.0,1.0,21.0,35.0,60.0,356.0,128.0,8.0,12.0,66.7,13.0,17.0,76.5,0.0,5.0,0.0,0.0,0.0,0.0,0.0,1.0,0.0,0.0,0.0,0.0,Matches,314,ma MAR,DFMF,18,5,92.0,18.0,2.7,1.0,1,53.0,0,4,10.0,14,0.8,2.0,2.0,0.0,0.0,0.46,0.9,1.6,-0.7,-0.66,-0.37,Matches,257.0,ma MAR,DFMF,18.0,1.0,55.0,6.0,30.0,15.0,10.0,1.0,55.0,1.0,0.0,0.0,1.0,100.0,19.0,44.0,5.0,0.0,0.0,0.0,4.0,0.0,20.0,5.0,Matches,257.0,ma MAR,DFMF,18.0,1.0,0.0,0.0,0.0,,0.0,0.0,,,,0.0,0.0,0.0,0.0,0.0,,0.0,0.0,Matches,257.0,ma MAR,DFMF,18.0,5.0,1.0,92.0,1.0,0.0,0.0,0.0,0.0,0.0,0.0,1.0,0.0,0.0,0.0,0.0,0.0,0.0,0.0,5.0,0.0,0.0,0.0,0.0,0.0,0.0,0.01,0.01,0.0,0.01,Matches,Omar El Hilali,D/WB R,18,95,-75,"Morocco,Spain",Espanyol,5,9,10,3,10,3,8,5,7,10,10,6,14,10,12,9,9,10,9,10,14,11,5,9,9,10,8,10,14,14,9,11,15,14,14,8,14,5,8,10,18,1,3,1,1,1,3,1,1,2,1,1,13,11,2,11,12,10,6,13,1,14,10,20,1,18,1,1,1,14,1,1,14,1,181,0,20,6,6391246,4500,4500,1250,North_African__Middle_Eastern,93,10,2003/9/12,0,0,420.0,,2000049425
393,Alexander Isak,Real Sociedad,1999,263.0,se SWE,FW,22.0,1.7,1.0,1.0,0.0,0.0,1.0,0.0,0.0,,0.0,0.0,0.0,0.0,0.0,1.0,2.0,0.0,Matches,263.0,se SWE,FW,22.0,1.7,2.0,1.18,2.0,0.0,0.0,0.0,0.0,0.0,0.0,0.0,0.0,0.0,0.0,0.0,0.0,0.0,Matches,,,,,,,,,,,,,,,,,,,,,,,,,,,,,,,,,,,,,,,,,,,,,,,,,,,,,,,,263.0,se SWE,FW,22.0,1.7,0.0,0.0,0.0,1.0,0.0,0.0,2.0,0.0,1.0,0.0,0.0,0.0,2.0,0.0,0.0,,Matches,263.0,se SWE,FW,22.0,1.7,30.0,25.0,4.0,0.0,0.0,0.0,2.0,0.0,0.0,0.0,0.0,0.0,17.0,1.0,2.0,Matches,263.0,se SWE,FW,22.0,1.7,17.0,30.0,56.7,236.0,60.0,11.0,14.0,78.6,6.0,9.0,66.7,0.0,2.0,0.0,0.0,0.1,0.0,-0.1,2.0,0.0,1.0,0.0,3.0,Matches,321,se SWE,FW,22,2,152.0,76.0,4.4,1.7,2,76.0,0,0,,0,1.5,2.0,3.0,-1.0,-0.59,-1.06,1.9,1.9,0.0,0.0,-0.55,Matches,263.0,se SWE,FW,22.0,1.7,46.0,3.0,5.0,19.0,22.0,11.0,46.0,5.0,2.0,40.0,3.0,60.0,29.0,214.0,72.0,3.0,2.0,2.0,3.0,2.0,33.0,11.0,Matches,263.0,se SWE,FW,22.0,1.7,1.0,3.0,1.0,33.3,1.78,0.59,0.33,1.0,12.0,0.0,0.0,0.0,0.2,0.2,0.07,0.8,0.8,Matches,263.0,se SWE,FW,22.0,2.0,2.0,152.0,1.7,1.0,0.0,1.0,1.0,0.0,0.0,0.0,0.0,0.2,0.2,0.1,0.3,3.0,3.0,11.0,0.59,0.0,0.59,0.59,0.59,0.12,0.06,0.18,0.12,0.18,Matches,Alexander Isak,S,22,151,166,"Sweden,Eritrea",Newcastle United,7,9,15,14,15,8,12,9,6,5,13,14,6,16,11,15,13,13,11,15,14,14,16,7,16,6,12,12,17,15,15,16,14,16,14,12,12,7,15,5,8,2,3,3,3,1,1,3,2,3,3,2,13,15,5,10,13,12,14,14,1,1,1,1,1,1,1,12,1,12,12,10,12,20,190,74,10,20,140433523,7450,6759,5507,African_Caribbean,150,14,1999/9/21,37,9,139190.0,,93070286
394,Isco,Sevilla,1992,264.0,es ESP,MFFW,30.0,8.9,15.0,9.0,6.0,5.0,4.0,8.0,14.0,57.1,6.0,3.0,0.0,3.0,10.0,25.0,3.0,0.0,Matches,264.0,es ESP,MFFW,30.0,8.9,32.0,3.6,22.0,5.0,2.0,0.0,2.0,1.0,3.0,0.34,2.0,0.0,1.0,0.0,0.0,0.0,Matches,,,,,,,,,,,,,,,,,,,,,,,,,,,,,,,,,,,,,,,,,,,,,,,,,,,,,,,,264.0,es ESP,MFFW,30.0,8.9,5.0,0.0,0.0,11.0,34.0,6.0,18.0,10.0,9.0,0.0,0.0,0.0,48.0,5.0,14.0,26.3,Matches,264.0,es ESP,MFFW,30.0,8.9,417.0,371.0,42.0,25.0,3.0,5.0,18.0,2.0,11.0,2.0,7.0,0.0,346.0,4.0,4.0,Matches,264.0,es ESP,MFFW,30.0,8.9,346.0,417.0,83.0,5315.0,1337.0,192.0,211.0,91.0,109.0,124.0,87.9,27.0,50.0,54.0,2.0,1.7,1.1,0.3,17.0,45.0,8.0,0.0,37.0,Matches,322,es ESP,MFFW,30,12,799.0,67.0,23.4,8.9,10,74.0,4,2,28.0,0,0.83,9.0,14.0,-5.0,-0.56,-0.49,8.3,15.4,-7.1,-0.81,-0.78,Matches,264.0,es ESP,MFFW,30.0,8.9,509.0,9.0,70.0,275.0,172.0,20.0,509.0,29.0,11.0,37.9,9.0,31.0,339.0,2050.0,818.0,16.0,23.0,1.0,21.0,22.0,387.0,36.0,Matches,264.0,es ESP,MFFW,30.0,8.9,0.0,4.0,1.0,25.0,0.45,0.11,0.0,0.0,15.6,0.0,0.0,0.0,0.4,0.4,0.11,-0.4,-0.4,Matches,264.0,es ESP,MFFW,30.0,12.0,10.0,799.0,8.9,0.0,2.0,2.0,0.0,0.0,0.0,5.0,0.0,0.4,0.4,1.7,2.1,16.0,37.0,36.0,0.0,0.23,0.23,0.0,0.23,0.05,0.19,0.24,0.05,0.24,Matches,Isco,M/AM RLC,30,142,180,Spain,Sevilla,15,15,16,13,18,14,9,15,8,5,17,15,8,19,10,12,8,12,12,19,13,13,18,12,12,11,8,7,9,11,17,8,9,10,10,13,12,10,11,5,15,3,1,2,2,3,2,1,2,2,2,3,10,14,14,8,15,8,13,11,1,1,1,1,1,1,1,17,18,16,17,20,17,10,176,79,14,20,13868925,7200,7200,6500,Mediterranean_Hispanic,135,6,1992/4/21,38,12,32145.0,,67103537
395,Adnan Januzaj,Sevilla,1995,267.0,be BEL,FW,27.0,0.5,0.0,0.0,0.0,0.0,0.0,0.0,1.0,0.0,1.0,0.0,0.0,0.0,1.0,1.0,0.0,0.0,Matches,267.0,be BEL,FW,27.0,0.5,0.0,0.0,0.0,0.0,0.0,0.0,0.0,0.0,0.0,0.0,0.0,0.0,0.0,0.0,0.0,0.0,Matches,,,,,,,,,,,,,,,,,,,,,,,,,,,,,,,,,,,,,,,,,,,,,,,,,,,,,,,,267.0,be BEL,FW,27.0,0.5,0.0,0.0,0.0,1.0,2.0,0.0,1.0,1.0,0.0,0.0,0.0,0.0,5.0,0.0,0.0,,Matches,267.0,be BEL,FW,27.0,0.5,24.0,22.0,1.0,0.0,0.0,0.0,1.0,0.0,1.0,0.0,1.0,0.0,15.0,1.0,3.0,Matches,267.0,be BEL,FW,27.0,0.5,15.0,24.0,62.5,229.0,35.0,10.0,12.0,83.3,4.0,5.0,80.0,1.0,3.0,33.3,0.0,0.0,0.0,0.0,0.0,0.0,0.0,0.0,1.0,Matches,326,be BEL,FW,27,2,47.0,24.0,1.4,0.5,1,45.0,0,1,2.0,12,0.0,0.0,0.0,0.0,0.0,0.19,0.0,0.4,-0.4,-0.72,-0.52,Matches,267.0,be BEL,FW,27.0,0.5,30.0,0.0,2.0,12.0,16.0,1.0,30.0,8.0,4.0,50.0,3.0,37.5,19.0,171.0,32.0,0.0,1.0,0.0,1.0,1.0,22.0,6.0,Matches,267.0,be BEL,FW,27.0,0.5,0.0,0.0,0.0,,0.0,0.0,,,,0.0,0.0,0.0,0.0,0.0,,0.0,0.0,Matches,267.0,be BEL,FW,27.0,2.0,1.0,47.0,0.5,0.0,0.0,0.0,0.0,0.0,0.0,0.0,0.0,0.0,0.0,0.0,0.0,0.0,1.0,6.0,0.0,0.0,0.0,0.0,0.0,0.0,0.0,0.0,0.0,0.0,Matches,Adnan Januzaj,M/AM RL,27,143,155,"Belgium,Albania,Kosovo",Sevilla,16,13,17,13,15,15,5,15,3,6,15,13,6,17,10,11,8,13,11,16,13,10,17,11,13,8,8,11,15,16,15,9,11,14,12,9,10,5,14,12,15,2,1,1,2,2,3,1,3,2,2,1,18,15,11,10,12,11,7,13,1,1,1,1,1,1,1,18,12,16,17,13,20,10,180,75,20,11,22014169,7150,7150,6000,Northern_European,141,4,1995/2/5,13,1,30072.0,,18054092
396,Joaquín,Betis,1981,269.0,es ESP,MFFW,41.0,5.5,3.0,3.0,2.0,1.0,0.0,1.0,3.0,33.3,2.0,7.0,2.0,5.0,4.0,7.0,5.0,0.0,Matches,269.0,es ESP,MFFW,41.0,5.5,29.0,5.37,23.0,3.0,1.0,1.0,1.0,0.0,2.0,0.37,2.0,0.0,0.0,0.0,0.0,0.0,Matches,,,,,,,,,,,,,,,,,,,,,,,,,,,,,,,,,,,,,,,,,,,,,,,,,,,,,,,,269.0,es ESP,MFFW,41.0,5.5,2.0,0.0,0.0,1.0,8.0,1.0,31.0,4.0,3.0,0.0,0.0,0.0,25.0,1.0,5.0,16.7,Matches,269.0,es ESP,MFFW,41.0,5.5,324.0,291.0,33.0,11.0,4.0,1.0,31.0,5.0,17.0,4.0,9.0,0.0,258.0,0.0,9.0,Matches,269.0,es ESP,MFFW,41.0,5.5,258.0,324.0,79.6,3561.0,928.0,159.0,175.0,90.9,74.0,91.0,81.3,12.0,31.0,38.7,2.0,1.8,1.8,0.2,21.0,15.0,11.0,3.0,26.0,Matches,330,es ESP,MFFW,41,22,496.0,23.0,14.5,5.5,2,63.0,0,20,19.0,11,1.18,10.0,3.0,7.0,1.27,1.33,12.0,6.5,5.5,1.02,1.15,Matches,269.0,es ESP,MFFW,41.0,5.5,377.0,7.0,42.0,152.0,186.0,17.0,377.0,19.0,11.0,57.9,6.0,31.6,227.0,1286.0,714.0,23.0,16.0,6.0,13.0,6.0,275.0,37.0,Matches,269.0,es ESP,MFFW,41.0,5.5,0.0,8.0,3.0,37.5,1.45,0.54,0.0,0.0,15.0,0.0,0.0,0.0,0.7,0.7,0.09,-0.7,-0.7,Matches,269.0,es ESP,MFFW,41.0,22.0,2.0,496.0,5.5,0.0,2.0,2.0,0.0,0.0,0.0,2.0,0.0,0.7,0.7,1.8,2.5,23.0,26.0,37.0,0.0,0.36,0.36,0.0,0.36,0.13,0.33,0.46,0.13,0.46,Matches,Joaquín,M/AM RLC,41,135,160,Spain,Real Hispalis,16,16,16,12,16,9,8,11,7,6,16,14,8,16,7,13,10,15,11,15,14,13,17,18,14,7,13,10,13,13,12,9,15,13,10,9,13,8,15,2,14,2,1,1,2,1,1,2,2,1,4,3,14,13,9,16,15,15,10,13,1,1,1,1,12,12,1,12,1,19,16,15,20,1,179,75,10,20,740112,6900,6900,5850,Mediterranean_Hispanic,134,4,1981/7/21,51,4,40486.0,,814555
397,Willian José,Betis,1991,273.0,br BRA,FW,30.0,8.1,9.0,6.0,6.0,3.0,0.0,4.0,9.0,44.4,5.0,4.0,0.0,4.0,1.0,10.0,15.0,0.0,Matches,273.0,br BRA,FW,30.0,8.1,12.0,1.48,9.0,0.0,0.0,3.0,0.0,0.0,2.0,0.25,0.0,0.0,0.0,2.0,0.0,0.0,Matches,,,,,,,,,,,,,,,,,,,,,,,,,,,,,,,,,,,,,,,,,,,,,,,,,,,,,,,,273.0,br BRA,FW,30.0,8.1,1.0,0.0,0.0,9.0,6.0,3.0,4.0,1.0,6.0,0.0,0.0,0.0,31.0,16.0,20.0,44.4,Matches,273.0,br BRA,FW,30.0,8.1,266.0,249.0,17.0,0.0,1.0,2.0,4.0,0.0,0.0,0.0,0.0,0.0,206.0,0.0,9.0,Matches,273.0,br BRA,FW,30.0,8.1,206.0,266.0,77.4,2771.0,446.0,118.0,137.0,86.1,67.0,84.0,79.8,8.0,15.0,53.3,1.0,1.3,0.5,-0.3,8.0,4.0,3.0,0.0,14.0,Matches,336,br BRA,FW,30,28,731.0,26.0,21.4,8.1,6,76.0,2,22,13.0,7,1.61,8.0,11.0,-3.0,-0.37,-0.64,10.5,12.3,-1.8,-0.22,-0.32,Matches,273.0,br BRA,FW,30.0,8.1,339.0,15.0,52.0,162.0,126.0,16.0,338.0,7.0,2.0,28.6,4.0,57.1,170.0,706.0,243.0,6.0,9.0,2.0,17.0,10.0,234.0,27.0,Matches,273.0,br BRA,FW,30.0,8.1,2.0,20.0,6.0,30.0,2.46,0.74,0.05,0.17,18.7,2.0,1.0,1.0,2.9,2.2,0.11,-0.9,-1.2,Matches,273.0,br BRA,FW,30.0,28.0,6.0,731.0,8.1,2.0,1.0,3.0,1.0,1.0,1.0,1.0,0.0,2.9,2.2,1.3,3.5,6.0,14.0,27.0,0.25,0.12,0.37,0.12,0.25,0.36,0.17,0.53,0.27,0.43,Matches,Willian José,AM/S C,30,142,155,"Brazil,Spain",Real Hispalis,10,10,15,14,14,15,16,17,7,5,14,16,8,15,13,12,15,14,11,13,12,15,15,9,14,13,14,12,11,12,11,14,13,12,12,17,13,15,13,10,7,1,2,1,3,2,2,1,3,1,2,1,12,15,12,7,12,14,9,8,1,1,1,1,1,1,1,1,1,1,9,18,8,20,186,87,13,20,14416398,7100,7000,5750,Mixed_Race,142,11,1991/11/23,0,0,57999.0,,19081798
398,Lago Junior,Mallorca,1990,277.0,ci CIV,FWMF,31.0,0.6,1.0,0.0,0.0,1.0,0.0,1.0,1.0,100.0,0.0,0.0,0.0,0.0,0.0,1.0,0.0,0.0,Matches,277.0,ci CIV,FWMF,31.0,0.6,1.0,1.73,1.0,0.0,0.0,0.0,0.0,0.0,0.0,0.0,0.0,0.0,0.0,0.0,0.0,0.0,Matches,,,,,,,,,,,,,,,,,,,,,,,,,,,,,,,,,,,,,,,,,,,,,,,,,,,,,,,,277.0,ci CIV,FWMF,31.0,0.6,0.0,0.0,0.0,3.0,1.0,0.0,2.0,0.0,0.0,0.0,0.0,0.0,7.0,4.0,1.0,80.0,Matches,277.0,ci CIV,FWMF,31.0,0.6,18.0,18.0,0.0,0.0,0.0,0.0,2.0,0.0,0.0,0.0,0.0,0.0,12.0,0.0,1.0,Matches,277.0,ci CIV,FWMF,31.0,0.6,12.0,18.0,66.7,154.0,31.0,6.0,7.0,85.7,3.0,5.0,60.0,1.0,2.0,50.0,0.0,0.0,0.0,0.0,0.0,0.0,0.0,0.0,0.0,Matches,340,ci CIV,FWMF,31,5,52.0,10.0,1.5,0.6,0,,0,5,10.0,9,0.2,0.0,2.0,-2.0,-3.46,-3.35,1.0,1.3,-0.3,-0.51,-0.22,Matches,277.0,ci CIV,FWMF,31.0,0.6,27.0,0.0,4.0,9.0,15.0,1.0,27.0,1.0,1.0,100.0,0.0,0.0,18.0,75.0,34.0,2.0,2.0,0.0,3.0,1.0,20.0,5.0,Matches,277.0,ci CIV,FWMF,31.0,0.6,0.0,2.0,1.0,50.0,3.46,1.73,0.0,0.0,17.4,0.0,0.0,0.0,0.0,0.0,0.01,0.0,0.0,Matches,277.0,ci CIV,FWMF,31.0,5.0,0.0,52.0,0.6,0.0,0.0,0.0,0.0,0.0,0.0,0.0,0.0,0.0,0.0,0.0,0.0,2.0,0.0,5.0,0.0,0.0,0.0,0.0,0.0,0.03,0.0,0.03,0.03,0.03,Matches,Lago Junior,AM/S RL,31,128,132,Ivory Coast,Mallorca,7,11,12,13,10,8,9,12,7,7,11,11,7,12,9,13,9,10,11,11,9,17,9,8,15,6,8,13,15,15,12,10,14,15,13,12,12,6,12,3,17,1,2,1,3,3,3,3,1,2,3,1,10,10,3,10,13,13,11,18,1,1,1,1,1,1,1,15,5,15,20,13,19,19,180,74,9,20,1812016,6400,6250,4800,African_Caribbean,116,18,1990/12/31,4,0,8491.0,,67092251
399,Tino Kadewere,Mallorca,1996,280.0,zw ZIM,FWMF,26.0,6.0,6.0,3.0,3.0,3.0,0.0,4.0,9.0,44.4,5.0,6.0,2.0,4.0,2.0,8.0,1.0,0.0,Matches,280.0,zw ZIM,FWMF,26.0,6.0,12.0,1.99,9.0,0.0,3.0,0.0,0.0,0.0,0.0,0.0,0.0,0.0,0.0,0.0,0.0,0.0,Matches,,,,,,,,,,,,,,,,,,,,,,,,,,,,,,,,,,,,,,,,,,,,,,,,,,,,,,,,280.0,zw ZIM,FWMF,26.0,6.0,1.0,0.0,0.0,6.0,3.0,5.0,7.0,2.0,3.0,0.0,0.0,0.0,17.0,30.0,20.0,60.0,Matches,280.0,zw ZIM,FWMF,26.0,6.0,151.0,147.0,2.0,0.0,0.0,0.0,7.0,1.0,0.0,0.0,0.0,0.0,95.0,2.0,4.0,Matches,280.0,zw ZIM,FWMF,26.0,6.0,95.0,151.0,62.9,1261.0,233.0,56.0,79.0,70.9,29.0,43.0,67.4,3.0,11.0,27.3,0.0,0.6,0.2,-0.6,3.0,6.0,0.0,0.0,4.0,Matches,343,zw ZIM,FWMF,26,15,542.0,36.0,15.8,6.0,5,62.0,0,10,23.0,11,1.2,8.0,7.0,1.0,0.17,0.38,5.9,6.8,-0.9,-0.15,0.17,Matches,280.0,zw ZIM,FWMF,26.0,6.0,224.0,3.0,22.0,114.0,94.0,28.0,224.0,14.0,8.0,57.1,4.0,28.6,122.0,710.0,333.0,14.0,5.0,9.0,15.0,11.0,163.0,29.0,Matches,280.0,zw ZIM,FWMF,26.0,6.0,1.0,19.0,6.0,31.6,3.15,1.0,0.05,0.17,18.7,0.0,0.0,0.0,1.6,1.6,0.08,-0.6,-0.6,Matches,280.0,zw ZIM,FWMF,26.0,15.0,5.0,542.0,6.0,1.0,0.0,1.0,1.0,0.0,0.0,1.0,0.0,1.6,1.6,0.6,2.2,14.0,4.0,29.0,0.17,0.0,0.17,0.17,0.17,0.26,0.1,0.37,0.26,0.37,Matches,Tino Kadewere,AM/S RC,26,131,134,Zimbabwe,Olympique Lyonnais,8,12,12,13,13,8,13,10,7,7,12,14,5,13,9,12,12,13,11,13,12,12,14,8,14,8,12,13,15,14,12,12,14,15,15,14,11,8,12,6,17,1,3,1,1,1,2,3,2,1,2,2,10,14,6,8,10,12,9,9,1,1,1,1,1,1,1,1,7,1,12,17,15,20,183,72,8,20,1894145,6000,6550,3950,African_Caribbean,130,15,1996/1/5,22,3,23014.0,Mallorca,93070869
400,Kaiky,Almería,2004,281.0,br BRA,DF,18.0,6.5,5.0,5.0,5.0,0.0,0.0,3.0,7.0,42.9,4.0,18.0,10.0,8.0,11.0,16.0,28.0,0.0,Matches,281.0,br BRA,DF,18.0,6.5,1.0,0.15,1.0,0.0,0.0,0.0,0.0,0.0,0.0,0.0,0.0,0.0,0.0,0.0,0.0,0.0,Matches,,,,,,,,,,,,,,,,,,,,,,,,,,,,,,,,,,,,,,,,,,,,,,,,,,,,,,,,281.0,br BRA,DF,18.0,6.5,5.0,0.0,0.0,7.0,3.0,0.0,1.0,11.0,5.0,0.0,1.0,0.0,22.0,6.0,10.0,37.5,Matches,281.0,br BRA,DF,18.0,6.5,224.0,208.0,16.0,15.0,0.0,9.0,1.0,1.0,0.0,0.0,0.0,0.0,182.0,0.0,2.0,Matches,281.0,br BRA,DF,18.0,6.5,182.0,224.0,81.3,3877.0,1389.0,60.0,65.0,92.3,84.0,97.0,86.6,34.0,54.0,63.0,0.0,0.0,0.0,0.0,0.0,12.0,1.0,0.0,11.0,Matches,344,br BRA,DF,18,13,581.0,45.0,17.0,6.5,7,79.0,3,6,5.0,13,1.31,6.0,13.0,-7.0,-1.08,-0.8,6.7,13.5,-6.8,-1.06,-0.73,Matches,281.0,br BRA,DF,18.0,6.5,294.0,61.0,184.0,108.0,3.0,1.0,294.0,3.0,2.0,66.7,1.0,33.3,167.0,886.0,513.0,7.0,2.0,0.0,5.0,0.0,180.0,2.0,Matches,281.0,br BRA,DF,18.0,6.5,0.0,1.0,0.0,0.0,0.15,0.0,0.0,,11.7,0.0,0.0,0.0,0.1,0.1,0.08,-0.1,-0.1,Matches,281.0,br BRA,DF,18.0,13.0,7.0,581.0,6.5,0.0,0.0,0.0,0.0,0.0,0.0,5.0,0.0,0.1,0.1,0.0,0.1,7.0,11.0,2.0,0.0,0.0,0.0,0.0,0.0,0.01,0.0,0.01,0.01,0.01,Matches,Kaiky,D C,18,125,-85,Brazil,Almería,4,6,9,9,13,7,13,7,7,14,13,9,14,13,13,13,11,11,13,14,12,14,9,8,13,13,13,13,12,12,11,14,13,12,13,13,12,9,11,4,9,1,2,1,3,2,1,3,1,2,3,3,15,13,8,12,11,10,9,17,1,1,20,1,1,1,1,1,1,1,1,1,1,1,186,76,12,20,76841996,6243,6243,3743,Mediterranean_Hispanic,124,4,2004/1/12,0,0,11506.0,,2000015032
401,Jon Karrikaburu,Real Sociedad,2002,283.0,es ESP,FW,19.0,1.0,1.0,0.0,0.0,1.0,0.0,0.0,0.0,,0.0,2.0,0.0,2.0,0.0,1.0,0.0,0.0,Matches,283.0,es ESP,FW,19.0,1.0,2.0,1.96,2.0,0.0,0.0,0.0,0.0,0.0,0.0,0.0,0.0,0.0,0.0,0.0,0.0,0.0,Matches,,,,,,,,,,,,,,,,,,,,,,,,,,,,,,,,,,,,,,,,,,,,,,,,,,,,,,,,283.0,es ESP,FW,19.0,1.0,1.0,0.0,0.0,3.0,4.0,3.0,1.0,0.0,0.0,0.0,0.0,0.0,5.0,4.0,4.0,50.0,Matches,283.0,es ESP,FW,19.0,1.0,18.0,18.0,0.0,0.0,1.0,0.0,1.0,0.0,0.0,0.0,0.0,0.0,11.0,0.0,0.0,Matches,283.0,es ESP,FW,19.0,1.0,11.0,18.0,61.1,164.0,66.0,5.0,7.0,71.4,2.0,4.0,50.0,2.0,3.0,66.7,0.0,0.3,0.1,-0.3,1.0,2.0,1.0,0.0,4.0,Matches,346,es ESP,FW,19,6,93.0,16.0,2.7,1.0,0,,0,6,16.0,11,1.0,0.0,3.0,-3.0,-2.9,-3.42,1.5,1.8,-0.3,-0.3,-0.85,Matches,283.0,es ESP,FW,19.0,1.0,38.0,0.0,0.0,18.0,20.0,3.0,38.0,0.0,0.0,,0.0,,22.0,127.0,38.0,2.0,1.0,1.0,4.0,3.0,28.0,2.0,Matches,283.0,es ESP,FW,19.0,1.0,0.0,5.0,1.0,20.0,4.84,0.97,0.0,0.0,20.1,0.0,0.0,0.0,0.3,0.3,0.06,-0.3,-0.3,Matches,283.0,es ESP,FW,19.0,6.0,0.0,93.0,1.0,0.0,0.0,0.0,0.0,0.0,0.0,1.0,0.0,0.3,0.3,0.3,0.6,2.0,4.0,2.0,0.0,0.0,0.0,0.0,0.0,0.27,0.3,0.57,0.27,0.57,Matches,Jon Karrikaburu,S,19,119,-85,"Spain,Pays Basque",Real San Sebastián,9,10,14,11,14,7,14,10,5,9,10,7,7,14,5,9,10,10,8,5,11,9,13,11,14,7,13,13,14,14,14,9,14,14,10,13,13,12,12,9,13,1,4,1,1,4,1,3,2,2,1,1,20,13,3,14,10,11,9,18,1,1,1,1,1,1,1,1,1,1,1,1,1,20,184,82,10,20,59560000,5950,5950,3000,Mediterranean_Hispanic,112,5,2002/9/19,0,0,3984.0,,2000082463
402,Kenedy,Valladolid,1996,284.0,br BRA,FWDF,26.0,3.1,6.0,2.0,3.0,3.0,0.0,2.0,4.0,50.0,2.0,2.0,0.0,2.0,1.0,7.0,0.0,0.0,Matches,284.0,br BRA,FWDF,26.0,3.1,6.0,1.96,5.0,0.0,0.0,0.0,1.0,0.0,1.0,0.33,1.0,0.0,0.0,0.0,0.0,0.0,Matches,,,,,,,,,,,,,,,,,,,,,,,,,,,,,,,,,,,,,,,,,,,,,,,,,,,,,,,,284.0,br BRA,FWDF,26.0,3.1,3.0,0.0,0.0,9.0,2.0,0.0,5.0,1.0,2.0,0.0,0.0,0.0,14.0,2.0,3.0,40.0,Matches,284.0,br BRA,FWDF,26.0,3.1,86.0,80.0,5.0,0.0,0.0,1.0,5.0,2.0,1.0,0.0,0.0,0.0,57.0,1.0,4.0,Matches,284.0,br BRA,FWDF,26.0,3.1,57.0,86.0,66.3,800.0,232.0,34.0,42.0,81.0,19.0,25.0,76.0,2.0,10.0,20.0,1.0,0.6,0.6,0.4,4.0,7.0,2.0,2.0,4.0,Matches,347,br BRA,FWDF,26,12,275.0,23.0,8.0,3.1,2,43.0,0,10,19.0,5,0.5,2.0,9.0,-7.0,-2.29,-1.63,4.1,7.7,-3.5,-1.16,-0.5,Matches,284.0,br BRA,FWDF,26.0,3.1,131.0,0.0,18.0,59.0,58.0,13.0,131.0,13.0,4.0,30.8,9.0,69.2,85.0,367.0,142.0,4.0,1.0,3.0,14.0,7.0,94.0,21.0,Matches,284.0,br BRA,FWDF,26.0,3.1,0.0,6.0,3.0,50.0,1.96,0.98,0.0,0.0,21.2,0.0,0.0,0.0,0.5,0.5,0.08,-0.5,-0.5,Matches,284.0,br BRA,FWDF,26.0,12.0,2.0,275.0,3.1,0.0,1.0,1.0,0.0,0.0,0.0,3.0,0.0,0.5,0.5,0.6,1.1,4.0,4.0,21.0,0.0,0.33,0.33,0.0,0.33,0.17,0.19,0.36,0.17,0.36,Matches,Kenedy,WB/M/AM RL,26,130,142,Brazil,Valladolid,11,12,13,12,13,13,10,14,4,7,12,11,11,14,11,13,11,12,11,12,11,13,15,10,13,12,12,12,13,13,13,13,14,13,13,14,10,11,11,6,13,3,2,3,1,3,1,1,2,3,4,1,15,13,7,12,12,9,12,12,1,11,1,1,16,1,1,16,1,12,20,10,17,12,182,81,20,11,3957817,6500,6500,5500,Mediterranean_Hispanic,126,13,1996/2/8,0,0,28998.0,,19192323
403,Lázaro,Almería,2002,300.0,br BRA,FWMF,20.0,8.0,4.0,3.0,3.0,0.0,1.0,3.0,15.0,20.0,12.0,16.0,1.0,15.0,2.0,6.0,1.0,0.0,Matches,300.0,br BRA,FWMF,20.0,8.0,23.0,2.89,15.0,1.0,2.0,2.0,3.0,0.0,2.0,0.25,2.0,0.0,0.0,0.0,0.0,0.0,Matches,,,,,,,,,,,,,,,,,,,,,,,,,,,,,,,,,,,,,,,,,,,,,,,,,,,,,,,,300.0,br BRA,FWMF,20.0,8.0,1.0,0.0,0.0,7.0,12.0,3.0,9.0,2.0,3.0,0.0,0.0,0.0,32.0,6.0,14.0,30.0,Matches,300.0,br BRA,FWMF,20.0,8.0,218.0,204.0,14.0,1.0,0.0,5.0,9.0,1.0,3.0,2.0,0.0,0.0,170.0,0.0,5.0,Matches,300.0,br BRA,FWMF,20.0,8.0,170.0,218.0,78.0,2490.0,660.0,103.0,123.0,83.7,43.0,54.0,79.6,14.0,20.0,70.0,0.0,0.8,0.4,-0.8,12.0,20.0,5.0,1.0,26.0,Matches,366,br BRA,FWMF,20,19,716.0,38.0,20.9,8.0,7,70.0,2,12,19.0,16,0.53,13.0,13.0,0.0,0.0,0.53,11.9,12.1,-0.3,-0.04,0.52,Matches,300.0,br BRA,FWMF,20.0,8.0,321.0,4.0,27.0,138.0,162.0,38.0,321.0,28.0,15.0,53.6,13.0,46.4,208.0,1424.0,665.0,23.0,21.0,3.0,18.0,11.0,236.0,59.0,Matches,300.0,br BRA,FWMF,20.0,8.0,6.0,25.0,12.0,48.0,3.14,1.51,0.24,0.5,15.0,0.0,0.0,0.0,4.0,4.0,0.16,2.0,2.0,Matches,300.0,br BRA,FWMF,20.0,19.0,7.0,716.0,8.0,6.0,0.0,6.0,6.0,0.0,0.0,1.0,0.0,4.0,4.0,0.8,4.8,23.0,26.0,59.0,0.75,0.0,0.75,0.75,0.75,0.5,0.1,0.6,0.5,0.6,Matches,Lázaro,AM RLC,20,123,145,Brazil,Almería,13,12,14,12,14,10,12,10,3,5,14,8,5,14,10,13,12,13,12,14,11,13,15,13,13,8,13,13,12,13,11,12,12,13,13,11,11,11,13,8,17,3,2,3,1,2,3,3,4,3,4,3,9,11,3,12,8,15,14,15,1,1,1,1,1,1,1,15,1,10,20,18,16,15,180,67,8,20,6980400,6150,6150,3000,Mixed_Race,119,12,2002/3/12,0,0,5434.0,,19371032
404,Pol Lirola,Elche,1997,310.0,es ESP,DF,24.0,7.0,13.0,6.0,9.0,3.0,1.0,8.0,13.0,61.5,5.0,3.0,2.0,1.0,7.0,20.0,16.0,0.0,Matches,310.0,es ESP,DF,24.0,7.0,19.0,2.72,18.0,0.0,1.0,0.0,0.0,0.0,0.0,0.0,0.0,0.0,0.0,0.0,0.0,0.0,Matches,,,,,,,,,,,,,,,,,,,,,,,,,,,,,,,,,,,,,,,,,,,,,,,,,,,,,,,,310.0,es ESP,DF,24.0,7.0,1.0,0.0,0.0,4.0,3.0,0.0,32.0,7.0,6.0,0.0,0.0,0.0,45.0,8.0,6.0,57.1,Matches,310.0,es ESP,DF,24.0,7.0,325.0,260.0,65.0,6.0,0.0,3.0,32.0,59.0,0.0,0.0,0.0,0.0,240.0,0.0,11.0,Matches,310.0,es ESP,DF,24.0,7.0,240.0,325.0,73.8,3762.0,1309.0,135.0,154.0,87.7,79.0,107.0,73.8,16.0,38.0,42.1,0.0,0.7,0.6,-0.7,6.0,10.0,3.0,2.0,19.0,Matches,377,es ESP,DF,24,12,628.0,52.0,18.4,7.0,7,73.0,3,5,23.0,19,0.25,5.0,17.0,-12.0,-1.72,-0.91,5.2,11.6,-6.3,-0.91,-0.06,Matches,310.0,es ESP,DF,24.0,7.0,396.0,18.0,126.0,159.0,117.0,8.0,396.0,19.0,7.0,36.8,10.0,52.6,213.0,1264.0,727.0,21.0,18.0,1.0,8.0,5.0,210.0,35.0,Matches,310.0,es ESP,DF,24.0,7.0,1.0,1.0,1.0,100.0,0.14,0.14,1.0,1.0,10.5,0.0,0.0,0.0,0.2,0.2,0.2,0.8,0.8,Matches,310.0,es ESP,DF,24.0,12.0,7.0,628.0,7.0,1.0,0.0,1.0,1.0,0.0,0.0,1.0,0.0,0.2,0.2,0.7,0.9,21.0,19.0,35.0,0.14,0.0,0.14,0.14,0.14,0.03,0.1,0.12,0.03,0.12,Matches,Pol Lirola,D/WB/M R,24,133,145,Spain,Olympique de Marseille,8,14,13,5,12,10,10,9,10,11,13,8,12,14,12,11,12,12,12,12,12,13,12,8,12,10,11,11,16,14,13,10,13,15,13,11,12,7,9,8,13,3,2,3,1,3,2,1,3,1,1,2,15,13,6,12,11,14,13,12,1,12,1,20,13,20,1,12,1,17,1,1,1,1,183,70,10,20,5828285,6650,6500,5000,Mediterranean_Hispanic,121,2,1997/8/13,0,0,32218.0,Elche,67211095
405,Diego López,Rayo Vallecano,1981,315.0,es ESP,GK,40.0,1.1,0.0,0.0,0.0,0.0,0.0,0.0,0.0,,0.0,0.0,0.0,0.0,0.0,0.0,0.0,1.0,Matches,315.0,es ESP,GK,40.0,1.1,0.0,0.0,0.0,0.0,0.0,0.0,0.0,0.0,0.0,0.0,0.0,0.0,0.0,0.0,0.0,0.0,Matches,24.0,es ESP,GK,40.0,1.1,4.0,0.0,0.0,2.0,0.0,1.7,0.33,-2.3,-2.19,2.0,8.0,25.0,21.0,5.0,28.6,30.3,8.0,25.0,35.3,12.0,0.0,0.0,2.0,1.88,17.0,Matches,24.0,es ESP,GK,40.0,2.0,1.0,96.0,1.1,4.0,3.75,5.0,1.0,20.0,0.0,0.0,1.0,0.0,0.0,0.0,0.0,0.0,0.0,,Matches,315.0,es ESP,GK,40.0,1.1,0.0,0.0,0.0,0.0,0.0,0.0,0.0,0.0,0.0,0.0,0.0,0.0,3.0,0.0,0.0,,Matches,315.0,es ESP,GK,40.0,1.1,29.0,21.0,8.0,0.0,0.0,0.0,0.0,0.0,0.0,0.0,0.0,0.0,22.0,0.0,0.0,Matches,315.0,es ESP,GK,40.0,1.1,22.0,29.0,75.9,462.0,309.0,7.0,8.0,87.5,11.0,11.0,100.0,4.0,10.0,40.0,0.0,0.0,0.0,0.0,0.0,0.0,0.0,0.0,0.0,Matches,385,es ESP,GK,40,2,96.0,48.0,2.8,1.1,1,90.0,1,1,6.0,30,0.0,1.0,4.0,-3.0,-2.81,-2.68,0.9,1.8,-0.9,-0.82,-0.67,Matches,315.0,es ESP,GK,40.0,1.1,29.0,23.0,29.0,0.0,0.0,0.0,29.0,0.0,0.0,,0.0,,14.0,92.0,64.0,0.0,0.0,0.0,0.0,0.0,12.0,0.0,Matches,315.0,es ESP,GK,40.0,1.1,0.0,0.0,0.0,,0.0,0.0,,,,0.0,0.0,0.0,0.0,0.0,,0.0,0.0,Matches,315.0,es ESP,GK,40.0,2.0,1.0,96.0,1.1,0.0,0.0,0.0,0.0,0.0,0.0,0.0,0.0,0.0,0.0,0.0,0.0,0.0,0.0,0.0,0.0,0.0,0.0,0.0,0.0,0.0,0.0,0.0,0.0,0.0,Matches,Diego López,GK,40,136,157,Spain,Vallecano,1,1,1,1,8,1,8,1,7,1,10,2,1,9,6,14,15,15,15,8,15,13,5,13,2,14,9,9,9,10,11,17,15,9,11,13,16,8,14,9,1,16,14,13,10,14,15,13,14,15,9,12,13,14,14,15,15,16,14,13,20,1,1,1,1,1,1,1,1,1,1,1,1,1,196,87,8,20,468738,6800,6800,5800,Mediterranean_Hispanic,137,5,1981/11/3,1,0,15558.0,,6701938
406,Pol Lozano,Espanyol,1999,319.0,es ESP,MF,22.0,0.2,0.0,0.0,0.0,0.0,0.0,0.0,0.0,,0.0,1.0,0.0,1.0,0.0,0.0,1.0,0.0,Matches,319.0,es ESP,MF,22.0,0.2,0.0,0.0,0.0,0.0,0.0,0.0,0.0,0.0,0.0,0.0,0.0,0.0,0.0,0.0,0.0,0.0,Matches,,,,,,,,,,,,,,,,,,,,,,,,,,,,,,,,,,,,,,,,,,,,,,,,,,,,,,,,319.0,es ESP,MF,22.0,0.2,1.0,0.0,0.0,1.0,0.0,0.0,1.0,0.0,0.0,0.0,0.0,0.0,1.0,1.0,1.0,50.0,Matches,319.0,es ESP,MF,22.0,0.2,8.0,8.0,0.0,0.0,0.0,0.0,1.0,0.0,0.0,0.0,0.0,0.0,5.0,0.0,0.0,Matches,319.0,es ESP,MF,22.0,0.2,5.0,8.0,62.5,91.0,46.0,2.0,3.0,66.7,2.0,3.0,66.7,1.0,2.0,50.0,0.0,0.0,0.0,0.0,0.0,0.0,0.0,0.0,0.0,Matches,392,es ESP,MF,22,4,17.0,4.0,0.5,0.2,0,,0,4,4.0,7,0.75,0.0,1.0,-1.0,-5.29,-4.87,0.1,0.9,-0.8,-4.26,-3.98,Matches,319.0,es ESP,MF,22.0,0.2,12.0,2.0,7.0,4.0,1.0,0.0,12.0,0.0,0.0,,0.0,,7.0,29.0,0.0,0.0,0.0,0.0,1.0,0.0,6.0,0.0,Matches,319.0,es ESP,MF,22.0,0.2,0.0,0.0,0.0,,0.0,0.0,,,,0.0,0.0,0.0,0.0,0.0,,0.0,0.0,Matches,319.0,es ESP,MF,22.0,4.0,0.0,17.0,0.2,0.0,0.0,0.0,0.0,0.0,0.0,1.0,0.0,0.0,0.0,0.0,0.0,0.0,0.0,0.0,0.0,0.0,0.0,0.0,0.0,0.0,0.0,0.0,0.0,0.0,Matches,Pol Lozano,M C,22,118,145,Spain,Espanyol,9,8,10,7,14,12,8,15,8,9,14,9,8,14,8,15,8,11,8,13,13,18,5,12,14,12,11,10,13,16,13,7,14,14,12,9,14,12,5,7,14,3,4,1,2,2,2,2,2,2,1,1,17,12,7,13,13,9,10,14,1,1,1,1,1,1,15,1,20,1,1,9,1,1,176,68,13,20,4335998,5599,5599,2749,Mediterranean_Hispanic,124,5,1999/10/6,0,0,3000.0,,67246431
407,Andriy Lunin,Real Madrid,1999,322.0,ua UKR,GK,23.0,7.0,0.0,0.0,0.0,0.0,0.0,0.0,0.0,,0.0,0.0,0.0,0.0,0.0,0.0,1.0,0.0,Matches,322.0,ua UKR,GK,23.0,7.0,0.0,0.0,0.0,0.0,0.0,0.0,0.0,0.0,0.0,0.0,0.0,0.0,0.0,0.0,0.0,0.0,Matches,25.0,ua UKR,GK,23.0,7.0,7.0,0.0,0.0,1.0,1.0,4.5,0.25,-1.5,-0.21,14.0,27.0,51.9,190.0,36.0,7.9,23.3,37.0,32.4,35.6,54.0,1.0,1.9,11.0,1.57,21.7,Matches,25.0,ua UKR,GK,23.0,7.0,7.0,630.0,7.0,7.0,1.0,18.0,12.0,61.1,4.0,1.0,2.0,3.0,42.9,0.0,0.0,0.0,0.0,,Matches,322.0,ua UKR,GK,23.0,7.0,0.0,0.0,0.0,0.0,0.0,0.0,0.0,0.0,0.0,0.0,0.0,0.0,14.0,0.0,0.0,,Matches,322.0,ua UKR,GK,23.0,7.0,227.0,186.0,41.0,4.0,0.0,1.0,0.0,0.0,0.0,0.0,0.0,0.0,205.0,0.0,1.0,Matches,322.0,ua UKR,GK,23.0,7.0,205.0,227.0,90.3,4750.0,3000.0,45.0,45.0,100.0,117.0,120.0,97.5,43.0,61.0,70.5,0.0,0.0,0.0,0.0,0.0,0.0,0.0,0.0,0.0,Matches,396,ua UKR,GK,23,7,630.0,90.0,18.4,7.0,7,90.0,7,0,,30,1.86,14.0,7.0,7.0,1.0,-0.03,14.0,6.7,7.4,1.05,0.11,Matches,322.0,ua UKR,GK,23.0,7.0,234.0,186.0,232.0,2.0,0.0,0.0,234.0,0.0,0.0,,0.0,,144.0,645.0,257.0,0.0,0.0,0.0,0.0,0.0,142.0,0.0,Matches,322.0,ua UKR,GK,23.0,7.0,0.0,0.0,0.0,,0.0,0.0,,,,0.0,0.0,0.0,0.0,0.0,,0.0,0.0,Matches,322.0,ua UKR,GK,23.0,7.0,7.0,630.0,7.0,0.0,0.0,0.0,0.0,0.0,0.0,0.0,0.0,0.0,0.0,0.0,0.0,0.0,0.0,0.0,0.0,0.0,0.0,0.0,0.0,0.0,0.0,0.0,0.0,0.0,Matches,Andriy Lunin,GK,23,140,156,Ukraine,R. Madrid,3,1,3,2,12,7,9,1,2,1,12,1,2,10,5,13,12,13,12,11,13,15,3,8,3,13,13,14,12,15,12,15,14,11,14,12,13,5,10,3,13,15,14,14,12,13,12,15,16,12,14,11,14,10,5,14,12,17,14,12,20,1,1,1,1,1,1,1,1,1,1,1,1,1,191,80,10,20,9825937,7000,6700,5500,Northern_European,140,1,1999/2/11,7,0,24317.0,,71099053
408,Awer Mabil,Cádiz,1995,323.0,au AUS,MFFW,26.0,1.8,2.0,0.0,0.0,1.0,1.0,1.0,3.0,33.3,2.0,1.0,1.0,0.0,0.0,2.0,1.0,0.0,Matches,323.0,au AUS,MFFW,26.0,1.8,2.0,1.09,0.0,2.0,0.0,0.0,0.0,0.0,0.0,0.0,0.0,0.0,0.0,0.0,0.0,0.0,Matches,,,,,,,,,,,,,,,,,,,,,,,,,,,,,,,,,,,,,,,,,,,,,,,,,,,,,,,,323.0,au AUS,MFFW,26.0,1.8,0.0,0.0,0.0,0.0,3.0,0.0,9.0,0.0,0.0,0.0,0.0,0.0,6.0,1.0,5.0,16.7,Matches,323.0,au AUS,MFFW,26.0,1.8,54.0,48.0,6.0,3.0,0.0,0.0,9.0,1.0,2.0,1.0,1.0,0.0,34.0,0.0,4.0,Matches,323.0,au AUS,MFFW,26.0,1.8,34.0,54.0,63.0,422.0,149.0,22.0,28.0,78.6,6.0,10.0,60.0,2.0,9.0,22.2,0.0,0.0,0.0,0.0,1.0,4.0,0.0,0.0,4.0,Matches,397,au AUS,MFFW,26,5,165.0,33.0,4.8,1.8,1,61.0,0,4,26.0,8,0.0,1.0,6.0,-5.0,-2.73,-2.23,0.9,5.2,-4.3,-2.34,-1.9,Matches,323.0,au AUS,MFFW,26.0,1.8,77.0,2.0,11.0,31.0,36.0,2.0,77.0,4.0,2.0,50.0,2.0,50.0,47.0,235.0,132.0,5.0,2.0,0.0,7.0,1.0,57.0,14.0,Matches,323.0,au AUS,MFFW,26.0,1.8,0.0,3.0,1.0,33.3,1.64,0.55,0.0,0.0,17.3,0.0,0.0,0.0,0.2,0.2,0.05,-0.2,-0.2,Matches,323.0,au AUS,MFFW,26.0,5.0,1.0,165.0,1.8,0.0,0.0,0.0,0.0,0.0,0.0,0.0,0.0,0.2,0.2,0.0,0.2,5.0,4.0,14.0,0.0,0.0,0.0,0.0,0.0,0.09,0.01,0.09,0.09,0.09,Matches,Awer Mabil,M/AM RL,26,128,139,"Australia,Kenya,South Sudan",Cádiz,9,11,15,10,13,8,6,10,4,4,12,8,4,14,9,11,8,9,8,10,7,13,15,7,12,6,7,13,18,17,13,8,10,17,12,7,8,6,10,5,10,3,3,2,3,3,2,3,3,2,2,2,10,16,5,14,8,11,8,6,1,1,1,1,1,1,1,18,1,16,19,12,20,10,179,65,9,20,2638543,6250,6500,5400,African_Caribbean,119,19,1995/9/15,28,7,6639.0,,15040452
409,Darwin Machís,Valladolid,1993,324.0,ve VEN,FW,29.0,6.7,3.0,2.0,0.0,2.0,1.0,1.0,8.0,12.5,7.0,5.0,0.0,5.0,3.0,6.0,4.0,0.0,Matches,324.0,ve VEN,FW,29.0,6.7,20.0,3.02,13.0,0.0,2.0,2.0,3.0,0.0,1.0,0.15,1.0,0.0,0.0,0.0,0.0,0.0,Matches,,,,,,,,,,,,,,,,,,,,,,,,,,,,,,,,,,,,,,,,,,,,,,,,,,,,,,,,324.0,ve VEN,FW,29.0,6.7,1.0,0.0,0.0,10.0,12.0,2.0,37.0,3.0,2.0,0.0,0.0,0.0,26.0,2.0,6.0,25.0,Matches,324.0,ve VEN,FW,29.0,6.7,208.0,191.0,12.0,2.0,1.0,5.0,37.0,8.0,1.0,1.0,0.0,0.0,137.0,5.0,13.0,Matches,324.0,ve VEN,FW,29.0,6.7,137.0,208.0,65.9,2613.0,731.0,68.0,81.0,84.0,42.0,55.0,76.4,24.0,47.0,51.1,1.0,2.1,1.8,-1.1,9.0,7.0,11.0,10.0,10.0,Matches,398,ve VEN,FW,29,11,599.0,54.0,17.5,6.7,7,73.0,2,4,22.0,2,1.73,5.0,3.0,2.0,0.3,1.32,7.2,9.6,-2.3,-0.35,0.43,Matches,324.0,ve VEN,FW,29.0,6.7,295.0,7.0,41.0,110.0,148.0,32.0,295.0,30.0,11.0,36.7,16.0,53.3,199.0,1326.0,588.0,29.0,17.0,11.0,21.0,6.0,204.0,53.0,Matches,324.0,ve VEN,FW,29.0,6.7,0.0,19.0,6.0,31.6,2.85,0.9,0.0,0.0,18.7,0.0,0.0,0.0,1.1,1.1,0.06,-1.1,-1.1,Matches,324.0,ve VEN,FW,29.0,11.0,7.0,599.0,6.7,0.0,1.0,1.0,0.0,0.0,0.0,1.0,0.0,1.1,1.1,2.1,3.3,29.0,10.0,53.0,0.0,0.15,0.15,0.0,0.15,0.17,0.32,0.49,0.17,0.49,Matches,Darwin Machís,M/AM RL,29,131,136,"Venezuela,Spain",Fútbol Club Juárez,9,10,14,13,10,11,10,13,4,4,10,12,4,11,8,11,11,11,10,11,11,18,13,8,13,7,9,12,16,14,13,7,14,16,13,10,12,7,12,5,5,2,3,2,2,3,3,2,1,1,2,1,12,16,10,14,14,18,15,10,1,13,1,1,14,1,1,16,1,16,20,11,17,15,171,72,9,20,4393609,6532,6586,5491,Mixed_Race,117,12,1993/2/7,36,9,14277.0,,86017618
410,Marcão,Sevilla,1996,334.0,br BRA,DF,26.0,4.2,2.0,2.0,1.0,1.0,0.0,1.0,1.0,100.0,0.0,3.0,3.0,0.0,6.0,8.0,14.0,0.0,Matches,334.0,br BRA,DF,26.0,4.2,0.0,0.0,0.0,0.0,0.0,0.0,0.0,0.0,0.0,0.0,0.0,0.0,0.0,0.0,0.0,0.0,Matches,,,,,,,,,,,,,,,,,,,,,,,,,,,,,,,,,,,,,,,,,,,,,,,,,,,,,,,,334.0,br BRA,DF,26.0,4.2,2.0,0.0,0.0,5.0,6.0,0.0,0.0,6.0,2.0,0.0,0.0,0.0,16.0,8.0,4.0,66.7,Matches,334.0,br BRA,DF,26.0,4.2,217.0,209.0,6.0,5.0,0.0,3.0,0.0,0.0,0.0,0.0,0.0,0.0,187.0,2.0,3.0,Matches,334.0,br BRA,DF,26.0,4.2,187.0,217.0,86.2,3094.0,1265.0,91.0,98.0,92.9,87.0,93.0,93.5,8.0,20.0,40.0,0.0,0.0,0.0,0.0,0.0,16.0,0.0,0.0,13.0,Matches,408,br BRA,DF,26,5,375.0,75.0,11.0,4.2,4,90.0,4,1,15.0,3,1.4,3.0,5.0,-2.0,-0.48,-0.33,2.9,6.1,-3.2,-0.78,-0.64,Matches,334.0,br BRA,DF,26.0,4.2,255.0,26.0,120.0,130.0,5.0,0.0,255.0,1.0,1.0,100.0,0.0,0.0,150.0,824.0,422.0,1.0,0.0,0.0,8.0,0.0,186.0,0.0,Matches,334.0,br BRA,DF,26.0,4.2,0.0,0.0,0.0,,0.0,0.0,,,,0.0,0.0,0.0,0.0,0.0,,0.0,0.0,Matches,334.0,br BRA,DF,26.0,5.0,4.0,375.0,4.2,0.0,0.0,0.0,0.0,0.0,0.0,2.0,0.0,0.0,0.0,0.0,0.0,1.0,13.0,0.0,0.0,0.0,0.0,0.0,0.0,0.0,0.0,0.0,0.0,0.0,Matches,Marcão,D C,26,140,145,Brazil,Sevilla,8,8,10,7,13,8,13,7,8,13,15,13,14,14,16,14,16,15,13,14,14,14,10,12,10,14,14,15,13,13,15,13,18,13,14,15,14,16,12,12,10,2,2,3,4,1,3,2,3,1,3,2,14,14,12,10,12,14,12,9,1,5,20,1,1,1,10,1,1,1,1,1,1,1,185,80,20,9,25323845,7000,6120,7082,African_Caribbean,141,14,1996/6/5,0,0,23877.0,,19190440
411,José Mari,Cádiz,1987,338.0,es ESP,MF,34.0,4.4,16.0,7.0,12.0,3.0,1.0,10.0,16.0,62.5,6.0,3.0,1.0,2.0,5.0,21.0,9.0,0.0,Matches,338.0,es ESP,MF,34.0,4.4,13.0,2.94,10.0,1.0,0.0,1.0,0.0,1.0,0.0,0.0,0.0,0.0,0.0,0.0,0.0,0.0,Matches,,,,,,,,,,,,,,,,,,,,,,,,,,,,,,,,,,,,,,,,,,,,,,,,,,,,,,,,338.0,es ESP,MF,34.0,4.4,4.0,0.0,0.0,6.0,7.0,0.0,1.0,5.0,7.0,0.0,0.0,0.0,38.0,5.0,7.0,41.7,Matches,338.0,es ESP,MF,34.0,4.4,203.0,188.0,14.0,14.0,0.0,8.0,1.0,0.0,0.0,0.0,0.0,0.0,168.0,1.0,2.0,Matches,338.0,es ESP,MF,34.0,4.4,168.0,203.0,82.8,3584.0,1144.0,55.0,68.0,80.9,71.0,76.0,93.4,37.0,49.0,75.5,0.0,0.3,0.1,-0.3,5.0,32.0,1.0,0.0,21.0,Matches,412,es ESP,MF,34,18,397.0,22.0,11.6,4.4,2,55.0,0,16,18.0,10,1.1,8.0,9.0,-1.0,-0.23,0.43,4.8,9.4,-4.6,-1.05,-0.59,Matches,338.0,es ESP,MF,34.0,4.4,260.0,15.0,82.0,153.0,29.0,2.0,260.0,6.0,3.0,50.0,3.0,50.0,129.0,694.0,321.0,5.0,1.0,0.0,6.0,7.0,146.0,4.0,Matches,338.0,es ESP,MF,34.0,4.4,0.0,5.0,2.0,40.0,1.13,0.45,0.0,0.0,24.1,0.0,0.0,0.0,0.1,0.1,0.02,-0.1,-0.1,Matches,338.0,es ESP,MF,34.0,18.0,2.0,397.0,4.4,0.0,0.0,0.0,0.0,0.0,0.0,4.0,0.0,0.1,0.1,0.3,0.4,5.0,21.0,4.0,0.0,0.0,0.0,0.0,0.0,0.03,0.07,0.09,0.03,0.09,Matches,José Mari,DM/M C,34,125,131,Spain,Cádiz,11,10,10,7,13,8,11,10,9,11,14,9,12,12,12,15,14,15,14,15,15,16,8,17,10,15,18,15,10,11,12,11,13,8,11,11,14,11,13,14,10,3,1,1,4,2,4,3,3,1,1,4,8,13,7,13,11,17,11,13,1,1,8,1,1,1,19,1,20,1,1,1,1,1,180,69,10,20,79776,6200,6200,3850,Mediterranean_Hispanic,122,6,1987/12/6,0,0,8212.0,,67082063
412,Mariano,Real Madrid,1993,340.0,do DOM,FW,28.0,1.7,1.0,0.0,0.0,1.0,0.0,0.0,0.0,,0.0,1.0,0.0,1.0,0.0,1.0,0.0,0.0,Matches,340.0,do DOM,FW,28.0,1.7,1.0,0.57,1.0,0.0,0.0,0.0,0.0,0.0,0.0,0.0,0.0,0.0,0.0,0.0,0.0,0.0,Matches,,,,,,,,,,,,,,,,,,,,,,,,,,,,,,,,,,,,,,,,,,,,,,,,,,,,,,,,340.0,do DOM,FW,28.0,1.7,2.0,0.0,0.0,3.0,0.0,1.0,0.0,0.0,0.0,0.0,0.0,0.0,4.0,5.0,3.0,62.5,Matches,340.0,do DOM,FW,28.0,1.7,41.0,39.0,1.0,0.0,0.0,1.0,0.0,0.0,0.0,0.0,0.0,0.0,32.0,1.0,0.0,Matches,340.0,do DOM,FW,28.0,1.7,32.0,41.0,78.0,426.0,81.0,25.0,30.0,83.3,5.0,7.0,71.4,2.0,2.0,100.0,0.0,0.4,0.7,-0.4,1.0,3.0,0.0,0.0,2.0,Matches,414,do DOM,FW,28,9,157.0,17.0,4.6,1.7,1,58.0,0,8,12.0,20,1.22,3.0,1.0,2.0,1.15,0.13,4.9,2.0,2.8,1.61,0.68,Matches,340.0,do DOM,FW,28.0,1.7,52.0,0.0,3.0,21.0,29.0,8.0,52.0,1.0,0.0,0.0,1.0,100.0,31.0,186.0,94.0,3.0,2.0,0.0,2.0,3.0,42.0,12.0,Matches,340.0,do DOM,FW,28.0,1.7,0.0,5.0,0.0,0.0,2.87,0.0,0.0,,10.3,0.0,0.0,0.0,0.6,0.6,0.11,-0.6,-0.6,Matches,340.0,do DOM,FW,28.0,9.0,1.0,157.0,1.7,0.0,0.0,0.0,0.0,0.0,0.0,2.0,0.0,0.6,0.6,0.4,1.0,3.0,2.0,12.0,0.0,0.0,0.0,0.0,0.0,0.32,0.25,0.57,0.32,0.57,Matches,Mariano,S,28,139,154,"Dominican Republic,Spain",R. Madrid,5,8,12,15,12,13,16,14,5,5,11,14,5,12,14,15,17,12,12,10,11,18,8,11,14,10,9,17,15,11,12,15,15,15,14,14,14,10,14,15,7,2,3,3,3,3,2,3,3,1,3,3,6,3,14,19,12,10,10,9,1,1,1,1,1,1,1,1,1,1,1,1,1,20,181,77,11,20,2055867,6500,6500,6000,African_Caribbean,138,12,1993/8/1,1,1,123288.0,,67157152
413,Pablo Marín,Real Sociedad,2003,341.0,es ESP,MFFW,19.0,4.0,10.0,5.0,5.0,4.0,1.0,2.0,7.0,28.6,5.0,1.0,0.0,1.0,4.0,14.0,2.0,0.0,Matches,341.0,es ESP,MFFW,19.0,4.0,11.0,2.75,9.0,0.0,2.0,0.0,0.0,0.0,0.0,0.0,0.0,0.0,0.0,0.0,0.0,0.0,Matches,,,,,,,,,,,,,,,,,,,,,,,,,,,,,,,,,,,,,,,,,,,,,,,,,,,,,,,,341.0,es ESP,MFFW,19.0,4.0,1.0,0.0,0.0,12.0,2.0,0.0,3.0,4.0,5.0,0.0,0.0,0.0,20.0,4.0,7.0,36.4,Matches,341.0,es ESP,MFFW,19.0,4.0,168.0,165.0,2.0,2.0,1.0,1.0,3.0,0.0,0.0,0.0,0.0,0.0,128.0,1.0,6.0,Matches,341.0,es ESP,MFFW,19.0,4.0,128.0,168.0,76.2,1809.0,362.0,78.0,92.0,84.8,36.0,48.0,75.0,9.0,12.0,75.0,0.0,0.8,0.4,-0.8,6.0,9.0,2.0,0.0,15.0,Matches,415,es ESP,MFFW,19,10,360.0,36.0,10.5,4.0,3,74.0,0,7,20.0,5,1.7,2.0,4.0,-2.0,-0.5,-1.03,6.6,3.4,3.2,0.8,0.31,Matches,341.0,es ESP,MFFW,19.0,4.0,215.0,4.0,38.0,89.0,89.0,10.0,215.0,9.0,5.0,55.6,3.0,33.3,132.0,629.0,302.0,9.0,8.0,3.0,8.0,5.0,155.0,24.0,Matches,341.0,es ESP,MFFW,19.0,4.0,0.0,9.0,4.0,44.4,2.25,1.0,0.0,0.0,16.6,0.0,0.0,0.0,1.2,1.2,0.14,-1.2,-1.2,Matches,341.0,es ESP,MFFW,19.0,10.0,3.0,360.0,4.0,0.0,0.0,0.0,0.0,0.0,0.0,1.0,0.0,1.2,1.2,0.8,2.1,9.0,15.0,24.0,0.0,0.0,0.0,0.0,0.0,0.31,0.2,0.51,0.31,0.51,Matches,Pablo Marín,M C,19,62,-75,"Spain,Pays Basque",Real San Sebastián,5,5,6,6,13,4,5,10,2,6,13,5,12,8,7,5,7,7,7,13,13,7,8,9,5,10,6,11,11,11,4,6,15,9,7,4,17,7,5,8,14,1,1,3,2,3,3,1,2,2,3,1,14,10,8,11,10,9,12,15,1,1,1,1,1,1,15,1,20,1,1,1,1,1,173,0,11,20,6235263,3099,3099,599,Mediterranean_Hispanic,63,5,2003/7/3,0,0,269.0,,2000131318
414,Diego Mariño,Almería,1990,342.0,es ESP,GK,32.0,0.5,0.0,0.0,0.0,0.0,0.0,0.0,0.0,,0.0,0.0,0.0,0.0,0.0,0.0,0.0,0.0,Matches,342.0,es ESP,GK,32.0,0.5,0.0,0.0,0.0,0.0,0.0,0.0,0.0,0.0,0.0,0.0,0.0,0.0,0.0,0.0,0.0,0.0,Matches,28.0,es ESP,GK,32.0,0.5,2.0,0.0,0.0,0.0,0.0,1.4,0.28,-0.6,-1.25,2.0,3.0,66.7,3.0,1.0,33.3,35.7,5.0,40.0,45.6,12.0,0.0,0.0,0.0,0.0,7.0,Matches,28.0,es ESP,GK,32.0,1.0,0.0,45.0,0.5,2.0,4.0,5.0,3.0,60.0,0.0,0.0,0.0,0.0,,0.0,0.0,0.0,0.0,,Matches,342.0,es ESP,GK,32.0,0.5,0.0,0.0,0.0,0.0,0.0,0.0,0.0,0.0,0.0,0.0,0.0,0.0,0.0,0.0,0.0,,Matches,342.0,es ESP,GK,32.0,0.5,8.0,2.0,6.0,1.0,0.0,0.0,0.0,0.0,0.0,0.0,0.0,0.0,7.0,0.0,0.0,Matches,342.0,es ESP,GK,32.0,0.5,7.0,8.0,87.5,261.0,204.0,0.0,0.0,,4.0,4.0,100.0,3.0,4.0,75.0,0.0,0.0,0.0,0.0,0.0,0.0,0.0,0.0,0.0,Matches,416,es ESP,GK,32,1,45.0,45.0,1.3,0.5,0,,0,1,45.0,17,0.0,0.0,2.0,-2.0,-4.0,-3.63,0.3,1.2,-0.9,-1.87,-1.44,Matches,342.0,es ESP,GK,32.0,0.5,10.0,10.0,10.0,0.0,0.0,0.0,10.0,0.0,0.0,,0.0,,2.0,12.0,12.0,0.0,0.0,0.0,0.0,0.0,0.0,0.0,Matches,342.0,es ESP,GK,32.0,0.5,0.0,0.0,0.0,,0.0,0.0,,,,0.0,0.0,0.0,0.0,0.0,,0.0,0.0,Matches,342.0,es ESP,GK,32.0,1.0,0.0,45.0,0.5,0.0,0.0,0.0,0.0,0.0,0.0,0.0,0.0,0.0,0.0,0.0,0.0,0.0,0.0,0.0,0.0,0.0,0.0,0.0,0.0,0.0,0.0,0.0,0.0,0.0,Matches,Diego Mariño,GK,32,120,144,Spain,S. Gijón,7,7,12,7,13,7,8,7,9,8,10,7,8,12,7,8,7,8,13,9,10,9,6,9,2,13,15,8,11,14,7,15,12,12,14,11,10,6,10,6,5,15,8,15,12,14,8,17,17,6,14,17,10,8,8,12,10,15,16,18,20,1,1,1,1,1,1,1,1,1,1,1,1,1,187,77,10,20,567698,6000,6000,4500,Mediterranean_Hispanic,119,5,1990/5/9,0,0,8624.0,,67066947
415,Roger Martí,Elche,1991,343.0,es ESP,FW,31.0,7.3,5.0,2.0,3.0,2.0,0.0,1.0,5.0,20.0,4.0,4.0,0.0,4.0,1.0,6.0,7.0,0.0,Matches,343.0,es ESP,FW,31.0,7.3,13.0,1.79,10.0,0.0,0.0,1.0,1.0,1.0,1.0,0.14,1.0,0.0,0.0,0.0,0.0,0.0,Matches,,,,,,,,,,,,,,,,,,,,,,,,,,,,,,,,,,,,,,,,,,,,,,,,,,,,,,,,343.0,es ESP,FW,31.0,7.3,2.0,0.0,0.0,16.0,11.0,4.0,5.0,1.0,2.0,0.0,0.0,0.0,27.0,6.0,12.0,33.3,Matches,343.0,es ESP,FW,31.0,7.3,160.0,147.0,10.0,0.0,0.0,1.0,5.0,0.0,0.0,0.0,0.0,0.0,118.0,3.0,8.0,Matches,343.0,es ESP,FW,31.0,7.3,118.0,160.0,73.8,1447.0,357.0,72.0,82.0,87.8,22.0,32.0,68.8,7.0,13.0,53.8,1.0,0.7,0.4,0.3,10.0,7.0,3.0,2.0,7.0,Matches,419,es ESP,FW,31,12,655.0,55.0,19.2,7.3,8,73.0,1,4,18.0,6,0.42,3.0,12.0,-9.0,-1.24,-0.33,5.0,14.0,-9.0,-1.23,-0.47,Matches,343.0,es ESP,FW,31.0,7.3,226.0,8.0,27.0,107.0,93.0,19.0,226.0,7.0,3.0,42.9,4.0,57.1,135.0,618.0,215.0,8.0,6.0,6.0,25.0,10.0,153.0,50.0,Matches,343.0,es ESP,FW,31.0,7.3,0.0,6.0,2.0,33.3,0.82,0.27,0.0,0.0,15.6,0.0,0.0,0.0,0.6,0.6,0.09,-0.6,-0.6,Matches,343.0,es ESP,FW,31.0,12.0,8.0,655.0,7.3,0.0,1.0,1.0,0.0,0.0,0.0,2.0,0.0,0.6,0.6,0.7,1.2,8.0,7.0,50.0,0.0,0.14,0.14,0.0,0.14,0.08,0.09,0.17,0.08,0.17,Matches,Roger Martí,S,31,136,142,Spain,Elche,6,10,11,16,13,9,13,12,7,6,11,16,8,13,12,15,13,14,14,12,14,14,14,9,16,7,16,14,13,13,12,10,16,13,14,11,14,8,13,7,10,3,1,1,1,1,2,1,1,2,1,2,13,13,8,15,14,15,14,13,1,1,1,1,1,1,1,9,1,9,8,9,12,20,179,74,12,20,347975206,6850,6850,4550,Mediterranean_Hispanic,135,6,1991/1/3,0,0,19657.0,,67115585
416,Andrés Martín,Rayo Vallecano,1999,346.0,es ESP,FWMF,23.0,2.3,4.0,2.0,2.0,1.0,1.0,3.0,5.0,60.0,2.0,2.0,0.0,2.0,1.0,5.0,2.0,0.0,Matches,346.0,es ESP,FWMF,23.0,2.3,6.0,2.61,5.0,0.0,1.0,0.0,0.0,0.0,0.0,0.0,0.0,0.0,0.0,0.0,0.0,0.0,Matches,,,,,,,,,,,,,,,,,,,,,,,,,,,,,,,,,,,,,,,,,,,,,,,,,,,,,,,,346.0,es ESP,FWMF,23.0,2.3,1.0,0.0,0.0,5.0,3.0,0.0,11.0,1.0,2.0,0.0,0.0,0.0,16.0,5.0,2.0,71.4,Matches,346.0,es ESP,FWMF,23.0,2.3,77.0,69.0,5.0,0.0,0.0,2.0,11.0,2.0,3.0,3.0,0.0,0.0,39.0,3.0,4.0,Matches,346.0,es ESP,FWMF,23.0,2.3,39.0,77.0,50.6,623.0,173.0,21.0,33.0,63.6,12.0,19.0,63.2,4.0,14.0,28.6,0.0,0.5,0.2,-0.5,1.0,1.0,3.0,2.0,4.0,Matches,422,es ESP,FWMF,23,9,205.0,23.0,6.0,2.3,3,56.0,0,6,6.0,15,0.67,2.0,1.0,1.0,0.44,0.69,2.2,2.4,-0.3,-0.12,0.05,Matches,346.0,es ESP,FWMF,23.0,2.3,102.0,3.0,22.0,32.0,48.0,5.0,102.0,6.0,3.0,50.0,2.0,33.3,53.0,188.0,95.0,3.0,3.0,1.0,7.0,2.0,62.0,22.0,Matches,346.0,es ESP,FWMF,23.0,2.3,0.0,4.0,2.0,50.0,1.76,0.88,0.0,0.0,13.7,0.0,0.0,0.0,0.5,0.5,0.12,-0.5,-0.5,Matches,346.0,es ESP,FWMF,23.0,9.0,3.0,205.0,2.3,0.0,0.0,0.0,0.0,0.0,0.0,1.0,0.0,0.5,0.5,0.5,1.0,3.0,4.0,22.0,0.0,0.0,0.0,0.0,0.0,0.21,0.21,0.43,0.21,0.43,Matches,Andrés Martín,AM/S RLC,23,119,135,Spain,Vallecano,10,11,11,12,14,11,10,11,11,5,13,7,7,13,8,12,10,10,11,12,10,6,14,12,13,7,11,10,14,14,12,7,12,12,12,8,12,15,14,8,13,2,1,2,2,1,1,3,1,1,2,3,8,10,1,10,11,12,12,16,1,1,1,1,1,1,1,12,8,14,16,18,18,20,170,66,20,10,1236124,5950,5950,3950,Mediterranean_Hispanic,105,4,1999/7/11,0,0,3417.0,,67260125
417,Roger Martínez,Espanyol,2004,351.0,es ESP,DF,18.0,0.1,0.0,0.0,0.0,0.0,0.0,0.0,0.0,,0.0,0.0,0.0,0.0,0.0,0.0,0.0,0.0,Matches,351.0,es ESP,DF,18.0,0.1,2.0,25.71,2.0,0.0,0.0,0.0,0.0,0.0,0.0,0.0,0.0,0.0,0.0,0.0,0.0,0.0,Matches,,,,,,,,,,,,,,,,,,,,,,,,,,,,,,,,,,,,,,,,,,,,,,,,,,,,,,,,351.0,es ESP,DF,18.0,0.1,0.0,0.0,0.0,0.0,0.0,0.0,0.0,0.0,0.0,0.0,0.0,0.0,1.0,0.0,0.0,,Matches,351.0,es ESP,DF,18.0,0.1,5.0,5.0,0.0,0.0,0.0,0.0,0.0,0.0,0.0,0.0,0.0,0.0,5.0,0.0,0.0,Matches,351.0,es ESP,DF,18.0,0.1,5.0,5.0,100.0,104.0,26.0,2.0,2.0,100.0,2.0,2.0,100.0,1.0,1.0,100.0,0.0,0.0,0.0,0.0,0.0,1.0,0.0,0.0,1.0,Matches,430,es ESP,DF,18,1,7.0,7.0,0.2,0.1,0,,0,1,7.0,5,1.0,0.0,1.0,-1.0,-12.86,-12.44,0.1,0.2,-0.1,-1.25,-0.95,Matches,351.0,es ESP,DF,18.0,0.1,6.0,0.0,0.0,1.0,5.0,1.0,6.0,0.0,0.0,,0.0,,3.0,10.0,4.0,0.0,0.0,0.0,0.0,0.0,4.0,0.0,Matches,351.0,es ESP,DF,18.0,0.1,0.0,1.0,0.0,0.0,12.86,0.0,0.0,,26.5,0.0,0.0,0.0,0.0,0.0,0.03,0.0,0.0,Matches,351.0,es ESP,DF,18.0,1.0,0.0,7.0,0.1,0.0,0.0,0.0,0.0,0.0,0.0,0.0,0.0,0.0,0.0,0.0,0.0,0.0,1.0,0.0,0.0,0.0,0.0,0.0,0.0,0.34,0.0,0.34,0.34,0.34,Matches,Roger Martínez,AM/S RL,28,128,145,Colombia,CF América,7,10,16,13,11,6,11,12,5,5,12,11,8,14,10,14,9,12,8,12,10,9,15,7,16,10,8,10,15,14,14,11,13,14,14,11,9,7,10,9,8,4,2,1,1,3,3,2,3,2,3,2,14,8,14,7,9,7,7,7,1,1,1,1,1,1,1,1,1,1,17,1,17,20,180,76,12,20,3538221,6789,6492,3992,Mixed_Race,127,12,1994/6/23,25,3,22006.0,,14083716
418,Jaime Mata,Getafe,1988,354.0,es ESP,FWMF,33.0,4.9,13.0,10.0,4.0,5.0,4.0,7.0,22.0,31.8,15.0,7.0,2.0,5.0,3.0,16.0,6.0,0.0,Matches,354.0,es ESP,FWMF,33.0,4.9,10.0,2.06,8.0,0.0,0.0,2.0,0.0,0.0,2.0,0.41,1.0,0.0,0.0,1.0,0.0,0.0,Matches,,,,,,,,,,,,,,,,,,,,,,,,,,,,,,,,,,,,,,,,,,,,,,,,,,,,,,,,354.0,es ESP,FWMF,33.0,4.9,5.0,0.0,0.0,17.0,7.0,4.0,9.0,3.0,10.0,0.0,0.0,0.0,27.0,10.0,15.0,40.0,Matches,354.0,es ESP,FWMF,33.0,4.9,122.0,119.0,2.0,0.0,0.0,0.0,9.0,1.0,0.0,0.0,0.0,0.0,68.0,1.0,7.0,Matches,354.0,es ESP,FWMF,33.0,4.9,68.0,122.0,55.7,1040.0,301.0,36.0,55.0,65.5,23.0,38.0,60.5,5.0,11.0,45.5,1.0,1.3,0.7,-0.3,6.0,6.0,6.0,3.0,10.0,Matches,433,es ESP,FWMF,33,18,437.0,24.0,12.8,4.9,5,76.0,1,13,4.0,15,1.42,8.0,5.0,3.0,0.62,1.04,7.8,4.4,3.4,0.7,1.08,Matches,354.0,es ESP,FWMF,33.0,4.9,190.0,8.0,29.0,73.0,90.0,20.0,190.0,5.0,2.0,40.0,3.0,60.0,102.0,369.0,104.0,2.0,6.0,0.0,16.0,7.0,131.0,33.0,Matches,354.0,es ESP,FWMF,33.0,4.9,1.0,14.0,5.0,35.7,2.88,1.03,0.07,0.2,12.0,0.0,0.0,0.0,1.9,1.9,0.15,-0.9,-0.9,Matches,354.0,es ESP,FWMF,33.0,18.0,5.0,437.0,4.9,1.0,1.0,2.0,1.0,0.0,0.0,5.0,0.0,1.9,1.9,1.3,3.2,2.0,10.0,33.0,0.21,0.21,0.41,0.21,0.41,0.4,0.27,0.66,0.4,0.66,Matches,Jaime Mata,S,33,132,141,Spain,Getafe,9,12,13,16,11,9,14,12,8,6,12,14,8,13,11,14,13,13,13,12,13,15,12,10,16,7,12,11,11,12,14,13,12,11,13,13,14,8,12,6,16,2,3,2,1,2,3,3,3,1,1,2,20,13,6,12,14,15,10,9,1,1,1,1,1,1,1,1,1,1,12,12,10,20,185,75,12,20,1361186,6600,6600,5100,Mediterranean_Hispanic,130,5,1988/10/24,1,0,12079.0,,67121201
419,Houboulang Mendes,Almería,1998,361.0,gw GNB,DF,24.0,9.8,19.0,11.0,16.0,3.0,0.0,11.0,27.0,40.7,16.0,12.0,2.0,10.0,7.0,26.0,23.0,1.0,Matches,361.0,gw GNB,DF,24.0,9.8,9.0,0.91,6.0,2.0,1.0,0.0,0.0,0.0,1.0,0.1,1.0,0.0,0.0,0.0,0.0,0.0,Matches,,,,,,,,,,,,,,,,,,,,,,,,,,,,,,,,,,,,,,,,,,,,,,,,,,,,,,,,361.0,gw GNB,DF,24.0,9.8,2.0,0.0,0.0,13.0,4.0,0.0,31.0,7.0,11.0,0.0,1.0,0.0,37.0,1.0,1.0,50.0,Matches,361.0,gw GNB,DF,24.0,9.8,335.0,238.0,96.0,4.0,0.0,0.0,31.0,92.0,0.0,0.0,0.0,0.0,239.0,1.0,9.0,Matches,361.0,gw GNB,DF,24.0,9.8,239.0,335.0,71.3,3634.0,1451.0,137.0,152.0,90.1,78.0,117.0,66.7,17.0,47.0,36.2,1.0,0.3,0.2,0.7,4.0,14.0,6.0,3.0,18.0,Matches,441,gw GNB,DF,24,14,886.0,63.0,25.9,9.8,11,74.0,4,3,25.0,20,1.0,12.0,28.0,-16.0,-1.63,-1.63,10.8,21.9,-11.1,-1.13,-0.92,Matches,361.0,gw GNB,DF,24.0,9.8,436.0,29.0,160.0,183.0,97.0,1.0,436.0,21.0,9.0,42.9,9.0,42.9,201.0,1270.0,704.0,18.0,10.0,1.0,16.0,10.0,227.0,30.0,Matches,361.0,gw GNB,DF,24.0,9.8,0.0,1.0,0.0,0.0,0.1,0.0,0.0,,23.9,0.0,0.0,0.0,0.0,0.0,0.02,0.0,0.0,Matches,361.0,gw GNB,DF,24.0,14.0,11.0,886.0,9.8,0.0,1.0,1.0,0.0,0.0,0.0,2.0,0.0,0.0,0.0,0.3,0.3,18.0,18.0,30.0,0.0,0.1,0.1,0.0,0.1,0.0,0.03,0.03,0.0,0.03,Matches,Houboulang Mendes,D/WB RC,24,120,135,"France,Guinea-Bissau,Senegal",Almería,6,12,11,6,11,8,13,11,12,13,12,8,13,11,13,13,15,13,12,12,10,13,8,8,13,12,12,14,12,12,15,12,15,13,15,13,12,11,12,8,12,2,3,1,2,1,2,1,4,3,2,1,14,12,7,13,10,14,13,15,1,1,20,19,1,16,1,1,1,1,1,1,1,1,184,73,8,20,1335762,6000,6000,2752,African_Caribbean,118,17,1998/5/4,0,0,3584.0,,49038621
420,Jorge Meré,Cádiz,1997,365.0,es ESP,DF,25.0,6.7,11.0,7.0,9.0,2.0,0.0,5.0,8.0,62.5,3.0,9.0,6.0,3.0,6.0,17.0,32.0,0.0,Matches,365.0,es ESP,DF,25.0,6.7,4.0,0.6,2.0,0.0,0.0,2.0,0.0,0.0,0.0,0.0,0.0,0.0,0.0,0.0,0.0,0.0,Matches,,,,,,,,,,,,,,,,,,,,,,,,,,,,,,,,,,,,,,,,,,,,,,,,,,,,,,,,365.0,es ESP,DF,25.0,6.7,0.0,0.0,0.0,1.0,3.0,0.0,0.0,6.0,7.0,0.0,0.0,0.0,27.0,15.0,8.0,65.2,Matches,365.0,es ESP,DF,25.0,6.7,215.0,207.0,8.0,8.0,0.0,1.0,0.0,0.0,0.0,0.0,0.0,0.0,179.0,0.0,1.0,Matches,365.0,es ESP,DF,25.0,6.7,179.0,215.0,83.3,3641.0,1350.0,55.0,64.0,85.9,100.0,112.0,89.3,23.0,36.0,63.9,0.0,0.0,0.0,0.0,0.0,8.0,0.0,0.0,14.0,Matches,446,es ESP,DF,25,10,601.0,60.0,17.6,6.7,6,84.0,4,4,24.0,6,1.5,6.0,10.0,-4.0,-0.6,0.01,9.9,12.4,-2.6,-0.38,0.18,Matches,365.0,es ESP,DF,25.0,6.7,283.0,45.0,148.0,127.0,11.0,6.0,283.0,0.0,0.0,,0.0,,142.0,474.0,182.0,1.0,0.0,0.0,3.0,1.0,146.0,0.0,Matches,365.0,es ESP,DF,25.0,6.7,0.0,4.0,1.0,25.0,0.6,0.15,0.0,0.0,14.6,0.0,0.0,0.0,0.2,0.2,0.05,-0.2,-0.2,Matches,365.0,es ESP,DF,25.0,10.0,6.0,601.0,6.7,0.0,0.0,0.0,0.0,0.0,0.0,0.0,0.0,0.2,0.2,0.0,0.2,1.0,14.0,0.0,0.0,0.0,0.0,0.0,0.0,0.03,0.0,0.03,0.03,0.03,Matches,Jorge Meré,D C,25,126,140,Spain,CF América,4,7,11,7,12,4,13,7,10,15,12,6,15,12,11,16,11,13,9,12,11,10,11,12,8,15,12,12,10,12,15,12,13,11,12,14,11,12,14,5,4,3,2,2,3,3,2,3,1,2,3,3,12,9,7,14,8,10,11,12,1,5,20,8,1,1,8,1,1,1,1,1,1,1,182,77,12,20,2249182,6312,6506,4264,Mediterranean_Hispanic,124,6,1997/4/17,0,0,14216.0,Mazatlán Fútbol Club,67199429
421,Marko Milovanović,Almería,2003,371.0,rs SRB,FW,18.0,0.2,0.0,0.0,0.0,0.0,0.0,0.0,0.0,,0.0,0.0,0.0,0.0,0.0,0.0,0.0,0.0,Matches,371.0,rs SRB,FW,18.0,0.2,1.0,6.0,0.0,0.0,0.0,1.0,0.0,0.0,0.0,0.0,0.0,0.0,0.0,0.0,0.0,0.0,Matches,,,,,,,,,,,,,,,,,,,,,,,,,,,,,,,,,,,,,,,,,,,,,,,,,,,,,,,,371.0,rs SRB,FW,18.0,0.2,1.0,0.0,0.0,2.0,0.0,0.0,0.0,0.0,0.0,0.0,0.0,0.0,0.0,5.0,3.0,62.5,Matches,371.0,rs SRB,FW,18.0,0.2,9.0,8.0,1.0,0.0,0.0,0.0,0.0,0.0,0.0,0.0,0.0,0.0,4.0,0.0,1.0,Matches,371.0,rs SRB,FW,18.0,0.2,4.0,9.0,44.4,53.0,7.0,1.0,2.0,50.0,2.0,4.0,50.0,0.0,0.0,,0.0,0.0,0.0,0.0,0.0,0.0,0.0,0.0,1.0,Matches,454,rs SRB,FW,18,2,15.0,8.0,0.4,0.2,0,,0,2,8.0,3,0.0,0.0,1.0,-1.0,-6.0,-5.6,0.3,0.7,-0.4,-2.34,-1.9,Matches,371.0,rs SRB,FW,18.0,0.2,12.0,0.0,1.0,5.0,6.0,1.0,12.0,0.0,0.0,,0.0,,5.0,20.0,8.0,0.0,1.0,0.0,0.0,3.0,10.0,3.0,Matches,371.0,rs SRB,FW,18.0,0.2,0.0,1.0,0.0,0.0,6.0,0.0,0.0,,9.4,0.0,0.0,0.0,0.1,0.1,0.05,-0.1,-0.1,Matches,371.0,rs SRB,FW,18.0,2.0,0.0,15.0,0.2,0.0,0.0,0.0,0.0,0.0,0.0,1.0,0.0,0.1,0.1,0.0,0.1,0.0,1.0,3.0,0.0,0.0,0.0,0.0,0.0,0.3,0.0,0.3,0.3,0.3,Matches,Marko Milovanović,S,18,115,-8,Serbia,Almería,5,7,9,12,11,7,14,9,10,8,9,8,5,11,10,12,10,12,13,11,11,13,14,10,11,13,10,10,12,10,10,15,12,12,12,13,13,9,13,7,14,3,2,3,3,2,3,3,1,2,2,2,11,12,9,12,13,12,11,12,1,1,1,1,1,1,1,1,1,1,1,1,1,20,196,85,13,20,30000000,5750,5400,3264,Northern_European,108,4,2003/8/4,0,0,3068.0,,2000076067
422,Johan Mojica,Villarreal,1992,377.0,co COL,DF,29.0,7.1,13.0,9.0,9.0,3.0,1.0,5.0,9.0,55.6,4.0,8.0,3.0,5.0,4.0,17.0,14.0,1.0,Matches,377.0,co COL,DF,29.0,7.1,13.0,1.82,11.0,2.0,0.0,0.0,0.0,0.0,0.0,0.0,0.0,0.0,0.0,0.0,0.0,0.0,Matches,,,,,,,,,,,,,,,,,,,,,,,,,,,,,,,,,,,,,,,,,,,,,,,,,,,,,,,,377.0,co COL,DF,29.0,7.1,0.0,0.0,0.0,3.0,14.0,0.0,40.0,4.0,9.0,0.0,0.0,0.0,49.0,7.0,4.0,63.6,Matches,377.0,co COL,DF,29.0,7.1,395.0,329.0,63.0,8.0,0.0,0.0,40.0,51.0,4.0,1.0,2.0,0.0,318.0,3.0,16.0,Matches,377.0,co COL,DF,29.0,7.1,318.0,395.0,80.5,5334.0,1393.0,150.0,164.0,91.5,133.0,153.0,86.9,27.0,45.0,60.0,0.0,0.9,1.0,-0.9,9.0,18.0,3.0,3.0,19.0,Matches,460,co COL,DF,29,17,642.0,38.0,18.8,7.1,5,89.0,4,12,16.0,18,1.41,9.0,12.0,-3.0,-0.42,-1.13,7.6,13.1,-5.5,-0.77,-1.33,Matches,377.0,co COL,DF,29.0,7.1,458.0,17.0,137.0,174.0,151.0,9.0,458.0,14.0,6.0,42.9,6.0,42.9,286.0,1820.0,884.0,27.0,15.0,5.0,10.0,5.0,276.0,38.0,Matches,377.0,co COL,DF,29.0,7.1,0.0,2.0,1.0,50.0,0.28,0.14,0.0,0.0,27.1,0.0,0.0,0.0,0.1,0.1,0.03,-0.1,-0.1,Matches,377.0,co COL,DF,29.0,17.0,5.0,642.0,7.1,0.0,0.0,0.0,0.0,0.0,0.0,0.0,0.0,0.1,0.1,0.9,0.9,27.0,19.0,38.0,0.0,0.0,0.0,0.0,0.0,0.01,0.12,0.13,0.01,0.13,Matches,Johan Mojica,D/WB/M L,29,136,142,"Colombia,Spain",Villarreal,13,13,14,9,12,13,11,10,12,9,13,6,11,13,14,12,12,10,10,12,10,13,13,7,14,11,11,13,16,14,14,10,17,17,15,11,7,11,13,12,14,1,1,2,3,1,3,4,3,2,1,3,12,12,6,10,12,11,10,10,1,19,1,1,20,1,1,18,1,1,14,1,1,1,179,66,20,8,5685403,6700,6024,4718,African_Caribbean,129,14,1992/8/21,20,1,16393.0,,76020280
423,Martín Montoya,Betis,1991,384.0,es ESP,DF,31.0,5.0,13.0,8.0,9.0,4.0,0.0,10.0,12.0,83.3,2.0,6.0,1.0,5.0,9.0,22.0,14.0,1.0,Matches,384.0,es ESP,DF,31.0,5.0,7.0,1.39,7.0,0.0,0.0,0.0,0.0,0.0,0.0,0.0,0.0,0.0,0.0,0.0,0.0,0.0,Matches,,,,,,,,,,,,,,,,,,,,,,,,,,,,,,,,,,,,,,,,,,,,,,,,,,,,,,,,384.0,es ESP,DF,31.0,5.0,1.0,0.0,0.0,4.0,6.0,0.0,10.0,9.0,8.0,0.0,0.0,0.0,24.0,8.0,3.0,72.7,Matches,384.0,es ESP,DF,31.0,5.0,244.0,199.0,45.0,6.0,0.0,2.0,10.0,39.0,0.0,0.0,0.0,0.0,190.0,0.0,5.0,Matches,384.0,es ESP,DF,31.0,5.0,190.0,244.0,77.9,2765.0,1133.0,107.0,116.0,92.2,60.0,77.0,77.9,12.0,31.0,38.7,0.0,0.7,0.6,-0.7,4.0,12.0,3.0,2.0,16.0,Matches,470,es ESP,DF,31,6,453.0,76.0,13.2,5.0,6,76.0,3,0,,28,1.17,6.0,10.0,-4.0,-0.79,-1.07,6.2,7.2,-1.0,-0.2,-0.27,Matches,384.0,es ESP,DF,31.0,5.0,302.0,22.0,95.0,161.0,48.0,5.0,302.0,5.0,2.0,40.0,3.0,60.0,151.0,594.0,309.0,6.0,2.0,0.0,7.0,4.0,167.0,12.0,Matches,384.0,es ESP,DF,31.0,5.0,0.0,1.0,0.0,0.0,0.2,0.0,0.0,,21.3,0.0,0.0,0.0,0.0,0.0,0.04,0.0,0.0,Matches,384.0,es ESP,DF,31.0,6.0,6.0,453.0,5.0,0.0,0.0,0.0,0.0,0.0,0.0,1.0,0.0,0.0,0.0,0.7,0.7,6.0,16.0,12.0,0.0,0.0,0.0,0.0,0.0,0.01,0.14,0.15,0.01,0.15,Matches,Martín Montoya,D/WB RL,31,125,153,Spain,Real Hispalis,8,13,12,8,12,6,11,9,11,12,12,8,13,14,13,14,13,12,11,11,11,12,10,11,12,12,15,14,13,12,11,9,11,12,16,12,12,10,13,12,10,1,1,3,3,1,2,4,2,1,3,1,12,11,10,12,11,13,13,13,1,16,1,20,11,19,1,1,1,11,1,1,1,1,175,73,8,20,2011228,6550,6550,5750,Mediterranean_Hispanic,119,6,1991/4/14,0,0,55000.0,,67053464
424,Jon Morcillo,Athletic Club,1998,386.0,es ESP,FWMF,23.0,0.8,1.0,0.0,1.0,0.0,0.0,0.0,1.0,0.0,1.0,0.0,0.0,0.0,1.0,2.0,0.0,0.0,Matches,386.0,es ESP,FWMF,23.0,0.8,4.0,5.45,4.0,0.0,0.0,0.0,0.0,0.0,1.0,1.36,1.0,0.0,0.0,0.0,0.0,0.0,Matches,,,,,,,,,,,,,,,,,,,,,,,,,,,,,,,,,,,,,,,,,,,,,,,,,,,,,,,,386.0,es ESP,FWMF,23.0,0.8,0.0,0.0,0.0,1.0,1.0,0.0,6.0,1.0,0.0,0.0,0.0,0.0,7.0,1.0,1.0,50.0,Matches,386.0,es ESP,FWMF,23.0,0.8,44.0,43.0,0.0,0.0,0.0,0.0,6.0,0.0,0.0,0.0,0.0,0.0,32.0,1.0,0.0,Matches,386.0,es ESP,FWMF,23.0,0.8,32.0,44.0,72.7,525.0,156.0,18.0,20.0,90.0,10.0,13.0,76.9,3.0,7.0,42.9,1.0,0.3,0.2,0.7,4.0,0.0,3.0,1.0,2.0,Matches,472,es ESP,FWMF,23,10,76.0,8.0,2.2,0.8,0,,0,10,8.0,9,2.2,1.0,1.0,0.0,0.0,-0.11,1.1,0.7,0.4,0.55,0.09,Matches,386.0,es ESP,FWMF,23.0,0.8,51.0,0.0,9.0,13.0,30.0,3.0,51.0,5.0,3.0,60.0,0.0,0.0,37.0,332.0,198.0,6.0,6.0,1.0,0.0,2.0,38.0,15.0,Matches,386.0,es ESP,FWMF,23.0,0.8,0.0,1.0,0.0,0.0,1.18,0.0,0.0,,10.3,0.0,0.0,0.0,0.1,0.1,0.15,-0.1,-0.1,Matches,386.0,es ESP,FWMF,23.0,10.0,0.0,76.0,0.8,0.0,1.0,1.0,0.0,0.0,0.0,0.0,0.0,0.1,0.1,0.3,0.5,6.0,2.0,15.0,0.0,1.18,1.18,0.0,1.18,0.2,0.42,0.62,0.2,0.62,Matches,Jon Morcillo,M/AM/S RL,23,128,143,"Spain,Pays Basque",A. Bilbao,13,15,14,12,10,12,9,15,7,7,13,9,7,14,9,13,11,12,11,13,14,13,13,7,13,7,11,11,12,12,13,12,13,13,13,12,12,7,15,13,11,3,1,1,2,1,3,2,3,2,1,1,18,13,6,13,11,13,10,20,1,1,1,1,1,1,1,19,1,16,20,1,18,16,183,72,20,9,14008306,6400,6400,4900,Mediterranean_Hispanic,121,4,1998/9/15,0,0,9770.0,,67260202
425,Manu Morlanes,Villarreal,1999,393.0,es ESP,MF,23.0,1.8,3.0,2.0,2.0,1.0,0.0,3.0,3.0,100.0,0.0,3.0,2.0,1.0,1.0,4.0,2.0,0.0,Matches,393.0,es ESP,MF,23.0,1.8,2.0,1.14,2.0,0.0,0.0,0.0,0.0,0.0,0.0,0.0,0.0,0.0,0.0,0.0,0.0,0.0,Matches,,,,,,,,,,,,,,,,,,,,,,,,,,,,,,,,,,,,,,,,,,,,,,,,,,,,,,,,393.0,es ESP,MF,23.0,1.8,0.0,1.0,0.0,1.0,1.0,0.0,0.0,1.0,2.0,0.0,0.0,0.0,5.0,1.0,2.0,33.3,Matches,393.0,es ESP,MF,23.0,1.8,46.0,42.0,3.0,3.0,0.0,0.0,0.0,0.0,0.0,0.0,0.0,0.0,36.0,1.0,2.0,Matches,393.0,es ESP,MF,23.0,1.8,36.0,46.0,78.3,596.0,151.0,19.0,21.0,90.5,13.0,15.0,86.7,4.0,7.0,57.1,0.0,0.0,0.0,0.0,0.0,6.0,0.0,0.0,6.0,Matches,482,es ESP,MF,23,4,158.0,40.0,4.6,1.8,2,70.0,0,2,10.0,11,2.0,3.0,4.0,-1.0,-0.57,-1.12,1.8,2.7,-0.9,-0.51,-0.86,Matches,393.0,es ESP,MF,23.0,1.8,60.0,5.0,15.0,34.0,11.0,0.0,60.0,0.0,0.0,,0.0,,31.0,127.0,49.0,1.0,1.0,0.0,0.0,1.0,36.0,1.0,Matches,393.0,es ESP,MF,23.0,1.8,0.0,0.0,0.0,,0.0,0.0,,,,0.0,0.0,0.0,0.0,0.0,,0.0,0.0,Matches,393.0,es ESP,MF,23.0,4.0,2.0,158.0,1.8,0.0,0.0,0.0,0.0,0.0,0.0,0.0,1.0,0.0,0.0,0.0,0.0,1.0,6.0,1.0,0.0,0.0,0.0,0.0,0.0,0.0,0.0,0.0,0.0,0.0,Matches,Manu Morlanes,DM/M/AM C,23,134,156,Spain,Villarreal,11,13,12,11,15,11,10,11,8,10,14,10,12,15,15,12,13,13,14,15,14,14,14,12,13,12,13,14,12,13,11,10,15,13,14,12,11,9,2,8,17,3,2,2,3,1,3,2,3,2,2,1,12,11,5,11,9,14,12,13,1,1,1,1,1,1,18,1,20,1,1,16,1,1,178,75,9,20,9619445,6600,6600,5200,Mediterranean_Hispanic,133,6,1999/1/12,0,0,14048.0,,67228802
426,Juanjo Narváez,Valladolid,1995,407.0,co COL,MFFW,27.0,1.6,1.0,1.0,1.0,0.0,0.0,1.0,1.0,100.0,0.0,2.0,0.0,2.0,0.0,1.0,0.0,0.0,Matches,407.0,co COL,MFFW,27.0,1.6,0.0,0.0,0.0,0.0,0.0,0.0,0.0,0.0,0.0,0.0,0.0,0.0,0.0,0.0,0.0,0.0,Matches,,,,,,,,,,,,,,,,,,,,,,,,,,,,,,,,,,,,,,,,,,,,,,,,,,,,,,,,407.0,co COL,MFFW,27.0,1.6,0.0,0.0,0.0,1.0,9.0,1.0,1.0,0.0,1.0,0.0,0.0,0.0,5.0,3.0,6.0,33.3,Matches,407.0,co COL,MFFW,27.0,1.6,36.0,35.0,0.0,0.0,0.0,0.0,1.0,0.0,0.0,0.0,0.0,0.0,25.0,1.0,2.0,Matches,407.0,co COL,MFFW,27.0,1.6,25.0,36.0,69.4,270.0,31.0,18.0,22.0,81.8,5.0,7.0,71.4,0.0,1.0,0.0,0.0,0.0,0.0,0.0,0.0,0.0,0.0,0.0,0.0,Matches,498,co COL,MFFW,27,5,148.0,30.0,4.3,1.6,1,61.0,0,4,22.0,10,0.8,1.0,4.0,-3.0,-1.82,-1.08,1.4,2.7,-1.3,-0.77,-0.07,Matches,407.0,co COL,MFFW,27.0,1.6,51.0,1.0,9.0,17.0,25.0,6.0,51.0,3.0,1.0,33.3,1.0,33.3,29.0,110.0,27.0,0.0,2.0,0.0,2.0,5.0,38.0,9.0,Matches,407.0,co COL,MFFW,27.0,1.6,0.0,3.0,0.0,0.0,1.82,0.0,0.0,,10.6,0.0,0.0,0.0,0.2,0.2,0.06,-0.2,-0.2,Matches,407.0,co COL,MFFW,27.0,5.0,1.0,148.0,1.6,0.0,0.0,0.0,0.0,0.0,0.0,0.0,0.0,0.2,0.2,0.0,0.2,0.0,0.0,9.0,0.0,0.0,0.0,0.0,0.0,0.11,0.0,0.11,0.11,0.11,Matches,Juanjo Narváez,AM/S RLC,27,128,134,"Colombia,Spain",Valladolid,9,9,13,14,12,9,10,14,9,8,11,13,8,13,7,13,12,14,12,11,12,14,11,10,14,13,11,10,14,12,13,9,11,12,13,12,12,8,10,7,12,3,1,3,1,3,2,2,3,3,1,3,16,13,4,11,12,11,12,10,1,1,1,1,1,1,1,11,10,11,18,20,18,18,180,80,12,20,2902399,6300,6300,4050,Mediterranean_Hispanic,122,8,1995/2/12,0,0,7258.0,,76021196
427,Álvaro Negredo,Cádiz,1985,411.0,es ESP,FW,36.0,8.4,5.0,4.0,1.0,2.0,2.0,2.0,2.0,100.0,0.0,4.0,1.0,3.0,0.0,5.0,8.0,0.0,Matches,411.0,es ESP,FW,36.0,8.4,21.0,2.49,13.0,0.0,3.0,3.0,1.0,1.0,4.0,0.47,2.0,0.0,1.0,1.0,0.0,0.0,Matches,,,,,,,,,,,,,,,,,,,,,,,,,,,,,,,,,,,,,,,,,,,,,,,,,,,,,,,,411.0,es ESP,FW,36.0,8.4,0.0,0.0,0.0,5.0,8.0,7.0,2.0,0.0,4.0,0.0,0.0,0.0,9.0,31.0,26.0,54.4,Matches,411.0,es ESP,FW,36.0,8.4,173.0,153.0,20.0,1.0,3.0,4.0,2.0,0.0,0.0,0.0,0.0,0.0,106.0,0.0,4.0,Matches,411.0,es ESP,FW,36.0,8.4,106.0,173.0,61.3,1766.0,383.0,53.0,77.0,68.8,32.0,48.0,66.7,12.0,28.0,42.9,2.0,2.4,1.6,-0.4,10.0,11.0,4.0,1.0,17.0,Matches,503,es ESP,FW,36,21,757.0,36.0,22.1,8.4,9,64.0,1,12,15.0,13,0.67,6.0,17.0,-11.0,-1.31,-0.9,9.7,17.1,-7.4,-0.88,-0.45,Matches,411.0,es ESP,FW,36.0,8.4,246.0,10.0,23.0,135.0,91.0,29.0,246.0,10.0,5.0,50.0,4.0,40.0,115.0,443.0,156.0,4.0,5.0,0.0,18.0,7.0,174.0,22.0,Matches,411.0,es ESP,FW,36.0,8.4,1.0,22.0,7.0,31.8,2.62,0.83,0.05,0.14,16.8,0.0,0.0,0.0,1.8,1.8,0.08,-0.8,-0.8,Matches,411.0,es ESP,FW,36.0,21.0,9.0,757.0,8.4,1.0,2.0,3.0,1.0,0.0,0.0,0.0,0.0,1.8,1.8,2.4,4.2,4.0,17.0,22.0,0.12,0.24,0.36,0.12,0.36,0.21,0.28,0.5,0.21,0.5,Matches,Álvaro Negredo,S,36,132,145,Spain,Cádiz,8,11,12,14,14,8,16,14,7,10,14,16,9,16,14,15,14,14,14,16,15,13,16,14,15,11,16,14,8,10,18,16,12,9,11,16,13,10,13,9,7,1,3,1,3,3,1,1,2,3,3,2,12,13,7,15,13,18,16,14,1,1,1,1,1,1,1,1,1,1,1,12,1,20,186,86,20,10,427620,6600,6600,6150,Mediterranean_Hispanic,136,6,1985/8/20,21,10,18509.0,,1501655
428,Randy Nteka,Elche,1997,415.0,ao ANG,FWMF,24.0,8.1,15.0,10.0,7.0,6.0,2.0,2.0,11.0,18.2,9.0,15.0,3.0,12.0,4.0,19.0,9.0,0.0,Matches,415.0,ao ANG,FWMF,24.0,8.1,16.0,1.99,12.0,0.0,3.0,1.0,0.0,0.0,1.0,0.12,1.0,0.0,0.0,0.0,0.0,0.0,Matches,,,,,,,,,,,,,,,,,,,,,,,,,,,,,,,,,,,,,,,,,,,,,,,,,,,,,,,,415.0,ao ANG,FWMF,24.0,8.1,1.0,0.0,0.0,21.0,17.0,3.0,0.0,4.0,10.0,0.0,0.0,0.0,38.0,15.0,31.0,32.6,Matches,415.0,ao ANG,FWMF,24.0,8.1,171.0,161.0,9.0,1.0,1.0,1.0,0.0,2.0,0.0,0.0,0.0,0.0,118.0,1.0,7.0,Matches,415.0,ao ANG,FWMF,24.0,8.1,118.0,171.0,69.0,1458.0,339.0,76.0,101.0,75.2,22.0,32.0,68.8,7.0,14.0,50.0,0.0,0.9,0.7,-0.9,6.0,8.0,3.0,0.0,13.0,Matches,508,ao ANG,FWMF,24,14,726.0,52.0,21.2,8.1,10,65.0,0,4,18.0,1,1.14,5.0,9.0,-4.0,-0.5,0.61,8.2,14.2,-6.1,-0.75,0.13,Matches,415.0,ao ANG,FWMF,24.0,8.1,290.0,18.0,43.0,140.0,110.0,32.0,290.0,24.0,12.0,50.0,11.0,45.8,175.0,837.0,346.0,13.0,6.0,6.0,21.0,17.0,190.0,43.0,Matches,415.0,ao ANG,FWMF,24.0,8.1,0.0,14.0,4.0,28.6,1.74,0.5,0.0,0.0,14.3,0.0,0.0,0.0,1.3,1.3,0.09,-1.3,-1.3,Matches,415.0,ao ANG,FWMF,24.0,14.0,10.0,726.0,8.1,0.0,0.0,0.0,0.0,0.0,0.0,1.0,0.0,1.3,1.3,0.9,2.2,13.0,13.0,43.0,0.0,0.0,0.0,0.0,0.0,0.16,0.12,0.28,0.16,0.28,Matches,Randy Nteka,DM/M/AM/S C,24,128,147,"France,Angola,Democratic Republic of Congo",Vallecano,11,10,11,12,11,11,14,11,7,9,13,7,12,12,14,12,14,12,13,14,14,12,14,14,12,11,11,12,12,11,9,14,14,13,14,14,12,7,16,6,15,3,1,3,1,2,2,3,2,3,2,2,12,12,1,13,13,9,11,17,1,1,1,1,1,1,16,13,18,1,1,20,1,16,189,75,20,11,3087097,6400,6400,4400,African_Caribbean,122,18,1997/12/6,0,0,8491.0,,67277397
429,Álvaro Odriozola,Real Madrid,1995,421.0,es ESP,DF,26.0,0.4,0.0,0.0,0.0,0.0,0.0,0.0,0.0,,0.0,0.0,0.0,0.0,0.0,0.0,0.0,0.0,Matches,421.0,es ESP,DF,26.0,0.4,3.0,6.92,2.0,0.0,0.0,0.0,1.0,0.0,0.0,0.0,0.0,0.0,0.0,0.0,0.0,0.0,Matches,,,,,,,,,,,,,,,,,,,,,,,,,,,,,,,,,,,,,,,,,,,,,,,,,,,,,,,,421.0,es ESP,DF,26.0,0.4,0.0,0.0,0.0,0.0,2.0,0.0,3.0,0.0,0.0,0.0,0.0,0.0,1.0,0.0,1.0,0.0,Matches,421.0,es ESP,DF,26.0,0.4,28.0,25.0,3.0,0.0,0.0,0.0,3.0,3.0,0.0,0.0,0.0,0.0,27.0,0.0,0.0,Matches,421.0,es ESP,DF,26.0,0.4,27.0,28.0,96.4,376.0,108.0,19.0,20.0,95.0,7.0,7.0,100.0,1.0,1.0,100.0,0.0,0.3,0.1,-0.3,2.0,1.0,1.0,1.0,2.0,Matches,514,es ESP,DF,26,3,39.0,13.0,1.1,0.4,0,,0,3,13.0,29,3.0,2.0,0.0,2.0,4.62,3.63,1.7,0.2,1.5,3.56,2.62,Matches,421.0,es ESP,DF,26.0,0.4,32.0,0.0,7.0,15.0,10.0,2.0,32.0,2.0,0.0,0.0,0.0,0.0,20.0,142.0,74.0,4.0,0.0,0.0,0.0,0.0,25.0,5.0,Matches,421.0,es ESP,DF,26.0,0.4,0.0,1.0,0.0,0.0,2.31,0.0,0.0,,13.7,0.0,0.0,0.0,0.2,0.2,0.24,-0.2,-0.2,Matches,421.0,es ESP,DF,26.0,3.0,0.0,39.0,0.4,0.0,0.0,0.0,0.0,0.0,0.0,0.0,0.0,0.2,0.2,0.3,0.5,4.0,2.0,5.0,0.0,0.0,0.0,0.0,0.0,0.56,0.66,1.22,0.56,1.22,Matches,Álvaro Odriozola,D/WB R,26,141,150,"Spain,Pays Basque",R. Madrid,11,14,13,9,13,8,9,10,14,12,15,8,13,14,12,12,15,12,13,12,12,12,11,9,13,14,15,15,15,15,13,8,15,16,13,13,13,8,13,9,11,1,3,3,2,3,2,1,2,3,2,3,13,14,5,11,12,14,15,14,1,9,1,20,9,18,1,1,1,1,1,1,1,1,175,66,9,20,10407824,7050,7200,6000,Mediterranean_Hispanic,137,6,1995/12/14,4,1,123288.0,,67199408
430,Pedro Ortiz,Sevilla,2000,427.0,es ESP,MF,21.0,0.0,0.0,0.0,0.0,0.0,0.0,0.0,0.0,,0.0,0.0,0.0,0.0,0.0,0.0,0.0,0.0,Matches,427.0,es ESP,MF,21.0,0.0,0.0,0.0,0.0,0.0,0.0,0.0,0.0,0.0,0.0,0.0,0.0,0.0,0.0,0.0,0.0,0.0,Matches,,,,,,,,,,,,,,,,,,,,,,,,,,,,,,,,,,,,,,,,,,,,,,,,,,,,,,,,427.0,es ESP,MF,21.0,0.0,0.0,0.0,0.0,0.0,0.0,0.0,0.0,0.0,0.0,0.0,0.0,0.0,1.0,0.0,0.0,,Matches,427.0,es ESP,MF,21.0,0.0,1.0,1.0,0.0,0.0,0.0,0.0,0.0,0.0,0.0,0.0,0.0,0.0,1.0,0.0,0.0,Matches,427.0,es ESP,MF,21.0,0.0,1.0,1.0,100.0,12.0,0.0,1.0,1.0,100.0,0.0,0.0,,0.0,0.0,,0.0,0.0,0.0,0.0,0.0,0.0,0.0,0.0,0.0,Matches,520,es ESP,MF,21,1,1.0,1.0,0.0,0.0,0,,0,1,1.0,1,1.0,0.0,0.0,0.0,0.0,0.18,0.0,0.0,0.0,0.0,0.21,Matches,427.0,es ESP,MF,21.0,0.0,2.0,0.0,1.0,1.0,0.0,0.0,2.0,0.0,0.0,,0.0,,2.0,1.0,0.0,0.0,0.0,0.0,1.0,0.0,1.0,0.0,Matches,427.0,es ESP,MF,21.0,0.0,0.0,0.0,0.0,,0.0,0.0,,,,0.0,0.0,0.0,0.0,0.0,,0.0,0.0,Matches,427.0,es ESP,MF,21.0,1.0,0.0,1.0,0.0,0.0,0.0,0.0,0.0,0.0,0.0,0.0,0.0,0.0,0.0,0.0,0.0,0.0,0.0,0.0,0.0,0.0,0.0,0.0,0.0,0.0,0.0,0.0,0.0,0.0,Matches,Pedro Ortiz,GK,32,123,124,Ecuador,Club Sport Emelec,4,3,1,3,6,9,5,2,2,2,6,1,2,6,11,11,10,7,10,7,14,14,7,13,6,10,11,9,11,12,14,16,14,10,11,16,15,8,11,12,15,16,13,14,6,16,12,11,14,8,9,10,16,13,6,11,13,11,10,15,20,1,1,1,1,1,1,1,1,1,1,1,1,1,187,70,8,20,135230,5697,5697,3072,African_Caribbean,120,14,1990/2/19,6,0,5483.0,,86050956
431,Fernando Pacheco,Almería,1992,430.0,es ESP,GK,30.0,1.0,0.0,0.0,0.0,0.0,0.0,0.0,0.0,,0.0,0.0,0.0,0.0,0.0,0.0,1.0,0.0,Matches,430.0,es ESP,GK,30.0,1.0,0.0,0.0,0.0,0.0,0.0,0.0,0.0,0.0,0.0,0.0,0.0,0.0,0.0,0.0,0.0,0.0,Matches,32.0,es ESP,GK,30.0,1.0,2.0,0.0,0.0,1.0,0.0,1.6,0.32,-0.4,-0.42,3.0,12.0,25.0,26.0,8.0,42.3,40.2,4.0,25.0,36.0,16.0,1.0,6.3,2.0,2.0,14.5,Matches,32.0,es ESP,GK,30.0,1.0,1.0,90.0,1.0,2.0,2.0,5.0,3.0,60.0,0.0,0.0,1.0,0.0,0.0,0.0,0.0,0.0,0.0,,Matches,430.0,es ESP,GK,30.0,1.0,0.0,0.0,0.0,0.0,0.0,0.0,0.0,0.0,0.0,0.0,0.0,0.0,0.0,0.0,0.0,,Matches,430.0,es ESP,GK,30.0,1.0,31.0,22.0,8.0,4.0,0.0,0.0,0.0,0.0,0.0,0.0,0.0,0.0,20.0,1.0,0.0,Matches,430.0,es ESP,GK,30.0,1.0,20.0,31.0,64.5,617.0,423.0,2.0,2.0,100.0,10.0,11.0,90.9,8.0,17.0,47.1,0.0,0.0,0.0,0.0,0.0,1.0,0.0,0.0,0.0,Matches,523,es ESP,GK,30,1,90.0,90.0,2.6,1.0,1,90.0,1,0,,10,0.0,1.0,2.0,-1.0,-1.0,-0.59,1.0,1.0,0.0,0.0,0.46,Matches,430.0,es ESP,GK,30.0,1.0,34.0,30.0,34.0,0.0,0.0,0.0,34.0,0.0,0.0,,0.0,,20.0,109.0,89.0,0.0,0.0,0.0,0.0,0.0,13.0,0.0,Matches,430.0,es ESP,GK,30.0,1.0,0.0,0.0,0.0,,0.0,0.0,,,,0.0,0.0,0.0,0.0,0.0,,0.0,0.0,Matches,430.0,es ESP,GK,30.0,1.0,1.0,90.0,1.0,0.0,0.0,0.0,0.0,0.0,0.0,0.0,0.0,0.0,0.0,0.0,0.0,0.0,0.0,0.0,0.0,0.0,0.0,0.0,0.0,0.0,0.0,0.0,0.0,0.0,Matches,Fernando Pacheco,GK,30,143,145,Spain,Almería,3,3,3,1,12,6,8,2,1,3,13,3,3,12,8,13,13,12,14,11,12,13,5,11,1,13,14,13,10,14,9,12,11,12,10,14,11,8,13,12,12,12,13,14,10,15,14,14,16,15,14,14,11,12,7,14,11,14,13,13,20,1,1,1,1,1,1,1,1,1,1,1,1,1,186,81,20,10,15027338,7000,7000,5500,Mediterranean_Hispanic,140,6,1992/5/18,0,0,19549.0,,67155103
432,Gonçalo Paciência,Celta Vigo,1994,433.0,pt POR,FWMF,27.0,7.4,8.0,5.0,0.0,5.0,3.0,2.0,7.0,28.6,5.0,9.0,1.0,8.0,0.0,8.0,4.0,0.0,Matches,433.0,pt POR,FWMF,27.0,7.4,18.0,2.45,12.0,0.0,1.0,2.0,3.0,0.0,3.0,0.41,2.0,0.0,0.0,1.0,0.0,0.0,Matches,,,,,,,,,,,,,,,,,,,,,,,,,,,,,,,,,,,,,,,,,,,,,,,,,,,,,,,,433.0,pt POR,FWMF,27.0,7.4,2.0,1.0,0.0,19.0,17.0,0.0,6.0,0.0,5.0,0.0,0.0,0.0,20.0,29.0,23.0,55.8,Matches,433.0,pt POR,FWMF,27.0,7.4,168.0,164.0,3.0,0.0,1.0,7.0,6.0,1.0,0.0,0.0,0.0,0.0,98.0,1.0,8.0,Matches,433.0,pt POR,FWMF,27.0,7.4,98.0,168.0,58.3,1609.0,391.0,55.0,85.0,64.7,31.0,48.0,64.6,10.0,20.0,50.0,0.0,0.6,0.5,-0.6,6.0,10.0,5.0,2.0,11.0,Matches,526,pt POR,FWMF,27,25,662.0,26.0,19.4,7.4,5,61.0,0,20,18.0,9,0.92,7.0,7.0,0.0,0.0,0.33,10.0,8.6,1.4,0.19,0.33,Matches,433.0,pt POR,FWMF,27.0,7.4,297.0,4.0,22.0,110.0,169.0,50.0,297.0,22.0,6.0,27.3,13.0,59.1,186.0,692.0,225.0,7.0,5.0,5.0,42.0,14.0,235.0,43.0,Matches,433.0,pt POR,FWMF,27.0,7.4,2.0,30.0,10.0,33.3,4.08,1.36,0.07,0.2,17.2,1.0,0.0,0.0,1.9,1.9,0.06,0.1,0.1,Matches,433.0,pt POR,FWMF,27.0,25.0,5.0,662.0,7.4,2.0,0.0,2.0,2.0,0.0,0.0,2.0,1.0,1.9,1.9,0.6,2.5,7.0,11.0,43.0,0.27,0.0,0.27,0.27,0.27,0.26,0.08,0.33,0.26,0.33,Matches,Gonçalo Paciência,S,27,126,132,Portugal,Vigo,8,9,15,11,15,10,14,12,5,7,13,15,7,14,9,13,12,10,11,13,10,11,14,8,12,7,10,12,11,14,15,13,12,14,12,16,11,6,11,8,6,3,3,3,1,1,2,3,2,3,1,2,8,12,13,15,9,14,7,12,1,1,1,1,1,1,1,1,1,1,1,14,1,20,184,81,12,20,2968361,6250,6800,4750,Mediterranean_Hispanic,126,6,1994/8/1,2,1,7029.0,,55028073
433,Aitor Paredes,Athletic Club,2000,436.0,es ESP,DF,22.0,9.5,7.0,6.0,4.0,2.0,1.0,6.0,11.0,54.5,5.0,11.0,7.0,4.0,14.0,21.0,26.0,0.0,Matches,436.0,es ESP,DF,22.0,9.5,5.0,0.52,3.0,0.0,0.0,2.0,0.0,0.0,0.0,0.0,0.0,0.0,0.0,0.0,0.0,0.0,Matches,,,,,,,,,,,,,,,,,,,,,,,,,,,,,,,,,,,,,,,,,,,,,,,,,,,,,,,,436.0,es ESP,DF,22.0,9.5,3.0,0.0,0.0,12.0,2.0,0.0,2.0,14.0,6.0,0.0,0.0,1.0,59.0,21.0,7.0,75.0,Matches,436.0,es ESP,DF,22.0,9.5,521.0,493.0,25.0,12.0,1.0,3.0,2.0,12.0,0.0,0.0,0.0,0.0,464.0,3.0,2.0,Matches,436.0,es ESP,DF,22.0,9.5,464.0,521.0,89.1,9712.0,3359.0,133.0,143.0,93.0,258.0,273.0,94.5,68.0,93.0,73.1,0.0,0.4,0.2,-0.4,3.0,29.0,2.0,0.0,33.0,Matches,530,es ESP,DF,22,16,859.0,54.0,25.1,9.5,9,89.0,8,7,8.0,22,1.25,9.0,18.0,-9.0,-0.94,-1.4,16.9,12.6,4.3,0.45,0.0,Matches,436.0,es ESP,DF,22.0,9.5,600.0,53.0,277.0,296.0,30.0,10.0,600.0,1.0,0.0,0.0,1.0,100.0,343.0,1678.0,895.0,4.0,2.0,0.0,3.0,0.0,377.0,8.0,Matches,436.0,es ESP,DF,22.0,9.5,0.0,8.0,3.0,37.5,0.84,0.31,0.0,0.0,12.6,0.0,0.0,0.0,0.5,0.5,0.06,-0.5,-0.5,Matches,436.0,es ESP,DF,22.0,16.0,9.0,859.0,9.5,0.0,0.0,0.0,0.0,0.0,0.0,3.0,0.0,0.5,0.5,0.4,0.9,4.0,33.0,8.0,0.0,0.0,0.0,0.0,0.0,0.05,0.04,0.09,0.05,0.09,Matches,Aitor Paredes,D C,22,105,135,"Spain,Pays Basque",A. Bilbao,6,4,3,8,13,4,12,10,4,12,16,6,16,13,15,12,11,11,11,14,11,4,6,6,10,15,10,11,12,10,11,15,12,11,11,8,14,8,12,11,12,3,3,1,2,2,2,1,2,2,4,2,15,11,1,11,10,12,9,18,1,1,20,1,1,1,1,1,1,1,1,1,1,1,186,77,10,20,1624999,5250,5250,3750,Mediterranean_Hispanic,107,6,2000/4/29,0,0,1922.0,,67276232
434,Javier Pastore,Elche,1989,441.0,ar ARG,MF,33.0,0.1,0.0,0.0,0.0,0.0,0.0,0.0,0.0,,0.0,0.0,0.0,0.0,0.0,0.0,0.0,0.0,Matches,441.0,ar ARG,MF,33.0,0.1,0.0,0.0,0.0,0.0,0.0,0.0,0.0,0.0,0.0,0.0,0.0,0.0,0.0,0.0,0.0,0.0,Matches,,,,,,,,,,,,,,,,,,,,,,,,,,,,,,,,,,,,,,,,,,,,,,,,,,,,,,,,441.0,ar ARG,MF,33.0,0.1,0.0,0.0,0.0,1.0,0.0,0.0,0.0,0.0,0.0,0.0,0.0,0.0,1.0,0.0,0.0,,Matches,441.0,ar ARG,MF,33.0,0.1,8.0,7.0,0.0,0.0,0.0,0.0,0.0,0.0,0.0,0.0,0.0,0.0,6.0,1.0,0.0,Matches,441.0,ar ARG,MF,33.0,0.1,6.0,8.0,75.0,81.0,49.0,3.0,3.0,100.0,0.0,1.0,0.0,1.0,1.0,100.0,0.0,0.0,0.0,0.0,0.0,1.0,0.0,0.0,1.0,Matches,535,ar ARG,MF,33,1,5.0,5.0,0.1,0.1,0,,0,1,5.0,6,1.0,0.0,0.0,0.0,0.0,0.98,0.0,0.1,-0.1,-1.44,-0.59,Matches,441.0,ar ARG,MF,33.0,0.1,10.0,0.0,0.0,3.0,7.0,2.0,10.0,0.0,0.0,,0.0,,9.0,91.0,27.0,2.0,1.0,0.0,1.0,1.0,9.0,2.0,Matches,441.0,ar ARG,MF,33.0,0.1,0.0,0.0,0.0,,0.0,0.0,,,,0.0,0.0,0.0,0.0,0.0,,0.0,0.0,Matches,441.0,ar ARG,MF,33.0,1.0,0.0,5.0,0.1,0.0,0.0,0.0,0.0,0.0,0.0,0.0,0.0,0.0,0.0,0.0,0.0,2.0,1.0,2.0,0.0,0.0,0.0,0.0,0.0,0.0,0.0,0.0,0.0,0.0,Matches,Javier Pastore,M/AM LC,33,132,159,"Argentina,Italy",Elche,13,14,16,13,18,13,8,13,3,4,16,14,4,19,8,13,9,15,11,17,14,13,18,10,14,3,15,9,9,14,12,12,5,10,10,9,10,8,14,18,13,2,2,3,1,4,4,3,2,2,2,1,10,14,7,14,12,17,18,15,1,1,1,1,1,1,1,13,17,10,15,20,10,1,187,78,14,20,2264720,6750,6750,5150,Mediterranean_Hispanic,131,7,1989/6/20,29,2,14585.0,,14006099
435,Adrià Pedrosa,Espanyol,1998,445.0,es ESP,DFMF,24.0,2.5,5.0,1.0,5.0,0.0,0.0,4.0,7.0,57.1,3.0,1.0,1.0,0.0,5.0,10.0,3.0,0.0,Matches,445.0,es ESP,DFMF,24.0,2.5,7.0,2.75,7.0,0.0,0.0,0.0,0.0,0.0,0.0,0.0,0.0,0.0,0.0,0.0,0.0,0.0,Matches,,,,,,,,,,,,,,,,,,,,,,,,,,,,,,,,,,,,,,,,,,,,,,,,,,,,,,,,445.0,es ESP,DFMF,24.0,2.5,0.0,0.0,0.0,3.0,4.0,1.0,9.0,5.0,1.0,0.0,0.0,0.0,18.0,1.0,1.0,50.0,Matches,445.0,es ESP,DFMF,24.0,2.5,76.0,69.0,7.0,1.0,1.0,0.0,9.0,6.0,0.0,0.0,0.0,0.0,61.0,0.0,3.0,Matches,445.0,es ESP,DFMF,24.0,2.5,61.0,76.0,80.3,881.0,239.0,37.0,40.0,92.5,20.0,27.0,74.1,2.0,4.0,50.0,0.0,0.7,1.0,-0.7,5.0,2.0,4.0,2.0,4.0,Matches,540,es ESP,DFMF,24,7,229.0,33.0,6.7,2.5,2,64.0,0,5,20.0,2,0.86,4.0,3.0,1.0,0.39,0.9,5.3,2.6,2.7,1.07,1.47,Matches,445.0,es ESP,DFMF,24.0,2.5,115.0,7.0,30.0,38.0,49.0,5.0,115.0,9.0,1.0,11.1,8.0,88.9,76.0,542.0,220.0,7.0,6.0,3.0,6.0,1.0,66.0,21.0,Matches,445.0,es ESP,DFMF,24.0,2.5,0.0,1.0,0.0,0.0,0.39,0.0,0.0,,19.8,0.0,0.0,0.0,0.1,0.1,0.05,-0.1,-0.1,Matches,445.0,es ESP,DFMF,24.0,7.0,2.0,229.0,2.5,0.0,0.0,0.0,0.0,0.0,0.0,0.0,0.0,0.1,0.1,0.7,0.7,7.0,4.0,21.0,0.0,0.0,0.0,0.0,0.0,0.02,0.26,0.28,0.02,0.28,Matches,Adrià Pedrosa,D/WB L,24,132,150,Spain,Espanyol,8,10,11,12,14,9,12,9,12,14,13,10,13,14,7,15,12,14,9,11,14,3,5,7,15,12,13,13,14,13,13,8,7,15,13,10,14,11,10,6,18,1,3,3,1,4,3,2,3,3,1,3,18,8,7,11,12,13,8,20,1,19,1,1,20,1,1,14,1,1,13,1,1,1,176,69,20,8,3336110,6500,6500,5100,Mediterranean_Hispanic,128,1,1998/5/13,0,0,10294.0,,95035991
436,Lucas Pérez,Cádiz,1988,453.0,es ESP,FW,33.0,7.0,3.0,2.0,2.0,1.0,0.0,1.0,3.0,33.3,2.0,2.0,0.0,2.0,1.0,4.0,3.0,0.0,Matches,453.0,es ESP,FW,33.0,7.0,16.0,2.29,11.0,1.0,2.0,1.0,0.0,1.0,0.0,0.0,0.0,0.0,0.0,0.0,0.0,0.0,Matches,,,,,,,,,,,,,,,,,,,,,,,,,,,,,,,,,,,,,,,,,,,,,,,,,,,,,,,,453.0,es ESP,FW,33.0,7.0,3.0,0.0,0.0,5.0,4.0,6.0,40.0,1.0,2.0,0.0,0.0,0.0,21.0,2.0,8.0,20.0,Matches,453.0,es ESP,FW,33.0,7.0,236.0,184.0,49.0,10.0,0.0,2.0,40.0,1.0,23.0,15.0,6.0,0.0,169.0,3.0,4.0,Matches,453.0,es ESP,FW,33.0,7.0,169.0,236.0,71.6,2634.0,646.0,96.0,106.0,90.6,48.0,63.0,76.2,17.0,48.0,35.4,0.0,0.6,1.0,-0.6,4.0,13.0,7.0,3.0,14.0,Matches,551,es ESP,FW,33,14,628.0,45.0,18.4,7.0,5,80.0,2,9,25.0,1,0.79,7.0,14.0,-7.0,-1.0,-0.49,6.4,15.1,-8.7,-1.25,-0.88,Matches,453.0,es ESP,FW,33.0,7.0,286.0,3.0,25.0,121.0,140.0,16.0,286.0,10.0,4.0,40.0,6.0,60.0,151.0,741.0,331.0,8.0,6.0,3.0,11.0,8.0,184.0,24.0,Matches,453.0,es ESP,FW,33.0,7.0,3.0,17.0,6.0,35.3,2.44,0.86,0.18,0.5,18.8,4.0,0.0,0.0,2.0,2.0,0.12,1.0,1.0,Matches,453.0,es ESP,FW,33.0,14.0,5.0,628.0,7.0,3.0,0.0,3.0,3.0,0.0,0.0,3.0,0.0,2.0,2.0,0.6,2.5,8.0,14.0,24.0,0.43,0.0,0.43,0.43,0.43,0.28,0.08,0.36,0.28,0.36,Matches,Lucas Pérez,AM/S RLC,33,132,150,Spain,Cádiz,13,13,14,14,14,14,8,13,7,5,13,15,7,15,14,14,12,12,13,13,13,11,15,12,14,6,13,13,14,13,13,9,13,13,13,13,9,11,11,11,13,1,1,3,3,3,1,3,3,4,2,1,11,12,11,11,10,13,12,9,1,1,1,1,1,1,1,10,10,10,16,16,15,20,181,78,20,9,1548471,6497,6497,5297,Mediterranean_Hispanic,128,6,1988/9/10,0,0,18509.0,,813076
437,Ronaël Pierre-Gabriel,Espanyol,1998,456.0,fr FRA,DF,24.0,2.6,17.0,9.0,12.0,4.0,1.0,5.0,11.0,45.5,6.0,5.0,2.0,3.0,9.0,26.0,11.0,0.0,Matches,456.0,fr FRA,DF,24.0,2.6,4.0,1.53,4.0,0.0,0.0,0.0,0.0,0.0,0.0,0.0,0.0,0.0,0.0,0.0,0.0,0.0,Matches,,,,,,,,,,,,,,,,,,,,,,,,,,,,,,,,,,,,,,,,,,,,,,,,,,,,,,,,456.0,fr FRA,DF,24.0,2.6,2.0,1.0,1.0,4.0,4.0,0.0,10.0,9.0,9.0,0.0,0.0,0.0,18.0,4.0,2.0,66.7,Matches,456.0,fr FRA,DF,24.0,2.6,104.0,76.0,28.0,0.0,0.0,0.0,10.0,28.0,0.0,0.0,0.0,0.0,77.0,0.0,4.0,Matches,456.0,fr FRA,DF,24.0,2.6,77.0,104.0,74.0,1187.0,440.0,37.0,41.0,90.2,34.0,42.0,81.0,3.0,8.0,37.5,0.0,0.3,0.5,-0.3,2.0,3.0,1.0,1.0,7.0,Matches,554,fr FRA,DF,24,8,236.0,30.0,6.9,2.6,2,53.0,0,6,22.0,9,1.0,3.0,5.0,-2.0,-0.76,-0.34,2.5,3.1,-0.6,-0.23,0.07,Matches,456.0,fr FRA,DF,24.0,2.6,154.0,14.0,61.0,46.0,50.0,6.0,154.0,9.0,4.0,44.4,4.0,44.4,69.0,433.0,211.0,7.0,3.0,2.0,5.0,2.0,68.0,16.0,Matches,456.0,fr FRA,DF,24.0,2.6,1.0,2.0,1.0,50.0,0.76,0.38,0.5,1.0,14.6,0.0,0.0,0.0,0.2,0.2,0.08,0.8,0.8,Matches,456.0,fr FRA,DF,24.0,8.0,2.0,236.0,2.6,1.0,0.0,1.0,1.0,0.0,0.0,2.0,1.0,0.2,0.2,0.3,0.4,7.0,7.0,16.0,0.38,0.0,0.38,0.38,0.38,0.06,0.11,0.16,0.06,0.16,Matches,Ronaël Pierre-Gabriel,D/WB R,24,125,135,France,1. FSV Mainz 05,6,11,13,6,11,6,7,6,15,13,12,7,15,12,15,12,16,12,12,11,12,15,11,8,12,13,13,15,14,12,15,8,13,14,14,15,12,13,12,10,15,2,1,1,2,1,1,2,1,3,3,1,11,12,10,8,11,11,10,10,1,14,14,20,12,18,1,1,1,1,1,1,1,1,177,80,7,20,2366661,6245,6095,4745,African_Caribbean,123,15,1998/6/13,0,0,21095.0,RC Strasbourg Alsace,48038032
438,Gerard Piqué,Barcelona,1987,458.0,es ESP,DF,35.0,4.3,5.0,4.0,1.0,4.0,0.0,4.0,4.0,100.0,0.0,2.0,1.0,1.0,2.0,7.0,19.0,0.0,Matches,458.0,es ESP,DF,35.0,4.3,5.0,1.17,5.0,0.0,0.0,0.0,0.0,0.0,0.0,0.0,0.0,0.0,0.0,0.0,0.0,0.0,Matches,,,,,,,,,,,,,,,,,,,,,,,,,,,,,,,,,,,,,,,,,,,,,,,,,,,,,,,,458.0,es ESP,DF,35.0,4.3,2.0,1.0,0.0,7.0,2.0,0.0,0.0,2.0,4.0,0.0,0.0,0.0,26.0,20.0,6.0,76.9,Matches,458.0,es ESP,DF,35.0,4.3,385.0,372.0,11.0,6.0,0.0,6.0,0.0,0.0,0.0,0.0,0.0,0.0,353.0,2.0,2.0,Matches,458.0,es ESP,DF,35.0,4.3,353.0,385.0,91.7,7375.0,2268.0,102.0,112.0,91.1,193.0,199.0,97.0,56.0,66.0,84.8,0.0,0.0,0.1,0.0,1.0,47.0,0.0,0.0,35.0,Matches,557,es ESP,DF,35,6,384.0,64.0,11.2,4.3,4,89.0,3,2,15.0,7,3.0,9.0,1.0,8.0,1.87,0.63,11.4,3.7,7.8,1.83,0.8,Matches,458.0,es ESP,DF,35.0,4.3,424.0,38.0,126.0,290.0,9.0,5.0,424.0,1.0,1.0,100.0,0.0,0.0,284.0,1789.0,1197.0,3.0,2.0,0.0,2.0,1.0,320.0,1.0,Matches,458.0,es ESP,DF,35.0,4.3,0.0,3.0,0.0,0.0,0.7,0.0,0.0,,8.9,0.0,0.0,0.0,0.4,0.4,0.13,-0.4,-0.4,Matches,458.0,es ESP,DF,35.0,6.0,4.0,384.0,4.3,0.0,0.0,0.0,0.0,0.0,0.0,2.0,1.0,0.4,0.4,0.0,0.4,3.0,35.0,1.0,0.0,0.0,0.0,0.0,0.0,0.09,0.01,0.09,0.09,0.09,Matches,Gerard Piqué,D C,35,155,173,Spain,Barcelona,7,7,12,11,15,7,16,8,7,15,16,13,15,16,12,15,14,17,14,15,17,14,10,17,8,18,15,15,10,8,9,16,15,11,13,14,14,11,16,8,9,1,1,1,1,3,1,1,1,2,2,1,16,16,16,19,18,14,10,11,1,1,20,1,1,1,10,1,1,1,1,1,1,1,194,85,10,20,4207502,7750,7750,7600,Mediterranean_Hispanic,154,1,1987/2/2,102,5,119999.0,,5124470
439,Francisco Portillo,Almería,1990,462.0,es ESP,MFFW,32.0,8.0,13.0,6.0,4.0,5.0,4.0,3.0,16.0,18.8,13.0,7.0,1.0,6.0,7.0,20.0,8.0,0.0,Matches,462.0,es ESP,MFFW,32.0,8.0,26.0,3.23,24.0,0.0,1.0,0.0,0.0,1.0,2.0,0.25,2.0,0.0,0.0,0.0,0.0,0.0,Matches,,,,,,,,,,,,,,,,,,,,,,,,,,,,,,,,,,,,,,,,,,,,,,,,,,,,,,,,462.0,es ESP,MFFW,32.0,8.0,1.0,0.0,0.0,2.0,3.0,2.0,12.0,7.0,6.0,0.0,0.0,0.0,54.0,5.0,5.0,50.0,Matches,462.0,es ESP,MFFW,32.0,8.0,459.0,436.0,20.0,5.0,6.0,1.0,12.0,8.0,7.0,1.0,3.0,0.0,365.0,3.0,13.0,Matches,462.0,es ESP,MFFW,32.0,8.0,365.0,459.0,79.5,5407.0,1875.0,211.0,240.0,87.9,115.0,136.0,84.6,22.0,41.0,53.7,1.0,1.0,1.9,0.0,13.0,49.0,18.0,3.0,74.0,Matches,562,es ESP,MFFW,32,27,722.0,27.0,21.1,8.0,4,69.0,1,23,19.0,11,0.85,10.0,16.0,-6.0,-0.75,-0.41,10.8,15.6,-4.8,-0.59,-0.18,Matches,462.0,es ESP,MFFW,32.0,8.0,519.0,11.0,95.0,268.0,162.0,13.0,519.0,17.0,9.0,52.9,7.0,41.2,327.0,1777.0,930.0,16.0,23.0,0.0,10.0,9.0,373.0,37.0,Matches,462.0,es ESP,MFFW,32.0,8.0,2.0,5.0,2.0,40.0,0.62,0.25,0.4,1.0,17.4,0.0,0.0,0.0,0.7,0.7,0.14,1.3,1.3,Matches,462.0,es ESP,MFFW,32.0,27.0,4.0,722.0,8.0,2.0,1.0,3.0,2.0,0.0,0.0,1.0,0.0,0.7,0.7,1.0,1.7,16.0,74.0,37.0,0.25,0.12,0.37,0.25,0.37,0.09,0.13,0.21,0.09,0.21,Matches,Francisco Portillo,AM LC,32,122,133,Spain,Almería,14,13,13,11,14,14,6,10,5,6,14,7,7,14,6,14,10,13,12,14,15,14,14,14,14,11,13,12,11,13,13,5,13,12,11,8,13,8,14,7,9,1,2,1,1,3,2,2,3,1,2,2,9,12,4,14,12,12,12,11,1,1,1,1,1,1,1,14,12,10,19,20,14,1,169,63,12,20,920326,6098,6098,4098,Mediterranean_Hispanic,122,8,1990/6/13,0,0,4814.0,,67044761
440,José Pozo,Rayo Vallecano,1996,464.0,es ESP,MFFW,26.0,1.0,2.0,2.0,0.0,2.0,0.0,0.0,0.0,,0.0,0.0,0.0,0.0,1.0,3.0,1.0,0.0,Matches,464.0,es ESP,MFFW,26.0,1.0,7.0,7.16,7.0,0.0,0.0,0.0,0.0,0.0,1.0,1.02,1.0,0.0,0.0,0.0,0.0,0.0,Matches,,,,,,,,,,,,,,,,,,,,,,,,,,,,,,,,,,,,,,,,,,,,,,,,,,,,,,,,464.0,es ESP,MFFW,26.0,1.0,0.0,0.0,0.0,2.0,4.0,0.0,4.0,1.0,2.0,0.0,0.0,0.0,5.0,2.0,3.0,40.0,Matches,464.0,es ESP,MFFW,26.0,1.0,45.0,42.0,3.0,3.0,1.0,0.0,4.0,0.0,0.0,0.0,0.0,0.0,34.0,0.0,1.0,Matches,464.0,es ESP,MFFW,26.0,1.0,34.0,45.0,75.6,481.0,128.0,20.0,24.0,83.3,8.0,13.0,61.5,3.0,4.0,75.0,0.0,0.1,0.2,-0.1,2.0,5.0,2.0,0.0,6.0,Matches,564,es ESP,MFFW,26,8,88.0,11.0,2.6,1.0,1,45.0,0,7,6.0,23,1.13,1.0,3.0,-2.0,-2.05,-1.88,0.8,3.1,-2.3,-2.37,-2.26,Matches,464.0,es ESP,MFFW,26.0,1.0,66.0,1.0,6.0,30.0,33.0,3.0,66.0,6.0,2.0,33.3,4.0,66.7,48.0,318.0,130.0,5.0,2.0,1.0,5.0,3.0,51.0,7.0,Matches,464.0,es ESP,MFFW,26.0,1.0,0.0,1.0,0.0,0.0,1.02,0.0,0.0,,20.9,0.0,0.0,0.0,0.0,0.0,0.04,0.0,0.0,Matches,464.0,es ESP,MFFW,26.0,8.0,1.0,88.0,1.0,0.0,0.0,0.0,0.0,0.0,0.0,0.0,0.0,0.0,0.0,0.1,0.1,5.0,6.0,7.0,0.0,0.0,0.0,0.0,0.0,0.04,0.1,0.14,0.04,0.14,Matches,José Pozo,AM/S RLC,26,122,144,Spain,Vallecano,5,13,13,12,13,6,9,12,2,2,14,11,5,14,9,12,8,11,9,12,10,8,16,10,13,5,10,11,14,14,11,6,13,14,12,9,8,7,17,9,6,3,1,2,3,3,2,2,4,2,2,1,14,17,4,11,14,11,16,17,1,1,1,1,1,1,1,12,15,1,20,20,15,19,172,69,9,20,1662281,6100,6100,4600,Mediterranean_Hispanic,107,6,1996/3/15,0,0,4790.0,,67174780
441,Arnau Puigmal,Almería,2001,469.0,es ESP,MFFW,21.0,8.5,22.0,14.0,10.0,7.0,5.0,12.0,17.0,70.6,5.0,7.0,0.0,7.0,11.0,33.0,6.0,0.0,Matches,469.0,es ESP,MFFW,21.0,8.5,26.0,3.05,20.0,1.0,1.0,0.0,2.0,2.0,1.0,0.12,1.0,0.0,0.0,0.0,0.0,0.0,Matches,,,,,,,,,,,,,,,,,,,,,,,,,,,,,,,,,,,,,,,,,,,,,,,,,,,,,,,,469.0,es ESP,MFFW,21.0,8.5,4.0,0.0,0.0,10.0,15.0,2.0,18.0,11.0,14.0,0.0,1.0,0.0,36.0,3.0,8.0,27.3,Matches,469.0,es ESP,MFFW,21.0,8.5,274.0,237.0,35.0,3.0,4.0,0.0,18.0,23.0,9.0,0.0,3.0,0.0,193.0,2.0,9.0,Matches,469.0,es ESP,MFFW,21.0,8.5,193.0,274.0,70.4,2779.0,909.0,117.0,138.0,84.8,64.0,94.0,68.1,9.0,23.0,39.1,0.0,0.5,0.8,-0.5,8.0,9.0,7.0,3.0,16.0,Matches,571,es ESP,MFFW,21,22,763.0,35.0,22.3,8.5,7,63.0,0,15,21.0,16,0.64,11.0,18.0,-7.0,-0.83,-0.52,9.4,15.8,-6.5,-0.76,-0.4,Matches,469.0,es ESP,MFFW,21.0,8.5,393.0,7.0,76.0,161.0,160.0,27.0,393.0,30.0,10.0,33.3,17.0,56.7,228.0,1385.0,691.0,24.0,11.0,9.0,28.0,8.0,243.0,57.0,Matches,469.0,es ESP,MFFW,21.0,8.5,1.0,17.0,6.0,35.3,2.01,0.71,0.06,0.17,18.1,0.0,0.0,0.0,1.1,1.1,0.07,-0.1,-0.1,Matches,469.0,es ESP,MFFW,21.0,22.0,7.0,763.0,8.5,1.0,0.0,1.0,1.0,0.0,0.0,4.0,0.0,1.1,1.1,0.5,1.7,24.0,16.0,57.0,0.12,0.0,0.12,0.12,0.12,0.13,0.06,0.19,0.13,0.19,Matches,Arnau Puigmal,M/AM RC,21,125,157,Spain,Almería,12,12,11,13,14,14,5,12,2,5,15,10,8,15,10,11,10,13,12,14,13,11,13,7,14,8,11,12,13,13,12,8,14,12,13,12,10,9,9,6,14,1,3,2,2,4,3,3,1,1,4,1,14,11,4,12,10,12,11,18,1,1,1,10,1,10,1,1,20,15,1,18,12,1,175,0,12,20,11309999,6244,6244,4794,Mediterranean_Hispanic,121,3,2001/1/10,0,0,6673.0,,28116557
442,Domingos Quina,Elche,1999,470.0,pt POR,MF,22.0,3.1,3.0,2.0,2.0,1.0,0.0,1.0,3.0,33.3,2.0,5.0,0.0,5.0,3.0,6.0,1.0,0.0,Matches,470.0,pt POR,MF,22.0,3.1,6.0,1.96,5.0,1.0,0.0,0.0,0.0,0.0,0.0,0.0,0.0,0.0,0.0,0.0,0.0,0.0,Matches,,,,,,,,,,,,,,,,,,,,,,,,,,,,,,,,,,,,,,,,,,,,,,,,,,,,,,,,470.0,pt POR,MF,22.0,3.1,3.0,1.0,1.0,5.0,11.0,0.0,6.0,3.0,2.0,0.0,0.0,0.0,27.0,0.0,1.0,0.0,Matches,470.0,pt POR,MF,22.0,3.1,147.0,137.0,9.0,4.0,2.0,0.0,6.0,4.0,1.0,0.0,0.0,0.0,122.0,1.0,3.0,Matches,470.0,pt POR,MF,22.0,3.1,122.0,147.0,83.0,2173.0,674.0,54.0,60.0,90.0,56.0,62.0,90.3,10.0,15.0,66.7,0.0,0.4,0.5,-0.4,3.0,16.0,4.0,1.0,17.0,Matches,572,pt POR,MF,22,10,275.0,28.0,8.0,3.1,2,73.0,1,8,16.0,3,0.3,2.0,8.0,-6.0,-1.96,-1.08,2.9,7.8,-4.9,-1.6,-0.8,Matches,470.0,pt POR,MF,22.0,3.1,191.0,6.0,39.0,104.0,53.0,4.0,191.0,10.0,5.0,50.0,3.0,30.0,139.0,1085.0,460.0,12.0,8.0,3.0,7.0,10.0,124.0,7.0,Matches,470.0,pt POR,MF,22.0,3.1,0.0,6.0,0.0,0.0,1.96,0.0,0.0,,33.0,0.0,0.0,0.0,0.2,0.2,0.03,-0.2,-0.2,Matches,470.0,pt POR,MF,22.0,10.0,2.0,275.0,3.1,0.0,0.0,0.0,0.0,0.0,0.0,3.0,1.0,0.2,0.2,0.4,0.6,12.0,17.0,7.0,0.0,0.0,0.0,0.0,0.0,0.07,0.14,0.21,0.07,0.21,Matches,Domingos Quina,M/AM RLC,22,114,140,"Portugal,Guinea-Bissau",Watford,11,12,13,11,13,9,7,12,4,7,13,10,11,13,12,12,8,13,9,12,11,10,16,8,12,6,11,7,13,14,12,5,14,14,13,7,9,5,11,8,11,3,2,3,2,3,3,4,2,1,1,3,12,18,13,5,10,9,9,11,1,1,1,1,1,1,1,12,16,10,17,20,16,5,173,68,12,20,6207878,5700,6000,4250,African_Caribbean,112,16,1999/11/18,0,0,5104.0,Elche,28108046
443,Chris Ramos,Cádiz,1997,476.0,es ESP,FW,25.0,7.9,12.0,9.0,2.0,7.0,3.0,4.0,11.0,36.4,7.0,8.0,3.0,5.0,1.0,13.0,19.0,0.0,Matches,476.0,es ESP,FW,25.0,7.9,12.0,1.52,8.0,0.0,1.0,1.0,2.0,0.0,0.0,0.0,0.0,0.0,0.0,0.0,0.0,0.0,Matches,,,,,,,,,,,,,,,,,,,,,,,,,,,,,,,,,,,,,,,,,,,,,,,,,,,,,,,,476.0,es ESP,FW,25.0,7.9,2.0,0.0,0.0,21.0,12.0,0.0,6.0,1.0,9.0,1.0,0.0,0.0,23.0,65.0,48.0,57.5,Matches,476.0,es ESP,FW,25.0,7.9,149.0,141.0,4.0,0.0,0.0,0.0,6.0,0.0,0.0,0.0,0.0,0.0,79.0,4.0,5.0,Matches,476.0,es ESP,FW,25.0,7.9,79.0,149.0,53.0,854.0,206.0,57.0,92.0,62.0,12.0,28.0,42.9,2.0,4.0,50.0,0.0,0.2,0.7,-0.2,4.0,7.0,1.0,1.0,6.0,Matches,583,es ESP,FW,25,15,710.0,47.0,20.8,7.9,7,77.0,3,8,21.0,2,1.07,6.0,10.0,-4.0,-0.51,0.12,13.0,12.7,0.2,0.03,0.71,Matches,476.0,es ESP,FW,25.0,7.9,276.0,21.0,41.0,95.0,141.0,56.0,276.0,22.0,8.0,36.4,11.0,50.0,110.0,481.0,191.0,9.0,3.0,4.0,24.0,3.0,175.0,35.0,Matches,476.0,es ESP,FW,25.0,7.9,1.0,31.0,6.0,19.4,3.93,0.76,0.03,0.17,13.3,0.0,0.0,0.0,3.0,3.0,0.1,-2.0,-2.0,Matches,476.0,es ESP,FW,25.0,15.0,7.0,710.0,7.9,1.0,0.0,1.0,1.0,0.0,0.0,2.0,0.0,3.0,3.0,0.2,3.2,9.0,6.0,35.0,0.13,0.0,0.13,0.13,0.13,0.38,0.03,0.41,0.38,0.41,Matches,Chris Ramos,AM/S RL,25,121,133,Spain,Lugo,7,9,12,11,11,8,10,9,6,5,10,10,6,12,5,11,12,11,11,13,11,4,12,10,14,7,11,12,16,13,12,16,14,15,11,11,13,5,16,7,11,1,3,2,2,3,3,2,2,1,3,3,7,12,4,8,12,11,11,14,1,1,1,1,1,1,1,1,1,1,19,1,16,20,193,0,9,20,1275467,5950,5950,3900,Mediterranean_Hispanic,113,8,1997/1/18,0,0,3778.0,,67264011
444,Sergio Reguilón,Atlético Madrid,1996,478.0,es ESP,DF,25.0,3.4,7.0,5.0,5.0,2.0,0.0,5.0,7.0,71.4,2.0,3.0,0.0,3.0,2.0,9.0,4.0,0.0,Matches,478.0,es ESP,DF,25.0,3.4,13.0,3.75,11.0,1.0,1.0,0.0,0.0,0.0,0.0,0.0,0.0,0.0,0.0,0.0,0.0,0.0,Matches,,,,,,,,,,,,,,,,,,,,,,,,,,,,,,,,,,,,,,,,,,,,,,,,,,,,,,,,478.0,es ESP,DF,25.0,3.4,3.0,1.0,1.0,4.0,6.0,1.0,9.0,2.0,5.0,0.0,0.0,0.0,15.0,8.0,5.0,61.5,Matches,478.0,es ESP,DF,25.0,3.4,147.0,131.0,15.0,1.0,1.0,0.0,9.0,14.0,0.0,0.0,0.0,0.0,117.0,1.0,7.0,Matches,478.0,es ESP,DF,25.0,3.4,117.0,147.0,79.6,1667.0,507.0,73.0,81.0,90.1,40.0,52.0,76.9,2.0,5.0,40.0,0.0,0.4,0.3,-0.4,7.0,10.0,3.0,1.0,11.0,Matches,586,es ESP,DF,25,11,309.0,28.0,9.0,3.4,2,76.0,0,9,17.0,10,1.36,5.0,2.0,3.0,0.87,-0.11,7.2,3.7,3.5,1.02,0.52,Matches,478.0,es ESP,DF,25.0,3.4,178.0,7.0,44.0,72.0,66.0,10.0,178.0,6.0,3.0,50.0,1.0,16.7,101.0,758.0,444.0,16.0,12.0,5.0,5.0,3.0,115.0,30.0,Matches,478.0,es ESP,DF,25.0,3.4,0.0,3.0,1.0,33.3,0.87,0.29,0.0,0.0,17.7,0.0,0.0,0.0,0.2,0.2,0.08,-0.2,-0.2,Matches,478.0,es ESP,DF,25.0,11.0,2.0,309.0,3.4,0.0,0.0,0.0,0.0,0.0,0.0,3.0,1.0,0.2,0.2,0.4,0.6,16.0,11.0,30.0,0.0,0.0,0.0,0.0,0.0,0.07,0.11,0.18,0.07,0.18,Matches,Sergio Reguilón,D/WB L,25,141,152,Spain,Tottenham Hotspur,10,12,12,10,13,9,11,11,13,13,12,12,14,13,15,14,14,13,12,13,14,15,12,12,15,13,15,16,15,14,13,8,15,15,15,12,13,8,14,8,13,2,2,2,3,2,1,1,3,2,2,2,13,14,7,12,11,13,9,11,1,20,8,1,17,1,1,14,1,1,12,1,1,1,176,64,20,7,27507440,7050,7500,6250,Mediterranean_Hispanic,140,2,1996/12/16,6,0,57996.0,A. Madrid,67211900
445,Reinier,Girona,2002,480.0,br BRA,MFFW,20.0,7.2,12.0,10.0,7.0,3.0,2.0,2.0,8.0,25.0,6.0,6.0,0.0,6.0,5.0,17.0,4.0,0.0,Matches,480.0,br BRA,MFFW,20.0,7.2,19.0,2.64,16.0,0.0,1.0,1.0,1.0,0.0,2.0,0.28,2.0,0.0,0.0,0.0,0.0,0.0,Matches,,,,,,,,,,,,,,,,,,,,,,,,,,,,,,,,,,,,,,,,,,,,,,,,,,,,,,,,480.0,br BRA,MFFW,20.0,7.2,1.0,1.0,0.0,4.0,15.0,2.0,2.0,5.0,10.0,0.0,0.0,0.0,29.0,6.0,12.0,33.3,Matches,480.0,br BRA,MFFW,20.0,7.2,248.0,241.0,6.0,2.0,1.0,1.0,2.0,1.0,0.0,0.0,0.0,0.0,198.0,1.0,8.0,Matches,480.0,br BRA,MFFW,20.0,7.2,198.0,248.0,79.8,2642.0,664.0,128.0,148.0,86.5,62.0,75.0,82.7,3.0,9.0,33.3,1.0,0.6,0.7,0.4,7.0,11.0,8.0,0.0,25.0,Matches,588,br BRA,MFFW,20,18,647.0,36.0,18.9,7.2,5,72.0,1,13,22.0,3,1.37,8.0,9.0,-1.0,-0.14,-0.27,7.4,11.3,-3.9,-0.54,-0.53,Matches,480.0,br BRA,MFFW,20.0,7.2,329.0,6.0,46.0,157.0,128.0,20.0,329.0,17.0,9.0,52.9,8.0,47.1,210.0,1139.0,490.0,13.0,18.0,1.0,19.0,19.0,258.0,27.0,Matches,480.0,br BRA,MFFW,20.0,7.2,2.0,10.0,4.0,40.0,1.39,0.56,0.2,0.5,11.6,0.0,0.0,0.0,1.5,1.5,0.15,0.5,0.5,Matches,480.0,br BRA,MFFW,20.0,18.0,5.0,647.0,7.2,2.0,1.0,3.0,2.0,0.0,0.0,1.0,1.0,1.5,1.5,0.6,2.0,13.0,25.0,27.0,0.28,0.14,0.42,0.28,0.42,0.2,0.08,0.28,0.2,0.28,Matches,Reinier,AM C,20,125,-85,Brazil,R. Madrid,10,12,15,12,15,11,12,12,3,7,15,7,7,16,10,13,12,12,12,14,11,9,15,10,12,9,13,13,13,13,13,12,15,13,12,13,8,6,5,5,18,1,2,3,1,1,2,2,1,1,1,2,8,11,5,12,10,9,11,14,1,1,1,1,1,1,1,1,12,1,1,20,1,1,185,82,8,20,66840001,6000,6250,4500,Mediterranean_Hispanic,125,3,2002/1/19,0,0,4458.0,Girona,19354888
446,Miguel Rodríguez,Celta Vigo,2003,497.0,es ESP,MFFW,19.0,2.8,7.0,5.0,4.0,3.0,0.0,4.0,11.0,36.4,7.0,6.0,0.0,6.0,1.0,8.0,3.0,0.0,Matches,497.0,es ESP,MFFW,19.0,2.8,7.0,2.5,7.0,0.0,0.0,0.0,0.0,0.0,2.0,0.71,2.0,0.0,0.0,0.0,0.0,0.0,Matches,,,,,,,,,,,,,,,,,,,,,,,,,,,,,,,,,,,,,,,,,,,,,,,,,,,,,,,,497.0,es ESP,MFFW,19.0,2.8,0.0,0.0,0.0,6.0,8.0,1.0,13.0,1.0,5.0,0.0,0.0,0.0,16.0,1.0,8.0,11.1,Matches,497.0,es ESP,MFFW,19.0,2.8,91.0,90.0,1.0,1.0,0.0,0.0,13.0,0.0,0.0,0.0,0.0,0.0,60.0,0.0,5.0,Matches,497.0,es ESP,MFFW,19.0,2.8,60.0,91.0,65.9,966.0,245.0,32.0,43.0,74.4,21.0,28.0,75.0,6.0,14.0,42.9,1.0,0.1,0.5,0.9,1.0,4.0,5.0,3.0,6.0,Matches,609,es ESP,MFFW,19,7,252.0,36.0,7.4,2.8,3,53.0,0,4,23.0,13,0.71,5.0,4.0,1.0,0.36,0.67,1.8,3.6,-1.8,-0.64,-0.61,Matches,497.0,es ESP,MFFW,19.0,2.8,132.0,2.0,25.0,46.0,64.0,13.0,132.0,13.0,3.0,23.1,6.0,46.2,89.0,520.0,298.0,10.0,6.0,4.0,6.0,4.0,89.0,22.0,Matches,497.0,es ESP,MFFW,19.0,2.8,1.0,3.0,2.0,66.7,1.07,0.71,0.33,0.5,18.8,0.0,0.0,0.0,0.2,0.2,0.07,0.8,0.8,Matches,497.0,es ESP,MFFW,19.0,7.0,3.0,252.0,2.8,1.0,1.0,2.0,1.0,0.0,0.0,0.0,0.0,0.2,0.2,0.1,0.3,10.0,6.0,22.0,0.36,0.36,0.71,0.36,0.71,0.07,0.05,0.12,0.07,0.12,Matches,Miguel Rodríguez,AM/S RL,19,114,-8,Spain,Vigo,10,6,13,13,12,11,6,13,8,9,7,8,7,12,14,14,11,9,12,11,12,14,13,3,13,6,8,14,14,13,13,11,13,12,10,8,13,6,9,11,12,1,3,1,3,2,3,3,3,1,1,2,19,11,6,12,10,9,12,19,1,1,1,1,1,1,1,12,1,14,18,1,20,20,179,0,20,12,58680001,5247,5247,2747,Mediterranean_Hispanic,103,4,2003/4/29,0,0,1833.0,,67279610
447,Iván Romero,Sevilla,2001,500.0,es ESP,MF,21.0,0.1,0.0,0.0,0.0,0.0,0.0,0.0,0.0,,0.0,0.0,0.0,0.0,0.0,0.0,0.0,0.0,Matches,500.0,es ESP,MF,21.0,0.1,0.0,0.0,0.0,0.0,0.0,0.0,0.0,0.0,0.0,0.0,0.0,0.0,0.0,0.0,0.0,0.0,Matches,,,,,,,,,,,,,,,,,,,,,,,,,,,,,,,,,,,,,,,,,,,,,,,,,,,,,,,,500.0,es ESP,MF,21.0,0.1,1.0,0.0,0.0,1.0,1.0,0.0,0.0,0.0,0.0,0.0,0.0,0.0,0.0,1.0,0.0,100.0,Matches,500.0,es ESP,MF,21.0,0.1,3.0,3.0,0.0,0.0,0.0,0.0,0.0,0.0,0.0,0.0,0.0,0.0,1.0,0.0,0.0,Matches,500.0,es ESP,MF,21.0,0.1,1.0,3.0,33.3,12.0,2.0,1.0,2.0,50.0,0.0,1.0,0.0,0.0,0.0,,0.0,0.0,0.0,0.0,0.0,0.0,0.0,0.0,0.0,Matches,615,es ESP,MF,21,1,11.0,11.0,0.3,0.1,0,,0,1,11.0,0,0.0,0.0,0.0,0.0,0.0,0.18,0.0,0.0,0.0,0.02,0.23,Matches,500.0,es ESP,MF,21.0,0.1,5.0,0.0,0.0,3.0,2.0,0.0,5.0,0.0,0.0,,0.0,,4.0,19.0,1.0,0.0,0.0,0.0,1.0,1.0,4.0,0.0,Matches,500.0,es ESP,MF,21.0,0.1,0.0,0.0,0.0,,0.0,0.0,,,,0.0,0.0,0.0,0.0,0.0,,0.0,0.0,Matches,500.0,es ESP,MF,21.0,1.0,0.0,11.0,0.1,0.0,0.0,0.0,0.0,0.0,0.0,1.0,0.0,0.0,0.0,0.0,0.0,0.0,0.0,0.0,0.0,0.0,0.0,0.0,0.0,0.0,0.0,0.0,0.0,0.0,Matches,Iván Romero,AM/S C,21,118,139,Spain,Sevilla,9,10,13,13,13,8,11,12,10,7,11,10,7,13,11,12,12,11,11,11,11,13,13,4,15,8,11,13,14,14,13,8,12,13,12,10,9,8,16,11,10,1,3,2,1,3,1,1,1,2,3,1,12,12,8,11,13,13,12,13,1,1,1,1,1,1,1,1,1,1,10,16,10,20,172,69,12,20,3029999,5899,5899,3549,Mediterranean_Hispanic,117,4,2001/4/10,0,0,4085.0,Tenerife,67295596
448,Rubén,Espanyol,2001,502.0,es ESP,DFMF,21.0,9.9,30.0,15.0,18.0,9.0,3.0,20.0,29.0,69.0,9.0,14.0,4.0,10.0,18.0,48.0,18.0,0.0,Matches,502.0,es ESP,DFMF,21.0,9.9,19.0,1.92,15.0,0.0,3.0,0.0,0.0,1.0,4.0,0.4,3.0,0.0,1.0,0.0,0.0,0.0,Matches,,,,,,,,,,,,,,,,,,,,,,,,,,,,,,,,,,,,,,,,,,,,,,,,,,,,,,,,502.0,es ESP,DFMF,21.0,9.9,1.0,0.0,0.0,18.0,7.0,0.0,48.0,18.0,15.0,0.0,0.0,0.0,64.0,15.0,4.0,78.9,Matches,502.0,es ESP,DFMF,21.0,9.9,339.0,286.0,52.0,5.0,2.0,2.0,48.0,47.0,0.0,0.0,0.0,0.0,232.0,1.0,9.0,Matches,502.0,es ESP,DFMF,21.0,9.9,232.0,339.0,68.4,3895.0,1166.0,119.0,138.0,86.2,81.0,117.0,69.2,25.0,61.0,41.0,2.0,1.5,0.9,0.5,7.0,12.0,7.0,3.0,14.0,Matches,617,es ESP,DFMF,21,18,888.0,49.0,26.0,9.9,9,73.0,2,9,26.0,5,0.56,10.0,25.0,-15.0,-1.52,-1.45,9.4,16.6,-7.2,-0.72,-0.57,Matches,502.0,es ESP,DFMF,21.0,9.9,473.0,24.0,130.0,195.0,160.0,21.0,473.0,24.0,12.0,50.0,10.0,41.7,224.0,1612.0,838.0,34.0,15.0,10.0,17.0,9.0,230.0,57.0,Matches,502.0,es ESP,DFMF,21.0,9.9,0.0,9.0,0.0,0.0,0.91,0.0,0.0,,19.1,0.0,0.0,0.0,0.5,0.5,0.06,-0.5,-0.5,Matches,502.0,es ESP,DFMF,21.0,18.0,9.0,888.0,9.9,0.0,2.0,2.0,0.0,0.0,0.0,1.0,0.0,0.5,0.5,1.5,2.0,34.0,14.0,57.0,0.0,0.2,0.2,0.0,0.2,0.05,0.15,0.2,0.05,0.2,Matches,Rubén,GK,38,120,135,Spain,,5,2,1,2,11,7,8,2,1,1,11,1,2,5,7,12,12,13,15,8,12,12,4,12,7,13,12,6,9,11,12,13,13,10,10,12,15,6,14,7,11,13,12,13,10,13,12,13,15,13,10,12,10,13,7,12,15,14,12,13,20,1,1,1,1,1,1,1,1,1,1,1,1,1,187,81,8,20,-1,6000,6720,5127,Mediterranean_Hispanic,120,6,1984/6/22,0,0,,,7451904
449,Víctor Ruiz,Betis,1989,505.0,es ESP,DF,33.0,6.2,5.0,3.0,3.0,2.0,0.0,3.0,3.0,100.0,0.0,10.0,7.0,3.0,6.0,11.0,34.0,0.0,Matches,505.0,es ESP,DF,33.0,6.2,4.0,0.64,4.0,0.0,0.0,0.0,0.0,0.0,0.0,0.0,0.0,0.0,0.0,0.0,0.0,0.0,Matches,,,,,,,,,,,,,,,,,,,,,,,,,,,,,,,,,,,,,,,,,,,,,,,,,,,,,,,,505.0,es ESP,DF,33.0,6.2,0.0,0.0,0.0,4.0,2.0,1.0,0.0,6.0,3.0,0.0,0.0,0.0,29.0,17.0,7.0,70.8,Matches,505.0,es ESP,DF,33.0,6.2,251.0,241.0,9.0,9.0,0.0,2.0,0.0,0.0,0.0,0.0,0.0,0.0,213.0,1.0,0.0,Matches,505.0,es ESP,DF,33.0,6.2,213.0,251.0,84.9,3911.0,1737.0,88.0,98.0,89.8,104.0,111.0,93.7,18.0,37.0,48.6,0.0,0.2,0.2,-0.2,2.0,11.0,0.0,0.0,10.0,Matches,620,es ESP,DF,33,10,560.0,56.0,16.4,6.2,5,90.0,5,5,22.0,14,2.0,8.0,8.0,0.0,0.0,-0.16,10.8,8.2,2.6,0.41,0.45,Matches,505.0,es ESP,DF,33.0,6.2,315.0,50.0,180.0,128.0,8.0,4.0,315.0,0.0,0.0,,0.0,,167.0,877.0,447.0,4.0,3.0,1.0,1.0,0.0,183.0,0.0,Matches,505.0,es ESP,DF,33.0,6.2,0.0,1.0,0.0,0.0,0.16,0.0,0.0,,8.6,0.0,0.0,0.0,0.1,0.1,0.11,-0.1,-0.1,Matches,505.0,es ESP,DF,33.0,10.0,5.0,560.0,6.2,0.0,0.0,0.0,0.0,0.0,0.0,0.0,0.0,0.1,0.1,0.2,0.3,4.0,10.0,0.0,0.0,0.0,0.0,0.0,0.0,0.02,0.03,0.05,0.02,0.05,Matches,Víctor Ruiz,D C,33,139,153,Spain,Real Hispalis,7,9,10,7,12,8,15,10,13,16,13,9,15,12,13,15,16,11,15,11,13,12,8,14,8,15,14,15,10,10,9,13,12,12,13,15,15,12,12,12,11,4,3,1,1,1,3,3,3,1,3,2,8,10,7,9,11,11,11,11,1,10,20,1,7,1,10,1,1,1,1,1,1,1,184,80,20,11,3789573,7150,7150,6000,Mediterranean_Hispanic,139,6,1989/1/25,0,0,27253.0,,67046591
450,Umar Sadiq,Almería,1997,509.0,ng NGA,FW,25.0,2.7,0.0,0.0,0.0,0.0,0.0,0.0,1.0,0.0,1.0,2.0,0.0,2.0,0.0,0.0,3.0,0.0,Matches,509.0,ng NGA,FW,25.0,2.7,6.0,2.25,4.0,0.0,1.0,0.0,1.0,0.0,0.0,0.0,0.0,0.0,0.0,0.0,0.0,0.0,Matches,,,,,,,,,,,,,,,,,,,,,,,,,,,,,,,,,,,,,,,,,,,,,,,,,,,,,,,,509.0,ng NGA,FW,25.0,2.7,1.0,0.0,0.0,9.0,2.0,7.0,0.0,0.0,0.0,0.0,0.0,0.0,8.0,4.0,10.0,28.6,Matches,509.0,ng NGA,FW,25.0,2.7,36.0,32.0,3.0,0.0,0.0,0.0,0.0,1.0,0.0,0.0,0.0,0.0,22.0,1.0,2.0,Matches,509.0,ng NGA,FW,25.0,2.7,22.0,36.0,61.1,254.0,34.0,11.0,15.0,73.3,8.0,11.0,72.7,0.0,0.0,,0.0,0.2,0.1,-0.2,3.0,0.0,1.0,0.0,2.0,Matches,625,ng NGA,FW,25,3,240.0,80.0,7.0,2.7,3,80.0,1,0,,0,1.33,4.0,3.0,1.0,0.37,0.86,3.3,4.0,-0.7,-0.25,0.22,Matches,509.0,ng NGA,FW,25.0,2.7,74.0,3.0,6.0,31.0,39.0,18.0,74.0,12.0,4.0,33.3,8.0,66.7,47.0,390.0,211.0,5.0,8.0,6.0,7.0,11.0,53.0,7.0,Matches,509.0,ng NGA,FW,25.0,2.7,2.0,7.0,3.0,42.9,2.62,1.13,0.29,0.67,14.5,0.0,0.0,0.0,1.5,1.5,0.21,0.5,0.5,Matches,509.0,ng NGA,FW,25.0,3.0,3.0,240.0,2.7,2.0,0.0,2.0,2.0,0.0,0.0,1.0,0.0,1.5,1.5,0.2,1.6,5.0,2.0,7.0,0.75,0.0,0.75,0.75,0.75,0.55,0.06,0.61,0.55,0.61,Matches,Umar Sadiq,S,25,142,159,Nigeria,Real San Sebastián,6,6,14,14,11,8,13,12,7,6,11,11,5,13,16,14,12,12,12,12,12,14,16,11,15,5,10,12,16,13,12,16,16,16,14,14,13,8,14,8,4,1,3,4,2,2,2,2,2,2,1,1,12,13,11,9,11,12,12,7,1,1,1,1,1,1,1,1,1,1,1,1,1,20,192,75,14,20,39711316,7000,6750,5750,African_Caribbean,140,16,1997/2/2,7,1,22683.0,,43195181
451,Kike Salas,Sevilla,2002,512.0,es ESP,DF,20.0,4.1,1.0,1.0,1.0,0.0,0.0,0.0,0.0,,0.0,4.0,3.0,1.0,5.0,6.0,23.0,0.0,Matches,512.0,es ESP,DF,20.0,4.1,1.0,0.24,0.0,0.0,0.0,1.0,0.0,0.0,1.0,0.24,0.0,0.0,0.0,1.0,0.0,0.0,Matches,,,,,,,,,,,,,,,,,,,,,,,,,,,,,,,,,,,,,,,,,,,,,,,,,,,,,,,,512.0,es ESP,DF,20.0,4.1,1.0,1.0,0.0,4.0,1.0,0.0,0.0,5.0,1.0,0.0,1.0,0.0,14.0,9.0,6.0,60.0,Matches,512.0,es ESP,DF,20.0,4.1,211.0,203.0,7.0,7.0,0.0,1.0,0.0,0.0,0.0,0.0,0.0,0.0,177.0,1.0,0.0,Matches,512.0,es ESP,DF,20.0,4.1,177.0,211.0,83.9,3258.0,1273.0,69.0,74.0,93.2,89.0,100.0,89.0,18.0,32.0,56.3,1.0,0.2,0.0,0.8,1.0,9.0,1.0,0.0,14.0,Matches,629,es ESP,DF,20,6,368.0,61.0,10.8,4.1,4,73.0,2,2,39.0,10,1.0,6.0,5.0,1.0,0.24,0.48,4.3,7.2,-2.9,-0.71,-0.56,Matches,512.0,es ESP,DF,20.0,4.1,255.0,39.0,133.0,112.0,10.0,3.0,255.0,0.0,0.0,,0.0,,149.0,530.0,227.0,3.0,1.0,0.0,2.0,1.0,177.0,0.0,Matches,512.0,es ESP,DF,20.0,4.1,1.0,3.0,1.0,33.3,0.73,0.24,0.33,1.0,8.7,0.0,0.0,0.0,0.2,0.2,0.05,0.8,0.8,Matches,512.0,es ESP,DF,20.0,6.0,4.0,368.0,4.1,1.0,1.0,2.0,1.0,0.0,0.0,1.0,1.0,0.2,0.2,0.2,0.4,3.0,14.0,0.0,0.24,0.24,0.49,0.24,0.49,0.04,0.05,0.09,0.04,0.09,Matches,Kike Salas,D C,20,117,-8,Spain,Sevilla,6,5,8,8,13,4,12,6,4,12,15,9,15,15,14,12,12,13,12,9,12,2,6,11,9,15,10,11,12,10,11,15,12,10,6,7,14,8,13,8,13,2,3,2,3,1,2,1,2,1,3,2,18,13,7,8,11,8,10,12,1,12,20,1,1,1,1,1,1,1,1,1,1,1,186,0,20,12,44670004,5850,5850,3376,Mediterranean_Hispanic,108,4,2002/4/23,0,0,3898.0,,2000165617
452,Esteban Saveljich,Rayo Vallecano,1991,520.0,me MNE,FW,31.0,0.0,0.0,0.0,0.0,0.0,0.0,0.0,0.0,,0.0,0.0,0.0,0.0,0.0,0.0,0.0,0.0,Matches,520.0,me MNE,FW,31.0,0.0,0.0,0.0,0.0,0.0,0.0,0.0,0.0,0.0,0.0,0.0,0.0,0.0,0.0,0.0,0.0,0.0,Matches,,,,,,,,,,,,,,,,,,,,,,,,,,,,,,,,,,,,,,,,,,,,,,,,,,,,,,,,520.0,me MNE,FW,31.0,0.0,1.0,0.0,0.0,0.0,0.0,0.0,0.0,0.0,0.0,0.0,0.0,0.0,0.0,0.0,0.0,,Matches,520.0,me MNE,FW,31.0,0.0,0.0,0.0,0.0,0.0,0.0,0.0,0.0,0.0,0.0,0.0,0.0,0.0,0.0,0.0,0.0,Matches,520.0,me MNE,FW,31.0,0.0,0.0,0.0,,0.0,0.0,0.0,0.0,,0.0,0.0,,0.0,0.0,,0.0,0.0,0.0,0.0,0.0,0.0,0.0,0.0,0.0,Matches,639,me MNE,FW,31,1,1.0,1.0,0.0,0.0,0,,0,1,1.0,28,1.5,0.0,4.0,-4.0,-360.0,-359.89,0.0,0.2,-0.2,-13.8,-13.63,Matches,520.0,me MNE,FW,31.0,0.0,0.0,0.0,0.0,0.0,0.0,0.0,0.0,0.0,0.0,,0.0,,0.0,0.0,0.0,0.0,0.0,0.0,0.0,0.0,0.0,0.0,Matches,520.0,me MNE,FW,31.0,0.0,0.0,0.0,0.0,,0.0,0.0,,,,0.0,0.0,0.0,0.0,0.0,,0.0,0.0,Matches,520.0,me MNE,FW,31.0,1.0,0.0,1.0,0.0,0.0,0.0,0.0,0.0,0.0,0.0,1.0,0.0,0.0,0.0,0.0,0.0,0.0,0.0,0.0,0.0,0.0,0.0,0.0,0.0,0.0,0.0,0.0,0.0,0.0,Matches,Esteban Saveljich,D C,31,123,132,"Montenegro,Argentina",Vallecano,4,5,6,5,9,5,13,5,7,14,11,6,13,10,11,13,15,12,14,6,13,12,5,16,7,14,14,13,12,11,12,13,12,13,15,15,11,14,12,8,5,3,1,3,3,4,3,2,1,1,1,3,14,13,6,7,10,15,15,9,1,1,20,1,1,1,1,1,1,1,1,1,1,1,187,82,7,20,1002318,6150,6150,4150,Northern_European,123,6,1991/5/20,4,0,5408.0,,14026358
453,Jaime Seoane,Getafe,1997,524.0,es ESP,MFFW,25.0,3.6,10.0,4.0,3.0,4.0,3.0,2.0,8.0,25.0,6.0,7.0,3.0,4.0,1.0,11.0,2.0,0.0,Matches,524.0,es ESP,MFFW,25.0,3.6,10.0,2.76,7.0,1.0,0.0,0.0,1.0,1.0,0.0,0.0,0.0,0.0,0.0,0.0,0.0,0.0,Matches,,,,,,,,,,,,,,,,,,,,,,,,,,,,,,,,,,,,,,,,,,,,,,,,,,,,,,,,524.0,es ESP,MFFW,25.0,3.6,1.0,0.0,0.0,6.0,4.0,0.0,2.0,1.0,4.0,0.0,0.0,0.0,17.0,2.0,5.0,28.6,Matches,524.0,es ESP,MFFW,25.0,3.6,112.0,107.0,4.0,4.0,1.0,3.0,2.0,0.0,0.0,0.0,0.0,0.0,87.0,1.0,1.0,Matches,524.0,es ESP,MFFW,25.0,3.6,87.0,112.0,77.7,1488.0,456.0,40.0,50.0,80.0,28.0,34.0,82.4,11.0,17.0,64.7,0.0,0.3,0.3,-0.3,6.0,7.0,1.0,0.0,7.0,Matches,643,es ESP,MFFW,25,16,326.0,20.0,9.5,3.6,2,59.0,0,14,15.0,22,1.13,2.0,8.0,-6.0,-1.66,-1.51,2.9,5.2,-2.3,-0.64,-0.44,Matches,524.0,es ESP,MFFW,25.0,3.6,155.0,4.0,26.0,82.0,47.0,2.0,155.0,5.0,2.0,40.0,3.0,60.0,84.0,434.0,208.0,6.0,3.0,1.0,4.0,6.0,94.0,7.0,Matches,524.0,es ESP,MFFW,25.0,3.6,0.0,2.0,0.0,0.0,0.55,0.0,0.0,,21.7,0.0,0.0,0.0,0.1,0.1,0.04,-0.1,-0.1,Matches,524.0,es ESP,MFFW,25.0,16.0,2.0,326.0,3.6,0.0,0.0,0.0,0.0,0.0,0.0,1.0,0.0,0.1,0.1,0.3,0.4,6.0,7.0,7.0,0.0,0.0,0.0,0.0,0.0,0.02,0.08,0.1,0.02,0.1,Matches,Jaime Seoane,M C,25,139,150,Spain,Getafe,8,11,14,10,15,10,10,12,9,11,15,12,10,15,8,14,12,13,14,15,15,14,15,15,11,15,11,15,12,12,10,7,12,13,15,10,11,8,13,5,14,4,2,3,3,2,3,3,2,1,3,3,12,15,5,12,14,14,14,12,1,1,1,1,1,1,15,1,20,1,1,15,1,1,175,73,12,20,4135917,6500,6500,4750,Mediterranean_Hispanic,138,6,1997/1/22,0,0,10070.0,,67220012
454,Simo,Espanyol,2005,527.0,es ESP,DF,17.0,1.6,3.0,1.0,3.0,0.0,0.0,2.0,3.0,66.7,1.0,5.0,4.0,1.0,0.0,3.0,3.0,0.0,Matches,527.0,es ESP,DF,17.0,1.6,1.0,0.6,1.0,0.0,0.0,0.0,0.0,0.0,1.0,0.6,1.0,0.0,0.0,0.0,0.0,0.0,Matches,,,,,,,,,,,,,,,,,,,,,,,,,,,,,,,,,,,,,,,,,,,,,,,,,,,,,,,,527.0,es ESP,DF,17.0,1.6,0.0,0.0,0.0,2.0,0.0,0.0,0.0,0.0,1.0,0.0,1.0,0.0,6.0,2.0,4.0,33.3,Matches,527.0,es ESP,DF,17.0,1.6,61.0,57.0,4.0,1.0,0.0,0.0,0.0,1.0,0.0,0.0,0.0,0.0,58.0,0.0,1.0,Matches,527.0,es ESP,DF,17.0,1.6,58.0,61.0,95.1,998.0,384.0,31.0,32.0,96.9,21.0,21.0,100.0,6.0,7.0,85.7,0.0,0.0,0.0,0.0,0.0,11.0,0.0,0.0,11.0,Matches,646,es ESP,DF,17,7,148.0,21.0,4.3,1.6,0,,0,7,21.0,15,1.43,5.0,6.0,-1.0,-0.61,-0.17,1.8,4.4,-2.6,-1.58,-1.33,Matches,527.0,es ESP,DF,17.0,1.6,79.0,14.0,32.0,46.0,2.0,0.0,79.0,0.0,0.0,,0.0,,46.0,241.0,143.0,2.0,0.0,0.0,0.0,2.0,47.0,1.0,Matches,527.0,es ESP,DF,17.0,1.6,0.0,0.0,0.0,,0.0,0.0,,,,0.0,0.0,0.0,0.0,0.0,,0.0,0.0,Matches,527.0,es ESP,DF,17.0,7.0,0.0,148.0,1.6,0.0,0.0,0.0,0.0,0.0,0.0,0.0,0.0,0.0,0.0,0.0,0.0,2.0,11.0,1.0,0.0,0.0,0.0,0.0,0.0,0.0,0.0,0.0,0.0,0.0,Matches,Simo,M/AM RL,22,115,135,"Morocco,Spain",Córdoba,10,13,14,10,12,8,7,8,7,5,12,8,9,12,12,11,13,11,12,11,12,15,14,12,13,7,12,15,14,13,12,8,14,13,12,8,14,12,16,5,12,1,1,3,3,2,2,3,2,2,2,1,13,12,10,12,12,13,12,7,1,1,1,1,1,1,1,17,1,12,20,14,15,10,171,0,7,20,680250,5750,5750,3250,Mediterranean_Hispanic,112,4,1999/11/16,0,0,3222.0,,2000107738
455,Augusto Solari,Celta Vigo,1992,531.0,ar ARG,MF,30.0,2.9,10.0,6.0,6.0,3.0,1.0,3.0,11.0,27.3,8.0,5.0,0.0,5.0,4.0,14.0,3.0,0.0,Matches,531.0,ar ARG,MF,30.0,2.9,6.0,2.05,6.0,0.0,0.0,0.0,0.0,0.0,2.0,0.68,2.0,0.0,0.0,0.0,0.0,0.0,Matches,,,,,,,,,,,,,,,,,,,,,,,,,,,,,,,,,,,,,,,,,,,,,,,,,,,,,,,,531.0,ar ARG,MF,30.0,2.9,0.0,0.0,0.0,9.0,4.0,0.0,3.0,4.0,6.0,0.0,0.0,0.0,18.0,4.0,3.0,57.1,Matches,531.0,ar ARG,MF,30.0,2.9,125.0,122.0,1.0,0.0,0.0,0.0,3.0,1.0,0.0,0.0,0.0,0.0,94.0,2.0,4.0,Matches,531.0,ar ARG,MF,30.0,2.9,94.0,125.0,75.2,1364.0,362.0,53.0,60.0,88.3,33.0,40.0,82.5,5.0,13.0,38.5,1.0,0.2,0.3,0.8,4.0,9.0,2.0,0.0,12.0,Matches,651,ar ARG,MF,30,12,262.0,22.0,7.7,2.9,3,48.0,0,9,13.0,19,1.92,5.0,3.0,2.0,0.69,1.03,3.3,2.3,1.0,0.36,0.47,Matches,531.0,ar ARG,MF,30.0,2.9,160.0,1.0,28.0,88.0,45.0,6.0,160.0,5.0,1.0,20.0,3.0,60.0,88.0,337.0,155.0,5.0,2.0,1.0,2.0,4.0,105.0,14.0,Matches,531.0,ar ARG,MF,30.0,2.9,0.0,2.0,0.0,0.0,0.69,0.0,0.0,,14.4,0.0,0.0,0.0,0.3,0.3,0.14,-0.3,-0.3,Matches,531.0,ar ARG,MF,30.0,12.0,3.0,262.0,2.9,0.0,1.0,1.0,0.0,0.0,0.0,0.0,0.0,0.3,0.3,0.2,0.5,5.0,12.0,14.0,0.0,0.34,0.34,0.0,0.34,0.09,0.07,0.16,0.09,0.16,Matches,Augusto Solari,M/AM R,30,130,132,"Argentina,Italy",Vigo,12,13,13,10,13,11,6,12,12,8,12,11,9,14,7,12,7,12,9,15,11,9,13,9,13,10,14,14,14,15,9,10,13,14,13,9,12,12,9,5,10,1,1,1,2,4,1,3,1,4,2,2,12,11,2,14,8,14,16,14,1,1,1,13,1,15,1,5,14,20,1,1,17,1,180,80,11,20,1917563,6250,6250,4300,Mediterranean_Hispanic,125,8,1992/1/3,0,0,10067.0,,14023373
456,Carlos Soler,Valencia,1997,532.0,es ESP,MF,25.0,2.7,2.0,0.0,0.0,1.0,1.0,2.0,3.0,66.7,1.0,1.0,0.0,1.0,0.0,2.0,2.0,0.0,Matches,532.0,es ESP,MF,25.0,2.7,6.0,2.23,5.0,1.0,0.0,0.0,0.0,0.0,0.0,0.0,0.0,0.0,0.0,0.0,0.0,0.0,Matches,,,,,,,,,,,,,,,,,,,,,,,,,,,,,,,,,,,,,,,,,,,,,,,,,,,,,,,,532.0,es ESP,MF,25.0,2.7,0.0,0.0,0.0,2.0,4.0,0.0,16.0,0.0,0.0,0.0,0.0,0.0,4.0,1.0,1.0,50.0,Matches,532.0,es ESP,MF,25.0,2.7,123.0,102.0,21.0,9.0,0.0,1.0,16.0,0.0,11.0,5.0,5.0,0.0,92.0,0.0,3.0,Matches,532.0,es ESP,MF,25.0,2.7,92.0,123.0,74.8,1388.0,378.0,52.0,59.0,88.1,23.0,28.0,82.1,9.0,24.0,37.5,0.0,0.2,0.2,-0.2,4.0,5.0,4.0,0.0,13.0,Matches,652,es ESP,MF,25,3,242.0,81.0,7.1,2.7,3,81.0,2,0,,0,1.0,1.0,2.0,-1.0,-0.37,-0.32,2.7,2.6,0.1,0.03,-0.14,Matches,532.0,es ESP,MF,25.0,2.7,143.0,2.0,13.0,62.0,68.0,4.0,142.0,2.0,1.0,50.0,0.0,0.0,83.0,508.0,223.0,3.0,4.0,0.0,2.0,1.0,98.0,7.0,Matches,532.0,es ESP,MF,25.0,2.7,1.0,4.0,1.0,25.0,1.49,0.37,0.0,0.0,30.0,3.0,1.0,1.0,0.9,0.2,0.04,0.1,-0.2,Matches,532.0,es ESP,MF,25.0,3.0,3.0,242.0,2.7,1.0,0.0,1.0,0.0,1.0,1.0,0.0,0.0,0.9,0.2,0.2,0.4,3.0,13.0,7.0,0.37,0.0,0.37,0.0,0.0,0.35,0.08,0.43,0.06,0.14,Matches,Carlos Soler,WB/DM/M/AM RC,25,155,163,Spain,Paris Saint-Germain,13,15,13,13,14,12,12,15,9,10,15,16,10,14,13,15,12,13,13,14,14,15,14,15,14,12,13,14,14,13,13,10,14,14,14,13,14,11,14,8,15,2,3,3,1,2,3,2,1,3,3,2,12,14,4,18,14,16,13,12,1,1,1,1,1,16,16,14,20,20,13,19,19,1,180,76,10,20,40747461,7750,7750,6250,Mediterranean_Hispanic,145,1,1997/1/2,9,3,108102.0,,67196204
457,Dyego Sousa,Almería,1989,535.0,pt POR,FW,32.0,5.9,10.0,6.0,5.0,4.0,1.0,4.0,5.0,80.0,1.0,4.0,2.0,2.0,1.0,11.0,14.0,0.0,Matches,535.0,pt POR,FW,32.0,5.9,14.0,2.39,11.0,0.0,2.0,1.0,0.0,0.0,1.0,0.17,1.0,0.0,0.0,0.0,0.0,0.0,Matches,,,,,,,,,,,,,,,,,,,,,,,,,,,,,,,,,,,,,,,,,,,,,,,,,,,,,,,,535.0,pt POR,FW,32.0,5.9,1.0,0.0,0.0,10.0,12.0,4.0,1.0,1.0,6.0,0.0,0.0,0.0,17.0,27.0,25.0,51.9,Matches,535.0,pt POR,FW,32.0,5.9,160.0,150.0,9.0,0.0,1.0,0.0,1.0,1.0,0.0,0.0,0.0,0.0,107.0,1.0,7.0,Matches,535.0,pt POR,FW,32.0,5.9,107.0,160.0,66.9,1396.0,361.0,60.0,83.0,72.3,38.0,52.0,73.1,2.0,6.0,33.3,1.0,1.0,0.9,0.0,10.0,4.0,5.0,0.0,16.0,Matches,656,pt POR,FW,32,20,527.0,26.0,15.4,5.9,3,65.0,0,17,20.0,14,0.7,4.0,6.0,-2.0,-0.34,0.09,7.7,9.6,-1.9,-0.33,0.14,Matches,535.0,pt POR,FW,32.0,5.9,256.0,16.0,34.0,110.0,114.0,35.0,256.0,13.0,5.0,38.5,7.0,53.8,131.0,611.0,214.0,10.0,8.0,4.0,28.0,11.0,190.0,39.0,Matches,535.0,pt POR,FW,32.0,5.9,0.0,13.0,4.0,30.8,2.22,0.68,0.0,0.0,14.2,0.0,0.0,0.0,1.2,1.2,0.09,-1.2,-1.2,Matches,535.0,pt POR,FW,32.0,20.0,3.0,527.0,5.9,0.0,1.0,1.0,0.0,0.0,0.0,1.0,0.0,1.2,1.2,1.0,2.2,10.0,16.0,39.0,0.0,0.17,0.17,0.0,0.17,0.2,0.17,0.37,0.2,0.37,Matches,Dyego Sousa,S,32,125,142,"Portugal,Brazil",Almería,4,7,11,14,11,8,16,11,5,5,11,13,8,11,15,12,15,13,13,13,12,14,8,10,12,8,13,13,11,10,15,16,15,12,13,16,12,14,11,5,5,1,2,1,3,4,1,3,1,3,1,3,12,15,14,10,11,16,8,8,1,1,1,1,1,1,1,1,1,1,10,7,7,20,190,85,12,20,1307705,6250,6500,4800,African_Caribbean,123,15,1989/9/14,2,0,6673.0,,19102543
458,Mario Suárez,Rayo Vallecano,1987,541.0,es ESP,MFDF,35.0,0.1,0.0,0.0,0.0,0.0,0.0,0.0,0.0,,0.0,1.0,0.0,1.0,0.0,0.0,0.0,0.0,Matches,541.0,es ESP,MFDF,35.0,0.1,0.0,0.0,0.0,0.0,0.0,0.0,0.0,0.0,0.0,0.0,0.0,0.0,0.0,0.0,0.0,0.0,Matches,,,,,,,,,,,,,,,,,,,,,,,,,,,,,,,,,,,,,,,,,,,,,,,,,,,,,,,,541.0,es ESP,MFDF,35.0,0.1,0.0,1.0,0.0,0.0,0.0,0.0,0.0,0.0,0.0,0.0,0.0,0.0,0.0,0.0,1.0,0.0,Matches,541.0,es ESP,MFDF,35.0,0.1,3.0,3.0,0.0,0.0,0.0,0.0,0.0,0.0,0.0,0.0,0.0,0.0,2.0,0.0,0.0,Matches,541.0,es ESP,MFDF,35.0,0.1,2.0,3.0,66.7,28.0,6.0,1.0,1.0,100.0,1.0,2.0,50.0,0.0,0.0,,0.0,0.0,0.0,0.0,0.0,0.0,0.0,0.0,0.0,Matches,663,es ESP,MFDF,35,2,12.0,6.0,0.4,0.1,0,,0,2,6.0,31,1.0,1.0,3.0,-2.0,-15.0,-14.84,0.1,0.7,-0.7,-4.96,-4.81,Matches,541.0,es ESP,MFDF,35.0,0.1,4.0,0.0,1.0,3.0,0.0,0.0,4.0,0.0,0.0,,0.0,,2.0,28.0,21.0,0.0,0.0,0.0,0.0,0.0,2.0,0.0,Matches,541.0,es ESP,MFDF,35.0,0.1,0.0,0.0,0.0,,0.0,0.0,,,,0.0,0.0,0.0,0.0,0.0,,0.0,0.0,Matches,541.0,es ESP,MFDF,35.0,2.0,0.0,12.0,0.1,0.0,0.0,0.0,0.0,0.0,0.0,0.0,1.0,0.0,0.0,0.0,0.0,0.0,0.0,0.0,0.0,0.0,0.0,0.0,0.0,0.0,0.0,0.0,0.0,0.0,Matches,Mario Suárez,D/DM/M C,35,123,148,Spain,Vallecano,9,9,10,10,14,9,12,14,7,12,14,2,13,13,12,13,14,15,13,12,13,10,11,9,11,14,15,12,10,10,14,13,14,10,11,14,13,14,14,7,12,2,3,3,3,3,3,3,2,1,1,2,10,12,8,15,10,14,12,14,1,1,17,1,1,1,20,1,19,1,1,1,1,1,185,77,12,20,136360,6150,6150,4150,Mediterranean_Hispanic,122,6,1987/2/24,3,0,5408.0,,7458309
459,Williot Swedberg,Celta Vigo,2004,543.0,se SWE,MF,18.0,0.6,3.0,1.0,1.0,0.0,2.0,0.0,0.0,,0.0,2.0,0.0,2.0,0.0,3.0,1.0,0.0,Matches,543.0,se SWE,MF,18.0,0.6,1.0,1.64,1.0,0.0,0.0,0.0,0.0,0.0,0.0,0.0,0.0,0.0,0.0,0.0,0.0,0.0,Matches,,,,,,,,,,,,,,,,,,,,,,,,,,,,,,,,,,,,,,,,,,,,,,,,,,,,,,,,543.0,se SWE,MF,18.0,0.6,1.0,0.0,0.0,1.0,1.0,0.0,0.0,0.0,1.0,0.0,0.0,0.0,2.0,0.0,0.0,,Matches,543.0,se SWE,MF,18.0,0.6,17.0,16.0,1.0,1.0,0.0,0.0,0.0,0.0,0.0,0.0,0.0,0.0,14.0,0.0,0.0,Matches,543.0,se SWE,MF,18.0,0.6,14.0,17.0,82.4,176.0,50.0,8.0,10.0,80.0,4.0,5.0,80.0,0.0,0.0,,0.0,0.0,0.1,0.0,0.0,1.0,2.0,0.0,4.0,Matches,666,se SWE,MF,18,4,55.0,14.0,1.6,0.6,0,,0,4,14.0,34,0.25,0.0,0.0,0.0,0.0,0.27,0.7,0.2,0.5,0.83,0.92,Matches,543.0,se SWE,MF,18.0,0.6,27.0,2.0,5.0,12.0,11.0,1.0,27.0,2.0,1.0,50.0,1.0,50.0,16.0,91.0,66.0,1.0,2.0,0.0,1.0,0.0,15.0,5.0,Matches,543.0,se SWE,MF,18.0,0.6,0.0,0.0,0.0,,0.0,0.0,,,,0.0,0.0,0.0,0.0,0.0,,0.0,0.0,Matches,543.0,se SWE,MF,18.0,4.0,0.0,55.0,0.6,0.0,0.0,0.0,0.0,0.0,0.0,1.0,0.0,0.0,0.0,0.0,0.0,1.0,4.0,5.0,0.0,0.0,0.0,0.0,0.0,0.0,0.0,0.0,0.0,0.0,Matches,Williot Swedberg,M RLC,18,114,-85,Sweden,Vigo,8,12,12,11,13,9,8,9,6,11,12,11,8,13,8,13,12,13,13,12,12,14,12,8,13,12,10,10,11,12,10,12,12,12,12,8,13,9,6,5,14,1,3,2,2,3,2,2,2,2,2,1,14,13,1,18,15,15,16,18,1,1,1,1,1,1,14,14,20,14,15,15,15,15,185,67,12,20,54900000,5700,5700,3004,Northern_European,107,4,2004/2/1,0,0,3068.0,,2000008568
460,Ramón Terrats,Villarreal,2000,549.0,es ESP,MF,21.0,9.1,15.0,10.0,3.0,8.0,4.0,9.0,17.0,52.9,8.0,11.0,4.0,7.0,8.0,23.0,6.0,2.0,Matches,549.0,es ESP,MF,21.0,9.1,20.0,2.21,13.0,2.0,2.0,0.0,2.0,1.0,1.0,0.11,1.0,0.0,0.0,0.0,0.0,0.0,Matches,,,,,,,,,,,,,,,,,,,,,,,,,,,,,,,,,,,,,,,,,,,,,,,,,,,,,,,,549.0,es ESP,MF,21.0,9.1,1.0,0.0,0.0,14.0,18.0,0.0,16.0,8.0,10.0,0.0,0.0,0.0,43.0,6.0,7.0,46.2,Matches,549.0,es ESP,MF,21.0,9.1,425.0,399.0,21.0,5.0,3.0,6.0,16.0,3.0,13.0,7.0,0.0,0.0,356.0,5.0,7.0,Matches,549.0,es ESP,MF,21.0,9.1,356.0,425.0,83.8,5550.0,1343.0,207.0,222.0,93.2,108.0,131.0,82.4,33.0,50.0,66.0,1.0,1.5,1.1,-0.5,10.0,30.0,9.0,1.0,45.0,Matches,673,es ESP,MF,21,16,816.0,51.0,23.9,9.1,11,65.0,0,5,21.0,2,2.0,10.0,9.0,1.0,0.11,-0.51,13.7,11.8,2.0,0.22,-0.12,Matches,549.0,es ESP,MF,21.0,9.1,528.0,18.0,95.0,284.0,151.0,16.0,528.0,29.0,15.0,51.7,13.0,44.8,330.0,1561.0,826.0,21.0,12.0,2.0,23.0,11.0,399.0,32.0,Matches,549.0,es ESP,MF,21.0,9.1,1.0,15.0,6.0,40.0,1.65,0.66,0.07,0.17,24.3,0.0,0.0,0.0,0.9,0.9,0.06,0.1,0.1,Matches,549.0,es ESP,MF,21.0,16.0,11.0,816.0,9.1,1.0,1.0,2.0,1.0,0.0,0.0,1.0,0.0,0.9,0.9,1.5,2.4,21.0,45.0,32.0,0.11,0.11,0.22,0.11,0.22,0.1,0.16,0.26,0.1,0.26,Matches,Ramón Terrats,M C,21,113,145,Spain,Girona,13,12,12,8,15,12,9,8,5,7,13,7,10,15,8,12,8,10,11,14,13,14,13,13,12,10,13,12,12,12,11,10,10,11,13,11,11,6,19,10,12,3,4,1,1,1,1,2,3,1,2,3,15,13,4,12,12,12,11,10,1,1,1,1,1,1,15,14,20,10,1,1,1,1,181,0,20,8,3807999,5650,5650,3150,Mediterranean_Hispanic,111,4,2000/10/18,0,0,2973.0,,2000063225
461,Pablo Torre,Barcelona,2003,552.0,es ESP,FWMF,19.0,1.6,2.0,1.0,0.0,1.0,1.0,2.0,4.0,50.0,2.0,1.0,0.0,1.0,2.0,4.0,1.0,0.0,Matches,552.0,es ESP,FWMF,19.0,1.6,8.0,5.03,6.0,2.0,0.0,0.0,0.0,0.0,1.0,0.63,1.0,0.0,0.0,0.0,0.0,0.0,Matches,,,,,,,,,,,,,,,,,,,,,,,,,,,,,,,,,,,,,,,,,,,,,,,,,,,,,,,,552.0,es ESP,FWMF,19.0,1.6,0.0,0.0,0.0,4.0,3.0,0.0,8.0,2.0,1.0,0.0,0.0,0.0,9.0,1.0,1.0,50.0,Matches,552.0,es ESP,FWMF,19.0,1.6,98.0,87.0,9.0,3.0,2.0,0.0,8.0,0.0,6.0,1.0,4.0,0.0,77.0,2.0,1.0,Matches,552.0,es ESP,FWMF,19.0,1.6,77.0,98.0,78.6,1026.0,294.0,54.0,62.0,87.1,16.0,19.0,84.2,5.0,12.0,41.7,0.0,0.5,0.4,-0.5,4.0,9.0,3.0,0.0,11.0,Matches,676,es ESP,FWMF,19,8,144.0,18.0,4.2,1.6,1,62.0,0,7,12.0,23,0.88,3.0,2.0,1.0,0.62,-0.72,3.3,2.7,0.6,0.38,-0.77,Matches,552.0,es ESP,FWMF,19.0,1.6,114.0,3.0,12.0,49.0,55.0,1.0,114.0,7.0,3.0,42.9,2.0,28.6,69.0,313.0,162.0,4.0,6.0,0.0,5.0,4.0,87.0,16.0,Matches,552.0,es ESP,FWMF,19.0,1.6,0.0,1.0,0.0,0.0,0.62,0.0,0.0,,25.9,0.0,0.0,0.0,0.0,0.0,0.02,0.0,0.0,Matches,552.0,es ESP,FWMF,19.0,8.0,1.0,144.0,1.6,0.0,0.0,0.0,0.0,0.0,0.0,0.0,0.0,0.0,0.0,0.5,0.5,4.0,11.0,16.0,0.0,0.0,0.0,0.0,0.0,0.02,0.3,0.31,0.02,0.31,Matches,Pablo Torre,M/AM C,19,125,-85,Spain,Barcelona,14,11,13,11,15,14,6,11,6,5,16,14,9,16,12,10,14,11,10,16,14,14,16,11,12,5,11,10,12,15,12,7,13,11,10,9,14,6,15,5,8,3,2,3,3,2,4,3,3,2,1,1,13,12,6,20,14,16,15,16,1,1,1,1,1,1,8,12,18,8,14,20,10,10,173,57,12,20,55160000,6250,6250,4251,Mediterranean_Hispanic,122,6,2003/4/3,0,0,3989.0,,2000040347
462,Roberto Torres,Osasuna,1989,557.0,es ESP,FWMF,33.0,0.1,0.0,0.0,0.0,0.0,0.0,0.0,0.0,,0.0,0.0,0.0,0.0,0.0,0.0,0.0,0.0,Matches,557.0,es ESP,FWMF,33.0,0.1,2.0,16.36,1.0,1.0,0.0,0.0,0.0,0.0,0.0,0.0,0.0,0.0,0.0,0.0,0.0,0.0,Matches,,,,,,,,,,,,,,,,,,,,,,,,,,,,,,,,,,,,,,,,,,,,,,,,,,,,,,,,557.0,es ESP,FWMF,33.0,0.1,0.0,0.0,0.0,0.0,0.0,0.0,2.0,0.0,0.0,0.0,0.0,0.0,1.0,0.0,0.0,,Matches,557.0,es ESP,FWMF,33.0,0.1,13.0,12.0,1.0,1.0,0.0,1.0,2.0,0.0,0.0,0.0,0.0,0.0,12.0,0.0,0.0,Matches,557.0,es ESP,FWMF,33.0,0.1,12.0,13.0,92.3,223.0,50.0,5.0,5.0,100.0,2.0,3.0,66.7,3.0,3.0,100.0,0.0,0.3,0.2,-0.3,2.0,0.0,0.0,0.0,0.0,Matches,681,es ESP,FWMF,33,2,11.0,6.0,0.3,0.1,0,,0,2,6.0,13,3.0,0.0,0.0,0.0,0.0,0.13,0.6,0.1,0.5,4.22,4.39,Matches,557.0,es ESP,FWMF,33.0,0.1,14.0,0.0,1.0,6.0,8.0,0.0,14.0,2.0,1.0,50.0,1.0,50.0,12.0,107.0,78.0,2.0,3.0,0.0,0.0,1.0,12.0,1.0,Matches,557.0,es ESP,FWMF,33.0,0.1,0.0,0.0,0.0,,0.0,0.0,,,,0.0,0.0,0.0,0.0,0.0,,0.0,0.0,Matches,557.0,es ESP,FWMF,33.0,2.0,0.0,11.0,0.1,0.0,0.0,0.0,0.0,0.0,0.0,0.0,0.0,0.0,0.0,0.3,0.3,2.0,0.0,1.0,0.0,0.0,0.0,0.0,0.0,0.0,2.13,2.13,0.0,2.13,Matches,Roberto Torres,M/AM RLC,33,136,145,"Spain,Pays Basque",Atlético Pamplona,16,15,11,12,15,16,7,15,7,7,16,17,7,16,13,12,13,14,14,15,14,15,16,14,11,11,15,14,11,12,12,10,13,11,12,11,15,6,13,6,6,1,2,1,3,3,1,2,3,2,2,1,19,14,13,10,9,11,12,19,1,1,1,1,1,1,1,13,16,15,15,20,20,1,176,69,12,20,2762183,7000,7000,4750,Mediterranean_Hispanic,134,6,1989/3/7,0,0,19847.0,,67044635
463,Manu Trigueros,Villarreal,1991,561.0,es ESP,MF,30.0,9.2,20.0,14.0,9.0,5.0,6.0,9.0,22.0,40.9,13.0,9.0,2.0,7.0,5.0,25.0,4.0,0.0,Matches,561.0,es ESP,MF,30.0,9.2,17.0,1.85,16.0,0.0,0.0,0.0,1.0,0.0,2.0,0.22,2.0,0.0,0.0,0.0,0.0,0.0,Matches,,,,,,,,,,,,,,,,,,,,,,,,,,,,,,,,,,,,,,,,,,,,,,,,,,,,,,,,561.0,es ESP,MF,30.0,9.2,2.0,1.0,0.0,13.0,10.0,1.0,4.0,5.0,14.0,0.0,0.0,0.0,33.0,6.0,13.0,31.6,Matches,561.0,es ESP,MF,30.0,9.2,534.0,519.0,14.0,10.0,1.0,1.0,4.0,2.0,2.0,1.0,0.0,0.0,475.0,1.0,7.0,Matches,561.0,es ESP,MF,30.0,9.2,475.0,534.0,89.0,6910.0,1993.0,270.0,288.0,93.8,155.0,175.0,88.6,25.0,35.0,71.4,1.0,1.1,0.7,-0.1,10.0,69.0,12.0,1.0,76.0,Matches,685,es ESP,MF,30,23,828.0,36.0,24.2,9.2,8,64.0,2,15,21.0,7,1.87,17.0,8.0,9.0,0.98,0.63,13.9,14.6,-0.7,-0.08,-0.51,Matches,561.0,es ESP,MF,30.0,9.2,599.0,14.0,76.0,354.0,173.0,7.0,599.0,5.0,2.0,40.0,3.0,60.0,368.0,1430.0,637.0,12.0,10.0,0.0,7.0,9.0,487.0,22.0,Matches,561.0,es ESP,MF,30.0,9.2,0.0,8.0,2.0,25.0,0.87,0.22,0.0,0.0,24.4,1.0,0.0,0.0,0.4,0.4,0.05,-0.4,-0.4,Matches,561.0,es ESP,MF,30.0,23.0,8.0,828.0,9.2,0.0,1.0,1.0,0.0,0.0,0.0,2.0,1.0,0.4,0.4,1.1,1.5,12.0,76.0,22.0,0.0,0.11,0.11,0.0,0.11,0.04,0.12,0.16,0.04,0.16,Matches,Manu Trigueros,M C,30,143,153,Spain,Villarreal,15,12,14,11,16,14,8,13,6,8,16,13,9,16,13,14,12,16,13,15,15,13,13,10,14,11,14,14,11,16,11,9,14,12,14,8,11,9,10,5,10,1,1,3,4,3,3,3,2,1,3,4,8,12,6,14,15,14,13,13,1,1,1,1,1,1,9,1,20,1,1,14,1,1,178,75,12,20,13417649,7150,7150,4800,Mediterranean_Hispanic,143,6,1991/10/17,0,0,29508.0,,67142545
464,Beñat Turrientes,Real Sociedad,2002,563.0,es ESP,MFFW,20.0,1.2,3.0,3.0,3.0,0.0,0.0,1.0,5.0,20.0,4.0,2.0,0.0,2.0,0.0,3.0,3.0,0.0,Matches,563.0,es ESP,MFFW,20.0,1.2,4.0,3.4,3.0,1.0,0.0,0.0,0.0,0.0,0.0,0.0,0.0,0.0,0.0,0.0,0.0,0.0,Matches,,,,,,,,,,,,,,,,,,,,,,,,,,,,,,,,,,,,,,,,,,,,,,,,,,,,,,,,563.0,es ESP,MFFW,20.0,1.2,0.0,0.0,0.0,2.0,1.0,0.0,4.0,0.0,3.0,0.0,0.0,0.0,7.0,0.0,2.0,0.0,Matches,563.0,es ESP,MFFW,20.0,1.2,47.0,40.0,7.0,4.0,0.0,2.0,4.0,0.0,3.0,2.0,1.0,0.0,40.0,0.0,0.0,Matches,563.0,es ESP,MFFW,20.0,1.2,40.0,47.0,85.1,707.0,113.0,20.0,23.0,87.0,14.0,14.0,100.0,5.0,9.0,55.6,0.0,0.2,0.0,-0.2,2.0,3.0,0.0,0.0,2.0,Matches,687,es ESP,MFFW,20,6,106.0,18.0,3.1,1.2,1,45.0,0,5,12.0,26,1.5,1.0,2.0,-1.0,-0.85,-1.31,0.9,2.3,-1.4,-1.17,-1.75,Matches,563.0,es ESP,MFFW,20.0,1.2,61.0,3.0,17.0,29.0,15.0,0.0,61.0,3.0,1.0,33.3,1.0,33.3,30.0,113.0,51.0,0.0,0.0,0.0,4.0,2.0,34.0,4.0,Matches,563.0,es ESP,MFFW,20.0,1.2,0.0,0.0,0.0,,0.0,0.0,,,,0.0,0.0,0.0,0.0,0.0,,0.0,0.0,Matches,563.0,es ESP,MFFW,20.0,6.0,1.0,106.0,1.2,0.0,0.0,0.0,0.0,0.0,0.0,0.0,0.0,0.0,0.0,0.2,0.2,0.0,2.0,4.0,0.0,0.0,0.0,0.0,0.0,0.0,0.13,0.13,0.0,0.13,Matches,Beñat Turrientes,DM/M C,20,125,152,"Spain,Pays Basque",Real San Sebastián,9,5,11,12,13,10,10,10,7,12,14,9,15,14,15,14,10,12,12,12,12,10,5,10,15,13,14,14,15,12,8,5,13,14,15,10,13,13,14,8,12,2,3,3,3,2,1,3,3,3,2,2,18,12,1,10,12,11,9,13,1,1,1,1,1,1,20,1,16,1,1,1,1,1,179,73,14,20,19424997,6250,6250,3900,Mediterranean_Hispanic,130,3,2002/1/31,0,0,7742.0,,67276474
465,Jesús Vallejo,Real Madrid,1997,568.0,es ESP,DF,25.0,0.2,0.0,0.0,0.0,0.0,0.0,0.0,0.0,,0.0,0.0,0.0,0.0,0.0,0.0,0.0,0.0,Matches,568.0,es ESP,DF,25.0,0.2,0.0,0.0,0.0,0.0,0.0,0.0,0.0,0.0,0.0,0.0,0.0,0.0,0.0,0.0,0.0,0.0,Matches,,,,,,,,,,,,,,,,,,,,,,,,,,,,,,,,,,,,,,,,,,,,,,,,,,,,,,,,568.0,es ESP,DF,25.0,0.2,0.0,0.0,0.0,0.0,0.0,0.0,0.0,0.0,0.0,0.0,0.0,0.0,1.0,0.0,0.0,,Matches,568.0,es ESP,DF,25.0,0.2,12.0,12.0,0.0,0.0,0.0,0.0,0.0,0.0,0.0,0.0,0.0,0.0,12.0,0.0,0.0,Matches,568.0,es ESP,DF,25.0,0.2,12.0,12.0,100.0,224.0,80.0,4.0,4.0,100.0,6.0,6.0,100.0,1.0,1.0,100.0,0.0,0.0,0.0,0.0,0.0,1.0,0.0,0.0,0.0,Matches,693,es ESP,DF,25,1,22.0,22.0,0.6,0.2,0,,0,1,22.0,35,3.0,2.0,0.0,2.0,8.18,7.2,1.2,0.1,1.1,4.47,3.53,Matches,568.0,es ESP,DF,25.0,0.2,14.0,4.0,9.0,3.0,2.0,2.0,14.0,0.0,0.0,,0.0,,10.0,27.0,13.0,0.0,0.0,0.0,0.0,0.0,11.0,0.0,Matches,568.0,es ESP,DF,25.0,0.2,0.0,1.0,1.0,100.0,4.09,4.09,0.0,0.0,5.7,0.0,0.0,0.0,0.3,0.3,0.32,-0.3,-0.3,Matches,568.0,es ESP,DF,25.0,1.0,0.0,22.0,0.2,0.0,0.0,0.0,0.0,0.0,0.0,0.0,0.0,0.3,0.3,0.0,0.3,0.0,0.0,0.0,0.0,0.0,0.0,0.0,0.0,1.29,0.0,1.29,1.29,1.29,Matches,Jesús Vallejo,D C,25,134,150,Spain,R. Madrid,5,8,9,7,12,6,12,8,9,15,12,9,16,13,14,17,13,15,12,12,14,14,7,14,8,14,16,10,11,12,11,13,15,13,12,12,16,11,15,15,10,2,3,1,1,3,1,2,1,2,2,3,12,9,4,12,15,14,16,18,1,1,20,13,1,8,11,1,1,1,1,1,1,1,184,79,9,20,3918239,6700,6700,5750,Mediterranean_Hispanic,132,7,1997/1/5,0,0,38461.0,,67192921
466,Manu Vallejo,Girona,1997,569.0,es ESP,FWMF,25.0,2.3,4.0,1.0,1.0,2.0,1.0,1.0,6.0,16.7,5.0,2.0,0.0,2.0,1.0,5.0,3.0,0.0,Matches,569.0,es ESP,FWMF,25.0,2.3,10.0,4.37,6.0,0.0,0.0,1.0,3.0,0.0,4.0,1.75,1.0,0.0,0.0,0.0,3.0,0.0,Matches,,,,,,,,,,,,,,,,,,,,,,,,,,,,,,,,,,,,,,,,,,,,,,,,,,,,,,,,569.0,es ESP,FWMF,25.0,2.3,0.0,0.0,0.0,1.0,6.0,1.0,7.0,1.0,1.0,2.0,0.0,0.0,8.0,0.0,5.0,0.0,Matches,569.0,es ESP,FWMF,25.0,2.3,89.0,87.0,1.0,0.0,1.0,0.0,7.0,0.0,0.0,0.0,0.0,0.0,68.0,1.0,2.0,Matches,569.0,es ESP,FWMF,25.0,2.3,68.0,89.0,76.4,1029.0,232.0,41.0,50.0,82.0,22.0,29.0,75.9,4.0,5.0,80.0,1.0,0.3,0.3,0.7,3.0,8.0,3.0,1.0,10.0,Matches,694,es ESP,FWMF,25,7,206.0,29.0,6.0,2.3,2,54.0,0,5,20.0,8,0.86,8.0,5.0,3.0,1.31,1.31,5.7,2.5,3.2,1.42,1.63,Matches,569.0,es ESP,FWMF,25.0,2.3,110.0,1.0,12.0,45.0,54.0,8.0,110.0,4.0,1.0,25.0,3.0,75.0,67.0,341.0,209.0,7.0,4.0,2.0,3.0,4.0,85.0,25.0,Matches,569.0,es ESP,FWMF,25.0,2.3,0.0,1.0,1.0,100.0,0.44,0.44,0.0,0.0,12.6,0.0,0.0,0.0,0.0,0.0,0.04,0.0,0.0,Matches,569.0,es ESP,FWMF,25.0,7.0,2.0,206.0,2.3,0.0,1.0,1.0,0.0,0.0,0.0,0.0,0.0,0.0,0.0,0.3,0.3,7.0,10.0,25.0,0.0,0.44,0.44,0.0,0.44,0.02,0.12,0.14,0.02,0.14,Matches,Manu Vallejo,AM/S RLC,25,136,145,Spain,Girona,12,11,12,14,12,11,9,12,12,7,12,14,7,13,10,14,13,10,12,12,12,15,13,10,14,12,11,13,15,14,14,6,9,13,12,12,12,7,3,5,12,1,1,2,1,1,2,1,1,2,3,3,10,12,6,14,12,14,15,12,1,1,1,1,1,1,1,15,1,14,20,17,15,19,167,72,12,20,7618798,6750,6750,4850,Mediterranean_Hispanic,127,5,1997/2/14,0,0,14585.0,,67227127
467,Gonzalo Verdú,Elche,1988,576.0,es ESP,DF,33.0,7.8,10.0,5.0,8.0,2.0,0.0,4.0,8.0,50.0,4.0,8.0,6.0,2.0,10.0,20.0,33.0,0.0,Matches,576.0,es ESP,DF,33.0,7.8,3.0,0.38,2.0,0.0,0.0,0.0,0.0,1.0,0.0,0.0,0.0,0.0,0.0,0.0,0.0,0.0,Matches,,,,,,,,,,,,,,,,,,,,,,,,,,,,,,,,,,,,,,,,,,,,,,,,,,,,,,,,576.0,es ESP,DF,33.0,7.8,1.0,2.0,0.0,10.0,5.0,0.0,0.0,10.0,5.0,0.0,0.0,1.0,33.0,28.0,15.0,65.1,Matches,576.0,es ESP,DF,33.0,7.8,338.0,317.0,21.0,21.0,0.0,0.0,0.0,0.0,0.0,0.0,0.0,0.0,269.0,0.0,1.0,Matches,576.0,es ESP,DF,33.0,7.8,269.0,338.0,79.6,5668.0,1965.0,65.0,75.0,86.7,172.0,186.0,92.5,31.0,70.0,44.3,0.0,0.0,0.1,0.0,0.0,8.0,0.0,0.0,13.0,Matches,702,es ESP,DF,33,16,703.0,44.0,20.6,7.8,9,65.0,3,7,17.0,15,0.88,4.0,12.0,-8.0,-1.02,-0.06,5.1,11.8,-6.6,-0.85,0.01,Matches,576.0,es ESP,DF,33.0,7.8,418.0,62.0,238.0,167.0,16.0,12.0,418.0,0.0,0.0,,0.0,,223.0,1075.0,488.0,0.0,1.0,0.0,3.0,0.0,251.0,0.0,Matches,576.0,es ESP,DF,33.0,7.8,1.0,9.0,2.0,22.2,1.15,0.26,0.11,0.5,12.2,1.0,0.0,0.0,0.6,0.6,0.07,0.4,0.4,Matches,576.0,es ESP,DF,33.0,16.0,9.0,703.0,7.8,1.0,0.0,1.0,1.0,0.0,0.0,1.0,2.0,0.6,0.6,0.0,0.6,0.0,13.0,0.0,0.13,0.0,0.13,0.13,0.13,0.08,0.0,0.08,0.08,0.08,Matches,Gonzalo Verdú,D C,33,132,135,Spain,Elche,4,6,6,7,9,16,15,6,6,16,11,6,15,6,6,13,15,11,14,8,14,12,12,14,13,15,13,14,11,12,13,13,13,12,15,16,16,6,13,3,6,2,3,4,1,1,1,2,4,3,3,2,14,11,5,18,11,17,16,12,1,1,20,1,1,1,15,1,12,1,1,1,1,1,185,80,5,20,772150,6500,6500,4500,Mediterranean_Hispanic,134,8,1988/10/21,0,0,9724.0,,67093485
468,Toni Villa,Valladolid,1995,580.0,es ESP,MF,27.0,1.0,6.0,3.0,2.0,3.0,1.0,4.0,9.0,44.4,5.0,0.0,0.0,0.0,0.0,6.0,0.0,0.0,Matches,580.0,es ESP,MF,27.0,1.0,4.0,3.96,3.0,0.0,1.0,0.0,0.0,0.0,0.0,0.0,0.0,0.0,0.0,0.0,0.0,0.0,Matches,,,,,,,,,,,,,,,,,,,,,,,,,,,,,,,,,,,,,,,,,,,,,,,,,,,,,,,,580.0,es ESP,MF,27.0,1.0,0.0,0.0,0.0,0.0,1.0,1.0,5.0,0.0,3.0,0.0,0.0,0.0,6.0,0.0,0.0,,Matches,580.0,es ESP,MF,27.0,1.0,32.0,31.0,1.0,0.0,0.0,0.0,5.0,0.0,1.0,1.0,0.0,0.0,20.0,0.0,2.0,Matches,580.0,es ESP,MF,27.0,1.0,20.0,32.0,62.5,258.0,109.0,13.0,16.0,81.3,5.0,8.0,62.5,1.0,3.0,33.3,0.0,0.0,0.0,0.0,1.0,2.0,0.0,0.0,4.0,Matches,708,es ESP,MF,27,2,91.0,46.0,2.7,1.0,1,61.0,0,1,30.0,1,0.0,0.0,3.0,-3.0,-2.97,-2.24,0.9,2.5,-1.6,-1.57,-0.89,Matches,580.0,es ESP,MF,27.0,1.0,45.0,0.0,7.0,17.0,22.0,1.0,45.0,5.0,1.0,20.0,3.0,60.0,27.0,126.0,56.0,2.0,2.0,0.0,1.0,1.0,27.0,5.0,Matches,580.0,es ESP,MF,27.0,1.0,0.0,0.0,0.0,,0.0,0.0,,,,0.0,0.0,0.0,0.0,0.0,,0.0,0.0,Matches,580.0,es ESP,MF,27.0,2.0,1.0,91.0,1.0,0.0,0.0,0.0,0.0,0.0,0.0,0.0,0.0,0.0,0.0,0.0,0.0,2.0,4.0,5.0,0.0,0.0,0.0,0.0,0.0,0.0,0.02,0.02,0.0,0.02,Matches,Toni Villa,M/AM RLC,27,125,132,Spain,Girona,7,12,14,13,13,6,5,9,5,4,14,6,5,15,7,13,13,9,11,15,12,13,13,6,14,7,9,11,15,15,15,5,13,14,11,7,12,6,10,8,14,2,1,2,3,2,3,2,3,1,1,3,15,10,2,9,12,11,12,11,1,1,1,1,10,8,1,18,1,16,20,19,18,10,171,63,20,11,2374688,6250,6250,3900,Mediterranean_Hispanic,119,5,1995/1/7,0,0,6639.0,,67215621
469,Asier Villalibre,Athletic Club,1997,582.0,es ESP,FW,24.0,1.1,0.0,0.0,0.0,0.0,0.0,0.0,0.0,,0.0,0.0,0.0,0.0,0.0,0.0,1.0,0.0,Matches,582.0,es ESP,FW,24.0,1.1,3.0,2.73,3.0,0.0,0.0,0.0,0.0,0.0,0.0,0.0,0.0,0.0,0.0,0.0,0.0,0.0,Matches,,,,,,,,,,,,,,,,,,,,,,,,,,,,,,,,,,,,,,,,,,,,,,,,,,,,,,,,582.0,es ESP,FW,24.0,1.1,0.0,0.0,0.0,3.0,1.0,0.0,0.0,0.0,0.0,0.0,0.0,0.0,2.0,2.0,2.0,50.0,Matches,582.0,es ESP,FW,24.0,1.1,18.0,18.0,0.0,0.0,0.0,0.0,0.0,0.0,0.0,0.0,0.0,0.0,11.0,0.0,0.0,Matches,582.0,es ESP,FW,24.0,1.1,11.0,18.0,61.1,163.0,39.0,6.0,9.0,66.7,5.0,6.0,83.3,0.0,0.0,,0.0,0.2,0.0,-0.2,2.0,1.0,1.0,0.0,2.0,Matches,711,es ESP,FW,24,5,97.0,19.0,2.8,1.1,1,56.0,0,4,10.0,13,1.6,2.0,0.0,2.0,1.86,1.8,3.0,0.7,2.3,2.14,1.73,Matches,582.0,es ESP,FW,24.0,1.1,27.0,1.0,1.0,7.0,19.0,7.0,27.0,0.0,0.0,,0.0,,14.0,48.0,14.0,0.0,0.0,0.0,0.0,2.0,22.0,9.0,Matches,582.0,es ESP,FW,24.0,1.1,0.0,4.0,1.0,25.0,3.71,0.93,0.0,0.0,11.6,0.0,0.0,0.0,0.3,0.3,0.08,-0.3,-0.3,Matches,582.0,es ESP,FW,24.0,5.0,1.0,97.0,1.1,0.0,0.0,0.0,0.0,0.0,0.0,0.0,0.0,0.3,0.3,0.2,0.5,0.0,2.0,9.0,0.0,0.0,0.0,0.0,0.0,0.29,0.19,0.47,0.29,0.47,Matches,Asier Villalibre,S,24,128,142,"Spain,Pays Basque",A. Bilbao,7,11,11,13,12,8,14,12,7,7,11,16,8,12,13,13,14,12,13,11,12,15,13,14,14,13,13,16,12,12,12,12,12,13,14,15,13,12,14,12,11,3,3,1,4,1,3,4,3,2,4,2,17,13,7,10,12,12,10,17,1,1,1,1,1,1,1,1,1,1,10,1,10,20,184,87,20,11,8746774,6400,6400,4900,Mediterranean_Hispanic,128,4,1997/9/30,0,0,9770.0,,67195730
470,Gonzalo Villar,Getafe,1998,583.0,es ESP,MF,24.0,5.1,10.0,5.0,1.0,6.0,3.0,6.0,14.0,42.9,8.0,9.0,2.0,7.0,6.0,16.0,5.0,0.0,Matches,583.0,es ESP,MF,24.0,5.1,6.0,1.18,5.0,0.0,0.0,1.0,0.0,0.0,0.0,0.0,0.0,0.0,0.0,0.0,0.0,0.0,Matches,,,,,,,,,,,,,,,,,,,,,,,,,,,,,,,,,,,,,,,,,,,,,,,,,,,,,,,,583.0,es ESP,MF,24.0,5.1,5.0,0.0,0.0,20.0,12.0,0.0,6.0,6.0,5.0,0.0,0.0,0.0,50.0,7.0,7.0,50.0,Matches,583.0,es ESP,MF,24.0,5.1,258.0,241.0,17.0,11.0,0.0,1.0,6.0,4.0,2.0,2.0,0.0,0.0,205.0,0.0,6.0,Matches,583.0,es ESP,MF,24.0,5.1,205.0,258.0,79.5,3259.0,927.0,97.0,111.0,87.4,84.0,109.0,77.1,15.0,21.0,71.4,0.0,0.3,0.4,-0.3,3.0,26.0,5.0,1.0,27.0,Matches,712,es ESP,MF,24,16,457.0,29.0,13.4,5.1,3,60.0,0,13,21.0,5,0.88,4.0,5.0,-1.0,-0.2,0.11,6.7,7.8,-1.1,-0.21,0.04,Matches,583.0,es ESP,MF,24.0,5.1,312.0,8.0,48.0,209.0,62.0,5.0,312.0,20.0,13.0,65.0,4.0,20.0,176.0,1206.0,608.0,13.0,10.0,2.0,9.0,6.0,184.0,9.0,Matches,583.0,es ESP,MF,24.0,5.1,0.0,3.0,1.0,33.3,0.59,0.2,0.0,0.0,19.7,0.0,0.0,0.0,0.1,0.1,0.04,-0.1,-0.1,Matches,583.0,es ESP,MF,24.0,16.0,3.0,457.0,5.1,0.0,0.0,0.0,0.0,0.0,0.0,5.0,0.0,0.1,0.1,0.3,0.4,13.0,27.0,9.0,0.0,0.0,0.0,0.0,0.0,0.02,0.06,0.08,0.02,0.08,Matches,Gonzalo Villar,M C,24,130,143,Spain,Associazione Sportiva Roma,11,4,15,7,16,8,8,10,8,8,16,8,11,15,7,12,15,15,13,12,14,13,13,5,10,10,13,13,12,15,15,11,13,12,13,11,10,12,10,6,11,4,3,3,4,4,1,1,1,1,1,2,13,15,3,11,10,15,18,10,1,1,1,1,1,1,15,1,20,1,1,12,1,1,181,73,11,20,1824987,6500,6350,5650,Mediterranean_Hispanic,127,7,1998/3/23,1,0,35076.0,U.C. Sampdoria,67219031
471,Shon Weissman,Valladolid,1996,586.0,il ISR,FW,26.0,8.3,2.0,1.0,1.0,1.0,0.0,0.0,4.0,0.0,4.0,8.0,0.0,8.0,1.0,3.0,7.0,0.0,Matches,586.0,il ISR,FW,26.0,8.3,4.0,0.48,4.0,0.0,0.0,0.0,0.0,0.0,0.0,0.0,0.0,0.0,0.0,0.0,0.0,0.0,Matches,,,,,,,,,,,,,,,,,,,,,,,,,,,,,,,,,,,,,,,,,,,,,,,,,,,,,,,,586.0,il ISR,FW,26.0,8.3,1.0,0.0,0.0,5.0,8.0,7.0,2.0,1.0,1.0,0.0,0.0,0.0,24.0,4.0,23.0,14.8,Matches,586.0,il ISR,FW,26.0,8.3,91.0,74.0,17.0,0.0,0.0,0.0,2.0,0.0,0.0,0.0,0.0,0.0,70.0,0.0,2.0,Matches,586.0,il ISR,FW,26.0,8.3,70.0,91.0,76.9,749.0,113.0,52.0,61.0,85.2,12.0,16.0,75.0,1.0,3.0,33.3,0.0,0.2,0.4,-0.2,3.0,3.0,0.0,0.0,4.0,Matches,717,il ISR,FW,26,15,747.0,50.0,21.8,8.3,6,74.0,1,9,34.0,1,1.07,5.0,13.0,-8.0,-0.96,-0.22,6.0,14.9,-8.9,-1.07,-0.47,Matches,586.0,il ISR,FW,26.0,8.3,160.0,6.0,19.0,86.0,57.0,25.0,160.0,5.0,2.0,40.0,2.0,40.0,76.0,283.0,104.0,7.0,2.0,3.0,22.0,7.0,91.0,15.0,Matches,586.0,il ISR,FW,26.0,8.3,1.0,18.0,7.0,38.9,2.17,0.84,0.06,0.14,12.8,0.0,0.0,0.0,2.3,2.3,0.13,-1.3,-1.3,Matches,586.0,il ISR,FW,26.0,15.0,6.0,747.0,8.3,1.0,0.0,1.0,1.0,0.0,0.0,1.0,0.0,2.3,2.3,0.2,2.5,7.0,4.0,15.0,0.12,0.0,0.12,0.12,0.12,0.28,0.02,0.3,0.28,0.3,Matches,Shon Weissman,AM/S RL,26,131,136,"Israel,Portugal",Valladolid,5,9,11,14,11,6,13,10,7,6,11,9,10,13,14,13,14,12,13,13,13,15,12,14,15,10,14,15,13,13,13,8,16,12,14,14,17,5,14,11,12,2,1,1,2,1,2,1,3,2,3,3,14,14,8,16,10,13,11,10,1,1,1,1,1,1,1,12,9,14,16,13,16,20,174,72,14,20,5006638,6550,6550,5300,Northern_European,127,8,1996/2/14,23,3,10690.0,,42058078
472,Axel Werner,Elche,1996,587.0,ar ARG,GK,26.0,2.0,0.0,0.0,0.0,0.0,0.0,0.0,1.0,0.0,1.0,0.0,0.0,0.0,0.0,0.0,0.0,0.0,Matches,587.0,ar ARG,GK,26.0,2.0,0.0,0.0,0.0,0.0,0.0,0.0,0.0,0.0,0.0,0.0,0.0,0.0,0.0,0.0,0.0,0.0,Matches,44.0,ar ARG,GK,26.0,2.0,4.0,0.0,0.0,2.0,0.0,2.4,0.31,-1.6,-0.82,4.0,20.0,20.0,53.0,9.0,32.1,34.9,16.0,18.8,33.8,26.0,1.0,3.8,1.0,0.5,14.0,Matches,44.0,ar ARG,GK,26.0,2.0,2.0,180.0,2.0,4.0,2.0,8.0,4.0,50.0,0.0,0.0,2.0,0.0,0.0,0.0,0.0,0.0,0.0,,Matches,587.0,ar ARG,GK,26.0,2.0,0.0,0.0,0.0,0.0,0.0,0.0,0.0,0.0,0.0,0.0,0.0,0.0,0.0,0.0,0.0,,Matches,587.0,ar ARG,GK,26.0,2.0,70.0,50.0,19.0,3.0,0.0,0.0,0.0,0.0,0.0,0.0,0.0,0.0,52.0,1.0,0.0,Matches,587.0,ar ARG,GK,26.0,2.0,52.0,70.0,74.3,1421.0,813.0,4.0,4.0,100.0,34.0,35.0,97.1,14.0,30.0,46.7,0.0,0.0,0.0,0.0,0.0,1.0,0.0,0.0,0.0,Matches,718,ar ARG,GK,26,2,180.0,90.0,5.3,2.0,2,90.0,2,0,,36,0.0,1.0,4.0,-3.0,-1.5,-0.56,1.7,3.0,-1.3,-0.66,0.21,Matches,587.0,ar ARG,GK,26.0,2.0,74.0,57.0,72.0,2.0,0.0,0.0,74.0,1.0,1.0,100.0,0.0,0.0,38.0,194.0,125.0,0.0,0.0,0.0,0.0,0.0,37.0,0.0,Matches,587.0,ar ARG,GK,26.0,2.0,0.0,0.0,0.0,,0.0,0.0,,,,0.0,0.0,0.0,0.0,0.0,,0.0,0.0,Matches,587.0,ar ARG,GK,26.0,2.0,2.0,180.0,2.0,0.0,0.0,0.0,0.0,0.0,0.0,0.0,0.0,0.0,0.0,0.0,0.0,0.0,0.0,0.0,0.0,0.0,0.0,0.0,0.0,0.0,0.0,0.0,0.0,0.0,Matches,Axel Werner,GK,26,120,124,"Argentina,Italy",Elche,5,2,2,3,7,7,5,3,3,3,6,6,3,10,10,11,15,15,11,10,11,12,3,6,3,14,15,11,8,15,14,17,12,8,13,15,12,15,12,7,15,14,12,10,5,13,9,11,16,10,13,14,16,14,4,10,12,11,14,10,20,1,1,1,1,1,1,1,1,1,1,1,1,1,192,86,7,20,672827,6000,5280,4022,Northern_European,119,4,1996/2/28,0,0,3567.0,,14063557
473,Matthis Abline,Auxerre,2003,5.0,fr FRA,FWMF,19.0,9.0,4.0,2.0,0.0,3.0,1.0,0.0,5.0,0.0,5.0,6.0,1.0,5.0,1.0,5.0,1.0,0.0,Matches,5.0,fr FRA,FWMF,19.0,9.0,15.0,1.67,8.0,0.0,5.0,0.0,2.0,0.0,3.0,0.33,1.0,0.0,1.0,0.0,1.0,0.0,Matches,,,,,,,,,,,,,,,,,,,,,,,,,,,,,,,,,,,,,,,,,,,,,,,,,,,,,,,,5.0,fr FRA,FWMF,19.0,9.0,1.0,0.0,0.0,14.0,10.0,5.0,6.0,1.0,2.0,1.0,0.0,0.0,13.0,12.0,30.0,28.6,Matches,5.0,fr FRA,FWMF,19.0,9.0,105.0,91.0,13.0,0.0,0.0,2.0,6.0,0.0,0.0,0.0,0.0,0.0,69.0,1.0,3.0,Matches,5.0,fr FRA,FWMF,19.0,9.0,69.0,105.0,65.7,1187.0,235.0,24.0,36.0,66.7,35.0,44.0,79.5,5.0,11.0,45.5,1.0,0.7,0.3,0.3,5.0,7.0,3.0,1.0,8.0,Matches,5,fr FRA,FWMF,19,19,806.0,42.0,23.6,9.0,8,73.0,1,11,20.0,1,1.11,7.0,14.0,-7.0,-0.78,-0.06,11.7,13.3,-1.6,-0.18,0.3,Matches,5.0,fr FRA,FWMF,19.0,9.0,210.0,3.0,11.0,101.0,103.0,41.0,208.0,23.0,12.0,52.2,11.0,47.8,141.0,918.0,319.0,14.0,5.0,7.0,43.0,17.0,155.0,49.0,Matches,5.0,fr FRA,FWMF,19.0,9.0,2.0,24.0,8.0,33.3,2.68,0.89,0.04,0.13,20.6,0.0,1.0,2.0,3.6,2.0,0.08,-1.6,-1.0,Matches,5.0,fr FRA,FWMF,19.0,19.0,8.0,806.0,9.0,2.0,1.0,3.0,1.0,1.0,2.0,1.0,0.0,3.6,2.0,0.7,2.7,14.0,8.0,49.0,0.22,0.11,0.33,0.11,0.22,0.4,0.08,0.47,0.22,0.3,Matches,Matthis Abline,S,19,102,-8,France,Stade Rennais FC,10,7,12,12,13,10,8,9,6,7,12,11,6,13,7,12,12,11,11,12,10,13,12,10,8,7,10,11,13,13,11,8,12,14,11,13,11,12,10,5,8,2,2,3,2,3,4,1,3,3,2,1,20,14,2,12,12,13,12,11,1,1,1,1,1,1,1,1,1,1,1,1,1,20,176,0,10,20,55860140,5100,5100,2500,Northern_European,100,6,2003/3/28,0,0,1711.0,,49056366
474,Martin Adeline,Reims,2003,9.0,fr FRA,MFFW,18.0,1.2,3.0,3.0,2.0,1.0,0.0,3.0,4.0,75.0,1.0,3.0,1.0,2.0,3.0,6.0,3.0,0.0,Matches,9.0,fr FRA,MFFW,18.0,1.2,2.0,1.68,2.0,0.0,0.0,0.0,0.0,0.0,0.0,0.0,0.0,0.0,0.0,0.0,0.0,0.0,Matches,,,,,,,,,,,,,,,,,,,,,,,,,,,,,,,,,,,,,,,,,,,,,,,,,,,,,,,,9.0,fr FRA,MFFW,18.0,1.2,2.0,0.0,0.0,5.0,0.0,0.0,0.0,3.0,3.0,0.0,0.0,0.0,11.0,6.0,5.0,54.5,Matches,9.0,fr FRA,MFFW,18.0,1.2,41.0,38.0,3.0,1.0,0.0,0.0,0.0,1.0,1.0,0.0,0.0,0.0,29.0,0.0,1.0,Matches,9.0,fr FRA,MFFW,18.0,1.2,29.0,41.0,70.7,390.0,93.0,12.0,18.0,66.7,11.0,14.0,78.6,1.0,3.0,33.3,0.0,0.0,0.0,0.0,0.0,2.0,0.0,0.0,3.0,Matches,9,fr FRA,MFFW,18,5,107.0,21.0,3.1,1.2,0,,0,5,21.0,10,1.4,3.0,5.0,-2.0,-1.68,-1.74,2.1,2.7,-0.7,-0.57,-0.82,Matches,9.0,fr FRA,MFFW,18.0,1.2,59.0,4.0,22.0,22.0,16.0,1.0,59.0,3.0,1.0,33.3,2.0,66.7,31.0,173.0,83.0,1.0,0.0,0.0,4.0,2.0,27.0,1.0,Matches,9.0,fr FRA,MFFW,18.0,1.2,0.0,1.0,0.0,0.0,0.84,0.0,0.0,,25.5,0.0,0.0,0.0,0.1,0.1,0.07,-0.1,-0.1,Matches,9.0,fr FRA,MFFW,18.0,5.0,0.0,107.0,1.2,0.0,0.0,0.0,0.0,0.0,0.0,2.0,0.0,0.1,0.1,0.0,0.1,1.0,3.0,1.0,0.0,0.0,0.0,0.0,0.0,0.06,0.0,0.06,0.06,0.06,Matches,Martin Adeline,M/AM C,18,96,-75,France,Stade de Reims,10,9,13,9,12,9,9,9,5,9,13,10,10,13,8,11,12,11,10,12,11,12,11,7,11,7,11,12,11,11,10,8,13,11,11,9,10,7,10,6,11,2,2,1,3,3,3,3,4,2,2,2,10,11,8,12,11,11,10,14,1,1,1,1,1,1,1,1,20,1,1,17,1,1,180,63,10,20,12352001,4793,4793,1493,Northern_European,94,6,2003/12/2,0,0,837.0,,2000024505
475,Ludovic Ajorque,Strasbourg,1994,15.0,fr FRA,FW,28.0,8.6,5.0,4.0,1.0,4.0,0.0,3.0,9.0,33.3,6.0,3.0,1.0,2.0,2.0,7.0,7.0,0.0,Matches,15.0,fr FRA,FW,28.0,8.6,22.0,2.57,20.0,0.0,0.0,2.0,0.0,0.0,2.0,0.23,1.0,0.0,0.0,1.0,0.0,0.0,Matches,,,,,,,,,,,,,,,,,,,,,,,,,,,,,,,,,,,,,,,,,,,,,,,,,,,,,,,,15.0,fr FRA,FW,28.0,8.6,1.0,0.0,0.0,14.0,8.0,1.0,0.0,2.0,4.0,0.0,0.0,0.0,21.0,50.0,33.0,60.2,Matches,15.0,fr FRA,FW,28.0,8.6,255.0,242.0,10.0,1.0,3.0,3.0,0.0,0.0,0.0,0.0,0.0,0.0,178.0,3.0,1.0,Matches,15.0,fr FRA,FW,28.0,8.6,178.0,255.0,69.8,2614.0,397.0,103.0,137.0,75.2,55.0,79.0,69.6,11.0,16.0,68.8,0.0,0.9,0.8,-0.9,10.0,10.0,6.0,0.0,13.0,Matches,16,fr FRA,FW,28,13,771.0,59.0,22.5,8.6,9,77.0,4,4,20.0,1,0.62,12.0,18.0,-6.0,-0.7,-0.63,10.8,13.6,-2.8,-0.33,-0.19,Matches,15.0,fr FRA,FW,28.0,8.6,336.0,8.0,32.0,172.0,136.0,50.0,335.0,5.0,3.0,60.0,2.0,40.0,225.0,901.0,202.0,2.0,7.0,1.0,19.0,10.0,262.0,55.0,Matches,15.0,fr FRA,FW,28.0,8.6,1.0,22.0,7.0,31.8,2.57,0.82,0.0,0.0,15.1,1.0,1.0,1.0,3.4,2.6,0.12,-2.4,-2.6,Matches,15.0,fr FRA,FW,28.0,13.0,9.0,771.0,8.6,1.0,0.0,1.0,0.0,1.0,1.0,1.0,0.0,3.4,2.6,0.9,3.5,2.0,13.0,55.0,0.12,0.0,0.12,0.0,0.0,0.39,0.1,0.5,0.3,0.4,Matches,Ludovic Ajorque,S,28,135,136,"France,Réunion",RC Strasbourg Alsace,4,10,12,16,13,7,17,12,4,4,12,15,2,13,13,14,15,13,15,11,13,15,13,12,12,7,15,16,12,12,16,17,15,12,14,16,13,8,12,7,10,2,4,1,2,4,3,1,1,3,3,3,18,14,7,13,10,12,10,10,1,1,1,1,1,1,1,1,1,1,1,1,1,20,197,82,20,7,7963831,6750,6750,4015,Mixed_Race,134,8,1994/2/25,0,0,22559.0,,85103818
476,Maghnes Akliouche,Monaco,2002,16.0,fr FRA,MFFW,20.0,4.5,7.0,4.0,4.0,3.0,0.0,2.0,8.0,25.0,6.0,2.0,0.0,2.0,3.0,10.0,2.0,0.0,Matches,16.0,fr FRA,MFFW,20.0,4.5,9.0,2.01,9.0,0.0,0.0,0.0,0.0,0.0,0.0,0.0,0.0,0.0,0.0,0.0,0.0,0.0,Matches,,,,,,,,,,,,,,,,,,,,,,,,,,,,,,,,,,,,,,,,,,,,,,,,,,,,,,,,16.0,fr FRA,MFFW,20.0,4.5,3.0,0.0,0.0,7.0,4.0,1.0,10.0,3.0,4.0,0.0,0.0,0.0,23.0,2.0,6.0,25.0,Matches,16.0,fr FRA,MFFW,20.0,4.5,168.0,161.0,5.0,1.0,0.0,0.0,10.0,3.0,1.0,1.0,0.0,0.0,130.0,2.0,6.0,Matches,16.0,fr FRA,MFFW,20.0,4.5,130.0,168.0,77.4,1613.0,498.0,78.0,91.0,85.7,34.0,46.0,73.9,3.0,7.0,42.9,0.0,0.5,0.5,-0.5,6.0,12.0,5.0,0.0,16.0,Matches,18,fr FRA,MFFW,20,11,402.0,37.0,11.8,4.5,5,61.0,0,6,16.0,16,1.82,6.0,4.0,2.0,0.45,0.15,8.6,5.7,2.9,0.66,0.48,Matches,16.0,fr FRA,MFFW,20.0,4.5,210.0,4.0,23.0,85.0,105.0,17.0,210.0,13.0,6.0,46.2,7.0,53.8,172.0,897.0,351.0,9.0,5.0,2.0,8.0,7.0,161.0,42.0,Matches,16.0,fr FRA,MFFW,20.0,4.5,0.0,5.0,2.0,40.0,1.12,0.45,0.0,0.0,14.9,0.0,0.0,0.0,0.5,0.5,0.09,-0.5,-0.5,Matches,16.0,fr FRA,MFFW,20.0,11.0,5.0,402.0,4.5,0.0,0.0,0.0,0.0,0.0,0.0,3.0,0.0,0.5,0.5,0.5,0.9,9.0,16.0,42.0,0.0,0.0,0.0,0.0,0.0,0.1,0.11,0.21,0.1,0.21,Matches,Maghnes Akliouche,M/AM RLC,20,104,-75,"France,Algeria",AS Monaco,11,13,12,8,13,10,7,9,4,6,13,11,7,13,11,11,12,13,11,13,11,12,13,11,11,8,12,12,12,13,10,7,13,12,12,8,11,8,9,5,17,1,2,2,3,1,1,1,2,3,2,2,8,13,2,10,11,12,12,20,1,1,1,1,1,1,1,13,20,13,17,18,15,1,175,63,20,10,30465067,5200,5200,1150,North_African__Middle_Eastern,100,7,2002/2/25,0,0,2275.0,,49055037
477,Doğan Alemdar,Rennes,2002,17.0,tr TUR,GK,19.0,4.5,0.0,0.0,0.0,0.0,0.0,0.0,0.0,,0.0,0.0,0.0,0.0,0.0,0.0,1.0,1.0,Matches,17.0,tr TUR,GK,19.0,4.5,1.0,0.22,0.0,1.0,0.0,0.0,0.0,0.0,0.0,0.0,0.0,0.0,0.0,0.0,0.0,0.0,Matches,1.0,tr TUR,GK,19.0,4.5,8.0,1.0,0.0,2.0,0.0,6.5,0.29,-1.5,-0.32,23.0,67.0,34.3,109.0,14.0,38.5,33.0,35.0,71.4,51.4,75.0,5.0,6.7,5.0,1.11,14.8,Matches,1.0,tr TUR,GK,19.0,6.0,4.0,406.0,4.5,8.0,1.77,16.0,7.0,56.3,2.0,0.0,2.0,1.0,25.0,2.0,1.0,1.0,0.0,50.0,Matches,17.0,tr TUR,GK,19.0,4.5,1.0,0.0,0.0,0.0,0.0,0.0,0.0,0.0,0.0,0.0,0.0,0.0,6.0,2.0,0.0,100.0,Matches,17.0,tr TUR,GK,19.0,4.5,145.0,96.0,48.0,13.0,0.0,0.0,0.0,0.0,0.0,0.0,0.0,0.0,95.0,1.0,0.0,Matches,17.0,tr TUR,GK,19.0,4.5,95.0,145.0,65.5,2786.0,2199.0,20.0,20.0,100.0,47.0,47.0,100.0,28.0,77.0,36.4,0.0,0.1,0.0,-0.1,1.0,2.0,0.0,0.0,0.0,Matches,19,tr TUR,GK,19,6,406.0,68.0,11.9,4.5,4,90.0,4,2,23.0,32,1.67,7.0,8.0,-1.0,-0.22,-1.15,6.1,6.1,0.1,0.01,-0.5,Matches,17.0,tr TUR,GK,19.0,4.5,154.0,117.0,154.0,0.0,0.0,0.0,154.0,0.0,0.0,,0.0,,102.0,490.0,229.0,0.0,0.0,0.0,1.0,0.0,67.0,0.0,Matches,17.0,tr TUR,GK,19.0,4.5,0.0,0.0,0.0,,0.0,0.0,,,,0.0,0.0,0.0,0.0,0.0,,0.0,0.0,Matches,17.0,tr TUR,GK,19.0,6.0,4.0,406.0,4.5,0.0,0.0,0.0,0.0,0.0,0.0,1.0,0.0,0.0,0.0,0.1,0.1,0.0,0.0,0.0,0.0,0.0,0.0,0.0,0.0,0.0,0.03,0.03,0.0,0.03,Matches,Doğan Alemdar,GK,19,105,-75,Turkey,Stade Rennais FC,1,3,2,3,8,1,1,1,2,2,9,5,3,9,8,9,13,12,13,6,9,5,7,8,8,10,14,15,10,11,13,12,12,11,14,14,12,6,12,5,1,13,12,12,7,12,12,13,13,11,12,12,13,10,4,11,13,11,11,11,20,1,1,1,1,1,1,1,1,1,1,1,1,1,185,0,5,20,38442936,5250,5250,2000,Mediterranean_Hispanic,105,1,2002/10/29,1,0,2465.0,,70117167
478,Ibrahim Amadou,Angers,1993,20.0,fr FRA,DFMF,29.0,4.7,10.0,7.0,6.0,3.0,1.0,7.0,11.0,63.6,4.0,7.0,3.0,4.0,10.0,20.0,20.0,0.0,Matches,20.0,fr FRA,DFMF,29.0,4.7,3.0,0.64,3.0,0.0,0.0,0.0,0.0,0.0,0.0,0.0,0.0,0.0,0.0,0.0,0.0,0.0,Matches,,,,,,,,,,,,,,,,,,,,,,,,,,,,,,,,,,,,,,,,,,,,,,,,,,,,,,,,20.0,fr FRA,DFMF,29.0,4.7,2.0,0.0,0.0,4.0,3.0,0.0,1.0,10.0,7.0,0.0,2.0,0.0,29.0,6.0,5.0,54.5,Matches,20.0,fr FRA,DFMF,29.0,4.7,190.0,186.0,4.0,4.0,0.0,0.0,1.0,0.0,0.0,0.0,0.0,0.0,161.0,0.0,5.0,Matches,20.0,fr FRA,DFMF,29.0,4.7,161.0,190.0,84.7,3021.0,1234.0,51.0,56.0,91.1,93.0,99.0,93.9,13.0,25.0,52.0,0.0,0.1,0.0,-0.1,1.0,4.0,0.0,0.0,5.0,Matches,23,fr FRA,DFMF,29,7,424.0,61.0,12.4,4.7,4,90.0,4,3,21.0,4,0.14,5.0,9.0,-4.0,-0.85,0.47,5.9,9.8,-3.9,-0.83,-0.32,Matches,20.0,fr FRA,DFMF,29.0,4.7,244.0,54.0,147.0,89.0,9.0,2.0,244.0,2.0,1.0,50.0,1.0,50.0,167.0,851.0,394.0,0.0,3.0,0.0,2.0,3.0,143.0,5.0,Matches,20.0,fr FRA,DFMF,29.0,4.7,0.0,2.0,0.0,0.0,0.42,0.0,0.0,,24.4,0.0,0.0,0.0,0.1,0.1,0.03,-0.1,-0.1,Matches,20.0,fr FRA,DFMF,29.0,7.0,4.0,424.0,4.7,0.0,0.0,0.0,0.0,0.0,0.0,2.0,0.0,0.1,0.1,0.1,0.1,0.0,5.0,5.0,0.0,0.0,0.0,0.0,0.0,0.01,0.01,0.03,0.01,0.03,Matches,Ibrahim Amadou,DM/M C,29,125,143,"France,Cameroon",Angers SCO,3,10,10,5,12,5,14,4,7,13,13,8,14,12,14,15,16,13,14,12,13,14,8,13,11,14,14,15,12,12,14,15,15,13,15,16,14,12,15,11,15,1,3,2,2,4,2,3,3,2,1,1,19,14,7,12,12,14,13,13,1,1,12,11,1,1,20,1,17,1,1,1,1,1,184,81,8,20,2392853,6250,6250,5350,African_Caribbean,127,15,1993/4/6,0,0,10674.0,,85027975
479,Houssem Aouar,Lyon,1998,24.0,dz ALG,MF,24.0,5.8,12.0,5.0,5.0,5.0,2.0,3.0,9.0,33.3,6.0,12.0,2.0,10.0,8.0,20.0,3.0,0.0,Matches,24.0,dz ALG,MF,24.0,5.8,15.0,2.57,9.0,0.0,3.0,3.0,0.0,0.0,2.0,0.34,2.0,0.0,0.0,0.0,0.0,0.0,Matches,,,,,,,,,,,,,,,,,,,,,,,,,,,,,,,,,,,,,,,,,,,,,,,,,,,,,,,,24.0,dz ALG,MF,24.0,5.8,2.0,0.0,0.0,7.0,5.0,0.0,6.0,8.0,5.0,0.0,0.0,0.0,35.0,6.0,4.0,60.0,Matches,24.0,dz ALG,MF,24.0,5.8,370.0,361.0,9.0,4.0,1.0,3.0,6.0,1.0,3.0,0.0,0.0,0.0,299.0,0.0,9.0,Matches,24.0,dz ALG,MF,24.0,5.8,299.0,370.0,80.8,4682.0,1089.0,160.0,179.0,89.4,101.0,127.0,79.5,24.0,36.0,66.7,1.0,1.1,0.8,-0.1,6.0,37.0,4.0,0.0,37.0,Matches,27,dz ALG,MF,24,16,526.0,33.0,15.4,5.8,6,57.0,0,10,18.0,10,1.88,8.0,6.0,2.0,0.34,-0.16,7.9,7.4,0.4,0.07,-0.21,Matches,24.0,dz ALG,MF,24.0,5.8,461.0,6.0,51.0,279.0,134.0,28.0,461.0,23.0,10.0,43.5,11.0,47.8,365.0,1848.0,739.0,12.0,19.0,4.0,8.0,13.0,349.0,36.0,Matches,24.0,dz ALG,MF,24.0,5.8,1.0,14.0,6.0,42.9,2.4,1.03,0.07,0.17,15.1,0.0,0.0,0.0,1.4,1.4,0.11,-0.4,-0.4,Matches,24.0,dz ALG,MF,24.0,16.0,6.0,526.0,5.8,1.0,1.0,2.0,1.0,0.0,0.0,2.0,0.0,1.4,1.4,1.1,2.6,12.0,37.0,36.0,0.17,0.17,0.34,0.17,0.34,0.25,0.2,0.44,0.25,0.44,Matches,Houssem Aouar,M/AM LC,24,138,153,"France,Algeria",Olympique Lyonnais,13,10,15,11,16,13,7,9,5,10,16,12,8,16,9,12,11,14,11,16,13,13,15,13,14,12,15,11,13,15,12,7,14,13,14,10,12,8,15,7,16,1,1,1,3,3,1,1,3,2,1,1,14,13,6,17,13,15,12,13,1,1,1,1,1,1,12,15,19,1,15,20,12,10,175,70,10,20,10956752,6800,6900,6550,Mediterranean_Hispanic,137,10,1998/6/30,1,0,71342.0,,48031455
480,Adil Aouchiche,Lorient,2002,25.0,fr FRA,MF,20.0,2.8,5.0,2.0,3.0,1.0,1.0,1.0,9.0,11.1,8.0,1.0,0.0,1.0,4.0,9.0,1.0,0.0,Matches,25.0,fr FRA,MF,20.0,2.8,5.0,1.8,3.0,0.0,0.0,1.0,0.0,1.0,0.0,0.0,0.0,0.0,0.0,0.0,0.0,0.0,Matches,,,,,,,,,,,,,,,,,,,,,,,,,,,,,,,,,,,,,,,,,,,,,,,,,,,,,,,,25.0,fr FRA,MF,20.0,2.8,0.0,0.0,0.0,4.0,5.0,0.0,17.0,4.0,2.0,0.0,0.0,0.0,14.0,0.0,3.0,0.0,Matches,25.0,fr FRA,MF,20.0,2.8,154.0,133.0,21.0,8.0,0.0,4.0,17.0,3.0,8.0,2.0,4.0,0.0,115.0,0.0,4.0,Matches,25.0,fr FRA,MF,20.0,2.8,115.0,154.0,74.7,1969.0,665.0,56.0,62.0,90.3,41.0,51.0,80.4,12.0,30.0,40.0,0.0,0.1,0.1,-0.1,1.0,15.0,3.0,0.0,23.0,Matches,28,fr FRA,MF,20,11,250.0,23.0,7.3,2.8,1,73.0,0,10,18.0,14,0.82,3.0,5.0,-2.0,-0.72,-0.75,3.5,2.9,0.5,0.19,0.59,Matches,25.0,fr FRA,MF,20.0,2.8,192.0,7.0,30.0,104.0,61.0,8.0,192.0,7.0,2.0,28.6,3.0,42.9,149.0,996.0,559.0,16.0,10.0,1.0,6.0,8.0,137.0,20.0,Matches,25.0,fr FRA,MF,20.0,2.8,0.0,8.0,3.0,37.5,2.88,1.08,0.0,0.0,17.1,0.0,0.0,0.0,0.5,0.5,0.07,-0.5,-0.5,Matches,25.0,fr FRA,MF,20.0,11.0,1.0,250.0,2.8,0.0,0.0,0.0,0.0,0.0,0.0,0.0,0.0,0.5,0.5,0.1,0.6,16.0,23.0,20.0,0.0,0.0,0.0,0.0,0.0,0.2,0.02,0.22,0.2,0.22,Matches,Adil Aouchiche,M/AM C,20,117,-8,"France,Algeria",FC Lorient,12,12,14,11,14,13,6,12,6,5,13,13,6,15,10,11,12,13,10,12,12,11,14,10,12,7,10,8,13,14,12,9,13,13,12,11,12,10,16,7,15,3,2,2,1,2,1,2,1,4,2,2,16,15,9,10,12,12,13,12,1,1,1,1,1,1,1,1,20,1,1,17,1,1,181,72,12,20,35898500,5750,5850,3750,North_African__Middle_Eastern,112,7,2002/7/15,0,0,4802.0,,49048441
481,Dennis Appiah,Nantes,1992,26.0,fr FRA,DFMF,30.0,8.8,21.0,11.0,14.0,7.0,0.0,10.0,27.0,37.0,17.0,13.0,5.0,8.0,10.0,31.0,16.0,0.0,Matches,26.0,fr FRA,DFMF,30.0,8.8,11.0,1.25,8.0,1.0,2.0,0.0,0.0,0.0,1.0,0.11,1.0,0.0,0.0,0.0,0.0,0.0,Matches,,,,,,,,,,,,,,,,,,,,,,,,,,,,,,,,,,,,,,,,,,,,,,,,,,,,,,,,26.0,fr FRA,DFMF,30.0,8.8,1.0,0.0,0.0,16.0,1.0,1.0,21.0,10.0,11.0,0.0,1.0,0.0,50.0,16.0,16.0,50.0,Matches,26.0,fr FRA,DFMF,30.0,8.8,468.0,393.0,74.0,5.0,0.0,0.0,21.0,69.0,0.0,0.0,0.0,0.0,339.0,1.0,8.0,Matches,26.0,fr FRA,DFMF,30.0,8.8,339.0,468.0,72.4,5590.0,2196.0,152.0,191.0,79.6,154.0,204.0,75.5,22.0,53.0,41.5,0.0,0.2,0.3,-0.2,4.0,30.0,7.0,4.0,39.0,Matches,29,fr FRA,DFMF,30,15,795.0,53.0,23.2,8.8,9,76.0,3,6,18.0,0,0.87,8.0,16.0,-8.0,-0.91,-0.56,10.0,12.5,-2.4,-0.28,-0.03,Matches,26.0,fr FRA,DFMF,30.0,8.8,554.0,37.0,158.0,292.0,113.0,4.0,554.0,18.0,6.0,33.3,10.0,55.6,372.0,2193.0,1173.0,15.0,13.0,0.0,12.0,10.0,339.0,51.0,Matches,26.0,fr FRA,DFMF,30.0,8.8,0.0,5.0,1.0,20.0,0.57,0.11,0.0,0.0,19.3,0.0,0.0,0.0,0.4,0.4,0.08,-0.4,-0.4,Matches,26.0,fr FRA,DFMF,30.0,15.0,9.0,795.0,8.8,0.0,0.0,0.0,0.0,0.0,0.0,1.0,0.0,0.4,0.4,0.2,0.6,15.0,39.0,51.0,0.0,0.0,0.0,0.0,0.0,0.05,0.02,0.06,0.05,0.06,Matches,Dennis Appiah,D/WB R,30,121,130,"France,Ghana",FC Nantes,4,13,9,6,12,9,11,7,8,12,13,8,14,12,15,14,13,14,13,10,12,14,10,9,9,10,13,13,14,11,13,11,8,13,14,14,12,11,13,10,14,3,1,2,2,1,2,1,3,2,2,2,13,14,6,14,11,16,15,15,1,13,13,20,13,16,10,1,1,1,1,1,1,1,179,68,10,20,1298911,6044,6044,4494,African_Caribbean,120,15,1992/6/9,0,0,18397.0,,85010865
482,Mohamed El Arouch,Lyon,2004,29.0,fr FRA,MF,18.0,0.0,1.0,1.0,1.0,0.0,0.0,0.0,0.0,,0.0,0.0,0.0,0.0,0.0,1.0,0.0,0.0,Matches,29.0,fr FRA,MF,18.0,0.0,1.0,90.0,1.0,0.0,0.0,0.0,0.0,0.0,0.0,0.0,0.0,0.0,0.0,0.0,0.0,0.0,Matches,,,,,,,,,,,,,,,,,,,,,,,,,,,,,,,,,,,,,,,,,,,,,,,,,,,,,,,,29.0,fr FRA,MF,18.0,0.0,0.0,0.0,0.0,0.0,0.0,0.0,1.0,0.0,1.0,0.0,0.0,0.0,1.0,0.0,0.0,,Matches,29.0,fr FRA,MF,18.0,0.0,2.0,1.0,1.0,0.0,0.0,0.0,1.0,0.0,1.0,1.0,0.0,0.0,1.0,0.0,0.0,Matches,29.0,fr FRA,MF,18.0,0.0,1.0,2.0,50.0,17.0,9.0,0.0,0.0,,1.0,1.0,100.0,0.0,1.0,0.0,0.0,0.0,0.0,0.0,0.0,1.0,0.0,0.0,1.0,Matches,33,fr FRA,MF,18,1,2.0,2.0,0.1,0.0,0,,0,1,2.0,7,3.0,1.0,0.0,1.0,45.0,44.55,0.6,0.0,0.6,50.45,50.21,Matches,29.0,fr FRA,MF,18.0,0.0,4.0,0.0,3.0,1.0,1.0,0.0,4.0,1.0,0.0,0.0,1.0,100.0,2.0,34.0,33.0,1.0,0.0,0.0,0.0,0.0,0.0,0.0,Matches,29.0,fr FRA,MF,18.0,0.0,0.0,0.0,0.0,,0.0,0.0,,,,0.0,0.0,0.0,0.0,0.0,,0.0,0.0,Matches,29.0,fr FRA,MF,18.0,1.0,0.0,2.0,0.0,0.0,0.0,0.0,0.0,0.0,0.0,0.0,0.0,0.0,0.0,0.0,0.0,1.0,1.0,0.0,0.0,0.0,0.0,0.0,0.0,0.0,0.0,0.0,0.0,0.0,Matches,Mohamed El Arouch,M/AM C,18,102,-85,"France,Morocco",Olympique Lyonnais,11,10,11,12,13,12,5,9,3,10,13,10,9,14,12,11,6,13,9,14,12,7,12,12,12,9,13,12,10,12,10,5,13,10,10,9,19,8,8,9,12,1,2,3,4,4,1,2,3,1,2,3,12,11,1,12,12,9,13,19,1,1,1,1,1,1,15,1,20,1,12,16,1,1,166,56,9,20,17730001,5299,5099,1509,North_African__Middle_Eastern,99,9,2004/4/6,0,0,2858.0,,2000011404
483,Lorenz Assignon,Rennes,2000,30.0,tg TOG,DF,22.0,2.9,6.0,2.0,4.0,2.0,0.0,2.0,4.0,50.0,2.0,6.0,0.0,6.0,2.0,8.0,9.0,0.0,Matches,30.0,tg TOG,DF,22.0,2.9,4.0,1.37,3.0,1.0,0.0,0.0,0.0,0.0,1.0,0.34,1.0,0.0,0.0,0.0,0.0,0.0,Matches,,,,,,,,,,,,,,,,,,,,,,,,,,,,,,,,,,,,,,,,,,,,,,,,,,,,,,,,30.0,tg TOG,DF,22.0,2.9,3.0,0.0,0.0,4.0,4.0,0.0,4.0,2.0,2.0,0.0,0.0,0.0,19.0,8.0,4.0,66.7,Matches,30.0,tg TOG,DF,22.0,2.9,155.0,127.0,27.0,5.0,0.0,0.0,4.0,22.0,0.0,0.0,0.0,0.0,127.0,1.0,2.0,Matches,30.0,tg TOG,DF,22.0,2.9,127.0,155.0,81.9,2129.0,587.0,60.0,72.0,83.3,60.0,70.0,85.7,6.0,11.0,54.5,1.0,0.3,0.3,0.7,1.0,8.0,0.0,0.0,11.0,Matches,34,tg TOG,DF,22,12,261.0,22.0,7.6,2.9,2,81.0,1,10,10.0,9,2.42,5.0,3.0,2.0,0.69,-0.11,4.6,1.5,3.1,1.07,0.67,Matches,30.0,tg TOG,DF,22.0,2.9,200.0,15.0,51.0,110.0,42.0,6.0,200.0,5.0,1.0,20.0,3.0,60.0,122.0,727.0,411.0,10.0,7.0,2.0,4.0,2.0,105.0,13.0,Matches,30.0,tg TOG,DF,22.0,2.9,0.0,3.0,1.0,33.3,1.03,0.34,0.0,0.0,14.7,0.0,0.0,0.0,0.3,0.3,0.11,-0.3,-0.3,Matches,30.0,tg TOG,DF,22.0,12.0,2.0,261.0,2.9,0.0,1.0,1.0,0.0,0.0,0.0,3.0,0.0,0.3,0.3,0.3,0.6,10.0,11.0,13.0,0.0,0.34,0.34,0.0,0.34,0.11,0.1,0.22,0.11,0.22,Matches,Lorenz Assignon,D R,22,114,139,"France,Togo",Stade Rennais FC,7,12,11,5,12,6,10,9,8,12,13,4,11,12,8,11,13,12,11,12,11,11,7,12,12,12,13,11,14,13,12,11,13,14,13,11,12,13,10,7,10,1,3,3,3,3,1,1,3,1,3,1,7,11,2,11,12,13,11,10,1,1,14,20,1,12,1,1,1,10,1,1,10,1,181,76,10,20,3460000,5700,5700,2764,African_Caribbean,113,12,2000/6/22,0,0,5195.0,,49053443
484,Youcef Atal,Nice,1996,31.0,dz ALG,DFMF,26.0,8.7,38.0,22.0,18.0,15.0,5.0,23.0,32.0,71.9,9.0,9.0,0.0,9.0,14.0,52.0,13.0,0.0,Matches,31.0,dz ALG,DFMF,26.0,8.7,31.0,3.58,22.0,0.0,4.0,2.0,2.0,1.0,2.0,0.23,1.0,0.0,1.0,0.0,0.0,0.0,Matches,,,,,,,,,,,,,,,,,,,,,,,,,,,,,,,,,,,,,,,,,,,,,,,,,,,,,,,,31.0,dz ALG,DFMF,26.0,8.7,1.0,0.0,0.0,9.0,15.0,3.0,40.0,14.0,22.0,0.0,0.0,0.0,51.0,9.0,7.0,56.3,Matches,31.0,dz ALG,DFMF,26.0,8.7,509.0,432.0,77.0,11.0,1.0,1.0,40.0,66.0,0.0,0.0,0.0,0.0,408.0,0.0,19.0,Matches,31.0,dz ALG,DFMF,26.0,8.7,408.0,509.0,80.2,6228.0,1790.0,232.0,262.0,88.5,131.0,157.0,83.4,33.0,64.0,51.6,0.0,1.3,1.7,-1.3,11.0,28.0,16.0,7.0,39.0,Matches,35,dz ALG,DFMF,26,18,779.0,43.0,22.8,8.7,8,66.0,2,10,25.0,2,1.56,10.0,6.0,4.0,0.46,0.22,13.8,8.9,4.9,0.57,0.31,Matches,31.0,dz ALG,DFMF,26.0,8.7,632.0,22.0,149.0,295.0,202.0,18.0,632.0,43.0,19.0,44.2,22.0,51.2,443.0,2882.0,1605.0,38.0,29.0,8.0,10.0,5.0,402.0,63.0,Matches,31.0,dz ALG,DFMF,26.0,8.7,1.0,12.0,5.0,41.7,1.39,0.58,0.08,0.2,17.3,0.0,0.0,0.0,1.0,1.0,0.09,0.0,0.0,Matches,31.0,dz ALG,DFMF,26.0,18.0,8.0,779.0,8.7,1.0,0.0,1.0,1.0,0.0,0.0,1.0,0.0,1.0,1.0,1.3,2.3,38.0,39.0,63.0,0.12,0.0,0.12,0.12,0.12,0.12,0.15,0.27,0.12,0.27,Matches,Youcef Atal,D/WB/M/AM R,26,135,140,Algeria,OGC Nice,10,12,15,11,13,8,7,11,10,10,12,10,12,15,15,12,12,11,10,12,11,15,14,10,14,10,13,15,15,14,10,6,12,15,14,9,10,13,1,16,15,2,1,2,2,3,2,3,1,1,3,2,13,16,11,12,13,12,10,8,1,1,1,20,1,19,1,1,1,18,1,1,17,1,176,64,8,20,8415219,6950,6950,5750,North_African__Middle_Eastern,116,9,1996/5/17,20,1,34496.0,,13195823
485,Benoît Badiashile,Monaco,2001,36.0,fr FRA,DF,21.0,9.3,10.0,8.0,6.0,4.0,0.0,5.0,10.0,50.0,5.0,9.0,6.0,3.0,17.0,27.0,40.0,1.0,Matches,36.0,fr FRA,DF,21.0,9.3,4.0,0.43,2.0,0.0,0.0,2.0,0.0,0.0,0.0,0.0,0.0,0.0,0.0,0.0,0.0,0.0,Matches,,,,,,,,,,,,,,,,,,,,,,,,,,,,,,,,,,,,,,,,,,,,,,,,,,,,,,,,36.0,fr FRA,DF,21.0,9.3,3.0,0.0,0.0,10.0,4.0,0.0,0.0,17.0,8.0,0.0,0.0,0.0,67.0,21.0,7.0,75.0,Matches,36.0,fr FRA,DF,21.0,9.3,468.0,455.0,13.0,13.0,0.0,5.0,0.0,0.0,0.0,0.0,0.0,0.0,403.0,0.0,2.0,Matches,36.0,fr FRA,DF,21.0,9.3,403.0,468.0,86.1,8296.0,3424.0,123.0,137.0,89.8,210.0,235.0,89.4,60.0,83.0,72.3,0.0,0.4,0.8,-0.4,1.0,46.0,3.0,0.0,39.0,Matches,40,fr FRA,DF,21,11,839.0,76.0,24.5,9.3,9,87.0,8,2,27.0,2,1.55,20.0,15.0,5.0,0.54,0.29,14.5,15.2,-0.7,-0.07,-0.41,Matches,36.0,fr FRA,DF,21.0,9.3,568.0,82.0,240.0,324.0,13.0,7.0,568.0,1.0,0.0,0.0,1.0,100.0,402.0,2118.0,1114.0,3.0,3.0,1.0,3.0,0.0,349.0,0.0,Matches,36.0,fr FRA,DF,21.0,9.3,2.0,5.0,3.0,60.0,0.54,0.32,0.4,0.67,16.0,0.0,0.0,0.0,0.6,0.6,0.13,1.4,1.4,Matches,36.0,fr FRA,DF,21.0,11.0,9.0,839.0,9.3,2.0,0.0,2.0,2.0,0.0,0.0,3.0,0.0,0.6,0.6,0.4,1.0,3.0,39.0,0.0,0.21,0.0,0.21,0.21,0.21,0.07,0.04,0.11,0.07,0.11,Matches,Benoît Badiashile,D C,21,133,158,France,AS Monaco,3,5,9,6,12,4,15,7,8,14,13,7,14,12,10,14,14,13,11,11,12,15,9,11,6,14,14,12,13,11,14,17,15,14,14,16,13,6,13,5,5,3,2,2,1,1,4,1,1,2,3,4,12,15,6,16,14,15,14,14,1,1,20,1,1,1,10,1,1,1,1,1,1,1,194,75,20,7,31039996,6638,6638,4988,African_Caribbean,132,17,2001/3/26,0,0,12657.0,,49038942
486,Cédric Bakambu,Marseille,1991,40.0,cd COD,MF,31.0,0.7,2.0,1.0,2.0,0.0,0.0,2.0,2.0,100.0,0.0,0.0,0.0,0.0,0.0,2.0,0.0,0.0,Matches,40.0,cd COD,MF,31.0,0.7,2.0,3.05,2.0,0.0,0.0,0.0,0.0,0.0,1.0,1.53,1.0,0.0,0.0,0.0,0.0,0.0,Matches,,,,,,,,,,,,,,,,,,,,,,,,,,,,,,,,,,,,,,,,,,,,,,,,,,,,,,,,40.0,cd COD,MF,31.0,0.7,0.0,0.0,0.0,2.0,1.0,0.0,1.0,0.0,1.0,0.0,0.0,0.0,5.0,4.0,3.0,57.1,Matches,40.0,cd COD,MF,31.0,0.7,23.0,23.0,0.0,0.0,0.0,0.0,1.0,0.0,0.0,0.0,0.0,0.0,19.0,0.0,1.0,Matches,40.0,cd COD,MF,31.0,0.7,19.0,23.0,82.6,263.0,56.0,12.0,13.0,92.3,4.0,5.0,80.0,1.0,1.0,100.0,1.0,1.0,0.7,0.0,2.0,1.0,0.0,0.0,0.0,Matches,44,cd COD,MF,31,3,59.0,20.0,1.7,0.7,0,,0,3,20.0,2,2.33,1.0,1.0,0.0,0.0,-0.72,1.5,1.6,-0.1,-0.14,-0.75,Matches,40.0,cd COD,MF,31.0,0.7,33.0,0.0,6.0,15.0,12.0,3.0,33.0,2.0,0.0,0.0,2.0,100.0,22.0,135.0,59.0,1.0,3.0,1.0,2.0,1.0,20.0,4.0,Matches,40.0,cd COD,MF,31.0,0.7,0.0,0.0,0.0,,0.0,0.0,,,,0.0,0.0,0.0,0.0,0.0,,0.0,0.0,Matches,40.0,cd COD,MF,31.0,3.0,0.0,59.0,0.7,0.0,1.0,1.0,0.0,0.0,0.0,0.0,0.0,0.0,0.0,1.0,1.0,1.0,0.0,4.0,0.0,1.53,1.53,0.0,1.53,0.0,1.56,1.56,0.0,1.56,Matches,Cédric Bakambu,S,31,130,155,"Democratic Republic of Congo,France",Olympiacos SF Piraeus,5,11,13,12,12,8,12,12,6,6,10,14,6,13,12,13,13,10,11,10,12,13,14,8,17,7,10,12,15,15,14,11,15,16,14,12,12,11,15,6,12,1,2,2,2,3,3,3,2,1,1,3,13,14,11,14,10,13,12,14,1,1,1,1,1,1,1,1,1,1,14,1,11,20,182,74,10,20,347975206,6500,6950,5500,African_Caribbean,127,14,1991/4/11,40,13,23653.0,,34009930
487,Carlos Baleba,Lille,2004,42.0,cm CMR,MF,18.0,5.3,13.0,11.0,2.0,9.0,2.0,9.0,14.0,64.3,5.0,13.0,3.0,10.0,1.0,14.0,3.0,2.0,Matches,42.0,cm CMR,MF,18.0,5.3,11.0,2.07,7.0,0.0,1.0,1.0,2.0,0.0,2.0,0.38,0.0,0.0,0.0,0.0,2.0,0.0,Matches,,,,,,,,,,,,,,,,,,,,,,,,,,,,,,,,,,,,,,,,,,,,,,,,,,,,,,,,42.0,cm CMR,MF,18.0,5.3,3.0,1.0,0.0,13.0,18.0,0.0,1.0,1.0,11.0,2.0,0.0,0.0,38.0,7.0,8.0,46.7,Matches,42.0,cm CMR,MF,18.0,5.3,300.0,294.0,5.0,5.0,0.0,3.0,1.0,0.0,0.0,0.0,0.0,0.0,249.0,1.0,9.0,Matches,42.0,cm CMR,MF,18.0,5.3,249.0,300.0,83.0,4837.0,877.0,98.0,114.0,86.0,103.0,119.0,86.6,41.0,51.0,80.4,0.0,0.1,0.1,-0.1,2.0,33.0,2.0,0.0,33.0,Matches,47,cm CMR,MF,18,19,478.0,25.0,14.0,5.3,5,72.0,0,14,9.0,13,2.05,9.0,4.0,5.0,0.94,0.45,9.0,4.8,4.2,0.8,0.07,Matches,42.0,cm CMR,MF,18.0,5.3,384.0,10.0,49.0,256.0,83.0,5.0,384.0,28.0,15.0,53.6,9.0,32.1,302.0,1903.0,1027.0,16.0,16.0,2.0,12.0,17.0,284.0,12.0,Matches,42.0,cm CMR,MF,18.0,5.3,0.0,12.0,2.0,16.7,2.26,0.38,0.0,0.0,24.3,0.0,0.0,0.0,0.5,0.5,0.04,-0.5,-0.5,Matches,42.0,cm CMR,MF,18.0,19.0,5.0,478.0,5.3,0.0,0.0,0.0,0.0,0.0,0.0,3.0,1.0,0.5,0.5,0.1,0.6,16.0,33.0,12.0,0.0,0.0,0.0,0.0,0.0,0.09,0.02,0.11,0.09,0.11,Matches,Carlos Baleba,M C,18,96,-75,Cameroon,LOSC Lille,6,7,11,8,12,8,9,8,5,10,12,7,10,12,12,11,12,11,10,12,11,10,11,7,12,10,11,10,12,13,10,9,14,12,14,10,10,7,9,6,10,2,3,3,2,3,1,1,4,3,1,2,11,8,6,11,10,11,12,18,1,1,1,1,1,1,1,1,20,1,1,15,1,1,177,0,20,8,11580000,4800,4800,1500,African_Caribbean,96,15,2004/1/3,0,0,929.0,,2000166563
488,Alexis Beka Beka,Nice,2001,53.0,fr FRA,MFDF,21.0,6.1,16.0,5.0,6.0,9.0,1.0,4.0,15.0,26.7,11.0,9.0,1.0,8.0,12.0,28.0,6.0,0.0,Matches,53.0,fr FRA,MFDF,21.0,6.1,9.0,1.49,5.0,1.0,0.0,0.0,3.0,0.0,0.0,0.0,0.0,0.0,0.0,0.0,0.0,0.0,Matches,,,,,,,,,,,,,,,,,,,,,,,,,,,,,,,,,,,,,,,,,,,,,,,,,,,,,,,,53.0,fr FRA,MFDF,21.0,6.1,2.0,0.0,0.0,11.0,7.0,0.0,17.0,12.0,5.0,0.0,0.0,0.0,44.0,3.0,4.0,42.9,Matches,53.0,fr FRA,MFDF,21.0,6.1,303.0,288.0,15.0,2.0,0.0,2.0,17.0,9.0,4.0,2.0,0.0,0.0,236.0,0.0,5.0,Matches,53.0,fr FRA,MFDF,21.0,6.1,236.0,303.0,77.9,3971.0,967.0,123.0,145.0,84.8,82.0,103.0,79.6,24.0,42.0,57.1,0.0,0.1,0.2,-0.1,3.0,19.0,2.0,1.0,25.0,Matches,62,fr FRA,MFDF,21,14,545.0,39.0,15.9,6.1,7,63.0,0,7,14.0,19,1.29,5.0,9.0,-4.0,-0.66,-1.13,7.5,8.8,-1.2,-0.2,-0.64,Matches,53.0,fr FRA,MFDF,21.0,6.1,387.0,14.0,82.0,219.0,93.0,5.0,387.0,17.0,8.0,47.1,8.0,47.1,295.0,1911.0,864.0,13.0,12.0,3.0,12.0,8.0,262.0,23.0,Matches,53.0,fr FRA,MFDF,21.0,6.1,0.0,9.0,3.0,33.3,1.49,0.5,0.0,0.0,24.5,1.0,0.0,0.0,0.5,0.5,0.05,-0.5,-0.5,Matches,53.0,fr FRA,MFDF,21.0,14.0,7.0,545.0,6.1,0.0,0.0,0.0,0.0,0.0,0.0,2.0,0.0,0.5,0.5,0.1,0.5,13.0,25.0,23.0,0.0,0.0,0.0,0.0,0.0,0.08,0.01,0.09,0.08,0.09,Matches,Alexis Beka Beka,DM/M C,21,117,149,France,OGC Nice,10,10,14,10,12,9,9,13,8,13,12,7,11,13,15,13,14,12,14,11,10,8,11,8,13,11,14,12,13,14,13,10,12,13,14,10,10,12,9,8,11,1,3,1,4,3,1,2,1,2,1,3,18,10,8,9,9,10,13,10,1,1,1,1,1,1,20,1,17,1,1,1,1,1,178,77,10,20,9984551,5850,5850,4000,African_Caribbean,116,11,2001/3/29,0,0,6129.0,,49048353
489,Reda Belahyane,Nice,2004,55.0,fr FRA,MF,18.0,2.0,8.0,6.0,5.0,3.0,0.0,3.0,5.0,60.0,2.0,5.0,1.0,4.0,2.0,10.0,0.0,0.0,Matches,55.0,fr FRA,MF,18.0,2.0,2.0,0.99,2.0,0.0,0.0,0.0,0.0,0.0,0.0,0.0,0.0,0.0,0.0,0.0,0.0,0.0,Matches,,,,,,,,,,,,,,,,,,,,,,,,,,,,,,,,,,,,,,,,,,,,,,,,,,,,,,,,55.0,fr FRA,MF,18.0,2.0,0.0,0.0,0.0,5.0,1.0,0.0,0.0,2.0,6.0,0.0,0.0,0.0,23.0,0.0,0.0,,Matches,55.0,fr FRA,MF,18.0,2.0,114.0,113.0,1.0,0.0,0.0,1.0,0.0,1.0,0.0,0.0,0.0,0.0,103.0,0.0,2.0,Matches,55.0,fr FRA,MF,18.0,2.0,103.0,114.0,90.4,1771.0,445.0,40.0,44.0,90.9,50.0,54.0,92.6,7.0,8.0,87.5,0.0,0.0,0.0,0.0,1.0,6.0,0.0,0.0,10.0,Matches,64,fr FRA,MF,18,4,182.0,46.0,5.3,2.0,1,90.0,1,3,31.0,14,1.0,0.0,2.0,-2.0,-0.99,-1.35,1.4,2.5,-1.1,-0.57,-0.95,Matches,55.0,fr FRA,MF,18.0,2.0,135.0,3.0,41.0,92.0,9.0,1.0,135.0,5.0,5.0,100.0,0.0,0.0,113.0,643.0,318.0,3.0,4.0,1.0,3.0,5.0,97.0,1.0,Matches,55.0,fr FRA,MF,18.0,2.0,0.0,1.0,0.0,0.0,0.49,0.0,0.0,,21.9,0.0,0.0,0.0,0.1,0.1,0.09,-0.1,-0.1,Matches,55.0,fr FRA,MF,18.0,4.0,1.0,182.0,2.0,0.0,0.0,0.0,0.0,0.0,0.0,0.0,0.0,0.1,0.1,0.0,0.1,3.0,10.0,1.0,0.0,0.0,0.0,0.0,0.0,0.04,0.01,0.05,0.04,0.05,Matches,Reda Belahyane,M/AM C,18,75,-75,"France,Morocco",OGC Nice,7,6,14,9,14,5,7,9,7,8,14,6,9,14,8,7,1,12,8,14,13,11,13,9,11,7,8,9,9,12,4,3,5,10,4,3,12,8,18,14,12,3,2,3,3,3,4,2,2,2,1,2,14,14,3,13,9,10,14,19,1,1,1,1,1,1,1,1,18,1,1,20,1,1,169,0,7,20,8914000,3600,3600,866,North_African__Middle_Eastern,71,10,2004/6/1,0,0,645.0,,2000031073
490,Youcef Belaïli,Brest,1992,57.0,dz ALG,FWMF,30.0,4.0,5.0,2.0,3.0,2.0,0.0,2.0,7.0,28.6,5.0,2.0,0.0,2.0,1.0,6.0,1.0,0.0,Matches,57.0,dz ALG,FWMF,30.0,4.0,15.0,3.79,8.0,6.0,0.0,0.0,1.0,0.0,2.0,0.51,0.0,2.0,0.0,0.0,0.0,0.0,Matches,,,,,,,,,,,,,,,,,,,,,,,,,,,,,,,,,,,,,,,,,,,,,,,,,,,,,,,,57.0,dz ALG,FWMF,30.0,4.0,3.0,0.0,0.0,11.0,8.0,2.0,21.0,1.0,2.0,0.0,0.0,0.0,19.0,2.0,1.0,66.7,Matches,57.0,dz ALG,FWMF,30.0,4.0,158.0,136.0,22.0,7.0,1.0,7.0,21.0,1.0,14.0,10.0,4.0,0.0,114.0,0.0,7.0,Matches,57.0,dz ALG,FWMF,30.0,4.0,114.0,158.0,72.2,2224.0,569.0,47.0,52.0,90.4,42.0,50.0,84.0,20.0,42.0,47.6,2.0,0.8,1.2,1.2,8.0,4.0,8.0,1.0,14.0,Matches,66,dz ALG,FWMF,30,6,356.0,59.0,10.4,4.0,4,69.0,0,2,40.0,1,0.83,6.0,10.0,-4.0,-1.01,-0.83,4.5,7.2,-2.7,-0.68,-0.38,Matches,57.0,dz ALG,FWMF,30.0,4.0,212.0,2.0,22.0,84.0,110.0,13.0,212.0,15.0,4.0,26.7,7.0,46.7,149.0,1023.0,484.0,16.0,10.0,4.0,16.0,4.0,144.0,31.0,Matches,57.0,dz ALG,FWMF,30.0,4.0,0.0,9.0,1.0,11.1,2.28,0.25,0.0,0.0,16.0,1.0,0.0,0.0,0.7,0.7,0.08,-0.7,-0.7,Matches,57.0,dz ALG,FWMF,30.0,6.0,4.0,356.0,4.0,0.0,2.0,2.0,0.0,0.0,0.0,3.0,0.0,0.7,0.7,0.8,1.4,16.0,14.0,31.0,0.0,0.51,0.51,0.0,0.51,0.17,0.19,0.36,0.17,0.36,Matches,Youcef Belaïli,M/AM L,30,136,145,Algeria,AC Ajaccio,11,13,15,13,15,12,8,14,4,7,14,12,7,15,13,14,11,12,12,13,14,10,12,10,13,11,12,12,14,14,12,9,12,14,13,11,12,10,14,9,12,1,3,1,3,1,3,3,1,2,3,2,18,11,10,12,11,11,11,9,1,1,1,1,1,1,1,17,1,1,20,14,12,14,178,75,10,20,6374837,6800,7000,4750,North_African__Middle_Eastern,136,6,1992/3/14,43,9,22595.0,,12038997
491,Jeanuël Belocian,Rennes,2005,60.0,fr FRA,DF,17.0,5.6,10.0,7.0,3.0,5.0,2.0,5.0,9.0,55.6,4.0,6.0,3.0,3.0,6.0,16.0,11.0,0.0,Matches,60.0,fr FRA,DF,17.0,5.6,3.0,0.53,3.0,0.0,0.0,0.0,0.0,0.0,0.0,0.0,0.0,0.0,0.0,0.0,0.0,0.0,Matches,,,,,,,,,,,,,,,,,,,,,,,,,,,,,,,,,,,,,,,,,,,,,,,,,,,,,,,,60.0,fr FRA,DF,17.0,5.6,1.0,0.0,0.0,6.0,1.0,0.0,3.0,6.0,7.0,0.0,0.0,0.0,28.0,7.0,2.0,77.8,Matches,60.0,fr FRA,DF,17.0,5.6,308.0,278.0,30.0,3.0,0.0,1.0,3.0,27.0,0.0,0.0,0.0,0.0,274.0,0.0,4.0,Matches,60.0,fr FRA,DF,17.0,5.6,274.0,308.0,89.0,4796.0,1397.0,105.0,120.0,87.5,156.0,165.0,94.5,13.0,19.0,68.4,0.0,0.1,0.3,-0.1,1.0,13.0,1.0,0.0,21.0,Matches,71,fr FRA,DF,17,8,506.0,63.0,14.8,5.6,6,81.0,2,2,12.0,20,2.63,16.0,3.0,13.0,2.31,1.79,12.0,5.1,6.9,1.22,0.9,Matches,60.0,fr FRA,DF,17.0,5.6,353.0,24.0,123.0,191.0,41.0,4.0,353.0,4.0,2.0,50.0,1.0,25.0,248.0,1242.0,543.0,8.0,5.0,1.0,4.0,2.0,223.0,21.0,Matches,60.0,fr FRA,DF,17.0,5.6,0.0,1.0,0.0,0.0,0.18,0.0,0.0,,19.3,0.0,0.0,0.0,0.0,0.0,0.03,0.0,0.0,Matches,60.0,fr FRA,DF,17.0,8.0,6.0,506.0,5.6,0.0,0.0,0.0,0.0,0.0,0.0,1.0,0.0,0.0,0.0,0.1,0.1,8.0,21.0,21.0,0.0,0.0,0.0,0.0,0.0,0.01,0.02,0.02,0.01,0.02,Matches,Jeanuël Belocian,D LC,17,93,-8,"France,Guadeloupe",Stade Rennais FC,7,10,11,6,12,7,12,10,7,11,11,8,12,12,10,11,10,11,11,11,10,14,12,8,9,11,10,10,11,13,10,12,12,11,12,10,13,6,11,6,8,4,3,3,2,2,4,1,2,1,1,2,11,13,6,13,12,12,12,11,1,15,20,1,12,1,15,1,10,1,1,1,1,1,182,73,20,8,8199999,4645,4645,1549,African_Caribbean,93,17,2005/2/17,0,0,749.0,,2000115205
492,Salim Ben Seghir,Marseille,2003,62.0,fr FRA,MF,19.0,0.0,0.0,0.0,0.0,0.0,0.0,0.0,0.0,,0.0,1.0,0.0,1.0,0.0,0.0,0.0,0.0,Matches,62.0,fr FRA,MF,19.0,0.0,0.0,0.0,0.0,0.0,0.0,0.0,0.0,0.0,0.0,0.0,0.0,0.0,0.0,0.0,0.0,0.0,Matches,,,,,,,,,,,,,,,,,,,,,,,,,,,,,,,,,,,,,,,,,,,,,,,,,,,,,,,,62.0,fr FRA,MF,19.0,0.0,0.0,0.0,0.0,0.0,0.0,0.0,0.0,0.0,0.0,0.0,0.0,0.0,2.0,0.0,0.0,,Matches,62.0,fr FRA,MF,19.0,0.0,2.0,2.0,0.0,0.0,0.0,0.0,0.0,0.0,0.0,0.0,0.0,0.0,2.0,0.0,0.0,Matches,62.0,fr FRA,MF,19.0,0.0,2.0,2.0,100.0,18.0,1.0,2.0,2.0,100.0,0.0,0.0,,0.0,0.0,,0.0,0.0,0.0,0.0,0.0,0.0,0.0,0.0,0.0,Matches,73,fr FRA,MF,19,1,4.0,4.0,0.1,0.0,0,,0,1,4.0,3,3.0,0.0,0.0,0.0,0.0,-0.71,0.4,0.0,0.4,6.6,6.01,Matches,62.0,fr FRA,MF,19.0,0.0,4.0,0.0,0.0,2.0,2.0,0.0,4.0,0.0,0.0,,0.0,,3.0,13.0,6.0,0.0,0.0,0.0,1.0,2.0,3.0,0.0,Matches,62.0,fr FRA,MF,19.0,0.0,0.0,0.0,0.0,,0.0,0.0,,,,0.0,0.0,0.0,0.0,0.0,,0.0,0.0,Matches,62.0,fr FRA,MF,19.0,1.0,0.0,4.0,0.0,0.0,0.0,0.0,0.0,0.0,0.0,0.0,0.0,0.0,0.0,0.0,0.0,0.0,0.0,0.0,0.0,0.0,0.0,0.0,0.0,0.0,0.0,0.0,0.0,0.0,Matches,Salim Ben Seghir,AM RL,19,90,-75,"France,Morocco",Olympique de Marseille,8,13,10,13,10,12,9,8,7,5,13,5,8,12,9,12,1,8,8,4,9,12,11,8,9,7,8,9,13,13,8,5,9,13,8,5,17,14,11,7,13,2,1,1,1,3,2,2,1,2,1,2,16,13,3,8,11,11,10,15,1,1,1,1,1,1,1,1,1,12,15,8,20,15,174,57,12,20,20490000,4499,4499,1499,North_African__Middle_Eastern,82,9,2003/2/24,0,0,645.0,,49060705
493,Patrick Berg,Lens,1997,65.0,no NOR,MFFW,24.0,0.3,0.0,0.0,0.0,0.0,0.0,0.0,1.0,0.0,1.0,0.0,0.0,0.0,1.0,1.0,0.0,0.0,Matches,65.0,no NOR,MFFW,24.0,0.3,2.0,7.2,2.0,0.0,0.0,0.0,0.0,0.0,0.0,0.0,0.0,0.0,0.0,0.0,0.0,0.0,Matches,,,,,,,,,,,,,,,,,,,,,,,,,,,,,,,,,,,,,,,,,,,,,,,,,,,,,,,,65.0,no NOR,MFFW,24.0,0.3,0.0,0.0,0.0,1.0,0.0,0.0,0.0,1.0,0.0,0.0,0.0,0.0,1.0,0.0,0.0,,Matches,65.0,no NOR,MFFW,24.0,0.3,20.0,20.0,0.0,0.0,0.0,0.0,0.0,0.0,0.0,0.0,0.0,0.0,17.0,0.0,1.0,Matches,65.0,no NOR,MFFW,24.0,0.3,17.0,20.0,85.0,319.0,133.0,8.0,8.0,100.0,5.0,6.0,83.3,3.0,3.0,100.0,0.0,0.0,0.0,0.0,1.0,3.0,1.0,0.0,3.0,Matches,77,no NOR,MFFW,24,3,25.0,8.0,0.7,0.3,0,,0,3,8.0,1,3.0,0.0,2.0,-2.0,-7.2,-8.29,0.3,1.2,-0.9,-3.19,-3.83,Matches,65.0,no NOR,MFFW,24.0,0.3,23.0,0.0,5.0,15.0,3.0,0.0,23.0,1.0,0.0,0.0,1.0,100.0,17.0,83.0,29.0,0.0,0.0,0.0,1.0,0.0,16.0,4.0,Matches,65.0,no NOR,MFFW,24.0,0.3,0.0,0.0,0.0,,0.0,0.0,,,,0.0,0.0,0.0,0.0,0.0,,0.0,0.0,Matches,65.0,no NOR,MFFW,24.0,3.0,0.0,25.0,0.3,0.0,0.0,0.0,0.0,0.0,0.0,0.0,0.0,0.0,0.0,0.0,0.0,0.0,3.0,4.0,0.0,0.0,0.0,0.0,0.0,0.0,0.17,0.17,0.0,0.17,Matches,Patrick Berg,DM,24,135,143,Norway,FK Bodø/Glimt,10,10,10,10,13,10,6,10,7,14,14,10,13,14,15,16,12,15,12,14,14,16,9,15,12,16,17,16,11,13,14,7,18,10,15,12,16,6,14,6,11,2,1,3,1,2,1,1,2,3,3,3,12,14,3,15,15,18,16,16,1,1,1,1,1,1,20,1,14,1,1,1,1,1,177,72,9,20,8951987,6550,6750,5250,Northern_European,136,4,1997/11/24,11,0,8970.0,,53099570
494,Jason Berthomier,Clermont Foot,1990,70.0,fr FRA,MF,32.0,0.3,0.0,0.0,0.0,0.0,0.0,0.0,0.0,,0.0,0.0,0.0,0.0,0.0,0.0,0.0,0.0,Matches,70.0,fr FRA,MF,32.0,0.3,0.0,0.0,0.0,0.0,0.0,0.0,0.0,0.0,0.0,0.0,0.0,0.0,0.0,0.0,0.0,0.0,Matches,,,,,,,,,,,,,,,,,,,,,,,,,,,,,,,,,,,,,,,,,,,,,,,,,,,,,,,,70.0,fr FRA,MF,32.0,0.3,0.0,0.0,0.0,0.0,0.0,0.0,0.0,0.0,0.0,0.0,0.0,0.0,2.0,0.0,1.0,0.0,Matches,70.0,fr FRA,MF,32.0,0.3,19.0,17.0,2.0,1.0,0.0,0.0,0.0,0.0,1.0,0.0,0.0,0.0,19.0,0.0,0.0,Matches,70.0,fr FRA,MF,32.0,0.3,19.0,19.0,100.0,248.0,34.0,13.0,13.0,100.0,4.0,4.0,100.0,1.0,1.0,100.0,0.0,0.0,0.0,0.0,0.0,1.0,0.0,0.0,1.0,Matches,84,fr FRA,MF,32,2,23.0,12.0,0.7,0.3,0,,0,2,12.0,2,3.0,0.0,0.0,0.0,0.0,0.11,0.1,0.6,-0.5,-2.14,-1.87,Matches,70.0,fr FRA,MF,32.0,0.3,20.0,0.0,1.0,13.0,6.0,0.0,20.0,0.0,0.0,,0.0,,16.0,69.0,20.0,0.0,0.0,0.0,0.0,0.0,17.0,2.0,Matches,70.0,fr FRA,MF,32.0,0.3,0.0,0.0,0.0,,0.0,0.0,,,,0.0,0.0,0.0,0.0,0.0,,0.0,0.0,Matches,70.0,fr FRA,MF,32.0,2.0,0.0,23.0,0.3,0.0,0.0,0.0,0.0,0.0,0.0,0.0,0.0,0.0,0.0,0.0,0.0,0.0,1.0,2.0,0.0,0.0,0.0,0.0,0.0,0.0,0.0,0.0,0.0,0.0,Matches,Jason Berthomier,M/AM LC,32,122,125,France,Valenciennes FC,14,13,12,10,14,14,9,13,5,4,15,11,5,15,7,13,8,14,14,14,14,13,10,10,12,8,14,16,11,14,14,9,13,12,13,11,12,8,9,8,9,1,1,2,4,3,2,2,2,4,3,3,12,13,6,12,14,13,12,14,1,1,1,1,1,1,1,1,18,1,15,20,14,1,177,74,20,8,347975206,6100,6100,3500,Northern_European,124,6,1990/1/6,0,0,8431.0,,49030681
495,El Bilal Touré,Reims,2001,71.0,ml MLI,FW,20.0,1.0,0.0,0.0,0.0,0.0,0.0,0.0,0.0,,0.0,2.0,0.0,2.0,0.0,0.0,1.0,0.0,Matches,71.0,ml MLI,FW,20.0,1.0,2.0,1.98,2.0,0.0,0.0,0.0,0.0,0.0,0.0,0.0,0.0,0.0,0.0,0.0,0.0,0.0,Matches,,,,,,,,,,,,,,,,,,,,,,,,,,,,,,,,,,,,,,,,,,,,,,,,,,,,,,,,71.0,ml MLI,FW,20.0,1.0,0.0,0.0,0.0,3.0,1.0,0.0,0.0,0.0,0.0,0.0,0.0,0.0,3.0,3.0,6.0,33.3,Matches,71.0,ml MLI,FW,20.0,1.0,20.0,16.0,4.0,0.0,0.0,0.0,0.0,0.0,0.0,0.0,0.0,0.0,16.0,0.0,1.0,Matches,71.0,ml MLI,FW,20.0,1.0,16.0,20.0,80.0,234.0,46.0,9.0,11.0,81.8,6.0,7.0,85.7,0.0,1.0,0.0,0.0,0.1,0.0,-0.1,2.0,1.0,1.0,0.0,1.0,Matches,85,ml MLI,FW,20,3,91.0,30.0,2.7,1.0,1,63.0,0,2,14.0,2,0.33,0.0,4.0,-4.0,-3.96,-4.06,0.8,0.8,0.1,0.06,-0.18,Matches,71.0,ml MLI,FW,20.0,1.0,29.0,1.0,3.0,13.0,13.0,3.0,29.0,2.0,1.0,50.0,1.0,50.0,13.0,61.0,15.0,0.0,0.0,0.0,1.0,2.0,17.0,1.0,Matches,71.0,ml MLI,FW,20.0,1.0,0.0,1.0,1.0,100.0,0.99,0.99,0.0,0.0,26.1,0.0,0.0,0.0,0.0,0.0,0.03,0.0,0.0,Matches,71.0,ml MLI,FW,20.0,3.0,1.0,91.0,1.0,0.0,0.0,0.0,0.0,0.0,0.0,0.0,0.0,0.0,0.0,0.1,0.1,0.0,1.0,1.0,0.0,0.0,0.0,0.0,0.0,0.03,0.05,0.09,0.03,0.09,Matches,El Bilal Touré,S,20,122,147,"Mali,Ivory Coast",Almería,8,7,12,12,14,9,12,11,10,6,12,13,6,14,8,12,10,12,11,11,11,11,12,8,12,9,9,10,16,11,11,11,11,14,14,13,11,7,10,8,6,2,1,2,3,1,3,2,3,3,3,4,15,14,12,7,10,8,14,10,1,1,1,1,1,1,1,1,1,1,1,1,10,20,185,72,10,20,7992601,6100,6100,4200,African_Caribbean,120,17,2001/10/3,13,4,4814.0,,12081007
496,Veljko Birmančević,Toulouse,1998,73.0,rs SRB,FWMF,24.0,4.9,13.0,7.0,5.0,4.0,4.0,7.0,21.0,33.3,14.0,12.0,2.0,10.0,7.0,20.0,1.0,0.0,Matches,73.0,rs SRB,FWMF,24.0,4.9,15.0,3.02,8.0,0.0,0.0,3.0,4.0,0.0,2.0,0.4,1.0,0.0,0.0,0.0,1.0,0.0,Matches,,,,,,,,,,,,,,,,,,,,,,,,,,,,,,,,,,,,,,,,,,,,,,,,,,,,,,,,73.0,rs SRB,FWMF,24.0,4.9,0.0,0.0,0.0,5.0,8.0,0.0,5.0,7.0,7.0,1.0,0.0,0.0,25.0,3.0,12.0,20.0,Matches,73.0,rs SRB,FWMF,24.0,4.9,161.0,152.0,5.0,1.0,0.0,2.0,5.0,3.0,1.0,0.0,0.0,0.0,107.0,4.0,5.0,Matches,73.0,rs SRB,FWMF,24.0,4.9,107.0,161.0,66.5,1391.0,503.0,62.0,87.0,71.3,33.0,45.0,73.3,2.0,8.0,25.0,0.0,0.2,0.2,-0.2,2.0,9.0,4.0,0.0,16.0,Matches,87,rs SRB,FWMF,24,25,444.0,18.0,13.0,4.9,2,57.0,0,23,14.0,7,1.16,5.0,10.0,-5.0,-1.01,-0.98,6.0,9.9,-4.0,-0.8,-0.78,Matches,73.0,rs SRB,FWMF,24.0,4.9,240.0,7.0,37.0,90.0,116.0,21.0,240.0,22.0,5.0,22.7,12.0,54.5,182.0,1095.0,521.0,21.0,13.0,11.0,13.0,3.0,169.0,50.0,Matches,73.0,rs SRB,FWMF,24.0,4.9,0.0,13.0,3.0,23.1,2.64,0.61,0.0,0.0,19.3,0.0,0.0,0.0,1.3,1.3,0.1,-1.3,-1.3,Matches,73.0,rs SRB,FWMF,24.0,25.0,2.0,444.0,4.9,0.0,0.0,0.0,0.0,0.0,0.0,0.0,0.0,1.3,1.3,0.2,1.5,21.0,16.0,50.0,0.0,0.0,0.0,0.0,0.0,0.27,0.05,0.31,0.27,0.31,Matches,Veljko Birmančević,AM L,24,127,140,Serbia,Toulouse FC,13,12,15,11,13,13,6,13,5,5,12,13,8,14,13,14,11,12,10,13,11,12,16,8,11,9,11,11,14,14,10,8,10,15,10,9,12,12,14,10,13,2,2,3,1,2,1,2,3,2,2,1,13,12,8,13,13,11,10,10,1,1,1,1,5,1,1,14,8,8,20,14,14,15,179,67,12,20,3926353,6350,6350,3250,Mediterranean_Hispanic,123,6,1998/3/5,3,0,12137.0,,62182264
497,Rubén Blanco,Marseille,1995,75.0,es ESP,GK,27.0,5.5,0.0,0.0,0.0,0.0,0.0,0.0,0.0,,0.0,0.0,0.0,0.0,0.0,0.0,1.0,0.0,Matches,75.0,es ESP,GK,27.0,5.5,1.0,0.18,1.0,0.0,0.0,0.0,0.0,0.0,0.0,0.0,0.0,0.0,0.0,0.0,0.0,0.0,Matches,4.0,es ESP,GK,27.0,5.5,6.0,0.0,0.0,1.0,2.0,3.9,0.2,-0.1,-0.02,11.0,47.0,23.4,165.0,31.0,20.6,27.4,41.0,31.7,32.1,73.0,3.0,4.1,7.0,1.27,17.9,Matches,4.0,es ESP,GK,27.0,6.0,6.0,495.0,5.5,6.0,1.09,19.0,15.0,68.4,1.0,3.0,2.0,0.0,0.0,0.0,0.0,0.0,0.0,,Matches,75.0,es ESP,GK,27.0,5.5,0.0,0.0,0.0,0.0,1.0,0.0,0.0,0.0,0.0,0.0,0.0,0.0,7.0,1.0,0.0,100.0,Matches,75.0,es ESP,GK,27.0,5.5,206.0,160.0,46.0,5.0,0.0,0.0,0.0,0.0,0.0,0.0,0.0,0.0,166.0,0.0,0.0,Matches,75.0,es ESP,GK,27.0,5.5,166.0,206.0,80.6,3744.0,2408.0,42.0,42.0,100.0,90.0,91.0,98.9,32.0,71.0,45.1,0.0,0.0,0.0,0.0,0.0,0.0,0.0,0.0,0.0,Matches,89,es ESP,GK,27,6,495.0,83.0,14.5,5.5,6,83.0,5,0,,32,1.0,8.0,6.0,2.0,0.36,-0.41,8.3,5.6,2.7,0.49,-0.12,Matches,75.0,es ESP,GK,27.0,5.5,216.0,169.0,216.0,0.0,0.0,0.0,216.0,0.0,0.0,,0.0,,167.0,888.0,490.0,0.0,0.0,0.0,0.0,0.0,119.0,0.0,Matches,75.0,es ESP,GK,27.0,5.5,0.0,0.0,0.0,,0.0,0.0,,,,0.0,0.0,0.0,0.0,0.0,,0.0,0.0,Matches,75.0,es ESP,GK,27.0,6.0,6.0,495.0,5.5,0.0,0.0,0.0,0.0,0.0,0.0,0.0,0.0,0.0,0.0,0.0,0.0,0.0,0.0,0.0,0.0,0.0,0.0,0.0,0.0,0.0,0.0,0.0,0.0,0.0,Matches,Rubén Blanco,GK,27,135,156,Spain,Vigo,4,3,2,1,11,8,1,3,1,2,13,4,3,7,9,13,12,15,11,7,12,6,7,8,1,15,13,11,13,15,11,14,11,11,13,11,7,5,12,14,15,13,10,14,7,14,12,14,16,14,13,11,11,13,5,13,13,10,12,16,20,1,1,1,1,1,1,1,1,1,1,1,1,1,189,80,12,20,5343053,6700,6700,5400,Mediterranean_Hispanic,132,6,1995/7/25,0,0,14410.0,Olympique de Marseille,67156610
498,Joaquín Blázquez,Brest,2001,78.0,ar ARG,GK,21.0,1.0,0.0,0.0,0.0,0.0,0.0,0.0,0.0,,0.0,0.0,0.0,0.0,0.0,0.0,2.0,0.0,Matches,78.0,ar ARG,GK,21.0,1.0,0.0,0.0,0.0,0.0,0.0,0.0,0.0,0.0,0.0,0.0,0.0,0.0,0.0,0.0,0.0,0.0,Matches,5.0,ar ARG,GK,21.0,1.0,0.0,0.0,0.0,0.0,0.0,0.2,0.06,0.2,0.17,8.0,13.0,61.5,18.0,3.0,61.1,45.7,11.0,18.2,26.3,11.0,2.0,18.2,0.0,0.0,3.5,Matches,5.0,ar ARG,GK,21.0,1.0,1.0,90.0,1.0,0.0,0.0,3.0,3.0,100.0,0.0,1.0,0.0,1.0,100.0,0.0,0.0,0.0,0.0,,Matches,78.0,ar ARG,GK,21.0,1.0,0.0,0.0,0.0,0.0,0.0,0.0,0.0,0.0,0.0,0.0,0.0,0.0,0.0,0.0,0.0,,Matches,78.0,ar ARG,GK,21.0,1.0,29.0,13.0,16.0,5.0,0.0,1.0,0.0,0.0,0.0,0.0,0.0,0.0,21.0,0.0,1.0,Matches,78.0,ar ARG,GK,21.0,1.0,21.0,29.0,72.4,728.0,535.0,6.0,6.0,100.0,7.0,8.0,87.5,8.0,14.0,57.1,0.0,0.0,0.0,0.0,0.0,1.0,0.0,0.0,0.0,Matches,92,ar ARG,GK,21,1,90.0,90.0,2.6,1.0,1,90.0,1,0,,33,1.0,0.0,0.0,0.0,0.0,0.27,1.5,1.0,0.4,0.43,0.78,Matches,78.0,ar ARG,GK,21.0,1.0,32.0,26.0,32.0,0.0,0.0,0.0,32.0,0.0,0.0,,0.0,,15.0,104.0,55.0,0.0,0.0,0.0,0.0,0.0,6.0,0.0,Matches,78.0,ar ARG,GK,21.0,1.0,0.0,0.0,0.0,,0.0,0.0,,,,0.0,0.0,0.0,0.0,0.0,,0.0,0.0,Matches,78.0,ar ARG,GK,21.0,1.0,1.0,90.0,1.0,0.0,0.0,0.0,0.0,0.0,0.0,0.0,0.0,0.0,0.0,0.0,0.0,0.0,0.0,0.0,0.0,0.0,0.0,0.0,0.0,0.0,0.0,0.0,0.0,0.0,Matches,Joaquín Blázquez,GK,21,112,148,"Argentina,Italy",Club Atlético Talleres de Córdoba,4,2,2,2,5,5,1,1,1,3,13,1,2,11,10,8,12,11,11,10,10,13,3,11,1,14,7,10,11,10,5,16,14,11,7,14,11,7,4,6,11,14,12,12,8,15,11,12,14,14,7,14,10,8,4,12,10,11,12,18,20,1,1,1,1,1,1,1,1,1,1,1,1,1,193,91,8,20,3551017,5441,5441,1991,Mediterranean_Hispanic,110,8,2001/1/28,0,0,3537.0,Stade Brestois 29,14201595
499,Myron Boadu,Monaco,2001,79.0,nl NED,FW,21.0,3.3,3.0,3.0,0.0,2.0,1.0,1.0,7.0,14.3,6.0,1.0,0.0,1.0,0.0,3.0,1.0,0.0,Matches,79.0,nl NED,FW,21.0,3.3,7.0,2.14,7.0,0.0,0.0,0.0,0.0,0.0,0.0,0.0,0.0,0.0,0.0,0.0,0.0,0.0,Matches,,,,,,,,,,,,,,,,,,,,,,,,,,,,,,,,,,,,,,,,,,,,,,,,,,,,,,,,79.0,nl NED,FW,21.0,3.3,0.0,0.0,0.0,7.0,3.0,5.0,1.0,0.0,3.0,0.0,0.0,0.0,11.0,11.0,9.0,55.0,Matches,79.0,nl NED,FW,21.0,3.3,57.0,54.0,3.0,0.0,0.0,0.0,1.0,0.0,0.0,0.0,0.0,0.0,39.0,0.0,2.0,Matches,79.0,nl NED,FW,21.0,3.3,39.0,57.0,68.4,455.0,114.0,25.0,34.0,73.5,9.0,15.0,60.0,1.0,1.0,100.0,0.0,0.3,0.5,-0.3,4.0,3.0,3.0,1.0,3.0,Matches,93,nl NED,FW,21,12,295.0,25.0,8.6,3.3,3,64.0,1,9,11.0,13,1.75,6.0,6.0,0.0,0.0,-0.35,7.0,4.5,2.5,0.77,0.59,Matches,79.0,nl NED,FW,21.0,3.3,98.0,1.0,7.0,39.0,53.0,23.0,98.0,4.0,1.0,25.0,3.0,75.0,65.0,336.0,138.0,5.0,1.0,3.0,17.0,7.0,75.0,21.0,Matches,79.0,nl NED,FW,21.0,3.3,3.0,7.0,5.0,71.4,2.14,1.53,0.43,0.6,11.5,0.0,0.0,0.0,2.6,2.6,0.37,0.4,0.4,Matches,79.0,nl NED,FW,21.0,12.0,3.0,295.0,3.3,3.0,0.0,3.0,3.0,0.0,0.0,0.0,0.0,2.6,2.6,0.3,2.9,5.0,3.0,21.0,0.92,0.0,0.92,0.92,0.92,0.79,0.09,0.88,0.79,0.88,Matches,Myron Boadu,AM/S RL,21,134,156,"Holland,Ghana",AS Monaco,6,8,12,11,13,5,9,7,3,4,12,13,5,13,13,12,11,11,10,10,9,14,12,4,14,4,8,12,17,14,14,14,13,16,13,12,10,4,16,12,12,1,3,2,1,4,2,2,4,2,2,1,8,13,5,12,13,12,14,12,1,1,1,1,1,1,1,14,10,14,17,14,17,20,183,71,16,20,17600000,6891,6591,5491,African_Caribbean,123,15,2001/1/14,1,1,23014.0,,37060951
500,Jérôme Boateng,Lyon,1988,80.0,de GER,DF,33.0,4.8,3.0,0.0,2.0,1.0,0.0,2.0,6.0,33.3,4.0,8.0,5.0,3.0,6.0,9.0,16.0,0.0,Matches,80.0,de GER,DF,33.0,4.8,2.0,0.42,2.0,0.0,0.0,0.0,0.0,0.0,0.0,0.0,0.0,0.0,0.0,0.0,0.0,0.0,Matches,,,,,,,,,,,,,,,,,,,,,,,,,,,,,,,,,,,,,,,,,,,,,,,,,,,,,,,,80.0,de GER,DF,33.0,4.8,0.0,0.0,0.0,1.0,0.0,0.0,1.0,6.0,0.0,0.0,0.0,1.0,18.0,7.0,1.0,87.5,Matches,80.0,de GER,DF,33.0,4.8,223.0,217.0,6.0,5.0,1.0,1.0,1.0,0.0,0.0,0.0,0.0,0.0,179.0,0.0,1.0,Matches,80.0,de GER,DF,33.0,4.8,179.0,223.0,80.3,3852.0,1320.0,44.0,52.0,84.6,111.0,126.0,88.1,21.0,39.0,53.8,0.0,0.2,0.2,-0.2,1.0,7.0,2.0,0.0,6.0,Matches,94,de GER,DF,33,8,428.0,54.0,12.5,4.8,6,67.0,1,2,12.0,14,1.88,8.0,6.0,2.0,0.42,-0.06,7.1,7.2,-0.1,-0.03,-0.32,Matches,80.0,de GER,DF,33.0,4.8,261.0,47.0,138.0,122.0,1.0,0.0,261.0,0.0,0.0,,0.0,,180.0,742.0,302.0,0.0,0.0,0.0,0.0,0.0,167.0,0.0,Matches,80.0,de GER,DF,33.0,4.8,0.0,0.0,0.0,,0.0,0.0,,,,0.0,0.0,0.0,0.0,0.0,,0.0,0.0,Matches,80.0,de GER,DF,33.0,8.0,6.0,428.0,4.8,0.0,0.0,0.0,0.0,0.0,0.0,0.0,0.0,0.0,0.0,0.2,0.2,0.0,6.0,0.0,0.0,0.0,0.0,0.0,0.0,0.0,0.04,0.04,0.0,0.04,Matches,Jérôme Boateng,D C,33,136,175,"Germany,Ghana",Olympique Lyonnais,4,11,10,6,13,5,11,6,11,15,15,6,15,13,12,16,12,16,12,14,14,11,11,14,5,15,12,10,10,9,15,17,8,10,7,15,14,9,16,11,10,3,2,1,2,2,1,1,1,2,1,3,10,15,15,10,13,11,14,9,1,12,20,12,8,8,1,1,1,1,1,1,1,1,190,94,16,20,1634788,6600,6800,6400,Mixed_Race,136,15,1988/9/3,76,1,95889.0,,35002579
501,Quentin Boisgard,Lorient,1997,82.0,fr FRA,MF,25.0,2.0,6.0,2.0,1.0,4.0,1.0,3.0,4.0,75.0,1.0,3.0,1.0,2.0,4.0,10.0,2.0,0.0,Matches,82.0,fr FRA,MF,25.0,2.0,9.0,4.38,9.0,0.0,0.0,0.0,0.0,0.0,1.0,0.49,1.0,0.0,0.0,0.0,0.0,0.0,Matches,,,,,,,,,,,,,,,,,,,,,,,,,,,,,,,,,,,,,,,,,,,,,,,,,,,,,,,,82.0,fr FRA,MF,25.0,2.0,1.0,0.0,0.0,3.0,1.0,0.0,8.0,4.0,2.0,0.0,0.0,0.0,9.0,2.0,0.0,100.0,Matches,82.0,fr FRA,MF,25.0,2.0,98.0,91.0,7.0,1.0,0.0,0.0,8.0,0.0,5.0,3.0,2.0,0.0,79.0,0.0,2.0,Matches,82.0,fr FRA,MF,25.0,2.0,79.0,98.0,80.6,1013.0,236.0,54.0,60.0,90.0,19.0,25.0,76.0,2.0,6.0,33.3,0.0,0.1,0.4,-0.1,4.0,9.0,4.0,0.0,11.0,Matches,96,fr FRA,MF,25,5,184.0,37.0,5.4,2.0,1,67.0,0,4,29.0,7,1.2,2.0,0.0,2.0,0.98,1.06,2.6,1.6,0.9,0.44,0.85,Matches,82.0,fr FRA,MF,25.0,2.0,135.0,2.0,21.0,58.0,58.0,8.0,135.0,4.0,1.0,25.0,2.0,50.0,90.0,566.0,263.0,7.0,4.0,1.0,5.0,2.0,84.0,15.0,Matches,82.0,fr FRA,MF,25.0,2.0,1.0,6.0,3.0,50.0,2.93,1.47,0.17,0.33,18.5,0.0,0.0,0.0,0.4,0.4,0.07,0.6,0.6,Matches,82.0,fr FRA,MF,25.0,5.0,1.0,184.0,2.0,1.0,0.0,1.0,1.0,0.0,0.0,1.0,0.0,0.4,0.4,0.1,0.5,7.0,11.0,15.0,0.49,0.0,0.49,0.49,0.49,0.19,0.05,0.25,0.19,0.25,Matches,Quentin Boisgard,M/AM RLC,25,120,135,France,FC Lorient,13,12,14,10,15,12,4,11,3,6,12,14,6,15,5,12,8,11,12,13,12,8,15,9,11,11,13,12,14,14,13,7,13,12,12,12,11,5,10,5,13,2,1,3,4,3,2,1,1,1,2,1,13,11,3,14,11,13,12,19,1,1,1,1,1,1,1,15,17,15,18,20,16,10,174,75,7,20,1372539,5846,5996,3599,Mediterranean_Hispanic,115,6,1997/3/17,0,0,5439.0,,48037012
502,Badredine Bouanani,Nice,2004,86.0,dz ALG,FWMF,17.0,9.6,13.0,9.0,2.0,7.0,4.0,7.0,14.0,50.0,7.0,4.0,0.0,4.0,1.0,14.0,2.0,0.0,Matches,86.0,dz ALG,FWMF,17.0,9.6,45.0,4.7,28.0,3.0,8.0,3.0,2.0,1.0,7.0,0.73,5.0,0.0,0.0,2.0,0.0,0.0,Matches,,,,,,,,,,,,,,,,,,,,,,,,,,,,,,,,,,,,,,,,,,,,,,,,,,,,,,,,86.0,dz ALG,FWMF,17.0,9.6,0.0,0.0,0.0,9.0,21.0,1.0,47.0,1.0,9.0,0.0,0.0,0.0,43.0,1.0,7.0,12.5,Matches,86.0,dz ALG,FWMF,17.0,9.6,378.0,352.0,25.0,6.0,6.0,5.0,47.0,6.0,13.0,6.0,2.0,0.0,288.0,1.0,12.0,Matches,86.0,dz ALG,FWMF,17.0,9.6,288.0,378.0,76.2,4811.0,1017.0,146.0,169.0,86.4,102.0,125.0,81.6,29.0,59.0,49.2,4.0,3.5,2.6,0.5,22.0,18.0,18.0,8.0,31.0,Matches,104,dz ALG,FWMF,17,19,863.0,45.0,25.2,9.6,9,71.0,1,10,22.0,3,1.63,12.0,7.0,5.0,0.52,0.31,15.5,10.8,4.7,0.49,0.21,Matches,86.0,dz ALG,FWMF,17.0,9.6,498.0,1.0,61.0,203.0,243.0,35.0,498.0,51.0,27.0,52.9,20.0,39.2,406.0,3033.0,1541.0,47.0,25.0,16.0,23.0,13.0,389.0,98.0,Matches,86.0,dz ALG,FWMF,17.0,9.6,0.0,24.0,10.0,41.7,2.5,1.04,0.0,0.0,21.1,1.0,0.0,0.0,1.7,1.7,0.07,-1.7,-1.7,Matches,86.0,dz ALG,FWMF,17.0,19.0,9.0,863.0,9.6,0.0,4.0,4.0,0.0,0.0,0.0,0.0,0.0,1.7,1.7,3.5,5.2,47.0,31.0,98.0,0.0,0.42,0.42,0.0,0.42,0.18,0.36,0.54,0.18,0.54,Matches,Badredine Bouanani,AM RC,17,90,-85,"France,Algeria",OGC Nice,9,13,14,10,14,8,8,8,4,7,9,1,9,14,6,8,6,7,9,10,10,10,13,11,12,8,9,10,14,14,9,6,12,14,5,4,9,5,20,11,18,2,3,3,1,1,1,1,2,1,2,2,16,11,6,12,12,13,11,14,1,1,1,1,1,1,1,1,1,12,13,15,20,1,172,0,20,8,19799999,4503,4503,1256,North_African__Middle_Eastern,90,7,2004/12/8,0,0,645.0,,2000100062
503,Sofiane Boufal,Angers,1993,89.0,ma MAR,FWMF,28.0,9.3,14.0,9.0,7.0,4.0,3.0,3.0,14.0,21.4,11.0,6.0,0.0,6.0,5.0,19.0,1.0,0.0,Matches,89.0,ma MAR,FWMF,28.0,9.3,52.0,5.61,38.0,3.0,4.0,1.0,6.0,0.0,6.0,0.65,3.0,1.0,0.0,0.0,2.0,0.0,Matches,,,,,,,,,,,,,,,,,,,,,,,,,,,,,,,,,,,,,,,,,,,,,,,,,,,,,,,,89.0,ma MAR,FWMF,28.0,9.3,3.0,1.0,1.0,20.0,20.0,2.0,37.0,5.0,9.0,1.0,0.0,0.0,36.0,1.0,9.0,10.0,Matches,89.0,ma MAR,FWMF,28.0,9.3,487.0,446.0,39.0,11.0,4.0,6.0,37.0,10.0,16.0,10.0,0.0,0.0,370.0,2.0,13.0,Matches,89.0,ma MAR,FWMF,28.0,9.3,370.0,487.0,76.0,5643.0,1574.0,203.0,239.0,84.9,124.0,161.0,77.0,25.0,50.0,50.0,3.0,2.9,1.7,0.1,27.0,30.0,10.0,1.0,56.0,Matches,107,ma MAR,FWMF,28,13,834.0,64.0,24.4,9.3,9,79.0,2,4,31.0,0,0.54,12.0,23.0,-11.0,-1.19,0.1,13.5,15.6,-2.1,-0.23,0.42,Matches,89.0,ma MAR,FWMF,28.0,9.3,613.0,1.0,43.0,298.0,285.0,38.0,611.0,80.0,39.0,48.8,36.0,45.0,499.0,3394.0,1573.0,49.0,33.0,17.0,28.0,19.0,488.0,94.0,Matches,89.0,ma MAR,FWMF,28.0,9.3,4.0,21.0,9.0,42.9,2.27,0.97,0.1,0.22,20.8,4.0,2.0,2.0,3.6,2.1,0.1,0.4,-0.1,Matches,89.0,ma MAR,FWMF,28.0,13.0,9.0,834.0,9.3,4.0,3.0,7.0,2.0,2.0,2.0,3.0,1.0,3.6,2.1,2.9,5.0,49.0,56.0,94.0,0.43,0.32,0.76,0.22,0.54,0.39,0.32,0.71,0.22,0.54,Matches,Sofiane Boufal,AM RLC,28,134,144,"Morocco,France",Angers SCO,12,13,16,12,15,13,7,13,8,6,12,13,5,16,10,10,8,13,11,14,10,12,17,7,12,6,10,8,14,15,17,6,12,14,13,9,11,8,12,10,14,3,2,2,1,3,3,2,2,3,1,2,13,13,9,13,14,12,10,16,1,1,1,1,1,1,1,14,1,14,20,18,18,15,175,75,10,20,5541345,6700,6700,5250,North_African__Middle_Eastern,127,11,1993/9/17,29,4,29999.0,,85104863
504,Joe Bryan,Nice,1993,95.0,eng ENG,MFDF,28.0,2.0,5.0,4.0,3.0,2.0,0.0,4.0,4.0,100.0,0.0,2.0,0.0,2.0,1.0,6.0,1.0,0.0,Matches,95.0,eng ENG,MFDF,28.0,2.0,1.0,0.51,1.0,0.0,0.0,0.0,0.0,0.0,0.0,0.0,0.0,0.0,0.0,0.0,0.0,0.0,Matches,,,,,,,,,,,,,,,,,,,,,,,,,,,,,,,,,,,,,,,,,,,,,,,,,,,,,,,,95.0,eng ENG,MFDF,28.0,2.0,3.0,0.0,0.0,4.0,3.0,1.0,3.0,1.0,4.0,0.0,0.0,0.0,16.0,0.0,5.0,0.0,Matches,95.0,eng ENG,MFDF,28.0,2.0,101.0,86.0,15.0,0.0,0.0,0.0,3.0,15.0,0.0,0.0,0.0,0.0,80.0,0.0,3.0,Matches,95.0,eng ENG,MFDF,28.0,2.0,80.0,101.0,79.2,1121.0,455.0,52.0,59.0,88.1,25.0,29.0,86.2,2.0,6.0,33.3,0.0,0.0,0.1,0.0,1.0,2.0,3.0,0.0,8.0,Matches,114,eng ENG,MFDF,28,6,177.0,30.0,5.2,2.0,2,69.0,0,4,10.0,12,1.67,3.0,1.0,2.0,1.02,0.77,3.2,1.5,1.7,0.84,0.54,Matches,95.0,eng ENG,MFDF,28.0,2.0,119.0,4.0,27.0,58.0,36.0,5.0,119.0,2.0,0.0,0.0,2.0,100.0,82.0,438.0,182.0,2.0,6.0,0.0,3.0,0.0,73.0,16.0,Matches,95.0,eng ENG,MFDF,28.0,2.0,0.0,1.0,0.0,0.0,0.51,0.0,0.0,,18.9,0.0,0.0,0.0,0.0,0.0,0.03,0.0,0.0,Matches,95.0,eng ENG,MFDF,28.0,6.0,2.0,177.0,2.0,0.0,0.0,0.0,0.0,0.0,0.0,3.0,0.0,0.0,0.0,0.0,0.1,2.0,8.0,16.0,0.0,0.0,0.0,0.0,0.0,0.01,0.02,0.04,0.01,0.04,Matches,Joe Bryan,D L,28,127,137,"England,Scotland",Fulham,11,13,12,11,13,12,12,11,7,12,14,9,13,12,10,12,12,13,12,12,13,16,12,12,13,14,13,15,12,13,11,8,14,14,11,11,11,5,12,10,12,3,2,3,4,1,1,3,1,1,2,3,14,16,5,16,13,14,12,13,1,20,1,1,13,1,1,10,1,1,10,1,1,1,173,75,20,14,3883948,6347,6347,4249,Northern_European,126,1,1993/9/17,0,0,34798.0,OGC Nice,28058545
505,Adam Buksa,Lens,1996,96.0,pl POL,FWMF,26.0,1.1,1.0,0.0,0.0,0.0,1.0,0.0,3.0,0.0,3.0,0.0,0.0,0.0,0.0,1.0,0.0,0.0,Matches,96.0,pl POL,FWMF,26.0,1.1,1.0,0.89,1.0,0.0,0.0,0.0,0.0,0.0,0.0,0.0,0.0,0.0,0.0,0.0,0.0,0.0,Matches,,,,,,,,,,,,,,,,,,,,,,,,,,,,,,,,,,,,,,,,,,,,,,,,,,,,,,,,96.0,pl POL,FWMF,26.0,1.1,0.0,0.0,0.0,5.0,1.0,0.0,1.0,0.0,0.0,0.0,0.0,0.0,2.0,1.0,5.0,16.7,Matches,96.0,pl POL,FWMF,26.0,1.1,24.0,23.0,1.0,0.0,0.0,0.0,1.0,0.0,0.0,0.0,0.0,0.0,15.0,0.0,0.0,Matches,96.0,pl POL,FWMF,26.0,1.1,15.0,24.0,62.5,245.0,53.0,7.0,11.0,63.6,7.0,9.0,77.8,0.0,1.0,0.0,0.0,0.0,0.0,0.0,1.0,3.0,0.0,0.0,3.0,Matches,115,pl POL,FWMF,26,8,101.0,13.0,3.0,1.1,0,,0,8,13.0,4,2.38,0.0,0.0,0.0,0.0,-1.06,1.0,2.5,-1.6,-1.41,-2.08,Matches,96.0,pl POL,FWMF,26.0,1.1,35.0,0.0,1.0,19.0,15.0,7.0,35.0,0.0,0.0,,0.0,,27.0,115.0,25.0,1.0,0.0,1.0,7.0,2.0,29.0,9.0,Matches,96.0,pl POL,FWMF,26.0,1.1,0.0,0.0,0.0,,0.0,0.0,,,,0.0,0.0,0.0,0.0,0.0,,0.0,0.0,Matches,96.0,pl POL,FWMF,26.0,8.0,0.0,101.0,1.1,0.0,0.0,0.0,0.0,0.0,0.0,0.0,0.0,0.0,0.0,0.0,0.0,1.0,3.0,9.0,0.0,0.0,0.0,0.0,0.0,0.0,0.04,0.04,0.0,0.04,Matches,Adam Buksa,S L,26,130,135,Poland,RC Lens,7,9,11,15,14,9,15,12,7,7,11,11,8,10,14,12,11,12,14,11,13,13,11,10,16,10,13,14,11,11,15,15,13,11,13,12,14,7,13,14,10,2,1,2,3,2,1,1,2,2,1,2,10,11,2,8,9,12,12,7,1,1,1,1,1,1,1,1,1,1,15,12,12,20,191,78,20,14,11708698,6450,6150,4750,Northern_European,129,1,1996/7/12,9,5,14310.0,,96055358
506,Marcin Bułka,Nice,1999,98.0,pl POL,GK,22.0,2.0,0.0,0.0,0.0,0.0,0.0,0.0,1.0,0.0,1.0,0.0,0.0,0.0,1.0,1.0,0.0,0.0,Matches,98.0,pl POL,GK,22.0,2.0,0.0,0.0,0.0,0.0,0.0,0.0,0.0,0.0,0.0,0.0,0.0,0.0,0.0,0.0,0.0,0.0,Matches,6.0,pl POL,GK,22.0,2.0,2.0,0.0,0.0,0.0,0.0,3.1,0.52,1.1,0.56,8.0,20.0,40.0,49.0,11.0,20.4,28.1,18.0,55.6,44.2,26.0,2.0,7.7,3.0,1.5,13.8,Matches,6.0,pl POL,GK,22.0,2.0,2.0,180.0,2.0,2.0,1.0,6.0,4.0,66.7,0.0,1.0,1.0,0.0,0.0,0.0,0.0,0.0,0.0,,Matches,98.0,pl POL,GK,22.0,2.0,0.0,0.0,0.0,0.0,0.0,0.0,0.0,1.0,0.0,0.0,0.0,0.0,3.0,0.0,0.0,,Matches,98.0,pl POL,GK,22.0,2.0,67.0,43.0,24.0,6.0,0.0,0.0,0.0,0.0,0.0,0.0,0.0,0.0,54.0,0.0,0.0,Matches,98.0,pl POL,GK,22.0,2.0,54.0,67.0,80.6,1465.0,1156.0,9.0,9.0,100.0,32.0,33.0,97.0,13.0,25.0,52.0,0.0,0.0,0.0,0.0,0.0,0.0,0.0,0.0,0.0,Matches,117,pl POL,GK,22,2,180.0,90.0,5.3,2.0,2,90.0,2,0,,20,0.5,1.0,2.0,-1.0,-0.5,-0.83,2.6,2.3,0.2,0.11,-0.24,Matches,98.0,pl POL,GK,22.0,2.0,70.0,64.0,70.0,0.0,0.0,0.0,70.0,0.0,0.0,,0.0,,46.0,210.0,72.0,0.0,0.0,0.0,0.0,0.0,29.0,0.0,Matches,98.0,pl POL,GK,22.0,2.0,0.0,0.0,0.0,,0.0,0.0,,,,0.0,0.0,0.0,0.0,0.0,,0.0,0.0,Matches,98.0,pl POL,GK,22.0,2.0,2.0,180.0,2.0,0.0,0.0,0.0,0.0,0.0,0.0,0.0,0.0,0.0,0.0,0.0,0.0,0.0,0.0,0.0,0.0,0.0,0.0,0.0,0.0,0.0,0.0,0.0,0.0,0.0,Matches,Marcin Bułka,GK,22,110,138,Poland,OGC Nice,3,2,1,3,7,6,3,1,3,1,7,2,2,6,11,11,10,10,10,11,12,14,1,8,2,13,12,11,12,9,16,18,10,11,6,14,14,5,15,13,11,17,11,9,8,11,15,12,11,12,8,10,15,14,3,11,14,15,11,19,20,1,1,1,1,1,1,1,1,1,1,1,1,1,199,99,10,20,2188000,5083,4854,2766,Northern_European,105,5,1999/10/4,0,0,5293.0,,28111106
507,Jimmy Cabot,Lens,1994,100.0,fr FRA,DFMF,28.0,5.7,20.0,12.0,10.0,8.0,2.0,12.0,26.0,46.2,14.0,5.0,0.0,5.0,4.0,24.0,12.0,0.0,Matches,100.0,fr FRA,DFMF,28.0,5.7,31.0,5.45,23.0,7.0,0.0,0.0,0.0,1.0,1.0,0.18,1.0,0.0,0.0,0.0,0.0,0.0,Matches,,,,,,,,,,,,,,,,,,,,,,,,,,,,,,,,,,,,,,,,,,,,,,,,,,,,,,,,100.0,fr FRA,DFMF,28.0,5.7,2.0,0.0,0.0,14.0,0.0,1.0,50.0,4.0,12.0,0.0,0.0,0.0,50.0,3.0,3.0,50.0,Matches,100.0,fr FRA,DFMF,28.0,5.7,346.0,266.0,78.0,4.0,1.0,2.0,50.0,41.0,33.0,12.0,14.0,0.0,261.0,2.0,7.0,Matches,100.0,fr FRA,DFMF,28.0,5.7,261.0,346.0,75.4,4629.0,1527.0,123.0,137.0,89.8,102.0,130.0,78.5,32.0,68.0,47.1,1.0,2.1,2.0,-1.1,17.0,19.0,13.0,4.0,29.0,Matches,119,fr FRA,DFMF,28,11,511.0,46.0,14.9,5.7,5,81.0,3,6,17.0,0,2.18,8.0,6.0,2.0,0.35,-0.79,11.2,6.7,4.5,0.78,0.2,Matches,100.0,fr FRA,DFMF,28.0,5.7,432.0,13.0,88.0,162.0,193.0,19.0,432.0,24.0,12.0,50.0,11.0,45.8,282.0,2002.0,887.0,26.0,17.0,8.0,26.0,6.0,247.0,65.0,Matches,100.0,fr FRA,DFMF,28.0,5.7,0.0,5.0,1.0,20.0,0.88,0.18,0.0,0.0,17.0,0.0,0.0,0.0,0.3,0.3,0.06,-0.3,-0.3,Matches,100.0,fr FRA,DFMF,28.0,11.0,5.0,511.0,5.7,0.0,1.0,1.0,0.0,0.0,0.0,2.0,0.0,0.3,0.3,2.1,2.4,26.0,29.0,65.0,0.0,0.18,0.18,0.0,0.18,0.05,0.37,0.43,0.05,0.43,Matches,Jimmy Cabot,WB/M/AM RL,28,129,134,France,RC Lens,13,12,14,10,13,10,5,10,4,11,13,10,10,14,7,12,11,12,11,12,11,15,15,8,13,10,11,13,14,15,8,2,14,14,15,6,12,7,10,7,12,1,3,4,1,2,1,3,4,1,1,3,10,12,9,13,11,13,10,10,1,1,1,1,1,20,1,15,1,20,15,1,17,10,164,64,10,20,5634640,6450,6450,3500,Northern_European,115,5,1994/4/18,0,0,14310.0,,167580
508,Duje Ćaleta-Car,Marseille,1996,102.0,hr CRO,DF,25.0,0.1,0.0,0.0,0.0,0.0,0.0,0.0,0.0,,0.0,0.0,0.0,0.0,0.0,0.0,1.0,0.0,Matches,102.0,hr CRO,DF,25.0,0.1,0.0,0.0,0.0,0.0,0.0,0.0,0.0,0.0,0.0,0.0,0.0,0.0,0.0,0.0,0.0,0.0,Matches,,,,,,,,,,,,,,,,,,,,,,,,,,,,,,,,,,,,,,,,,,,,,,,,,,,,,,,,102.0,hr CRO,DF,25.0,0.1,0.0,0.0,0.0,0.0,0.0,0.0,0.0,0.0,0.0,0.0,0.0,0.0,0.0,1.0,0.0,100.0,Matches,102.0,hr CRO,DF,25.0,0.1,2.0,2.0,0.0,0.0,0.0,0.0,0.0,0.0,0.0,0.0,0.0,0.0,2.0,0.0,0.0,Matches,102.0,hr CRO,DF,25.0,0.1,2.0,2.0,100.0,46.0,16.0,0.0,0.0,,2.0,2.0,100.0,0.0,0.0,,0.0,0.0,0.0,0.0,0.0,0.0,0.0,0.0,0.0,Matches,121,hr CRO,DF,25,1,8.0,8.0,0.2,0.1,0,,0,1,8.0,3,3.0,0.0,0.0,0.0,0.0,-0.71,0.0,0.1,0.0,-0.25,-0.86,Matches,102.0,hr CRO,DF,25.0,0.1,3.0,1.0,2.0,1.0,0.0,0.0,3.0,0.0,0.0,,0.0,,2.0,5.0,3.0,0.0,0.0,0.0,0.0,0.0,2.0,0.0,Matches,102.0,hr CRO,DF,25.0,0.1,0.0,0.0,0.0,,0.0,0.0,,,,0.0,0.0,0.0,0.0,0.0,,0.0,0.0,Matches,102.0,hr CRO,DF,25.0,1.0,0.0,8.0,0.1,0.0,0.0,0.0,0.0,0.0,0.0,0.0,0.0,0.0,0.0,0.0,0.0,0.0,0.0,0.0,0.0,0.0,0.0,0.0,0.0,0.0,0.0,0.0,0.0,0.0,Matches,Duje Ćaleta-Car,D C,25,135,144,Croatia,Southampton,5,5,8,7,13,8,15,10,8,14,14,8,14,9,14,15,13,12,13,12,12,15,10,11,8,14,14,14,11,11,15,15,14,12,14,16,14,11,13,12,6,1,3,3,2,4,3,2,3,1,3,1,14,13,8,10,12,14,14,13,1,1,20,1,1,1,1,1,1,1,1,1,1,1,192,89,11,20,24283271,6750,7050,5250,Northern_European,134,4,1996/9/17,23,1,57996.0,,24039427
509,Ousmane Camara,Auxerre,2001,105.0,gn GUI,FWMF,20.0,0.3,1.0,1.0,0.0,0.0,1.0,0.0,0.0,,0.0,0.0,0.0,0.0,0.0,1.0,0.0,0.0,Matches,105.0,gn GUI,FWMF,20.0,0.3,2.0,7.2,1.0,0.0,0.0,1.0,0.0,0.0,0.0,0.0,0.0,0.0,0.0,0.0,0.0,0.0,Matches,,,,,,,,,,,,,,,,,,,,,,,,,,,,,,,,,,,,,,,,,,,,,,,,,,,,,,,,105.0,gn GUI,FWMF,20.0,0.3,1.0,0.0,0.0,2.0,0.0,0.0,2.0,0.0,1.0,0.0,0.0,0.0,2.0,0.0,3.0,0.0,Matches,105.0,gn GUI,FWMF,20.0,0.3,8.0,8.0,0.0,0.0,0.0,0.0,2.0,0.0,0.0,0.0,0.0,0.0,7.0,0.0,0.0,Matches,105.0,gn GUI,FWMF,20.0,0.3,7.0,8.0,87.5,157.0,60.0,1.0,1.0,100.0,5.0,5.0,100.0,1.0,2.0,50.0,0.0,0.2,0.1,-0.2,1.0,1.0,1.0,1.0,2.0,Matches,124,gn GUI,FWMF,20,3,24.0,8.0,0.7,0.3,0,,0,3,8.0,1,0.0,0.0,0.0,0.0,0.0,0.74,1.2,0.0,1.1,4.09,4.54,Matches,105.0,gn GUI,FWMF,20.0,0.3,11.0,0.0,0.0,3.0,8.0,1.0,11.0,1.0,0.0,0.0,0.0,0.0,7.0,71.0,35.0,2.0,2.0,0.0,0.0,0.0,5.0,1.0,Matches,105.0,gn GUI,FWMF,20.0,0.3,0.0,1.0,0.0,0.0,3.75,0.0,0.0,,11.1,0.0,0.0,0.0,0.1,0.1,0.05,-0.1,-0.1,Matches,105.0,gn GUI,FWMF,20.0,3.0,0.0,24.0,0.3,0.0,0.0,0.0,0.0,0.0,0.0,1.0,0.0,0.1,0.1,0.2,0.3,2.0,2.0,1.0,0.0,0.0,0.0,0.0,0.0,0.19,0.83,1.01,0.19,1.01,Matches,Ousmane Camara,D/DM C,19,110,-75,France,Angers SCO,7,8,11,5,10,5,14,5,7,13,14,8,13,12,8,11,12,12,11,8,12,15,8,10,11,12,12,12,11,8,12,18,14,11,12,14,11,13,13,7,8,3,1,3,2,2,1,1,2,2,1,3,14,10,7,10,11,11,8,19,1,1,20,1,1,1,17,1,14,1,1,1,1,1,197,90,6,20,18912001,5500,5500,2250,African_Caribbean,110,16,2003/3/6,0,0,3288.0,,2000066137
510,El Chadaille Bitshiabu,Paris S-G,2005,118.0,fr FRA,DF,17.0,6.5,10.0,7.0,7.0,2.0,1.0,3.0,12.0,25.0,9.0,9.0,7.0,2.0,9.0,19.0,13.0,3.0,Matches,118.0,fr FRA,DF,17.0,6.5,3.0,0.46,3.0,0.0,0.0,0.0,0.0,0.0,0.0,0.0,0.0,0.0,0.0,0.0,0.0,0.0,Matches,,,,,,,,,,,,,,,,,,,,,,,,,,,,,,,,,,,,,,,,,,,,,,,,,,,,,,,,118.0,fr FRA,DF,17.0,6.5,2.0,0.0,0.0,4.0,0.0,0.0,0.0,9.0,7.0,0.0,0.0,0.0,41.0,6.0,4.0,60.0,Matches,118.0,fr FRA,DF,17.0,6.5,465.0,453.0,12.0,2.0,0.0,1.0,0.0,10.0,0.0,0.0,0.0,0.0,430.0,0.0,1.0,Matches,118.0,fr FRA,DF,17.0,6.5,430.0,465.0,92.5,7453.0,2477.0,184.0,193.0,95.3,200.0,216.0,92.6,33.0,41.0,80.5,0.0,0.1,0.1,-0.1,1.0,26.0,1.0,0.0,23.0,Matches,138,fr FRA,DF,17,13,583.0,45.0,17.0,6.5,6,74.0,2,7,20.0,19,1.92,9.0,12.0,-3.0,-0.46,-2.11,10.3,12.0,-1.7,-0.27,-1.27,Matches,118.0,fr FRA,DF,17.0,6.5,515.0,56.0,214.0,283.0,21.0,2.0,515.0,2.0,1.0,50.0,1.0,50.0,428.0,1642.0,610.0,1.0,3.0,0.0,2.0,2.0,396.0,8.0,Matches,118.0,fr FRA,DF,17.0,6.5,0.0,0.0,0.0,,0.0,0.0,,,,0.0,0.0,0.0,0.0,0.0,,0.0,0.0,Matches,118.0,fr FRA,DF,17.0,13.0,6.0,583.0,6.5,0.0,0.0,0.0,0.0,0.0,0.0,2.0,0.0,0.0,0.0,0.1,0.1,1.0,23.0,8.0,0.0,0.0,0.0,0.0,0.0,0.0,0.01,0.01,0.0,0.01,Matches,El Chadaille Bitshiabu,D C,17,100,-85,"France,Democratic Republic of Congo",Paris Saint-Germain,6,7,7,7,11,6,15,8,4,10,10,6,11,11,12,11,12,11,11,12,10,4,9,10,7,11,11,11,8,11,12,16,15,10,12,15,10,8,10,5,19,2,3,2,1,2,2,1,2,2,4,2,20,15,8,11,14,12,11,17,1,1,20,1,1,1,1,1,1,1,1,1,1,1,196,95,20,8,29400001,5000,5000,2500,African_Caribbean,96,15,2005/5/16,0,0,1388.0,,2000100253
511,Gaëtan Charbonnier,Auxerre,1988,121.0,fr FRA,FWMF,33.0,2.8,2.0,1.0,0.0,2.0,0.0,0.0,4.0,0.0,4.0,2.0,0.0,2.0,0.0,2.0,5.0,0.0,Matches,121.0,fr FRA,FWMF,33.0,2.8,9.0,3.19,8.0,0.0,0.0,0.0,1.0,0.0,0.0,0.0,0.0,0.0,0.0,0.0,0.0,0.0,Matches,,,,,,,,,,,,,,,,,,,,,,,,,,,,,,,,,,,,,,,,,,,,,,,,,,,,,,,,121.0,fr FRA,FWMF,33.0,2.8,1.0,0.0,0.0,3.0,1.0,3.0,1.0,0.0,1.0,0.0,0.0,0.0,6.0,3.0,7.0,30.0,Matches,121.0,fr FRA,FWMF,33.0,2.8,89.0,78.0,11.0,0.0,0.0,2.0,1.0,1.0,0.0,0.0,0.0,0.0,79.0,0.0,2.0,Matches,121.0,fr FRA,FWMF,33.0,2.8,79.0,89.0,88.8,1359.0,298.0,36.0,42.0,85.7,33.0,36.0,91.7,7.0,7.0,100.0,0.0,0.2,0.1,-0.2,3.0,5.0,5.0,0.0,11.0,Matches,142,fr FRA,FWMF,33,6,254.0,42.0,7.4,2.8,3,72.0,1,3,13.0,0,0.83,3.0,9.0,-6.0,-2.13,-1.5,2.8,5.8,-3.0,-1.06,-0.7,Matches,121.0,fr FRA,FWMF,33.0,2.8,120.0,5.0,11.0,67.0,43.0,14.0,120.0,4.0,2.0,50.0,1.0,25.0,91.0,433.0,139.0,2.0,3.0,0.0,8.0,6.0,92.0,18.0,Matches,121.0,fr FRA,FWMF,33.0,2.8,1.0,7.0,1.0,14.3,2.48,0.35,0.14,1.0,23.2,0.0,0.0,0.0,0.6,0.6,0.09,0.4,0.4,Matches,121.0,fr FRA,FWMF,33.0,6.0,3.0,254.0,2.8,1.0,0.0,1.0,1.0,0.0,0.0,1.0,0.0,0.6,0.6,0.2,0.7,2.0,11.0,18.0,0.35,0.0,0.35,0.35,0.35,0.21,0.05,0.26,0.21,0.26,Matches,Gaëtan Charbonnier,AM/S C,33,121,127,France,AJ Auxerre,7,10,12,13,11,10,15,11,5,8,11,11,8,13,12,13,15,13,14,10,12,14,12,10,13,8,14,14,11,11,15,14,15,11,13,15,13,12,13,6,8,2,2,1,1,2,1,1,1,2,2,3,8,14,8,14,12,13,9,8,1,1,1,1,1,1,1,1,7,1,10,18,10,20,188,80,10,20,436636,6048,6048,3698,Northern_European,121,5,1988/12/27,0,0,7193.0,,85015491
512,Alexis Claude-Maurice,Nice,1998,132.0,fr FRA,FW,24.0,0.7,3.0,2.0,2.0,1.0,0.0,3.0,3.0,100.0,0.0,0.0,0.0,0.0,2.0,5.0,1.0,0.0,Matches,132.0,fr FRA,FW,24.0,0.7,3.0,4.22,3.0,0.0,0.0,0.0,0.0,0.0,0.0,0.0,0.0,0.0,0.0,0.0,0.0,0.0,Matches,,,,,,,,,,,,,,,,,,,,,,,,,,,,,,,,,,,,,,,,,,,,,,,,,,,,,,,,132.0,fr FRA,FW,24.0,0.7,0.0,0.0,0.0,0.0,2.0,0.0,1.0,2.0,2.0,0.0,0.0,0.0,1.0,2.0,0.0,100.0,Matches,132.0,fr FRA,FW,24.0,0.7,25.0,25.0,0.0,0.0,0.0,1.0,1.0,0.0,0.0,0.0,0.0,0.0,20.0,0.0,2.0,Matches,132.0,fr FRA,FW,24.0,0.7,20.0,25.0,80.0,260.0,33.0,12.0,13.0,92.3,5.0,7.0,71.4,1.0,2.0,50.0,0.0,0.0,0.0,0.0,1.0,1.0,1.0,0.0,2.0,Matches,153,fr FRA,FW,24,2,64.0,32.0,1.9,0.7,1,45.0,0,1,19.0,2,0.0,0.0,3.0,-3.0,-4.22,-4.59,0.9,1.2,-0.3,-0.36,-0.7,Matches,132.0,fr FRA,FW,24.0,0.7,39.0,4.0,9.0,18.0,12.0,0.0,39.0,0.0,0.0,,0.0,,24.0,129.0,34.0,0.0,1.0,0.0,3.0,2.0,25.0,1.0,Matches,132.0,fr FRA,FW,24.0,0.7,0.0,2.0,0.0,0.0,2.81,0.0,0.0,,24.0,0.0,0.0,0.0,0.1,0.1,0.04,-0.1,-0.1,Matches,132.0,fr FRA,FW,24.0,2.0,1.0,64.0,0.7,0.0,0.0,0.0,0.0,0.0,0.0,0.0,0.0,0.1,0.1,0.0,0.1,0.0,2.0,1.0,0.0,0.0,0.0,0.0,0.0,0.12,0.07,0.18,0.12,0.18,Matches,Alexis Claude-Maurice,M/AM RLC,24,120,138,France,OGC Nice,10,11,14,12,13,13,7,11,7,8,14,12,7,14,10,12,10,10,12,14,10,13,14,7,13,8,14,12,13,14,10,7,15,14,13,6,14,7,13,14,12,2,1,3,4,4,1,2,2,1,1,1,15,13,7,15,12,15,13,20,1,1,1,1,1,1,1,17,16,12,20,18,15,12,175,64,10,20,1156143,5999,5999,3749,African_Caribbean,118,12,1998/6/6,0,0,25298.0,RC Lens,48036267
513,Marcus Coco,Nantes,1996,135.0,fr FRA,FWMF,26.0,7.1,24.0,15.0,11.0,9.0,4.0,11.0,23.0,47.8,12.0,13.0,3.0,10.0,14.0,38.0,7.0,0.0,Matches,135.0,fr FRA,FWMF,26.0,7.1,19.0,2.67,17.0,0.0,2.0,0.0,0.0,0.0,0.0,0.0,0.0,0.0,0.0,0.0,0.0,0.0,Matches,,,,,,,,,,,,,,,,,,,,,,,,,,,,,,,,,,,,,,,,,,,,,,,,,,,,,,,,135.0,fr FRA,FWMF,26.0,7.1,2.0,0.0,0.0,19.0,11.0,3.0,24.0,14.0,15.0,0.0,0.0,0.0,50.0,17.0,33.0,34.0,Matches,135.0,fr FRA,FWMF,26.0,7.1,244.0,225.0,18.0,3.0,0.0,0.0,24.0,11.0,4.0,0.0,4.0,0.0,175.0,1.0,9.0,Matches,135.0,fr FRA,FWMF,26.0,7.1,175.0,244.0,71.7,2841.0,897.0,97.0,124.0,78.2,48.0,67.0,71.6,20.0,35.0,57.1,0.0,1.1,0.7,-1.1,10.0,15.0,8.0,5.0,26.0,Matches,156,fr FRA,FWMF,26,26,641.0,25.0,18.7,7.1,6,62.0,0,20,14.0,10,1.08,8.0,7.0,1.0,0.14,0.76,9.9,10.8,-0.9,-0.13,0.16,Matches,135.0,fr FRA,FWMF,26.0,7.1,347.0,13.0,74.0,152.0,131.0,22.0,347.0,15.0,7.0,46.7,8.0,53.3,232.0,1445.0,733.0,23.0,9.0,4.0,17.0,11.0,210.0,56.0,Matches,135.0,fr FRA,FWMF,26.0,7.1,1.0,7.0,1.0,14.3,0.98,0.14,0.14,1.0,13.6,0.0,0.0,0.0,1.1,1.1,0.16,-0.1,-0.1,Matches,135.0,fr FRA,FWMF,26.0,26.0,6.0,641.0,7.1,1.0,0.0,1.0,1.0,0.0,0.0,2.0,0.0,1.1,1.1,1.1,2.2,23.0,26.0,56.0,0.14,0.0,0.14,0.14,0.14,0.16,0.15,0.31,0.16,0.31,Matches,Marcus Coco,M/AM RL,26,121,131,"France,Guadeloupe",FC Nantes,9,10,13,10,12,6,10,11,6,8,11,12,7,13,9,11,12,12,11,10,10,12,12,9,12,9,12,13,15,13,13,13,15,14,13,13,12,6,14,8,13,3,2,3,1,2,1,1,2,1,1,4,13,14,8,12,12,13,14,16,1,1,1,1,1,12,1,15,1,17,16,1,20,7,184,78,10,20,1655534,6049,6049,3520,African_Caribbean,118,13,1996/6/24,0,0,5680.0,,85142872
514,Sébastien Corchia,Nantes,1990,138.0,fr FRA,DF,31.0,8.7,16.0,6.0,10.0,2.0,4.0,11.0,22.0,50.0,11.0,9.0,3.0,6.0,14.0,30.0,21.0,0.0,Matches,138.0,fr FRA,DF,31.0,8.7,15.0,1.72,11.0,2.0,1.0,0.0,0.0,1.0,4.0,0.46,4.0,0.0,0.0,0.0,0.0,0.0,Matches,,,,,,,,,,,,,,,,,,,,,,,,,,,,,,,,,,,,,,,,,,,,,,,,,,,,,,,,138.0,fr FRA,DF,31.0,8.7,3.0,0.0,0.0,16.0,18.0,1.0,43.0,14.0,6.0,0.0,0.0,0.0,52.0,12.0,10.0,54.5,Matches,138.0,fr FRA,DF,31.0,8.7,371.0,299.0,71.0,5.0,0.0,0.0,43.0,59.0,7.0,0.0,5.0,0.0,257.0,1.0,11.0,Matches,138.0,fr FRA,DF,31.0,8.7,257.0,371.0,69.3,4354.0,1895.0,120.0,150.0,80.0,103.0,151.0,68.2,23.0,45.0,51.1,1.0,0.3,0.4,0.7,5.0,18.0,7.0,5.0,29.0,Matches,159,fr FRA,DF,31,22,786.0,36.0,23.0,8.7,6,77.0,2,16,20.0,12,1.14,10.0,16.0,-6.0,-0.69,-0.28,7.3,14.0,-6.7,-0.77,-0.67,Matches,138.0,fr FRA,DF,31.0,8.7,468.0,27.0,116.0,200.0,162.0,10.0,468.0,11.0,3.0,27.3,2.0,18.2,288.0,1550.0,639.0,21.0,10.0,4.0,14.0,7.0,251.0,65.0,Matches,138.0,fr FRA,DF,31.0,8.7,0.0,5.0,2.0,40.0,0.57,0.23,0.0,0.0,27.4,1.0,0.0,0.0,0.2,0.2,0.03,-0.2,-0.2,Matches,138.0,fr FRA,DF,31.0,22.0,6.0,786.0,8.7,0.0,1.0,1.0,0.0,0.0,0.0,3.0,0.0,0.2,0.2,0.3,0.5,21.0,29.0,65.0,0.0,0.11,0.11,0.0,0.11,0.02,0.04,0.05,0.02,0.05,Matches,Sébastien Corchia,D/WB R,31,121,139,"France,Italy",FC Nantes,12,13,12,7,13,13,11,11,11,12,13,11,13,13,13,13,13,13,12,11,13,17,12,11,10,11,13,13,13,13,12,8,10,13,12,12,12,12,13,12,13,3,3,1,2,3,4,3,3,2,2,2,19,14,7,15,14,17,15,14,1,12,1,20,12,17,1,1,1,13,1,1,10,1,176,64,8,20,928008,6045,6045,4245,Northern_European,121,5,1990/11/1,1,0,7648.0,,34002343
515,Damien Da Silva,Lyon,1988,145.0,fr FRA,DF,34.0,3.8,8.0,7.0,5.0,3.0,0.0,3.0,3.0,100.0,0.0,4.0,3.0,1.0,5.0,13.0,12.0,0.0,Matches,145.0,fr FRA,DF,34.0,3.8,1.0,0.27,1.0,0.0,0.0,0.0,0.0,0.0,0.0,0.0,0.0,0.0,0.0,0.0,0.0,0.0,Matches,,,,,,,,,,,,,,,,,,,,,,,,,,,,,,,,,,,,,,,,,,,,,,,,,,,,,,,,145.0,fr FRA,DF,34.0,3.8,2.0,0.0,0.0,8.0,2.0,0.0,2.0,5.0,7.0,0.0,0.0,0.0,13.0,12.0,7.0,63.2,Matches,145.0,fr FRA,DF,34.0,3.8,254.0,238.0,16.0,2.0,0.0,3.0,2.0,14.0,0.0,0.0,0.0,0.0,217.0,0.0,3.0,Matches,145.0,fr FRA,DF,34.0,3.8,217.0,254.0,85.4,4247.0,1562.0,66.0,75.0,88.0,122.0,138.0,88.4,25.0,35.0,71.4,0.0,0.0,0.1,0.0,0.0,14.0,2.0,0.0,18.0,Matches,170,fr FRA,DF,34,7,338.0,48.0,9.9,3.8,3,75.0,2,4,28.0,11,1.71,6.0,6.0,0.0,0.0,-0.53,7.4,4.1,3.3,0.87,0.69,Matches,145.0,fr FRA,DF,34.0,3.8,295.0,17.0,105.0,166.0,25.0,3.0,295.0,2.0,1.0,50.0,1.0,50.0,206.0,1084.0,441.0,2.0,6.0,0.0,2.0,1.0,200.0,1.0,Matches,145.0,fr FRA,DF,34.0,3.8,0.0,2.0,0.0,0.0,0.53,0.0,0.0,,13.5,0.0,0.0,0.0,0.1,0.1,0.07,-0.1,-0.1,Matches,145.0,fr FRA,DF,34.0,7.0,3.0,338.0,3.8,0.0,0.0,0.0,0.0,0.0,0.0,2.0,0.0,0.1,0.1,0.0,0.1,2.0,18.0,1.0,0.0,0.0,0.0,0.0,0.0,0.03,0.0,0.03,0.03,0.03,Matches,Damien Da Silva,D C,34,122,131,"France,Portugal",Olympique Lyonnais,5,5,6,8,11,6,14,8,6,15,11,6,14,11,15,15,16,12,14,12,13,16,7,12,8,13,16,15,9,11,15,13,11,9,15,15,12,16,14,10,8,1,2,1,2,3,1,2,1,3,1,1,14,14,6,14,13,15,10,12,1,1,20,12,1,10,14,1,1,1,1,1,1,1,184,83,6,20,102445,5994,6094,3994,Mediterranean_Hispanic,123,6,1988/5/17,0,0,7795.0,,34005782
516,Flavius Daniliuc,Nice,2001,149.0,at AUT,DF,21.0,1.0,2.0,0.0,2.0,0.0,0.0,1.0,1.0,100.0,0.0,4.0,1.0,3.0,0.0,2.0,1.0,0.0,Matches,149.0,at AUT,DF,21.0,1.0,1.0,0.99,1.0,0.0,0.0,0.0,0.0,0.0,0.0,0.0,0.0,0.0,0.0,0.0,0.0,0.0,Matches,,,,,,,,,,,,,,,,,,,,,,,,,,,,,,,,,,,,,,,,,,,,,,,,,,,,,,,,149.0,at AUT,DF,21.0,1.0,0.0,0.0,0.0,2.0,0.0,0.0,2.0,0.0,0.0,0.0,0.0,0.0,5.0,1.0,0.0,100.0,Matches,149.0,at AUT,DF,21.0,1.0,63.0,50.0,13.0,2.0,0.0,1.0,2.0,11.0,0.0,0.0,0.0,0.0,57.0,0.0,1.0,Matches,149.0,at AUT,DF,21.0,1.0,57.0,63.0,90.5,787.0,259.0,35.0,38.0,92.1,15.0,16.0,93.8,3.0,4.0,75.0,0.0,0.1,0.0,-0.1,1.0,1.0,1.0,1.0,4.0,Matches,175,at AUT,DF,21,2,91.0,46.0,2.7,1.0,1,90.0,1,1,1.0,0,0.5,0.0,1.0,-1.0,-0.99,-1.31,1.4,0.9,0.5,0.48,0.16,Matches,149.0,at AUT,DF,21.0,1.0,71.0,3.0,23.0,28.0,20.0,1.0,71.0,0.0,0.0,,0.0,,45.0,234.0,129.0,2.0,2.0,0.0,1.0,0.0,43.0,3.0,Matches,149.0,at AUT,DF,21.0,1.0,0.0,0.0,0.0,,0.0,0.0,,,,0.0,0.0,0.0,0.0,0.0,,0.0,0.0,Matches,149.0,at AUT,DF,21.0,2.0,1.0,91.0,1.0,0.0,0.0,0.0,0.0,0.0,0.0,0.0,0.0,0.0,0.0,0.1,0.1,2.0,4.0,3.0,0.0,0.0,0.0,0.0,0.0,0.0,0.05,0.05,0.0,0.05,Matches,Flavius Daniliuc,D RC,21,126,157,"Austria,Romania",U.S. Salernitana 1919,6,7,12,6,12,5,13,7,11,13,14,7,15,12,14,13,13,10,10,12,13,15,11,6,8,13,15,13,13,11,13,13,16,13,13,15,14,8,14,7,16,1,3,3,3,3,3,2,2,4,2,1,11,13,5,13,12,15,13,13,1,13,20,17,10,12,10,1,1,1,1,1,1,1,188,83,13,20,9339999,6300,5900,3250,Mediterranean_Hispanic,126,1,2001/4/27,0,0,12466.0,,91172522
517,Andy Delort,Nice,1991,160.0,dz ALG,FW,30.0,8.7,2.0,0.0,1.0,1.0,0.0,1.0,2.0,50.0,1.0,0.0,0.0,0.0,1.0,3.0,7.0,0.0,Matches,160.0,dz ALG,FW,30.0,8.7,21.0,2.42,19.0,0.0,0.0,2.0,0.0,0.0,2.0,0.23,2.0,0.0,0.0,0.0,0.0,0.0,Matches,,,,,,,,,,,,,,,,,,,,,,,,,,,,,,,,,,,,,,,,,,,,,,,,,,,,,,,,160.0,dz ALG,FW,30.0,8.7,0.0,0.0,0.0,8.0,9.0,7.0,15.0,1.0,0.0,0.0,0.0,0.0,12.0,28.0,25.0,52.8,Matches,160.0,dz ALG,FW,30.0,8.7,230.0,211.0,17.0,1.0,1.0,2.0,15.0,0.0,0.0,0.0,0.0,0.0,139.0,2.0,4.0,Matches,160.0,dz ALG,FW,30.0,8.7,139.0,230.0,60.4,2109.0,558.0,78.0,113.0,69.0,41.0,73.0,56.2,12.0,25.0,48.0,1.0,1.4,0.9,-0.4,11.0,16.0,7.0,1.0,19.0,Matches,187,dz ALG,FW,30,14,781.0,56.0,22.8,8.7,9,78.0,4,5,16.0,0,1.36,12.0,9.0,3.0,0.35,0.07,13.1,8.8,4.3,0.5,0.22,Matches,160.0,dz ALG,FW,30.0,8.7,309.0,7.0,21.0,150.0,141.0,37.0,306.0,12.0,4.0,33.3,7.0,58.3,224.0,1093.0,372.0,7.0,7.0,1.0,23.0,9.0,246.0,48.0,Matches,160.0,dz ALG,FW,30.0,8.7,6.0,23.0,8.0,34.8,2.65,0.92,0.13,0.38,16.4,1.0,3.0,3.0,5.4,3.0,0.13,0.6,0.0,Matches,160.0,dz ALG,FW,30.0,14.0,9.0,781.0,8.7,6.0,1.0,7.0,3.0,3.0,3.0,0.0,0.0,5.4,3.0,1.4,4.4,7.0,19.0,48.0,0.69,0.12,0.81,0.35,0.46,0.62,0.16,0.78,0.35,0.51,Matches,Andy Delort,S,30,145,150,"Algeria,France",OGC Nice,4,12,12,15,13,13,15,16,8,7,12,14,7,13,17,14,18,13,12,15,12,18,15,17,15,14,15,16,13,12,16,15,17,15,14,17,14,13,16,8,8,2,3,2,1,1,2,4,1,3,3,2,16,15,12,8,12,16,13,12,1,1,1,1,1,1,1,1,1,1,10,1,13,20,181,83,8,20,15725883,7100,7100,4500,Mediterranean_Hispanic,147,6,1991/10/9,11,2,31067.0,,85059211
518,Moussa Dembélé,Lyon,1996,163.0,fr FRA,FWMF,26.0,9.7,8.0,4.0,3.0,3.0,2.0,4.0,7.0,57.1,3.0,5.0,0.0,5.0,2.0,10.0,6.0,0.0,Matches,163.0,fr FRA,FWMF,26.0,9.7,14.0,1.44,12.0,0.0,1.0,0.0,0.0,1.0,2.0,0.21,2.0,0.0,0.0,0.0,0.0,0.0,Matches,,,,,,,,,,,,,,,,,,,,,,,,,,,,,,,,,,,,,,,,,,,,,,,,,,,,,,,,163.0,fr FRA,FWMF,26.0,9.7,1.0,0.0,0.0,17.0,3.0,8.0,2.0,2.0,4.0,0.0,0.0,0.0,22.0,29.0,22.0,56.9,Matches,163.0,fr FRA,FWMF,26.0,9.7,191.0,176.0,15.0,0.0,0.0,0.0,2.0,1.0,0.0,0.0,0.0,0.0,138.0,0.0,10.0,Matches,163.0,fr FRA,FWMF,26.0,9.7,138.0,191.0,72.3,1752.0,364.0,72.0,99.0,72.7,45.0,59.0,76.3,3.0,6.0,50.0,0.0,0.3,0.5,-0.3,4.0,8.0,11.0,0.0,23.0,Matches,190,fr FRA,FWMF,26,23,877.0,38.0,25.6,9.7,8,72.0,3,15,20.0,10,1.35,11.0,11.0,0.0,0.0,-0.64,14.7,11.7,3.0,0.3,0.07,Matches,163.0,fr FRA,FWMF,26.0,9.7,299.0,9.0,24.0,135.0,143.0,50.0,299.0,12.0,4.0,33.3,8.0,66.7,200.0,1043.0,240.0,10.0,4.0,5.0,32.0,16.0,215.0,66.0,Matches,163.0,fr FRA,FWMF,26.0,9.7,3.0,28.0,13.0,46.4,2.87,1.33,0.11,0.23,13.3,0.0,0.0,0.0,3.8,3.8,0.14,-0.8,-0.8,Matches,163.0,fr FRA,FWMF,26.0,23.0,8.0,877.0,9.7,3.0,0.0,3.0,3.0,0.0,0.0,1.0,0.0,3.8,3.8,0.3,4.1,10.0,23.0,66.0,0.31,0.0,0.31,0.31,0.31,0.39,0.03,0.42,0.39,0.42,Matches,Moussa Dembélé,S,26,140,146,"France,Mali",Olympique Lyonnais,5,8,13,15,12,12,15,12,5,4,12,15,4,13,10,13,14,14,11,11,12,15,13,12,16,8,12,12,15,12,15,13,15,15,14,15,12,6,16,8,5,1,2,2,3,1,1,3,1,3,1,1,10,17,10,10,13,14,11,12,1,1,1,1,1,1,1,1,1,1,1,1,1,20,183,74,10,20,10690562,6850,6800,6200,African_Caribbean,139,16,1996/7/12,0,0,61369.0,,85104422
519,Bamba Dieng,Marseille,2000,179.0,sn SEN,FWMF,22.0,2.2,4.0,4.0,2.0,1.0,1.0,3.0,4.0,75.0,1.0,5.0,1.0,4.0,0.0,4.0,0.0,0.0,Matches,179.0,sn SEN,FWMF,22.0,2.2,6.0,2.78,2.0,0.0,0.0,0.0,3.0,1.0,1.0,0.46,0.0,0.0,0.0,0.0,1.0,0.0,Matches,,,,,,,,,,,,,,,,,,,,,,,,,,,,,,,,,,,,,,,,,,,,,,,,,,,,,,,,179.0,sn SEN,FWMF,22.0,2.2,1.0,0.0,0.0,8.0,6.0,1.0,1.0,0.0,4.0,1.0,0.0,0.0,7.0,9.0,10.0,47.4,Matches,179.0,sn SEN,FWMF,22.0,2.2,43.0,39.0,4.0,0.0,0.0,0.0,1.0,0.0,0.0,0.0,0.0,0.0,27.0,0.0,1.0,Matches,179.0,sn SEN,FWMF,22.0,2.2,27.0,43.0,62.8,367.0,34.0,18.0,26.0,69.2,5.0,9.0,55.6,2.0,2.0,100.0,0.0,0.1,0.1,-0.1,2.0,1.0,2.0,1.0,1.0,Matches,210,sn SEN,FWMF,22,10,194.0,19.0,5.7,2.2,1,78.0,0,9,13.0,1,1.9,6.0,3.0,3.0,1.39,0.72,5.1,2.4,2.7,1.25,0.69,Matches,179.0,sn SEN,FWMF,22.0,2.2,76.0,1.0,4.0,39.0,34.0,15.0,76.0,3.0,2.0,66.7,1.0,33.3,54.0,303.0,112.0,5.0,1.0,2.0,7.0,4.0,58.0,23.0,Matches,179.0,sn SEN,FWMF,22.0,2.2,1.0,11.0,5.0,45.5,5.1,2.32,0.09,0.2,12.5,0.0,0.0,0.0,1.5,1.5,0.14,-0.5,-0.5,Matches,179.0,sn SEN,FWMF,22.0,10.0,1.0,194.0,2.2,1.0,0.0,1.0,1.0,0.0,0.0,1.0,0.0,1.5,1.5,0.1,1.6,5.0,1.0,23.0,0.46,0.0,0.46,0.46,0.46,0.71,0.04,0.76,0.71,0.76,Matches,Bamba Dieng,S,22,120,145,Senegal,Olympique de Marseille,5,8,12,14,12,6,11,10,1,6,10,8,8,13,8,13,13,14,11,10,11,13,14,10,14,8,13,12,16,13,12,9,14,15,13,11,13,10,12,10,7,1,2,1,1,1,2,1,2,1,3,3,18,15,1,12,10,12,12,19,1,1,1,1,1,1,1,1,1,1,12,1,1,20,178,72,8,20,4754999,5999,5999,4999,African_Caribbean,118,17,2000/3/23,11,1,7795.0,,12092876
520,Tristan Dingomé,Troyes,1991,181.0,cm CMR,MF,31.0,1.1,1.0,1.0,0.0,1.0,0.0,0.0,2.0,0.0,2.0,0.0,0.0,0.0,0.0,1.0,0.0,0.0,Matches,181.0,cm CMR,MF,31.0,1.1,8.0,7.35,6.0,1.0,1.0,0.0,0.0,0.0,0.0,0.0,0.0,0.0,0.0,0.0,0.0,0.0,Matches,,,,,,,,,,,,,,,,,,,,,,,,,,,,,,,,,,,,,,,,,,,,,,,,,,,,,,,,181.0,cm CMR,MF,31.0,1.1,0.0,0.0,0.0,1.0,1.0,0.0,5.0,0.0,1.0,0.0,0.0,0.0,10.0,1.0,3.0,25.0,Matches,181.0,cm CMR,MF,31.0,1.1,78.0,68.0,9.0,2.0,0.0,0.0,5.0,2.0,5.0,2.0,1.0,0.0,55.0,1.0,1.0,Matches,181.0,cm CMR,MF,31.0,1.1,55.0,78.0,70.5,840.0,252.0,31.0,34.0,91.2,19.0,28.0,67.9,3.0,9.0,33.3,0.0,0.3,0.2,-0.3,4.0,7.0,1.0,0.0,6.0,Matches,212,cm CMR,MF,31,8,99.0,12.0,2.9,1.1,0,,0,8,12.0,8,1.25,2.0,2.0,0.0,0.0,0.98,2.1,2.1,0.0,0.02,1.08,Matches,181.0,cm CMR,MF,31.0,1.1,88.0,0.0,9.0,41.0,38.0,5.0,88.0,2.0,1.0,50.0,1.0,50.0,66.0,263.0,123.0,1.0,1.0,1.0,1.0,1.0,61.0,4.0,Matches,181.0,cm CMR,MF,31.0,1.1,0.0,3.0,1.0,33.3,2.73,0.91,0.0,0.0,21.7,0.0,0.0,0.0,0.2,0.2,0.06,-0.2,-0.2,Matches,181.0,cm CMR,MF,31.0,8.0,0.0,99.0,1.1,0.0,0.0,0.0,0.0,0.0,0.0,0.0,0.0,0.2,0.2,0.3,0.4,1.0,6.0,4.0,0.0,0.0,0.0,0.0,0.0,0.16,0.23,0.39,0.16,0.39,Matches,Tristan Dingomé,M/AM RC,31,120,130,"France,Cameroon",ESTAC Troyes,11,12,12,6,13,11,6,13,10,8,15,9,10,14,11,13,13,12,13,15,12,14,13,11,10,12,16,14,12,14,12,8,14,12,13,11,13,11,13,9,12,1,3,2,2,1,1,1,1,1,2,2,12,13,6,14,12,15,15,15,1,10,1,1,10,1,14,14,20,14,13,18,15,1,174,71,20,7,788128,5999,5999,3699,African_Caribbean,120,12,1991/2/17,0,0,10349.0,,34011923
521,Sofiane Diop,Monaco,2000,186.0,fr FRA,MF,22.0,0.7,0.0,0.0,0.0,0.0,0.0,0.0,0.0,,0.0,0.0,0.0,0.0,1.0,1.0,0.0,0.0,Matches,186.0,fr FRA,MF,22.0,0.7,7.0,9.69,4.0,2.0,1.0,0.0,0.0,0.0,2.0,2.77,1.0,1.0,0.0,0.0,0.0,0.0,Matches,,,,,,,,,,,,,,,,,,,,,,,,,,,,,,,,,,,,,,,,,,,,,,,,,,,,,,,,186.0,fr FRA,MF,22.0,0.7,0.0,0.0,0.0,0.0,2.0,1.0,7.0,1.0,0.0,0.0,0.0,0.0,4.0,2.0,0.0,100.0,Matches,186.0,fr FRA,MF,22.0,0.7,33.0,26.0,7.0,1.0,0.0,0.0,7.0,0.0,6.0,4.0,2.0,0.0,20.0,0.0,1.0,Matches,186.0,fr FRA,MF,22.0,0.7,20.0,33.0,60.6,276.0,92.0,14.0,19.0,73.7,2.0,6.0,33.3,2.0,5.0,40.0,0.0,0.1,0.1,-0.1,3.0,0.0,2.0,0.0,2.0,Matches,217,fr FRA,MF,22,1,65.0,65.0,1.9,0.7,1,65.0,0,0,,2,3.0,2.0,1.0,1.0,1.38,1.09,2.0,0.5,1.4,2.0,1.8,Matches,186.0,fr FRA,MF,22.0,0.7,48.0,0.0,0.0,14.0,35.0,5.0,48.0,5.0,1.0,20.0,3.0,60.0,33.0,255.0,127.0,5.0,5.0,3.0,3.0,3.0,32.0,10.0,Matches,186.0,fr FRA,MF,22.0,0.7,1.0,2.0,1.0,50.0,2.77,1.38,0.5,1.0,10.5,0.0,0.0,0.0,1.0,1.0,0.5,0.0,0.0,Matches,186.0,fr FRA,MF,22.0,1.0,1.0,65.0,0.7,1.0,0.0,1.0,1.0,0.0,0.0,0.0,0.0,1.0,1.0,0.1,1.1,5.0,2.0,10.0,1.38,0.0,1.38,1.38,1.38,1.4,0.11,1.51,1.4,1.51,Matches,Sofiane Diop,M/AM RLC,22,134,152,"France,Morocco,Senegal",OGC Nice,13,12,14,11,14,12,8,10,2,4,14,12,8,15,13,12,13,12,13,13,12,15,15,8,13,6,12,14,15,14,13,6,14,15,14,10,14,7,12,6,15,3,3,3,1,2,2,2,1,3,3,2,11,16,8,12,13,13,13,12,1,1,1,1,1,1,1,17,12,16,15,20,17,1,175,65,9,20,19965200,6700,6700,4500,North_African__Middle_Eastern,128,9,2000/6/9,0,0,19999.0,,49037827
522,Alberth Elis,Brest,1996,210.0,hn HON,MFFW,26.0,2.9,4.0,3.0,1.0,2.0,1.0,1.0,7.0,14.3,6.0,1.0,0.0,1.0,1.0,5.0,2.0,0.0,Matches,210.0,hn HON,MFFW,26.0,2.9,12.0,4.2,6.0,0.0,1.0,1.0,3.0,1.0,0.0,0.0,0.0,0.0,0.0,0.0,0.0,0.0,Matches,,,,,,,,,,,,,,,,,,,,,,,,,,,,,,,,,,,,,,,,,,,,,,,,,,,,,,,,210.0,hn HON,MFFW,26.0,2.9,0.0,0.0,0.0,8.0,5.0,1.0,2.0,1.0,3.0,0.0,0.0,0.0,17.0,3.0,12.0,20.0,Matches,210.0,hn HON,MFFW,26.0,2.9,44.0,43.0,1.0,0.0,1.0,0.0,2.0,0.0,0.0,0.0,0.0,0.0,33.0,0.0,2.0,Matches,210.0,hn HON,MFFW,26.0,2.9,33.0,44.0,75.0,405.0,137.0,24.0,32.0,75.0,6.0,7.0,85.7,0.0,2.0,0.0,0.0,0.2,0.3,-0.2,3.0,2.0,3.0,1.0,4.0,Matches,242,hn HON,MFFW,26,10,257.0,26.0,7.5,2.9,2,62.0,0,8,17.0,6,1.3,1.0,6.0,-5.0,-1.75,-1.61,3.6,6.1,-2.4,-0.85,-0.56,Matches,210.0,hn HON,MFFW,26.0,2.9,81.0,5.0,18.0,32.0,37.0,6.0,81.0,11.0,2.0,18.2,7.0,63.6,60.0,603.0,275.0,8.0,9.0,3.0,4.0,5.0,49.0,19.0,Matches,210.0,hn HON,MFFW,26.0,2.9,0.0,4.0,1.0,25.0,1.4,0.35,0.0,0.0,13.1,0.0,0.0,0.0,0.5,0.5,0.13,-0.5,-0.5,Matches,210.0,hn HON,MFFW,26.0,10.0,2.0,257.0,2.9,0.0,0.0,0.0,0.0,0.0,0.0,0.0,0.0,0.5,0.5,0.2,0.7,8.0,4.0,19.0,0.0,0.0,0.0,0.0,0.0,0.18,0.06,0.24,0.18,0.24,Matches,Alberth Elis,AM/S RL,26,131,139,Honduras,FC Girondins de Bordeaux,7,9,12,13,10,8,12,8,7,7,10,13,7,12,14,10,15,13,11,11,12,16,11,11,16,7,13,11,16,12,10,12,18,17,15,14,12,13,15,4,13,2,1,1,1,3,2,1,1,2,1,3,11,13,12,7,11,14,8,6,1,1,1,1,1,1,1,1,1,1,17,1,19,20,183,77,7,20,6470401,6450,6550,5500,African_Caribbean,123,14,1996/2/12,56,12,8500.0,,87034587
523,Fábio,Nantes,1990,213.0,br BRA,DFMF,32.0,2.5,4.0,2.0,1.0,2.0,1.0,4.0,6.0,66.7,2.0,2.0,0.0,2.0,3.0,7.0,11.0,0.0,Matches,213.0,br BRA,DFMF,32.0,2.5,10.0,4.0,10.0,0.0,0.0,0.0,0.0,0.0,1.0,0.4,1.0,0.0,0.0,0.0,0.0,0.0,Matches,,,,,,,,,,,,,,,,,,,,,,,,,,,,,,,,,,,,,,,,,,,,,,,,,,,,,,,,213.0,br BRA,DFMF,32.0,2.5,1.0,1.0,0.0,3.0,1.0,0.0,6.0,3.0,2.0,0.0,0.0,0.0,12.0,4.0,3.0,57.1,Matches,213.0,br BRA,DFMF,32.0,2.5,117.0,94.0,21.0,1.0,0.0,0.0,6.0,20.0,0.0,0.0,0.0,0.0,87.0,2.0,2.0,Matches,213.0,br BRA,DFMF,32.0,2.5,87.0,117.0,74.4,1376.0,431.0,47.0,57.0,82.5,34.0,44.0,77.3,4.0,11.0,36.4,0.0,0.6,0.7,-0.6,4.0,5.0,5.0,1.0,11.0,Matches,246,br BRA,DFMF,32,6,224.0,37.0,6.5,2.5,3,47.0,0,3,27.0,1,1.0,3.0,3.0,0.0,0.0,0.51,3.2,2.5,0.7,0.29,0.58,Matches,213.0,br BRA,DFMF,32.0,2.5,149.0,10.0,32.0,64.0,53.0,4.0,149.0,4.0,1.0,25.0,3.0,75.0,87.0,409.0,191.0,4.0,6.0,0.0,4.0,1.0,80.0,18.0,Matches,213.0,br BRA,DFMF,32.0,2.5,0.0,3.0,2.0,66.7,1.21,0.8,0.0,0.0,13.9,0.0,0.0,0.0,0.2,0.2,0.07,-0.2,-0.2,Matches,213.0,br BRA,DFMF,32.0,6.0,3.0,224.0,2.5,0.0,0.0,0.0,0.0,0.0,0.0,1.0,1.0,0.2,0.2,0.6,0.8,4.0,11.0,18.0,0.0,0.0,0.0,0.0,0.0,0.08,0.24,0.32,0.08,0.32,Matches,Fábio,GK,41,127,154,"Brazil,Italy",FLU,1,5,10,6,9,1,7,3,4,3,11,9,6,10,13,15,14,13,13,10,13,18,1,15,2,15,13,12,10,12,9,16,12,10,12,13,14,3,14,10,2,14,12,13,4,15,11,15,12,14,15,12,10,10,8,20,18,18,15,15,20,1,1,1,1,1,1,1,1,1,1,1,1,1,188,92,7,20,150741,6292,6292,4174,Mediterranean_Hispanic,130,3,1980/9/30,0,0,8945.0,,303204
524,Wout Faes,Reims,1998,215.0,be BEL,DF,24.0,3.0,1.0,1.0,1.0,0.0,0.0,1.0,2.0,50.0,1.0,6.0,3.0,3.0,7.0,8.0,19.0,0.0,Matches,215.0,be BEL,DF,24.0,3.0,3.0,1.0,3.0,0.0,0.0,0.0,0.0,0.0,2.0,0.67,2.0,0.0,0.0,0.0,0.0,0.0,Matches,,,,,,,,,,,,,,,,,,,,,,,,,,,,,,,,,,,,,,,,,,,,,,,,,,,,,,,,215.0,be BEL,DF,24.0,3.0,2.0,0.0,0.0,2.0,3.0,0.0,0.0,7.0,1.0,0.0,0.0,1.0,15.0,4.0,6.0,40.0,Matches,215.0,be BEL,DF,24.0,3.0,115.0,106.0,8.0,7.0,1.0,0.0,0.0,0.0,0.0,0.0,0.0,0.0,95.0,1.0,1.0,Matches,215.0,be BEL,DF,24.0,3.0,95.0,115.0,82.6,2016.0,841.0,22.0,28.0,78.6,54.0,58.0,93.1,16.0,23.0,69.6,0.0,0.0,0.2,0.0,1.0,8.0,2.0,0.0,8.0,Matches,248,be BEL,DF,24,3,270.0,90.0,7.9,3.0,3,90.0,3,0,,0,0.67,3.0,6.0,-3.0,-1.0,-1.09,3.4,4.4,-1.1,-0.35,-0.63,Matches,215.0,be BEL,DF,24.0,3.0,150.0,38.0,85.0,64.0,2.0,1.0,150.0,2.0,1.0,50.0,1.0,50.0,91.0,402.0,210.0,1.0,0.0,0.0,1.0,1.0,76.0,1.0,Matches,215.0,be BEL,DF,24.0,3.0,0.0,0.0,0.0,,0.0,0.0,,,,0.0,0.0,0.0,0.0,0.0,,0.0,0.0,Matches,215.0,be BEL,DF,24.0,3.0,3.0,270.0,3.0,0.0,0.0,0.0,0.0,0.0,0.0,2.0,0.0,0.0,0.0,0.0,0.0,1.0,8.0,1.0,0.0,0.0,0.0,0.0,0.0,0.0,0.0,0.0,0.0,0.0,Matches,Wout Faes,D C,24,135,144,Belgium,Leicester City,8,10,11,6,12,8,14,8,5,15,13,5,15,12,13,17,14,14,13,14,12,14,8,15,8,14,14,15,12,12,13,14,12,12,14,13,14,15,12,6,10,1,2,1,2,2,3,3,1,4,1,2,11,15,4,13,12,11,12,17,1,1,20,1,1,1,14,1,10,1,1,1,1,1,187,84,7,20,18501541,6600,6600,4500,Northern_European,135,5,1998/4/3,1,0,69595.0,,18083577
525,Romain Faivre,Lyon,1998,217.0,fr FRA,MF,24.0,3.3,6.0,3.0,2.0,2.0,2.0,1.0,3.0,33.3,2.0,3.0,0.0,3.0,0.0,6.0,0.0,0.0,Matches,217.0,fr FRA,MF,24.0,3.3,13.0,3.87,10.0,3.0,0.0,0.0,0.0,0.0,1.0,0.3,0.0,1.0,0.0,0.0,0.0,0.0,Matches,,,,,,,,,,,,,,,,,,,,,,,,,,,,,,,,,,,,,,,,,,,,,,,,,,,,,,,,217.0,fr FRA,MF,24.0,3.3,0.0,0.0,0.0,7.0,4.0,0.0,17.0,0.0,3.0,0.0,0.0,0.0,16.0,2.0,1.0,66.7,Matches,217.0,fr FRA,MF,24.0,3.3,170.0,149.0,19.0,8.0,0.0,1.0,17.0,0.0,10.0,8.0,2.0,0.0,145.0,2.0,1.0,Matches,217.0,fr FRA,MF,24.0,3.3,145.0,170.0,85.3,2183.0,685.0,84.0,92.0,91.3,43.0,49.0,87.8,10.0,18.0,55.6,1.0,0.3,0.6,0.7,6.0,17.0,3.0,1.0,24.0,Matches,251,fr FRA,MF,24,10,300.0,30.0,8.8,3.3,3,67.0,1,7,14.0,5,1.6,9.0,5.0,4.0,1.2,0.8,7.6,3.5,4.1,1.22,1.06,Matches,217.0,fr FRA,MF,24.0,3.3,216.0,1.0,15.0,112.0,95.0,6.0,216.0,20.0,3.0,15.0,16.0,80.0,160.0,1198.0,543.0,14.0,12.0,1.0,4.0,3.0,153.0,16.0,Matches,217.0,fr FRA,MF,24.0,3.3,0.0,5.0,2.0,40.0,1.5,0.6,0.0,0.0,23.6,0.0,0.0,0.0,0.2,0.2,0.03,-0.2,-0.2,Matches,217.0,fr FRA,MF,24.0,10.0,3.0,300.0,3.3,0.0,1.0,1.0,0.0,0.0,0.0,0.0,0.0,0.2,0.2,0.3,0.5,14.0,24.0,16.0,0.0,0.3,0.3,0.0,0.3,0.05,0.09,0.14,0.05,0.14,Matches,Romain Faivre,M/AM RLC,24,134,146,France,Olympique Lyonnais,11,11,14,12,14,13,9,12,5,6,13,11,6,14,10,11,11,13,13,13,12,13,12,8,13,8,13,12,14,14,13,12,13,14,14,12,13,7,12,6,13,2,3,3,3,2,1,2,1,1,1,2,14,12,6,13,12,14,14,13,1,1,1,1,1,1,1,13,18,13,17,20,19,1,185,75,20,12,23437930,6700,6700,3900,North_African__Middle_Eastern,130,7,1998/7/14,0,0,24687.0,,49040542
526,Khalil Fayad,Montpellier,2004,219.0,fr FRA,MF,18.0,8.0,30.0,14.0,12.0,16.0,2.0,12.0,21.0,57.1,9.0,8.0,1.0,7.0,9.0,39.0,4.0,0.0,Matches,219.0,fr FRA,MF,18.0,8.0,19.0,2.38,15.0,2.0,1.0,1.0,0.0,0.0,5.0,0.63,4.0,0.0,0.0,1.0,0.0,0.0,Matches,,,,,,,,,,,,,,,,,,,,,,,,,,,,,,,,,,,,,,,,,,,,,,,,,,,,,,,,219.0,fr FRA,MF,18.0,8.0,1.0,1.0,0.0,17.0,16.0,0.0,10.0,9.0,14.0,0.0,0.0,0.0,47.0,3.0,14.0,17.6,Matches,219.0,fr FRA,MF,18.0,8.0,341.0,330.0,10.0,6.0,2.0,2.0,10.0,1.0,3.0,2.0,1.0,0.0,283.0,1.0,3.0,Matches,219.0,fr FRA,MF,18.0,8.0,283.0,341.0,83.0,4478.0,1236.0,141.0,158.0,89.2,114.0,129.0,88.4,18.0,36.0,50.0,2.0,1.4,0.7,0.6,12.0,21.0,4.0,2.0,22.0,Matches,253,fr FRA,MF,18,24,718.0,30.0,21.0,8.0,7,67.0,2,17,15.0,8,1.21,17.0,15.0,2.0,0.25,0.22,10.4,14.3,-3.9,-0.49,-0.29,Matches,219.0,fr FRA,MF,18.0,8.0,438.0,11.0,99.0,274.0,73.0,5.0,438.0,16.0,8.0,50.0,4.0,25.0,318.0,1724.0,659.0,9.0,12.0,1.0,15.0,7.0,278.0,11.0,Matches,219.0,fr FRA,MF,18.0,8.0,0.0,8.0,3.0,37.5,1.0,0.38,0.0,0.0,21.8,0.0,0.0,0.0,0.5,0.5,0.06,-0.5,-0.5,Matches,219.0,fr FRA,MF,18.0,24.0,7.0,718.0,8.0,0.0,2.0,2.0,0.0,0.0,0.0,1.0,1.0,0.5,0.5,1.4,1.9,9.0,22.0,11.0,0.0,0.25,0.25,0.0,0.25,0.06,0.17,0.24,0.06,0.24,Matches,Khalil Fayad,M C,18,95,-75,France,Montpellier Hérault SC,8,8,8,7,13,8,8,7,3,10,13,5,10,15,8,11,9,10,10,13,14,14,5,8,6,8,9,13,12,11,9,5,6,11,11,10,15,10,8,12,12,3,2,3,3,3,2,1,1,3,2,3,8,14,12,10,13,9,10,13,1,1,1,1,1,1,12,1,20,1,1,1,1,1,172,61,12,20,11034399,4747,4747,1747,North_African__Middle_Eastern,96,9,2004/6/9,0,0,2320.0,,2000006178
527,Ignatius Ganago,Lens,1999,235.0,cm CMR,FW,23.0,0.7,0.0,0.0,0.0,0.0,0.0,0.0,0.0,,0.0,0.0,0.0,0.0,0.0,0.0,1.0,0.0,Matches,235.0,cm CMR,FW,23.0,0.7,0.0,0.0,0.0,0.0,0.0,0.0,0.0,0.0,0.0,0.0,0.0,0.0,0.0,0.0,0.0,0.0,Matches,,,,,,,,,,,,,,,,,,,,,,,,,,,,,,,,,,,,,,,,,,,,,,,,,,,,,,,,235.0,cm CMR,FW,23.0,0.7,0.0,0.0,0.0,2.0,0.0,1.0,0.0,0.0,0.0,0.0,0.0,0.0,5.0,2.0,4.0,33.3,Matches,235.0,cm CMR,FW,23.0,0.7,11.0,9.0,2.0,0.0,0.0,0.0,0.0,0.0,0.0,0.0,0.0,0.0,10.0,0.0,0.0,Matches,235.0,cm CMR,FW,23.0,0.7,10.0,11.0,90.9,204.0,74.0,3.0,3.0,100.0,6.0,7.0,85.7,1.0,1.0,100.0,0.0,0.0,0.0,0.0,0.0,1.0,0.0,0.0,3.0,Matches,273,cm CMR,FW,23,4,59.0,15.0,1.7,0.7,0,,0,4,15.0,0,2.5,1.0,2.0,-1.0,-1.53,-2.6,0.5,1.9,-1.4,-2.09,-2.75,Matches,235.0,cm CMR,FW,23.0,0.7,17.0,0.0,2.0,13.0,3.0,0.0,17.0,1.0,0.0,0.0,1.0,100.0,13.0,120.0,30.0,0.0,1.0,0.0,2.0,2.0,11.0,3.0,Matches,235.0,cm CMR,FW,23.0,0.7,0.0,1.0,0.0,0.0,1.53,0.0,0.0,,23.1,0.0,0.0,0.0,0.0,0.0,0.05,0.0,0.0,Matches,235.0,cm CMR,FW,23.0,4.0,0.0,59.0,0.7,0.0,0.0,0.0,0.0,0.0,0.0,0.0,0.0,0.0,0.0,0.0,0.0,0.0,3.0,3.0,0.0,0.0,0.0,0.0,0.0,0.07,0.0,0.07,0.07,0.07,Matches,Ignatius Ganago,S,23,119,135,Cameroon,FC Nantes,7,9,12,14,12,10,12,11,8,8,11,12,10,12,8,11,13,12,11,8,11,12,12,8,14,6,11,13,15,12,15,11,14,14,12,14,12,6,10,13,6,2,1,1,1,3,3,3,1,2,1,1,13,14,2,9,11,12,11,16,1,1,1,1,1,1,1,1,1,1,10,1,1,20,179,82,8,20,4378602,5950,5950,3900,African_Caribbean,118,17,1999/2/16,11,0,13919.0,,49045927
528,Ismaël Gharbi,Paris S-G,2004,240.0,es ESP,MFFW,18.0,0.6,0.0,0.0,0.0,0.0,0.0,0.0,2.0,0.0,2.0,2.0,0.0,2.0,3.0,3.0,0.0,0.0,Matches,240.0,es ESP,MFFW,18.0,0.6,2.0,3.1,0.0,0.0,1.0,0.0,1.0,0.0,0.0,0.0,0.0,0.0,0.0,0.0,0.0,0.0,Matches,,,,,,,,,,,,,,,,,,,,,,,,,,,,,,,,,,,,,,,,,,,,,,,,,,,,,,,,240.0,es ESP,MFFW,18.0,0.6,1.0,0.0,0.0,3.0,4.0,0.0,0.0,3.0,0.0,0.0,0.0,0.0,3.0,0.0,0.0,,Matches,240.0,es ESP,MFFW,18.0,0.6,36.0,33.0,3.0,2.0,0.0,0.0,0.0,0.0,1.0,0.0,0.0,0.0,32.0,0.0,0.0,Matches,240.0,es ESP,MFFW,18.0,0.6,32.0,36.0,88.9,320.0,45.0,23.0,26.0,88.5,5.0,5.0,100.0,0.0,1.0,0.0,0.0,0.0,0.1,0.0,0.0,1.0,0.0,0.0,1.0,Matches,280,es ESP,MFFW,18,6,58.0,10.0,1.7,0.6,0,,0,6,10.0,20,1.0,0.0,0.0,0.0,0.0,-1.31,0.7,1.1,-0.4,-0.66,-1.47,Matches,240.0,es ESP,MFFW,18.0,0.6,47.0,1.0,3.0,25.0,20.0,2.0,47.0,6.0,5.0,83.3,1.0,16.7,42.0,298.0,160.0,3.0,1.0,0.0,1.0,1.0,39.0,8.0,Matches,240.0,es ESP,MFFW,18.0,0.6,0.0,3.0,1.0,33.3,4.66,1.55,0.0,0.0,21.3,0.0,0.0,0.0,0.2,0.2,0.07,-0.2,-0.2,Matches,240.0,es ESP,MFFW,18.0,6.0,0.0,58.0,0.6,0.0,0.0,0.0,0.0,0.0,0.0,1.0,0.0,0.2,0.2,0.0,0.2,3.0,1.0,8.0,0.0,0.0,0.0,0.0,0.0,0.32,0.0,0.32,0.32,0.32,Matches,Ismaël Gharbi,AM RC,18,97,-8,"Spain,France,Tunisia",Paris Saint-Germain,11,11,13,11,13,10,7,9,3,6,10,10,7,13,10,11,12,11,10,13,9,12,13,7,11,6,11,11,12,14,12,7,12,11,12,7,10,10,10,4,10,3,3,3,1,2,2,3,1,3,1,1,17,13,7,9,11,11,11,14,1,1,1,1,1,1,1,1,12,1,1,20,15,1,173,63,10,20,28560000,4846,4846,1760,North_African__Middle_Eastern,97,9,2004/4/10,0,0,1162.0,,2000006181
529,Faouzi Ghoulam,Angers,1991,241.0,dz ALG,DF,31.0,5.3,3.0,3.0,1.0,1.0,1.0,3.0,5.0,60.0,2.0,4.0,2.0,2.0,4.0,7.0,12.0,1.0,Matches,241.0,dz ALG,DF,31.0,5.3,17.0,3.2,6.0,10.0,0.0,0.0,1.0,0.0,1.0,0.19,1.0,0.0,0.0,0.0,0.0,0.0,Matches,,,,,,,,,,,,,,,,,,,,,,,,,,,,,,,,,,,,,,,,,,,,,,,,,,,,,,,,241.0,dz ALG,DF,31.0,5.3,0.0,0.0,0.0,4.0,5.0,2.0,38.0,4.0,3.0,0.0,0.0,0.0,21.0,9.0,6.0,60.0,Matches,241.0,dz ALG,DF,31.0,5.3,329.0,242.0,86.0,22.0,0.0,1.0,38.0,48.0,15.0,3.0,12.0,0.0,233.0,1.0,10.0,Matches,241.0,dz ALG,DF,31.0,5.3,233.0,329.0,70.8,4360.0,1945.0,101.0,114.0,88.6,97.0,128.0,75.8,31.0,71.0,43.7,0.0,0.8,0.5,-0.8,10.0,11.0,2.0,1.0,19.0,Matches,281,dz ALG,DF,31,7,479.0,68.0,14.0,5.3,6,76.0,1,1,25.0,0,0.86,4.0,7.0,-3.0,-0.56,0.81,4.3,8.7,-4.5,-0.84,-0.34,Matches,241.0,dz ALG,DF,31.0,5.3,364.0,27.0,114.0,162.0,89.0,1.0,364.0,5.0,3.0,60.0,0.0,0.0,221.0,1093.0,526.0,4.0,6.0,0.0,1.0,2.0,218.0,20.0,Matches,241.0,dz ALG,DF,31.0,5.3,0.0,1.0,0.0,0.0,0.19,0.0,0.0,,24.4,0.0,0.0,0.0,0.1,0.1,0.07,-0.1,-0.1,Matches,241.0,dz ALG,DF,31.0,7.0,6.0,479.0,5.3,0.0,0.0,0.0,0.0,0.0,0.0,0.0,0.0,0.1,0.1,0.8,0.8,4.0,19.0,20.0,0.0,0.0,0.0,0.0,0.0,0.01,0.14,0.16,0.01,0.16,Matches,Faouzi Ghoulam,D/WB L,31,134,151,"Algeria,France",,13,15,12,8,14,11,11,12,18,12,14,10,14,14,11,14,14,14,14,11,13,15,11,7,14,13,14,17,13,12,14,12,5,14,11,13,12,12,13,20,12,1,1,2,1,2,2,2,4,1,2,2,14,14,12,14,14,17,13,12,1,20,1,1,18,1,1,13,1,1,10,1,1,1,184,80,20,8,-1,6700,7250,5250,North_African__Middle_Eastern,135,8,1991/2/1,37,5,,,85051536
530,Amine Gouiri,Nice,2000,249.0,dz ALG,FWMF,22.0,2.5,1.0,1.0,1.0,0.0,0.0,0.0,1.0,0.0,1.0,1.0,0.0,1.0,0.0,1.0,3.0,0.0,Matches,249.0,dz ALG,FWMF,22.0,2.5,7.0,2.79,4.0,1.0,0.0,1.0,1.0,0.0,1.0,0.4,0.0,0.0,0.0,0.0,1.0,0.0,Matches,,,,,,,,,,,,,,,,,,,,,,,,,,,,,,,,,,,,,,,,,,,,,,,,,,,,,,,,249.0,dz ALG,FWMF,22.0,2.5,0.0,0.0,0.0,2.0,2.0,0.0,6.0,0.0,1.0,1.0,0.0,0.0,6.0,3.0,2.0,60.0,Matches,249.0,dz ALG,FWMF,22.0,2.5,74.0,66.0,6.0,1.0,0.0,0.0,6.0,0.0,3.0,3.0,0.0,0.0,53.0,2.0,7.0,Matches,249.0,dz ALG,FWMF,22.0,2.5,53.0,74.0,71.6,736.0,116.0,30.0,35.0,85.7,17.0,22.0,77.3,2.0,5.0,40.0,0.0,0.3,0.2,-0.3,3.0,2.0,1.0,0.0,1.0,Matches,289,dz ALG,FWMF,22,3,226.0,75.0,6.6,2.5,3,75.0,1,0,,1,0.67,1.0,3.0,-2.0,-0.8,-1.16,3.5,2.3,1.2,0.48,0.16,Matches,249.0,dz ALG,FWMF,22.0,2.5,99.0,3.0,12.0,35.0,52.0,7.0,99.0,3.0,0.0,0.0,2.0,66.7,75.0,470.0,179.0,8.0,3.0,2.0,7.0,5.0,79.0,18.0,Matches,249.0,dz ALG,FWMF,22.0,2.5,0.0,5.0,2.0,40.0,1.99,0.8,0.0,0.0,12.5,0.0,0.0,0.0,0.6,0.6,0.12,-0.6,-0.6,Matches,249.0,dz ALG,FWMF,22.0,3.0,3.0,226.0,2.5,0.0,0.0,0.0,0.0,0.0,0.0,0.0,0.0,0.6,0.6,0.3,0.8,8.0,1.0,18.0,0.0,0.0,0.0,0.0,0.0,0.23,0.1,0.33,0.23,0.33,Matches,Amine Gouiri,AM/S L,22,132,156,"France,Algeria",Stade Rennais FC,6,10,15,14,15,8,11,13,4,4,13,12,4,15,13,12,14,14,13,14,13,16,16,10,15,9,15,14,14,14,15,12,15,14,13,12,13,8,15,7,11,3,2,2,2,2,1,1,2,3,1,4,16,15,8,14,16,16,11,14,1,1,1,1,1,1,1,12,1,1,20,1,1,19,180,72,8,20,32213997,6600,6600,4750,North_African__Middle_Eastern,134,6,2000/2/16,0,0,20106.0,,48044735
531,Gabriel Gudmundsson,Lille,1999,254.0,se SWE,DFFW,23.0,9.3,19.0,11.0,7.0,10.0,2.0,12.0,22.0,54.5,10.0,11.0,2.0,9.0,10.0,29.0,20.0,0.0,Matches,254.0,se SWE,DFFW,23.0,9.3,22.0,2.37,16.0,0.0,3.0,1.0,2.0,0.0,1.0,0.11,0.0,0.0,0.0,0.0,1.0,0.0,Matches,,,,,,,,,,,,,,,,,,,,,,,,,,,,,,,,,,,,,,,,,,,,,,,,,,,,,,,,254.0,se SWE,DFFW,23.0,9.3,3.0,0.0,0.0,17.0,21.0,3.0,33.0,10.0,11.0,1.0,0.0,0.0,46.0,12.0,7.0,63.2,Matches,254.0,se SWE,DFFW,23.0,9.3,455.0,363.0,92.0,10.0,0.0,1.0,33.0,81.0,1.0,1.0,0.0,0.0,369.0,0.0,9.0,Matches,254.0,se SWE,DFFW,23.0,9.3,369.0,455.0,81.1,6058.0,1643.0,170.0,200.0,85.0,161.0,188.0,85.6,24.0,46.0,52.2,0.0,0.9,1.5,-0.9,11.0,22.0,8.0,7.0,31.0,Matches,294,se SWE,DFFW,23,18,838.0,47.0,24.5,9.3,9,72.0,5,9,21.0,6,1.72,18.0,16.0,2.0,0.21,-0.45,17.0,11.4,5.6,0.6,-0.19,Matches,254.0,se SWE,DFFW,23.0,9.3,563.0,26.0,142.0,247.0,180.0,24.0,563.0,32.0,18.0,56.3,9.0,28.1,355.0,2508.0,1298.0,44.0,25.0,10.0,13.0,7.0,323.0,57.0,Matches,254.0,se SWE,DFFW,23.0,9.3,0.0,7.0,1.0,14.3,0.75,0.11,0.0,0.0,22.0,0.0,0.0,0.0,0.5,0.5,0.07,-0.5,-0.5,Matches,254.0,se SWE,DFFW,23.0,18.0,9.0,838.0,9.3,0.0,0.0,0.0,0.0,0.0,0.0,3.0,0.0,0.5,0.5,0.9,1.3,44.0,31.0,57.0,0.0,0.0,0.0,0.0,0.0,0.05,0.09,0.14,0.05,0.14,Matches,Gabriel Gudmundsson,D/WB/M/AM L,23,118,138,Sweden,LOSC Lille,9,12,14,10,11,7,9,12,5,8,12,6,6,12,9,10,10,10,10,8,10,12,13,8,12,10,13,13,15,13,10,10,11,15,13,9,11,7,7,7,7,1,1,2,3,2,2,2,2,2,3,2,10,12,2,17,11,12,13,16,1,18,1,10,20,10,1,18,1,10,18,8,10,1,181,78,20,7,1617317,5889,5939,5239,Northern_European,102,4,1999/4/29,0,0,6534.0,,93065006
532,Pape Gueye,Marseille,1999,258.0,sn SEN,MFDF,23.0,5.5,18.0,7.0,10.0,7.0,1.0,7.0,15.0,46.7,8.0,9.0,2.0,7.0,9.0,27.0,2.0,0.0,Matches,258.0,sn SEN,MFDF,23.0,5.5,10.0,1.83,10.0,0.0,0.0,0.0,0.0,0.0,1.0,0.18,1.0,0.0,0.0,0.0,0.0,0.0,Matches,,,,,,,,,,,,,,,,,,,,,,,,,,,,,,,,,,,,,,,,,,,,,,,,,,,,,,,,258.0,sn SEN,MFDF,23.0,5.5,1.0,0.0,0.0,10.0,12.0,1.0,3.0,9.0,7.0,0.0,0.0,0.0,42.0,11.0,5.0,68.8,Matches,258.0,sn SEN,MFDF,23.0,5.5,320.0,304.0,15.0,9.0,0.0,2.0,3.0,6.0,0.0,0.0,0.0,0.0,271.0,1.0,2.0,Matches,258.0,sn SEN,MFDF,23.0,5.5,271.0,320.0,84.7,4966.0,1291.0,100.0,106.0,94.3,142.0,165.0,86.1,25.0,39.0,64.1,1.0,0.9,0.4,0.1,4.0,22.0,6.0,2.0,31.0,Matches,299,sn SEN,MFDF,23,14,492.0,35.0,14.4,5.5,4,75.0,2,10,19.0,3,2.07,13.0,5.0,8.0,1.46,0.88,11.3,5.9,5.4,0.98,0.44,Matches,258.0,sn SEN,MFDF,23.0,5.5,388.0,9.0,72.0,246.0,73.0,7.0,388.0,7.0,1.0,14.3,4.0,57.1,297.0,1687.0,881.0,9.0,4.0,1.0,7.0,6.0,271.0,13.0,Matches,258.0,sn SEN,MFDF,23.0,5.5,1.0,8.0,4.0,50.0,1.46,0.73,0.13,0.25,16.8,0.0,0.0,0.0,0.7,0.7,0.09,0.3,0.3,Matches,258.0,sn SEN,MFDF,23.0,14.0,4.0,492.0,5.5,1.0,1.0,2.0,1.0,0.0,0.0,1.0,0.0,0.7,0.7,0.9,1.6,9.0,31.0,13.0,0.18,0.18,0.37,0.18,0.37,0.13,0.16,0.29,0.13,0.29,Matches,Pape Gueye,DM/M C,23,125,145,"Senegal,France",Olympique de Marseille,11,8,11,6,13,10,10,14,3,12,14,9,14,13,12,13,11,7,8,12,12,13,13,12,13,14,15,14,14,11,14,10,14,14,14,14,11,11,10,12,9,2,1,3,3,2,1,2,2,1,1,2,13,15,13,7,8,7,11,10,1,1,1,1,1,1,20,1,18,1,1,1,1,1,183,65,20,10,4159691,6250,6000,4500,African_Caribbean,125,17,1999/1/24,11,0,27615.0,,48043484
533,Serhou Guirassy,Rennes,1996,260.0,gn GUI,MF,26.0,0.3,0.0,0.0,0.0,0.0,0.0,0.0,0.0,,0.0,0.0,0.0,0.0,0.0,0.0,0.0,0.0,Matches,260.0,gn GUI,MF,26.0,0.3,2.0,7.83,2.0,0.0,0.0,0.0,0.0,0.0,0.0,0.0,0.0,0.0,0.0,0.0,0.0,0.0,Matches,,,,,,,,,,,,,,,,,,,,,,,,,,,,,,,,,,,,,,,,,,,,,,,,,,,,,,,,260.0,gn GUI,MF,26.0,0.3,0.0,0.0,0.0,0.0,0.0,0.0,0.0,0.0,0.0,0.0,0.0,0.0,1.0,0.0,0.0,,Matches,260.0,gn GUI,MF,26.0,0.3,8.0,8.0,0.0,0.0,0.0,0.0,0.0,0.0,0.0,0.0,0.0,0.0,8.0,0.0,0.0,Matches,260.0,gn GUI,MF,26.0,0.3,8.0,8.0,100.0,67.0,7.0,6.0,6.0,100.0,0.0,0.0,,0.0,0.0,,0.0,0.1,0.0,-0.1,2.0,1.0,0.0,0.0,0.0,Matches,301,gn GUI,MF,26,1,23.0,23.0,0.7,0.3,0,,0,1,23.0,0,0.0,0.0,0.0,0.0,0.0,-0.79,0.4,0.9,-0.5,-1.81,-2.28,Matches,260.0,gn GUI,MF,26.0,0.3,13.0,1.0,1.0,3.0,9.0,5.0,13.0,0.0,0.0,,0.0,,9.0,43.0,0.0,0.0,0.0,0.0,0.0,1.0,8.0,6.0,Matches,260.0,gn GUI,MF,26.0,0.3,0.0,2.0,1.0,50.0,7.83,3.91,0.0,0.0,10.5,0.0,0.0,0.0,0.1,0.1,0.06,-0.1,-0.1,Matches,260.0,gn GUI,MF,26.0,1.0,0.0,23.0,0.3,0.0,0.0,0.0,0.0,0.0,0.0,0.0,0.0,0.1,0.1,0.1,0.3,0.0,0.0,6.0,0.0,0.0,0.0,0.0,0.0,0.44,0.57,1.0,0.44,1.0,Matches,Serhou Guirassy,AM/S L,26,129,135,"France,Guinea",Stade Rennais FC,6,9,11,14,12,10,15,11,5,5,13,13,6,12,12,13,15,11,8,11,12,13,14,6,12,6,15,14,13,12,15,15,14,15,14,15,13,5,12,12,7,2,1,1,3,3,3,2,3,2,3,3,9,16,13,9,11,12,14,14,1,1,1,1,1,1,1,12,1,10,16,8,10,20,187,82,10,20,4615653,6449,6449,3999,African_Caribbean,126,16,1996/3/12,0,0,22998.0,VfB Stuttgart,85111795
534,Rafik Guitane,Reims,1999,261.0,fr FRA,FW,23.0,0.0,0.0,0.0,0.0,0.0,0.0,0.0,0.0,,0.0,0.0,0.0,0.0,0.0,0.0,1.0,0.0,Matches,261.0,fr FRA,FW,23.0,0.0,0.0,0.0,0.0,0.0,0.0,0.0,0.0,0.0,0.0,0.0,0.0,0.0,0.0,0.0,0.0,0.0,Matches,,,,,,,,,,,,,,,,,,,,,,,,,,,,,,,,,,,,,,,,,,,,,,,,,,,,,,,,261.0,fr FRA,FW,23.0,0.0,0.0,0.0,0.0,1.0,0.0,0.0,0.0,0.0,0.0,0.0,0.0,0.0,1.0,0.0,0.0,,Matches,261.0,fr FRA,FW,23.0,0.0,0.0,0.0,0.0,0.0,0.0,0.0,0.0,0.0,0.0,0.0,0.0,0.0,0.0,0.0,0.0,Matches,261.0,fr FRA,FW,23.0,0.0,0.0,0.0,,0.0,0.0,0.0,0.0,,0.0,0.0,,0.0,0.0,,0.0,0.0,0.0,0.0,0.0,0.0,0.0,0.0,0.0,Matches,302,fr FRA,FW,23,1,3.0,3.0,0.1,0.0,0,,0,1,3.0,7,3.0,0.0,0.0,0.0,0.0,0.0,0.0,0.0,0.0,0.27,0.03,Matches,261.0,fr FRA,FW,23.0,0.0,3.0,1.0,2.0,1.0,0.0,0.0,3.0,0.0,0.0,,0.0,,1.0,7.0,0.0,0.0,0.0,0.0,0.0,1.0,0.0,0.0,Matches,261.0,fr FRA,FW,23.0,0.0,0.0,0.0,0.0,,0.0,0.0,,,,0.0,0.0,0.0,0.0,0.0,,0.0,0.0,Matches,261.0,fr FRA,FW,23.0,1.0,0.0,3.0,0.0,0.0,0.0,0.0,0.0,0.0,0.0,0.0,0.0,0.0,0.0,0.0,0.0,0.0,0.0,0.0,0.0,0.0,0.0,0.0,0.0,0.0,0.0,0.0,0.0,0.0,Matches,Rafik Guitane,M/AM RC,23,120,134,"France,Algeria",Stade de Reims,12,12,15,8,13,11,6,9,5,6,13,10,5,16,7,11,9,14,11,14,11,8,15,10,12,9,9,11,13,16,14,5,11,13,11,8,10,7,14,14,10,3,2,3,3,1,3,3,3,3,3,3,10,14,8,12,13,12,8,10,1,1,1,1,1,1,1,1,18,1,12,20,18,1,170,60,20,12,1853658,6000,6000,4008,North_African__Middle_Eastern,117,11,1999/5/26,0,0,6547.0,,48043095
535,Amine Harit,Marseille,1997,270.0,ma MAR,MFFW,25.0,5.7,6.0,4.0,0.0,3.0,3.0,3.0,8.0,37.5,5.0,4.0,1.0,3.0,4.0,10.0,6.0,0.0,Matches,270.0,ma MAR,MFFW,25.0,5.7,30.0,5.25,23.0,3.0,3.0,0.0,1.0,0.0,2.0,0.35,2.0,0.0,0.0,0.0,0.0,0.0,Matches,,,,,,,,,,,,,,,,,,,,,,,,,,,,,,,,,,,,,,,,,,,,,,,,,,,,,,,,270.0,ma MAR,MFFW,25.0,5.7,1.0,0.0,0.0,2.0,13.0,2.0,16.0,4.0,4.0,0.0,0.0,0.0,27.0,1.0,12.0,7.7,Matches,270.0,ma MAR,MFFW,25.0,5.7,271.0,252.0,19.0,3.0,2.0,0.0,16.0,5.0,9.0,2.0,6.0,0.0,221.0,0.0,10.0,Matches,270.0,ma MAR,MFFW,25.0,5.7,221.0,271.0,81.5,3186.0,969.0,133.0,154.0,86.4,61.0,70.0,87.1,13.0,22.0,59.1,0.0,1.5,1.6,-1.5,15.0,21.0,16.0,1.0,38.0,Matches,312,ma MAR,MFFW,25,10,515.0,52.0,15.1,5.7,6,72.0,1,4,20.0,0,1.7,6.0,5.0,1.0,0.17,-0.63,9.8,8.0,1.8,0.31,-0.34,Matches,270.0,ma MAR,MFFW,25.0,5.7,341.0,10.0,33.0,139.0,176.0,30.0,341.0,36.0,13.0,36.1,18.0,50.0,284.0,1842.0,791.0,19.0,13.0,9.0,18.0,17.0,273.0,54.0,Matches,270.0,ma MAR,MFFW,25.0,5.7,0.0,6.0,3.0,50.0,1.05,0.52,0.0,0.0,18.7,0.0,0.0,0.0,0.5,0.5,0.08,-0.5,-0.5,Matches,270.0,ma MAR,MFFW,25.0,10.0,6.0,515.0,5.7,0.0,0.0,0.0,0.0,0.0,0.0,1.0,0.0,0.5,0.5,1.5,2.0,19.0,38.0,54.0,0.0,0.0,0.0,0.0,0.0,0.09,0.25,0.34,0.09,0.34,Matches,Amine Harit,AM RLC,25,136,153,"Morocco,France",FC Schalke 04,14,11,17,11,15,14,5,10,3,8,15,12,8,17,12,12,9,13,11,16,12,12,17,4,13,8,12,12,15,16,12,8,13,14,12,7,12,6,12,8,15,1,2,1,1,3,1,3,1,1,1,3,12,13,16,8,10,10,10,11,1,1,1,1,1,1,1,15,12,11,18,20,15,12,180,67,10,20,4111059,6750,6750,5800,North_African__Middle_Eastern,133,10,1997/6/18,14,0,95889.0,Olympique de Marseille,85137101
536,Rhys Healey,Toulouse,1994,271.0,wls WAL,FW,27.0,0.7,0.0,0.0,0.0,0.0,0.0,0.0,0.0,,0.0,0.0,0.0,0.0,0.0,0.0,0.0,0.0,Matches,271.0,wls WAL,FW,27.0,0.7,2.0,2.77,2.0,0.0,0.0,0.0,0.0,0.0,0.0,0.0,0.0,0.0,0.0,0.0,0.0,0.0,Matches,,,,,,,,,,,,,,,,,,,,,,,,,,,,,,,,,,,,,,,,,,,,,,,,,,,,,,,,271.0,wls WAL,FW,27.0,0.7,1.0,0.0,0.0,0.0,0.0,0.0,0.0,0.0,0.0,0.0,0.0,0.0,3.0,2.0,0.0,100.0,Matches,271.0,wls WAL,FW,27.0,0.7,15.0,15.0,0.0,0.0,0.0,0.0,0.0,0.0,0.0,0.0,0.0,0.0,8.0,0.0,1.0,Matches,271.0,wls WAL,FW,27.0,0.7,8.0,15.0,53.3,64.0,7.0,3.0,6.0,50.0,1.0,3.0,33.3,0.0,0.0,,0.0,0.2,0.1,-0.2,2.0,0.0,0.0,0.0,0.0,Matches,314,wls WAL,FW,27,4,64.0,16.0,1.9,0.7,0,,0,4,16.0,0,2.0,2.0,1.0,1.0,1.41,1.59,0.9,1.6,-0.7,-0.94,-0.84,Matches,271.0,wls WAL,FW,27.0,0.7,24.0,0.0,2.0,7.0,15.0,8.0,24.0,0.0,0.0,,0.0,,19.0,94.0,21.0,1.0,0.0,1.0,3.0,2.0,23.0,7.0,Matches,271.0,wls WAL,FW,27.0,0.7,2.0,5.0,3.0,60.0,7.03,4.22,0.4,0.67,15.3,0.0,0.0,0.0,0.4,0.4,0.08,1.6,1.6,Matches,271.0,wls WAL,FW,27.0,4.0,0.0,64.0,0.7,2.0,0.0,2.0,2.0,0.0,0.0,1.0,0.0,0.4,0.4,0.2,0.6,1.0,0.0,7.0,2.81,0.0,2.81,2.81,2.81,0.56,0.34,0.9,0.56,0.9,Matches,Rhys Healey,S,27,125,130,England,Toulouse FC,7,10,12,15,13,8,10,12,8,6,12,12,7,12,11,14,14,14,12,10,12,15,10,6,14,9,14,13,14,13,12,8,12,14,13,12,13,7,8,8,10,3,1,1,1,2,2,2,2,1,3,3,11,15,8,8,9,10,8,12,1,1,1,1,1,1,1,1,1,1,1,1,1,20,180,72,11,20,1717359,6250,6250,3500,Northern_European,125,3,1994/12/6,0,0,10509.0,,74029518
537,Henrique,Lyon,1994,273.0,br BRA,DFFW,28.0,4.0,9.0,4.0,3.0,2.0,4.0,6.0,13.0,46.2,7.0,3.0,1.0,2.0,5.0,14.0,8.0,0.0,Matches,273.0,br BRA,DFFW,28.0,4.0,3.0,0.76,2.0,0.0,0.0,0.0,1.0,0.0,1.0,0.25,1.0,0.0,0.0,0.0,0.0,0.0,Matches,,,,,,,,,,,,,,,,,,,,,,,,,,,,,,,,,,,,,,,,,,,,,,,,,,,,,,,,273.0,br BRA,DFFW,28.0,4.0,0.0,0.0,0.0,5.0,11.0,1.0,4.0,5.0,4.0,0.0,0.0,0.0,15.0,10.0,5.0,66.7,Matches,273.0,br BRA,DFFW,28.0,4.0,223.0,181.0,42.0,6.0,0.0,1.0,4.0,36.0,0.0,0.0,0.0,0.0,192.0,0.0,3.0,Matches,273.0,br BRA,DFFW,28.0,4.0,192.0,223.0,86.1,2975.0,704.0,107.0,122.0,87.7,74.0,79.0,93.7,8.0,16.0,50.0,1.0,0.1,0.2,0.9,1.0,8.0,3.0,1.0,11.0,Matches,316,br BRA,DFFW,28,7,356.0,51.0,10.4,4.0,3,90.0,3,4,22.0,25,2.57,10.0,5.0,5.0,1.26,0.88,6.7,7.0,-0.3,-0.07,-0.36,Matches,273.0,br BRA,DFFW,28.0,4.0,260.0,7.0,66.0,150.0,46.0,1.0,260.0,6.0,1.0,16.7,3.0,50.0,177.0,887.0,285.0,3.0,4.0,0.0,3.0,2.0,168.0,4.0,Matches,273.0,br BRA,DFFW,28.0,4.0,0.0,1.0,0.0,0.0,0.25,0.0,0.0,,27.6,0.0,0.0,0.0,0.0,0.0,0.03,0.0,0.0,Matches,273.0,br BRA,DFFW,28.0,7.0,3.0,356.0,4.0,0.0,1.0,1.0,0.0,0.0,0.0,0.0,0.0,0.0,0.0,0.1,0.1,3.0,11.0,4.0,0.0,0.25,0.25,0.0,0.25,0.01,0.03,0.04,0.01,0.04,Matches,Henrique,D C,35,122,149,Brazil,CTB,3,10,8,9,11,9,13,12,8,14,14,13,12,12,13,12,15,14,13,11,14,14,12,15,9,13,13,14,9,9,13,13,18,9,14,14,14,12,14,7,15,2,3,4,3,1,3,3,3,4,1,1,14,13,7,13,14,14,13,11,1,1,20,1,1,1,14,1,1,1,1,1,1,1,186,84,11,20,228689,6174,6174,3789,Mediterranean_Hispanic,123,6,1986/10/14,7,0,6261.0,,2116459
538,Ilyes Housni,Paris S-G,2005,278.0,fr FRA,FW,17.0,0.1,1.0,1.0,1.0,0.0,0.0,1.0,1.0,100.0,0.0,0.0,0.0,0.0,0.0,1.0,0.0,0.0,Matches,278.0,fr FRA,FW,17.0,0.1,0.0,0.0,0.0,0.0,0.0,0.0,0.0,0.0,0.0,0.0,0.0,0.0,0.0,0.0,0.0,0.0,Matches,,,,,,,,,,,,,,,,,,,,,,,,,,,,,,,,,,,,,,,,,,,,,,,,,,,,,,,,278.0,fr FRA,FW,17.0,0.1,0.0,0.0,0.0,0.0,1.0,0.0,0.0,0.0,1.0,0.0,0.0,0.0,0.0,0.0,0.0,,Matches,278.0,fr FRA,FW,17.0,0.1,3.0,3.0,0.0,0.0,0.0,0.0,0.0,0.0,0.0,0.0,0.0,0.0,3.0,0.0,0.0,Matches,278.0,fr FRA,FW,17.0,0.1,3.0,3.0,100.0,37.0,0.0,2.0,2.0,100.0,1.0,1.0,100.0,0.0,0.0,,0.0,0.0,0.0,0.0,0.0,0.0,0.0,0.0,0.0,Matches,321,fr FRA,FW,17,1,11.0,11.0,0.3,0.1,0,,0,1,11.0,13,0.0,0.0,0.0,0.0,0.0,-1.29,0.0,0.4,-0.4,-2.94,-3.74,Matches,278.0,fr FRA,FW,17.0,0.1,5.0,0.0,1.0,2.0,2.0,0.0,5.0,0.0,0.0,,0.0,,6.0,25.0,13.0,0.0,0.0,0.0,1.0,2.0,6.0,1.0,Matches,278.0,fr FRA,FW,17.0,0.1,0.0,0.0,0.0,,0.0,0.0,,,,0.0,0.0,0.0,0.0,0.0,,0.0,0.0,Matches,278.0,fr FRA,FW,17.0,1.0,0.0,11.0,0.1,0.0,0.0,0.0,0.0,0.0,0.0,0.0,0.0,0.0,0.0,0.0,0.0,0.0,0.0,1.0,0.0,0.0,0.0,0.0,0.0,0.0,0.0,0.0,0.0,0.0,Matches,Ilyes Housni,AM/S L,17,88,-8,"France,Morocco",Paris Saint-Germain,9,12,11,12,11,8,15,10,8,8,12,5,4,12,10,12,6,10,7,11,12,9,10,10,10,6,8,10,11,9,9,10,13,11,10,9,11,11,18,5,12,4,2,2,3,2,3,2,1,3,2,3,18,9,4,10,12,10,12,20,1,1,1,1,1,1,1,1,1,1,17,1,1,20,176,0,8,20,16599999,4397,4397,1147,North_African__Middle_Eastern,87,7,2005/5/14,0,0,645.0,,2000091572
539,Rareş Ilie,Nice,2003,281.0,ro ROU,MFFW,19.0,1.6,3.0,3.0,0.0,1.0,2.0,2.0,4.0,50.0,2.0,2.0,0.0,2.0,1.0,4.0,1.0,0.0,Matches,281.0,ro ROU,MFFW,19.0,1.6,6.0,3.65,3.0,0.0,0.0,1.0,0.0,2.0,0.0,0.0,0.0,0.0,0.0,0.0,0.0,0.0,Matches,,,,,,,,,,,,,,,,,,,,,,,,,,,,,,,,,,,,,,,,,,,,,,,,,,,,,,,,281.0,ro ROU,MFFW,19.0,1.6,0.0,0.0,0.0,0.0,0.0,1.0,1.0,1.0,3.0,0.0,0.0,0.0,9.0,2.0,1.0,66.7,Matches,281.0,ro ROU,MFFW,19.0,1.6,60.0,60.0,0.0,0.0,0.0,0.0,1.0,0.0,0.0,0.0,0.0,0.0,47.0,0.0,3.0,Matches,281.0,ro ROU,MFFW,19.0,1.6,47.0,60.0,78.3,559.0,91.0,32.0,37.0,86.5,8.0,11.0,72.7,2.0,3.0,66.7,0.0,0.2,0.0,-0.2,2.0,2.0,0.0,0.0,1.0,Matches,324,ro ROU,MFFW,19,4,148.0,37.0,4.3,1.6,2,60.0,0,2,14.0,8,1.25,2.0,4.0,-2.0,-1.22,-1.57,1.9,1.8,0.2,0.1,-0.24,Matches,281.0,ro ROU,MFFW,19.0,1.6,75.0,1.0,13.0,28.0,36.0,5.0,75.0,6.0,5.0,83.3,1.0,16.7,58.0,378.0,165.0,7.0,11.0,1.0,3.0,10.0,54.0,6.0,Matches,281.0,ro ROU,MFFW,19.0,1.6,0.0,4.0,0.0,0.0,2.43,0.0,0.0,,16.8,0.0,0.0,0.0,0.3,0.3,0.07,-0.3,-0.3,Matches,281.0,ro ROU,MFFW,19.0,4.0,2.0,148.0,1.6,0.0,0.0,0.0,0.0,0.0,0.0,0.0,0.0,0.3,0.3,0.2,0.5,7.0,1.0,6.0,0.0,0.0,0.0,0.0,0.0,0.18,0.14,0.32,0.18,0.32,Matches,Rareş Ilie,M/AM LC,19,110,-8,Romania,OGC Nice,13,12,12,11,13,12,11,11,6,8,13,9,11,14,7,11,9,12,10,13,10,13,11,4,12,9,12,12,11,12,12,10,10,12,12,11,11,5,10,5,8,2,1,1,3,3,1,1,3,2,2,2,20,13,2,14,11,14,13,15,1,1,1,1,1,1,1,1,18,1,19,20,1,1,183,73,10,20,38442936,5500,5500,3550,Mediterranean_Hispanic,108,4,2003/4/19,0,0,3620.0,,2000045306
540,Léo Jardim,Lille,1995,287.0,br BRA,GK,27.0,6.0,0.0,0.0,0.0,0.0,0.0,0.0,1.0,0.0,1.0,0.0,0.0,0.0,0.0,0.0,0.0,1.0,Matches,287.0,br BRA,GK,27.0,6.0,0.0,0.0,0.0,0.0,0.0,0.0,0.0,0.0,0.0,0.0,0.0,0.0,0.0,0.0,0.0,0.0,Matches,18.0,br BRA,GK,27.0,6.0,13.0,2.0,0.0,2.0,0.0,8.6,0.4,-4.4,-0.73,6.0,34.0,17.6,138.0,27.0,21.7,26.8,15.0,26.7,26.7,65.0,5.0,7.7,9.0,1.5,16.0,Matches,18.0,br BRA,GK,27.0,6.0,6.0,540.0,6.0,13.0,2.17,17.0,4.0,35.3,3.0,1.0,2.0,0.0,0.0,2.0,2.0,0.0,0.0,0.0,Matches,287.0,br BRA,GK,27.0,6.0,0.0,0.0,0.0,1.0,0.0,0.0,0.0,0.0,0.0,0.0,1.0,0.0,7.0,2.0,0.0,100.0,Matches,287.0,br BRA,GK,27.0,6.0,154.0,133.0,20.0,5.0,0.0,0.0,0.0,0.0,0.0,0.0,0.0,0.0,122.0,1.0,0.0,Matches,287.0,br BRA,GK,27.0,6.0,122.0,154.0,79.2,2482.0,1869.0,41.0,41.0,100.0,64.0,64.0,100.0,15.0,46.0,32.6,0.0,0.0,0.0,0.0,0.0,0.0,0.0,0.0,0.0,Matches,332,br BRA,GK,27,6,540.0,90.0,15.8,6.0,6,90.0,6,0,,12,1.67,13.0,13.0,0.0,0.0,-0.66,10.4,8.7,1.7,0.28,-0.55,Matches,287.0,br BRA,GK,27.0,6.0,159.0,136.0,159.0,0.0,0.0,0.0,159.0,0.0,0.0,,0.0,,130.0,557.0,279.0,0.0,0.0,0.0,0.0,0.0,97.0,0.0,Matches,287.0,br BRA,GK,27.0,6.0,0.0,0.0,0.0,,0.0,0.0,,,,0.0,0.0,0.0,0.0,0.0,,0.0,0.0,Matches,287.0,br BRA,GK,27.0,6.0,6.0,540.0,6.0,0.0,0.0,0.0,0.0,0.0,0.0,0.0,0.0,0.0,0.0,0.0,0.0,0.0,0.0,0.0,0.0,0.0,0.0,0.0,0.0,0.0,0.0,0.0,0.0,0.0,Matches,Léo Jardim,GK,27,126,140,"Brazil,Italy",LOSC Lille,5,3,2,2,9,7,8,2,1,3,10,3,2,7,8,14,12,13,13,12,12,13,1,10,3,10,10,11,11,15,12,13,14,12,11,10,13,10,9,9,10,13,12,10,8,14,12,12,16,11,9,13,20,14,9,8,12,14,12,16,20,1,1,1,1,1,1,1,1,1,1,1,1,1,188,74,10,20,1420608,6000,5800,4500,Northern_European,124,9,1995/3/20,0,0,18604.0,,19219843
541,Jeffinho,Lyon,1999,291.0,br BRA,FW,22.0,5.0,17.0,4.0,4.0,9.0,4.0,6.0,15.0,40.0,9.0,6.0,0.0,6.0,1.0,18.0,0.0,0.0,Matches,291.0,br BRA,FW,22.0,5.0,19.0,3.83,12.0,0.0,3.0,0.0,4.0,0.0,3.0,0.61,2.0,0.0,0.0,0.0,1.0,0.0,Matches,,,,,,,,,,,,,,,,,,,,,,,,,,,,,,,,,,,,,,,,,,,,,,,,,,,,,,,,291.0,br BRA,FW,22.0,5.0,1.0,0.0,0.0,8.0,10.0,0.0,3.0,1.0,4.0,1.0,0.0,0.0,21.0,3.0,6.0,33.3,Matches,291.0,br BRA,FW,22.0,5.0,173.0,171.0,1.0,0.0,0.0,0.0,3.0,1.0,0.0,0.0,0.0,0.0,146.0,1.0,6.0,Matches,291.0,br BRA,FW,22.0,5.0,146.0,173.0,84.4,1802.0,399.0,98.0,107.0,91.6,36.0,43.0,83.7,1.0,1.0,100.0,0.0,0.5,0.7,-0.5,7.0,11.0,4.0,0.0,10.0,Matches,336,br BRA,FW,22,9,446.0,50.0,13.0,5.0,4,80.0,2,5,25.0,4,1.78,13.0,7.0,6.0,1.21,0.85,11.4,7.3,4.0,0.81,0.65,Matches,291.0,br BRA,FW,22.0,5.0,258.0,3.0,21.0,100.0,147.0,32.0,258.0,37.0,15.0,40.5,18.0,48.6,207.0,1616.0,877.0,27.0,28.0,14.0,21.0,12.0,201.0,52.0,Matches,291.0,br BRA,FW,22.0,5.0,1.0,10.0,5.0,50.0,2.02,1.01,0.1,0.2,15.7,0.0,0.0,0.0,1.1,1.1,0.11,-0.1,-0.1,Matches,291.0,br BRA,FW,22.0,9.0,4.0,446.0,5.0,1.0,0.0,1.0,1.0,0.0,0.0,1.0,0.0,1.1,1.1,0.5,1.6,27.0,10.0,52.0,0.2,0.0,0.2,0.2,0.2,0.23,0.1,0.33,0.23,0.33,Matches,Jeffinho,AM RL,22,121,135,Brazil,Resende Futebol Clube,11,11,15,11,14,10,9,10,10,7,12,10,7,15,10,11,9,11,12,13,13,12,15,9,12,7,11,12,14,15,9,8,12,13,13,10,12,9,11,10,13,1,3,2,1,1,2,2,2,3,2,2,18,10,6,10,8,11,12,18,1,1,1,1,1,1,1,1,1,12,15,1,20,10,176,63,8,20,291528,6212,6212,3260,African_Caribbean,121,16,1999/12/30,0,0,7200.0,BOT,2000118650
542,Paul Joly,Auxerre,2000,292.0,fr FRA,DF,22.0,9.6,33.0,21.0,21.0,10.0,2.0,19.0,35.0,54.3,16.0,13.0,2.0,11.0,24.0,57.0,29.0,2.0,Matches,292.0,fr FRA,DF,22.0,9.6,18.0,1.87,14.0,0.0,2.0,1.0,1.0,0.0,3.0,0.31,1.0,0.0,1.0,0.0,1.0,0.0,Matches,,,,,,,,,,,,,,,,,,,,,,,,,,,,,,,,,,,,,,,,,,,,,,,,,,,,,,,,292.0,fr FRA,DF,22.0,9.6,2.0,0.0,0.0,7.0,9.0,0.0,36.0,24.0,21.0,1.0,0.0,0.0,83.0,6.0,11.0,35.3,Matches,292.0,fr FRA,DF,22.0,9.6,652.0,565.0,86.0,5.0,1.0,17.0,36.0,81.0,0.0,0.0,0.0,0.0,514.0,1.0,19.0,Matches,292.0,fr FRA,DF,22.0,9.6,514.0,652.0,78.8,9641.0,3372.0,218.0,247.0,88.3,201.0,237.0,84.8,75.0,127.0,59.1,0.0,0.3,0.6,-0.3,7.0,34.0,13.0,8.0,41.0,Matches,337,fr FRA,DF,22,10,867.0,87.0,25.4,9.6,10,87.0,9,0,,6,0.9,9.0,20.0,-11.0,-1.14,-0.54,9.7,15.1,-5.4,-0.56,-0.2,Matches,292.0,fr FRA,DF,22.0,9.6,783.0,54.0,283.0,328.0,179.0,4.0,783.0,28.0,13.0,46.4,8.0,28.6,519.0,3094.0,1511.0,19.0,27.0,1.0,9.0,12.0,445.0,48.0,Matches,292.0,fr FRA,DF,22.0,9.6,0.0,7.0,0.0,0.0,0.73,0.0,0.0,,23.5,0.0,0.0,0.0,0.1,0.1,0.02,-0.1,-0.1,Matches,292.0,fr FRA,DF,22.0,10.0,10.0,867.0,9.6,0.0,0.0,0.0,0.0,0.0,0.0,2.0,0.0,0.1,0.1,0.3,0.5,19.0,41.0,48.0,0.0,0.0,0.0,0.0,0.0,0.01,0.03,0.05,0.01,0.05,Matches,Paul Joly,D R,22,119,137,France,AJ Auxerre,6,14,11,6,12,6,12,9,6,12,11,7,13,10,11,15,12,13,12,11,11,13,9,8,13,14,14,14,13,12,12,12,13,13,15,12,12,8,11,6,10,2,2,3,3,3,1,1,1,3,1,2,16,12,1,12,11,12,12,11,1,12,13,20,1,1,1,1,1,1,1,1,1,1,182,75,8,20,1531999,5950,5950,2750,Northern_European,119,4,2000/6/7,0,0,6076.0,,49054998
543,Gaël Kakuta,Lens,1991,298.0,cd COD,FW,31.0,0.2,0.0,0.0,0.0,0.0,0.0,0.0,0.0,,0.0,0.0,0.0,0.0,0.0,0.0,1.0,0.0,Matches,298.0,cd COD,FW,31.0,0.2,0.0,0.0,0.0,0.0,0.0,0.0,0.0,0.0,0.0,0.0,0.0,0.0,0.0,0.0,0.0,0.0,Matches,,,,,,,,,,,,,,,,,,,,,,,,,,,,,,,,,,,,,,,,,,,,,,,,,,,,,,,,298.0,cd COD,FW,31.0,0.2,0.0,0.0,0.0,0.0,1.0,0.0,1.0,0.0,0.0,0.0,0.0,0.0,1.0,1.0,0.0,100.0,Matches,298.0,cd COD,FW,31.0,0.2,16.0,16.0,0.0,0.0,0.0,0.0,1.0,0.0,0.0,0.0,0.0,0.0,12.0,0.0,1.0,Matches,298.0,cd COD,FW,31.0,0.2,12.0,16.0,75.0,172.0,14.0,5.0,6.0,83.3,4.0,6.0,66.7,1.0,2.0,50.0,0.0,0.0,0.0,0.0,0.0,2.0,0.0,0.0,1.0,Matches,345,cd COD,FW,31,2,22.0,11.0,0.6,0.2,0,,0,2,11.0,4,2.0,1.0,0.0,1.0,4.09,3.08,0.5,0.4,0.0,0.03,-0.58,Matches,298.0,cd COD,FW,31.0,0.2,18.0,0.0,4.0,11.0,4.0,0.0,18.0,0.0,0.0,,0.0,,16.0,103.0,53.0,2.0,2.0,0.0,0.0,0.0,16.0,1.0,Matches,298.0,cd COD,FW,31.0,0.2,0.0,1.0,0.0,0.0,4.09,0.0,0.0,,29.8,0.0,0.0,0.0,0.0,0.0,0.05,0.0,0.0,Matches,298.0,cd COD,FW,31.0,2.0,0.0,22.0,0.2,0.0,0.0,0.0,0.0,0.0,0.0,0.0,0.0,0.0,0.0,0.0,0.0,2.0,1.0,1.0,0.0,0.0,0.0,0.0,0.0,0.19,0.0,0.19,0.19,0.19,Matches,Gaël Kakuta,AM RLC,31,128,142,"Democratic Republic of Congo,France",Amiens SC,12,12,15,12,15,13,7,14,5,4,13,13,4,15,8,13,11,14,10,13,12,14,17,8,14,5,12,10,15,16,14,7,13,13,12,10,12,6,14,14,10,1,4,2,2,1,3,1,1,1,1,1,14,15,7,12,10,12,16,16,1,1,1,1,1,1,1,10,13,10,15,20,15,1,173,72,20,10,347975206,6400,6400,5000,African_Caribbean,128,15,1991/6/21,13,2,8109.0,,34001371
544,Bingourou Kamara,Montpellier,1996,303.0,sn SEN,GK,25.0,4.5,0.0,0.0,0.0,0.0,0.0,0.0,0.0,,0.0,0.0,0.0,0.0,0.0,0.0,2.0,0.0,Matches,303.0,sn SEN,GK,25.0,4.5,0.0,0.0,0.0,0.0,0.0,0.0,0.0,0.0,0.0,0.0,0.0,0.0,0.0,0.0,0.0,0.0,Matches,19.0,sn SEN,GK,25.0,4.5,11.0,1.0,0.0,2.0,0.0,9.1,0.29,-1.9,-0.41,18.0,57.0,31.6,95.0,19.0,42.1,35.4,35.0,48.6,39.9,52.0,3.0,5.8,2.0,0.44,11.2,Matches,19.0,sn SEN,GK,25.0,5.0,4.0,408.0,4.5,11.0,2.43,25.0,13.0,60.0,0.0,1.0,3.0,0.0,0.0,3.0,1.0,1.0,1.0,50.0,Matches,303.0,sn SEN,GK,25.0,4.5,1.0,0.0,0.0,1.0,1.0,0.0,0.0,0.0,0.0,0.0,1.0,0.0,4.0,1.0,0.0,100.0,Matches,303.0,sn SEN,GK,25.0,4.5,131.0,87.0,43.0,8.0,0.0,0.0,0.0,0.0,0.0,0.0,0.0,0.0,87.0,1.0,0.0,Matches,303.0,sn SEN,GK,25.0,4.5,87.0,131.0,66.4,2374.0,1898.0,16.0,17.0,94.1,43.0,44.0,97.7,28.0,69.0,40.6,0.0,0.0,0.0,0.0,0.0,2.0,0.0,0.0,0.0,Matches,351,sn SEN,GK,25,5,408.0,82.0,11.9,4.5,4,90.0,4,1,48.0,24,0.2,5.0,11.0,-6.0,-1.32,-1.59,5.0,10.3,-5.3,-1.17,-1.03,Matches,303.0,sn SEN,GK,25.0,4.5,143.0,120.0,143.0,0.0,0.0,0.0,143.0,0.0,0.0,,0.0,,86.0,416.0,244.0,0.0,0.0,0.0,0.0,0.0,57.0,0.0,Matches,303.0,sn SEN,GK,25.0,4.5,0.0,0.0,0.0,,0.0,0.0,,,,0.0,0.0,0.0,0.0,0.0,,0.0,0.0,Matches,303.0,sn SEN,GK,25.0,5.0,4.0,408.0,4.5,0.0,0.0,0.0,0.0,0.0,0.0,1.0,0.0,0.0,0.0,0.0,0.0,0.0,0.0,0.0,0.0,0.0,0.0,0.0,0.0,0.0,0.0,0.0,0.0,0.0,Matches,Bingourou Kamara,GK,25,124,135,"Senegal,France",Montpellier Hérault SC,6,3,1,2,9,7,2,2,2,3,10,4,2,8,8,12,13,12,14,8,11,12,6,10,3,12,13,12,9,14,15,16,14,9,13,16,12,9,12,8,12,15,11,12,8,13,12,12,14,9,8,11,19,14,6,15,12,14,12,13,20,1,1,1,1,1,1,1,1,1,1,1,1,1,196,92,8,20,1408232,6200,6200,3800,African_Caribbean,122,15,1996/10/21,2,0,5599.0,,211500
545,Ayman Kari,Lorient,2004,305.0,fr FRA,MFDF,17.0,1.1,0.0,0.0,0.0,0.0,0.0,0.0,0.0,,0.0,4.0,0.0,4.0,3.0,3.0,0.0,0.0,Matches,305.0,fr FRA,MFDF,17.0,1.1,7.0,6.56,5.0,0.0,1.0,0.0,1.0,0.0,1.0,0.94,1.0,0.0,0.0,0.0,0.0,0.0,Matches,,,,,,,,,,,,,,,,,,,,,,,,,,,,,,,,,,,,,,,,,,,,,,,,,,,,,,,,305.0,fr FRA,MFDF,17.0,1.1,0.0,0.0,0.0,1.0,5.0,1.0,0.0,3.0,0.0,0.0,0.0,0.0,12.0,1.0,1.0,50.0,Matches,305.0,fr FRA,MFDF,17.0,1.1,74.0,73.0,0.0,0.0,0.0,0.0,0.0,0.0,0.0,0.0,0.0,0.0,67.0,1.0,1.0,Matches,305.0,fr FRA,MFDF,17.0,1.1,67.0,74.0,90.5,939.0,192.0,38.0,40.0,95.0,20.0,22.0,90.9,4.0,4.0,100.0,0.0,0.0,0.1,0.0,1.0,2.0,2.0,0.0,7.0,Matches,354,fr FRA,MFDF,17,5,96.0,19.0,2.8,1.1,0,,0,5,19.0,7,2.0,2.0,2.0,0.0,0.0,0.03,3.1,1.5,1.6,1.53,1.94,Matches,305.0,fr FRA,MFDF,17.0,1.1,94.0,0.0,32.0,38.0,27.0,6.0,94.0,7.0,4.0,57.1,2.0,28.6,70.0,401.0,215.0,5.0,4.0,1.0,3.0,1.0,64.0,3.0,Matches,305.0,fr FRA,MFDF,17.0,1.1,0.0,4.0,0.0,0.0,3.75,0.0,0.0,,18.6,0.0,0.0,0.0,0.5,0.5,0.14,-0.5,-0.5,Matches,305.0,fr FRA,MFDF,17.0,5.0,0.0,96.0,1.1,0.0,0.0,0.0,0.0,0.0,0.0,0.0,0.0,0.5,0.5,0.0,0.6,5.0,7.0,3.0,0.0,0.0,0.0,0.0,0.0,0.51,0.03,0.54,0.51,0.54,Matches,Ayman Kari,M C,17,95,-8,"France,Comoros",Paris Saint-Germain,7,7,11,8,11,7,8,10,6,11,11,8,12,12,7,12,11,11,11,11,11,15,11,6,12,10,12,12,11,12,10,10,13,11,13,11,10,7,10,5,12,3,1,3,2,3,1,2,3,2,2,1,13,14,6,12,12,15,14,10,1,1,1,1,1,1,13,1,20,1,1,1,1,1,177,0,8,20,24599999,4738,4738,1489,African_Caribbean,95,17,2004/11/19,0,0,1010.0,,2000127853
546,Presnel Kimpembe,Paris S-G,1995,311.0,fr FRA,DF,26.0,8.1,17.0,8.0,9.0,6.0,2.0,9.0,13.0,69.2,4.0,12.0,7.0,5.0,13.0,30.0,9.0,1.0,Matches,311.0,fr FRA,DF,26.0,8.1,2.0,0.25,2.0,0.0,0.0,0.0,0.0,0.0,0.0,0.0,0.0,0.0,0.0,0.0,0.0,0.0,Matches,,,,,,,,,,,,,,,,,,,,,,,,,,,,,,,,,,,,,,,,,,,,,,,,,,,,,,,,311.0,fr FRA,DF,26.0,8.1,3.0,0.0,0.0,22.0,9.0,1.0,0.0,13.0,8.0,0.0,1.0,0.0,38.0,13.0,8.0,61.9,Matches,311.0,fr FRA,DF,26.0,8.1,503.0,454.0,48.0,13.0,1.0,0.0,0.0,20.0,0.0,0.0,0.0,0.0,471.0,1.0,6.0,Matches,311.0,fr FRA,DF,26.0,8.1,471.0,503.0,93.6,7240.0,2911.0,243.0,251.0,96.8,194.0,202.0,96.0,22.0,26.0,84.6,0.0,0.2,0.3,-0.2,1.0,36.0,1.0,0.0,40.0,Matches,363,fr FRA,DF,26,11,730.0,66.0,21.3,8.1,9,78.0,7,2,14.0,0,2.55,30.0,9.0,21.0,2.59,1.65,21.6,9.6,12.0,1.49,0.89,Matches,311.0,fr FRA,DF,26.0,8.1,567.0,59.0,203.0,327.0,39.0,7.0,567.0,3.0,2.0,66.7,0.0,0.0,430.0,2001.0,1090.0,4.0,8.0,0.0,4.0,5.0,407.0,4.0,Matches,311.0,fr FRA,DF,26.0,8.1,0.0,4.0,0.0,0.0,0.49,0.0,0.0,,6.3,0.0,0.0,0.0,0.7,0.7,0.17,-0.7,-0.7,Matches,311.0,fr FRA,DF,26.0,11.0,9.0,730.0,8.1,0.0,0.0,0.0,0.0,0.0,0.0,3.0,0.0,0.7,0.7,0.2,0.8,4.0,40.0,4.0,0.0,0.0,0.0,0.0,0.0,0.08,0.02,0.1,0.08,0.1,Matches,Presnel Kimpembe,D C,26,159,164,"France,Democratic Republic of Congo",Paris Saint-Germain,4,10,10,6,13,5,16,6,8,16,12,10,17,13,17,15,18,15,16,10,14,16,8,12,10,15,16,16,13,13,16,14,16,14,16,16,14,9,16,7,10,3,1,2,3,1,1,2,3,1,1,1,9,17,7,14,15,15,16,14,1,10,20,1,1,1,7,1,1,1,1,1,1,1,183,77,20,10,57206289,7950,7950,7050,African_Caribbean,159,14,1995/8/13,28,0,191781.0,,85141999
547,Gaëtan Laborde,Rennes,1994,324.0,fr FRA,FW,28.0,2.8,1.0,1.0,1.0,0.0,0.0,0.0,1.0,0.0,1.0,1.0,0.0,1.0,0.0,1.0,1.0,0.0,Matches,324.0,fr FRA,FW,28.0,2.8,10.0,3.61,6.0,0.0,1.0,3.0,0.0,0.0,1.0,0.36,0.0,0.0,0.0,1.0,0.0,0.0,Matches,,,,,,,,,,,,,,,,,,,,,,,,,,,,,,,,,,,,,,,,,,,,,,,,,,,,,,,,324.0,fr FRA,FW,28.0,2.8,0.0,0.0,0.0,0.0,1.0,0.0,3.0,0.0,1.0,0.0,0.0,0.0,7.0,6.0,9.0,40.0,Matches,324.0,fr FRA,FW,28.0,2.8,61.0,54.0,7.0,0.0,0.0,0.0,3.0,0.0,0.0,0.0,0.0,0.0,41.0,0.0,6.0,Matches,324.0,fr FRA,FW,28.0,2.8,41.0,61.0,67.2,623.0,128.0,25.0,35.0,71.4,12.0,17.0,70.6,2.0,5.0,40.0,0.0,0.2,0.2,-0.2,3.0,3.0,2.0,1.0,5.0,Matches,378,fr FRA,FW,28,4,249.0,62.0,7.3,2.8,3,73.0,0,1,30.0,0,1.0,4.0,5.0,-1.0,-0.36,-1.24,5.3,4.0,1.3,0.47,0.02,Matches,324.0,fr FRA,FW,28.0,2.8,92.0,2.0,3.0,41.0,51.0,24.0,92.0,2.0,2.0,100.0,0.0,0.0,61.0,349.0,150.0,8.0,4.0,4.0,11.0,4.0,59.0,20.0,Matches,324.0,fr FRA,FW,28.0,2.8,2.0,11.0,6.0,54.5,3.98,2.17,0.18,0.33,13.2,0.0,0.0,0.0,1.7,1.7,0.16,0.3,0.3,Matches,324.0,fr FRA,FW,28.0,4.0,3.0,249.0,2.8,2.0,0.0,2.0,2.0,0.0,0.0,0.0,0.0,1.7,1.7,0.2,1.9,8.0,5.0,20.0,0.72,0.0,0.72,0.72,0.72,0.62,0.07,0.69,0.62,0.69,Matches,Gaëtan Laborde,S R,28,140,145,France,OGC Nice,5,13,13,15,13,10,17,14,5,4,13,12,4,12,13,14,14,13,14,13,12,15,11,8,15,11,17,18,13,13,13,15,15,13,16,14,14,8,14,5,14,2,3,1,4,4,3,3,1,3,2,1,10,14,7,15,8,16,12,15,1,1,1,1,1,1,1,1,1,1,13,10,15,20,181,78,20,8,13890406,7000,7000,4250,Northern_European,142,3,1994/5/3,0,0,40917.0,,85075725
548,Mario Lemina,Nice,1993,344.0,ga GAB,MFDF,28.0,9.3,32.0,21.0,11.0,14.0,7.0,12.0,18.0,66.7,6.0,13.0,5.0,8.0,11.0,43.0,20.0,0.0,Matches,344.0,ga GAB,MFDF,28.0,9.3,12.0,1.29,11.0,0.0,0.0,0.0,0.0,1.0,1.0,0.11,1.0,0.0,0.0,0.0,0.0,0.0,Matches,,,,,,,,,,,,,,,,,,,,,,,,,,,,,,,,,,,,,,,,,,,,,,,,,,,,,,,,344.0,ga GAB,MFDF,28.0,9.3,1.0,1.0,0.0,13.0,5.0,0.0,2.0,11.0,21.0,0.0,0.0,0.0,62.0,5.0,4.0,55.6,Matches,344.0,ga GAB,MFDF,28.0,9.3,637.0,629.0,5.0,5.0,1.0,6.0,2.0,0.0,0.0,0.0,0.0,0.0,569.0,3.0,4.0,Matches,344.0,ga GAB,MFDF,28.0,9.3,569.0,637.0,89.3,9544.0,2701.0,253.0,268.0,94.4,252.0,265.0,95.1,42.0,75.0,56.0,0.0,0.1,0.2,-0.1,4.0,44.0,3.0,0.0,46.0,Matches,403,ga GAB,MFDF,28,14,838.0,60.0,24.5,9.3,11,69.0,2,3,26.0,0,1.29,15.0,9.0,6.0,0.64,0.47,13.8,9.4,4.4,0.48,0.19,Matches,344.0,ga GAB,MFDF,28.0,9.3,724.0,39.0,204.0,451.0,73.0,6.0,724.0,16.0,11.0,68.8,5.0,31.3,579.0,2983.0,1278.0,14.0,14.0,0.0,4.0,1.0,549.0,10.0,Matches,344.0,ga GAB,MFDF,28.0,9.3,0.0,6.0,3.0,50.0,0.64,0.32,0.0,0.0,20.1,0.0,0.0,0.0,0.3,0.3,0.05,-0.3,-0.3,Matches,344.0,ga GAB,MFDF,28.0,14.0,11.0,838.0,9.3,0.0,0.0,0.0,0.0,0.0,0.0,1.0,1.0,0.3,0.3,0.1,0.4,14.0,46.0,10.0,0.0,0.0,0.0,0.0,0.0,0.03,0.01,0.04,0.03,0.04,Matches,Mario Lemina,DM/M C,28,130,147,"Gabon,France",OGC Nice,9,9,13,11,13,8,12,12,10,12,14,9,14,13,14,13,15,12,11,13,10,15,14,12,12,10,13,15,13,13,15,13,14,13,15,16,14,12,14,12,13,2,2,1,3,3,2,2,3,2,2,3,14,15,8,10,13,14,12,9,1,1,1,10,1,10,18,1,20,10,1,7,7,1,184,85,10,20,6501730,6649,6649,5499,African_Caribbean,131,13,1993/9/1,25,3,37499.0,,85104273
549,Jean Lucas,Monaco,1998,361.0,br BRA,MF,24.0,3.2,9.0,5.0,3.0,5.0,1.0,6.0,12.0,50.0,6.0,2.0,1.0,1.0,4.0,13.0,2.0,0.0,Matches,361.0,br BRA,MF,24.0,3.2,5.0,1.55,4.0,0.0,0.0,1.0,0.0,0.0,0.0,0.0,0.0,0.0,0.0,0.0,0.0,0.0,Matches,,,,,,,,,,,,,,,,,,,,,,,,,,,,,,,,,,,,,,,,,,,,,,,,,,,,,,,,361.0,br BRA,MF,24.0,3.2,0.0,0.0,0.0,4.0,4.0,1.0,1.0,4.0,5.0,0.0,0.0,0.0,23.0,1.0,7.0,12.5,Matches,361.0,br BRA,MF,24.0,3.2,154.0,152.0,1.0,1.0,1.0,2.0,1.0,0.0,0.0,0.0,0.0,0.0,134.0,1.0,1.0,Matches,361.0,br BRA,MF,24.0,3.2,134.0,154.0,87.0,2491.0,633.0,60.0,67.0,89.6,54.0,59.0,91.5,17.0,22.0,77.3,0.0,0.2,0.2,-0.2,3.0,19.0,1.0,0.0,20.0,Matches,427,br BRA,MF,24,6,291.0,49.0,8.5,3.2,3,85.0,2,3,12.0,6,0.83,4.0,5.0,-1.0,-0.31,-0.68,6.0,6.2,-0.2,-0.07,-0.33,Matches,361.0,br BRA,MF,24.0,3.2,191.0,8.0,29.0,136.0,32.0,5.0,191.0,14.0,9.0,64.3,3.0,21.4,147.0,968.0,398.0,5.0,6.0,1.0,3.0,1.0,125.0,6.0,Matches,361.0,br BRA,MF,24.0,3.2,0.0,5.0,3.0,60.0,1.55,0.93,0.0,0.0,18.3,0.0,0.0,0.0,0.6,0.6,0.12,-0.6,-0.6,Matches,361.0,br BRA,MF,24.0,6.0,3.0,291.0,3.2,0.0,0.0,0.0,0.0,0.0,0.0,0.0,0.0,0.6,0.6,0.2,0.8,5.0,20.0,6.0,0.0,0.0,0.0,0.0,0.0,0.19,0.05,0.23,0.19,0.23,Matches,Jean Lucas,DM/M C,24,121,135,Brazil,AS Monaco,8,10,12,8,12,10,7,12,4,11,14,10,11,12,12,12,13,13,12,13,13,13,13,10,13,12,14,14,13,14,13,9,14,13,14,13,11,12,10,7,13,1,3,1,3,3,3,2,1,1,3,1,12,11,6,11,11,14,11,19,1,1,1,1,1,1,18,1,20,12,1,1,1,1,181,78,8,20,954061,6049,6049,3999,Mixed_Race,122,14,1998/6/22,0,0,19164.0,,19328100
550,Jonas Martin,Lille,1990,381.0,fr FRA,MF,32.0,3.1,9.0,7.0,4.0,5.0,0.0,5.0,14.0,35.7,9.0,3.0,1.0,2.0,7.0,16.0,3.0,0.0,Matches,381.0,fr FRA,MF,32.0,3.1,6.0,1.94,5.0,1.0,0.0,0.0,0.0,0.0,0.0,0.0,0.0,0.0,0.0,0.0,0.0,0.0,Matches,,,,,,,,,,,,,,,,,,,,,,,,,,,,,,,,,,,,,,,,,,,,,,,,,,,,,,,,381.0,fr FRA,MF,32.0,3.1,2.0,0.0,0.0,9.0,5.0,0.0,3.0,7.0,7.0,0.0,0.0,0.0,24.0,8.0,3.0,72.7,Matches,381.0,fr FRA,MF,32.0,3.1,229.0,219.0,10.0,7.0,0.0,2.0,3.0,2.0,1.0,1.0,0.0,0.0,193.0,0.0,1.0,Matches,381.0,fr FRA,MF,32.0,3.1,193.0,229.0,84.3,3285.0,864.0,99.0,117.0,84.6,62.0,73.0,84.9,24.0,30.0,80.0,0.0,0.1,0.3,-0.1,4.0,19.0,2.0,0.0,20.0,Matches,450,fr FRA,MF,32,12,277.0,23.0,8.1,3.1,2,63.0,0,10,15.0,23,2.08,2.0,5.0,-3.0,-0.97,-1.66,4.9,3.1,1.9,0.61,-0.14,Matches,381.0,fr FRA,MF,32.0,3.1,262.0,6.0,56.0,178.0,29.0,3.0,262.0,1.0,0.0,0.0,1.0,100.0,202.0,986.0,387.0,4.0,6.0,0.0,2.0,4.0,191.0,4.0,Matches,381.0,fr FRA,MF,32.0,3.1,0.0,1.0,0.0,0.0,0.32,0.0,0.0,,7.6,0.0,0.0,0.0,0.1,0.1,0.12,-0.1,-0.1,Matches,381.0,fr FRA,MF,32.0,12.0,2.0,277.0,3.1,0.0,0.0,0.0,0.0,0.0,0.0,2.0,0.0,0.1,0.1,0.1,0.2,4.0,20.0,4.0,0.0,0.0,0.0,0.0,0.0,0.04,0.04,0.08,0.04,0.08,Matches,Jonas Martin,M/AM C,32,129,131,France,LOSC Lille,10,12,14,12,14,12,11,13,11,13,14,13,12,15,15,13,13,12,12,13,14,14,12,13,12,13,13,15,13,13,14,10,11,12,14,14,13,7,16,14,8,2,3,4,2,2,2,2,2,3,3,2,17,14,6,14,14,14,14,14,1,1,1,1,1,1,13,12,20,12,12,17,12,1,184,76,5,20,347975206,6450,6450,4002,Northern_European,133,6,1990/4/9,0,0,15502.0,,34008680
551,Gelson Martins,Monaco,1995,382.0,pt POR,MFFW,27.0,3.8,15.0,8.0,6.0,4.0,5.0,4.0,13.0,30.8,9.0,4.0,1.0,3.0,3.0,18.0,2.0,0.0,Matches,382.0,pt POR,MFFW,27.0,3.8,15.0,3.91,11.0,0.0,1.0,2.0,1.0,0.0,1.0,0.26,1.0,0.0,0.0,0.0,0.0,0.0,Matches,,,,,,,,,,,,,,,,,,,,,,,,,,,,,,,,,,,,,,,,,,,,,,,,,,,,,,,,382.0,pt POR,MFFW,27.0,3.8,0.0,0.0,0.0,6.0,4.0,2.0,5.0,3.0,8.0,0.0,0.0,0.0,25.0,2.0,7.0,22.2,Matches,382.0,pt POR,MFFW,27.0,3.8,155.0,154.0,1.0,0.0,0.0,0.0,5.0,1.0,0.0,0.0,0.0,0.0,121.0,0.0,6.0,Matches,382.0,pt POR,MFFW,27.0,3.8,121.0,155.0,78.1,1651.0,377.0,74.0,86.0,86.0,39.0,49.0,79.6,3.0,8.0,37.5,0.0,0.3,0.4,-0.3,3.0,8.0,9.0,0.0,14.0,Matches,451,pt POR,MFFW,27,11,345.0,31.0,10.1,3.8,3,74.0,0,8,15.0,8,2.18,9.0,6.0,3.0,0.78,0.52,6.7,6.7,-0.1,-0.02,-0.29,Matches,382.0,pt POR,MFFW,27.0,3.8,218.0,3.0,30.0,74.0,118.0,22.0,218.0,13.0,4.0,30.8,8.0,61.5,168.0,1050.0,529.0,15.0,9.0,6.0,10.0,7.0,154.0,47.0,Matches,382.0,pt POR,MFFW,27.0,3.8,0.0,12.0,3.0,25.0,3.13,0.78,0.0,0.0,15.9,0.0,0.0,0.0,0.8,0.8,0.06,-0.8,-0.8,Matches,382.0,pt POR,MFFW,27.0,11.0,3.0,345.0,3.8,0.0,0.0,0.0,0.0,0.0,0.0,0.0,0.0,0.8,0.8,0.3,1.1,15.0,14.0,47.0,0.0,0.0,0.0,0.0,0.0,0.2,0.08,0.28,0.2,0.28,Matches,Gelson Martins,M/AM RL,27,126,145,"Portugal,Cape Verde Islands",AS Monaco,7,10,14,10,15,7,4,10,2,5,13,12,5,15,10,13,10,12,10,12,10,15,16,6,14,7,9,10,15,16,12,7,14,15,13,9,8,7,14,6,14,3,1,3,1,2,3,3,1,1,1,1,16,16,6,15,14,12,14,13,1,1,1,10,1,10,1,12,1,18,15,13,20,12,173,74,11,20,1682127,6293,6293,5493,African_Caribbean,121,13,1995/5/11,21,0,69041.0,,55063369
552,Chrislain Matsima,Lorient,2002,386.0,fr FRA,DFMF,20.0,2.5,0.0,0.0,0.0,0.0,0.0,0.0,0.0,,0.0,3.0,3.0,0.0,2.0,2.0,7.0,0.0,Matches,386.0,fr FRA,DFMF,20.0,2.5,0.0,0.0,0.0,0.0,0.0,0.0,0.0,0.0,0.0,0.0,0.0,0.0,0.0,0.0,0.0,0.0,Matches,,,,,,,,,,,,,,,,,,,,,,,,,,,,,,,,,,,,,,,,,,,,,,,,,,,,,,,,386.0,fr FRA,DFMF,20.0,2.5,0.0,0.0,0.0,0.0,1.0,0.0,0.0,2.0,0.0,0.0,0.0,0.0,9.0,3.0,6.0,33.3,Matches,386.0,fr FRA,DFMF,20.0,2.5,127.0,120.0,7.0,7.0,0.0,0.0,0.0,0.0,0.0,0.0,0.0,0.0,108.0,0.0,3.0,Matches,386.0,fr FRA,DFMF,20.0,2.5,108.0,127.0,85.0,2009.0,663.0,34.0,36.0,94.4,62.0,68.0,91.2,8.0,16.0,50.0,0.0,0.0,0.0,0.0,0.0,3.0,0.0,0.0,1.0,Matches,455,fr FRA,DFMF,20,6,227.0,38.0,6.6,2.5,2,90.0,2,4,12.0,8,1.67,3.0,5.0,-2.0,-0.79,-0.82,1.6,5.9,-4.3,-1.71,-1.45,Matches,386.0,fr FRA,DFMF,20.0,2.5,145.0,25.0,90.0,51.0,4.0,3.0,145.0,0.0,0.0,,0.0,,114.0,599.0,310.0,0.0,2.0,0.0,2.0,0.0,108.0,0.0,Matches,386.0,fr FRA,DFMF,20.0,2.5,0.0,1.0,0.0,0.0,0.4,0.0,0.0,,10.5,0.0,0.0,0.0,0.1,0.1,0.06,-0.1,-0.1,Matches,386.0,fr FRA,DFMF,20.0,6.0,2.0,227.0,2.5,0.0,0.0,0.0,0.0,0.0,0.0,0.0,0.0,0.1,0.1,0.0,0.1,0.0,1.0,0.0,0.0,0.0,0.0,0.0,0.0,0.02,0.0,0.02,0.02,0.02,Matches,Chrislain Matsima,D/DM C,20,100,-75,"France,Congo",AS Monaco,4,4,8,6,11,5,13,6,4,12,11,5,13,12,10,11,13,10,12,9,12,12,6,8,7,11,12,11,12,9,12,14,14,12,13,13,12,8,10,6,11,3,1,4,3,2,3,1,2,1,2,3,10,13,8,10,11,11,12,14,1,1,20,14,1,12,16,1,1,1,1,1,1,1,193,0,6,20,32173876,4995,5245,2245,African_Caribbean,100,16,2002/5/15,0,0,1246.0,FC Lorient,49048468
553,Christian Mawissa,Toulouse,2005,392.0,fr FRA,DF,17.0,1.1,2.0,0.0,1.0,1.0,0.0,1.0,3.0,33.3,2.0,0.0,0.0,0.0,3.0,5.0,1.0,0.0,Matches,392.0,fr FRA,DF,17.0,1.1,0.0,0.0,0.0,0.0,0.0,0.0,0.0,0.0,0.0,0.0,0.0,0.0,0.0,0.0,0.0,0.0,Matches,,,,,,,,,,,,,,,,,,,,,,,,,,,,,,,,,,,,,,,,,,,,,,,,,,,,,,,,392.0,fr FRA,DF,17.0,1.1,1.0,0.0,0.0,2.0,2.0,0.0,1.0,3.0,0.0,0.0,1.0,0.0,3.0,1.0,1.0,50.0,Matches,392.0,fr FRA,DF,17.0,1.1,48.0,41.0,7.0,1.0,0.0,0.0,1.0,6.0,0.0,0.0,0.0,0.0,41.0,0.0,0.0,Matches,392.0,fr FRA,DF,17.0,1.1,41.0,48.0,85.4,600.0,267.0,26.0,29.0,89.7,13.0,15.0,86.7,1.0,1.0,100.0,0.0,0.0,0.0,0.0,0.0,1.0,0.0,0.0,6.0,Matches,461,fr FRA,DF,17,2,98.0,49.0,2.9,1.1,1,90.0,1,1,8.0,5,1.5,1.0,6.0,-5.0,-4.59,-4.56,1.8,2.6,-0.8,-0.72,-0.62,Matches,392.0,fr FRA,DF,17.0,1.1,56.0,5.0,11.0,34.0,11.0,0.0,56.0,1.0,0.0,0.0,1.0,100.0,39.0,195.0,113.0,1.0,2.0,0.0,0.0,0.0,35.0,1.0,Matches,392.0,fr FRA,DF,17.0,1.1,0.0,0.0,0.0,,0.0,0.0,,,,0.0,0.0,0.0,0.0,0.0,,0.0,0.0,Matches,392.0,fr FRA,DF,17.0,2.0,1.0,98.0,1.1,0.0,0.0,0.0,0.0,0.0,0.0,1.0,0.0,0.0,0.0,0.0,0.0,1.0,6.0,1.0,0.0,0.0,0.0,0.0,0.0,0.0,0.0,0.0,0.0,0.0,Matches,Christian Mawissa,D LC,17,85,-75,"France,Democratic Republic of Congo",Toulouse FC,6,8,10,9,12,6,12,10,10,12,12,8,17,9,12,10,10,12,12,9,7,16,5,12,8,12,13,11,11,12,11,12,14,12,11,7,12,5,13,8,13,2,1,2,3,1,3,3,1,3,3,3,13,9,5,13,13,13,10,13,1,15,20,1,1,1,1,1,1,1,1,1,1,1,184,77,20,10,6559998,4250,4250,1750,African_Caribbean,95,17,2005/4/18,0,0,93.0,,2000131124
554,Pedro Mendes,Montpellier,1990,404.0,pt POR,DF,31.0,0.1,0.0,0.0,0.0,0.0,0.0,0.0,0.0,,0.0,0.0,0.0,0.0,0.0,0.0,0.0,1.0,Matches,404.0,pt POR,DF,31.0,0.1,0.0,0.0,0.0,0.0,0.0,0.0,0.0,0.0,0.0,0.0,0.0,0.0,0.0,0.0,0.0,0.0,Matches,,,,,,,,,,,,,,,,,,,,,,,,,,,,,,,,,,,,,,,,,,,,,,,,,,,,,,,,404.0,pt POR,DF,31.0,0.1,0.0,0.0,0.0,0.0,1.0,0.0,0.0,0.0,0.0,0.0,0.0,0.0,1.0,1.0,1.0,50.0,Matches,404.0,pt POR,DF,31.0,0.1,3.0,3.0,0.0,0.0,0.0,0.0,0.0,0.0,0.0,0.0,0.0,0.0,1.0,0.0,0.0,Matches,404.0,pt POR,DF,31.0,0.1,1.0,3.0,33.3,10.0,0.0,1.0,2.0,50.0,0.0,0.0,,0.0,0.0,,0.0,0.0,0.0,0.0,0.0,0.0,0.0,0.0,0.0,Matches,474,pt POR,DF,31,1,13.0,13.0,0.4,0.1,0,,0,1,13.0,7,0.0,1.0,1.0,0.0,0.0,-0.08,0.2,1.3,-1.1,-7.91,-7.68,Matches,404.0,pt POR,DF,31.0,0.1,4.0,1.0,2.0,2.0,0.0,0.0,4.0,0.0,0.0,,0.0,,2.0,20.0,16.0,0.0,0.0,0.0,1.0,0.0,1.0,0.0,Matches,404.0,pt POR,DF,31.0,0.1,0.0,0.0,0.0,,0.0,0.0,,,,0.0,0.0,0.0,0.0,0.0,,0.0,0.0,Matches,404.0,pt POR,DF,31.0,1.0,0.0,13.0,0.1,0.0,0.0,0.0,0.0,0.0,0.0,0.0,0.0,0.0,0.0,0.0,0.0,0.0,0.0,0.0,0.0,0.0,0.0,0.0,0.0,0.0,0.0,0.0,0.0,0.0,Matches,Pedro Mendes,D C,31,125,140,"Portugal,Switzerland",Montpellier Hérault SC,7,7,11,6,12,9,13,11,10,15,12,6,13,12,18,13,15,12,12,10,11,13,9,12,12,14,15,14,11,12,15,14,12,11,13,14,11,14,12,12,10,3,3,2,2,2,2,1,1,2,3,1,12,16,12,14,9,13,10,6,1,1,20,13,1,1,12,1,1,1,1,1,1,1,186,78,8,20,1815438,6450,6450,4750,Mediterranean_Hispanic,125,9,1990/10/1,1,0,14948.0,,55009672
555,Antoine Mendy,Nice,2004,406.0,fr FRA,DF,18.0,5.8,22.0,13.0,16.0,5.0,1.0,9.0,15.0,60.0,6.0,6.0,1.0,5.0,2.0,24.0,16.0,0.0,Matches,406.0,fr FRA,DF,18.0,5.8,17.0,2.95,12.0,2.0,0.0,2.0,0.0,1.0,2.0,0.35,1.0,0.0,0.0,1.0,0.0,0.0,Matches,,,,,,,,,,,,,,,,,,,,,,,,,,,,,,,,,,,,,,,,,,,,,,,,,,,,,,,,406.0,fr FRA,DF,18.0,5.8,0.0,0.0,0.0,9.0,3.0,2.0,13.0,2.0,13.0,0.0,0.0,0.0,37.0,7.0,11.0,38.9,Matches,406.0,fr FRA,DF,18.0,5.8,325.0,279.0,45.0,2.0,0.0,1.0,13.0,43.0,0.0,0.0,0.0,0.0,262.0,1.0,4.0,Matches,406.0,fr FRA,DF,18.0,5.8,262.0,325.0,80.6,4265.0,1050.0,125.0,138.0,90.6,112.0,132.0,84.8,18.0,40.0,45.0,1.0,0.4,0.3,0.6,6.0,11.0,7.0,3.0,21.0,Matches,476,fr FRA,DF,18,11,518.0,47.0,15.1,5.8,7,71.0,2,4,6.0,14,1.64,10.0,5.0,5.0,0.87,0.68,8.9,6.4,2.5,0.43,0.12,Matches,406.0,fr FRA,DF,18.0,5.8,394.0,22.0,122.0,186.0,88.0,9.0,394.0,4.0,3.0,75.0,1.0,25.0,266.0,1269.0,580.0,2.0,5.0,0.0,11.0,5.0,235.0,37.0,Matches,406.0,fr FRA,DF,18.0,5.8,0.0,8.0,2.0,25.0,1.39,0.35,0.0,0.0,16.3,0.0,0.0,0.0,0.3,0.3,0.04,-0.3,-0.3,Matches,406.0,fr FRA,DF,18.0,11.0,7.0,518.0,5.8,0.0,1.0,1.0,0.0,0.0,0.0,0.0,0.0,0.3,0.3,0.4,0.7,2.0,21.0,37.0,0.0,0.17,0.17,0.0,0.17,0.06,0.07,0.13,0.06,0.13,Matches,Antoine Mendy,D R,18,80,-75,"France,Senegal",OGC Nice,2,5,4,5,9,1,9,5,6,8,9,6,14,8,9,9,9,5,7,8,14,13,5,3,6,5,13,13,14,12,8,12,12,12,8,10,13,10,11,11,10,3,1,2,1,2,1,4,1,3,2,2,17,12,5,10,11,14,12,12,1,1,12,20,1,15,1,1,1,1,1,1,1,1,187,75,10,20,11004999,4117,4117,1034,African_Caribbean,72,19,2004/5/27,0,0,645.0,,2000130977
556,Arkadiusz Milik,Marseille,1994,413.0,pl POL,FW,28.0,1.4,1.0,1.0,0.0,0.0,1.0,0.0,1.0,0.0,1.0,0.0,0.0,0.0,0.0,1.0,2.0,0.0,Matches,413.0,pl POL,FW,28.0,1.4,0.0,0.0,0.0,0.0,0.0,0.0,0.0,0.0,0.0,0.0,0.0,0.0,0.0,0.0,0.0,0.0,Matches,,,,,,,,,,,,,,,,,,,,,,,,,,,,,,,,,,,,,,,,,,,,,,,,,,,,,,,,413.0,pl POL,FW,28.0,1.4,1.0,0.0,0.0,4.0,1.0,1.0,0.0,0.0,1.0,0.0,0.0,0.0,4.0,2.0,7.0,22.2,Matches,413.0,pl POL,FW,28.0,1.4,37.0,34.0,3.0,0.0,0.0,0.0,0.0,0.0,0.0,0.0,0.0,0.0,28.0,0.0,1.0,Matches,413.0,pl POL,FW,28.0,1.4,28.0,37.0,75.7,311.0,43.0,14.0,18.0,77.8,9.0,11.0,81.8,0.0,0.0,,0.0,0.2,0.0,-0.2,1.0,2.0,0.0,0.0,1.0,Matches,484,pl POL,FW,28,2,129.0,65.0,3.8,1.4,2,65.0,0,0,,1,2.0,3.0,1.0,2.0,1.4,0.71,1.2,1.8,-0.6,-0.44,-1.08,Matches,413.0,pl POL,FW,28.0,1.4,47.0,3.0,5.0,27.0,15.0,1.0,47.0,1.0,0.0,0.0,1.0,100.0,33.0,171.0,53.0,1.0,3.0,0.0,1.0,1.0,36.0,9.0,Matches,413.0,pl POL,FW,28.0,1.4,0.0,1.0,0.0,0.0,0.7,0.0,0.0,,7.8,0.0,0.0,0.0,0.1,0.1,0.14,-0.1,-0.1,Matches,413.0,pl POL,FW,28.0,2.0,2.0,129.0,1.4,0.0,0.0,0.0,0.0,0.0,0.0,1.0,0.0,0.1,0.1,0.2,0.4,1.0,1.0,9.0,0.0,0.0,0.0,0.0,0.0,0.1,0.17,0.27,0.1,0.27,Matches,Arkadiusz Milik,S,28,151,160,Poland,Olympique de Marseille,10,10,12,16,15,15,15,14,4,4,13,15,6,16,10,17,14,14,14,11,15,13,14,11,15,4,15,16,14,14,16,14,12,13,13,15,13,10,13,14,11,1,1,2,1,3,2,3,3,3,3,3,11,16,9,9,13,10,12,15,1,1,1,1,1,1,1,1,1,1,1,12,1,20,186,80,20,10,53670146,7550,7850,6800,Northern_European,152,5,1994/2/28,62,16,75941.0,Juventus,96026541
557,Takumi Minamino,Monaco,1995,414.0,jp JPN,MFFW,27.0,8.0,15.0,8.0,5.0,7.0,3.0,7.0,35.0,20.0,28.0,14.0,0.0,14.0,6.0,21.0,4.0,0.0,Matches,414.0,jp JPN,MFFW,27.0,8.0,27.0,3.36,20.0,1.0,0.0,3.0,2.0,1.0,4.0,0.5,2.0,1.0,0.0,0.0,1.0,0.0,Matches,,,,,,,,,,,,,,,,,,,,,,,,,,,,,,,,,,,,,,,,,,,,,,,,,,,,,,,,414.0,jp JPN,MFFW,27.0,8.0,2.0,0.0,0.0,20.0,10.0,4.0,31.0,6.0,8.0,1.0,0.0,0.0,42.0,7.0,7.0,50.0,Matches,414.0,jp JPN,MFFW,27.0,8.0,259.0,234.0,23.0,7.0,0.0,2.0,31.0,3.0,11.0,9.0,2.0,0.0,168.0,2.0,9.0,Matches,414.0,jp JPN,MFFW,27.0,8.0,168.0,259.0,64.9,2530.0,689.0,80.0,109.0,73.4,57.0,75.0,76.0,13.0,37.0,35.1,3.0,1.4,1.9,1.6,10.0,13.0,12.0,0.0,28.0,Matches,485,jp JPN,MFFW,27,18,724.0,40.0,21.2,8.0,10,58.0,0,8,18.0,19,1.83,13.0,9.0,4.0,0.5,0.23,13.0,11.2,1.8,0.22,-0.02,Matches,414.0,jp JPN,MFFW,27.0,8.0,382.0,8.0,43.0,153.0,193.0,43.0,382.0,18.0,8.0,44.4,10.0,55.6,264.0,1684.0,696.0,26.0,12.0,11.0,29.0,11.0,244.0,66.0,Matches,414.0,jp JPN,MFFW,27.0,8.0,1.0,22.0,8.0,36.4,2.73,0.99,0.05,0.13,16.4,1.0,0.0,0.0,1.9,1.9,0.08,-0.9,-0.9,Matches,414.0,jp JPN,MFFW,27.0,18.0,10.0,724.0,8.0,1.0,3.0,4.0,1.0,0.0,0.0,2.0,0.0,1.9,1.9,1.4,3.2,26.0,28.0,66.0,0.12,0.37,0.5,0.12,0.5,0.23,0.17,0.4,0.23,0.4,Matches,Takumi Minamino,AM/S RLC,27,139,150,Japan,AS Monaco,10,12,13,13,14,10,7,11,5,8,13,10,7,14,11,13,12,12,14,13,10,14,14,7,14,8,14,14,14,16,14,8,14,14,13,7,12,6,11,7,11,2,2,2,3,3,1,1,4,2,3,2,11,14,4,10,10,12,12,14,1,1,1,1,1,1,1,14,14,14,20,18,17,18,174,68,12,20,17034266,6950,7400,6250,10,130,1,1995/1/16,42,17,89999.0,,45064891
558,Lebo Mothiba,Strasbourg,1996,420.0,za RSA,FWMF,26.0,4.8,1.0,0.0,1.0,0.0,0.0,0.0,1.0,0.0,1.0,6.0,1.0,5.0,0.0,1.0,4.0,0.0,Matches,420.0,za RSA,FWMF,26.0,4.8,6.0,1.24,3.0,0.0,1.0,0.0,2.0,0.0,1.0,0.21,1.0,0.0,0.0,0.0,0.0,0.0,Matches,,,,,,,,,,,,,,,,,,,,,,,,,,,,,,,,,,,,,,,,,,,,,,,,,,,,,,,,420.0,za RSA,FWMF,26.0,4.8,0.0,0.0,0.0,12.0,12.0,0.0,4.0,0.0,0.0,0.0,0.0,0.0,11.0,10.0,24.0,29.4,Matches,420.0,za RSA,FWMF,26.0,4.8,98.0,87.0,11.0,0.0,0.0,0.0,4.0,1.0,0.0,0.0,0.0,0.0,75.0,0.0,0.0,Matches,420.0,za RSA,FWMF,26.0,4.8,75.0,98.0,76.5,969.0,140.0,42.0,49.0,85.7,25.0,32.0,78.1,1.0,6.0,16.7,0.0,0.1,0.1,-0.1,1.0,5.0,1.0,0.0,7.0,Matches,491,za RSA,FWMF,26,19,435.0,23.0,12.7,4.8,3,65.0,0,16,15.0,14,1.21,11.0,9.0,2.0,0.41,0.72,6.8,8.7,-1.9,-0.38,-0.23,Matches,420.0,za RSA,FWMF,26.0,4.8,157.0,5.0,11.0,76.0,71.0,12.0,157.0,9.0,3.0,33.3,4.0,44.4,110.0,618.0,198.0,7.0,4.0,2.0,15.0,7.0,116.0,30.0,Matches,420.0,za RSA,FWMF,26.0,4.8,3.0,9.0,4.0,44.4,1.86,0.83,0.33,0.75,13.0,0.0,0.0,0.0,1.1,1.1,0.12,1.9,1.9,Matches,420.0,za RSA,FWMF,26.0,19.0,3.0,435.0,4.8,3.0,0.0,3.0,3.0,0.0,0.0,0.0,0.0,1.1,1.1,0.1,1.1,7.0,7.0,30.0,0.62,0.0,0.62,0.62,0.62,0.22,0.02,0.23,0.22,0.23,Matches,Lebo Mothiba,S,26,124,129,South Africa,RC Strasbourg Alsace,11,8,10,13,11,11,15,10,7,6,10,10,6,12,12,12,15,13,13,9,12,13,10,10,12,7,15,17,13,12,16,10,14,14,15,17,12,7,12,8,11,1,2,3,2,3,2,1,1,3,2,1,14,14,5,14,13,12,13,15,1,1,1,1,1,1,1,1,1,1,1,10,1,20,182,76,8,20,2485118,6200,6200,3809,African_Caribbean,122,14,1996/1/28,14,4,13798.0,,48036699
559,Youssouf Ndayishimiye,Nice,1998,429.0,bi BDI,MFDF,23.0,6.3,13.0,9.0,8.0,5.0,0.0,6.0,11.0,54.5,5.0,8.0,5.0,3.0,12.0,25.0,22.0,1.0,Matches,429.0,bi BDI,MFDF,23.0,6.3,8.0,1.27,6.0,0.0,1.0,1.0,0.0,0.0,1.0,0.16,1.0,0.0,0.0,0.0,0.0,0.0,Matches,,,,,,,,,,,,,,,,,,,,,,,,,,,,,,,,,,,,,,,,,,,,,,,,,,,,,,,,429.0,bi BDI,MFDF,23.0,6.3,2.0,0.0,0.0,5.0,4.0,0.0,2.0,12.0,9.0,0.0,0.0,0.0,36.0,5.0,6.0,45.5,Matches,429.0,bi BDI,MFDF,23.0,6.3,374.0,364.0,9.0,8.0,1.0,0.0,2.0,1.0,0.0,0.0,0.0,0.0,337.0,1.0,2.0,Matches,429.0,bi BDI,MFDF,23.0,6.3,337.0,374.0,90.1,6228.0,1553.0,130.0,139.0,93.5,165.0,178.0,92.7,35.0,47.0,74.5,0.0,0.1,0.4,-0.1,1.0,32.0,3.0,1.0,30.0,Matches,509,bi BDI,MFDF,23,10,568.0,57.0,16.6,6.3,6,83.0,4,4,18.0,1,1.8,11.0,6.0,5.0,0.79,0.6,9.8,7.4,2.4,0.38,0.06,Matches,429.0,bi BDI,MFDF,23.0,6.3,446.0,31.0,159.0,250.0,43.0,7.0,446.0,5.0,3.0,60.0,1.0,20.0,351.0,1768.0,937.0,7.0,10.0,1.0,9.0,3.0,320.0,5.0,Matches,429.0,bi BDI,MFDF,23.0,6.3,1.0,8.0,4.0,50.0,1.27,0.63,0.13,0.25,18.2,0.0,0.0,0.0,0.5,0.5,0.06,0.5,0.5,Matches,429.0,bi BDI,MFDF,23.0,10.0,6.0,568.0,6.3,1.0,0.0,1.0,1.0,0.0,0.0,2.0,0.0,0.5,0.5,0.1,0.5,7.0,30.0,5.0,0.16,0.0,0.16,0.16,0.16,0.08,0.01,0.08,0.08,0.08,Matches,Youssouf Ndayishimiye,D/DM C,23,120,135,Burundi,Başakşehir Futbol Kulübü,8,9,11,6,13,7,11,5,8,12,13,8,12,12,15,12,16,13,13,11,12,16,6,9,9,13,15,16,12,12,15,12,16,12,15,14,14,11,16,5,14,3,3,1,1,2,1,4,1,2,2,2,15,13,7,9,9,10,8,10,1,1,20,1,1,1,18,1,14,9,1,10,9,1,183,75,8,20,3035541,6099,5185,4427,African_Caribbean,119,19,1998/10/27,17,1,4999.0,,70138807
560,Azzedine Ounahi,Marseille,2000,448.0,ma MAR,MFFW,22.0,1.3,2.0,1.0,1.0,1.0,0.0,0.0,2.0,0.0,2.0,1.0,0.0,1.0,0.0,2.0,0.0,0.0,Matches,448.0,ma MAR,MFFW,22.0,1.3,5.0,3.72,1.0,0.0,2.0,1.0,1.0,0.0,2.0,1.49,0.0,0.0,2.0,0.0,0.0,0.0,Matches,,,,,,,,,,,,,,,,,,,,,,,,,,,,,,,,,,,,,,,,,,,,,,,,,,,,,,,,448.0,ma MAR,MFFW,22.0,1.3,0.0,0.0,0.0,1.0,3.0,0.0,0.0,0.0,1.0,0.0,0.0,0.0,8.0,0.0,5.0,0.0,Matches,448.0,ma MAR,MFFW,22.0,1.3,94.0,94.0,0.0,0.0,1.0,0.0,0.0,0.0,0.0,0.0,0.0,0.0,87.0,0.0,2.0,Matches,448.0,ma MAR,MFFW,22.0,1.3,87.0,94.0,92.6,1264.0,252.0,49.0,51.0,96.1,24.0,27.0,88.9,6.0,6.0,100.0,0.0,0.2,0.1,-0.2,1.0,9.0,0.0,0.0,5.0,Matches,534,ma MAR,MFFW,22,7,121.0,17.0,3.5,1.3,1,45.0,0,6,13.0,1,2.14,1.0,2.0,-1.0,-0.74,-1.51,2.8,2.9,-0.1,-0.09,-0.72,Matches,448.0,ma MAR,MFFW,22.0,1.3,110.0,0.0,8.0,59.0,45.0,3.0,110.0,8.0,6.0,75.0,1.0,12.5,99.0,650.0,256.0,6.0,5.0,1.0,2.0,5.0,92.0,8.0,Matches,448.0,ma MAR,MFFW,22.0,1.3,1.0,3.0,2.0,66.7,2.23,1.49,0.33,0.5,21.0,1.0,0.0,0.0,0.7,0.7,0.22,0.3,0.3,Matches,448.0,ma MAR,MFFW,22.0,7.0,1.0,121.0,1.3,1.0,0.0,1.0,1.0,0.0,0.0,0.0,0.0,0.7,0.7,0.2,0.9,6.0,5.0,8.0,0.74,0.0,0.74,0.74,0.74,0.5,0.16,0.65,0.5,0.65,Matches,Azzedine Ounahi,DM/M C,22,125,148,Morocco,Angers SCO,9,10,13,7,14,8,11,8,4,12,14,9,11,14,10,12,13,13,11,14,11,9,14,8,12,12,12,13,13,15,11,11,12,13,15,12,12,11,11,13,11,3,1,2,2,1,2,2,2,2,2,3,15,12,5,9,12,13,9,13,1,1,1,1,1,1,17,13,20,1,14,14,1,1,182,62,10,20,6151999,6249,6249,2505,North_African__Middle_Eastern,124,8,2000/4/19,7,2,10674.0,,49052370
561,Ante Palaversa,Troyes,2000,451.0,hr CRO,MF,22.0,0.3,1.0,1.0,1.0,0.0,0.0,0.0,0.0,,0.0,0.0,0.0,0.0,1.0,2.0,0.0,0.0,Matches,451.0,hr CRO,MF,22.0,0.3,2.0,5.81,1.0,1.0,0.0,0.0,0.0,0.0,0.0,0.0,0.0,0.0,0.0,0.0,0.0,0.0,Matches,,,,,,,,,,,,,,,,,,,,,,,,,,,,,,,,,,,,,,,,,,,,,,,,,,,,,,,,451.0,hr CRO,MF,22.0,0.3,0.0,0.0,0.0,0.0,0.0,0.0,2.0,1.0,1.0,0.0,0.0,0.0,7.0,0.0,0.0,,Matches,451.0,hr CRO,MF,22.0,0.3,17.0,14.0,3.0,2.0,0.0,0.0,2.0,0.0,1.0,1.0,0.0,0.0,14.0,0.0,0.0,Matches,451.0,hr CRO,MF,22.0,0.3,14.0,17.0,82.4,281.0,82.0,5.0,5.0,100.0,5.0,6.0,83.3,3.0,5.0,60.0,0.0,0.1,0.0,-0.1,2.0,1.0,0.0,0.0,0.0,Matches,539,hr CRO,MF,22,2,31.0,16.0,0.9,0.3,0,,0,2,16.0,11,0.0,2.0,0.0,2.0,5.81,6.82,1.1,0.6,0.5,1.51,2.55,Matches,451.0,hr CRO,MF,22.0,0.3,20.0,1.0,3.0,12.0,5.0,1.0,20.0,0.0,0.0,,0.0,,12.0,48.0,16.0,0.0,0.0,0.0,0.0,0.0,8.0,0.0,Matches,451.0,hr CRO,MF,22.0,0.3,1.0,1.0,1.0,100.0,2.9,2.9,1.0,1.0,5.2,0.0,0.0,0.0,0.5,0.5,0.51,0.5,0.5,Matches,451.0,hr CRO,MF,22.0,2.0,0.0,31.0,0.3,1.0,0.0,1.0,1.0,0.0,0.0,0.0,0.0,0.5,0.5,0.1,0.6,0.0,0.0,0.0,2.9,0.0,2.9,2.9,2.9,1.47,0.19,1.66,1.47,1.66,Matches,Ante Palaversa,DM/M C,22,111,143,Croatia,ESTAC Troyes,7,8,12,9,11,8,10,10,6,10,13,10,12,11,11,12,13,11,12,14,13,11,11,9,12,12,14,14,12,11,10,11,13,12,13,10,11,7,12,7,11,1,3,2,1,3,1,4,3,2,2,1,16,12,7,10,10,11,10,14,1,1,1,1,1,1,17,12,20,12,7,8,5,1,187,77,10,20,3343999,5900,5700,3000,Northern_European,111,3,2000/4/6,0,0,14999.0,,24055163
562,Lucas Paquetá,Lyon,1997,454.0,br BRA,MF,24.0,1.8,5.0,4.0,0.0,5.0,0.0,1.0,3.0,33.3,2.0,2.0,0.0,2.0,1.0,6.0,3.0,0.0,Matches,454.0,br BRA,MF,24.0,1.8,9.0,5.09,5.0,0.0,1.0,1.0,0.0,2.0,1.0,0.57,0.0,0.0,0.0,1.0,0.0,0.0,Matches,,,,,,,,,,,,,,,,,,,,,,,,,,,,,,,,,,,,,,,,,,,,,,,,,,,,,,,,454.0,br BRA,MF,24.0,1.8,0.0,0.0,0.0,2.0,3.0,0.0,1.0,1.0,4.0,0.0,0.0,0.0,10.0,4.0,1.0,80.0,Matches,454.0,br BRA,MF,24.0,1.8,126.0,121.0,5.0,1.0,5.0,2.0,1.0,1.0,1.0,0.0,0.0,0.0,110.0,0.0,3.0,Matches,454.0,br BRA,MF,24.0,1.8,110.0,126.0,87.3,1981.0,536.0,54.0,60.0,90.0,36.0,40.0,90.0,16.0,21.0,76.2,0.0,0.2,0.7,-0.2,3.0,14.0,3.0,1.0,8.0,Matches,543,br BRA,MF,24,2,159.0,80.0,4.6,1.8,2,80.0,0,0,,0,3.0,6.0,2.0,4.0,2.26,1.88,3.5,2.4,1.0,0.58,0.35,Matches,454.0,br BRA,MF,24.0,1.8,146.0,5.0,22.0,92.0,33.0,8.0,146.0,3.0,1.0,33.3,2.0,66.7,121.0,584.0,203.0,3.0,2.0,2.0,2.0,1.0,117.0,10.0,Matches,454.0,br BRA,MF,24.0,1.8,0.0,5.0,1.0,20.0,2.83,0.57,0.0,0.0,15.1,0.0,0.0,0.0,0.4,0.4,0.07,-0.4,-0.4,Matches,454.0,br BRA,MF,24.0,2.0,2.0,159.0,1.8,0.0,0.0,0.0,0.0,0.0,0.0,0.0,0.0,0.4,0.4,0.2,0.6,3.0,8.0,10.0,0.0,0.0,0.0,0.0,0.0,0.21,0.12,0.33,0.21,0.33,Matches,Lucas Paquetá,M/AM RC,24,147,161,"Brazil,Portugal",West Ham United,12,12,15,12,16,12,12,13,6,10,16,13,10,17,13,13,16,14,12,16,13,13,17,11,14,10,13,14,13,16,14,11,13,13,13,14,11,11,14,8,14,1,3,3,3,1,3,2,1,2,2,2,11,14,9,9,9,14,8,10,1,1,1,1,1,1,1,13,19,14,13,20,15,12,180,72,20,9,57424604,7350,8097,5897,Mixed_Race,147,10,1997/8/27,21,5,150789.0,,19226741
563,Leandro Paredes,Paris S-G,1994,455.0,ar ARG,MF,28.0,0.6,1.0,1.0,1.0,0.0,0.0,1.0,1.0,100.0,0.0,2.0,1.0,1.0,1.0,2.0,0.0,0.0,Matches,455.0,ar ARG,MF,28.0,0.6,4.0,6.92,4.0,0.0,0.0,0.0,0.0,0.0,1.0,1.73,1.0,0.0,0.0,0.0,0.0,0.0,Matches,,,,,,,,,,,,,,,,,,,,,,,,,,,,,,,,,,,,,,,,,,,,,,,,,,,,,,,,455.0,ar ARG,MF,28.0,0.6,0.0,0.0,0.0,0.0,1.0,0.0,0.0,1.0,1.0,0.0,0.0,0.0,2.0,0.0,0.0,,Matches,455.0,ar ARG,MF,28.0,0.6,70.0,65.0,5.0,5.0,1.0,1.0,0.0,0.0,0.0,0.0,0.0,0.0,68.0,0.0,0.0,Matches,455.0,ar ARG,MF,28.0,0.6,68.0,70.0,97.1,1060.0,325.0,36.0,38.0,94.7,25.0,25.0,100.0,4.0,4.0,100.0,1.0,0.4,0.4,0.6,2.0,7.0,1.0,0.0,6.0,Matches,544,ar ARG,MF,28,3,52.0,17.0,1.5,0.6,0,,0,3,17.0,1,3.0,4.0,1.0,3.0,5.19,3.96,2.2,0.3,1.8,3.19,2.44,Matches,455.0,ar ARG,MF,28.0,0.6,75.0,2.0,10.0,57.0,8.0,0.0,75.0,0.0,0.0,,0.0,,64.0,320.0,203.0,1.0,3.0,0.0,0.0,0.0,62.0,0.0,Matches,455.0,ar ARG,MF,28.0,0.6,0.0,0.0,0.0,,0.0,0.0,,,,0.0,0.0,0.0,0.0,0.0,,0.0,0.0,Matches,455.0,ar ARG,MF,28.0,3.0,0.0,52.0,0.6,0.0,1.0,1.0,0.0,0.0,0.0,0.0,0.0,0.0,0.0,0.4,0.4,1.0,6.0,0.0,0.0,1.73,1.73,0.0,1.73,0.0,0.72,0.72,0.0,0.72,Matches,Leandro Paredes,DM/M C,28,149,154,Argentina,Paris Saint-Germain,15,12,14,11,15,14,12,15,7,12,15,13,14,16,17,15,16,14,14,13,14,14,13,10,14,12,15,14,13,14,13,10,14,13,15,13,13,15,13,10,10,3,1,1,2,1,3,2,3,1,3,3,15,8,5,10,15,13,10,9,1,1,1,1,1,1,19,1,20,1,1,12,1,1,180,75,10,20,28214999,7450,7450,6750,Mediterranean_Hispanic,150,6,1994/6/29,44,4,172603.0,Juventus,14024702
564,Dimitri Payet,Marseille,1987,456.0,fr FRA,MFFW,35.0,9.3,6.0,4.0,2.0,2.0,2.0,3.0,10.0,30.0,7.0,4.0,0.0,4.0,0.0,6.0,4.0,0.0,Matches,456.0,fr FRA,MFFW,35.0,9.3,53.0,5.72,33.0,11.0,6.0,1.0,2.0,0.0,6.0,0.65,2.0,2.0,1.0,0.0,1.0,0.0,Matches,,,,,,,,,,,,,,,,,,,,,,,,,,,,,,,,,,,,,,,,,,,,,,,,,,,,,,,,456.0,fr FRA,MFFW,35.0,9.3,0.0,0.0,0.0,5.0,19.0,2.0,58.0,0.0,4.0,0.0,0.0,0.0,46.0,5.0,5.0,50.0,Matches,456.0,fr FRA,MFFW,35.0,9.3,520.0,458.0,61.0,18.0,7.0,10.0,58.0,4.0,34.0,16.0,12.0,0.0,386.0,1.0,10.0,Matches,456.0,fr FRA,MFFW,35.0,9.3,386.0,520.0,74.2,7048.0,2234.0,173.0,210.0,82.4,146.0,187.0,78.1,53.0,89.0,59.6,3.0,3.5,3.4,-0.5,31.0,37.0,28.0,1.0,71.0,Matches,545,fr FRA,MFFW,35,24,835.0,35.0,24.4,9.3,9,65.0,1,15,17.0,8,1.96,27.0,13.0,14.0,1.51,1.06,16.8,10.9,5.8,0.63,0.04,Matches,456.0,fr FRA,MFFW,35.0,9.3,605.0,6.0,53.0,239.0,321.0,39.0,604.0,32.0,18.0,56.3,11.0,34.4,474.0,2613.0,1242.0,22.0,17.0,7.0,15.0,9.0,459.0,84.0,Matches,456.0,fr FRA,MFFW,35.0,9.3,4.0,27.0,7.0,25.9,2.91,0.75,0.11,0.43,20.6,1.0,1.0,1.0,3.0,2.2,0.08,1.0,0.8,Matches,456.0,fr FRA,MFFW,35.0,24.0,9.0,835.0,9.3,4.0,3.0,7.0,3.0,1.0,1.0,0.0,0.0,3.0,2.2,3.5,5.7,22.0,71.0,84.0,0.43,0.32,0.75,0.32,0.65,0.33,0.37,0.7,0.24,0.62,Matches,Dimitri Payet,AM RLC,35,141,154,"France,Réunion",Olympique de Marseille,15,15,16,14,16,17,6,16,6,5,16,18,5,16,8,14,10,15,13,16,14,14,16,14,12,5,12,8,12,13,13,8,14,12,12,12,13,9,12,8,8,1,3,3,1,3,2,3,2,3,3,1,8,15,10,12,13,10,13,11,1,1,1,1,1,1,1,12,12,10,19,20,15,13,175,77,14,20,347975206,7048,7048,5498,African_Caribbean,141,13,1987/3/29,38,8,62137.0,,8442349
565,Patrick Pentz,Reims,1997,459.0,at AUT,GK,25.0,7.0,0.0,0.0,0.0,0.0,0.0,0.0,0.0,,0.0,0.0,0.0,0.0,0.0,0.0,1.0,0.0,Matches,459.0,at AUT,GK,25.0,7.0,2.0,0.29,1.0,1.0,0.0,0.0,0.0,0.0,0.0,0.0,0.0,0.0,0.0,0.0,0.0,0.0,Matches,34.0,at AUT,GK,25.0,7.0,14.0,2.0,0.0,2.0,1.0,11.9,0.34,-1.1,-0.16,29.0,94.0,30.9,152.0,25.0,44.7,36.3,59.0,44.1,38.7,103.0,8.0,7.8,4.0,0.57,12.2,Matches,34.0,at AUT,GK,25.0,7.0,7.0,630.0,7.0,14.0,2.0,29.0,16.0,58.6,1.0,3.0,3.0,0.0,0.0,2.0,2.0,0.0,0.0,0.0,Matches,459.0,at AUT,GK,25.0,7.0,1.0,0.0,0.0,0.0,2.0,0.0,0.0,0.0,0.0,0.0,0.0,0.0,8.0,0.0,0.0,,Matches,459.0,at AUT,GK,25.0,7.0,211.0,138.0,73.0,14.0,0.0,0.0,0.0,0.0,0.0,0.0,0.0,0.0,141.0,0.0,0.0,Matches,459.0,at AUT,GK,25.0,7.0,141.0,211.0,66.8,3725.0,2480.0,34.0,36.0,94.4,61.0,61.0,100.0,44.0,112.0,39.3,0.0,0.0,0.0,0.0,0.0,3.0,0.0,0.0,0.0,Matches,550,at AUT,GK,25,7,630.0,90.0,18.4,7.0,7,90.0,7,0,,12,0.86,10.0,14.0,-4.0,-0.57,-0.7,11.4,11.2,0.2,0.03,-0.25,Matches,459.0,at AUT,GK,25.0,7.0,221.0,191.0,221.0,0.0,0.0,0.0,221.0,0.0,0.0,,0.0,,144.0,845.0,503.0,0.0,1.0,1.0,0.0,0.0,91.0,0.0,Matches,459.0,at AUT,GK,25.0,7.0,0.0,0.0,0.0,,0.0,0.0,,,,0.0,0.0,0.0,0.0,0.0,,0.0,0.0,Matches,459.0,at AUT,GK,25.0,7.0,7.0,630.0,7.0,0.0,0.0,0.0,0.0,0.0,0.0,1.0,0.0,0.0,0.0,0.0,0.0,0.0,0.0,0.0,0.0,0.0,0.0,0.0,0.0,0.0,0.0,0.0,0.0,0.0,Matches,Patrick Pentz,GK,25,124,134,Austria,Stade de Reims,3,4,6,4,11,3,7,6,10,5,10,5,8,9,9,10,11,9,11,9,11,15,6,11,9,15,16,14,11,16,10,13,14,13,14,11,15,4,11,5,4,10,11,12,10,13,10,11,16,13,12,10,8,18,6,8,8,10,10,15,20,1,1,1,1,1,1,1,1,1,1,1,1,1,182,81,20,11,2042646,6193,6193,4146,Northern_European,118,2,1997/1/2,3,0,9847.0,,16147449
566,Łukasz Poręba,Lens,2000,468.0,pl POL,MF,22.0,2.9,5.0,4.0,2.0,1.0,2.0,2.0,3.0,66.7,1.0,3.0,0.0,3.0,4.0,9.0,2.0,0.0,Matches,468.0,pl POL,MF,22.0,2.9,9.0,3.1,8.0,0.0,0.0,0.0,0.0,1.0,2.0,0.69,1.0,0.0,0.0,0.0,0.0,1.0,Matches,,,,,,,,,,,,,,,,,,,,,,,,,,,,,,,,,,,,,,,,,,,,,,,,,,,,,,,,468.0,pl POL,MF,22.0,2.9,1.0,0.0,0.0,9.0,2.0,0.0,6.0,4.0,4.0,0.0,0.0,0.0,12.0,3.0,1.0,75.0,Matches,468.0,pl POL,MF,22.0,2.9,143.0,142.0,1.0,1.0,0.0,0.0,6.0,0.0,0.0,0.0,0.0,0.0,116.0,0.0,1.0,Matches,468.0,pl POL,MF,22.0,2.9,116.0,143.0,81.1,1866.0,539.0,52.0,63.0,82.5,48.0,57.0,84.2,9.0,13.0,69.2,1.0,0.7,0.4,0.3,5.0,12.0,5.0,2.0,20.0,Matches,562,pl POL,MF,22,10,260.0,26.0,7.6,2.9,3,67.0,0,7,8.0,27,2.3,6.0,2.0,4.0,1.38,0.39,5.8,3.5,2.3,0.78,0.18,Matches,468.0,pl POL,MF,22.0,2.9,170.0,4.0,20.0,93.0,57.0,1.0,170.0,2.0,1.0,50.0,1.0,50.0,126.0,625.0,223.0,3.0,8.0,0.0,5.0,2.0,120.0,18.0,Matches,468.0,pl POL,MF,22.0,2.9,0.0,3.0,0.0,0.0,1.04,0.0,0.0,,17.1,0.0,0.0,0.0,0.6,0.6,0.19,-0.6,-0.6,Matches,468.0,pl POL,MF,22.0,10.0,3.0,260.0,2.9,0.0,1.0,1.0,0.0,0.0,0.0,1.0,0.0,0.6,0.6,0.7,1.3,3.0,20.0,18.0,0.0,0.35,0.35,0.0,0.35,0.2,0.23,0.44,0.2,0.44,Matches,Łukasz Poręba,M C,22,108,135,Poland,RC Lens,9,11,8,9,11,10,9,11,7,9,11,8,10,11,12,13,11,12,12,13,11,14,10,8,12,12,14,15,13,12,12,9,5,11,13,10,13,8,17,15,16,2,1,2,1,2,3,2,1,2,3,3,14,14,6,13,12,13,12,14,1,1,1,1,1,1,15,1,20,1,1,14,1,1,179,76,12,20,2184999,5000,5000,2252,Northern_European,108,1,2000/3/13,0,0,1096.0,,96131652
567,Jeff Reine-Adélaïde,Troyes,1998,482.0,fr FRA,MF,24.0,2.6,3.0,2.0,2.0,1.0,0.0,1.0,2.0,50.0,1.0,2.0,0.0,2.0,2.0,5.0,1.0,0.0,Matches,482.0,fr FRA,MF,24.0,2.6,6.0,2.32,6.0,0.0,0.0,0.0,0.0,0.0,1.0,0.39,1.0,0.0,0.0,0.0,0.0,0.0,Matches,,,,,,,,,,,,,,,,,,,,,,,,,,,,,,,,,,,,,,,,,,,,,,,,,,,,,,,,482.0,fr FRA,MF,24.0,2.6,0.0,0.0,0.0,2.0,5.0,0.0,0.0,2.0,2.0,0.0,0.0,0.0,14.0,3.0,4.0,42.9,Matches,482.0,fr FRA,MF,24.0,2.6,128.0,120.0,8.0,5.0,0.0,1.0,0.0,0.0,0.0,0.0,0.0,0.0,106.0,0.0,3.0,Matches,482.0,fr FRA,MF,24.0,2.6,106.0,128.0,82.8,1746.0,440.0,48.0,56.0,85.7,44.0,51.0,86.3,9.0,13.0,69.2,1.0,0.4,0.1,0.6,2.0,9.0,3.0,0.0,20.0,Matches,576,fr FRA,MF,24,6,233.0,39.0,6.8,2.6,3,62.0,0,3,15.0,4,0.17,2.0,7.0,-5.0,-1.93,-1.06,2.8,5.9,-3.0,-1.17,-0.16,Matches,482.0,fr FRA,MF,24.0,2.6,159.0,2.0,33.0,96.0,36.0,1.0,159.0,17.0,10.0,58.8,7.0,41.2,126.0,949.0,518.0,10.0,13.0,0.0,3.0,13.0,121.0,8.0,Matches,482.0,fr FRA,MF,24.0,2.6,0.0,4.0,0.0,0.0,1.55,0.0,0.0,,22.3,0.0,0.0,0.0,0.3,0.3,0.08,-0.3,-0.3,Matches,482.0,fr FRA,MF,24.0,6.0,3.0,233.0,2.6,0.0,1.0,1.0,0.0,0.0,0.0,0.0,0.0,0.3,0.3,0.4,0.8,10.0,20.0,8.0,0.0,0.39,0.39,0.0,0.39,0.12,0.17,0.29,0.12,0.29,Matches,Jeff Reine-Adélaïde,M/AM RLC,24,130,137,France,Olympique Lyonnais,12,11,14,11,14,10,11,10,6,11,14,11,11,15,11,12,8,11,11,14,12,16,15,8,12,10,12,12,14,12,14,12,8,14,12,13,10,12,11,13,16,2,3,2,2,2,3,2,2,2,2,2,12,16,10,12,13,14,14,13,1,1,1,1,1,1,14,12,19,12,17,20,18,1,184,75,10,20,4924779,6500,6500,4750,African_Caribbean,126,14,1998/1/17,0,0,34496.0,,28106680
568,Mamadou Sakho,Montpellier,1990,498.0,fr FRA,DF,32.0,8.5,9.0,5.0,4.0,5.0,0.0,3.0,5.0,60.0,2.0,17.0,12.0,5.0,8.0,17.0,35.0,1.0,Matches,498.0,fr FRA,DF,32.0,8.5,4.0,0.47,2.0,0.0,0.0,1.0,0.0,1.0,0.0,0.0,0.0,0.0,0.0,0.0,0.0,0.0,Matches,,,,,,,,,,,,,,,,,,,,,,,,,,,,,,,,,,,,,,,,,,,,,,,,,,,,,,,,498.0,fr FRA,DF,32.0,8.5,2.0,0.0,0.0,6.0,5.0,0.0,0.0,8.0,5.0,0.0,2.0,0.0,45.0,22.0,18.0,55.0,Matches,498.0,fr FRA,DF,32.0,8.5,459.0,438.0,19.0,17.0,0.0,0.0,0.0,1.0,0.0,0.0,0.0,0.0,397.0,2.0,0.0,Matches,498.0,fr FRA,DF,32.0,8.5,397.0,459.0,86.5,6800.0,2504.0,157.0,175.0,89.7,205.0,227.0,90.3,21.0,39.0,53.8,0.0,0.2,0.4,-0.2,1.0,15.0,0.0,0.0,33.0,Matches,598,fr FRA,DF,32,15,763.0,51.0,22.3,8.5,7,76.0,1,8,29.0,17,1.07,16.0,20.0,-4.0,-0.47,-0.71,11.1,13.2,-2.1,-0.25,0.02,Matches,498.0,fr FRA,DF,32.0,8.5,539.0,74.0,239.0,293.0,8.0,5.0,539.0,2.0,1.0,50.0,1.0,50.0,382.0,1940.0,1144.0,0.0,0.0,0.0,1.0,0.0,357.0,2.0,Matches,498.0,fr FRA,DF,32.0,8.5,1.0,3.0,2.0,66.7,0.35,0.24,0.33,0.5,6.1,0.0,0.0,0.0,0.5,0.5,0.18,0.5,0.5,Matches,498.0,fr FRA,DF,32.0,15.0,7.0,763.0,8.5,1.0,0.0,1.0,1.0,0.0,0.0,2.0,0.0,0.5,0.5,0.2,0.7,0.0,33.0,2.0,0.12,0.0,0.12,0.12,0.12,0.06,0.02,0.08,0.06,0.08,Matches,Mamadou Sakho,D C,32,127,154,"France,Senegal",Montpellier Hérault SC,4,7,10,7,10,6,14,5,11,14,13,7,14,8,15,14,15,13,13,11,13,16,10,17,12,14,14,12,10,10,10,15,12,11,14,16,14,12,15,14,5,1,2,3,1,2,3,2,3,1,3,2,13,16,8,15,14,16,11,14,1,1,20,1,1,1,1,1,1,1,1,1,1,1,187,83,20,7,347975206,6350,6350,5500,African_Caribbean,127,17,1990/2/13,29,2,25314.0,,34000070
569,Renato Sanches,Paris S-G,1997,504.0,pt POR,MF,24.0,8.0,8.0,1.0,1.0,3.0,4.0,5.0,14.0,35.7,9.0,13.0,3.0,10.0,9.0,17.0,4.0,0.0,Matches,504.0,pt POR,MF,24.0,8.0,19.0,2.39,15.0,1.0,0.0,3.0,0.0,0.0,1.0,0.13,0.0,0.0,0.0,1.0,0.0,0.0,Matches,,,,,,,,,,,,,,,,,,,,,,,,,,,,,,,,,,,,,,,,,,,,,,,,,,,,,,,,504.0,pt POR,MF,24.0,8.0,1.0,0.0,0.0,22.0,10.0,0.0,5.0,9.0,1.0,0.0,0.0,0.0,52.0,5.0,4.0,55.6,Matches,504.0,pt POR,MF,24.0,8.0,669.0,653.0,14.0,7.0,2.0,3.0,5.0,5.0,2.0,0.0,2.0,0.0,608.0,2.0,10.0,Matches,504.0,pt POR,MF,24.0,8.0,608.0,669.0,90.9,9958.0,2377.0,300.0,331.0,90.6,243.0,254.0,95.7,48.0,58.0,82.8,0.0,1.7,1.3,-1.7,10.0,64.0,3.0,0.0,56.0,Matches,605,pt POR,MF,24,23,717.0,31.0,21.0,8.0,6,51.0,1,17,24.0,1,2.22,18.0,9.0,9.0,1.13,-0.2,16.7,10.5,6.2,0.78,-0.01,Matches,504.0,pt POR,MF,24.0,8.0,753.0,17.0,106.0,479.0,179.0,18.0,753.0,22.0,13.0,59.1,7.0,31.8,648.0,3751.0,2154.0,30.0,26.0,4.0,13.0,8.0,625.0,25.0,Matches,504.0,pt POR,MF,24.0,8.0,2.0,14.0,6.0,42.9,1.76,0.75,0.14,0.33,17.9,0.0,0.0,0.0,1.1,1.1,0.08,0.9,0.9,Matches,504.0,pt POR,MF,24.0,23.0,6.0,717.0,8.0,2.0,0.0,2.0,2.0,0.0,0.0,1.0,0.0,1.1,1.1,1.7,2.8,30.0,56.0,25.0,0.25,0.0,0.25,0.25,0.25,0.14,0.21,0.35,0.14,0.35,Matches,Renato Sanches,DM/M RC,24,145,156,"Portugal,Cape Verde Islands,São Tomé and Príncipe",Paris Saint-Germain,9,12,15,10,14,9,9,15,10,10,14,11,11,16,17,11,16,14,12,13,11,18,13,8,12,9,10,18,15,15,18,10,17,13,16,14,12,13,15,4,13,1,3,3,2,2,1,2,1,1,2,3,6,15,13,13,9,11,10,10,1,1,1,1,1,1,18,13,20,13,11,15,15,1,176,76,10,20,18839539,7250,7300,6000,African_Caribbean,140,13,1997/8/18,32,3,77534.0,,55070298
570,Amin Sarr,Lyon,2001,509.0,se SWE,FW,21.0,6.0,9.0,6.0,1.0,4.0,4.0,1.0,4.0,25.0,3.0,2.0,0.0,2.0,0.0,9.0,4.0,0.0,Matches,509.0,se SWE,FW,21.0,6.0,9.0,1.51,7.0,0.0,0.0,0.0,2.0,0.0,2.0,0.33,2.0,0.0,0.0,0.0,0.0,0.0,Matches,,,,,,,,,,,,,,,,,,,,,,,,,,,,,,,,,,,,,,,,,,,,,,,,,,,,,,,,509.0,se SWE,FW,21.0,6.0,0.0,0.0,0.0,14.0,4.0,1.0,4.0,0.0,6.0,0.0,0.0,0.0,19.0,10.0,18.0,35.7,Matches,509.0,se SWE,FW,21.0,6.0,142.0,136.0,6.0,0.0,0.0,0.0,4.0,1.0,0.0,0.0,0.0,0.0,104.0,0.0,3.0,Matches,509.0,se SWE,FW,21.0,6.0,104.0,142.0,73.2,1376.0,210.0,62.0,83.0,74.7,25.0,36.0,69.4,7.0,7.0,100.0,1.0,0.4,0.3,0.6,4.0,6.0,4.0,0.0,9.0,Matches,610,se SWE,FW,21,13,537.0,41.0,15.7,6.0,6,63.0,1,7,23.0,3,1.69,10.0,10.0,0.0,0.0,-0.56,9.2,10.1,-0.9,-0.14,-0.47,Matches,509.0,se SWE,FW,21.0,6.0,203.0,3.0,13.0,96.0,97.0,20.0,203.0,14.0,4.0,28.6,8.0,57.1,144.0,863.0,344.0,12.0,15.0,5.0,20.0,5.0,138.0,47.0,Matches,509.0,se SWE,FW,21.0,6.0,1.0,6.0,5.0,83.3,1.01,0.84,0.17,0.2,12.7,0.0,0.0,0.0,1.2,1.2,0.2,-0.2,-0.2,Matches,509.0,se SWE,FW,21.0,13.0,6.0,537.0,6.0,1.0,1.0,2.0,1.0,0.0,0.0,0.0,0.0,1.2,1.2,0.4,1.6,12.0,9.0,47.0,0.17,0.17,0.34,0.17,0.34,0.21,0.07,0.27,0.21,0.27,Matches,Amin Sarr,AM/S RL,21,121,135,"Sweden,Senegal,The Gambia",sc Heerenveen,7,7,12,13,12,8,10,10,6,5,11,9,5,13,13,12,12,12,12,9,11,14,13,6,13,7,12,11,15,13,13,14,12,15,13,13,11,8,12,5,7,3,2,1,2,1,3,3,2,4,2,2,8,12,6,10,10,11,10,11,1,1,1,1,1,1,1,10,1,10,17,1,16,20,188,83,9,20,4880000,6250,5500,3852,African_Caribbean,117,10,2001/3/11,0,0,3999.0,,93122985
571,Malang Sarr,Monaco,1999,510.0,fr FRA,DF,23.0,8.0,6.0,3.0,5.0,1.0,0.0,1.0,5.0,20.0,4.0,11.0,7.0,4.0,15.0,21.0,29.0,2.0,Matches,510.0,fr FRA,DF,23.0,8.0,8.0,1.01,8.0,0.0,0.0,0.0,0.0,0.0,1.0,0.13,1.0,0.0,0.0,0.0,0.0,0.0,Matches,,,,,,,,,,,,,,,,,,,,,,,,,,,,,,,,,,,,,,,,,,,,,,,,,,,,,,,,510.0,fr FRA,DF,23.0,8.0,3.0,0.0,0.0,10.0,4.0,0.0,1.0,15.0,3.0,0.0,0.0,0.0,49.0,15.0,9.0,62.5,Matches,510.0,fr FRA,DF,23.0,8.0,517.0,503.0,13.0,9.0,0.0,10.0,1.0,3.0,0.0,0.0,0.0,0.0,460.0,1.0,5.0,Matches,510.0,fr FRA,DF,23.0,8.0,460.0,517.0,89.0,9845.0,3187.0,120.0,131.0,91.6,258.0,274.0,94.2,74.0,95.0,77.9,0.0,0.0,0.2,0.0,1.0,55.0,1.0,0.0,59.0,Matches,611,fr FRA,DF,23,13,716.0,55.0,20.9,8.0,8,79.0,6,5,17.0,12,1.92,10.0,14.0,-4.0,-0.5,-1.04,11.7,10.8,0.9,0.12,-0.15,Matches,510.0,fr FRA,DF,23.0,8.0,590.0,54.0,210.0,366.0,17.0,1.0,590.0,4.0,2.0,50.0,2.0,50.0,457.0,2591.0,1656.0,5.0,7.0,2.0,4.0,2.0,410.0,2.0,Matches,510.0,fr FRA,DF,23.0,8.0,0.0,1.0,0.0,0.0,0.13,0.0,0.0,,12.5,0.0,0.0,0.0,0.0,0.0,0.02,0.0,0.0,Matches,510.0,fr FRA,DF,23.0,13.0,8.0,716.0,8.0,0.0,0.0,0.0,0.0,0.0,0.0,3.0,0.0,0.0,0.0,0.0,0.0,5.0,59.0,2.0,0.0,0.0,0.0,0.0,0.0,0.0,0.0,0.01,0.0,0.01,Matches,Malang Sarr,D LC,23,130,150,"France,Senegal",Chelsea,5,11,12,7,13,6,13,7,8,13,13,9,14,13,12,12,15,13,12,12,13,15,12,10,10,12,14,14,14,14,15,11,16,15,15,13,13,8,12,6,8,2,2,1,3,3,3,1,4,3,1,1,7,15,6,14,12,16,13,14,1,16,20,1,1,1,1,1,1,1,1,1,1,1,182,73,20,8,13169507,6500,6600,5500,African_Caribbean,129,15,1999/1/23,0,0,40597.0,AS Monaco,48036830
572,Mamadou Sarr,Lyon,2005,511.0,fr FRA,MF,16.0,0.1,0.0,0.0,0.0,0.0,0.0,0.0,0.0,,0.0,0.0,0.0,0.0,0.0,0.0,0.0,0.0,Matches,511.0,fr FRA,MF,16.0,0.1,0.0,0.0,0.0,0.0,0.0,0.0,0.0,0.0,0.0,0.0,0.0,0.0,0.0,0.0,0.0,0.0,Matches,,,,,,,,,,,,,,,,,,,,,,,,,,,,,,,,,,,,,,,,,,,,,,,,,,,,,,,,511.0,fr FRA,MF,16.0,0.1,0.0,0.0,0.0,0.0,0.0,0.0,0.0,0.0,0.0,0.0,0.0,0.0,0.0,0.0,0.0,,Matches,511.0,fr FRA,MF,16.0,0.1,8.0,8.0,0.0,0.0,0.0,0.0,0.0,0.0,0.0,0.0,0.0,0.0,8.0,0.0,0.0,Matches,511.0,fr FRA,MF,16.0,0.1,8.0,8.0,100.0,170.0,77.0,1.0,1.0,100.0,6.0,6.0,100.0,1.0,1.0,100.0,0.0,0.0,0.0,0.0,0.0,0.0,0.0,0.0,0.0,Matches,612,fr FRA,MF,16,1,8.0,8.0,0.2,0.1,0,,0,1,8.0,6,3.0,0.0,0.0,0.0,0.0,-0.47,1.2,0.0,1.2,13.98,13.76,Matches,511.0,fr FRA,MF,16.0,0.1,9.0,0.0,6.0,3.0,0.0,0.0,9.0,0.0,0.0,,0.0,,8.0,39.0,6.0,0.0,0.0,0.0,0.0,0.0,8.0,0.0,Matches,511.0,fr FRA,MF,16.0,0.1,0.0,0.0,0.0,,0.0,0.0,,,,0.0,0.0,0.0,0.0,0.0,,0.0,0.0,Matches,511.0,fr FRA,MF,16.0,1.0,0.0,8.0,0.1,0.0,0.0,0.0,0.0,0.0,0.0,0.0,0.0,0.0,0.0,0.0,0.0,0.0,0.0,0.0,0.0,0.0,0.0,0.0,0.0,0.0,0.0,0.0,0.0,0.0,Matches,Mamadou Sarr,D/DM C,16,84,-8,France,Olympique Lyonnais,5,5,3,5,9,5,12,8,5,11,9,2,14,8,11,8,9,8,8,9,14,6,12,2,8,9,7,9,10,9,12,14,8,10,5,12,7,10,19,7,10,1,3,1,2,2,3,2,3,3,3,3,19,8,1,9,9,11,11,14,1,1,20,1,1,1,18,1,1,1,1,1,1,1,188,0,10,20,11007750,4200,4200,1055,African_Caribbean,78,19,2005/8/29,0,0,645.0,,2000107103
573,Vincent Sierro,Toulouse,1995,518.0,ch SUI,MF,26.0,7.4,19.0,11.0,9.0,9.0,1.0,11.0,29.0,37.9,18.0,12.0,3.0,9.0,4.0,23.0,11.0,1.0,Matches,518.0,ch SUI,MF,26.0,7.4,14.0,1.89,8.0,4.0,0.0,2.0,0.0,0.0,0.0,0.0,0.0,0.0,0.0,0.0,0.0,0.0,Matches,,,,,,,,,,,,,,,,,,,,,,,,,,,,,,,,,,,,,,,,,,,,,,,,,,,,,,,,518.0,ch SUI,MF,26.0,7.4,3.0,0.0,0.0,19.0,8.0,0.0,25.0,4.0,11.0,0.0,0.0,0.0,50.0,9.0,9.0,50.0,Matches,518.0,ch SUI,MF,26.0,7.4,408.0,367.0,38.0,7.0,2.0,7.0,25.0,2.0,21.0,11.0,8.0,0.0,321.0,3.0,8.0,Matches,518.0,ch SUI,MF,26.0,7.4,321.0,408.0,78.7,6144.0,1812.0,120.0,145.0,82.8,151.0,174.0,86.8,41.0,67.0,61.2,0.0,0.8,0.6,-0.8,11.0,36.0,6.0,0.0,49.0,Matches,619,ch SUI,MF,26,15,665.0,44.0,19.4,7.4,7,78.0,3,8,15.0,1,1.27,6.0,8.0,-2.0,-0.27,-0.14,11.3,10.2,1.1,0.15,0.34,Matches,518.0,ch SUI,MF,26.0,7.4,485.0,16.0,100.0,296.0,92.0,6.0,485.0,8.0,6.0,75.0,1.0,12.5,343.0,1717.0,666.0,7.0,10.0,2.0,6.0,7.0,313.0,13.0,Matches,518.0,ch SUI,MF,26.0,7.4,0.0,8.0,3.0,37.5,1.08,0.41,0.0,0.0,22.3,1.0,0.0,0.0,0.5,0.5,0.06,-0.5,-0.5,Matches,518.0,ch SUI,MF,26.0,15.0,7.0,665.0,7.4,0.0,0.0,0.0,0.0,0.0,0.0,3.0,0.0,0.5,0.5,0.8,1.2,7.0,49.0,13.0,0.0,0.0,0.0,0.0,0.0,0.06,0.1,0.17,0.06,0.17,Matches,Vincent Sierro,DM/M C,26,124,126,Switzerland,BSC Young Boys,12,12,12,9,13,9,11,14,6,9,14,13,9,14,15,15,10,13,11,12,14,13,11,9,12,11,15,15,11,10,13,13,17,12,15,10,12,8,13,11,12,2,2,3,3,2,2,3,1,2,2,3,10,12,6,13,9,14,16,16,1,1,1,1,1,1,17,10,20,10,10,14,10,1,187,79,12,20,2301539,6167,6167,3934,Northern_European,124,4,1995/10/8,0,0,10633.0,,98034038
574,Eduard Sobol,Strasbourg,1995,527.0,ua UKR,DF,27.0,9.7,19.0,10.0,10.0,6.0,3.0,9.0,13.0,69.2,4.0,10.0,1.0,9.0,8.0,27.0,19.0,0.0,Matches,527.0,ua UKR,DF,27.0,9.7,20.0,2.07,13.0,0.0,2.0,0.0,3.0,2.0,2.0,0.21,1.0,0.0,0.0,0.0,0.0,1.0,Matches,,,,,,,,,,,,,,,,,,,,,,,,,,,,,,,,,,,,,,,,,,,,,,,,,,,,,,,,527.0,ua UKR,DF,27.0,9.7,2.0,0.0,0.0,10.0,17.0,2.0,19.0,8.0,10.0,0.0,1.0,0.0,35.0,9.0,5.0,64.3,Matches,527.0,ua UKR,DF,27.0,9.7,391.0,323.0,68.0,4.0,0.0,2.0,19.0,64.0,0.0,0.0,0.0,0.0,298.0,0.0,3.0,Matches,527.0,ua UKR,DF,27.0,9.7,298.0,391.0,76.2,4795.0,1729.0,156.0,179.0,87.2,108.0,151.0,71.5,21.0,43.0,48.8,1.0,0.8,0.7,0.2,8.0,25.0,10.0,3.0,34.0,Matches,628,ua UKR,DF,27,15,870.0,58.0,25.4,9.7,9,81.0,5,6,24.0,1,1.13,16.0,14.0,2.0,0.21,0.56,14.0,11.0,3.0,0.31,0.66,Matches,527.0,ua UKR,DF,27.0,9.7,479.0,19.0,97.0,230.0,156.0,8.0,479.0,25.0,11.0,44.0,9.0,36.0,300.0,1781.0,771.0,16.0,15.0,2.0,12.0,7.0,277.0,54.0,Matches,527.0,ua UKR,DF,27.0,9.7,0.0,5.0,0.0,0.0,0.52,0.0,0.0,,26.6,0.0,0.0,0.0,0.1,0.1,0.02,-0.1,-0.1,Matches,527.0,ua UKR,DF,27.0,15.0,9.0,870.0,9.7,0.0,1.0,1.0,0.0,0.0,0.0,2.0,0.0,0.1,0.1,0.8,0.9,16.0,34.0,54.0,0.0,0.1,0.1,0.0,0.1,0.01,0.08,0.09,0.01,0.09,Matches,Eduard Sobol,D/WB/M L,27,121,135,Ukraine,Club Brugge KV,12,13,11,9,10,14,11,9,12,13,11,13,13,11,11,10,11,12,14,12,11,13,10,12,13,12,14,13,14,14,12,11,12,13,14,11,11,13,13,8,13,2,3,2,3,2,3,1,1,1,1,1,12,12,2,16,9,12,11,12,1,20,1,1,17,1,1,17,1,1,13,1,1,1,181,73,20,7,1051875,6000,6000,3012,Northern_European,121,4,1995/5/4,26,0,7499.0,,71050075
575,Arnaud Souquet,Montpellier,1992,532.0,fr FRA,DFFW,30.0,4.0,22.0,16.0,13.0,7.0,2.0,11.0,14.0,78.6,3.0,8.0,3.0,5.0,4.0,26.0,4.0,0.0,Matches,532.0,fr FRA,DFFW,30.0,4.0,5.0,1.25,5.0,0.0,0.0,0.0,0.0,0.0,0.0,0.0,0.0,0.0,0.0,0.0,0.0,0.0,Matches,,,,,,,,,,,,,,,,,,,,,,,,,,,,,,,,,,,,,,,,,,,,,,,,,,,,,,,,532.0,fr FRA,DFFW,30.0,4.0,1.0,0.0,0.0,7.0,7.0,1.0,7.0,4.0,16.0,0.0,1.0,0.0,27.0,9.0,10.0,47.4,Matches,532.0,fr FRA,DFFW,30.0,4.0,137.0,111.0,26.0,3.0,1.0,0.0,7.0,23.0,0.0,0.0,0.0,0.0,104.0,0.0,1.0,Matches,532.0,fr FRA,DFFW,30.0,4.0,104.0,137.0,75.9,1509.0,690.0,65.0,75.0,86.7,29.0,40.0,72.5,4.0,10.0,40.0,0.0,0.5,0.3,-0.5,3.0,7.0,1.0,1.0,10.0,Matches,633,fr FRA,DFFW,30,12,361.0,30.0,10.6,4.0,3,63.0,0,9,19.0,5,1.17,6.0,9.0,-3.0,-0.75,-0.92,6.1,8.7,-2.6,-0.66,-0.44,Matches,532.0,fr FRA,DFFW,30.0,4.0,185.0,17.0,57.0,93.0,37.0,3.0,185.0,7.0,2.0,28.6,4.0,57.1,98.0,532.0,245.0,5.0,1.0,0.0,5.0,1.0,86.0,14.0,Matches,532.0,fr FRA,DFFW,30.0,4.0,0.0,1.0,0.0,0.0,0.25,0.0,0.0,,20.7,0.0,0.0,0.0,0.1,0.1,0.06,-0.1,-0.1,Matches,532.0,fr FRA,DFFW,30.0,12.0,3.0,361.0,4.0,0.0,0.0,0.0,0.0,0.0,0.0,1.0,0.0,0.1,0.1,0.5,0.6,5.0,10.0,14.0,0.0,0.0,0.0,0.0,0.0,0.01,0.13,0.15,0.01,0.15,Matches,Arnaud Souquet,D/WB R,30,120,131,France,Montpellier Hérault SC,12,12,12,7,13,12,6,13,6,11,13,10,11,13,9,12,9,13,14,12,15,17,10,9,12,11,15,15,12,14,8,8,14,12,14,8,14,12,13,7,15,3,1,4,2,3,2,3,1,1,2,2,12,14,5,13,13,15,14,16,1,1,13,20,1,20,1,1,1,1,1,1,1,1,179,74,10,20,1285052,6146,6296,3896,Northern_European,117,6,1992/2/12,0,0,12649.0,,85014379
576,Calvin Stengs,Nice,1998,536.0,nl NED,FW,23.0,2.4,2.0,2.0,1.0,0.0,1.0,1.0,2.0,50.0,1.0,0.0,0.0,0.0,0.0,2.0,0.0,0.0,Matches,536.0,nl NED,FW,23.0,2.4,9.0,3.82,8.0,0.0,1.0,0.0,0.0,0.0,1.0,0.42,1.0,0.0,0.0,0.0,0.0,0.0,Matches,,,,,,,,,,,,,,,,,,,,,,,,,,,,,,,,,,,,,,,,,,,,,,,,,,,,,,,,536.0,nl NED,FW,23.0,2.4,0.0,0.0,0.0,5.0,6.0,0.0,3.0,0.0,2.0,0.0,0.0,0.0,13.0,1.0,1.0,50.0,Matches,536.0,nl NED,FW,23.0,2.4,100.0,94.0,6.0,0.0,2.0,2.0,3.0,3.0,3.0,2.0,0.0,0.0,82.0,0.0,0.0,Matches,536.0,nl NED,FW,23.0,2.4,82.0,100.0,82.0,1288.0,254.0,45.0,55.0,81.8,31.0,34.0,91.2,3.0,7.0,42.9,0.0,0.1,0.4,-0.1,1.0,11.0,2.0,0.0,12.0,Matches,637,nl NED,FW,23,4,212.0,53.0,6.2,2.4,3,66.0,0,1,13.0,0,0.5,1.0,3.0,-2.0,-0.85,-1.21,3.1,2.3,0.8,0.32,-0.01,Matches,536.0,nl NED,FW,23.0,2.4,119.0,0.0,14.0,47.0,61.0,6.0,119.0,10.0,6.0,60.0,3.0,30.0,105.0,727.0,332.0,10.0,11.0,1.0,6.0,3.0,100.0,16.0,Matches,536.0,nl NED,FW,23.0,2.4,0.0,3.0,1.0,33.3,1.27,0.42,0.0,0.0,20.1,0.0,0.0,0.0,0.3,0.3,0.09,-0.3,-0.3,Matches,536.0,nl NED,FW,23.0,4.0,3.0,212.0,2.4,0.0,0.0,0.0,0.0,0.0,0.0,0.0,0.0,0.3,0.3,0.1,0.4,10.0,12.0,16.0,0.0,0.0,0.0,0.0,0.0,0.12,0.05,0.17,0.12,0.17,Matches,Calvin Stengs,M/AM RC,23,133,144,"Holland,Suriname",OGC Nice,15,11,15,9,14,12,9,12,5,5,15,13,6,15,11,14,10,11,11,16,12,14,18,5,14,6,14,14,13,14,14,12,12,15,13,11,12,3,14,12,12,1,1,3,1,1,3,1,4,3,3,3,12,10,6,15,11,14,13,10,1,1,1,1,1,1,1,12,1,18,14,16,20,1,182,68,20,10,11771364,6752,6751,5394,Mixed_Race,132,13,1998/12/18,7,0,19999.0,R Antwerp FC,37059574
577,Kamaldeen Sulemana,Rennes,2002,539.0,gh GHA,FWMF,20.0,3.6,6.0,3.0,1.0,4.0,1.0,1.0,5.0,20.0,4.0,2.0,0.0,2.0,4.0,10.0,2.0,0.0,Matches,539.0,gh GHA,FWMF,20.0,3.6,13.0,3.6,9.0,0.0,3.0,1.0,0.0,0.0,0.0,0.0,0.0,0.0,0.0,0.0,0.0,0.0,Matches,,,,,,,,,,,,,,,,,,,,,,,,,,,,,,,,,,,,,,,,,,,,,,,,,,,,,,,,539.0,gh GHA,FWMF,20.0,3.6,1.0,0.0,0.0,5.0,6.0,1.0,10.0,4.0,3.0,0.0,0.0,0.0,29.0,4.0,5.0,44.4,Matches,539.0,gh GHA,FWMF,20.0,3.6,155.0,149.0,5.0,1.0,0.0,2.0,10.0,4.0,0.0,0.0,0.0,0.0,127.0,1.0,6.0,Matches,539.0,gh GHA,FWMF,20.0,3.6,127.0,155.0,81.9,2261.0,415.0,64.0,73.0,87.7,43.0,48.0,89.6,16.0,22.0,72.7,0.0,0.6,0.9,-0.6,6.0,7.0,5.0,2.0,18.0,Matches,640,gh GHA,FWMF,20,14,326.0,23.0,9.5,3.6,2,52.0,0,12,19.0,4,1.71,7.0,2.0,5.0,1.38,0.65,8.0,3.7,4.3,1.2,0.82,Matches,539.0,gh GHA,FWMF,20.0,3.6,230.0,2.0,19.0,82.0,133.0,25.0,230.0,32.0,15.0,46.9,14.0,43.8,189.0,1486.0,540.0,17.0,10.0,10.0,13.0,12.0,170.0,57.0,Matches,539.0,gh GHA,FWMF,20.0,3.6,1.0,13.0,3.0,23.1,3.59,0.83,0.08,0.33,17.6,0.0,0.0,0.0,1.4,1.4,0.11,-0.4,-0.4,Matches,539.0,gh GHA,FWMF,20.0,14.0,2.0,326.0,3.6,1.0,0.0,1.0,1.0,0.0,0.0,1.0,0.0,1.4,1.4,0.6,1.9,17.0,18.0,57.0,0.28,0.0,0.28,0.28,0.28,0.38,0.16,0.54,0.38,0.54,Matches,Kamaldeen Sulemana,M/AM L,20,122,-8,Ghana,Stade Rennais FC,8,11,15,14,12,6,5,12,2,3,11,10,3,16,9,12,11,12,9,12,12,13,17,3,14,5,9,12,16,15,8,8,12,16,8,7,11,13,9,12,9,1,2,3,3,2,2,1,1,2,1,3,12,13,7,12,11,14,13,13,1,1,1,1,1,1,1,16,1,13,20,12,14,11,175,69,12,20,70117004,6093,6093,3993,African_Caribbean,117,14,2002/2/15,11,0,9270.0,,29244869
578,Alexis Tibidi,Troyes,2003,558.0,fr FRA,FWMF,18.0,0.8,1.0,1.0,1.0,0.0,0.0,0.0,0.0,,0.0,0.0,0.0,0.0,0.0,1.0,0.0,0.0,Matches,558.0,fr FRA,FWMF,18.0,0.8,3.0,3.65,2.0,0.0,0.0,0.0,1.0,0.0,0.0,0.0,0.0,0.0,0.0,0.0,0.0,0.0,Matches,,,,,,,,,,,,,,,,,,,,,,,,,,,,,,,,,,,,,,,,,,,,,,,,,,,,,,,,558.0,fr FRA,FWMF,18.0,0.8,0.0,0.0,0.0,0.0,1.0,0.0,0.0,0.0,1.0,0.0,0.0,0.0,1.0,2.0,1.0,66.7,Matches,558.0,fr FRA,FWMF,18.0,0.8,23.0,21.0,2.0,0.0,0.0,0.0,0.0,0.0,0.0,0.0,0.0,0.0,19.0,0.0,0.0,Matches,558.0,fr FRA,FWMF,18.0,0.8,19.0,23.0,82.6,271.0,4.0,10.0,12.0,83.3,6.0,7.0,85.7,1.0,2.0,50.0,0.0,0.0,0.0,0.0,0.0,0.0,0.0,0.0,0.0,Matches,661,fr FRA,FWMF,18,3,74.0,25.0,2.2,0.8,0,,0,3,25.0,4,0.0,0.0,2.0,-2.0,-2.43,-1.52,0.5,1.3,-0.9,-1.07,-0.04,Matches,558.0,fr FRA,FWMF,18.0,0.8,25.0,0.0,2.0,13.0,11.0,0.0,25.0,3.0,2.0,66.7,0.0,0.0,20.0,121.0,46.0,1.0,1.0,0.0,1.0,1.0,23.0,4.0,Matches,558.0,fr FRA,FWMF,18.0,0.8,0.0,0.0,0.0,,0.0,0.0,,,,0.0,0.0,0.0,0.0,0.0,,0.0,0.0,Matches,558.0,fr FRA,FWMF,18.0,3.0,0.0,74.0,0.8,0.0,0.0,0.0,0.0,0.0,0.0,0.0,0.0,0.0,0.0,0.0,0.0,1.0,0.0,4.0,0.0,0.0,0.0,0.0,0.0,0.0,0.0,0.0,0.0,0.0,Matches,Alexis Tibidi,AM/S RLC,18,114,-8,"France,Cameroon",VfB Stuttgart,10,11,13,11,11,9,6,10,6,7,11,9,5,13,8,8,11,10,9,10,9,12,16,5,11,7,11,12,15,15,8,14,13,15,10,8,12,7,12,8,14,2,2,1,2,3,1,1,3,1,1,3,12,12,10,12,12,10,14,14,1,1,1,1,1,1,1,10,10,10,20,16,18,18,187,0,8,20,64384000,5686,4257,3920,African_Caribbean,103,13,2003/11/3,0,0,5674.0,Sportclub Rheindorf Altach,2000006110
579,João Victor,Nantes,1998,581.0,br BRA,DF,24.0,9.4,19.0,11.0,9.0,7.0,3.0,12.0,22.0,54.5,10.0,11.0,1.0,10.0,15.0,34.0,30.0,0.0,Matches,581.0,br BRA,DF,24.0,9.4,10.0,1.07,8.0,0.0,0.0,1.0,0.0,1.0,1.0,0.11,1.0,0.0,0.0,0.0,0.0,0.0,Matches,,,,,,,,,,,,,,,,,,,,,,,,,,,,,,,,,,,,,,,,,,,,,,,,,,,,,,,,581.0,br BRA,DF,24.0,9.4,5.0,0.0,0.0,9.0,11.0,0.0,8.0,15.0,11.0,0.0,0.0,1.0,53.0,11.0,6.0,64.7,Matches,581.0,br BRA,DF,24.0,9.4,436.0,367.0,68.0,19.0,0.0,0.0,8.0,48.0,1.0,0.0,0.0,0.0,347.0,1.0,6.0,Matches,581.0,br BRA,DF,24.0,9.4,347.0,436.0,79.6,6390.0,1715.0,133.0,160.0,83.1,168.0,198.0,84.8,39.0,64.0,60.9,1.0,0.6,0.4,0.4,4.0,19.0,5.0,3.0,40.0,Matches,688,br BRA,DF,24,13,842.0,65.0,24.6,9.4,9,80.0,7,4,31.0,4,0.92,9.0,16.0,-7.0,-0.75,-0.36,10.3,16.5,-6.2,-0.66,-0.54,Matches,581.0,br BRA,DF,24.0,9.4,539.0,41.0,188.0,281.0,80.0,6.0,539.0,11.0,6.0,54.5,3.0,27.3,338.0,2231.0,1227.0,17.0,22.0,1.0,10.0,8.0,293.0,14.0,Matches,581.0,br BRA,DF,24.0,9.4,0.0,2.0,0.0,0.0,0.21,0.0,0.0,,15.7,0.0,0.0,0.0,0.1,0.1,0.06,-0.1,-0.1,Matches,581.0,br BRA,DF,24.0,13.0,9.0,842.0,9.4,0.0,1.0,1.0,0.0,0.0,0.0,5.0,0.0,0.1,0.1,0.6,0.8,17.0,40.0,14.0,0.0,0.11,0.11,0.0,0.11,0.01,0.07,0.08,0.01,0.08,Matches,João Victor,D RC,24,134,145,Brazil,SL Benfica,6,11,12,7,12,5,13,8,10,13,12,7,14,12,12,15,13,13,11,11,12,13,10,7,10,13,12,13,13,14,11,14,13,15,14,13,13,13,9,6,11,1,3,2,3,2,1,4,1,2,3,2,12,13,6,14,12,9,11,9,1,1,20,17,1,10,1,1,1,1,1,1,1,1,187,77,11,20,8068732,6700,6450,5200,Mixed_Race,130,10,1998/7/17,0,0,30550.0,,19296885
580,Alan Virginius,Lille,2003,583.0,fr FRA,FW,19.0,2.9,3.0,2.0,1.0,1.0,1.0,0.0,4.0,0.0,4.0,0.0,0.0,0.0,2.0,5.0,1.0,0.0,Matches,583.0,fr FRA,FW,19.0,2.9,8.0,2.78,4.0,0.0,0.0,3.0,1.0,0.0,1.0,0.35,0.0,0.0,0.0,1.0,0.0,0.0,Matches,,,,,,,,,,,,,,,,,,,,,,,,,,,,,,,,,,,,,,,,,,,,,,,,,,,,,,,,583.0,fr FRA,FW,19.0,2.9,1.0,0.0,0.0,6.0,2.0,2.0,2.0,2.0,2.0,0.0,0.0,0.0,9.0,1.0,11.0,8.3,Matches,583.0,fr FRA,FW,19.0,2.9,75.0,69.0,6.0,0.0,0.0,0.0,2.0,1.0,0.0,0.0,0.0,0.0,58.0,0.0,6.0,Matches,583.0,fr FRA,FW,19.0,2.9,58.0,75.0,77.3,823.0,192.0,31.0,38.0,81.6,22.0,23.0,95.7,1.0,2.0,50.0,0.0,0.0,0.2,0.0,1.0,6.0,3.0,0.0,10.0,Matches,690,fr FRA,FW,19,15,258.0,17.0,7.5,2.9,1,68.0,0,14,14.0,12,1.33,5.0,6.0,-1.0,-0.35,-0.98,6.5,2.9,3.6,1.25,0.55,Matches,583.0,fr FRA,FW,19.0,2.9,122.0,1.0,8.0,30.0,85.0,23.0,122.0,7.0,0.0,0.0,6.0,85.7,86.0,636.0,291.0,12.0,6.0,8.0,7.0,6.0,81.0,32.0,Matches,583.0,fr FRA,FW,19.0,2.9,1.0,12.0,5.0,41.7,4.19,1.74,0.08,0.2,14.4,0.0,0.0,0.0,3.1,3.1,0.26,-2.1,-2.1,Matches,583.0,fr FRA,FW,19.0,15.0,1.0,258.0,2.9,1.0,0.0,1.0,1.0,0.0,0.0,1.0,0.0,3.1,3.1,0.0,3.1,12.0,10.0,32.0,0.35,0.0,0.35,0.35,0.35,1.07,0.01,1.09,1.07,1.09,Matches,Alan Virginius,M/AM RL,19,106,-8,France,LOSC Lille,7,11,13,11,12,7,7,10,6,5,12,8,5,14,10,11,10,11,12,12,12,12,13,6,12,6,11,11,14,13,6,7,13,14,12,6,12,7,12,7,12,1,2,2,2,1,3,1,3,2,1,1,18,11,10,11,11,13,13,10,1,1,1,1,1,1,1,15,1,17,17,1,20,10,175,65,8,20,35515547,5300,5300,2500,African_Caribbean,104,19,2003/1/3,0,0,2661.0,,49060048
581,Mattia Viti,Nice,2002,584.0,it ITA,DF,20.0,7.0,4.0,2.0,1.0,1.0,2.0,2.0,5.0,40.0,3.0,9.0,3.0,6.0,8.0,12.0,22.0,0.0,Matches,584.0,it ITA,DF,20.0,7.0,2.0,0.28,2.0,0.0,0.0,0.0,0.0,0.0,1.0,0.14,1.0,0.0,0.0,0.0,0.0,0.0,Matches,,,,,,,,,,,,,,,,,,,,,,,,,,,,,,,,,,,,,,,,,,,,,,,,,,,,,,,,584.0,it ITA,DF,20.0,7.0,0.0,0.0,0.0,3.0,5.0,0.0,0.0,8.0,2.0,0.0,0.0,0.0,27.0,13.0,7.0,65.0,Matches,584.0,it ITA,DF,20.0,7.0,360.0,345.0,15.0,12.0,0.0,1.0,0.0,3.0,0.0,0.0,0.0,0.0,303.0,0.0,4.0,Matches,584.0,it ITA,DF,20.0,7.0,303.0,360.0,84.2,5043.0,1569.0,140.0,155.0,90.3,133.0,144.0,92.4,22.0,43.0,51.2,0.0,0.0,0.0,0.0,0.0,14.0,0.0,0.0,19.0,Matches,691,it ITA,DF,20,9,634.0,70.0,18.5,7.0,7,86.0,6,2,17.0,18,1.33,7.0,11.0,-4.0,-0.57,-1.05,9.2,7.4,1.8,0.25,-0.1,Matches,584.0,it ITA,DF,20.0,7.0,424.0,57.0,222.0,189.0,15.0,2.0,424.0,12.0,5.0,41.7,5.0,41.7,320.0,1547.0,749.0,1.0,5.0,0.0,2.0,2.0,296.0,1.0,Matches,584.0,it ITA,DF,20.0,7.0,1.0,2.0,1.0,50.0,0.28,0.14,0.5,1.0,7.8,0.0,0.0,0.0,0.1,0.1,0.05,0.9,0.9,Matches,584.0,it ITA,DF,20.0,9.0,7.0,634.0,7.0,1.0,0.0,1.0,1.0,0.0,0.0,0.0,0.0,0.1,0.1,0.0,0.1,1.0,19.0,1.0,0.14,0.0,0.14,0.14,0.14,0.01,0.0,0.01,0.01,0.01,Matches,Mattia Viti,D C,20,125,-85,Italy,OGC Nice,6,7,10,6,11,6,14,6,8,13,13,6,14,11,11,14,13,10,13,11,13,14,9,10,7,13,14,14,12,12,13,14,15,13,14,13,14,8,10,9,8,3,2,1,2,3,1,1,3,3,1,2,15,13,5,13,15,15,8,19,1,1,20,1,1,1,1,1,1,1,1,1,1,1,190,74,20,9,64537802,6250,6250,4550,Mediterranean_Hispanic,125,2,2002/1/24,0,0,11750.0,,43426109
582,Vitinha,Marseille,2000,585.0,pt POR,FW,22.0,5.2,15.0,7.0,0.0,6.0,9.0,3.0,11.0,27.3,8.0,3.0,0.0,3.0,2.0,17.0,6.0,0.0,Matches,585.0,pt POR,FW,22.0,5.2,11.0,2.13,5.0,0.0,3.0,2.0,1.0,0.0,1.0,0.19,0.0,0.0,1.0,0.0,0.0,0.0,Matches,,,,,,,,,,,,,,,,,,,,,,,,,,,,,,,,,,,,,,,,,,,,,,,,,,,,,,,,585.0,pt POR,FW,22.0,5.2,0.0,0.0,0.0,7.0,8.0,4.0,1.0,2.0,7.0,0.0,0.0,0.0,27.0,5.0,13.0,27.8,Matches,585.0,pt POR,FW,22.0,5.2,109.0,96.0,11.0,1.0,1.0,0.0,1.0,0.0,0.0,0.0,0.0,0.0,77.0,2.0,4.0,Matches,585.0,pt POR,FW,22.0,5.2,77.0,109.0,70.6,1023.0,231.0,46.0,61.0,75.4,21.0,26.0,80.8,3.0,4.0,75.0,0.0,0.2,0.2,-0.2,3.0,7.0,2.0,0.0,9.0,Matches,692,pt POR,FW,22,14,464.0,33.0,13.6,5.2,5,61.0,1,9,17.0,3,1.43,7.0,8.0,-1.0,-0.19,-1.05,11.2,4.3,7.0,1.35,0.87,Matches,585.0,pt POR,FW,22.0,5.2,198.0,6.0,14.0,82.0,107.0,42.0,198.0,11.0,5.0,45.5,6.0,54.5,133.0,615.0,191.0,3.0,6.0,2.0,18.0,8.0,121.0,41.0,Matches,585.0,pt POR,FW,22.0,5.2,2.0,25.0,9.0,36.0,4.85,1.75,0.08,0.22,12.6,0.0,0.0,0.0,4.0,4.0,0.16,-2.0,-2.0,Matches,585.0,pt POR,FW,22.0,14.0,5.0,464.0,5.2,2.0,0.0,2.0,2.0,0.0,0.0,0.0,0.0,4.0,4.0,0.2,4.2,3.0,9.0,41.0,0.39,0.0,0.39,0.39,0.39,0.77,0.03,0.8,0.77,0.8,Matches,Vitinha,DM/M C,22,150,173,Portugal,Paris Saint-Germain,12,11,15,9,15,10,6,13,9,12,16,10,12,16,12,15,15,15,13,16,15,14,13,12,14,13,16,15,13,16,14,6,14,13,14,9,15,5,13,5,10,2,2,1,3,1,1,1,1,1,2,1,15,14,5,16,16,16,14,14,1,1,1,1,1,1,19,1,20,1,1,13,1,1,172,66,10,20,82354132,7600,7300,5550,Mediterranean_Hispanic,150,5,2000/2/13,3,0,91246.0,,83174762
583,Kevin Volland,Monaco,1992,587.0,de GER,FWMF,30.0,7.1,8.0,4.0,1.0,5.0,2.0,2.0,8.0,25.0,6.0,8.0,0.0,8.0,2.0,10.0,0.0,0.0,Matches,587.0,de GER,FWMF,30.0,7.1,18.0,2.54,16.0,1.0,0.0,0.0,1.0,0.0,4.0,0.56,3.0,0.0,0.0,0.0,1.0,0.0,Matches,,,,,,,,,,,,,,,,,,,,,,,,,,,,,,,,,,,,,,,,,,,,,,,,,,,,,,,,587.0,de GER,FWMF,30.0,7.1,1.0,0.0,0.0,20.0,13.0,7.0,8.0,2.0,4.0,1.0,0.0,0.0,27.0,11.0,14.0,44.0,Matches,587.0,de GER,FWMF,30.0,7.1,200.0,196.0,3.0,1.0,3.0,2.0,8.0,1.0,0.0,0.0,0.0,0.0,112.0,1.0,15.0,Matches,587.0,de GER,FWMF,30.0,7.1,112.0,200.0,56.0,1719.0,722.0,65.0,102.0,63.7,30.0,50.0,60.0,10.0,20.0,50.0,2.0,1.6,1.3,0.4,14.0,14.0,8.0,0.0,31.0,Matches,695,de GER,FWMF,30,17,639.0,38.0,18.7,7.1,7,66.0,0,10,18.0,5,1.59,12.0,12.0,0.0,0.0,-0.39,11.1,9.6,1.5,0.21,-0.03,Matches,587.0,de GER,FWMF,30.0,7.1,267.0,2.0,15.0,122.0,133.0,37.0,267.0,5.0,1.0,20.0,3.0,60.0,210.0,1030.0,270.0,6.0,6.0,5.0,19.0,7.0,213.0,60.0,Matches,587.0,de GER,FWMF,30.0,7.1,3.0,15.0,7.0,46.7,2.11,0.99,0.2,0.43,15.6,0.0,0.0,0.0,1.7,1.7,0.12,1.3,1.3,Matches,587.0,de GER,FWMF,30.0,17.0,7.0,639.0,7.1,3.0,2.0,5.0,3.0,0.0,0.0,1.0,0.0,1.7,1.7,1.6,3.3,6.0,31.0,60.0,0.42,0.28,0.7,0.42,0.7,0.25,0.23,0.47,0.25,0.47,Matches,Kevin Volland,AM/S RC,29,145,151,Germany,AS Monaco,8,10,14,12,12,12,11,13,8,7,14,13,10,12,18,14,15,13,12,14,12,17,15,11,17,7,16,18,13,12,18,9,17,13,18,14,13,8,13,3,15,2,3,3,1,2,2,1,1,4,3,1,9,13,6,14,12,17,12,10,1,1,1,1,1,1,1,12,1,15,12,17,16,20,179,85,20,11,44696821,7248,7248,5998,Northern_European,136,5,1992/7/30,14,1,92055.0,,91014650
584,Christopher Wooh,Lens,2001,592.0,cm CMR,MF,20.0,0.0,0.0,0.0,0.0,0.0,0.0,0.0,1.0,0.0,1.0,0.0,0.0,0.0,0.0,0.0,1.0,0.0,Matches,592.0,cm CMR,MF,20.0,0.0,0.0,0.0,0.0,0.0,0.0,0.0,0.0,0.0,0.0,0.0,0.0,0.0,0.0,0.0,0.0,0.0,Matches,,,,,,,,,,,,,,,,,,,,,,,,,,,,,,,,,,,,,,,,,,,,,,,,,,,,,,,,592.0,cm CMR,MF,20.0,0.0,0.0,0.0,0.0,0.0,0.0,0.0,0.0,0.0,0.0,0.0,0.0,0.0,0.0,0.0,0.0,,Matches,592.0,cm CMR,MF,20.0,0.0,2.0,2.0,0.0,0.0,0.0,0.0,0.0,0.0,0.0,0.0,0.0,0.0,2.0,0.0,0.0,Matches,592.0,cm CMR,MF,20.0,0.0,2.0,2.0,100.0,38.0,7.0,1.0,1.0,100.0,1.0,1.0,100.0,0.0,0.0,,0.0,0.0,0.0,0.0,0.0,0.0,0.0,0.0,0.0,Matches,701,cm CMR,MF,20,1,4.0,4.0,0.1,0.0,0,,0,1,4.0,4,3.0,0.0,0.0,0.0,0.0,-1.03,0.0,0.1,-0.1,-1.75,-2.36,Matches,592.0,cm CMR,MF,20.0,0.0,3.0,0.0,1.0,2.0,0.0,0.0,3.0,0.0,0.0,,0.0,,2.0,4.0,2.0,0.0,0.0,0.0,0.0,0.0,2.0,0.0,Matches,592.0,cm CMR,MF,20.0,0.0,0.0,0.0,0.0,,0.0,0.0,,,,0.0,0.0,0.0,0.0,0.0,,0.0,0.0,Matches,592.0,cm CMR,MF,20.0,1.0,0.0,4.0,0.0,0.0,0.0,0.0,0.0,0.0,0.0,0.0,0.0,0.0,0.0,0.0,0.0,0.0,0.0,0.0,0.0,0.0,0.0,0.0,0.0,0.0,0.0,0.0,0.0,0.0,Matches,Christopher Wooh,D C,20,110,135,"Cameroon,France",Stade Rennais FC,6,5,11,7,10,2,13,11,9,12,11,9,13,11,13,12,11,12,12,11,11,4,8,8,10,12,12,13,11,12,12,15,13,13,12,13,12,11,11,8,19,3,1,1,1,3,2,1,3,1,2,2,15,14,8,12,13,9,11,20,1,13,20,1,1,1,1,1,1,1,1,1,1,1,191,90,5,20,9924521,5500,5500,2500,African_Caribbean,108,16,2001/9/18,1,0,3722.0,,49048590
585,Xeka,Rennes,1994,593.0,pt POR,MF,27.0,6.1,10.0,3.0,6.0,3.0,1.0,7.0,16.0,43.8,9.0,11.0,2.0,9.0,6.0,16.0,8.0,0.0,Matches,593.0,pt POR,MF,27.0,6.1,8.0,1.31,6.0,1.0,0.0,0.0,1.0,0.0,1.0,0.16,0.0,0.0,0.0,0.0,1.0,0.0,Matches,,,,,,,,,,,,,,,,,,,,,,,,,,,,,,,,,,,,,,,,,,,,,,,,,,,,,,,,593.0,pt POR,MF,27.0,6.1,1.0,0.0,0.0,13.0,11.0,0.0,0.0,6.0,3.0,0.0,0.0,0.0,38.0,8.0,15.0,34.8,Matches,593.0,pt POR,MF,27.0,6.1,312.0,296.0,14.0,14.0,1.0,6.0,0.0,0.0,0.0,0.0,0.0,0.0,279.0,2.0,5.0,Matches,593.0,pt POR,MF,27.0,6.1,279.0,312.0,89.4,5221.0,1409.0,116.0,124.0,93.5,118.0,130.0,90.8,35.0,40.0,87.5,0.0,0.0,0.2,0.0,0.0,32.0,2.0,0.0,39.0,Matches,702,pt POR,MF,27,8,552.0,69.0,16.1,6.1,6,85.0,4,2,23.0,0,2.38,11.0,6.0,5.0,0.82,0.03,9.2,6.8,2.3,0.38,-0.09,Matches,593.0,pt POR,MF,27.0,6.1,380.0,12.0,74.0,248.0,61.0,6.0,380.0,6.0,1.0,16.7,3.0,50.0,276.0,1285.0,559.0,5.0,8.0,0.0,13.0,3.0,242.0,13.0,Matches,593.0,pt POR,MF,27.0,6.1,0.0,5.0,0.0,0.0,0.82,0.0,0.0,,22.8,0.0,0.0,0.0,0.1,0.1,0.02,-0.1,-0.1,Matches,593.0,pt POR,MF,27.0,8.0,6.0,552.0,6.1,0.0,0.0,0.0,0.0,0.0,0.0,1.0,0.0,0.1,0.1,0.0,0.1,5.0,39.0,13.0,0.0,0.0,0.0,0.0,0.0,0.02,0.0,0.02,0.02,0.02,Matches,Xeka,DM/M C,27,131,140,Portugal,Stade Rennais FC,12,11,13,8,15,9,10,11,6,9,15,8,11,14,12,12,10,14,14,15,13,15,14,8,13,14,15,14,11,12,14,12,12,11,14,12,14,7,14,8,14,2,2,2,1,3,2,2,1,2,1,1,11,14,10,13,13,15,12,14,1,1,1,1,1,1,17,1,20,1,10,5,7,1,186,79,12,20,6172072,6550,6500,4750,Mediterranean_Hispanic,131,1,1994/11/10,0,0,18429.0,,55068415
586,Yusuf Yazıcı,Lille,1997,594.0,tr TUR,MF,25.0,2.2,0.0,0.0,0.0,0.0,0.0,0.0,0.0,,0.0,2.0,0.0,2.0,0.0,0.0,1.0,0.0,Matches,594.0,tr TUR,MF,25.0,2.2,11.0,4.95,10.0,1.0,0.0,0.0,0.0,0.0,1.0,0.45,1.0,0.0,0.0,0.0,0.0,0.0,Matches,,,,,,,,,,,,,,,,,,,,,,,,,,,,,,,,,,,,,,,,,,,,,,,,,,,,,,,,594.0,tr TUR,MF,25.0,2.2,0.0,0.0,0.0,4.0,1.0,0.0,9.0,0.0,0.0,0.0,0.0,0.0,5.0,0.0,0.0,,Matches,594.0,tr TUR,MF,25.0,2.2,96.0,88.0,8.0,3.0,0.0,1.0,9.0,0.0,4.0,2.0,2.0,0.0,73.0,0.0,2.0,Matches,594.0,tr TUR,MF,25.0,2.2,73.0,96.0,76.0,1236.0,449.0,41.0,47.0,87.2,23.0,31.0,74.2,8.0,15.0,53.3,1.0,0.6,0.2,0.4,8.0,9.0,6.0,1.0,17.0,Matches,703,tr TUR,MF,25,4,200.0,50.0,5.8,2.2,3,64.0,0,1,7.0,1,1.5,5.0,7.0,-2.0,-0.9,-1.54,3.1,5.5,-2.3,-1.06,-1.91,Matches,594.0,tr TUR,MF,25.0,2.2,116.0,1.0,15.0,48.0,54.0,6.0,116.0,6.0,1.0,16.7,5.0,83.3,95.0,570.0,230.0,5.0,6.0,0.0,2.0,2.0,90.0,18.0,Matches,594.0,tr TUR,MF,25.0,2.2,1.0,5.0,2.0,40.0,2.25,0.9,0.2,0.5,19.0,0.0,0.0,0.0,0.2,0.2,0.03,0.8,0.8,Matches,594.0,tr TUR,MF,25.0,4.0,3.0,200.0,2.2,1.0,1.0,2.0,1.0,0.0,0.0,0.0,0.0,0.2,0.2,0.6,0.7,5.0,17.0,18.0,0.45,0.45,0.9,0.45,0.9,0.07,0.26,0.34,0.07,0.34,Matches,Yusuf Yazıcı,M/AM RC,25,137,145,Turkey,LOSC Lille,15,15,16,14,16,14,11,14,7,7,16,13,10,16,15,13,11,15,14,15,13,12,16,16,13,8,13,13,12,14,10,13,13,13,11,12,12,14,14,10,15,1,1,3,2,3,3,4,1,2,2,1,13,15,2,16,14,15,8,10,1,1,1,1,1,1,5,10,18,14,12,20,15,13,183,74,20,8,12931966,6900,6900,5250,Mediterranean_Hispanic,138,1,1997/1/29,39,2,23014.0,Trabzonspor A.Ş.,70103149
587,Leny Yoro,Lille,2005,596.0,fr FRA,DF,16.0,8.5,11.0,5.0,8.0,3.0,0.0,4.0,9.0,44.4,5.0,6.0,1.0,5.0,18.0,29.0,27.0,1.0,Matches,596.0,fr FRA,DF,16.0,8.5,5.0,0.59,4.0,0.0,0.0,1.0,0.0,0.0,0.0,0.0,0.0,0.0,0.0,0.0,0.0,0.0,Matches,,,,,,,,,,,,,,,,,,,,,,,,,,,,,,,,,,,,,,,,,,,,,,,,,,,,,,,,596.0,fr FRA,DF,16.0,8.5,0.0,0.0,0.0,5.0,5.0,0.0,0.0,18.0,5.0,0.0,0.0,0.0,41.0,12.0,8.0,60.0,Matches,596.0,fr FRA,DF,16.0,8.5,565.0,537.0,28.0,20.0,0.0,1.0,0.0,0.0,0.0,0.0,0.0,0.0,514.0,0.0,1.0,Matches,596.0,fr FRA,DF,16.0,8.5,514.0,565.0,91.0,9564.0,2895.0,177.0,186.0,95.2,271.0,287.0,94.4,55.0,79.0,69.6,0.0,0.0,0.1,0.0,1.0,11.0,0.0,0.0,15.0,Matches,705,fr FRA,DF,16,13,769.0,59.0,22.5,8.5,8,85.0,6,5,18.0,19,2.23,21.0,12.0,9.0,1.05,0.65,16.8,10.4,6.4,0.75,0.0,Matches,596.0,fr FRA,DF,16.0,8.5,641.0,51.0,293.0,348.0,4.0,3.0,641.0,3.0,3.0,100.0,0.0,0.0,498.0,2516.0,1198.0,0.0,1.0,0.0,5.0,1.0,460.0,1.0,Matches,596.0,fr FRA,DF,16.0,8.5,0.0,2.0,0.0,0.0,0.23,0.0,0.0,,15.9,0.0,0.0,0.0,0.1,0.1,0.05,-0.1,-0.1,Matches,596.0,fr FRA,DF,16.0,13.0,8.0,769.0,8.5,0.0,0.0,0.0,0.0,0.0,0.0,0.0,0.0,0.1,0.1,0.0,0.1,0.0,15.0,1.0,0.0,0.0,0.0,0.0,0.0,0.01,0.0,0.02,0.01,0.02,Matches,Leny Yoro,D C,16,86,-8,France,LOSC Lille,4,3,7,7,8,2,15,5,1,14,8,1,14,7,8,11,6,8,8,7,14,14,7,6,4,14,7,8,14,11,8,15,15,11,6,5,12,11,2,14,12,1,3,3,3,3,3,2,2,3,3,2,19,11,7,12,9,12,12,16,1,1,20,1,1,1,10,1,1,1,1,1,1,1,190,0,3,20,11850000,4299,4299,1053,African_Caribbean,86,13,2005/11/13,0,0,645.0,,2000182819
588,Oliver Zandén,Toulouse,2001,599.0,se SWE,DFMF,20.0,1.6,2.0,1.0,1.0,0.0,1.0,2.0,5.0,40.0,3.0,0.0,0.0,0.0,1.0,3.0,7.0,0.0,Matches,599.0,se SWE,DFMF,20.0,1.6,4.0,2.47,4.0,0.0,0.0,0.0,0.0,0.0,0.0,0.0,0.0,0.0,0.0,0.0,0.0,0.0,Matches,,,,,,,,,,,,,,,,,,,,,,,,,,,,,,,,,,,,,,,,,,,,,,,,,,,,,,,,599.0,se SWE,DFMF,20.0,1.6,0.0,0.0,0.0,3.0,6.0,0.0,6.0,1.0,1.0,0.0,0.0,0.0,8.0,1.0,2.0,33.3,Matches,599.0,se SWE,DFMF,20.0,1.6,71.0,58.0,13.0,2.0,0.0,0.0,6.0,11.0,0.0,0.0,0.0,0.0,47.0,0.0,3.0,Matches,599.0,se SWE,DFMF,20.0,1.6,47.0,71.0,66.2,768.0,319.0,22.0,31.0,71.0,20.0,31.0,64.5,3.0,6.0,50.0,0.0,0.1,0.1,-0.1,2.0,6.0,2.0,1.0,6.0,Matches,708,se SWE,DFMF,20,5,146.0,29.0,4.3,1.6,1,62.0,0,4,21.0,8,1.2,0.0,5.0,-5.0,-3.08,-3.05,1.3,3.7,-2.3,-1.44,-1.39,Matches,599.0,se SWE,DFMF,20.0,1.6,89.0,8.0,25.0,31.0,33.0,3.0,89.0,6.0,3.0,50.0,2.0,33.3,51.0,251.0,121.0,4.0,0.0,0.0,3.0,0.0,45.0,12.0,Matches,599.0,se SWE,DFMF,20.0,1.6,0.0,2.0,1.0,50.0,1.23,0.62,0.0,0.0,17.6,0.0,0.0,0.0,0.0,0.0,0.01,0.0,0.0,Matches,599.0,se SWE,DFMF,20.0,5.0,1.0,146.0,1.6,0.0,0.0,0.0,0.0,0.0,0.0,0.0,0.0,0.0,0.0,0.1,0.1,4.0,6.0,12.0,0.0,0.0,0.0,0.0,0.0,0.02,0.06,0.08,0.02,0.08,Matches,Oliver Zandén,D/WB L,20,113,138,Sweden,Toulouse FC,9,12,11,8,12,9,9,11,10,12,12,8,13,12,10,13,11,12,12,12,12,14,8,6,13,13,12,12,13,11,10,10,12,13,13,10,13,6,10,5,9,2,2,3,1,1,2,3,2,1,3,2,13,13,2,14,14,14,18,18,1,20,1,1,19,1,1,12,1,1,8,1,1,1,183,75,20,9,2460799,5650,5650,2018,Northern_European,111,4,2001/8/14,0,0,4198.0,,93104384
589,Akim Zedadka,Lille,1995,601.0,dz ALG,DFMF,27.0,3.9,1.0,1.0,1.0,0.0,0.0,0.0,2.0,0.0,2.0,3.0,0.0,3.0,2.0,3.0,6.0,0.0,Matches,601.0,dz ALG,DFMF,27.0,3.9,7.0,1.77,6.0,0.0,0.0,0.0,1.0,0.0,0.0,0.0,0.0,0.0,0.0,0.0,0.0,0.0,Matches,,,,,,,,,,,,,,,,,,,,,,,,,,,,,,,,,,,,,,,,,,,,,,,,,,,,,,,,601.0,dz ALG,DFMF,27.0,3.9,1.0,0.0,0.0,5.0,8.0,1.0,7.0,2.0,1.0,0.0,0.0,0.0,24.0,5.0,5.0,50.0,Matches,601.0,dz ALG,DFMF,27.0,3.9,222.0,194.0,28.0,4.0,0.0,2.0,7.0,24.0,0.0,0.0,0.0,0.0,185.0,0.0,4.0,Matches,601.0,dz ALG,DFMF,27.0,3.9,185.0,222.0,83.3,3038.0,815.0,79.0,89.0,88.8,85.0,97.0,87.6,10.0,21.0,47.6,0.0,0.5,0.8,-0.5,5.0,8.0,7.0,1.0,15.0,Matches,710,dz ALG,DFMF,27,8,354.0,44.0,10.4,3.9,4,78.0,2,4,11.0,7,1.63,9.0,6.0,3.0,0.76,0.23,9.1,5.8,3.3,0.83,0.1,Matches,601.0,dz ALG,DFMF,27.0,3.9,252.0,10.0,71.0,115.0,69.0,7.0,252.0,8.0,3.0,37.5,4.0,50.0,188.0,958.0,519.0,6.0,8.0,1.0,4.0,3.0,173.0,18.0,Matches,601.0,dz ALG,DFMF,27.0,3.9,1.0,3.0,1.0,33.3,0.76,0.25,0.33,1.0,15.3,0.0,0.0,0.0,0.4,0.4,0.13,0.6,0.6,Matches,601.0,dz ALG,DFMF,27.0,8.0,4.0,354.0,3.9,1.0,0.0,1.0,1.0,0.0,0.0,1.0,0.0,0.4,0.4,0.5,0.9,6.0,15.0,18.0,0.25,0.0,0.25,0.25,0.25,0.1,0.13,0.22,0.1,0.22,Matches,Akim Zedadka,D/WB/M RL,27,125,129,"France,Algeria",LOSC Lille,11,14,13,8,13,10,10,11,10,13,12,11,9,13,8,11,11,12,11,12,12,8,12,6,12,12,11,13,13,13,12,8,13,14,14,13,13,10,11,8,13,3,1,1,2,1,3,1,1,4,2,3,11,12,10,11,9,11,12,12,1,17,1,20,1,18,1,1,1,17,1,1,14,1,173,72,8,20,2856825,6242,6242,3742,North_African__Middle_Eastern,116,7,1995/5/30,0,0,11832.0,,49030855
590,Nathan Zeze,Nantes,2005,604.0,fr FRA,DF,17.0,0.7,3.0,2.0,2.0,1.0,0.0,1.0,1.0,100.0,0.0,0.0,0.0,0.0,0.0,3.0,1.0,0.0,Matches,604.0,fr FRA,DF,17.0,0.7,0.0,0.0,0.0,0.0,0.0,0.0,0.0,0.0,0.0,0.0,0.0,0.0,0.0,0.0,0.0,0.0,Matches,,,,,,,,,,,,,,,,,,,,,,,,,,,,,,,,,,,,,,,,,,,,,,,,,,,,,,,,604.0,fr FRA,DF,17.0,0.7,0.0,0.0,0.0,0.0,1.0,0.0,0.0,0.0,2.0,0.0,0.0,0.0,2.0,1.0,1.0,50.0,Matches,604.0,fr FRA,DF,17.0,0.7,26.0,25.0,1.0,1.0,0.0,0.0,0.0,0.0,0.0,0.0,0.0,0.0,18.0,0.0,0.0,Matches,604.0,fr FRA,DF,17.0,0.7,18.0,26.0,69.2,325.0,104.0,4.0,5.0,80.0,12.0,17.0,70.6,1.0,2.0,50.0,0.0,0.0,0.0,0.0,0.0,1.0,0.0,0.0,0.0,Matches,713,fr FRA,DF,17,1,59.0,59.0,1.7,0.7,1,59.0,0,0,,2,3.0,1.0,0.0,1.0,1.53,2.03,0.1,0.8,-0.7,-1.08,-0.84,Matches,604.0,fr FRA,DF,17.0,0.7,30.0,1.0,15.0,15.0,0.0,0.0,30.0,0.0,0.0,,0.0,,20.0,103.0,49.0,0.0,0.0,0.0,0.0,0.0,18.0,0.0,Matches,604.0,fr FRA,DF,17.0,0.7,0.0,0.0,0.0,,0.0,0.0,,,,0.0,0.0,0.0,0.0,0.0,,0.0,0.0,Matches,604.0,fr FRA,DF,17.0,1.0,1.0,59.0,0.7,0.0,0.0,0.0,0.0,0.0,0.0,0.0,0.0,0.0,0.0,0.0,0.0,0.0,0.0,0.0,0.0,0.0,0.0,0.0,0.0,0.0,0.0,0.0,0.0,0.0,Matches,Nathan Zeze,D C,17,85,-8,France,FC Nantes,6,6,10,7,11,6,14,7,4,11,10,7,11,10,6,13,11,10,11,11,10,13,8,9,7,12,8,8,8,10,10,14,10,8,11,10,10,5,11,4,6,2,2,1,1,3,4,1,1,1,1,2,12,12,6,14,10,13,12,16,1,1,20,1,1,1,1,1,1,1,1,1,1,1,190,0,20,6,14320000,4250,4250,1250,Northern_European,83,12,2005/6/18,0,0,645.0,,2000116383
591,Oliver Abildgaard,Hellas Verona,1996,2.0,dk DEN,MF,26.0,6.6,10.0,6.0,6.0,3.0,1.0,7.0,16.0,43.8,9.0,7.0,1.0,6.0,5.0,15.0,17.0,0.0,Matches,2.0,dk DEN,MF,26.0,6.6,9.0,1.37,8.0,0.0,0.0,1.0,0.0,0.0,0.0,0.0,0.0,0.0,0.0,0.0,0.0,0.0,Matches,,,,,,,,,,,,,,,,,,,,,,,,,,,,,,,,,,,,,,,,,,,,,,,,,,,,,,,,2.0,dk DEN,MF,26.0,6.6,2.0,0.0,0.0,13.0,7.0,0.0,5.0,5.0,6.0,0.0,0.0,0.0,37.0,50.0,21.0,70.4,Matches,2.0,dk DEN,MF,26.0,6.6,195.0,194.0,0.0,0.0,0.0,1.0,5.0,0.0,0.0,0.0,0.0,0.0,115.0,1.0,2.0,Matches,2.0,dk DEN,MF,26.0,6.6,115.0,195.0,59.0,1943.0,930.0,58.0,85.0,68.2,41.0,71.0,57.7,13.0,27.0,48.1,0.0,0.4,0.3,-0.4,6.0,17.0,3.0,2.0,15.0,Matches,2,dk DEN,MF,26,13,592.0,46.0,17.3,6.6,6,80.0,5,7,16.0,5,1.08,2.0,11.0,-9.0,-1.37,-0.76,4.9,9.3,-4.4,-0.67,-0.36,Matches,2.0,dk DEN,MF,26.0,6.6,257.0,15.0,82.0,137.0,40.0,13.0,257.0,1.0,1.0,100.0,0.0,0.0,99.0,401.0,156.0,2.0,3.0,0.0,6.0,1.0,116.0,8.0,Matches,2.0,dk DEN,MF,26.0,6.6,0.0,3.0,2.0,66.7,0.46,0.3,0.0,0.0,14.0,0.0,0.0,0.0,0.1,0.1,0.05,-0.1,-0.1,Matches,2.0,dk DEN,MF,26.0,13.0,6.0,592.0,6.6,0.0,0.0,0.0,0.0,0.0,0.0,2.0,0.0,0.1,0.1,0.4,0.6,2.0,15.0,8.0,0.0,0.0,0.0,0.0,0.0,0.02,0.07,0.09,0.02,0.09,Matches,Oliver Abildgaard,DM/M C,26,123,129,Denmark,Rubin Kazan,7,8,10,9,10,10,13,12,9,12,11,12,14,10,15,12,15,11,14,11,13,17,6,11,11,13,14,16,11,10,14,16,15,13,17,15,15,10,14,5,14,1,3,3,1,3,3,1,3,1,2,3,10,12,5,13,11,12,12,10,1,10,10,1,11,1,20,12,17,10,9,10,8,1,193,82,20,8,4699152,6000,6000,3250,Northern_European,122,4,1996/6/10,1,0,18000.0,Celtic,27093157
592,Yacine Adli,Milan,2000,6.0,fr FRA,MFFW,22.0,1.6,6.0,3.0,2.0,4.0,0.0,2.0,2.0,100.0,0.0,2.0,0.0,2.0,1.0,7.0,1.0,0.0,Matches,6.0,fr FRA,MFFW,22.0,1.6,3.0,1.87,2.0,1.0,0.0,0.0,0.0,0.0,1.0,0.62,1.0,0.0,0.0,0.0,0.0,0.0,Matches,,,,,,,,,,,,,,,,,,,,,,,,,,,,,,,,,,,,,,,,,,,,,,,,,,,,,,,,6.0,fr FRA,MFFW,22.0,1.6,1.0,0.0,0.0,4.0,1.0,1.0,6.0,1.0,3.0,0.0,0.0,0.0,8.0,1.0,3.0,25.0,Matches,6.0,fr FRA,MFFW,22.0,1.6,76.0,72.0,4.0,1.0,0.0,1.0,6.0,1.0,2.0,0.0,2.0,0.0,49.0,0.0,5.0,Matches,6.0,fr FRA,MFFW,22.0,1.6,49.0,76.0,64.5,931.0,308.0,21.0,28.0,75.0,17.0,24.0,70.8,9.0,16.0,56.3,0.0,0.3,0.2,-0.3,2.0,6.0,2.0,0.0,10.0,Matches,7,fr FRA,MFFW,22,6,144.0,24.0,4.2,1.6,1,59.0,0,5,17.0,32,1.17,2.0,4.0,-2.0,-1.25,-1.88,2.4,2.9,-0.5,-0.33,-0.83,Matches,6.0,fr FRA,MFFW,22.0,1.6,97.0,1.0,14.0,45.0,42.0,2.0,97.0,6.0,4.0,66.7,2.0,33.3,55.0,349.0,171.0,7.0,5.0,0.0,3.0,5.0,67.0,8.0,Matches,6.0,fr FRA,MFFW,22.0,1.6,0.0,2.0,2.0,100.0,1.25,1.25,0.0,0.0,18.5,0.0,0.0,0.0,0.1,0.1,0.04,-0.1,-0.1,Matches,6.0,fr FRA,MFFW,22.0,6.0,1.0,144.0,1.6,0.0,0.0,0.0,0.0,0.0,0.0,1.0,0.0,0.1,0.1,0.3,0.3,7.0,10.0,8.0,0.0,0.0,0.0,0.0,0.0,0.05,0.16,0.22,0.05,0.22,Matches,Yacine Adli,M/AM C,21,132,155,"France,Algeria",AC Milan,12,13,15,11,16,14,8,13,4,6,15,10,11,15,9,12,12,14,12,14,13,15,15,10,12,7,13,13,12,14,15,9,14,13,13,12,13,11,13,7,12,1,3,1,3,3,1,3,1,3,2,3,15,16,13,12,12,14,10,12,1,1,1,1,1,1,1,10,18,10,10,20,10,1,186,78,10,20,11675000,6600,6600,5250,North_African__Middle_Eastern,132,1,2000/7/29,0,0,19808.0,,48044568
593,Felix Afena-Gyan,Cremonese,2003,8.0,gh GHA,FWMF,19.0,9.1,7.0,3.0,4.0,1.0,2.0,2.0,10.0,20.0,8.0,5.0,1.0,4.0,1.0,8.0,6.0,0.0,Matches,8.0,gh GHA,FWMF,19.0,9.1,15.0,1.65,10.0,0.0,1.0,4.0,0.0,0.0,1.0,0.11,0.0,0.0,0.0,1.0,0.0,0.0,Matches,,,,,,,,,,,,,,,,,,,,,,,,,,,,,,,,,,,,,,,,,,,,,,,,,,,,,,,,8.0,gh GHA,FWMF,19.0,9.1,4.0,0.0,0.0,18.0,11.0,6.0,4.0,1.0,3.0,0.0,0.0,0.0,39.0,17.0,42.0,28.8,Matches,8.0,gh GHA,FWMF,19.0,9.1,193.0,185.0,8.0,2.0,0.0,1.0,4.0,5.0,0.0,0.0,0.0,0.0,146.0,0.0,4.0,Matches,8.0,gh GHA,FWMF,19.0,9.1,146.0,193.0,75.6,1855.0,194.0,99.0,115.0,86.1,34.0,46.0,73.9,4.0,7.0,57.1,0.0,0.1,0.2,-0.1,3.0,3.0,0.0,0.0,8.0,Matches,9,gh GHA,FWMF,19,23,817.0,36.0,23.9,9.1,7,63.0,1,16,24.0,11,0.78,9.0,13.0,-4.0,-0.44,0.56,8.1,12.9,-4.8,-0.52,0.26,Matches,8.0,gh GHA,FWMF,19.0,9.1,318.0,7.0,40.0,129.0,156.0,28.0,318.0,25.0,7.0,28.0,12.0,48.0,202.0,1160.0,463.0,22.0,13.0,3.0,34.0,21.0,217.0,54.0,Matches,8.0,gh GHA,FWMF,19.0,9.1,0.0,21.0,2.0,9.5,2.31,0.22,0.0,0.0,18.7,0.0,0.0,0.0,1.9,1.9,0.09,-1.9,-1.9,Matches,8.0,gh GHA,FWMF,19.0,23.0,7.0,817.0,9.1,0.0,0.0,0.0,0.0,0.0,0.0,4.0,0.0,1.9,1.9,0.1,2.0,22.0,8.0,54.0,0.0,0.0,0.0,0.0,0.0,0.21,0.02,0.22,0.21,0.22,Matches,Felix Afena-Gyan,AM/S L,19,122,-8,Ghana,Cremonese,5,8,10,13,10,6,9,10,4,5,8,10,7,8,17,10,16,14,9,7,8,11,12,5,14,5,11,17,18,16,12,8,12,18,13,9,10,15,12,5,11,3,2,3,2,3,3,1,1,3,2,3,15,14,7,11,12,12,5,10,1,1,1,1,1,1,1,1,1,1,17,1,12,20,175,75,8,20,31520000,6100,4014,1511,African_Caribbean,108,18,2003/1/19,6,1,1341.0,,2000096580
594,Ola Aina,Torino,1996,10.0,ng NGA,DF,25.0,9.7,17.0,13.0,5.0,8.0,4.0,9.0,15.0,60.0,6.0,12.0,2.0,10.0,11.0,28.0,26.0,0.0,Matches,10.0,ng NGA,DF,25.0,9.7,27.0,2.77,21.0,2.0,3.0,0.0,1.0,0.0,3.0,0.31,2.0,0.0,1.0,0.0,0.0,0.0,Matches,,,,,,,,,,,,,,,,,,,,,,,,,,,,,,,,,,,,,,,,,,,,,,,,,,,,,,,,10.0,ng NGA,DF,25.0,9.7,5.0,0.0,0.0,16.0,16.0,1.0,35.0,11.0,13.0,0.0,1.0,0.0,62.0,12.0,10.0,54.5,Matches,10.0,ng NGA,DF,25.0,9.7,544.0,432.0,108.0,8.0,0.0,3.0,35.0,97.0,3.0,0.0,0.0,0.0,402.0,4.0,17.0,Matches,10.0,ng NGA,DF,25.0,9.7,402.0,544.0,73.9,6725.0,2554.0,210.0,232.0,90.5,130.0,173.0,75.1,48.0,93.0,51.6,1.0,2.1,1.9,-1.1,12.0,35.0,14.0,9.0,43.0,Matches,13,ng NGA,DF,25,19,876.0,46.0,25.6,9.7,9,75.0,4,10,20.0,3,1.53,10.0,7.0,3.0,0.31,0.38,13.7,10.5,3.2,0.32,0.37,Matches,10.0,ng NGA,DF,25.0,9.7,679.0,20.0,146.0,294.0,250.0,13.0,679.0,49.0,23.0,46.9,20.0,40.8,361.0,2268.0,1112.0,35.0,26.0,4.0,15.0,8.0,390.0,43.0,Matches,10.0,ng NGA,DF,25.0,9.7,1.0,8.0,3.0,37.5,0.82,0.31,0.13,0.33,15.2,0.0,0.0,0.0,0.8,0.8,0.1,0.2,0.2,Matches,10.0,ng NGA,DF,25.0,19.0,9.0,876.0,9.7,1.0,1.0,2.0,1.0,0.0,0.0,5.0,0.0,0.8,0.8,2.1,2.9,35.0,43.0,43.0,0.1,0.1,0.21,0.1,0.21,0.08,0.21,0.29,0.08,0.29,Matches,Ola Aina,D/WB/M RL,25,132,139,"Nigeria,England",Torino,5,12,12,7,11,4,11,6,12,9,11,5,12,12,11,9,9,11,9,10,9,12,14,7,11,9,10,12,17,14,12,11,16,17,13,10,11,11,12,7,16,2,3,2,2,3,1,1,2,4,1,2,12,14,7,10,11,15,14,15,1,17,10,19,19,20,8,18,1,17,1,1,1,1,184,82,15,20,3882697,6600,6650,5500,African_Caribbean,115,17,1996/10/8,29,0,35577.0,,28090452
595,Bruno Amione,Hellas Verona,2002,16.0,ar ARG,DF,20.0,0.6,1.0,1.0,1.0,0.0,0.0,1.0,2.0,50.0,1.0,1.0,0.0,1.0,0.0,1.0,4.0,0.0,Matches,16.0,ar ARG,DF,20.0,0.6,0.0,0.0,0.0,0.0,0.0,0.0,0.0,0.0,0.0,0.0,0.0,0.0,0.0,0.0,0.0,0.0,Matches,,,,,,,,,,,,,,,,,,,,,,,,,,,,,,,,,,,,,,,,,,,,,,,,,,,,,,,,16.0,ar ARG,DF,20.0,0.6,1.0,0.0,0.0,3.0,0.0,0.0,0.0,0.0,1.0,0.0,0.0,0.0,5.0,1.0,0.0,100.0,Matches,16.0,ar ARG,DF,20.0,0.6,16.0,9.0,7.0,0.0,0.0,0.0,0.0,3.0,0.0,0.0,0.0,0.0,11.0,0.0,1.0,Matches,16.0,ar ARG,DF,20.0,0.6,11.0,16.0,68.8,167.0,40.0,6.0,6.0,100.0,5.0,7.0,71.4,0.0,2.0,0.0,0.0,0.0,0.0,0.0,0.0,0.0,0.0,0.0,0.0,Matches,23,ar ARG,DF,20,1,58.0,58.0,1.7,0.6,1,58.0,0,0,,3,0.0,2.0,3.0,-1.0,-1.55,-0.83,0.9,1.7,-0.8,-1.27,-0.91,Matches,16.0,ar ARG,DF,20.0,0.6,20.0,9.0,17.0,4.0,0.0,0.0,20.0,0.0,0.0,,0.0,,7.0,22.0,8.0,0.0,0.0,0.0,0.0,0.0,4.0,0.0,Matches,16.0,ar ARG,DF,20.0,0.6,0.0,0.0,0.0,,0.0,0.0,,,,0.0,0.0,0.0,0.0,0.0,,0.0,0.0,Matches,16.0,ar ARG,DF,20.0,1.0,1.0,58.0,0.6,0.0,0.0,0.0,0.0,0.0,0.0,1.0,0.0,0.0,0.0,0.0,0.0,0.0,0.0,0.0,0.0,0.0,0.0,0.0,0.0,0.0,0.0,0.0,0.0,0.0,Matches,Bruno Amione,D C,20,114,-75,Argentina,Hellas Verona,5,7,8,6,11,6,13,5,6,14,11,6,14,12,15,12,14,11,13,11,11,14,8,8,7,13,12,16,12,11,14,13,15,12,11,14,13,13,13,6,10,3,4,2,1,1,4,2,1,3,1,3,14,15,4,12,13,17,13,12,1,10,20,1,1,1,1,1,1,1,1,1,1,1,185,81,20,8,6825600,5700,5650,3400,Native_American,114,11,2002/1/3,0,0,3557.0,U.C. Sampdoria,14216968
596,Janis Antiste,Sassuolo,2002,21.0,fr FRA,FW,19.0,0.6,1.0,0.0,1.0,0.0,0.0,1.0,1.0,100.0,0.0,0.0,0.0,0.0,0.0,1.0,0.0,0.0,Matches,21.0,fr FRA,FW,19.0,0.6,0.0,0.0,0.0,0.0,0.0,0.0,0.0,0.0,0.0,0.0,0.0,0.0,0.0,0.0,0.0,0.0,Matches,,,,,,,,,,,,,,,,,,,,,,,,,,,,,,,,,,,,,,,,,,,,,,,,,,,,,,,,21.0,fr FRA,FW,19.0,0.6,0.0,0.0,0.0,4.0,0.0,0.0,0.0,0.0,0.0,0.0,0.0,0.0,4.0,2.0,1.0,66.7,Matches,21.0,fr FRA,FW,19.0,0.6,18.0,18.0,0.0,0.0,0.0,0.0,0.0,0.0,0.0,0.0,0.0,0.0,13.0,0.0,0.0,Matches,21.0,fr FRA,FW,19.0,0.6,13.0,18.0,72.2,159.0,43.0,8.0,11.0,72.7,4.0,5.0,80.0,0.0,1.0,0.0,0.0,0.0,0.0,0.0,0.0,0.0,0.0,0.0,1.0,Matches,31,fr FRA,FW,19,2,52.0,26.0,1.5,0.6,0,,0,2,26.0,13,1.5,2.0,1.0,1.0,1.73,2.13,1.0,1.0,0.0,-0.08,-0.13,Matches,21.0,fr FRA,FW,19.0,0.6,23.0,0.0,7.0,9.0,7.0,1.0,23.0,1.0,0.0,0.0,1.0,100.0,14.0,49.0,9.0,0.0,0.0,0.0,1.0,0.0,16.0,2.0,Matches,21.0,fr FRA,FW,19.0,0.6,1.0,1.0,1.0,100.0,1.73,1.73,1.0,1.0,17.3,0.0,0.0,0.0,0.2,0.2,0.18,0.8,0.8,Matches,21.0,fr FRA,FW,19.0,2.0,0.0,52.0,0.6,1.0,0.0,1.0,1.0,0.0,0.0,0.0,0.0,0.2,0.2,0.0,0.2,0.0,1.0,2.0,1.73,0.0,1.73,1.73,1.73,0.31,0.0,0.31,0.31,0.31,Matches,Janis Antiste,S RL,19,123,-75,"France,Martinique",Spezia Calcio,5,10,13,12,13,8,12,11,4,8,13,12,8,13,9,13,12,12,11,13,13,15,14,10,15,6,13,13,14,14,12,11,14,13,12,12,13,11,12,5,14,2,3,3,2,1,3,3,4,3,1,4,20,14,12,10,10,14,12,15,1,1,1,1,1,1,1,1,1,1,15,13,15,20,185,76,9,20,6000000,6150,5323,4017,African_Caribbean,121,11,2002/8/18,0,0,14621.0,U.S. Sassuolo,49048340
597,Valentin Antov,Monza,2000,23.0,bg BUL,DF,21.0,3.4,6.0,5.0,3.0,3.0,0.0,1.0,5.0,20.0,4.0,5.0,4.0,1.0,4.0,10.0,14.0,1.0,Matches,23.0,bg BUL,DF,21.0,3.4,2.0,0.59,2.0,0.0,0.0,0.0,0.0,0.0,1.0,0.29,1.0,0.0,0.0,0.0,0.0,0.0,Matches,,,,,,,,,,,,,,,,,,,,,,,,,,,,,,,,,,,,,,,,,,,,,,,,,,,,,,,,23.0,bg BUL,DF,21.0,3.4,2.0,0.0,0.0,4.0,2.0,0.0,2.0,4.0,5.0,0.0,0.0,0.0,24.0,6.0,11.0,35.3,Matches,23.0,bg BUL,DF,21.0,3.4,229.0,213.0,16.0,4.0,0.0,1.0,2.0,12.0,0.0,0.0,0.0,0.0,201.0,0.0,1.0,Matches,23.0,bg BUL,DF,21.0,3.4,201.0,229.0,87.8,3529.0,1518.0,85.0,93.0,91.4,90.0,98.0,91.8,19.0,30.0,63.3,0.0,0.0,0.1,0.0,1.0,12.0,2.0,0.0,14.0,Matches,33,bg BUL,DF,21,9,306.0,34.0,8.9,3.4,2,75.0,1,7,22.0,28,0.89,6.0,8.0,-2.0,-0.59,-0.53,3.7,4.0,-0.3,-0.1,0.05,Matches,23.0,bg BUL,DF,21.0,3.4,267.0,34.0,127.0,121.0,19.0,0.0,267.0,1.0,1.0,100.0,0.0,0.0,138.0,600.0,313.0,2.0,2.0,0.0,3.0,2.0,174.0,3.0,Matches,23.0,bg BUL,DF,21.0,3.4,0.0,0.0,0.0,,0.0,0.0,,,,0.0,0.0,0.0,0.0,0.0,,0.0,0.0,Matches,23.0,bg BUL,DF,21.0,9.0,2.0,306.0,3.4,0.0,0.0,0.0,0.0,0.0,0.0,2.0,0.0,0.0,0.0,0.0,0.0,2.0,14.0,3.0,0.0,0.0,0.0,0.0,0.0,0.0,0.01,0.01,0.0,0.01,Matches,Valentin Antov,D/DM C,21,112,148,Bulgaria,Brianza,6,7,9,8,9,7,12,7,10,12,11,9,14,11,14,12,14,11,12,11,12,15,6,14,9,12,18,14,10,10,11,15,14,11,12,12,14,9,14,8,15,3,2,1,3,2,3,2,3,1,3,2,19,15,1,14,18,18,16,18,1,1,20,8,1,1,18,1,11,1,1,1,1,3,188,75,10,20,3224000,5600,5800,4500,Northern_European,111,4,2000/11/9,11,0,14808.0,,22067326
598,Santiago Ascacíbar,Cremonese,1997,26.0,ar ARG,MF,25.0,8.1,29.0,14.0,17.0,10.0,2.0,14.0,35.0,40.0,21.0,14.0,2.0,12.0,13.0,42.0,11.0,0.0,Matches,26.0,ar ARG,MF,25.0,8.1,25.0,3.09,17.0,1.0,0.0,7.0,0.0,0.0,3.0,0.37,1.0,0.0,0.0,2.0,0.0,0.0,Matches,,,,,,,,,,,,,,,,,,,,,,,,,,,,,,,,,,,,,,,,,,,,,,,,,,,,,,,,26.0,ar ARG,MF,25.0,8.1,1.0,0.0,0.0,11.0,9.0,0.0,5.0,13.0,14.0,0.0,0.0,0.0,62.0,10.0,20.0,33.3,Matches,26.0,ar ARG,MF,25.0,8.1,435.0,412.0,21.0,11.0,0.0,4.0,5.0,5.0,5.0,0.0,3.0,0.0,358.0,2.0,9.0,Matches,26.0,ar ARG,MF,25.0,8.1,358.0,435.0,82.3,6100.0,2189.0,182.0,207.0,87.9,135.0,145.0,93.1,34.0,56.0,60.7,0.0,0.4,0.5,-0.4,8.0,50.0,7.0,2.0,41.0,Matches,36,ar ARG,MF,25,13,727.0,56.0,21.3,8.1,7,74.0,3,6,35.0,3,0.31,6.0,11.0,-5.0,-0.62,0.32,10.4,14.4,-4.0,-0.5,0.28,Matches,26.0,ar ARG,MF,25.0,8.1,553.0,26.0,177.0,280.0,100.0,4.0,553.0,9.0,4.0,44.4,4.0,44.4,254.0,976.0,442.0,1.0,3.0,0.0,8.0,4.0,314.0,6.0,Matches,26.0,ar ARG,MF,25.0,8.1,0.0,14.0,3.0,21.4,1.73,0.37,0.0,0.0,27.2,0.0,0.0,0.0,0.4,0.4,0.03,-0.4,-0.4,Matches,26.0,ar ARG,MF,25.0,13.0,7.0,727.0,8.1,0.0,0.0,0.0,0.0,0.0,0.0,1.0,0.0,0.4,0.4,0.4,0.8,1.0,41.0,6.0,0.0,0.0,0.0,0.0,0.0,0.05,0.05,0.1,0.05,0.1,Matches,Santiago Ascacíbar,DM/M C,25,128,136,"Argentina,Italy",Hertha Berlin,6,7,10,7,11,6,9,8,8,14,11,9,17,11,18,12,17,11,13,10,11,18,6,12,9,15,15,15,14,16,15,7,14,11,15,12,12,16,16,10,7,1,2,1,1,3,1,3,3,3,2,1,12,17,14,12,14,10,6,9,1,1,1,1,1,1,20,1,20,1,1,1,1,1,168,70,9,20,10438354,6800,7048,5498,Mediterranean_Hispanic,124,5,1997/2/25,3,0,47913.0,Cremonese,14124215
599,Kristoffer Askildsen,Lecce,2001,27.0,no NOR,MF,21.0,8.1,7.0,3.0,2.0,3.0,2.0,4.0,10.0,40.0,6.0,15.0,4.0,11.0,11.0,18.0,6.0,0.0,Matches,27.0,no NOR,MF,21.0,8.1,15.0,1.85,9.0,4.0,0.0,0.0,2.0,0.0,1.0,0.12,1.0,0.0,0.0,0.0,0.0,0.0,Matches,,,,,,,,,,,,,,,,,,,,,,,,,,,,,,,,,,,,,,,,,,,,,,,,,,,,,,,,27.0,no NOR,MF,21.0,8.1,3.0,0.0,0.0,20.0,7.0,1.0,19.0,11.0,3.0,0.0,1.0,0.0,45.0,21.0,19.0,52.5,Matches,27.0,no NOR,MF,21.0,8.1,269.0,234.0,34.0,11.0,0.0,8.0,19.0,5.0,15.0,7.0,6.0,0.0,165.0,1.0,8.0,Matches,27.0,no NOR,MF,21.0,8.1,165.0,269.0,61.3,2965.0,1017.0,80.0,117.0,68.4,52.0,80.0,65.0,24.0,48.0,50.0,0.0,0.3,0.4,-0.3,7.0,20.0,2.0,0.0,24.0,Matches,37,no NOR,MF,21,21,728.0,35.0,21.3,8.1,7,63.0,0,14,21.0,15,1.19,9.0,10.0,-1.0,-0.12,0.28,8.6,10.7,-2.1,-0.26,-0.12,Matches,27.0,no NOR,MF,21.0,8.1,351.0,17.0,68.0,190.0,97.0,8.0,351.0,6.0,3.0,50.0,1.0,16.7,131.0,665.0,336.0,10.0,2.0,2.0,13.0,3.0,176.0,17.0,Matches,27.0,no NOR,MF,21.0,8.1,0.0,10.0,3.0,30.0,1.24,0.37,0.0,0.0,24.0,1.0,0.0,0.0,0.5,0.5,0.05,-0.5,-0.5,Matches,27.0,no NOR,MF,21.0,21.0,7.0,728.0,8.1,0.0,0.0,0.0,0.0,0.0,0.0,3.0,0.0,0.5,0.5,0.3,0.9,10.0,24.0,17.0,0.0,0.0,0.0,0.0,0.0,0.06,0.04,0.11,0.06,0.11,Matches,Kristoffer Askildsen,DM/M C,21,122,144,Norway,U.C. Sampdoria,10,10,12,10,12,10,15,12,9,13,13,10,13,11,13,13,13,11,13,11,13,11,13,12,13,13,13,15,12,10,12,15,11,11,13,13,13,12,12,4,12,1,1,3,3,2,3,3,2,1,2,3,12,13,5,13,13,12,13,8,1,1,1,1,1,1,16,14,20,1,1,1,1,1,190,77,12,20,4659999,5749,6049,4949,Northern_European,122,0,2001/1/9,1,0,3557.0,Salento,53159473
600,Kristjan Asllani,Inter,2002,28.0,al ALB,MF,20.0,6.6,11.0,5.0,1.0,8.0,2.0,7.0,10.0,70.0,3.0,3.0,1.0,2.0,6.0,17.0,4.0,0.0,Matches,28.0,al ALB,MF,20.0,6.6,22.0,3.36,11.0,9.0,1.0,0.0,1.0,0.0,1.0,0.15,1.0,0.0,0.0,0.0,0.0,0.0,Matches,,,,,,,,,,,,,,,,,,,,,,,,,,,,,,,,,,,,,,,,,,,,,,,,,,,,,,,,28.0,al ALB,MF,20.0,6.6,2.0,0.0,0.0,5.0,7.0,0.0,21.0,6.0,5.0,0.0,0.0,0.0,37.0,0.0,4.0,0.0,Matches,28.0,al ALB,MF,20.0,6.6,457.0,426.0,30.0,13.0,1.0,5.0,21.0,1.0,16.0,5.0,9.0,0.0,402.0,1.0,4.0,Matches,28.0,al ALB,MF,20.0,6.6,402.0,457.0,88.0,7554.0,2029.0,188.0,192.0,97.9,148.0,161.0,91.9,61.0,93.0,65.6,0.0,0.9,1.0,-0.9,11.0,27.0,6.0,1.0,29.0,Matches,38,al ALB,MF,20,20,592.0,30.0,17.3,6.6,5,69.0,1,15,16.0,18,2.05,9.0,10.0,-1.0,-0.15,-1.11,10.7,7.8,2.9,0.44,-0.47,Matches,28.0,al ALB,MF,20.0,6.6,507.0,8.0,115.0,309.0,87.0,2.0,507.0,5.0,2.0,40.0,3.0,60.0,331.0,1588.0,634.0,6.0,9.0,1.0,3.0,2.0,389.0,6.0,Matches,28.0,al ALB,MF,20.0,6.6,0.0,11.0,0.0,0.0,1.67,0.0,0.0,,27.0,2.0,0.0,0.0,0.5,0.5,0.05,-0.5,-0.5,Matches,28.0,al ALB,MF,20.0,20.0,5.0,592.0,6.6,0.0,0.0,0.0,0.0,0.0,0.0,2.0,0.0,0.5,0.5,0.9,1.5,6.0,29.0,6.0,0.0,0.0,0.0,0.0,0.0,0.08,0.14,0.22,0.08,0.22,Matches,Kristjan Asllani,DM/M/AM C,20,132,159,"Albania,Italy",Empoli Football Club,12,11,11,10,15,13,7,13,5,9,15,13,10,13,10,14,12,14,12,13,12,14,10,10,14,14,14,12,13,12,13,9,13,12,16,10,13,8,14,6,11,3,1,1,2,3,2,1,3,3,3,4,15,15,8,12,13,15,12,12,1,1,1,1,1,1,19,1,20,1,1,16,1,1,175,68,10,20,36800002,6600,4419,5198,Mediterranean_Hispanic,129,2,2002/3/9,4,0,27299.0,FC Internazionale Milano,43424567
601,Kaan Ayhan,Sassuolo,1994,32.0,tr TUR,DF,27.0,6.1,10.0,4.0,6.0,4.0,0.0,7.0,7.0,100.0,0.0,5.0,4.0,1.0,5.0,15.0,26.0,1.0,Matches,32.0,tr TUR,DF,27.0,6.1,5.0,0.83,5.0,0.0,0.0,0.0,0.0,0.0,0.0,0.0,0.0,0.0,0.0,0.0,0.0,0.0,Matches,,,,,,,,,,,,,,,,,,,,,,,,,,,,,,,,,,,,,,,,,,,,,,,,,,,,,,,,32.0,tr TUR,DF,27.0,6.1,1.0,0.0,0.0,4.0,8.0,0.0,0.0,5.0,4.0,0.0,0.0,0.0,28.0,2.0,7.0,22.2,Matches,32.0,tr TUR,DF,27.0,6.1,332.0,311.0,20.0,15.0,0.0,7.0,0.0,2.0,0.0,0.0,0.0,0.0,288.0,1.0,2.0,Matches,32.0,tr TUR,DF,27.0,6.1,288.0,332.0,86.7,6000.0,1702.0,84.0,87.0,96.6,154.0,167.0,92.2,48.0,72.0,66.7,0.0,0.0,0.0,0.0,0.0,20.0,0.0,0.0,15.0,Matches,42,tr TUR,DF,27,10,545.0,55.0,15.9,6.1,5,90.0,5,5,19.0,8,1.4,6.0,11.0,-5.0,-0.83,-0.54,5.7,7.3,-1.6,-0.26,-0.37,Matches,32.0,tr TUR,DF,27.0,6.1,385.0,54.0,198.0,182.0,6.0,0.0,385.0,0.0,0.0,,0.0,,235.0,1168.0,744.0,8.0,5.0,0.0,0.0,1.0,264.0,0.0,Matches,32.0,tr TUR,DF,27.0,6.1,0.0,1.0,1.0,100.0,0.17,0.17,0.0,0.0,37.5,0.0,0.0,0.0,0.0,0.0,0.01,0.0,0.0,Matches,32.0,tr TUR,DF,27.0,10.0,5.0,545.0,6.1,0.0,0.0,0.0,0.0,0.0,0.0,1.0,0.0,0.0,0.0,0.0,0.0,8.0,15.0,0.0,0.0,0.0,0.0,0.0,0.0,0.0,0.0,0.0,0.0,0.0,Matches,Kaan Ayhan,D RC,27,125,134,"Turkey,Germany",U.S. Sassuolo,9,5,8,7,13,12,13,10,7,14,14,9,13,13,12,14,14,15,12,13,13,16,9,11,9,13,13,13,11,12,13,13,14,11,13,12,11,11,14,6,14,4,1,1,3,3,1,1,3,1,2,2,11,14,9,13,16,16,9,9,1,1,20,16,1,1,15,1,1,1,1,1,1,1,185,84,10,20,2743437,6250,6600,5300,Mediterranean_Hispanic,125,7,1994/11/10,49,5,14808.0,,91100534
602,Nedim Bajrami,Sassuolo,1999,35.0,al ALB,FWMF,23.0,9.1,12.0,7.0,6.0,2.0,4.0,5.0,11.0,45.5,6.0,9.0,1.0,8.0,7.0,19.0,6.0,0.0,Matches,35.0,al ALB,FWMF,23.0,9.1,34.0,3.74,21.0,6.0,4.0,2.0,0.0,1.0,2.0,0.22,1.0,0.0,0.0,1.0,0.0,0.0,Matches,,,,,,,,,,,,,,,,,,,,,,,,,,,,,,,,,,,,,,,,,,,,,,,,,,,,,,,,35.0,al ALB,FWMF,23.0,9.1,0.0,0.0,0.0,6.0,9.0,6.0,57.0,7.0,7.0,0.0,0.0,0.0,44.0,2.0,4.0,33.3,Matches,35.0,al ALB,FWMF,23.0,9.1,355.0,307.0,48.0,9.0,0.0,0.0,57.0,5.0,34.0,17.0,13.0,0.0,245.0,0.0,15.0,Matches,35.0,al ALB,FWMF,23.0,9.1,245.0,355.0,69.0,3599.0,922.0,150.0,174.0,86.2,73.0,100.0,73.0,16.0,52.0,30.8,0.0,1.5,1.6,-1.5,14.0,13.0,11.0,0.0,44.0,Matches,46,al ALB,FWMF,23,18,819.0,46.0,23.9,9.1,7,71.0,1,11,29.0,0,1.39,9.0,19.0,-10.0,-1.1,-0.96,11.7,11.9,-0.2,-0.02,-0.09,Matches,35.0,al ALB,FWMF,23.0,9.1,451.0,8.0,63.0,150.0,247.0,29.0,451.0,32.0,18.0,56.3,12.0,37.5,278.0,1652.0,739.0,23.0,16.0,12.0,20.0,9.0,295.0,96.0,Matches,35.0,al ALB,FWMF,23.0,9.1,1.0,23.0,8.0,34.8,2.53,0.88,0.04,0.13,20.7,4.0,0.0,0.0,1.9,1.9,0.08,-0.9,-0.9,Matches,35.0,al ALB,FWMF,23.0,18.0,7.0,819.0,9.1,1.0,0.0,1.0,1.0,0.0,0.0,0.0,0.0,1.9,1.9,1.5,3.4,23.0,44.0,96.0,0.11,0.0,0.11,0.11,0.11,0.21,0.16,0.37,0.21,0.37,Matches,Nedim Bajrami,M/AM C,23,134,151,"Albania,Switzerland,North Macedonia",Empoli Football Club,13,13,13,13,14,13,8,14,4,7,14,14,8,15,13,12,12,14,11,14,13,13,14,10,14,7,14,14,13,13,13,9,13,14,13,11,11,8,10,5,14,2,1,3,3,1,1,3,2,1,1,3,14,14,7,12,13,14,11,9,1,1,1,1,1,1,10,1,18,1,1,20,1,1,179,68,11,20,9878407,6696,6096,5346,Northern_European,134,4,1999/2/28,7,0,29614.0,,98038311
603,Fodé Ballo-Touré,Milan,1997,38.0,sn SEN,DF,25.0,5.8,14.0,9.0,7.0,6.0,1.0,7.0,10.0,70.0,3.0,11.0,3.0,8.0,2.0,16.0,3.0,0.0,Matches,38.0,sn SEN,DF,25.0,5.8,8.0,1.38,4.0,1.0,1.0,0.0,1.0,1.0,1.0,0.17,0.0,0.0,1.0,0.0,0.0,0.0,Matches,,,,,,,,,,,,,,,,,,,,,,,,,,,,,,,,,,,,,,,,,,,,,,,,,,,,,,,,38.0,sn SEN,DF,25.0,5.8,0.0,0.0,0.0,5.0,13.0,0.0,17.0,2.0,9.0,0.0,0.0,0.0,33.0,13.0,5.0,72.2,Matches,38.0,sn SEN,DF,25.0,5.8,281.0,219.0,62.0,6.0,0.0,1.0,17.0,56.0,0.0,0.0,0.0,0.0,234.0,0.0,2.0,Matches,38.0,sn SEN,DF,25.0,5.8,234.0,281.0,83.3,3827.0,1223.0,117.0,128.0,91.4,103.0,119.0,86.6,13.0,26.0,50.0,0.0,0.2,0.3,-0.2,4.0,13.0,8.0,5.0,25.0,Matches,50,sn SEN,DF,25,10,523.0,52.0,15.3,5.8,5,90.0,5,5,15.0,24,1.8,6.0,8.0,-2.0,-0.34,-1.06,8.4,7.6,0.9,0.15,-0.37,Matches,38.0,sn SEN,DF,25.0,5.8,352.0,7.0,77.0,168.0,110.0,9.0,352.0,15.0,5.0,33.3,9.0,60.0,152.0,762.0,427.0,11.0,7.0,0.0,6.0,6.0,188.0,31.0,Matches,38.0,sn SEN,DF,25.0,5.8,1.0,5.0,3.0,60.0,0.86,0.52,0.2,0.33,11.4,0.0,0.0,0.0,0.6,0.6,0.12,0.4,0.4,Matches,38.0,sn SEN,DF,25.0,10.0,5.0,523.0,5.8,1.0,0.0,1.0,1.0,0.0,0.0,0.0,0.0,0.6,0.6,0.2,0.9,11.0,25.0,31.0,0.17,0.0,0.17,0.17,0.17,0.11,0.04,0.15,0.11,0.15,Matches,Fodé Ballo-Touré,D/WB L,25,130,138,"Senegal,France,Mali",AC Milan,8,13,12,4,10,5,10,7,14,12,12,6,13,10,14,12,14,10,12,10,12,12,8,8,14,11,14,13,15,15,13,11,15,16,16,13,13,10,11,6,13,3,2,1,3,3,2,1,3,2,1,1,13,14,8,12,11,11,12,14,1,20,1,1,17,1,1,15,1,1,10,1,1,1,182,70,20,7,2177179,6500,6500,5250,African_Caribbean,125,16,1997/1/3,13,0,24615.0,,85140284
604,Antonín Barák,Hellas Verona,1994,41.0,cz CZE,MF,27.0,0.3,0.0,0.0,0.0,0.0,0.0,0.0,0.0,,0.0,0.0,0.0,0.0,0.0,0.0,0.0,0.0,Matches,41.0,cz CZE,MF,27.0,0.3,0.0,0.0,0.0,0.0,0.0,0.0,0.0,0.0,0.0,0.0,0.0,0.0,0.0,0.0,0.0,0.0,Matches,,,,,,,,,,,,,,,,,,,,,,,,,,,,,,,,,,,,,,,,,,,,,,,,,,,,,,,,41.0,cz CZE,MF,27.0,0.3,0.0,0.0,0.0,0.0,0.0,0.0,1.0,0.0,0.0,0.0,0.0,0.0,2.0,0.0,0.0,,Matches,41.0,cz CZE,MF,27.0,0.3,14.0,13.0,1.0,0.0,0.0,0.0,1.0,0.0,0.0,0.0,0.0,0.0,11.0,0.0,0.0,Matches,41.0,cz CZE,MF,27.0,0.3,11.0,14.0,78.6,140.0,24.0,7.0,10.0,70.0,3.0,3.0,100.0,0.0,0.0,,0.0,0.0,0.0,0.0,0.0,2.0,0.0,0.0,2.0,Matches,53,cz CZE,MF,27,1,25.0,25.0,0.7,0.3,0,,0,1,25.0,0,0.0,0.0,1.0,-1.0,-3.6,-2.88,0.1,0.6,-0.5,-1.77,-1.41,Matches,41.0,cz CZE,MF,27.0,0.3,16.0,0.0,0.0,10.0,6.0,0.0,16.0,2.0,1.0,50.0,1.0,50.0,12.0,68.0,25.0,0.0,0.0,0.0,1.0,1.0,11.0,1.0,Matches,41.0,cz CZE,MF,27.0,0.3,0.0,0.0,0.0,,0.0,0.0,,,,0.0,0.0,0.0,0.0,0.0,,0.0,0.0,Matches,41.0,cz CZE,MF,27.0,1.0,0.0,25.0,0.3,0.0,0.0,0.0,0.0,0.0,0.0,0.0,0.0,0.0,0.0,0.0,0.0,0.0,2.0,1.0,0.0,0.0,0.0,0.0,0.0,0.0,0.0,0.0,0.0,0.0,Matches,Antonín Barák,M/AM C,27,143,148,Czech Republic,Hellas Verona,10,11,14,15,15,12,14,13,4,8,15,10,12,14,11,17,13,14,12,13,14,13,14,13,17,9,16,14,11,12,15,14,14,12,15,16,14,11,14,12,11,2,2,3,1,2,2,2,2,2,3,3,13,14,5,15,10,14,12,15,1,1,1,1,1,1,12,10,19,10,8,20,8,10,190,86,20,11,9765282,7150,6500,5500,Northern_European,143,1,1994/12/3,31,8,17787.0,ACF Fiorentina,25040431
605,Andrea Barberis,Monza,1993,43.0,it ITA,MF,28.0,3.8,7.0,2.0,4.0,3.0,0.0,5.0,11.0,45.5,6.0,0.0,0.0,0.0,8.0,15.0,1.0,0.0,Matches,43.0,it ITA,MF,28.0,3.8,10.0,2.67,9.0,1.0,0.0,0.0,0.0,0.0,2.0,0.53,1.0,1.0,0.0,0.0,0.0,0.0,Matches,,,,,,,,,,,,,,,,,,,,,,,,,,,,,,,,,,,,,,,,,,,,,,,,,,,,,,,,43.0,it ITA,MF,28.0,3.8,0.0,0.0,0.0,1.0,2.0,0.0,4.0,8.0,2.0,0.0,0.0,0.0,16.0,2.0,2.0,50.0,Matches,43.0,it ITA,MF,28.0,3.8,166.0,157.0,9.0,6.0,0.0,0.0,4.0,1.0,2.0,0.0,2.0,0.0,140.0,0.0,2.0,Matches,43.0,it ITA,MF,28.0,3.8,140.0,166.0,84.3,2307.0,639.0,67.0,75.0,89.3,63.0,74.0,85.1,8.0,11.0,72.7,1.0,0.4,0.2,0.6,4.0,16.0,1.0,1.0,14.0,Matches,55,it ITA,MF,28,9,338.0,38.0,9.9,3.8,3,75.0,2,6,19.0,27,1.11,4.0,9.0,-5.0,-1.33,-1.36,4.6,6.0,-1.4,-0.37,-0.26,Matches,43.0,it ITA,MF,28.0,3.8,194.0,6.0,38.0,126.0,31.0,2.0,194.0,0.0,0.0,,0.0,,100.0,487.0,253.0,3.0,7.0,1.0,3.0,6.0,137.0,0.0,Matches,43.0,it ITA,MF,28.0,3.8,0.0,2.0,0.0,0.0,0.53,0.0,0.0,,26.7,0.0,0.0,0.0,0.1,0.1,0.05,-0.1,-0.1,Matches,43.0,it ITA,MF,28.0,9.0,3.0,338.0,3.8,0.0,1.0,1.0,0.0,0.0,0.0,0.0,0.0,0.1,0.1,0.4,0.5,3.0,14.0,0.0,0.0,0.27,0.27,0.0,0.27,0.03,0.1,0.12,0.03,0.12,Matches,Andrea Barberis,DM/M C,28,122,132,Italy,Brianza,13,12,13,12,12,14,12,13,6,11,12,11,11,12,12,13,11,13,13,12,12,18,13,12,10,13,13,12,13,12,13,9,16,12,14,13,13,8,14,6,10,4,2,2,2,3,2,3,2,3,1,2,7,15,6,15,12,15,15,10,1,1,1,1,1,1,20,1,19,1,1,1,1,1,177,72,10,20,1356544,6100,6200,5250,Mediterranean_Hispanic,122,2,1993/12/11,0,0,17115.0,,43078258
606,Toma Bašić,Lazio,1996,50.0,hr CRO,MF,25.0,5.7,6.0,4.0,4.0,1.0,1.0,3.0,8.0,37.5,5.0,9.0,0.0,9.0,7.0,13.0,8.0,0.0,Matches,50.0,hr CRO,MF,25.0,5.7,13.0,2.28,7.0,0.0,1.0,0.0,5.0,0.0,0.0,0.0,0.0,0.0,0.0,0.0,0.0,0.0,Matches,,,,,,,,,,,,,,,,,,,,,,,,,,,,,,,,,,,,,,,,,,,,,,,,,,,,,,,,50.0,hr CRO,MF,25.0,5.7,2.0,0.0,0.0,12.0,17.0,1.0,20.0,7.0,4.0,0.0,0.0,0.0,32.0,14.0,6.0,70.0,Matches,50.0,hr CRO,MF,25.0,5.7,293.0,273.0,20.0,6.0,2.0,0.0,20.0,0.0,7.0,3.0,4.0,0.0,214.0,0.0,13.0,Matches,50.0,hr CRO,MF,25.0,5.7,214.0,293.0,73.0,3132.0,612.0,101.0,123.0,82.1,94.0,111.0,84.7,6.0,28.0,21.4,0.0,0.4,0.4,-0.4,8.0,14.0,5.0,2.0,22.0,Matches,62,hr CRO,MF,25,25,513.0,21.0,15.0,5.7,4,51.0,0,21,15.0,13,2.0,5.0,6.0,-1.0,-0.18,-1.14,7.8,5.2,2.6,0.45,0.23,Matches,50.0,hr CRO,MF,25.0,5.7,367.0,12.0,75.0,179.0,115.0,17.0,367.0,8.0,3.0,37.5,4.0,50.0,222.0,1064.0,477.0,14.0,8.0,1.0,13.0,6.0,250.0,29.0,Matches,50.0,hr CRO,MF,25.0,5.7,1.0,11.0,5.0,45.5,1.93,0.88,0.09,0.2,19.6,0.0,0.0,0.0,1.8,1.8,0.17,-0.8,-0.8,Matches,50.0,hr CRO,MF,25.0,25.0,4.0,513.0,5.7,1.0,0.0,1.0,1.0,0.0,0.0,2.0,0.0,1.8,1.8,0.4,2.2,14.0,22.0,29.0,0.18,0.0,0.18,0.18,0.18,0.32,0.07,0.39,0.32,0.39,Matches,Toma Bašić,M/AM C,25,133,141,Croatia,S.S. Lazio,14,11,12,12,13,17,14,13,3,12,13,10,12,14,12,15,13,12,12,14,12,14,14,7,15,13,16,14,11,12,11,14,14,12,14,14,13,7,13,5,14,2,4,3,3,2,2,3,3,2,3,1,15,13,7,12,8,16,13,14,1,1,1,8,1,8,14,10,20,10,10,16,10,1,189,80,20,11,3296040,6650,6250,5500,Northern_European,133,4,1996/11/25,2,0,34423.0,,24047067
607,Raoul Bellanova,Inter,2000,57.0,it ITA,DF,22.0,5.5,14.0,6.0,11.0,2.0,1.0,9.0,14.0,64.3,5.0,6.0,1.0,5.0,4.0,18.0,14.0,0.0,Matches,57.0,it ITA,DF,22.0,5.5,7.0,1.27,3.0,2.0,0.0,1.0,1.0,0.0,0.0,0.0,0.0,0.0,0.0,0.0,0.0,0.0,Matches,,,,,,,,,,,,,,,,,,,,,,,,,,,,,,,,,,,,,,,,,,,,,,,,,,,,,,,,57.0,it ITA,DF,22.0,5.5,0.0,0.0,0.0,4.0,9.0,2.0,32.0,4.0,6.0,0.0,0.0,0.0,25.0,3.0,3.0,50.0,Matches,57.0,it ITA,DF,22.0,5.5,306.0,274.0,32.0,0.0,0.0,4.0,32.0,32.0,0.0,0.0,0.0,0.0,238.0,0.0,8.0,Matches,57.0,it ITA,DF,22.0,5.5,238.0,306.0,77.8,3914.0,953.0,120.0,135.0,88.9,82.0,110.0,74.5,23.0,39.0,59.0,0.0,0.4,0.4,-0.4,3.0,9.0,6.0,5.0,12.0,Matches,70,it ITA,DF,22,18,496.0,28.0,14.5,5.5,3,73.0,0,15,18.0,20,2.0,10.0,8.0,2.0,0.36,-0.47,7.1,6.9,0.3,0.05,-0.92,Matches,57.0,it ITA,DF,22.0,5.5,373.0,24.0,115.0,127.0,135.0,13.0,373.0,12.0,7.0,58.3,2.0,16.7,230.0,1762.0,908.0,25.0,12.0,3.0,4.0,5.0,246.0,37.0,Matches,57.0,it ITA,DF,22.0,5.5,0.0,4.0,1.0,25.0,0.73,0.18,0.0,0.0,8.1,0.0,0.0,0.0,0.6,0.6,0.16,-0.6,-0.6,Matches,57.0,it ITA,DF,22.0,18.0,3.0,496.0,5.5,0.0,0.0,0.0,0.0,0.0,0.0,0.0,0.0,0.6,0.6,0.4,1.0,25.0,12.0,37.0,0.0,0.0,0.0,0.0,0.0,0.12,0.07,0.19,0.12,0.19,Matches,Raoul Bellanova,D/WB/M R,22,130,155,Italy,Cagliari Calcio,6,14,14,8,13,5,11,6,8,12,12,5,10,12,11,13,14,12,13,11,11,16,10,8,11,12,10,12,16,13,12,12,15,16,14,12,13,7,12,6,13,1,3,3,1,3,4,4,2,3,3,3,14,16,4,12,12,15,15,14,1,12,10,20,12,19,1,10,1,17,1,1,1,1,186,78,8,20,21991200,6500,6250,5250,Mediterranean_Hispanic,121,4,2000/5/17,0,0,18249.0,FC Internazionale Milano,43295110
608,Marco Benassi,Fiorentina,1994,59.0,it ITA,DF,27.0,1.0,3.0,3.0,2.0,0.0,1.0,3.0,4.0,75.0,1.0,0.0,0.0,0.0,1.0,4.0,1.0,0.0,Matches,59.0,it ITA,DF,27.0,1.0,1.0,0.97,1.0,0.0,0.0,0.0,0.0,0.0,0.0,0.0,0.0,0.0,0.0,0.0,0.0,0.0,Matches,,,,,,,,,,,,,,,,,,,,,,,,,,,,,,,,,,,,,,,,,,,,,,,,,,,,,,,,59.0,it ITA,DF,27.0,1.0,0.0,0.0,0.0,1.0,1.0,0.0,7.0,1.0,3.0,0.0,0.0,0.0,10.0,3.0,2.0,60.0,Matches,59.0,it ITA,DF,27.0,1.0,105.0,94.0,11.0,5.0,0.0,4.0,7.0,6.0,0.0,0.0,0.0,0.0,91.0,0.0,1.0,Matches,59.0,it ITA,DF,27.0,1.0,91.0,105.0,86.7,2107.0,426.0,32.0,32.0,100.0,33.0,41.0,80.5,26.0,31.0,83.9,0.0,0.1,0.1,-0.1,1.0,11.0,1.0,0.0,9.0,Matches,72,it ITA,DF,27,2,93.0,47.0,2.7,1.0,1,70.0,0,1,23.0,2,1.5,2.0,2.0,0.0,0.0,-0.27,1.5,1.1,0.4,0.35,0.04,Matches,59.0,it ITA,DF,27.0,1.0,112.0,1.0,25.0,64.0,24.0,3.0,112.0,1.0,0.0,0.0,0.0,0.0,81.0,284.0,120.0,0.0,4.0,0.0,1.0,1.0,85.0,6.0,Matches,59.0,it ITA,DF,27.0,1.0,0.0,0.0,0.0,,0.0,0.0,,,,0.0,0.0,0.0,0.0,0.0,,0.0,0.0,Matches,59.0,it ITA,DF,27.0,2.0,1.0,93.0,1.0,0.0,0.0,0.0,0.0,0.0,0.0,0.0,0.0,0.0,0.0,0.1,0.1,0.0,9.0,6.0,0.0,0.0,0.0,0.0,0.0,0.0,0.09,0.09,0.0,0.09,Matches,Marco Benassi,M/AM C,27,120,135,Italy,ACF Fiorentina,10,12,11,10,12,9,12,14,8,9,12,11,12,13,13,13,14,12,13,11,12,14,11,13,16,11,16,14,12,12,13,11,11,12,12,11,13,9,13,13,13,2,1,1,3,1,1,1,3,2,1,2,13,13,7,14,12,15,15,13,1,1,1,11,1,10,12,7,20,11,1,16,10,1,183,80,11,20,829539,6000,6150,5250,Mediterranean_Hispanic,119,3,1994/9/8,0,0,39231.0,,43078262
609,Bartosz Bereszyński,Napoli,1992,64.0,pl POL,DF,30.0,1.8,3.0,2.0,1.0,1.0,1.0,2.0,2.0,100.0,0.0,4.0,0.0,4.0,3.0,6.0,3.0,0.0,Matches,64.0,pl POL,DF,30.0,1.8,2.0,1.09,2.0,0.0,0.0,0.0,0.0,0.0,1.0,0.55,1.0,0.0,0.0,0.0,0.0,0.0,Matches,,,,,,,,,,,,,,,,,,,,,,,,,,,,,,,,,,,,,,,,,,,,,,,,,,,,,,,,64.0,pl POL,DF,30.0,1.8,1.0,0.0,0.0,2.0,2.0,0.0,0.0,3.0,2.0,0.0,0.0,0.0,14.0,2.0,1.0,66.7,Matches,64.0,pl POL,DF,30.0,1.8,105.0,84.0,21.0,1.0,0.0,2.0,0.0,20.0,0.0,0.0,0.0,0.0,87.0,0.0,3.0,Matches,64.0,pl POL,DF,30.0,1.8,87.0,105.0,82.9,1252.0,420.0,54.0,59.0,91.5,26.0,33.0,78.8,4.0,5.0,80.0,1.0,0.2,0.1,0.8,2.0,5.0,3.0,0.0,7.0,Matches,79,pl POL,DF,30,3,166.0,55.0,4.9,1.8,2,76.0,1,1,15.0,18,1.33,3.0,4.0,-1.0,-0.54,-1.93,2.1,3.3,-1.2,-0.64,-1.59,Matches,64.0,pl POL,DF,30.0,1.8,124.0,6.0,33.0,60.0,32.0,1.0,124.0,3.0,1.0,33.3,2.0,66.7,61.0,342.0,173.0,8.0,7.0,0.0,1.0,1.0,66.0,7.0,Matches,64.0,pl POL,DF,30.0,1.8,0.0,0.0,0.0,,0.0,0.0,,,,0.0,0.0,0.0,0.0,0.0,,0.0,0.0,Matches,64.0,pl POL,DF,30.0,3.0,2.0,166.0,1.8,0.0,1.0,1.0,0.0,0.0,0.0,1.0,0.0,0.0,0.0,0.2,0.2,8.0,7.0,7.0,0.0,0.54,0.54,0.0,0.54,0.0,0.1,0.1,0.0,0.1,Matches,Bartosz Bereszyński,D/WB R,30,131,138,Poland,U.C. Sampdoria,6,13,11,4,11,6,12,4,16,12,13,8,15,12,16,13,16,11,11,11,12,15,10,5,13,12,15,16,13,12,13,10,15,13,16,16,14,10,12,10,13,1,2,2,1,3,3,1,3,1,2,2,15,15,10,5,13,15,12,9,1,12,10,20,12,19,1,1,1,1,1,1,1,1,183,77,10,20,3895171,6550,6600,5000,Northern_European,127,2,1992/7/12,43,0,15962.0,,96011201
610,Marco Bertini,Lazio,2002,65.0,it ITA,MF,19.0,0.0,0.0,0.0,0.0,0.0,0.0,0.0,0.0,,0.0,0.0,0.0,0.0,0.0,0.0,0.0,0.0,Matches,65.0,it ITA,MF,19.0,0.0,0.0,0.0,0.0,0.0,0.0,0.0,0.0,0.0,0.0,0.0,0.0,0.0,0.0,0.0,0.0,0.0,Matches,,,,,,,,,,,,,,,,,,,,,,,,,,,,,,,,,,,,,,,,,,,,,,,,,,,,,,,,65.0,it ITA,MF,19.0,0.0,0.0,0.0,0.0,0.0,0.0,0.0,0.0,0.0,0.0,0.0,0.0,0.0,0.0,0.0,0.0,,Matches,65.0,it ITA,MF,19.0,0.0,0.0,0.0,0.0,0.0,0.0,0.0,0.0,0.0,0.0,0.0,0.0,0.0,0.0,0.0,0.0,Matches,65.0,it ITA,MF,19.0,0.0,0.0,0.0,,0.0,0.0,0.0,0.0,,0.0,0.0,,0.0,0.0,,0.0,0.0,0.0,0.0,0.0,0.0,0.0,0.0,0.0,Matches,83,it ITA,MF,19,1,1.0,1.0,0.0,0.0,0,,0,1,1.0,21,3.0,0.0,0.0,0.0,0.0,-0.79,0.0,0.0,0.0,0.0,-0.26,Matches,65.0,it ITA,MF,19.0,0.0,0.0,0.0,0.0,0.0,0.0,0.0,0.0,0.0,0.0,,0.0,,0.0,0.0,0.0,0.0,0.0,0.0,0.0,0.0,0.0,0.0,Matches,65.0,it ITA,MF,19.0,0.0,0.0,0.0,0.0,,0.0,0.0,,,,0.0,0.0,0.0,0.0,0.0,,0.0,0.0,Matches,65.0,it ITA,MF,19.0,1.0,0.0,1.0,0.0,0.0,0.0,0.0,0.0,0.0,0.0,0.0,0.0,0.0,0.0,0.0,0.0,0.0,0.0,0.0,0.0,0.0,0.0,0.0,0.0,0.0,0.0,0.0,0.0,0.0,Matches,Marco Bertini,DM/M C,19,101,-8,Italy,S.S. Lazio,12,10,11,6,11,10,10,13,5,10,13,9,11,13,11,13,11,11,12,13,13,15,7,10,10,11,13,12,10,11,11,11,13,11,12,11,13,10,11,9,10,3,2,1,4,4,2,3,4,2,2,2,7,12,8,12,12,15,10,8,1,1,1,1,1,1,20,1,18,1,1,12,1,1,185,68,6,20,25900000,5050,5050,1294,Mediterranean_Hispanic,102,1,2002/8/7,0,0,2763.0,,43424638
611,Alessandro Bianco,Fiorentina,2002,68.0,it ITA,MF,19.0,1.7,5.0,2.0,2.0,3.0,0.0,2.0,3.0,66.7,1.0,1.0,0.0,1.0,0.0,5.0,0.0,0.0,Matches,68.0,it ITA,MF,19.0,1.7,4.0,2.35,3.0,0.0,0.0,0.0,1.0,0.0,0.0,0.0,0.0,0.0,0.0,0.0,0.0,0.0,Matches,,,,,,,,,,,,,,,,,,,,,,,,,,,,,,,,,,,,,,,,,,,,,,,,,,,,,,,,68.0,it ITA,MF,19.0,1.7,1.0,0.0,0.0,7.0,4.0,0.0,1.0,0.0,2.0,0.0,0.0,0.0,8.0,2.0,2.0,50.0,Matches,68.0,it ITA,MF,19.0,1.7,78.0,76.0,2.0,2.0,0.0,3.0,1.0,0.0,0.0,0.0,0.0,0.0,67.0,0.0,0.0,Matches,68.0,it ITA,MF,19.0,1.7,67.0,78.0,85.9,1237.0,231.0,29.0,34.0,85.3,28.0,34.0,82.4,9.0,9.0,100.0,0.0,0.0,0.0,0.0,1.0,11.0,1.0,0.0,9.0,Matches,88,it ITA,MF,19,7,153.0,22.0,4.5,1.7,2,54.0,0,5,9.0,30,1.71,3.0,1.0,2.0,1.18,0.96,2.6,1.8,0.9,0.51,0.21,Matches,68.0,it ITA,MF,19.0,1.7,91.0,2.0,18.0,59.0,14.0,1.0,91.0,2.0,0.0,0.0,0.0,0.0,49.0,240.0,144.0,4.0,1.0,0.0,2.0,5.0,68.0,2.0,Matches,68.0,it ITA,MF,19.0,1.7,0.0,2.0,1.0,50.0,1.18,0.59,0.0,0.0,25.2,0.0,0.0,0.0,0.1,0.1,0.03,-0.1,-0.1,Matches,68.0,it ITA,MF,19.0,7.0,2.0,153.0,1.7,0.0,0.0,0.0,0.0,0.0,0.0,1.0,0.0,0.1,0.1,0.0,0.1,4.0,9.0,2.0,0.0,0.0,0.0,0.0,0.0,0.04,0.01,0.05,0.04,0.05,Matches,Alessandro Bianco,DM/M C,19,88,-75,Italy,ACF Fiorentina,8,8,10,7,11,8,7,7,6,7,12,8,7,10,9,12,12,8,13,12,12,10,8,9,10,11,12,13,13,12,9,8,11,12,12,10,12,8,11,9,12,4,2,1,1,2,4,2,1,1,2,2,12,11,9,12,13,11,12,10,1,1,1,1,1,1,16,1,20,1,1,1,1,1,176,0,7,20,11729999,4398,3998,364,Mediterranean_Hispanic,89,2,2002/10/1,0,0,1027.0,,43458331
612,Emil Bohinen,Salernitana,1999,75.0,no NOR,MF,23.0,9.2,25.0,13.0,15.0,8.0,2.0,12.0,23.0,52.2,11.0,25.0,7.0,18.0,17.0,42.0,21.0,0.0,Matches,75.0,no NOR,MF,23.0,9.2,17.0,1.85,15.0,1.0,0.0,1.0,0.0,0.0,0.0,0.0,0.0,0.0,0.0,0.0,0.0,0.0,Matches,,,,,,,,,,,,,,,,,,,,,,,,,,,,,,,,,,,,,,,,,,,,,,,,,,,,,,,,75.0,no NOR,MF,23.0,9.2,0.0,0.0,0.0,15.0,13.0,1.0,3.0,17.0,13.0,0.0,1.0,0.0,78.0,12.0,15.0,44.4,Matches,75.0,no NOR,MF,23.0,9.2,479.0,459.0,19.0,17.0,0.0,3.0,3.0,0.0,2.0,0.0,2.0,0.0,404.0,1.0,12.0,Matches,75.0,no NOR,MF,23.0,9.2,404.0,479.0,84.3,5591.0,1452.0,238.0,262.0,90.8,127.0,146.0,87.0,16.0,28.0,57.1,0.0,0.7,0.3,-0.7,12.0,25.0,5.0,1.0,31.0,Matches,97,no NOR,MF,23,24,832.0,35.0,24.3,9.2,9,62.0,0,15,18.0,5,1.21,15.0,13.0,2.0,0.22,0.77,9.1,18.2,-9.2,-0.99,-0.25,Matches,75.0,no NOR,MF,23.0,9.2,610.0,36.0,172.0,335.0,110.0,6.0,610.0,18.0,8.0,44.4,7.0,38.9,320.0,1702.0,868.0,12.0,12.0,0.0,10.0,9.0,355.0,16.0,Matches,75.0,no NOR,MF,23.0,9.2,0.0,4.0,0.0,0.0,0.43,0.0,0.0,,25.9,0.0,0.0,0.0,0.1,0.1,0.04,-0.1,-0.1,Matches,75.0,no NOR,MF,23.0,24.0,9.0,832.0,9.2,0.0,0.0,0.0,0.0,0.0,0.0,0.0,0.0,0.1,0.1,0.7,0.8,12.0,31.0,16.0,0.0,0.0,0.0,0.0,0.0,0.02,0.07,0.09,0.02,0.09,Matches,Emil Bohinen,DM/M C,23,128,147,Norway,U.S. Salernitana 1919,10,12,11,8,14,11,7,13,4,7,15,13,13,14,9,13,10,15,13,14,13,15,14,6,10,14,14,14,13,13,14,12,10,12,13,10,15,12,12,10,12,3,3,1,2,2,3,3,2,3,1,3,9,15,7,14,13,15,14,9,1,1,1,1,1,1,18,1,20,1,1,10,5,1,189,78,20,11,3906629,6400,6350,3000,Northern_European,128,1,1999/3/12,0,0,18000.0,,53126104
613,Warren Bondo,Monza,2003,78.0,fr FRA,MF,18.0,0.7,1.0,0.0,1.0,0.0,0.0,0.0,0.0,,0.0,1.0,0.0,1.0,0.0,1.0,0.0,0.0,Matches,78.0,fr FRA,MF,18.0,0.7,3.0,4.5,1.0,0.0,0.0,0.0,2.0,0.0,0.0,0.0,0.0,0.0,0.0,0.0,0.0,0.0,Matches,,,,,,,,,,,,,,,,,,,,,,,,,,,,,,,,,,,,,,,,,,,,,,,,,,,,,,,,78.0,fr FRA,MF,18.0,0.7,1.0,0.0,0.0,2.0,3.0,0.0,0.0,0.0,0.0,0.0,0.0,0.0,4.0,1.0,0.0,100.0,Matches,78.0,fr FRA,MF,18.0,0.7,51.0,48.0,3.0,2.0,0.0,0.0,0.0,1.0,0.0,0.0,0.0,0.0,45.0,0.0,1.0,Matches,78.0,fr FRA,MF,18.0,0.7,45.0,51.0,88.2,720.0,106.0,24.0,26.0,92.3,20.0,22.0,90.9,1.0,1.0,100.0,0.0,0.0,0.0,0.0,0.0,2.0,0.0,0.0,5.0,Matches,100,fr FRA,MF,18,4,60.0,15.0,1.8,0.7,0,,0,4,15.0,15,0.75,2.0,2.0,0.0,0.0,0.11,0.9,1.1,-0.2,-0.34,-0.2,Matches,78.0,fr FRA,MF,18.0,0.7,60.0,0.0,8.0,40.0,13.0,0.0,60.0,4.0,3.0,75.0,1.0,25.0,45.0,315.0,147.0,3.0,3.0,0.0,1.0,1.0,51.0,2.0,Matches,78.0,fr FRA,MF,18.0,0.7,0.0,1.0,0.0,0.0,1.5,0.0,0.0,,21.2,0.0,0.0,0.0,0.1,0.1,0.06,-0.1,-0.1,Matches,78.0,fr FRA,MF,18.0,4.0,0.0,60.0,0.7,0.0,0.0,0.0,0.0,0.0,0.0,1.0,0.0,0.1,0.1,0.0,0.1,3.0,5.0,2.0,0.0,0.0,0.0,0.0,0.0,0.09,0.0,0.09,0.09,0.09,Matches,Warren Bondo,M C,18,101,-8,France,Brianza,8,10,13,11,14,8,11,8,8,12,13,6,12,12,13,8,4,13,7,14,14,8,15,3,10,9,9,10,12,8,9,8,12,9,13,12,11,5,7,11,12,2,2,2,2,1,3,2,2,3,3,2,15,13,7,9,11,12,13,11,1,1,1,1,1,1,10,13,20,13,13,15,13,1,177,0,6,20,14259200,5000,5000,2500,African_Caribbean,94,17,2003/9/15,0,0,2022.0,,2000006107
614,Leonardo Bonucci,Juventus,1987,80.0,it ITA,DF,35.0,9.8,5.0,4.0,1.0,4.0,0.0,2.0,4.0,50.0,2.0,12.0,8.0,4.0,13.0,18.0,29.0,0.0,Matches,80.0,it ITA,DF,35.0,9.8,9.0,0.92,7.0,0.0,0.0,1.0,0.0,1.0,1.0,0.1,0.0,0.0,0.0,1.0,0.0,0.0,Matches,,,,,,,,,,,,,,,,,,,,,,,,,,,,,,,,,,,,,,,,,,,,,,,,,,,,,,,,80.0,it ITA,DF,35.0,9.8,2.0,0.0,0.0,11.0,5.0,1.0,0.0,13.0,4.0,0.0,0.0,0.0,48.0,20.0,23.0,46.5,Matches,80.0,it ITA,DF,35.0,9.8,580.0,539.0,40.0,13.0,1.0,6.0,0.0,1.0,0.0,0.0,0.0,0.0,508.0,1.0,2.0,Matches,80.0,it ITA,DF,35.0,9.8,508.0,580.0,87.6,10749.0,4060.0,139.0,149.0,93.3,295.0,316.0,93.4,71.0,106.0,67.0,0.0,0.2,0.3,-0.2,4.0,35.0,4.0,0.0,28.0,Matches,102,it ITA,DF,35,16,879.0,55.0,25.7,9.8,9,85.0,7,7,16.0,9,2.06,20.0,10.0,10.0,1.02,0.56,16.5,11.3,5.2,0.53,0.23,Matches,80.0,it ITA,DF,35.0,9.8,658.0,102.0,326.0,326.0,10.0,7.0,657.0,1.0,1.0,100.0,0.0,0.0,405.0,1630.0,854.0,2.0,2.0,0.0,3.0,1.0,460.0,1.0,Matches,80.0,it ITA,DF,35.0,9.8,1.0,4.0,1.0,25.0,0.41,0.1,0.25,1.0,12.0,0.0,0.0,1.0,1.1,0.3,0.07,-0.1,0.7,Matches,80.0,it ITA,DF,35.0,16.0,9.0,879.0,9.8,1.0,0.0,1.0,1.0,0.0,1.0,2.0,0.0,1.1,0.3,0.2,0.5,2.0,28.0,1.0,0.1,0.0,0.1,0.1,0.1,0.11,0.02,0.13,0.03,0.05,Matches,Leonardo Bonucci,D C,35,151,173,Italy,Juventus,4,8,8,10,14,12,15,12,5,14,17,12,13,13,11,18,17,15,15,17,13,20,10,20,6,19,16,12,11,11,12,14,15,10,11,15,15,11,14,5,8,1,2,2,3,3,1,1,3,4,2,2,14,14,9,10,15,18,11,9,1,1,20,1,1,1,6,1,1,1,1,1,1,1,190,85,9,20,347975206,7550,8000,7500,Mediterranean_Hispanic,149,4,1987/5/1,116,8,231537.0,,1410956
615,Erik Botheim,Salernitana,2000,81.0,no NOR,MFFW,22.0,9.6,11.0,7.0,3.0,4.0,4.0,6.0,13.0,46.2,7.0,3.0,0.0,3.0,0.0,11.0,4.0,0.0,Matches,81.0,no NOR,MFFW,22.0,9.6,17.0,1.77,12.0,0.0,0.0,2.0,1.0,2.0,4.0,0.42,4.0,0.0,0.0,0.0,0.0,0.0,Matches,,,,,,,,,,,,,,,,,,,,,,,,,,,,,,,,,,,,,,,,,,,,,,,,,,,,,,,,81.0,no NOR,MFFW,22.0,9.6,2.0,0.0,0.0,12.0,11.0,3.0,5.0,0.0,7.0,0.0,0.0,0.0,32.0,20.0,28.0,41.7,Matches,81.0,no NOR,MFFW,22.0,9.6,231.0,226.0,4.0,0.0,1.0,0.0,5.0,1.0,0.0,0.0,0.0,0.0,165.0,1.0,9.0,Matches,81.0,no NOR,MFFW,22.0,9.6,165.0,231.0,71.4,2038.0,460.0,99.0,126.0,78.6,42.0,59.0,71.2,5.0,7.0,71.4,3.0,1.8,0.7,1.2,9.0,10.0,4.0,0.0,21.0,Matches,103,no NOR,MFFW,22,28,866.0,31.0,25.3,9.6,9,65.0,2,19,15.0,10,1.29,13.0,17.0,-4.0,-0.42,-0.06,9.2,17.6,-8.4,-0.88,-0.1,Matches,81.0,no NOR,MFFW,22.0,9.6,300.0,7.0,38.0,146.0,118.0,23.0,300.0,7.0,2.0,28.6,4.0,57.1,166.0,647.0,259.0,11.0,5.0,3.0,19.0,12.0,230.0,61.0,Matches,81.0,no NOR,MFFW,22.0,9.6,1.0,7.0,1.0,14.3,0.73,0.1,0.14,1.0,13.5,0.0,0.0,0.0,0.6,0.6,0.08,0.4,0.4,Matches,81.0,no NOR,MFFW,22.0,28.0,9.0,866.0,9.6,1.0,3.0,4.0,1.0,0.0,0.0,2.0,0.0,0.6,0.6,1.8,2.3,11.0,21.0,61.0,0.1,0.31,0.42,0.1,0.42,0.06,0.18,0.24,0.06,0.24,Matches,Erik Botheim,S,22,126,147,Norway,U.S. Salernitana 1919,7,11,11,13,14,10,13,10,6,5,12,13,5,15,9,12,12,14,12,13,12,15,14,10,13,7,12,13,11,12,13,13,14,12,13,13,13,5,16,7,6,2,1,1,3,2,3,2,3,2,1,2,13,17,14,5,16,14,11,8,1,1,1,1,1,1,1,1,1,1,11,14,11,20,183,80,20,15,5127999,6300,6250,4650,Northern_European,126,4,2000/1/10,0,0,18468.0,,53138885
616,Liberato Cacace,Empoli,2000,94.0,nz NZL,DF,21.0,6.5,25.0,10.0,12.0,8.0,5.0,9.0,15.0,60.0,6.0,15.0,7.0,8.0,4.0,29.0,16.0,0.0,Matches,94.0,nz NZL,DF,21.0,6.5,23.0,3.53,13.0,3.0,2.0,4.0,0.0,1.0,1.0,0.15,0.0,0.0,0.0,1.0,0.0,0.0,Matches,,,,,,,,,,,,,,,,,,,,,,,,,,,,,,,,,,,,,,,,,,,,,,,,,,,,,,,,94.0,nz NZL,DF,21.0,6.5,1.0,0.0,0.0,9.0,4.0,0.0,29.0,4.0,10.0,0.0,2.0,0.0,38.0,7.0,21.0,25.0,Matches,94.0,nz NZL,DF,21.0,6.5,424.0,336.0,88.0,11.0,0.0,1.0,29.0,75.0,2.0,2.0,0.0,0.0,338.0,0.0,10.0,Matches,94.0,nz NZL,DF,21.0,6.5,338.0,424.0,79.7,5441.0,1880.0,169.0,188.0,89.9,143.0,173.0,82.7,20.0,42.0,47.6,0.0,0.6,0.7,-0.6,8.0,24.0,1.0,1.0,41.0,Matches,123,nz NZL,DF,21,12,587.0,49.0,17.2,6.5,5,86.0,4,7,22.0,26,0.5,6.0,9.0,-3.0,-0.46,-0.17,6.4,12.8,-6.4,-0.98,-0.57,Matches,94.0,nz NZL,DF,21.0,6.5,525.0,33.0,166.0,243.0,122.0,12.0,525.0,20.0,8.0,40.0,10.0,50.0,242.0,1509.0,814.0,21.0,14.0,4.0,6.0,7.0,292.0,31.0,Matches,94.0,nz NZL,DF,21.0,6.5,0.0,7.0,1.0,14.3,1.07,0.15,0.0,0.0,19.7,0.0,0.0,0.0,0.6,0.6,0.09,-0.6,-0.6,Matches,94.0,nz NZL,DF,21.0,12.0,5.0,587.0,6.5,0.0,0.0,0.0,0.0,0.0,0.0,1.0,0.0,0.6,0.6,0.6,1.2,21.0,41.0,31.0,0.0,0.0,0.0,0.0,0.0,0.09,0.1,0.19,0.09,0.19,Matches,Liberato Cacace,D/WB L,21,121,151,"New Zealand,Italy",Empoli Football Club,6,13,12,8,14,5,8,12,11,12,12,4,13,13,7,11,10,10,11,12,10,14,11,5,12,11,13,13,15,13,14,11,16,14,14,12,14,10,11,5,9,1,1,1,3,2,1,2,3,4,3,3,8,11,2,12,11,11,14,15,1,20,7,1,20,1,1,10,1,1,1,1,1,1,184,66,20,8,4982399,6050,5900,4900,Mediterranean_Hispanic,115,4,2000/9/27,12,1,5577.0,,88024471
617,Mohamed Camara,Roma,1997,99.0,gn GUI,MF,25.0,7.7,13.0,10.0,3.0,7.0,3.0,5.0,15.0,33.3,10.0,5.0,1.0,4.0,10.0,23.0,8.0,0.0,Matches,99.0,gn GUI,MF,25.0,7.7,12.0,1.55,6.0,0.0,0.0,1.0,1.0,4.0,0.0,0.0,0.0,0.0,0.0,0.0,0.0,0.0,Matches,,,,,,,,,,,,,,,,,,,,,,,,,,,,,,,,,,,,,,,,,,,,,,,,,,,,,,,,99.0,gn GUI,MF,25.0,7.7,3.0,0.0,0.0,15.0,7.0,0.0,6.0,10.0,10.0,0.0,0.0,0.0,59.0,15.0,8.0,65.2,Matches,99.0,gn GUI,MF,25.0,7.7,323.0,318.0,4.0,3.0,2.0,1.0,6.0,1.0,0.0,0.0,0.0,0.0,252.0,1.0,6.0,Matches,99.0,gn GUI,MF,25.0,7.7,252.0,323.0,78.0,4178.0,844.0,125.0,143.0,87.4,105.0,129.0,81.4,18.0,31.0,58.1,0.0,0.4,0.5,-0.4,3.0,27.0,3.0,1.0,30.0,Matches,129,gn GUI,MF,25,15,696.0,46.0,20.4,7.7,8,76.0,1,7,13.0,18,1.33,5.0,10.0,-5.0,-0.65,-1.21,8.2,6.3,1.9,0.25,-0.53,Matches,99.0,gn GUI,MF,25.0,7.7,393.0,10.0,61.0,262.0,81.0,8.0,393.0,13.0,7.0,53.8,5.0,38.5,233.0,1268.0,585.0,13.0,10.0,2.0,11.0,6.0,241.0,14.0,Matches,99.0,gn GUI,MF,25.0,7.7,0.0,11.0,1.0,9.1,1.42,0.13,0.0,0.0,23.6,1.0,0.0,0.0,0.6,0.6,0.06,-0.6,-0.6,Matches,99.0,gn GUI,MF,25.0,15.0,8.0,696.0,7.7,0.0,0.0,0.0,0.0,0.0,0.0,3.0,0.0,0.6,0.6,0.4,1.0,13.0,30.0,14.0,0.0,0.0,0.0,0.0,0.0,0.08,0.05,0.13,0.08,0.13,Matches,Mohamed Camara,DM/M C,22,137,160,Mali,AS Monaco,7,9,10,9,13,8,8,9,5,14,13,10,14,12,12,14,16,12,13,14,13,17,10,8,10,14,14,15,16,14,12,8,14,14,14,13,12,7,10,5,8,1,2,2,4,2,1,2,1,3,2,3,13,12,1,13,13,10,10,11,1,1,1,1,1,1,17,1,20,1,1,1,1,1,174,73,13,20,33919997,6850,6500,4650,African_Caribbean,135,15,2000/1/6,15,3,23363.0,,13193983
618,Matteo Cancellieri,Lazio,2002,102.0,it ITA,FW,20.0,2.8,10.0,4.0,5.0,3.0,2.0,5.0,9.0,55.6,4.0,4.0,0.0,4.0,1.0,11.0,2.0,0.0,Matches,102.0,it ITA,FW,20.0,2.8,8.0,2.82,4.0,0.0,1.0,1.0,2.0,0.0,0.0,0.0,0.0,0.0,0.0,0.0,0.0,0.0,Matches,,,,,,,,,,,,,,,,,,,,,,,,,,,,,,,,,,,,,,,,,,,,,,,,,,,,,,,,102.0,it ITA,FW,20.0,2.8,4.0,0.0,0.0,14.0,10.0,5.0,7.0,1.0,4.0,1.0,0.0,0.0,14.0,4.0,3.0,57.1,Matches,102.0,it ITA,FW,20.0,2.8,87.0,86.0,1.0,0.0,0.0,0.0,7.0,1.0,0.0,0.0,0.0,0.0,61.0,0.0,4.0,Matches,102.0,it ITA,FW,20.0,2.8,61.0,87.0,70.1,757.0,98.0,44.0,50.0,88.0,15.0,25.0,60.0,0.0,5.0,0.0,0.0,0.4,0.3,-0.4,3.0,1.0,1.0,1.0,2.0,Matches,132,it ITA,FW,20,20,256.0,13.0,7.5,2.8,1,45.0,0,19,11.0,18,1.85,6.0,2.0,4.0,1.41,0.67,5.9,3.3,2.6,0.91,0.71,Matches,102.0,it ITA,FW,20.0,2.8,134.0,2.0,20.0,50.0,66.0,16.0,134.0,9.0,3.0,33.3,4.0,44.4,88.0,630.0,346.0,15.0,8.0,9.0,13.0,3.0,97.0,33.0,Matches,102.0,it ITA,FW,20.0,2.8,0.0,6.0,1.0,16.7,2.11,0.35,0.0,0.0,17.8,0.0,0.0,0.0,0.4,0.4,0.06,-0.4,-0.4,Matches,102.0,it ITA,FW,20.0,20.0,1.0,256.0,2.8,0.0,0.0,0.0,0.0,0.0,0.0,4.0,0.0,0.4,0.4,0.4,0.8,15.0,2.0,33.0,0.0,0.0,0.0,0.0,0.0,0.14,0.14,0.28,0.14,0.28,Matches,Matteo Cancellieri,M/AM/S R,20,130,-85,Italy,Hellas Verona,11,12,14,11,12,12,10,13,3,4,12,11,5,13,9,11,11,12,13,12,12,16,13,8,14,6,13,13,15,12,13,10,12,16,12,10,12,7,11,5,17,3,1,2,1,2,3,4,3,2,2,2,12,15,6,11,13,14,14,14,1,1,1,1,1,1,1,10,1,18,12,12,20,17,180,79,20,9,7289863,6500,7100,3900,Mediterranean_Hispanic,124,3,2002/2/12,1,0,24439.0,S.S. Lazio,43424754
619,Andrea Carboni,Monza,2001,107.0,it ITA,DF,21.0,1.9,3.0,2.0,2.0,0.0,1.0,2.0,5.0,40.0,3.0,3.0,2.0,1.0,3.0,6.0,2.0,1.0,Matches,107.0,it ITA,DF,21.0,1.9,3.0,1.62,3.0,0.0,0.0,0.0,0.0,0.0,0.0,0.0,0.0,0.0,0.0,0.0,0.0,0.0,Matches,,,,,,,,,,,,,,,,,,,,,,,,,,,,,,,,,,,,,,,,,,,,,,,,,,,,,,,,107.0,it ITA,DF,21.0,1.9,0.0,0.0,0.0,1.0,1.0,0.0,5.0,3.0,2.0,0.0,0.0,0.0,8.0,0.0,3.0,0.0,Matches,107.0,it ITA,DF,21.0,1.9,87.0,74.0,13.0,1.0,0.0,1.0,5.0,11.0,1.0,0.0,1.0,0.0,69.0,0.0,3.0,Matches,107.0,it ITA,DF,21.0,1.9,69.0,87.0,79.3,1170.0,558.0,33.0,38.0,86.8,29.0,31.0,93.5,7.0,14.0,50.0,0.0,0.1,0.3,-0.1,1.0,3.0,2.0,2.0,9.0,Matches,141,it ITA,DF,21,4,167.0,42.0,4.9,1.9,1,90.0,1,3,26.0,15,0.0,2.0,7.0,-5.0,-2.69,-2.72,1.9,4.1,-2.1,-1.14,-1.05,Matches,107.0,it ITA,DF,21.0,1.9,104.0,4.0,41.0,43.0,20.0,4.0,104.0,3.0,1.0,33.3,2.0,66.7,50.0,284.0,190.0,4.0,2.0,0.0,0.0,0.0,66.0,2.0,Matches,107.0,it ITA,DF,21.0,1.9,0.0,1.0,1.0,100.0,0.54,0.54,0.0,0.0,10.8,0.0,0.0,0.0,0.1,0.1,0.05,-0.1,-0.1,Matches,107.0,it ITA,DF,21.0,4.0,1.0,167.0,1.9,0.0,0.0,0.0,0.0,0.0,0.0,0.0,0.0,0.1,0.1,0.1,0.2,4.0,9.0,2.0,0.0,0.0,0.0,0.0,0.0,0.03,0.07,0.1,0.03,0.1,Matches,Andrea Carboni,D LC,21,123,156,Italy,Brianza,5,8,8,5,9,5,15,5,8,13,10,5,14,9,11,12,13,12,13,12,13,14,9,13,7,13,14,13,13,12,12,15,11,12,13,14,13,14,11,7,10,2,1,3,2,4,1,2,3,2,1,1,7,15,5,12,13,13,8,18,1,16,20,1,12,1,1,1,1,1,1,1,1,1,185,70,20,8,4246399,6150,6350,4400,Mediterranean_Hispanic,123,2,2001/2/4,0,0,14621.0,,43391662
620,Franco Carboni,Monza,2003,108.0,it ITA,DFFW,19.0,0.7,1.0,1.0,1.0,0.0,0.0,0.0,2.0,0.0,2.0,3.0,0.0,3.0,1.0,2.0,0.0,0.0,Matches,108.0,it ITA,DFFW,19.0,0.7,1.0,1.36,1.0,0.0,0.0,0.0,0.0,0.0,0.0,0.0,0.0,0.0,0.0,0.0,0.0,0.0,Matches,,,,,,,,,,,,,,,,,,,,,,,,,,,,,,,,,,,,,,,,,,,,,,,,,,,,,,,,108.0,it ITA,DFFW,19.0,0.7,0.0,0.0,0.0,2.0,0.0,0.0,9.0,1.0,1.0,0.0,0.0,0.0,7.0,1.0,1.0,50.0,Matches,108.0,it ITA,DFFW,19.0,0.7,50.0,43.0,7.0,0.0,0.0,0.0,9.0,7.0,0.0,0.0,0.0,0.0,33.0,0.0,7.0,Matches,108.0,it ITA,DFFW,19.0,0.7,33.0,50.0,66.0,529.0,140.0,19.0,20.0,95.0,12.0,15.0,80.0,2.0,5.0,40.0,0.0,0.0,0.0,0.0,1.0,3.0,2.0,1.0,2.0,Matches,142,it ITA,DFFW,19,3,66.0,22.0,1.9,0.7,0,,0,3,22.0,15,2.0,1.0,0.0,1.0,1.36,1.5,0.5,1.2,-0.7,-0.95,-0.82,Matches,108.0,it ITA,DFFW,19.0,0.7,61.0,2.0,17.0,28.0,21.0,1.0,61.0,7.0,3.0,42.9,4.0,57.1,34.0,293.0,169.0,7.0,3.0,1.0,0.0,0.0,36.0,8.0,Matches,108.0,it ITA,DFFW,19.0,0.7,0.0,1.0,0.0,0.0,1.36,0.0,0.0,,16.1,0.0,0.0,0.0,0.1,0.1,0.08,-0.1,-0.1,Matches,108.0,it ITA,DFFW,19.0,3.0,0.0,66.0,0.7,0.0,0.0,0.0,0.0,0.0,0.0,0.0,0.0,0.1,0.1,0.0,0.1,7.0,2.0,8.0,0.0,0.0,0.0,0.0,0.0,0.11,0.06,0.17,0.11,0.17,Matches,Franco Carboni,D/WB/M L,19,109,-8,"Argentina,Italy",FC Internazionale Milano,7,12,11,9,12,4,10,9,8,10,11,6,11,11,13,14,12,11,11,10,12,11,7,7,11,11,12,11,13,12,12,12,14,14,13,13,13,7,11,5,16,2,2,3,2,4,2,1,1,1,1,3,13,13,6,13,9,12,10,20,1,20,1,1,19,1,1,18,1,1,15,10,1,10,183,76,20,5,28000000,5450,5450,2750,Mediterranean_Hispanic,105,2,2003/4/4,0,0,4741.0,Cagliari Calcio,43619130
621,Tommaso Cassandro,Lecce,2000,112.0,it ITA,DF,22.0,0.1,1.0,1.0,0.0,1.0,0.0,0.0,0.0,,0.0,1.0,1.0,0.0,0.0,1.0,0.0,0.0,Matches,112.0,it ITA,DF,22.0,0.1,0.0,0.0,0.0,0.0,0.0,0.0,0.0,0.0,0.0,0.0,0.0,0.0,0.0,0.0,0.0,0.0,Matches,,,,,,,,,,,,,,,,,,,,,,,,,,,,,,,,,,,,,,,,,,,,,,,,,,,,,,,,112.0,it ITA,DF,22.0,0.1,0.0,0.0,0.0,1.0,0.0,0.0,0.0,0.0,1.0,0.0,0.0,0.0,0.0,0.0,0.0,,Matches,112.0,it ITA,DF,22.0,0.1,6.0,3.0,3.0,0.0,0.0,0.0,0.0,3.0,0.0,0.0,0.0,0.0,6.0,0.0,0.0,Matches,112.0,it ITA,DF,22.0,0.1,6.0,6.0,100.0,125.0,104.0,3.0,3.0,100.0,2.0,2.0,100.0,1.0,1.0,100.0,0.0,0.0,0.0,0.0,0.0,1.0,1.0,0.0,0.0,Matches,146,it ITA,DF,22,1,13.0,13.0,0.4,0.1,0,,0,1,13.0,19,0.0,0.0,0.0,0.0,0.0,0.34,0.1,0.4,-0.4,-2.5,-2.35,Matches,112.0,it ITA,DF,22.0,0.1,8.0,1.0,4.0,3.0,1.0,0.0,8.0,0.0,0.0,,0.0,,2.0,5.0,4.0,0.0,0.0,0.0,0.0,0.0,3.0,0.0,Matches,112.0,it ITA,DF,22.0,0.1,0.0,0.0,0.0,,0.0,0.0,,,,0.0,0.0,0.0,0.0,0.0,,0.0,0.0,Matches,112.0,it ITA,DF,22.0,1.0,0.0,13.0,0.1,0.0,0.0,0.0,0.0,0.0,0.0,0.0,0.0,0.0,0.0,0.0,0.0,0.0,0.0,0.0,0.0,0.0,0.0,0.0,0.0,0.0,0.0,0.0,0.0,0.0,Matches,Tommaso Cassandro,D/WB R,22,117,135,Italy,Cittadella,8,10,10,8,10,8,10,7,10,10,11,8,12,10,12,13,10,10,12,10,10,12,9,13,10,11,14,14,15,14,10,8,10,15,15,10,12,7,10,8,10,1,2,4,2,1,3,1,3,3,2,3,10,12,3,10,10,15,18,12,1,1,10,20,1,18,1,1,1,1,1,1,1,1,185,72,8,20,1835625,5850,5850,4251,Mediterranean_Hispanic,110,2,2000/1/9,0,0,7739.0,,43296005
622,Gaetano Castrovilli,Fiorentina,1997,114.0,it ITA,MF,25.0,8.0,10.0,8.0,1.0,7.0,2.0,2.0,9.0,22.2,7.0,5.0,1.0,4.0,8.0,18.0,5.0,0.0,Matches,114.0,it ITA,MF,25.0,8.0,18.0,2.25,12.0,2.0,0.0,2.0,1.0,1.0,1.0,0.12,1.0,0.0,0.0,0.0,0.0,0.0,Matches,,,,,,,,,,,,,,,,,,,,,,,,,,,,,,,,,,,,,,,,,,,,,,,,,,,,,,,,114.0,it ITA,MF,25.0,8.0,3.0,0.0,0.0,12.0,12.0,1.0,12.0,8.0,8.0,0.0,0.0,0.0,36.0,4.0,11.0,26.7,Matches,114.0,it ITA,MF,25.0,8.0,241.0,224.0,16.0,10.0,1.0,1.0,12.0,1.0,3.0,0.0,2.0,0.0,188.0,1.0,6.0,Matches,114.0,it ITA,MF,25.0,8.0,188.0,241.0,78.0,2876.0,559.0,103.0,116.0,88.8,58.0,69.0,84.1,17.0,38.0,44.7,1.0,1.1,1.0,-0.1,8.0,10.0,4.0,1.0,14.0,Matches,149,it ITA,MF,25,15,718.0,48.0,21.0,8.0,7,77.0,2,8,22.0,5,1.67,17.0,8.0,9.0,1.13,1.09,13.7,8.1,5.6,0.7,0.49,Matches,114.0,it ITA,MF,25.0,8.0,324.0,15.0,56.0,148.0,127.0,22.0,324.0,16.0,7.0,43.8,5.0,31.3,176.0,1019.0,467.0,12.0,13.0,0.0,11.0,9.0,200.0,16.0,Matches,114.0,it ITA,MF,25.0,8.0,2.0,18.0,8.0,44.4,2.26,1.0,0.11,0.25,17.7,1.0,0.0,0.0,1.2,1.2,0.07,0.8,0.8,Matches,114.0,it ITA,MF,25.0,15.0,7.0,718.0,8.0,2.0,1.0,3.0,2.0,0.0,0.0,3.0,0.0,1.2,1.2,1.1,2.3,12.0,14.0,16.0,0.25,0.13,0.38,0.25,0.38,0.15,0.14,0.29,0.15,0.29,Matches,Gaetano Castrovilli,M/AM C,25,140,150,Italy,ACF Fiorentina,13,12,15,13,15,12,13,14,6,9,14,11,13,15,14,13,13,11,12,13,13,16,15,10,13,11,14,16,14,15,12,13,14,13,15,12,12,14,12,13,13,2,2,1,1,3,3,1,1,4,1,4,12,18,7,13,13,15,12,9,1,1,1,1,1,1,1,12,20,12,13,16,12,1,187,72,10,20,7601607,7000,7100,5600,Mediterranean_Hispanic,141,3,1997/2/17,4,0,49807.0,,43206176
623,Pietro Ceccaroni,Lecce,1995,116.0,it ITA,DF,26.0,0.5,0.0,0.0,0.0,0.0,0.0,0.0,0.0,,0.0,1.0,1.0,0.0,3.0,3.0,2.0,0.0,Matches,116.0,it ITA,DF,26.0,0.5,1.0,2.09,0.0,0.0,0.0,1.0,0.0,0.0,0.0,0.0,0.0,0.0,0.0,0.0,0.0,0.0,Matches,,,,,,,,,,,,,,,,,,,,,,,,,,,,,,,,,,,,,,,,,,,,,,,,,,,,,,,,116.0,it ITA,DF,26.0,0.5,0.0,0.0,0.0,0.0,0.0,0.0,0.0,3.0,0.0,0.0,0.0,0.0,3.0,0.0,0.0,,Matches,116.0,it ITA,DF,26.0,0.5,14.0,10.0,4.0,1.0,0.0,0.0,0.0,3.0,0.0,0.0,0.0,0.0,10.0,0.0,0.0,Matches,116.0,it ITA,DF,26.0,0.5,10.0,14.0,71.4,187.0,78.0,6.0,6.0,100.0,2.0,4.0,50.0,2.0,4.0,50.0,0.0,0.2,0.0,-0.2,1.0,0.0,0.0,0.0,0.0,Matches,152,it ITA,DF,26,2,43.0,22.0,1.3,0.5,0,,0,2,22.0,16,1.5,1.0,1.0,0.0,0.0,0.35,0.8,1.0,-0.3,-0.53,-0.38,Matches,116.0,it ITA,DF,26.0,0.5,22.0,4.0,9.0,10.0,3.0,1.0,22.0,0.0,0.0,,0.0,,7.0,30.0,16.0,0.0,0.0,0.0,0.0,0.0,7.0,1.0,Matches,116.0,it ITA,DF,26.0,0.5,0.0,2.0,0.0,0.0,4.19,0.0,0.0,,17.9,0.0,0.0,0.0,0.1,0.1,0.06,-0.1,-0.1,Matches,116.0,it ITA,DF,26.0,2.0,0.0,43.0,0.5,0.0,0.0,0.0,0.0,0.0,0.0,0.0,0.0,0.1,0.1,0.2,0.3,0.0,0.0,1.0,0.0,0.0,0.0,0.0,0.0,0.24,0.33,0.58,0.24,0.58,Matches,Pietro Ceccaroni,D LC,26,125,134,Italy,Venezia Football Club,3,6,7,9,8,7,14,6,6,13,11,8,14,10,16,14,13,12,12,8,13,15,11,14,11,14,13,13,12,12,13,14,13,12,14,13,16,12,13,4,15,3,3,2,2,2,2,2,2,4,3,2,13,12,9,14,12,17,12,11,1,15,20,1,1,1,1,1,1,1,1,1,1,1,188,73,20,10,3353089,6250,6250,4500,Mediterranean_Hispanic,125,5,1995/12/21,0,0,1242.0,,43113705
624,Michele Cerofolini,Fiorentina,1999,121.0,it ITA,GK,23.0,5.0,0.0,0.0,0.0,0.0,0.0,0.0,0.0,,0.0,0.0,0.0,0.0,1.0,1.0,2.0,0.0,Matches,121.0,it ITA,GK,23.0,5.0,0.0,0.0,0.0,0.0,0.0,0.0,0.0,0.0,0.0,0.0,0.0,0.0,0.0,0.0,0.0,0.0,Matches,4.0,it ITA,GK,23.0,5.0,3.0,1.0,0.0,0.0,0.0,3.4,0.22,0.4,0.09,24.0,70.0,34.3,167.0,27.0,34.7,33.3,28.0,42.9,38.1,29.0,1.0,3.4,3.0,0.6,13.8,Matches,4.0,it ITA,GK,23.0,5.0,5.0,450.0,5.0,3.0,0.6,11.0,8.0,81.8,4.0,1.0,0.0,2.0,40.0,1.0,1.0,0.0,0.0,0.0,Matches,121.0,it ITA,GK,23.0,5.0,0.0,0.0,0.0,0.0,0.0,0.0,0.0,1.0,0.0,0.0,0.0,0.0,4.0,0.0,0.0,,Matches,121.0,it ITA,GK,23.0,5.0,195.0,156.0,39.0,11.0,0.0,0.0,0.0,0.0,0.0,0.0,0.0,0.0,148.0,0.0,0.0,Matches,121.0,it ITA,GK,23.0,5.0,148.0,195.0,75.9,3964.0,2708.0,27.0,27.0,100.0,71.0,71.0,100.0,49.0,96.0,51.0,0.0,0.0,0.0,0.0,0.0,1.0,0.0,0.0,0.0,Matches,158,it ITA,GK,23,5,450.0,90.0,13.2,5.0,5,90.0,5,0,,33,2.6,13.0,3.0,10.0,2.0,2.0,8.5,4.1,4.4,0.88,0.66,Matches,121.0,it ITA,GK,23.0,5.0,202.0,165.0,201.0,1.0,0.0,0.0,202.0,0.0,0.0,,0.0,,123.0,615.0,370.0,0.0,0.0,0.0,0.0,0.0,121.0,0.0,Matches,121.0,it ITA,GK,23.0,5.0,0.0,0.0,0.0,,0.0,0.0,,,,0.0,0.0,0.0,0.0,0.0,,0.0,0.0,Matches,121.0,it ITA,GK,23.0,5.0,5.0,450.0,5.0,0.0,0.0,0.0,0.0,0.0,0.0,0.0,0.0,0.0,0.0,0.0,0.0,0.0,0.0,0.0,0.0,0.0,0.0,0.0,0.0,0.0,0.0,0.0,0.0,0.0,Matches,Michele Cerofolini,GK,23,104,140,Italy,ACF Fiorentina,4,3,2,3,9,6,3,7,3,2,10,3,3,4,12,11,11,11,11,10,11,1,2,13,1,10,12,10,10,10,12,16,12,11,13,11,12,5,2,10,12,12,11,11,8,14,11,12,13,10,10,11,14,11,2,12,12,11,7,13,20,1,1,1,1,1,1,1,1,1,1,1,1,1,188,80,7,20,34547,5200,5250,3000,Mediterranean_Hispanic,101,1,1999/1/4,0,0,2885.0,,43252199
625,Federico Chiesa,Juventus,1997,122.0,it ITA,DFMF,24.0,9.5,22.0,11.0,6.0,6.0,10.0,5.0,14.0,35.7,9.0,13.0,1.0,12.0,0.0,22.0,1.0,0.0,Matches,122.0,it ITA,DFMF,24.0,9.5,41.0,4.34,26.0,3.0,7.0,3.0,1.0,1.0,6.0,0.63,5.0,0.0,1.0,0.0,0.0,0.0,Matches,,,,,,,,,,,,,,,,,,,,,,,,,,,,,,,,,,,,,,,,,,,,,,,,,,,,,,,,122.0,it ITA,DFMF,24.0,9.5,2.0,0.0,0.0,13.0,12.0,2.0,43.0,0.0,11.0,0.0,0.0,0.0,41.0,1.0,5.0,16.7,Matches,122.0,it ITA,DFMF,24.0,9.5,338.0,306.0,32.0,5.0,1.0,5.0,43.0,20.0,7.0,0.0,5.0,0.0,246.0,0.0,15.0,Matches,122.0,it ITA,DFMF,24.0,9.5,246.0,338.0,72.8,3806.0,1114.0,135.0,163.0,82.8,87.0,119.0,73.1,14.0,26.0,53.8,5.0,2.6,1.7,2.4,20.0,25.0,15.0,6.0,34.0,Matches,160,it ITA,DFMF,24,21,852.0,41.0,24.9,9.5,6,76.0,1,15,26.0,0,1.81,14.0,10.0,4.0,0.42,-0.24,14.9,10.0,4.9,0.52,0.21,Matches,122.0,it ITA,DFMF,24.0,9.5,476.0,4.0,56.0,166.0,265.0,49.0,476.0,45.0,24.0,53.3,19.0,42.2,293.0,2176.0,1193.0,46.0,28.0,16.0,26.0,19.0,331.0,88.0,Matches,122.0,it ITA,DFMF,24.0,9.5,2.0,26.0,3.0,11.5,2.75,0.32,0.08,0.67,18.9,1.0,0.0,0.0,1.5,1.5,0.06,0.5,0.5,Matches,122.0,it ITA,DFMF,24.0,21.0,6.0,852.0,9.5,2.0,5.0,7.0,2.0,0.0,0.0,2.0,0.0,1.5,1.5,2.6,4.1,46.0,34.0,88.0,0.21,0.53,0.74,0.21,0.74,0.15,0.27,0.43,0.15,0.43,Matches,Federico Chiesa,M/AM RL,24,156,167,Italy,Juventus,10,14,15,13,14,6,9,13,4,6,13,10,5,14,17,12,13,15,10,13,10,18,15,13,15,7,11,16,16,15,13,8,16,17,14,13,16,14,15,11,18,2,3,1,4,3,1,2,1,2,3,2,13,15,11,11,17,17,8,9,1,1,1,1,12,12,1,19,1,18,20,12,20,14,175,70,15,20,99000004,7800,7800,6850,Mediterranean_Hispanic,150,2,1997/10/25,37,4,178076.0,,43161651
626,Andrea Conti,Sampdoria,1994,132.0,it ITA,DF,28.0,0.3,0.0,0.0,0.0,0.0,0.0,0.0,0.0,,0.0,0.0,0.0,0.0,0.0,0.0,0.0,0.0,Matches,132.0,it ITA,DF,28.0,0.3,0.0,0.0,0.0,0.0,0.0,0.0,0.0,0.0,0.0,0.0,0.0,0.0,0.0,0.0,0.0,0.0,Matches,,,,,,,,,,,,,,,,,,,,,,,,,,,,,,,,,,,,,,,,,,,,,,,,,,,,,,,,132.0,it ITA,DF,28.0,0.3,0.0,0.0,0.0,0.0,1.0,1.0,0.0,0.0,0.0,0.0,0.0,0.0,1.0,0.0,0.0,,Matches,132.0,it ITA,DF,28.0,0.3,11.0,7.0,4.0,0.0,0.0,0.0,0.0,4.0,0.0,0.0,0.0,0.0,6.0,0.0,0.0,Matches,132.0,it ITA,DF,28.0,0.3,6.0,11.0,54.5,76.0,25.0,5.0,7.0,71.4,1.0,3.0,33.3,0.0,0.0,,0.0,0.0,0.0,0.0,0.0,0.0,0.0,0.0,1.0,Matches,179,it ITA,DF,28,1,23.0,23.0,0.7,0.3,0,,0,1,23.0,7,0.0,0.0,1.0,-1.0,-3.91,-2.69,0.0,0.2,-0.2,-0.71,0.14,Matches,132.0,it ITA,DF,28.0,0.3,11.0,0.0,0.0,8.0,3.0,0.0,11.0,0.0,0.0,,0.0,,4.0,10.0,5.0,0.0,0.0,0.0,0.0,1.0,6.0,2.0,Matches,132.0,it ITA,DF,28.0,0.3,0.0,0.0,0.0,,0.0,0.0,,,,0.0,0.0,0.0,0.0,0.0,,0.0,0.0,Matches,132.0,it ITA,DF,28.0,1.0,0.0,23.0,0.3,0.0,0.0,0.0,0.0,0.0,0.0,0.0,0.0,0.0,0.0,0.0,0.0,0.0,1.0,2.0,0.0,0.0,0.0,0.0,0.0,0.0,0.0,0.0,0.0,0.0,Matches,Andrea Conti,D/WB/M R,28,122,143,Italy,U.C. Sampdoria,7,13,13,7,11,6,10,9,12,13,13,7,12,13,13,12,13,12,10,9,12,13,8,10,15,13,13,13,13,13,12,12,11,13,13,12,12,15,12,15,12,3,2,1,1,1,3,4,1,2,3,1,10,13,4,12,12,13,12,11,1,1,1,20,1,20,1,1,1,16,1,1,10,1,184,76,12,20,1606434,6100,6100,5500,Mediterranean_Hispanic,119,2,1994/3/2,1,0,71154.0,,43081379
627,Alessandro Cortinovis,Hellas Verona,2001,136.0,it ITA,MF,21.0,0.1,1.0,0.0,1.0,0.0,0.0,0.0,0.0,,0.0,1.0,0.0,1.0,0.0,1.0,0.0,0.0,Matches,136.0,it ITA,MF,21.0,0.1,0.0,0.0,0.0,0.0,0.0,0.0,0.0,0.0,0.0,0.0,0.0,0.0,0.0,0.0,0.0,0.0,Matches,,,,,,,,,,,,,,,,,,,,,,,,,,,,,,,,,,,,,,,,,,,,,,,,,,,,,,,,136.0,it ITA,MF,21.0,0.1,0.0,0.0,0.0,0.0,0.0,0.0,1.0,0.0,0.0,0.0,0.0,0.0,0.0,0.0,3.0,0.0,Matches,136.0,it ITA,MF,21.0,0.1,6.0,6.0,0.0,0.0,0.0,0.0,1.0,0.0,0.0,0.0,0.0,0.0,5.0,0.0,0.0,Matches,136.0,it ITA,MF,21.0,0.1,5.0,6.0,83.3,77.0,35.0,3.0,3.0,100.0,2.0,2.0,100.0,0.0,1.0,0.0,0.0,0.0,0.0,0.0,0.0,0.0,2.0,1.0,2.0,Matches,184,it ITA,MF,21,1,6.0,6.0,0.2,0.1,0,,0,1,6.0,8,0.0,0.0,0.0,0.0,0.0,0.74,0.1,0.2,-0.1,-1.09,-0.72,Matches,136.0,it ITA,MF,21.0,0.1,8.0,0.0,3.0,0.0,5.0,0.0,8.0,0.0,0.0,,0.0,,5.0,10.0,4.0,0.0,0.0,0.0,0.0,0.0,5.0,2.0,Matches,136.0,it ITA,MF,21.0,0.1,0.0,0.0,0.0,,0.0,0.0,,,,0.0,0.0,0.0,0.0,0.0,,0.0,0.0,Matches,136.0,it ITA,MF,21.0,1.0,0.0,6.0,0.1,0.0,0.0,0.0,0.0,0.0,0.0,0.0,0.0,0.0,0.0,0.0,0.0,0.0,2.0,2.0,0.0,0.0,0.0,0.0,0.0,0.0,0.0,0.0,0.0,0.0,Matches,Alessandro Cortinovis,M/AM LC,21,112,142,Italy,Atalanta,7,11,15,10,15,9,7,10,5,6,12,8,7,14,17,13,11,11,11,13,12,16,15,9,13,5,12,14,12,14,12,9,16,12,11,8,10,9,13,6,14,2,1,3,3,1,1,1,2,1,1,2,14,16,5,13,12,15,13,13,1,1,1,1,1,1,1,12,18,1,17,20,13,10,180,74,10,20,2792999,5600,5600,3000,Mediterranean_Hispanic,110,2,2001/1/25,0,0,621.0,Hellas Verona,43372277
628,Alessio Cragno,Monza,1994,138.0,it ITA,GK,28.0,1.0,0.0,0.0,0.0,0.0,0.0,0.0,1.0,0.0,1.0,0.0,0.0,0.0,0.0,0.0,0.0,0.0,Matches,138.0,it ITA,GK,28.0,1.0,0.0,0.0,0.0,0.0,0.0,0.0,0.0,0.0,0.0,0.0,0.0,0.0,0.0,0.0,0.0,0.0,Matches,7.0,it ITA,GK,28.0,1.0,3.0,0.0,0.0,0.0,0.0,1.7,0.35,-1.3,-1.33,2.0,4.0,50.0,25.0,4.0,12.0,22.6,6.0,16.7,33.3,7.0,0.0,0.0,2.0,2.0,25.7,Matches,7.0,it ITA,GK,28.0,1.0,1.0,90.0,1.0,3.0,3.0,5.0,2.0,40.0,0.0,0.0,1.0,0.0,0.0,0.0,0.0,0.0,0.0,,Matches,138.0,it ITA,GK,28.0,1.0,0.0,0.0,0.0,0.0,0.0,0.0,0.0,0.0,0.0,0.0,0.0,0.0,2.0,0.0,0.0,,Matches,138.0,it ITA,GK,28.0,1.0,31.0,24.0,7.0,1.0,0.0,0.0,0.0,0.0,0.0,0.0,0.0,0.0,29.0,0.0,0.0,Matches,138.0,it ITA,GK,28.0,1.0,29.0,31.0,93.5,621.0,431.0,7.0,7.0,100.0,18.0,18.0,100.0,4.0,6.0,66.7,0.0,0.0,0.0,0.0,0.0,0.0,0.0,0.0,0.0,Matches,186,it ITA,GK,28,1,90.0,90.0,2.6,1.0,1,90.0,1,0,,37,0.0,0.0,3.0,-3.0,-3.0,-2.97,1.4,2.4,-1.1,-1.05,-0.93,Matches,138.0,it ITA,GK,28.0,1.0,32.0,26.0,32.0,0.0,0.0,0.0,32.0,0.0,0.0,,0.0,,19.0,101.0,61.0,0.0,0.0,0.0,0.0,0.0,17.0,0.0,Matches,138.0,it ITA,GK,28.0,1.0,0.0,0.0,0.0,,0.0,0.0,,,,0.0,0.0,0.0,0.0,0.0,,0.0,0.0,Matches,138.0,it ITA,GK,28.0,1.0,1.0,90.0,1.0,0.0,0.0,0.0,0.0,0.0,0.0,0.0,0.0,0.0,0.0,0.0,0.0,0.0,0.0,0.0,0.0,0.0,0.0,0.0,0.0,0.0,0.0,0.0,0.0,0.0,Matches,Alessio Cragno,GK,28,128,146,Italy,Cagliari Calcio,4,3,5,2,6,2,5,1,3,1,8,2,2,9,10,11,12,13,14,5,12,14,2,10,2,15,10,10,12,13,12,12,14,8,10,8,14,4,14,14,1,13,15,14,13,15,12,14,16,12,11,10,12,15,2,15,14,15,14,12,20,1,1,1,1,1,1,1,1,1,1,1,1,1,184,78,8,20,2889943,6240,6740,5990,Mediterranean_Hispanic,126,4,1994/6/28,2,0,35577.0,Brianza,43092903
629,Domen Črnigoj,Salernitana,1995,140.0,si SVN,MF,26.0,3.3,8.0,3.0,0.0,7.0,1.0,1.0,2.0,50.0,1.0,9.0,1.0,8.0,9.0,17.0,6.0,0.0,Matches,140.0,si SVN,MF,26.0,3.3,6.0,1.83,4.0,0.0,0.0,1.0,0.0,1.0,0.0,0.0,0.0,0.0,0.0,0.0,0.0,0.0,Matches,,,,,,,,,,,,,,,,,,,,,,,,,,,,,,,,,,,,,,,,,,,,,,,,,,,,,,,,140.0,si SVN,MF,26.0,3.3,1.0,0.0,0.0,6.0,2.0,0.0,0.0,9.0,3.0,0.0,0.0,0.0,21.0,5.0,7.0,41.7,Matches,140.0,si SVN,MF,26.0,3.3,111.0,110.0,1.0,1.0,0.0,0.0,0.0,0.0,0.0,0.0,0.0,0.0,79.0,0.0,4.0,Matches,140.0,si SVN,MF,26.0,3.3,79.0,111.0,71.2,1189.0,263.0,42.0,55.0,76.4,31.0,36.0,86.1,4.0,10.0,40.0,0.0,0.4,0.6,-0.4,2.0,8.0,0.0,0.0,3.0,Matches,188,si SVN,MF,26,7,296.0,42.0,8.7,3.3,4,60.0,0,3,19.0,3,1.14,1.0,3.0,-2.0,-0.61,-0.26,2.0,5.3,-3.3,-1.0,-0.21,Matches,140.0,si SVN,MF,26.0,3.3,160.0,5.0,36.0,95.0,32.0,6.0,160.0,4.0,2.0,50.0,2.0,50.0,64.0,255.0,71.0,2.0,2.0,1.0,13.0,1.0,89.0,9.0,Matches,140.0,si SVN,MF,26.0,3.3,0.0,1.0,0.0,0.0,0.3,0.0,0.0,,6.9,0.0,0.0,0.0,0.1,0.1,0.1,-0.1,-0.1,Matches,140.0,si SVN,MF,26.0,7.0,4.0,296.0,3.3,0.0,0.0,0.0,0.0,0.0,0.0,1.0,0.0,0.1,0.1,0.4,0.5,2.0,3.0,9.0,0.0,0.0,0.0,0.0,0.0,0.03,0.13,0.16,0.03,0.16,Matches,Domen Črnigoj,M RC,26,122,130,Slovenia,Venezia Football Club,7,12,13,12,13,7,12,13,4,10,13,10,12,14,15,13,15,12,13,12,13,16,16,9,14,11,14,13,13,12,12,12,14,12,13,13,14,14,11,10,12,3,3,4,3,3,1,1,1,2,2,3,15,15,10,14,10,14,14,12,1,1,1,1,1,1,1,1,20,17,1,15,13,1,187,73,9,20,2743013,6100,6500,4800,Northern_European,123,4,1995/11/18,24,3,5994.0,,62123347
630,Danilo D'Ambrosio,Inter,1988,144.0,it ITA,DF,33.0,8.1,25.0,17.0,17.0,7.0,1.0,15.0,27.0,55.6,12.0,12.0,4.0,8.0,10.0,35.0,17.0,0.0,Matches,144.0,it ITA,DF,33.0,8.1,17.0,2.09,14.0,0.0,1.0,1.0,1.0,0.0,2.0,0.25,2.0,0.0,0.0,0.0,0.0,0.0,Matches,,,,,,,,,,,,,,,,,,,,,,,,,,,,,,,,,,,,,,,,,,,,,,,,,,,,,,,,144.0,it ITA,DF,33.0,8.1,3.0,1.0,0.0,16.0,11.0,0.0,9.0,10.0,17.0,1.0,0.0,0.0,39.0,8.0,9.0,47.1,Matches,144.0,it ITA,DF,33.0,8.1,557.0,530.0,26.0,13.0,0.0,2.0,9.0,13.0,0.0,0.0,0.0,0.0,493.0,1.0,2.0,Matches,144.0,it ITA,DF,33.0,8.1,493.0,557.0,88.5,8396.0,2823.0,212.0,222.0,95.5,246.0,270.0,91.1,26.0,51.0,51.0,2.0,0.7,0.6,1.3,7.0,26.0,5.0,1.0,34.0,Matches,194,it ITA,DF,33,15,733.0,49.0,21.4,8.1,8,72.0,3,7,23.0,17,1.8,19.0,12.0,7.0,0.86,0.12,15.6,10.5,5.1,0.62,-0.26,Matches,144.0,it ITA,DF,33.0,8.1,635.0,58.0,303.0,269.0,64.0,12.0,635.0,6.0,1.0,16.7,3.0,50.0,424.0,1843.0,988.0,8.0,7.0,2.0,7.0,2.0,467.0,17.0,Matches,144.0,it ITA,DF,33.0,8.1,0.0,3.0,2.0,66.7,0.37,0.25,0.0,0.0,8.4,0.0,0.0,0.0,0.3,0.3,0.09,-0.3,-0.3,Matches,144.0,it ITA,DF,33.0,15.0,8.0,733.0,8.1,0.0,2.0,2.0,0.0,0.0,0.0,3.0,1.0,0.3,0.3,0.7,0.9,8.0,34.0,17.0,0.0,0.25,0.25,0.0,0.25,0.03,0.08,0.11,0.03,0.11,Matches,Danilo D'Ambrosio,D/WB RC,33,138,146,Italy,FC Internazionale Milano,4,12,10,13,12,5,18,8,13,13,12,6,14,12,17,14,15,14,13,10,12,16,7,13,13,13,14,15,12,12,13,14,14,12,13,13,17,13,14,10,16,2,1,4,3,3,1,3,2,2,1,3,13,16,8,17,16,20,12,14,1,12,18,20,10,18,1,10,1,12,1,1,1,1,180,75,10,20,1245342,6900,6600,5750,Mediterranean_Hispanic,128,3,1988/9/9,6,0,71154.0,,1414241
631,Luca D'Andrea,Sassuolo,2004,145.0,it ITA,FW,17.0,3.5,4.0,0.0,2.0,1.0,1.0,1.0,4.0,25.0,3.0,2.0,0.0,2.0,1.0,5.0,1.0,0.0,Matches,145.0,it ITA,FW,17.0,3.5,16.0,4.56,12.0,1.0,2.0,1.0,0.0,0.0,1.0,0.28,1.0,0.0,0.0,0.0,0.0,0.0,Matches,,,,,,,,,,,,,,,,,,,,,,,,,,,,,,,,,,,,,,,,,,,,,,,,,,,,,,,,145.0,it ITA,FW,17.0,3.5,0.0,0.0,0.0,4.0,9.0,1.0,7.0,1.0,0.0,0.0,0.0,0.0,13.0,2.0,3.0,40.0,Matches,145.0,it ITA,FW,17.0,3.5,84.0,80.0,4.0,0.0,1.0,0.0,7.0,1.0,3.0,0.0,0.0,0.0,61.0,0.0,1.0,Matches,145.0,it ITA,FW,17.0,3.5,61.0,84.0,72.6,896.0,334.0,32.0,42.0,76.2,24.0,31.0,77.4,3.0,6.0,50.0,1.0,0.8,0.4,0.2,10.0,6.0,3.0,2.0,9.0,Matches,195,it ITA,FW,17,5,316.0,63.0,9.2,3.5,5,63.0,0,0,,16,1.4,2.0,4.0,-2.0,-0.57,-0.22,1.9,4.1,-2.2,-0.61,-0.73,Matches,145.0,it ITA,FW,17.0,3.5,129.0,0.0,17.0,61.0,53.0,12.0,129.0,12.0,4.0,33.3,6.0,50.0,81.0,535.0,314.0,11.0,4.0,5.0,11.0,7.0,91.0,29.0,Matches,145.0,it ITA,FW,17.0,3.5,0.0,7.0,3.0,42.9,1.99,0.85,0.0,0.0,17.0,0.0,0.0,0.0,0.3,0.3,0.04,-0.3,-0.3,Matches,145.0,it ITA,FW,17.0,5.0,5.0,316.0,3.5,0.0,1.0,1.0,0.0,0.0,0.0,0.0,0.0,0.3,0.3,0.8,1.1,11.0,9.0,29.0,0.0,0.28,0.28,0.0,0.28,0.08,0.23,0.31,0.08,0.31,Matches,Luca D'Andrea,AM RC,17,110,-75,Italy,U.S. Sassuolo,7,13,12,10,12,7,8,8,7,8,12,8,7,13,10,11,10,12,10,12,12,14,13,7,13,7,11,11,14,14,11,5,9,13,13,8,12,5,13,5,12,2,3,3,1,1,2,2,2,1,2,1,12,14,5,13,12,14,12,13,1,1,1,1,1,1,1,1,1,15,11,20,20,13,172,0,20,8,16799999,5498,5498,2498,Mediterranean_Hispanic,104,4,2004/9/6,0,0,4710.0,,2000024665
632,Juan David Cabal,Hellas Verona,2001,149.0,co COL,DF,21.0,4.9,10.0,6.0,7.0,3.0,0.0,7.0,12.0,58.3,5.0,8.0,5.0,3.0,13.0,23.0,12.0,0.0,Matches,149.0,co COL,DF,21.0,4.9,8.0,1.62,7.0,1.0,0.0,0.0,0.0,0.0,0.0,0.0,0.0,0.0,0.0,0.0,0.0,0.0,Matches,,,,,,,,,,,,,,,,,,,,,,,,,,,,,,,,,,,,,,,,,,,,,,,,,,,,,,,,149.0,co COL,DF,21.0,4.9,3.0,0.0,0.0,7.0,2.0,1.0,8.0,13.0,6.0,0.0,0.0,0.0,41.0,18.0,15.0,54.5,Matches,149.0,co COL,DF,21.0,4.9,223.0,209.0,14.0,7.0,0.0,7.0,8.0,7.0,0.0,0.0,0.0,0.0,166.0,0.0,7.0,Matches,149.0,co COL,DF,21.0,4.9,166.0,223.0,74.4,3165.0,1118.0,63.0,73.0,86.3,79.0,91.0,86.8,20.0,46.0,43.5,0.0,0.3,0.1,-0.3,2.0,15.0,3.0,2.0,17.0,Matches,201,co COL,DF,21,11,444.0,40.0,13.0,4.9,3,73.0,1,8,28.0,25,0.42,3.0,11.0,-8.0,-1.62,-1.02,4.7,9.0,-4.3,-0.88,-0.58,Matches,149.0,co COL,DF,21.0,4.9,279.0,29.0,134.0,136.0,16.0,1.0,279.0,4.0,3.0,75.0,0.0,0.0,139.0,642.0,358.0,4.0,5.0,0.0,4.0,3.0,141.0,8.0,Matches,149.0,co COL,DF,21.0,4.9,0.0,1.0,1.0,100.0,0.2,0.2,0.0,0.0,32.6,0.0,0.0,0.0,0.0,0.0,0.02,0.0,0.0,Matches,149.0,co COL,DF,21.0,11.0,3.0,444.0,4.9,0.0,0.0,0.0,0.0,0.0,0.0,3.0,0.0,0.0,0.0,0.3,0.3,4.0,17.0,8.0,0.0,0.0,0.0,0.0,0.0,0.0,0.06,0.06,0.0,0.06,Matches,Juan David Cabal,D C,21,117,149,Colombia,Hellas Verona,4,9,7,5,11,8,13,7,10,13,12,8,13,13,12,14,13,11,11,10,11,12,7,10,8,13,12,13,13,12,13,13,12,12,12,13,12,9,12,5,10,1,2,3,3,1,3,3,3,3,3,2,13,12,7,13,8,12,13,9,1,12,20,1,8,1,1,1,1,1,1,1,1,1,186,79,20,10,3492421,5850,5850,2300,African_Caribbean,117,15,2001/1/8,0,0,9178.0,,76064373
633,Lorenzo De Silvestri,Bologna,1988,155.0,it ITA,DF,34.0,7.5,3.0,2.0,2.0,0.0,1.0,3.0,7.0,42.9,4.0,6.0,5.0,1.0,3.0,6.0,20.0,0.0,Matches,155.0,it ITA,DF,34.0,7.5,11.0,1.47,11.0,0.0,0.0,0.0,0.0,0.0,0.0,0.0,0.0,0.0,0.0,0.0,0.0,0.0,Matches,,,,,,,,,,,,,,,,,,,,,,,,,,,,,,,,,,,,,,,,,,,,,,,,,,,,,,,,155.0,it ITA,DF,34.0,7.5,1.0,0.0,0.0,6.0,6.0,2.0,7.0,3.0,2.0,0.0,0.0,1.0,39.0,14.0,12.0,53.8,Matches,155.0,it ITA,DF,34.0,7.5,430.0,352.0,78.0,6.0,1.0,1.0,7.0,72.0,0.0,0.0,0.0,0.0,330.0,0.0,6.0,Matches,155.0,it ITA,DF,34.0,7.5,330.0,430.0,76.7,5002.0,2370.0,182.0,202.0,90.1,127.0,168.0,75.6,11.0,40.0,27.5,0.0,0.2,0.2,-0.2,6.0,29.0,4.0,1.0,31.0,Matches,208,it ITA,DF,34,15,672.0,45.0,19.6,7.5,6,76.0,3,9,24.0,17,1.27,10.0,11.0,-1.0,-0.13,-0.3,7.8,8.9,-1.0,-0.14,-0.01,Matches,155.0,it ITA,DF,34.0,7.5,484.0,27.0,172.0,237.0,81.0,7.0,484.0,4.0,2.0,50.0,1.0,25.0,261.0,1371.0,800.0,18.0,12.0,0.0,6.0,5.0,289.0,17.0,Matches,155.0,it ITA,DF,34.0,7.5,1.0,5.0,3.0,60.0,0.67,0.4,0.2,0.33,12.0,0.0,0.0,0.0,0.6,0.6,0.13,0.4,0.4,Matches,155.0,it ITA,DF,34.0,15.0,6.0,672.0,7.5,1.0,0.0,1.0,1.0,0.0,0.0,1.0,0.0,0.6,0.6,0.2,0.9,18.0,31.0,17.0,0.13,0.0,0.13,0.13,0.13,0.09,0.03,0.12,0.09,0.12,Matches,Lorenzo De Silvestri,D/WB/M R,34,127,144,Italy,Bologna FC 1909,8,12,10,9,11,4,15,6,15,12,11,4,11,11,14,13,16,14,12,8,13,18,8,12,13,13,17,16,14,12,14,14,14,14,12,13,14,14,12,9,12,1,1,1,1,1,1,1,1,1,1,1,13,18,12,11,12,18,14,14,1,9,13,20,8,20,1,7,1,17,1,1,1,1,186,84,9,20,320735,6350,6250,6100,Northern_European,125,4,1988/5/23,6,0,32115.0,,1401054
634,Diego Demme,Napoli,1991,160.0,de GER,MF,30.0,1.6,1.0,0.0,1.0,0.0,0.0,0.0,4.0,0.0,4.0,2.0,0.0,2.0,0.0,1.0,1.0,0.0,Matches,160.0,de GER,MF,30.0,1.6,3.0,1.85,3.0,0.0,0.0,0.0,0.0,0.0,1.0,0.62,1.0,0.0,0.0,0.0,0.0,0.0,Matches,,,,,,,,,,,,,,,,,,,,,,,,,,,,,,,,,,,,,,,,,,,,,,,,,,,,,,,,160.0,de GER,MF,30.0,1.6,0.0,0.0,0.0,2.0,3.0,0.0,0.0,0.0,0.0,0.0,0.0,0.0,5.0,2.0,1.0,66.7,Matches,160.0,de GER,MF,30.0,1.6,191.0,187.0,4.0,4.0,0.0,0.0,0.0,0.0,0.0,0.0,0.0,0.0,181.0,0.0,1.0,Matches,160.0,de GER,MF,30.0,1.6,181.0,191.0,94.8,3026.0,924.0,84.0,86.0,97.7,78.0,80.0,97.5,16.0,18.0,88.9,0.0,0.0,0.1,0.0,1.0,13.0,1.0,0.0,16.0,Matches,216,de GER,MF,30,7,146.0,21.0,4.3,1.6,2,54.0,0,5,8.0,24,2.71,1.0,0.0,1.0,0.62,-0.7,1.3,1.0,0.3,0.19,-0.71,Matches,160.0,de GER,MF,30.0,1.6,205.0,6.0,30.0,153.0,22.0,0.0,205.0,4.0,2.0,50.0,1.0,25.0,143.0,612.0,270.0,3.0,1.0,0.0,3.0,1.0,183.0,1.0,Matches,160.0,de GER,MF,30.0,1.6,0.0,0.0,0.0,,0.0,0.0,,,,0.0,0.0,0.0,0.0,0.0,,0.0,0.0,Matches,160.0,de GER,MF,30.0,7.0,2.0,146.0,1.6,0.0,0.0,0.0,0.0,0.0,0.0,0.0,0.0,0.0,0.0,0.0,0.0,3.0,16.0,1.0,0.0,0.0,0.0,0.0,0.0,0.0,0.01,0.01,0.0,0.01,Matches,Diego Demme,DM/M C,30,138,148,"Germany,Italy",Parthenope,10,11,10,8,12,8,9,11,7,14,15,10,17,12,17,13,17,13,14,11,12,17,8,11,12,14,16,18,12,14,14,6,13,11,14,13,12,11,12,11,13,2,1,1,2,3,3,3,2,2,1,2,16,14,5,13,13,17,12,8,1,1,1,1,10,1,20,10,20,10,1,1,1,1,170,68,10,20,6795608,6900,7000,5850,Mediterranean_Hispanic,136,5,1991/11/21,1,0,74038.0,,92023691
635,Fabio Depaoli,Sampdoria,1997,162.0,it ITA,DFMF,25.0,1.5,5.0,3.0,2.0,3.0,0.0,3.0,4.0,75.0,1.0,1.0,0.0,1.0,1.0,6.0,4.0,0.0,Matches,162.0,it ITA,DFMF,25.0,1.5,6.0,3.97,5.0,0.0,0.0,0.0,1.0,0.0,0.0,0.0,0.0,0.0,0.0,0.0,0.0,0.0,Matches,,,,,,,,,,,,,,,,,,,,,,,,,,,,,,,,,,,,,,,,,,,,,,,,,,,,,,,,162.0,it ITA,DFMF,25.0,1.5,1.0,0.0,0.0,1.0,7.0,0.0,8.0,1.0,3.0,0.0,0.0,0.0,6.0,0.0,2.0,0.0,Matches,162.0,it ITA,DFMF,25.0,1.5,95.0,75.0,20.0,1.0,1.0,0.0,8.0,19.0,0.0,0.0,0.0,0.0,74.0,0.0,1.0,Matches,162.0,it ITA,DFMF,25.0,1.5,74.0,95.0,77.9,1373.0,584.0,31.0,36.0,86.1,31.0,36.0,86.1,11.0,21.0,52.4,0.0,0.4,0.3,-0.4,4.0,6.0,4.0,4.0,10.0,Matches,218,it ITA,DFMF,25,3,136.0,45.0,4.0,1.5,1,90.0,1,2,23.0,1,0.33,0.0,5.0,-5.0,-3.31,-2.16,2.6,2.5,0.1,0.08,0.96,Matches,162.0,it ITA,DFMF,25.0,1.5,117.0,6.0,28.0,56.0,34.0,3.0,117.0,7.0,3.0,42.9,2.0,28.6,73.0,347.0,184.0,2.0,3.0,0.0,2.0,1.0,70.0,6.0,Matches,162.0,it ITA,DFMF,25.0,1.5,0.0,2.0,0.0,0.0,1.32,0.0,0.0,,13.6,0.0,0.0,0.0,0.2,0.2,0.09,-0.2,-0.2,Matches,162.0,it ITA,DFMF,25.0,3.0,1.0,136.0,1.5,0.0,0.0,0.0,0.0,0.0,0.0,1.0,0.0,0.2,0.2,0.4,0.6,2.0,10.0,6.0,0.0,0.0,0.0,0.0,0.0,0.12,0.26,0.38,0.12,0.38,Matches,Fabio Depaoli,D/WB/M R,25,128,136,Italy,U.C. Sampdoria,10,13,10,7,12,8,9,10,14,10,12,9,12,13,14,11,10,10,13,12,13,15,13,10,12,12,13,14,13,14,14,6,14,14,15,10,14,8,11,5,16,2,2,2,1,2,1,3,2,3,3,1,12,13,13,13,13,16,14,13,1,10,1,20,12,20,1,10,1,19,1,1,12,1,178,71,11,20,2821337,6400,6400,4600,Mediterranean_Hispanic,121,4,1997/4/24,0,0,10672.0,Hellas Verona,43161628
636,Kastriot Dermaku,Lecce,1992,163.0,al ALB,DF,30.0,0.4,0.0,0.0,0.0,0.0,0.0,0.0,0.0,,0.0,0.0,0.0,0.0,0.0,0.0,0.0,0.0,Matches,163.0,al ALB,DF,30.0,0.4,0.0,0.0,0.0,0.0,0.0,0.0,0.0,0.0,0.0,0.0,0.0,0.0,0.0,0.0,0.0,0.0,Matches,,,,,,,,,,,,,,,,,,,,,,,,,,,,,,,,,,,,,,,,,,,,,,,,,,,,,,,,163.0,al ALB,DF,30.0,0.4,0.0,0.0,0.0,0.0,0.0,0.0,0.0,0.0,0.0,0.0,0.0,0.0,0.0,0.0,0.0,,Matches,163.0,al ALB,DF,30.0,0.4,2.0,2.0,0.0,0.0,0.0,0.0,0.0,0.0,0.0,0.0,0.0,0.0,1.0,0.0,0.0,Matches,163.0,al ALB,DF,30.0,0.4,1.0,2.0,50.0,27.0,0.0,0.0,0.0,,1.0,2.0,50.0,0.0,0.0,,0.0,0.0,0.0,0.0,0.0,0.0,0.0,0.0,0.0,Matches,219,al ALB,DF,30,1,34.0,34.0,1.0,0.4,0,,0,1,34.0,5,1.0,0.0,1.0,-1.0,-2.65,-2.33,0.1,1.1,-1.0,-2.7,-2.57,Matches,163.0,al ALB,DF,30.0,0.4,2.0,0.0,0.0,2.0,0.0,0.0,2.0,0.0,0.0,,0.0,,0.0,0.0,0.0,0.0,0.0,0.0,0.0,0.0,0.0,0.0,Matches,163.0,al ALB,DF,30.0,0.4,0.0,0.0,0.0,,0.0,0.0,,,,0.0,0.0,0.0,0.0,0.0,,0.0,0.0,Matches,163.0,al ALB,DF,30.0,1.0,0.0,34.0,0.4,0.0,0.0,0.0,0.0,0.0,0.0,0.0,0.0,0.0,0.0,0.0,0.0,0.0,0.0,0.0,0.0,0.0,0.0,0.0,0.0,0.0,0.0,0.0,0.0,0.0,Matches,Kastriot Dermaku,D C,30,121,130,"Albania,Italy",Salento,7,7,7,8,9,5,15,8,5,13,11,7,13,8,12,13,13,13,13,8,13,13,5,10,4,13,10,12,11,10,13,17,14,11,15,15,12,8,10,5,5,2,3,3,3,1,3,1,3,3,3,4,11,13,7,9,10,13,9,13,1,1,20,1,1,1,1,1,1,1,1,1,1,5,194,90,7,20,1536324,6050,6300,4750,Mediterranean_Hispanic,119,4,1992/1/15,13,1,2500.0,,43072400
637,Sergiño Dest,Milan,2000,165.0,us USA,DF,21.0,3.7,12.0,6.0,3.0,5.0,4.0,3.0,4.0,75.0,1.0,1.0,0.0,1.0,4.0,16.0,2.0,0.0,Matches,165.0,us USA,DF,21.0,3.7,11.0,3.0,8.0,2.0,1.0,0.0,0.0,0.0,1.0,0.27,1.0,0.0,0.0,0.0,0.0,0.0,Matches,,,,,,,,,,,,,,,,,,,,,,,,,,,,,,,,,,,,,,,,,,,,,,,,,,,,,,,,165.0,us USA,DF,21.0,3.7,0.0,0.0,0.0,6.0,4.0,0.0,4.0,4.0,6.0,0.0,1.0,0.0,29.0,3.0,1.0,75.0,Matches,165.0,us USA,DF,21.0,3.7,198.0,154.0,44.0,1.0,0.0,1.0,4.0,43.0,0.0,0.0,0.0,0.0,169.0,0.0,5.0,Matches,165.0,us USA,DF,21.0,3.7,169.0,198.0,85.4,2535.0,793.0,95.0,102.0,93.1,65.0,73.0,89.0,5.0,12.0,41.7,0.0,0.3,0.2,-0.3,4.0,15.0,3.0,1.0,14.0,Matches,221,us USA,DF,21,8,329.0,41.0,9.6,3.7,2,68.0,1,6,32.0,7,1.63,10.0,7.0,3.0,0.82,0.3,6.1,5.7,0.4,0.11,-0.39,Matches,165.0,us USA,DF,21.0,3.7,246.0,7.0,75.0,116.0,61.0,3.0,246.0,18.0,8.0,44.4,9.0,50.0,134.0,827.0,470.0,11.0,3.0,0.0,3.0,5.0,137.0,12.0,Matches,165.0,us USA,DF,21.0,3.7,0.0,2.0,1.0,50.0,0.55,0.27,0.0,0.0,20.3,0.0,0.0,0.0,0.3,0.3,0.15,-0.3,-0.3,Matches,165.0,us USA,DF,21.0,8.0,2.0,329.0,3.7,0.0,0.0,0.0,0.0,0.0,0.0,0.0,0.0,0.3,0.3,0.3,0.6,11.0,14.0,12.0,0.0,0.0,0.0,0.0,0.0,0.08,0.09,0.17,0.08,0.17,Matches,Sergiño Dest,D/WB RL,21,140,155,"United States,Holland",Barcelona,8,14,14,8,14,8,8,10,12,11,13,9,13,14,11,12,13,11,11,12,11,16,15,10,15,11,13,14,15,16,11,7,12,15,13,8,12,10,9,9,14,2,3,1,3,1,3,1,2,2,2,1,15,14,8,10,14,14,13,10,1,18,1,20,18,19,1,12,1,14,12,1,12,1,171,62,12,20,24420000,6995,6995,5995,African_Caribbean,125,8,2000/11/3,17,2,76923.0,AC Milan,37065767
638,Mattia Destro,Empoli,1991,166.0,it ITA,FWMF,31.0,6.4,1.0,1.0,0.0,1.0,0.0,0.0,0.0,,0.0,2.0,0.0,2.0,1.0,2.0,5.0,0.0,Matches,166.0,it ITA,FWMF,31.0,6.4,11.0,1.73,5.0,0.0,3.0,1.0,2.0,0.0,1.0,0.16,1.0,0.0,0.0,0.0,0.0,0.0,Matches,,,,,,,,,,,,,,,,,,,,,,,,,,,,,,,,,,,,,,,,,,,,,,,,,,,,,,,,166.0,it ITA,FWMF,31.0,6.4,3.0,0.0,0.0,12.0,5.0,7.0,2.0,1.0,1.0,0.0,1.0,0.0,9.0,8.0,20.0,28.6,Matches,166.0,it ITA,FWMF,31.0,6.4,79.0,74.0,5.0,0.0,0.0,0.0,2.0,0.0,0.0,0.0,0.0,0.0,44.0,0.0,5.0,Matches,166.0,it ITA,FWMF,31.0,6.4,44.0,79.0,55.7,518.0,127.0,32.0,45.0,71.1,6.0,19.0,31.6,3.0,5.0,60.0,0.0,0.4,0.3,-0.4,4.0,1.0,2.0,0.0,4.0,Matches,222,it ITA,FWMF,31,17,572.0,34.0,16.7,6.4,6,63.0,1,11,18.0,5,1.06,5.0,11.0,-6.0,-0.94,-0.75,6.5,10.8,-4.3,-0.68,-0.2,Matches,166.0,it ITA,FWMF,31.0,6.4,139.0,6.0,12.0,59.0,68.0,26.0,139.0,8.0,4.0,50.0,4.0,50.0,79.0,286.0,108.0,4.0,1.0,3.0,14.0,5.0,102.0,20.0,Matches,166.0,it ITA,FWMF,31.0,6.4,1.0,20.0,7.0,35.0,3.15,1.1,0.05,0.14,14.8,0.0,0.0,0.0,1.4,1.4,0.07,-0.4,-0.4,Matches,166.0,it ITA,FWMF,31.0,17.0,6.0,572.0,6.4,1.0,0.0,1.0,1.0,0.0,0.0,3.0,0.0,1.4,1.4,0.4,1.8,4.0,4.0,20.0,0.16,0.0,0.16,0.16,0.16,0.22,0.06,0.28,0.22,0.28,Matches,Mattia Destro,S,31,126,145,Italy,Empoli Football Club,5,8,11,13,12,8,14,11,5,6,11,14,7,13,12,14,15,14,12,11,13,17,13,13,16,7,13,15,12,12,13,13,13,13,12,13,12,12,13,12,7,3,1,3,1,3,4,2,2,2,1,3,14,14,8,13,10,14,12,12,1,1,1,1,1,1,1,1,1,1,5,1,5,20,182,80,11,20,2042496,6300,6300,5100,Mediterranean_Hispanic,126,1,1991/3/20,8,1,19567.0,,43008779
639,Festy Ebosele,Udinese,2002,188.0,ie IRL,DF,19.0,4.6,15.0,10.0,8.0,7.0,0.0,4.0,10.0,40.0,6.0,5.0,0.0,5.0,2.0,17.0,5.0,0.0,Matches,188.0,ie IRL,DF,19.0,4.6,11.0,2.41,8.0,0.0,2.0,0.0,0.0,1.0,2.0,0.44,2.0,0.0,0.0,0.0,0.0,0.0,Matches,,,,,,,,,,,,,,,,,,,,,,,,,,,,,,,,,,,,,,,,,,,,,,,,,,,,,,,,188.0,ie IRL,DF,19.0,4.6,4.0,0.0,0.0,11.0,7.0,0.0,16.0,2.0,10.0,0.0,0.0,0.0,36.0,6.0,4.0,60.0,Matches,188.0,ie IRL,DF,19.0,4.6,151.0,137.0,14.0,1.0,1.0,0.0,16.0,13.0,0.0,0.0,0.0,0.0,101.0,0.0,6.0,Matches,188.0,ie IRL,DF,19.0,4.6,101.0,151.0,66.9,1691.0,748.0,52.0,64.0,81.3,39.0,56.0,69.6,9.0,17.0,52.9,1.0,0.9,0.5,0.1,5.0,9.0,9.0,5.0,17.0,Matches,247,ie IRL,DF,19,17,411.0,24.0,12.0,4.6,4,65.0,0,13,12.0,18,1.06,3.0,5.0,-2.0,-0.44,-0.47,4.4,5.6,-1.2,-0.26,-0.15,Matches,188.0,ie IRL,DF,19.0,4.6,233.0,16.0,64.0,82.0,97.0,13.0,233.0,36.0,19.0,52.8,13.0,36.1,129.0,1242.0,644.0,27.0,18.0,6.0,17.0,9.0,125.0,22.0,Matches,188.0,ie IRL,DF,19.0,4.6,0.0,4.0,1.0,25.0,0.88,0.22,0.0,0.0,21.5,0.0,0.0,0.0,0.2,0.2,0.05,-0.2,-0.2,Matches,188.0,ie IRL,DF,19.0,17.0,4.0,411.0,4.6,0.0,1.0,1.0,0.0,0.0,0.0,4.0,0.0,0.2,0.2,0.9,1.1,27.0,17.0,22.0,0.0,0.22,0.22,0.0,0.22,0.04,0.19,0.24,0.04,0.24,Matches,Festy Ebosele,D/WB/AM R,19,108,-75,"Republic of Ireland,Nigeria",Udinese Calcio,6,9,10,6,10,7,9,4,14,7,10,6,8,10,13,10,12,8,6,8,8,13,9,7,8,6,9,10,16,10,9,10,9,18,11,14,10,13,10,11,12,3,2,1,1,1,1,4,1,2,2,1,15,16,11,12,12,9,8,11,1,12,1,18,14,20,1,9,1,15,11,1,17,11,180,64,8,20,19680000,5400,5250,2750,African_Caribbean,85,19,2002/8/2,0,0,4048.0,,29216094
640,Gonzalo Escalante,Cremonese,1993,198.0,ar ARG,MF,29.0,6.2,16.0,8.0,8.0,8.0,0.0,10.0,13.0,76.9,3.0,7.0,1.0,6.0,10.0,26.0,4.0,0.0,Matches,198.0,ar ARG,MF,29.0,6.2,10.0,1.62,8.0,0.0,0.0,1.0,1.0,0.0,0.0,0.0,0.0,0.0,0.0,0.0,0.0,0.0,Matches,,,,,,,,,,,,,,,,,,,,,,,,,,,,,,,,,,,,,,,,,,,,,,,,,,,,,,,,198.0,ar ARG,MF,29.0,6.2,0.0,1.0,0.0,6.0,5.0,0.0,1.0,10.0,8.0,0.0,0.0,0.0,39.0,9.0,9.0,50.0,Matches,198.0,ar ARG,MF,29.0,6.2,290.0,279.0,8.0,4.0,0.0,1.0,1.0,0.0,0.0,0.0,0.0,0.0,222.0,3.0,8.0,Matches,198.0,ar ARG,MF,29.0,6.2,222.0,290.0,76.6,3755.0,1430.0,99.0,117.0,84.6,103.0,122.0,84.4,16.0,36.0,44.4,1.0,0.2,0.1,0.8,4.0,30.0,2.0,0.0,30.0,Matches,258,ar ARG,MF,29,9,555.0,62.0,16.2,6.2,7,72.0,3,2,27.0,5,0.44,3.0,13.0,-10.0,-1.62,-0.9,3.8,11.6,-7.7,-1.26,-0.64,Matches,198.0,ar ARG,MF,29.0,6.2,352.0,16.0,103.0,199.0,56.0,7.0,352.0,5.0,1.0,20.0,3.0,60.0,174.0,660.0,341.0,3.0,4.0,0.0,7.0,7.0,226.0,8.0,Matches,198.0,ar ARG,MF,29.0,6.2,0.0,6.0,1.0,16.7,0.97,0.16,0.0,0.0,17.9,0.0,0.0,0.0,0.2,0.2,0.03,-0.2,-0.2,Matches,198.0,ar ARG,MF,29.0,9.0,7.0,555.0,6.2,0.0,1.0,1.0,0.0,0.0,0.0,0.0,1.0,0.2,0.2,0.2,0.4,3.0,30.0,8.0,0.0,0.16,0.16,0.0,0.16,0.03,0.04,0.07,0.03,0.07,Matches,Gonzalo Escalante,DM/M C,29,128,145,"Argentina,Italy",S.S. Lazio,8,9,10,10,13,10,13,13,3,12,13,8,15,11,16,15,15,13,14,11,12,15,9,10,12,15,15,14,13,12,13,11,13,13,14,12,13,16,12,9,13,2,1,3,1,2,3,2,3,2,2,1,14,15,5,13,14,18,16,14,1,1,1,1,1,1,20,1,20,14,1,1,1,1,183,75,8,20,2167865,6400,6000,5300,Native_American,129,5,1993/3/27,0,0,40922.0,Cremonese,14024699
641,Alex Ferrari,Sampdoria,1994,206.0,it ITA,DF,28.0,9.6,9.0,5.0,7.0,2.0,0.0,4.0,8.0,50.0,4.0,21.0,10.0,11.0,19.0,28.0,25.0,0.0,Matches,206.0,it ITA,DF,28.0,9.6,4.0,0.41,3.0,0.0,0.0,1.0,0.0,0.0,0.0,0.0,0.0,0.0,0.0,0.0,0.0,0.0,Matches,,,,,,,,,,,,,,,,,,,,,,,,,,,,,,,,,,,,,,,,,,,,,,,,,,,,,,,,206.0,it ITA,DF,28.0,9.6,3.0,0.0,0.0,12.0,7.0,0.0,4.0,19.0,5.0,0.0,1.0,0.0,62.0,21.0,15.0,58.3,Matches,206.0,it ITA,DF,28.0,9.6,456.0,433.0,23.0,21.0,0.0,3.0,4.0,2.0,0.0,0.0,0.0,0.0,384.0,0.0,8.0,Matches,206.0,it ITA,DF,28.0,9.6,384.0,456.0,84.2,7605.0,2387.0,114.0,126.0,90.5,220.0,242.0,90.9,41.0,67.0,61.2,0.0,0.4,0.6,-0.4,3.0,17.0,1.0,0.0,25.0,Matches,271,it ITA,DF,28,12,868.0,72.0,25.4,9.6,10,83.0,7,2,20.0,3,0.17,4.0,18.0,-14.0,-1.45,-0.29,8.0,14.4,-6.3,-0.66,0.25,Matches,206.0,it ITA,DF,28.0,9.6,560.0,51.0,276.0,265.0,25.0,5.0,560.0,6.0,3.0,50.0,3.0,50.0,304.0,1591.0,849.0,7.0,1.0,0.0,10.0,3.0,308.0,3.0,Matches,206.0,it ITA,DF,28.0,9.6,0.0,5.0,0.0,0.0,0.52,0.0,0.0,,20.0,0.0,0.0,0.0,0.2,0.2,0.04,-0.2,-0.2,Matches,206.0,it ITA,DF,28.0,12.0,10.0,868.0,9.6,0.0,0.0,0.0,0.0,0.0,0.0,3.0,0.0,0.2,0.2,0.4,0.5,7.0,25.0,3.0,0.0,0.0,0.0,0.0,0.0,0.02,0.04,0.06,0.02,0.06,Matches,Alex Ferrari,D RC,28,125,130,Italy,U.C. Sampdoria,4,10,10,4,12,4,15,4,4,13,12,4,15,11,11,13,12,12,11,11,12,13,12,10,10,15,13,13,12,12,13,15,12,12,12,13,14,10,10,12,11,2,3,1,3,1,1,4,3,1,3,2,11,12,8,11,12,8,8,10,1,12,20,18,1,1,1,1,1,1,1,1,1,1,191,80,10,20,2194749,6250,6250,4350,Mediterranean_Hispanic,124,2,1994/7/1,0,0,14230.0,,43093049
642,Alessandro Florenzi,Milan,1991,210.0,it ITA,DF,31.0,2.3,6.0,4.0,3.0,2.0,1.0,4.0,7.0,57.1,3.0,1.0,0.0,1.0,4.0,10.0,2.0,0.0,Matches,210.0,it ITA,DF,31.0,2.3,9.0,4.01,4.0,3.0,0.0,1.0,1.0,0.0,0.0,0.0,0.0,0.0,0.0,0.0,0.0,0.0,Matches,,,,,,,,,,,,,,,,,,,,,,,,,,,,,,,,,,,,,,,,,,,,,,,,,,,,,,,,210.0,it ITA,DF,31.0,2.3,1.0,0.0,0.0,2.0,1.0,0.0,22.0,4.0,4.0,0.0,0.0,0.0,14.0,1.0,0.0,100.0,Matches,210.0,it ITA,DF,31.0,2.3,172.0,136.0,35.0,7.0,0.0,1.0,22.0,22.0,6.0,2.0,4.0,0.0,130.0,1.0,0.0,Matches,210.0,it ITA,DF,31.0,2.3,130.0,172.0,75.6,2370.0,661.0,52.0,57.0,91.2,64.0,78.0,82.1,12.0,34.0,35.3,0.0,0.5,1.1,-0.5,6.0,8.0,6.0,5.0,10.0,Matches,278,it ITA,DF,31,6,203.0,34.0,5.9,2.3,2,73.0,1,4,14.0,8,1.33,3.0,1.0,2.0,0.89,0.36,4.1,1.9,2.2,0.99,0.56,Matches,210.0,it ITA,DF,31.0,2.3,195.0,3.0,42.0,82.0,71.0,10.0,195.0,1.0,0.0,0.0,1.0,100.0,103.0,340.0,129.0,1.0,1.0,0.0,3.0,0.0,113.0,19.0,Matches,210.0,it ITA,DF,31.0,2.3,0.0,5.0,1.0,20.0,2.22,0.44,0.0,0.0,16.2,1.0,0.0,0.0,0.8,0.8,0.15,-0.8,-0.8,Matches,210.0,it ITA,DF,31.0,6.0,2.0,203.0,2.3,0.0,0.0,0.0,0.0,0.0,0.0,1.0,0.0,0.8,0.8,0.5,1.2,1.0,10.0,19.0,0.0,0.0,0.0,0.0,0.0,0.34,0.21,0.54,0.34,0.54,Matches,Alessandro Florenzi,D/WB/M R,31,145,154,Italy,AC Milan,13,13,13,10,14,14,9,14,10,13,13,11,12,14,14,13,15,13,14,12,13,16,12,14,14,12,16,14,14,15,11,8,16,14,13,9,14,8,15,12,20,1,2,1,3,3,3,1,3,1,3,3,10,15,8,18,14,16,18,13,1,11,1,20,10,20,1,9,13,18,8,7,15,1,173,67,11,20,347975206,7250,7250,6200,Mediterranean_Hispanic,136,3,1991/3/11,49,2,71154.0,,43041177
643,Matteo Gabbia,Milan,1999,212.0,it ITA,DF,22.0,6.8,17.0,10.0,12.0,5.0,0.0,6.0,8.0,75.0,2.0,8.0,3.0,5.0,5.0,22.0,29.0,0.0,Matches,212.0,it ITA,DF,22.0,6.8,4.0,0.59,4.0,0.0,0.0,0.0,0.0,0.0,0.0,0.0,0.0,0.0,0.0,0.0,0.0,0.0,Matches,,,,,,,,,,,,,,,,,,,,,,,,,,,,,,,,,,,,,,,,,,,,,,,,,,,,,,,,212.0,it ITA,DF,22.0,6.8,2.0,0.0,0.0,8.0,1.0,0.0,2.0,5.0,10.0,0.0,0.0,0.0,37.0,15.0,4.0,78.9,Matches,212.0,it ITA,DF,22.0,6.8,359.0,346.0,13.0,7.0,0.0,1.0,2.0,1.0,0.0,0.0,0.0,0.0,289.0,0.0,2.0,Matches,212.0,it ITA,DF,22.0,6.8,289.0,359.0,80.5,6382.0,2047.0,78.0,92.0,84.8,147.0,163.0,90.2,59.0,91.0,64.8,0.0,0.0,0.0,0.0,0.0,14.0,0.0,0.0,15.0,Matches,283,it ITA,DF,22,12,613.0,51.0,17.9,6.8,6,87.0,5,6,16.0,24,1.92,11.0,14.0,-3.0,-0.44,-1.21,10.3,10.4,-0.1,-0.02,-0.59,Matches,212.0,it ITA,DF,22.0,6.8,427.0,54.0,258.0,163.0,7.0,1.0,427.0,0.0,0.0,,0.0,,187.0,827.0,398.0,1.0,0.0,1.0,1.0,0.0,248.0,1.0,Matches,212.0,it ITA,DF,22.0,6.8,0.0,1.0,0.0,0.0,0.15,0.0,0.0,,19.8,0.0,0.0,0.0,0.0,0.0,0.04,0.0,0.0,Matches,212.0,it ITA,DF,22.0,12.0,6.0,613.0,6.8,0.0,0.0,0.0,0.0,0.0,0.0,2.0,0.0,0.0,0.0,0.0,0.0,1.0,15.0,1.0,0.0,0.0,0.0,0.0,0.0,0.01,0.0,0.01,0.01,0.01,Matches,Matteo Gabbia,D C,22,130,159,Italy,AC Milan,3,7,7,6,11,7,13,8,12,14,13,8,14,12,12,13,12,13,14,11,13,14,6,11,9,13,14,16,13,12,15,14,14,12,14,14,14,12,10,8,12,1,3,3,1,3,2,2,1,2,1,4,12,14,3,14,13,14,16,13,1,1,20,1,1,1,11,1,10,1,1,1,1,1,185,78,9,20,13690000,6500,6250,4750,Mediterranean_Hispanic,130,2,1999/10/21,0,0,28461.0,,43266774
644,Gianluca Gaetano,Napoli,2000,214.0,it ITA,MF,22.0,0.8,5.0,3.0,1.0,3.0,1.0,0.0,0.0,,0.0,1.0,0.0,1.0,1.0,6.0,0.0,0.0,Matches,214.0,it ITA,MF,22.0,0.8,5.0,6.62,4.0,0.0,0.0,1.0,0.0,0.0,1.0,1.32,1.0,0.0,0.0,0.0,0.0,0.0,Matches,,,,,,,,,,,,,,,,,,,,,,,,,,,,,,,,,,,,,,,,,,,,,,,,,,,,,,,,214.0,it ITA,MF,22.0,0.8,0.0,0.0,0.0,2.0,1.0,0.0,1.0,1.0,3.0,0.0,0.0,0.0,6.0,0.0,0.0,,Matches,214.0,it ITA,MF,22.0,0.8,62.0,58.0,2.0,2.0,0.0,0.0,1.0,0.0,0.0,0.0,0.0,0.0,48.0,2.0,1.0,Matches,214.0,it ITA,MF,22.0,0.8,48.0,62.0,77.4,655.0,152.0,28.0,29.0,96.6,14.0,20.0,70.0,3.0,4.0,75.0,1.0,0.2,0.1,0.8,1.0,3.0,0.0,0.0,4.0,Matches,285,it ITA,MF,22,8,76.0,10.0,2.2,0.8,0,,0,8,10.0,25,2.75,4.0,0.0,4.0,4.74,3.53,2.1,0.5,1.6,2.13,1.29,Matches,214.0,it ITA,MF,22.0,0.8,79.0,0.0,3.0,39.0,38.0,8.0,79.0,3.0,2.0,66.7,0.0,0.0,53.0,240.0,123.0,4.0,2.0,2.0,2.0,4.0,64.0,9.0,Matches,214.0,it ITA,MF,22.0,0.8,1.0,7.0,5.0,71.4,8.29,5.92,0.14,0.2,18.3,0.0,0.0,0.0,1.1,1.1,0.15,-0.1,-0.1,Matches,214.0,it ITA,MF,22.0,8.0,0.0,76.0,0.8,1.0,1.0,2.0,1.0,0.0,0.0,0.0,0.0,1.1,1.1,0.2,1.2,4.0,4.0,9.0,1.18,1.18,2.37,1.18,2.37,1.42,0.22,1.64,1.42,1.64,Matches,Gianluca Gaetano,M/AM RLC,22,123,149,Italy,Parthenope,13,12,15,12,14,13,7,12,6,6,13,13,7,14,9,13,8,9,8,13,11,14,14,7,14,9,14,12,13,14,11,8,15,13,15,10,12,4,10,4,15,2,2,3,3,1,2,1,2,2,4,1,10,14,3,11,10,12,13,12,1,1,1,1,1,1,1,15,20,15,15,19,15,10,183,74,10,20,5685000,6150,6050,4750,Mediterranean_Hispanic,116,2,2000/5/5,0,0,14230.0,,43317758
645,Roberto Gagliardini,Inter,1994,215.0,it ITA,MF,28.0,8.7,16.0,6.0,9.0,6.0,1.0,10.0,21.0,47.6,11.0,14.0,5.0,9.0,4.0,20.0,15.0,0.0,Matches,215.0,it ITA,MF,28.0,8.7,19.0,2.18,17.0,0.0,0.0,1.0,1.0,0.0,1.0,0.11,0.0,0.0,0.0,1.0,0.0,0.0,Matches,,,,,,,,,,,,,,,,,,,,,,,,,,,,,,,,,,,,,,,,,,,,,,,,,,,,,,,,215.0,it ITA,MF,28.0,8.7,5.0,1.0,1.0,20.0,9.0,0.0,7.0,4.0,6.0,0.0,0.0,0.0,38.0,16.0,7.0,69.6,Matches,215.0,it ITA,MF,28.0,8.7,355.0,348.0,5.0,4.0,1.0,1.0,7.0,1.0,0.0,0.0,0.0,0.0,297.0,2.0,3.0,Matches,215.0,it ITA,MF,28.0,8.7,297.0,355.0,83.7,4333.0,1269.0,177.0,200.0,88.5,94.0,108.0,87.0,15.0,25.0,60.0,0.0,0.3,0.7,-0.3,5.0,32.0,12.0,4.0,39.0,Matches,286,it ITA,MF,28,19,783.0,41.0,22.9,8.7,7,81.0,5,12,18.0,16,2.32,16.0,9.0,7.0,0.8,0.05,11.8,10.2,1.5,0.18,-0.85,Matches,215.0,it ITA,MF,28.0,8.7,454.0,21.0,105.0,229.0,125.0,24.0,454.0,5.0,0.0,0.0,4.0,80.0,244.0,1435.0,787.0,20.0,10.0,1.0,9.0,2.0,315.0,22.0,Matches,215.0,it ITA,MF,28.0,8.7,0.0,16.0,2.0,12.5,1.84,0.23,0.0,0.0,16.1,0.0,0.0,0.0,0.9,0.9,0.05,-0.9,-0.9,Matches,215.0,it ITA,MF,28.0,19.0,7.0,783.0,8.7,0.0,0.0,0.0,0.0,0.0,0.0,5.0,1.0,0.9,0.9,0.3,1.1,20.0,39.0,22.0,0.0,0.0,0.0,0.0,0.0,0.1,0.03,0.13,0.1,0.13,Matches,Roberto Gagliardini,M C,28,139,150,Italy,FC Internazionale Milano,4,9,10,12,13,7,13,12,11,12,14,7,15,13,14,15,15,14,16,12,13,16,9,10,15,14,18,16,13,12,16,13,15,13,15,16,12,12,11,9,11,2,3,3,3,3,1,3,3,3,2,1,15,14,8,14,12,20,14,13,1,1,1,1,1,1,15,8,20,8,7,9,7,1,188,77,9,20,3794011,6950,6750,5950,Mediterranean_Hispanic,141,3,1994/4/7,7,0,53462.0,,43081390
646,Adolfo Gaich,Hellas Verona,1999,216.0,ar ARG,FW,23.0,8.1,5.0,3.0,0.0,3.0,2.0,1.0,6.0,16.7,5.0,7.0,2.0,5.0,3.0,8.0,7.0,1.0,Matches,216.0,ar ARG,FW,23.0,8.1,19.0,2.36,14.0,0.0,2.0,0.0,2.0,1.0,1.0,0.12,0.0,0.0,0.0,0.0,1.0,0.0,Matches,,,,,,,,,,,,,,,,,,,,,,,,,,,,,,,,,,,,,,,,,,,,,,,,,,,,,,,,216.0,ar ARG,FW,23.0,8.1,2.0,0.0,0.0,17.0,13.0,4.0,0.0,3.0,3.0,1.0,0.0,1.0,14.0,25.0,51.0,32.9,Matches,216.0,ar ARG,FW,23.0,8.1,165.0,160.0,4.0,0.0,0.0,0.0,0.0,0.0,0.0,0.0,0.0,0.0,94.0,1.0,4.0,Matches,216.0,ar ARG,FW,23.0,8.1,94.0,165.0,57.0,1055.0,200.0,61.0,100.0,61.0,22.0,39.0,56.4,0.0,2.0,0.0,0.0,0.4,0.2,-0.4,6.0,8.0,0.0,0.0,11.0,Matches,287,ar ARG,FW,23,16,726.0,45.0,21.2,8.1,8,67.0,1,8,24.0,2,1.06,7.0,13.0,-6.0,-0.74,-0.01,8.5,9.7,-1.2,-0.14,0.29,Matches,216.0,ar ARG,FW,23.0,8.1,263.0,10.0,21.0,129.0,116.0,26.0,263.0,17.0,11.0,64.7,5.0,29.4,144.0,637.0,181.0,6.0,4.0,4.0,22.0,9.0,198.0,33.0,Matches,216.0,ar ARG,FW,23.0,8.1,2.0,24.0,8.0,33.3,2.98,0.99,0.08,0.25,16.8,0.0,0.0,0.0,2.5,2.5,0.1,-0.5,-0.5,Matches,216.0,ar ARG,FW,23.0,16.0,8.0,726.0,8.1,2.0,0.0,2.0,2.0,0.0,0.0,2.0,0.0,2.5,2.5,0.4,2.9,6.0,11.0,33.0,0.25,0.0,0.25,0.25,0.25,0.31,0.05,0.36,0.31,0.36,Matches,Adolfo Gaich,S,23,122,134,Argentina,CSKA Moscow,4,7,12,14,14,7,14,9,5,7,11,12,6,13,13,13,13,12,8,12,10,9,10,10,14,9,15,15,10,10,14,14,15,12,15,15,12,13,12,6,10,2,3,1,3,3,1,2,3,2,2,4,8,11,7,10,10,13,13,7,1,1,1,1,1,1,1,1,1,1,1,1,1,20,194,94,10,20,7079958,6150,6250,4600,Mediterranean_Hispanic,119,6,1999/2/26,1,0,21095.0,,14151843
647,Paolo Ghiglione,Cremonese,1997,221.0,it ITA,DF,25.0,7.9,16.0,11.0,10.0,3.0,3.0,10.0,23.0,43.5,13.0,9.0,4.0,5.0,4.0,20.0,12.0,0.0,Matches,221.0,it ITA,DF,25.0,7.9,19.0,2.41,16.0,3.0,0.0,0.0,0.0,0.0,3.0,0.38,3.0,0.0,0.0,0.0,0.0,0.0,Matches,,,,,,,,,,,,,,,,,,,,,,,,,,,,,,,,,,,,,,,,,,,,,,,,,,,,,,,,221.0,it ITA,DF,25.0,7.9,4.0,0.0,0.0,16.0,7.0,2.0,39.0,4.0,11.0,0.0,1.0,0.0,42.0,5.0,8.0,38.5,Matches,221.0,it ITA,DF,25.0,7.9,285.0,227.0,58.0,1.0,0.0,2.0,39.0,55.0,2.0,0.0,2.0,0.0,159.0,0.0,11.0,Matches,221.0,it ITA,DF,25.0,7.9,159.0,285.0,55.8,3153.0,1607.0,61.0,86.0,70.9,73.0,122.0,59.8,25.0,63.0,39.7,1.0,0.6,0.6,0.4,13.0,17.0,18.0,15.0,19.0,Matches,295,it ITA,DF,25,15,711.0,47.0,20.8,7.9,8,77.0,3,7,14.0,20,0.87,9.0,14.0,-5.0,-0.63,0.3,7.7,14.7,-7.1,-0.89,-0.22,Matches,221.0,it ITA,DF,25.0,7.9,359.0,16.0,106.0,135.0,122.0,9.0,359.0,11.0,2.0,18.2,9.0,81.8,153.0,736.0,381.0,5.0,7.0,1.0,6.0,4.0,178.0,35.0,Matches,221.0,it ITA,DF,25.0,7.9,1.0,7.0,2.0,28.6,0.89,0.25,0.14,0.5,17.0,0.0,0.0,0.0,0.8,0.8,0.12,0.2,0.2,Matches,221.0,it ITA,DF,25.0,15.0,8.0,711.0,7.9,1.0,1.0,2.0,1.0,0.0,0.0,4.0,0.0,0.8,0.8,0.6,1.5,5.0,19.0,35.0,0.13,0.13,0.25,0.13,0.25,0.1,0.08,0.18,0.1,0.18,Matches,Paolo Ghiglione,D/WB/M R,25,121,128,Italy,Cremonese,7,13,11,9,12,8,12,8,12,12,13,8,12,11,9,12,12,12,13,13,11,13,12,9,13,12,11,12,13,13,12,14,12,13,13,12,13,7,12,7,15,3,2,1,1,2,3,1,2,2,1,3,10,12,9,14,12,13,12,13,1,5,1,20,8,20,1,10,1,18,6,1,10,1,191,82,11,20,1432317,6044,6044,4994,Mediterranean_Hispanic,119,6,1997/2/2,0,0,21346.0,,43140923
648,Mario Gila,Lazio,2000,222.0,es ESP,DF,21.0,1.0,3.0,1.0,3.0,0.0,0.0,0.0,1.0,0.0,1.0,0.0,0.0,0.0,3.0,6.0,3.0,0.0,Matches,222.0,es ESP,DF,21.0,1.0,0.0,0.0,0.0,0.0,0.0,0.0,0.0,0.0,0.0,0.0,0.0,0.0,0.0,0.0,0.0,0.0,Matches,,,,,,,,,,,,,,,,,,,,,,,,,,,,,,,,,,,,,,,,,,,,,,,,,,,,,,,,222.0,es ESP,DF,21.0,1.0,0.0,0.0,0.0,1.0,1.0,0.0,0.0,3.0,1.0,0.0,0.0,0.0,6.0,0.0,3.0,0.0,Matches,222.0,es ESP,DF,21.0,1.0,61.0,56.0,5.0,3.0,0.0,0.0,0.0,2.0,0.0,0.0,0.0,0.0,56.0,0.0,0.0,Matches,222.0,es ESP,DF,21.0,1.0,56.0,61.0,91.8,953.0,330.0,25.0,27.0,92.6,24.0,26.0,92.3,6.0,7.0,85.7,0.0,0.0,0.0,0.0,0.0,1.0,0.0,0.0,6.0,Matches,296,es ESP,DF,21,4,90.0,23.0,2.6,1.0,0,,0,4,23.0,29,1.75,3.0,2.0,1.0,1.0,0.22,1.7,1.7,0.1,0.05,-0.21,Matches,222.0,es ESP,DF,21.0,1.0,71.0,6.0,36.0,33.0,2.0,0.0,71.0,0.0,0.0,,0.0,,42.0,247.0,99.0,1.0,1.0,0.0,1.0,1.0,46.0,2.0,Matches,222.0,es ESP,DF,21.0,1.0,0.0,0.0,0.0,,0.0,0.0,,,,0.0,0.0,0.0,0.0,0.0,,0.0,0.0,Matches,222.0,es ESP,DF,21.0,4.0,0.0,90.0,1.0,0.0,0.0,0.0,0.0,0.0,0.0,0.0,0.0,0.0,0.0,0.0,0.0,1.0,6.0,2.0,0.0,0.0,0.0,0.0,0.0,0.0,0.0,0.0,0.0,0.0,Matches,Mario Gila,D C,21,127,157,Spain,S.S. Lazio,5,5,5,6,11,6,15,10,13,12,11,8,15,10,16,15,17,15,12,11,11,18,13,16,10,12,14,14,10,11,12,15,12,10,14,16,13,12,12,5,11,2,1,1,4,1,1,1,1,1,1,3,14,15,5,13,12,15,12,12,1,1,20,1,1,1,11,1,8,1,1,1,1,1,184,76,11,20,12519999,6350,5543,2519,Mediterranean_Hispanic,125,3,2000/8/29,0,0,12308.0,,67277455
649,Pierluigi Gollini,Fiorentina,1995,225.0,it ITA,GK,27.0,3.0,1.0,0.0,1.0,0.0,0.0,1.0,1.0,100.0,0.0,0.0,0.0,0.0,0.0,1.0,2.0,0.0,Matches,225.0,it ITA,GK,27.0,3.0,0.0,0.0,0.0,0.0,0.0,0.0,0.0,0.0,0.0,0.0,0.0,0.0,0.0,0.0,0.0,0.0,Matches,13.0,it ITA,GK,27.0,3.0,2.0,0.0,0.0,1.0,0.0,1.7,0.21,-0.3,-0.1,13.0,38.0,34.2,115.0,17.0,27.0,32.4,11.0,63.6,49.3,24.0,1.0,4.2,0.0,0.0,9.3,Matches,13.0,it ITA,GK,27.0,3.0,3.0,270.0,3.0,2.0,0.67,8.0,6.0,75.0,1.0,2.0,0.0,2.0,66.7,0.0,0.0,0.0,0.0,,Matches,225.0,it ITA,GK,27.0,3.0,0.0,0.0,0.0,0.0,0.0,0.0,0.0,0.0,0.0,0.0,0.0,0.0,2.0,0.0,0.0,,Matches,225.0,it ITA,GK,27.0,3.0,126.0,111.0,15.0,4.0,0.0,0.0,0.0,0.0,0.0,0.0,0.0,0.0,96.0,0.0,0.0,Matches,225.0,it ITA,GK,27.0,3.0,96.0,126.0,76.2,2622.0,1774.0,18.0,18.0,100.0,42.0,42.0,100.0,36.0,66.0,54.5,0.0,0.0,0.0,0.0,0.0,1.0,0.0,0.0,0.0,Matches,300,it ITA,GK,27,3,270.0,90.0,7.9,3.0,3,90.0,3,0,,10,1.67,3.0,2.0,1.0,0.33,0.08,3.3,3.3,0.0,-0.01,-0.35,Matches,225.0,it ITA,GK,27.0,3.0,131.0,116.0,131.0,0.0,0.0,0.0,131.0,0.0,0.0,,0.0,,104.0,423.0,217.0,0.0,0.0,0.0,0.0,0.0,91.0,0.0,Matches,225.0,it ITA,GK,27.0,3.0,0.0,0.0,0.0,,0.0,0.0,,,,0.0,0.0,0.0,0.0,0.0,,0.0,0.0,Matches,225.0,it ITA,GK,27.0,3.0,3.0,270.0,3.0,0.0,0.0,0.0,0.0,0.0,0.0,0.0,0.0,0.0,0.0,0.0,0.0,0.0,0.0,0.0,0.0,0.0,0.0,0.0,0.0,0.0,0.0,0.0,0.0,0.0,Matches,Pierluigi Gollini,GK,27,135,145,Italy,Atalanta,6,1,3,2,10,7,10,2,2,2,10,3,1,9,11,14,15,13,12,8,11,14,3,13,3,13,15,15,12,14,14,16,15,12,10,15,13,5,12,5,12,14,13,12,16,13,12,14,14,14,14,13,14,15,8,10,13,13,12,10,20,1,1,1,1,1,1,1,1,1,1,1,1,1,194,94,8,20,2309130,6750,6750,5800,Mediterranean_Hispanic,135,2,1995/3/18,1,0,28461.0,ACF Fiorentina,43090278
650,Koray Günter,Sampdoria,1994,234.0,de GER,DF,27.0,8.6,10.0,8.0,6.0,4.0,0.0,6.0,9.0,66.7,3.0,10.0,5.0,5.0,11.0,21.0,46.0,0.0,Matches,234.0,de GER,DF,27.0,8.6,3.0,0.35,3.0,0.0,0.0,0.0,0.0,0.0,0.0,0.0,0.0,0.0,0.0,0.0,0.0,0.0,Matches,,,,,,,,,,,,,,,,,,,,,,,,,,,,,,,,,,,,,,,,,,,,,,,,,,,,,,,,234.0,de GER,DF,27.0,8.6,2.0,0.0,0.0,7.0,3.0,0.0,1.0,11.0,8.0,0.0,1.0,0.0,47.0,24.0,9.0,72.7,Matches,234.0,de GER,DF,27.0,8.6,420.0,386.0,34.0,14.0,1.0,3.0,1.0,20.0,0.0,0.0,0.0,0.0,344.0,0.0,3.0,Matches,234.0,de GER,DF,27.0,8.6,344.0,420.0,81.9,6493.0,2308.0,138.0,157.0,87.9,172.0,198.0,86.9,32.0,55.0,58.2,0.0,0.2,0.3,-0.2,2.0,21.0,2.0,1.0,21.0,Matches,311,de GER,DF,27,10,776.0,78.0,22.7,8.6,8,84.0,7,2,51.0,1,0.6,8.0,20.0,-12.0,-1.39,-0.2,7.5,16.8,-9.4,-1.09,-0.31,Matches,234.0,de GER,DF,27.0,8.6,509.0,67.0,233.0,256.0,23.0,7.0,509.0,1.0,1.0,100.0,0.0,0.0,247.0,1070.0,598.0,4.0,6.0,0.0,3.0,0.0,285.0,2.0,Matches,234.0,de GER,DF,27.0,8.6,0.0,1.0,0.0,0.0,0.12,0.0,0.0,,9.6,0.0,0.0,0.0,0.1,0.1,0.07,-0.1,-0.1,Matches,234.0,de GER,DF,27.0,10.0,8.0,776.0,8.6,0.0,0.0,0.0,0.0,0.0,0.0,2.0,0.0,0.1,0.1,0.2,0.3,4.0,21.0,2.0,0.0,0.0,0.0,0.0,0.0,0.01,0.02,0.03,0.01,0.03,Matches,Koray Günter,D C,27,129,136,"Germany,Turkey",Hellas Verona,4,7,8,6,11,4,14,5,7,15,11,5,16,10,14,12,16,11,12,9,12,13,7,14,5,14,15,13,12,12,13,13,14,11,14,15,13,14,12,7,8,1,3,3,3,2,3,3,1,3,3,1,11,14,5,15,7,15,14,15,1,1,20,11,1,1,1,1,1,1,1,1,1,1,184,79,11,20,3170192,6450,6300,5100,Mediterranean_Hispanic,127,4,1994/8/16,0,0,28817.0,,92023404
651,Christian Gytkjær,Monza,1990,237.0,dk DEN,FWMF,32.0,6.2,6.0,2.0,1.0,4.0,1.0,2.0,5.0,40.0,3.0,6.0,1.0,5.0,0.0,6.0,2.0,0.0,Matches,237.0,dk DEN,FWMF,32.0,6.2,9.0,1.46,7.0,0.0,0.0,2.0,0.0,0.0,2.0,0.32,1.0,0.0,0.0,1.0,0.0,0.0,Matches,,,,,,,,,,,,,,,,,,,,,,,,,,,,,,,,,,,,,,,,,,,,,,,,,,,,,,,,237.0,dk DEN,FWMF,32.0,6.2,0.0,0.0,0.0,11.0,6.0,10.0,1.0,0.0,2.0,0.0,1.0,0.0,9.0,10.0,20.0,33.3,Matches,237.0,dk DEN,FWMF,32.0,6.2,102.0,94.0,7.0,0.0,0.0,0.0,1.0,0.0,0.0,0.0,0.0,0.0,69.0,1.0,5.0,Matches,237.0,dk DEN,FWMF,32.0,6.2,69.0,102.0,67.6,895.0,155.0,41.0,57.0,71.9,18.0,26.0,69.2,3.0,3.0,100.0,0.0,0.3,0.1,-0.3,3.0,3.0,2.0,0.0,6.0,Matches,314,dk DEN,FWMF,32,22,559.0,25.0,16.3,6.2,3,69.0,1,19,18.0,16,1.0,9.0,7.0,2.0,0.32,0.51,11.1,8.0,3.1,0.5,0.77,Matches,237.0,dk DEN,FWMF,32.0,6.2,161.0,5.0,8.0,80.0,73.0,27.0,160.0,5.0,3.0,60.0,2.0,40.0,84.0,274.0,53.0,1.0,2.0,2.0,17.0,5.0,119.0,32.0,Matches,237.0,dk DEN,FWMF,32.0,6.2,1.0,12.0,5.0,41.7,1.93,0.81,0.08,0.2,12.8,1.0,0.0,1.0,3.9,3.1,0.26,-2.9,-2.1,Matches,237.0,dk DEN,FWMF,32.0,22.0,3.0,559.0,6.2,1.0,0.0,1.0,1.0,0.0,1.0,0.0,0.0,3.9,3.1,0.3,3.4,1.0,6.0,32.0,0.16,0.0,0.16,0.16,0.16,0.63,0.05,0.68,0.51,0.55,Matches,Christian Gytkjær,S,32,123,129,Denmark,Brianza,7,8,11,14,13,10,15,12,7,5,10,14,5,11,10,16,16,14,14,8,10,13,11,6,14,6,10,8,13,11,14,12,15,10,13,13,15,5,13,7,6,2,3,3,4,2,3,1,3,1,3,3,12,16,13,6,10,14,11,12,1,1,1,1,1,1,1,1,1,1,1,1,1,20,185,77,14,20,544354,6150,6250,5450,Northern_European,123,1,1990/5/6,9,5,21537.0,,27000596
652,Abdou Harroui,Sassuolo,1998,240.0,nl NED,MF,24.0,7.2,17.0,6.0,6.0,7.0,4.0,2.0,7.0,28.6,5.0,6.0,1.0,5.0,2.0,19.0,10.0,0.0,Matches,240.0,nl NED,MF,24.0,7.2,15.0,2.09,15.0,0.0,0.0,0.0,0.0,0.0,1.0,0.14,1.0,0.0,0.0,0.0,0.0,0.0,Matches,,,,,,,,,,,,,,,,,,,,,,,,,,,,,,,,,,,,,,,,,,,,,,,,,,,,,,,,240.0,nl NED,MF,24.0,7.2,2.0,0.0,0.0,13.0,3.0,1.0,11.0,2.0,6.0,0.0,0.0,0.0,38.0,9.0,5.0,64.3,Matches,240.0,nl NED,MF,24.0,7.2,308.0,303.0,5.0,0.0,1.0,1.0,11.0,2.0,0.0,0.0,0.0,0.0,254.0,0.0,7.0,Matches,240.0,nl NED,MF,24.0,7.2,254.0,308.0,82.5,3861.0,992.0,133.0,147.0,90.5,98.0,116.0,84.5,14.0,21.0,66.7,0.0,0.3,0.5,-0.3,6.0,35.0,7.0,2.0,36.0,Matches,317,nl NED,MF,24,23,647.0,28.0,18.9,7.2,5,66.0,1,18,18.0,14,1.35,5.0,9.0,-4.0,-0.56,-0.23,7.6,9.3,-1.7,-0.24,-0.36,Matches,240.0,nl NED,MF,24.0,7.2,395.0,16.0,68.0,211.0,126.0,15.0,395.0,15.0,11.0,73.3,4.0,26.7,228.0,1379.0,632.0,21.0,20.0,3.0,12.0,13.0,279.0,32.0,Matches,240.0,nl NED,MF,24.0,7.2,2.0,14.0,4.0,28.6,1.95,0.56,0.14,0.5,23.4,0.0,0.0,0.0,1.5,1.5,0.1,0.5,0.5,Matches,240.0,nl NED,MF,24.0,23.0,5.0,647.0,7.2,2.0,0.0,2.0,2.0,0.0,0.0,2.0,0.0,1.5,1.5,0.3,1.8,21.0,36.0,32.0,0.28,0.0,0.28,0.28,0.28,0.2,0.05,0.25,0.2,0.25,Matches,Abdou Harroui,DM/M C,24,122,135,"Morocco,Holland",U.S. Sassuolo,5,8,13,11,12,10,11,13,10,10,13,10,12,13,14,12,14,13,11,13,12,14,10,10,13,11,15,15,11,12,13,11,14,11,14,12,10,8,12,6,14,1,1,2,1,2,3,4,2,2,3,2,12,15,6,12,14,14,11,14,1,1,1,1,1,1,18,1,20,13,1,12,1,1,181,76,12,20,2869296,6098,6198,4998,North_African__Middle_Eastern,122,7,1998/1/13,0,0,4999.0,,37064635
653,Jack Hendry,Cremonese,1995,243.0,sct SCO,DF,27.0,2.4,0.0,0.0,0.0,0.0,0.0,0.0,1.0,0.0,1.0,2.0,1.0,1.0,1.0,1.0,7.0,0.0,Matches,243.0,sct SCO,DF,27.0,2.4,4.0,1.64,4.0,0.0,0.0,0.0,0.0,0.0,1.0,0.41,1.0,0.0,0.0,0.0,0.0,0.0,Matches,,,,,,,,,,,,,,,,,,,,,,,,,,,,,,,,,,,,,,,,,,,,,,,,,,,,,,,,243.0,sct SCO,DF,27.0,2.4,1.0,0.0,0.0,2.0,1.0,0.0,1.0,1.0,0.0,0.0,0.0,0.0,14.0,8.0,3.0,72.7,Matches,243.0,sct SCO,DF,27.0,2.4,137.0,122.0,15.0,7.0,0.0,1.0,1.0,5.0,0.0,0.0,0.0,0.0,118.0,0.0,1.0,Matches,243.0,sct SCO,DF,27.0,2.4,118.0,137.0,86.1,2402.0,1087.0,40.0,44.0,90.9,58.0,67.0,86.6,17.0,22.0,77.3,0.0,0.0,0.0,0.0,1.0,12.0,1.0,0.0,9.0,Matches,320,sct SCO,DF,27,4,220.0,55.0,6.4,2.4,2,90.0,2,2,20.0,6,0.5,2.0,5.0,-3.0,-1.23,-0.38,3.4,4.7,-1.2,-0.51,0.23,Matches,243.0,sct SCO,DF,27.0,2.4,148.0,13.0,71.0,73.0,7.0,0.0,148.0,1.0,0.0,0.0,1.0,100.0,94.0,571.0,361.0,1.0,2.0,0.0,0.0,0.0,90.0,0.0,Matches,243.0,sct SCO,DF,27.0,2.4,0.0,0.0,0.0,,0.0,0.0,,,,0.0,0.0,0.0,0.0,0.0,,0.0,0.0,Matches,243.0,sct SCO,DF,27.0,4.0,2.0,220.0,2.4,0.0,0.0,0.0,0.0,0.0,0.0,1.0,0.0,0.0,0.0,0.0,0.0,1.0,9.0,0.0,0.0,0.0,0.0,0.0,0.0,0.0,0.01,0.01,0.0,0.01,Matches,Jack Hendry,D C,27,122,127,"Scotland,Wales",Club Brugge KV,5,4,10,5,10,6,14,7,12,14,9,7,14,10,12,10,13,12,14,11,13,14,6,13,10,14,14,14,11,11,14,14,12,10,14,15,13,4,8,8,9,4,1,2,2,1,1,4,2,1,2,1,8,13,8,9,14,12,9,13,1,1,20,1,1,1,1,1,1,1,1,1,1,1,189,76,8,20,2915997,6100,6100,4500,Northern_European,122,1,1995/5/7,17,2,10000.0,Cremonese,29091029
654,Martin Hongla,Hellas Verona,1998,250.0,cm CMR,MF,24.0,5.8,8.0,5.0,4.0,4.0,0.0,5.0,5.0,100.0,0.0,7.0,1.0,6.0,6.0,14.0,9.0,0.0,Matches,250.0,cm CMR,MF,24.0,5.8,11.0,1.89,9.0,0.0,1.0,1.0,0.0,0.0,1.0,0.17,1.0,0.0,0.0,0.0,0.0,0.0,Matches,,,,,,,,,,,,,,,,,,,,,,,,,,,,,,,,,,,,,,,,,,,,,,,,,,,,,,,,250.0,cm CMR,MF,24.0,5.8,4.0,0.0,0.0,11.0,4.0,0.0,8.0,6.0,5.0,0.0,0.0,0.0,48.0,5.0,8.0,38.5,Matches,250.0,cm CMR,MF,24.0,5.8,212.0,204.0,8.0,5.0,0.0,3.0,8.0,1.0,0.0,0.0,0.0,0.0,166.0,0.0,1.0,Matches,250.0,cm CMR,MF,24.0,5.8,166.0,212.0,78.3,3239.0,992.0,62.0,74.0,83.8,75.0,89.0,84.3,24.0,41.0,58.5,0.0,0.3,0.4,-0.3,3.0,18.0,2.0,1.0,24.0,Matches,327,cm CMR,MF,24,9,523.0,58.0,15.3,5.8,6,76.0,2,3,23.0,6,0.56,4.0,11.0,-7.0,-1.2,-0.55,5.5,9.2,-3.7,-0.64,-0.32,Matches,250.0,cm CMR,MF,24.0,5.8,258.0,12.0,66.0,142.0,54.0,3.0,258.0,14.0,8.0,57.1,6.0,42.9,131.0,680.0,345.0,6.0,4.0,1.0,4.0,3.0,141.0,10.0,Matches,250.0,cm CMR,MF,24.0,5.8,0.0,5.0,2.0,40.0,0.86,0.34,0.0,0.0,28.1,0.0,0.0,0.0,0.2,0.2,0.03,-0.2,-0.2,Matches,250.0,cm CMR,MF,24.0,9.0,6.0,523.0,5.8,0.0,0.0,0.0,0.0,0.0,0.0,4.0,0.0,0.2,0.2,0.3,0.5,6.0,24.0,10.0,0.0,0.0,0.0,0.0,0.0,0.03,0.05,0.08,0.03,0.08,Matches,Martin Hongla,DM/M C,24,125,138,Cameroon,Hellas Verona,5,8,10,8,13,9,12,12,9,11,13,12,12,12,16,12,12,13,13,12,13,12,8,10,12,12,15,15,13,12,14,12,15,12,16,14,14,12,11,6,13,3,3,1,3,2,1,3,3,1,4,3,11,12,8,11,12,14,12,10,1,1,14,1,1,1,20,1,20,1,1,1,1,1,181,79,9,20,2574089,6250,5900,4250,African_Caribbean,124,18,1998/3/16,17,0,5999.0,,13157239
655,Petko Hristov,Spezia,1999,251.0,bg BUL,DF,23.0,4.1,6.0,4.0,2.0,4.0,0.0,5.0,8.0,62.5,3.0,4.0,2.0,2.0,4.0,10.0,12.0,0.0,Matches,251.0,bg BUL,DF,23.0,4.1,3.0,0.74,1.0,0.0,0.0,1.0,1.0,0.0,1.0,0.25,0.0,0.0,0.0,0.0,1.0,0.0,Matches,,,,,,,,,,,,,,,,,,,,,,,,,,,,,,,,,,,,,,,,,,,,,,,,,,,,,,,,251.0,bg BUL,DF,23.0,4.1,0.0,0.0,0.0,1.0,4.0,0.0,1.0,4.0,4.0,1.0,0.0,0.0,21.0,10.0,5.0,66.7,Matches,251.0,bg BUL,DF,23.0,4.1,207.0,168.0,38.0,9.0,0.0,3.0,1.0,29.0,0.0,0.0,0.0,0.0,160.0,1.0,1.0,Matches,251.0,bg BUL,DF,23.0,4.1,160.0,207.0,77.3,2653.0,997.0,82.0,90.0,91.1,64.0,79.0,81.0,11.0,29.0,37.9,0.0,0.0,0.1,0.0,0.0,11.0,2.0,1.0,8.0,Matches,328,bg BUL,DF,23,9,365.0,41.0,10.7,4.1,4,68.0,2,5,19.0,8,0.56,5.0,10.0,-5.0,-1.23,-0.47,3.5,7.0,-3.5,-0.87,-0.44,Matches,251.0,bg BUL,DF,23.0,4.1,251.0,19.0,101.0,122.0,29.0,3.0,251.0,3.0,0.0,0.0,3.0,100.0,112.0,510.0,270.0,2.0,2.0,0.0,3.0,0.0,133.0,3.0,Matches,251.0,bg BUL,DF,23.0,4.1,0.0,1.0,0.0,0.0,0.25,0.0,0.0,,10.0,0.0,0.0,0.0,0.1,0.1,0.08,-0.1,-0.1,Matches,251.0,bg BUL,DF,23.0,9.0,4.0,365.0,4.1,0.0,0.0,0.0,0.0,0.0,0.0,0.0,0.0,0.1,0.1,0.0,0.1,2.0,8.0,3.0,0.0,0.0,0.0,0.0,0.0,0.02,0.0,0.02,0.02,0.02,Matches,Petko Hristov,D C,23,123,144,Bulgaria,Spezia Calcio,6,6,9,10,11,6,14,9,8,14,10,2,13,8,11,13,13,12,12,10,13,13,11,11,9,13,14,14,12,12,11,14,13,12,12,14,14,9,11,7,2,1,1,3,2,4,1,3,2,2,1,3,9,13,7,11,12,14,11,11,1,1,20,1,1,1,1,1,1,1,1,1,1,1,191,85,10,20,2868768,6150,6050,3501,Northern_European,123,2,1999/3/1,14,0,1517.0,,22064932
656,Ajdin Hrustic,Hellas Verona,1996,252.0,au AUS,MF,26.0,2.5,2.0,1.0,1.0,1.0,0.0,1.0,2.0,50.0,1.0,2.0,0.0,2.0,0.0,2.0,2.0,1.0,Matches,252.0,au AUS,MF,26.0,2.5,7.0,2.79,6.0,1.0,0.0,0.0,0.0,0.0,1.0,0.4,1.0,0.0,0.0,0.0,0.0,0.0,Matches,,,,,,,,,,,,,,,,,,,,,,,,,,,,,,,,,,,,,,,,,,,,,,,,,,,,,,,,252.0,au AUS,MF,26.0,2.5,0.0,0.0,0.0,7.0,2.0,0.0,7.0,0.0,1.0,0.0,0.0,0.0,11.0,1.0,3.0,25.0,Matches,252.0,au AUS,MF,26.0,2.5,94.0,82.0,12.0,6.0,0.0,1.0,7.0,0.0,4.0,2.0,0.0,0.0,75.0,0.0,4.0,Matches,252.0,au AUS,MF,26.0,2.5,75.0,94.0,79.8,1069.0,341.0,40.0,42.0,95.2,25.0,33.0,75.8,4.0,7.0,57.1,0.0,0.6,0.6,-0.6,3.0,1.0,5.0,1.0,8.0,Matches,329,au AUS,MF,26,6,226.0,38.0,6.6,2.5,3,61.0,0,3,15.0,5,0.17,2.0,5.0,-3.0,-1.19,-0.49,2.6,4.3,-1.8,-0.7,-0.35,Matches,252.0,au AUS,MF,26.0,2.5,121.0,4.0,17.0,59.0,47.0,6.0,121.0,12.0,4.0,33.3,8.0,66.7,63.0,414.0,171.0,7.0,6.0,2.0,8.0,3.0,77.0,12.0,Matches,252.0,au AUS,MF,26.0,2.5,0.0,3.0,0.0,0.0,1.19,0.0,0.0,,19.4,0.0,0.0,0.0,0.3,0.3,0.11,-0.3,-0.3,Matches,252.0,au AUS,MF,26.0,6.0,3.0,226.0,2.5,0.0,0.0,0.0,0.0,0.0,0.0,0.0,0.0,0.3,0.3,0.6,0.9,7.0,8.0,12.0,0.0,0.0,0.0,0.0,0.0,0.13,0.24,0.37,0.13,0.37,Matches,Ajdin Hrustic,M/AM RC,26,120,123,"Australia,Bosnia and Herzegovina,Romania",Hellas Verona,14,9,12,8,12,15,12,15,9,8,14,14,6,13,14,11,13,13,12,11,12,15,12,9,12,8,13,14,12,13,12,13,13,11,13,12,11,7,12,5,12,2,1,2,3,1,3,1,1,2,1,4,12,13,7,11,14,15,12,8,1,1,1,1,1,1,14,14,20,15,14,18,15,1,183,78,20,12,1795427,6100,5500,4500,Northern_European,116,4,1996/7/5,19,3,7399.0,,91145128
657,Zlatan Ibrahimović,Milan,1981,256.0,se SWE,FW,40.0,1.6,0.0,0.0,0.0,0.0,0.0,0.0,0.0,,0.0,1.0,1.0,0.0,0.0,0.0,2.0,0.0,Matches,256.0,se SWE,FW,40.0,1.6,3.0,1.85,2.0,0.0,0.0,1.0,0.0,0.0,0.0,0.0,0.0,0.0,0.0,0.0,0.0,0.0,Matches,,,,,,,,,,,,,,,,,,,,,,,,,,,,,,,,,,,,,,,,,,,,,,,,,,,,,,,,256.0,se SWE,FW,40.0,1.6,0.0,0.0,0.0,2.0,1.0,0.0,0.0,0.0,0.0,0.0,0.0,0.0,3.0,8.0,4.0,66.7,Matches,256.0,se SWE,FW,40.0,1.6,51.0,45.0,6.0,0.0,0.0,1.0,0.0,0.0,0.0,0.0,0.0,0.0,36.0,0.0,2.0,Matches,256.0,se SWE,FW,40.0,1.6,36.0,51.0,70.6,517.0,102.0,22.0,31.0,71.0,10.0,13.0,76.9,2.0,2.0,100.0,0.0,0.2,0.1,-0.2,1.0,3.0,2.0,0.0,4.0,Matches,333,se SWE,FW,40,4,146.0,37.0,4.3,1.6,1,75.0,0,3,24.0,3,1.0,3.0,4.0,-1.0,-0.62,-1.22,2.9,2.6,0.4,0.24,-0.24,Matches,256.0,se SWE,FW,40.0,1.6,72.0,3.0,5.0,31.0,36.0,7.0,71.0,3.0,0.0,0.0,2.0,66.7,38.0,145.0,53.0,0.0,1.0,1.0,5.0,2.0,55.0,10.0,Matches,256.0,se SWE,FW,40.0,1.6,1.0,5.0,2.0,40.0,3.08,1.23,0.0,0.0,24.8,1.0,1.0,1.0,1.2,0.4,0.08,-0.2,-0.4,Matches,256.0,se SWE,FW,40.0,4.0,1.0,146.0,1.6,1.0,0.0,1.0,0.0,1.0,1.0,0.0,0.0,1.2,0.4,0.2,0.6,0.0,4.0,10.0,0.62,0.0,0.62,0.0,0.0,0.72,0.11,0.84,0.24,0.35,Matches,Zlatan Ibrahimović,S,40,152,186,"Sweden,Bosnia and Herzegovina,Croatia",AC Milan,4,12,12,19,20,15,16,15,6,4,15,14,3,19,16,17,18,16,17,15,16,20,20,20,16,5,14,7,7,9,19,18,20,8,8,18,18,16,18,15,5,2,2,1,4,3,2,3,3,2,2,1,20,20,20,10,20,20,5,5,1,1,1,1,1,1,1,1,1,1,1,9,1,20,195,95,15,20,2902501,7600,8472,7574,Northern_European,156,2,1981/10/3,121,62,36922.0,,142173
658,Ivan Ilić,Hellas Verona,2001,260.0,rs SRB,MF,21.0,9.5,16.0,10.0,9.0,7.0,0.0,6.0,11.0,54.5,5.0,10.0,1.0,9.0,8.0,24.0,14.0,0.0,Matches,260.0,rs SRB,MF,21.0,9.5,28.0,2.96,14.0,12.0,2.0,0.0,0.0,0.0,2.0,0.21,1.0,0.0,1.0,0.0,0.0,0.0,Matches,,,,,,,,,,,,,,,,,,,,,,,,,,,,,,,,,,,,,,,,,,,,,,,,,,,,,,,,260.0,rs SRB,MF,21.0,9.5,1.0,0.0,0.0,9.0,9.0,0.0,47.0,8.0,10.0,0.0,0.0,0.0,72.0,10.0,13.0,43.5,Matches,260.0,rs SRB,MF,21.0,9.5,401.0,332.0,68.0,17.0,1.0,3.0,47.0,2.0,39.0,14.0,19.0,0.0,279.0,1.0,13.0,Matches,260.0,rs SRB,MF,21.0,9.5,279.0,401.0,69.6,5107.0,1432.0,113.0,138.0,81.9,128.0,168.0,76.2,29.0,66.0,43.9,1.0,1.0,1.0,0.0,16.0,19.0,10.0,1.0,39.0,Matches,339,rs SRB,MF,21,11,851.0,77.0,24.9,9.5,10,83.0,7,1,20.0,2,1.09,10.0,14.0,-4.0,-0.42,0.42,9.0,10.6,-1.7,-0.18,0.26,Matches,260.0,rs SRB,MF,21.0,9.5,489.0,26.0,98.0,249.0,149.0,11.0,489.0,17.0,8.0,47.1,7.0,41.2,219.0,1427.0,609.0,18.0,13.0,4.0,17.0,5.0,238.0,20.0,Matches,260.0,rs SRB,MF,21.0,9.5,0.0,9.0,2.0,22.2,0.95,0.21,0.0,0.0,21.6,0.0,0.0,0.0,0.4,0.4,0.04,-0.4,-0.4,Matches,260.0,rs SRB,MF,21.0,11.0,10.0,851.0,9.5,0.0,1.0,1.0,0.0,0.0,0.0,1.0,0.0,0.4,0.4,1.0,1.4,18.0,39.0,20.0,0.0,0.11,0.11,0.0,0.11,0.04,0.1,0.14,0.04,0.14,Matches,Ivan Ilić,DM/M/AM C,21,135,159,Serbia,Hellas Verona,13,12,15,10,14,12,9,11,7,8,14,10,12,15,10,14,11,14,12,14,13,15,13,9,11,12,16,12,12,13,13,12,15,14,14,12,13,9,12,6,11,3,1,3,2,2,1,3,2,3,1,2,16,15,6,12,12,17,11,12,1,1,1,1,1,1,18,1,20,1,1,18,1,1,182,75,20,11,32960000,6750,6400,5300,Northern_European,133,4,2001/3/17,3,0,4999.0,,62201068
659,Emirhan İlkhan,Torino,2004,263.0,tr TUR,MF,18.0,1.0,1.0,1.0,0.0,1.0,0.0,1.0,1.0,100.0,0.0,3.0,1.0,2.0,2.0,3.0,2.0,0.0,Matches,263.0,tr TUR,MF,18.0,1.0,5.0,5.17,5.0,0.0,0.0,0.0,0.0,0.0,1.0,1.03,1.0,0.0,0.0,0.0,0.0,0.0,Matches,,,,,,,,,,,,,,,,,,,,,,,,,,,,,,,,,,,,,,,,,,,,,,,,,,,,,,,,263.0,tr TUR,MF,18.0,1.0,1.0,0.0,0.0,5.0,0.0,0.0,0.0,2.0,1.0,0.0,0.0,0.0,7.0,1.0,2.0,33.3,Matches,263.0,tr TUR,MF,18.0,1.0,43.0,41.0,2.0,2.0,0.0,2.0,0.0,0.0,0.0,0.0,0.0,0.0,36.0,0.0,0.0,Matches,263.0,tr TUR,MF,18.0,1.0,36.0,43.0,83.7,671.0,140.0,16.0,19.0,84.2,12.0,13.0,92.3,7.0,9.0,77.8,0.0,0.1,0.0,-0.1,1.0,6.0,2.0,0.0,8.0,Matches,342,tr TUR,MF,18,4,87.0,22.0,2.5,1.0,1,63.0,0,3,8.0,11,2.25,1.0,2.0,-1.0,-1.03,-1.09,1.2,1.9,-0.7,-0.71,-0.77,Matches,263.0,tr TUR,MF,18.0,1.0,58.0,4.0,12.0,34.0,12.0,0.0,58.0,2.0,1.0,50.0,1.0,50.0,39.0,240.0,86.0,2.0,4.0,0.0,2.0,2.0,38.0,3.0,Matches,263.0,tr TUR,MF,18.0,1.0,0.0,2.0,0.0,0.0,2.07,0.0,0.0,,31.8,0.0,0.0,0.0,0.0,0.0,0.02,0.0,0.0,Matches,263.0,tr TUR,MF,18.0,4.0,1.0,87.0,1.0,0.0,0.0,0.0,0.0,0.0,0.0,1.0,0.0,0.0,0.0,0.1,0.1,2.0,8.0,3.0,0.0,0.0,0.0,0.0,0.0,0.05,0.1,0.14,0.05,0.14,Matches,Emirhan İlkhan,M/AM C,18,119,-8,Turkey,Torino,6,11,15,12,14,7,7,11,3,7,12,8,7,15,9,12,10,12,10,12,13,13,15,7,13,7,12,14,14,14,12,8,14,13,13,8,13,6,11,5,12,2,3,1,2,2,3,1,1,3,1,3,13,15,6,16,10,14,14,12,1,1,1,1,1,1,12,1,20,1,12,18,12,1,176,72,10,20,55520001,5950,2965,1207,North_African__Middle_Eastern,112,4,2004/6/1,0,0,6730.0,,2000079739
660,Mato Jajalo,Udinese,1988,269.0,ba BIH,MF,34.0,0.7,0.0,0.0,0.0,0.0,0.0,0.0,1.0,0.0,1.0,0.0,0.0,0.0,0.0,0.0,2.0,0.0,Matches,269.0,ba BIH,MF,34.0,0.7,3.0,4.29,3.0,0.0,0.0,0.0,0.0,0.0,0.0,0.0,0.0,0.0,0.0,0.0,0.0,0.0,Matches,,,,,,,,,,,,,,,,,,,,,,,,,,,,,,,,,,,,,,,,,,,,,,,,,,,,,,,,269.0,ba BIH,MF,34.0,0.7,0.0,0.0,0.0,1.0,0.0,0.0,0.0,0.0,0.0,0.0,0.0,0.0,6.0,1.0,0.0,100.0,Matches,269.0,ba BIH,MF,34.0,0.7,29.0,29.0,0.0,0.0,0.0,2.0,0.0,0.0,0.0,0.0,0.0,0.0,23.0,0.0,2.0,Matches,269.0,ba BIH,MF,34.0,0.7,23.0,29.0,79.3,401.0,166.0,10.0,13.0,76.9,9.0,9.0,100.0,3.0,4.0,75.0,0.0,0.0,0.1,0.0,1.0,1.0,1.0,0.0,4.0,Matches,349,ba BIH,MF,34,3,63.0,21.0,1.8,0.7,0,,0,3,21.0,12,0.67,2.0,0.0,2.0,2.86,2.94,0.8,0.2,0.6,0.82,0.97,Matches,269.0,ba BIH,MF,34.0,0.7,36.0,4.0,7.0,14.0,16.0,1.0,36.0,2.0,1.0,50.0,1.0,50.0,17.0,67.0,40.0,0.0,2.0,0.0,1.0,0.0,22.0,1.0,Matches,269.0,ba BIH,MF,34.0,0.7,0.0,2.0,0.0,0.0,2.86,0.0,0.0,,26.3,0.0,0.0,0.0,0.0,0.0,0.02,0.0,0.0,Matches,269.0,ba BIH,MF,34.0,3.0,0.0,63.0,0.7,0.0,0.0,0.0,0.0,0.0,0.0,0.0,0.0,0.0,0.0,0.0,0.1,0.0,4.0,1.0,0.0,0.0,0.0,0.0,0.0,0.07,0.07,0.14,0.07,0.14,Matches,Mato Jajalo,DM/M C,34,122,130,"Bosnia and Herzegovina,Croatia",Udinese Calcio,13,12,12,8,14,12,12,13,10,10,15,12,11,15,14,12,15,13,15,13,13,17,13,13,9,13,13,14,11,11,14,10,16,11,11,14,15,7,14,3,12,3,1,4,2,3,2,3,3,1,1,4,18,14,6,11,16,16,14,18,1,1,1,1,1,1,20,1,20,1,1,5,1,1,182,77,8,20,148538,6100,6300,4650,Mediterranean_Hispanic,123,4,1988/5/25,11,0,25000.0,,24004081
661,Jesé,Sampdoria,1993,270.0,es ESP,FW,29.0,2.3,2.0,0.0,0.0,2.0,0.0,0.0,1.0,0.0,1.0,3.0,1.0,2.0,1.0,3.0,2.0,0.0,Matches,270.0,es ESP,FW,29.0,2.3,7.0,3.0,5.0,0.0,0.0,1.0,1.0,0.0,2.0,0.86,2.0,0.0,0.0,0.0,0.0,0.0,Matches,,,,,,,,,,,,,,,,,,,,,,,,,,,,,,,,,,,,,,,,,,,,,,,,,,,,,,,,270.0,es ESP,FW,29.0,2.3,0.0,0.0,0.0,3.0,5.0,2.0,0.0,1.0,0.0,0.0,0.0,0.0,8.0,2.0,12.0,14.3,Matches,270.0,es ESP,FW,29.0,2.3,65.0,56.0,9.0,0.0,0.0,1.0,0.0,2.0,0.0,0.0,0.0,0.0,47.0,0.0,4.0,Matches,270.0,es ESP,FW,29.0,2.3,47.0,65.0,72.3,706.0,87.0,26.0,30.0,86.7,16.0,21.0,76.2,3.0,4.0,75.0,1.0,0.5,0.4,0.5,2.0,0.0,0.0,0.0,1.0,Matches,351,es ESP,FW,29,11,210.0,19.0,6.1,2.3,1,60.0,0,10,15.0,5,0.55,2.0,8.0,-6.0,-2.57,-1.42,2.0,4.9,-2.9,-1.25,-0.43,Matches,270.0,es ESP,FW,29.0,2.3,92.0,3.0,5.0,47.0,41.0,6.0,92.0,5.0,3.0,60.0,1.0,20.0,49.0,313.0,74.0,1.0,4.0,0.0,5.0,3.0,60.0,15.0,Matches,270.0,es ESP,FW,29.0,2.3,1.0,3.0,2.0,66.7,1.29,0.86,0.33,0.5,20.4,0.0,0.0,0.0,0.3,0.3,0.1,0.7,0.7,Matches,270.0,es ESP,FW,29.0,11.0,1.0,210.0,2.3,1.0,1.0,2.0,1.0,0.0,0.0,0.0,0.0,0.3,0.3,0.5,0.8,1.0,1.0,15.0,0.43,0.43,0.86,0.43,0.86,0.13,0.2,0.34,0.13,0.34,Matches,Jesé,AM/S RLC,29,129,152,Spain,MKE Ankaragücü,13,9,15,13,15,12,8,13,5,4,13,14,6,16,14,13,12,12,8,14,9,11,15,12,14,6,10,11,13,13,12,9,9,13,13,11,8,10,12,13,14,2,1,2,2,3,2,2,3,3,2,1,8,8,15,8,10,7,8,8,1,1,1,1,1,1,1,12,1,12,18,15,17,20,178,72,14,20,4625212,6500,6550,4900,Mediterranean_Hispanic,122,6,1993/2/26,0,0,25000.0,,67117361
662,Þórir Jóhann Helgason,Lecce,2000,272.0,is ISL,MF,21.0,2.5,2.0,2.0,1.0,0.0,1.0,2.0,3.0,66.7,1.0,3.0,1.0,2.0,3.0,5.0,3.0,0.0,Matches,272.0,is ISL,MF,21.0,2.5,7.0,2.84,3.0,3.0,0.0,0.0,1.0,0.0,1.0,0.41,1.0,0.0,0.0,0.0,0.0,0.0,Matches,,,,,,,,,,,,,,,,,,,,,,,,,,,,,,,,,,,,,,,,,,,,,,,,,,,,,,,,272.0,is ISL,MF,21.0,2.5,0.0,0.0,0.0,2.0,2.0,0.0,10.0,3.0,2.0,0.0,0.0,0.0,12.0,4.0,7.0,36.4,Matches,272.0,is ISL,MF,21.0,2.5,75.0,65.0,10.0,2.0,0.0,0.0,10.0,0.0,6.0,5.0,1.0,0.0,55.0,0.0,0.0,Matches,272.0,is ISL,MF,21.0,2.5,55.0,75.0,73.3,967.0,363.0,26.0,34.0,76.5,19.0,22.0,86.4,8.0,15.0,53.3,0.0,0.4,0.3,-0.4,4.0,2.0,0.0,0.0,2.0,Matches,353,is ISL,MF,21,12,222.0,19.0,6.5,2.5,2,45.0,0,10,13.0,24,0.58,1.0,4.0,-3.0,-1.22,-0.93,2.0,3.7,-1.7,-0.7,-0.57,Matches,272.0,is ISL,MF,21.0,2.5,96.0,8.0,25.0,42.0,31.0,3.0,96.0,1.0,0.0,0.0,1.0,100.0,41.0,181.0,88.0,2.0,2.0,1.0,4.0,2.0,50.0,5.0,Matches,272.0,is ISL,MF,21.0,2.5,0.0,2.0,0.0,0.0,0.81,0.0,0.0,,32.6,1.0,0.0,0.0,0.1,0.1,0.03,-0.1,-0.1,Matches,272.0,is ISL,MF,21.0,12.0,2.0,222.0,2.5,0.0,0.0,0.0,0.0,0.0,0.0,0.0,0.0,0.1,0.1,0.4,0.4,2.0,2.0,5.0,0.0,0.0,0.0,0.0,0.0,0.02,0.16,0.18,0.02,0.18,Matches,Þórir Jóhann Helgason,M C,21,111,148,Iceland,Salento,11,12,13,12,13,10,8,12,2,11,13,10,11,13,6,13,12,9,12,12,12,12,12,13,13,11,13,11,12,12,12,13,14,12,12,12,12,4,10,3,12,2,1,1,1,1,3,3,1,3,2,1,14,12,4,12,13,13,14,16,1,1,1,1,1,1,15,1,20,1,1,12,1,1,187,74,8,20,4303999,5548,4892,2048,Northern_European,112,1,2000/9/28,12,2,5014.0,,39053303
663,Yayah Kallon,Hellas Verona,2001,275.0,sl SLE,MFFW,21.0,9.6,14.0,10.0,5.0,4.0,5.0,7.0,12.0,58.3,5.0,10.0,0.0,10.0,8.0,22.0,5.0,0.0,Matches,275.0,sl SLE,MFFW,21.0,9.6,30.0,3.14,24.0,0.0,2.0,1.0,3.0,0.0,2.0,0.21,1.0,0.0,0.0,1.0,0.0,0.0,Matches,,,,,,,,,,,,,,,,,,,,,,,,,,,,,,,,,,,,,,,,,,,,,,,,,,,,,,,,275.0,sl SLE,MFFW,21.0,9.6,1.0,0.0,0.0,13.0,21.0,4.0,33.0,8.0,10.0,0.0,0.0,0.0,40.0,9.0,22.0,29.0,Matches,275.0,sl SLE,MFFW,21.0,9.6,237.0,223.0,12.0,2.0,0.0,0.0,33.0,4.0,1.0,0.0,0.0,0.0,148.0,2.0,10.0,Matches,275.0,sl SLE,MFFW,21.0,9.6,148.0,237.0,62.4,2179.0,653.0,79.0,106.0,74.5,51.0,83.0,61.4,8.0,17.0,47.1,1.0,1.5,0.9,-0.5,13.0,10.0,14.0,6.0,22.0,Matches,358,sl SLE,MFFW,21,22,860.0,39.0,25.1,9.6,8,57.0,0,14,29.0,14,0.77,8.0,14.0,-6.0,-0.63,0.15,10.6,11.8,-1.1,-0.12,0.34,Matches,275.0,sl SLE,MFFW,21.0,9.6,356.0,7.0,31.0,127.0,207.0,43.0,356.0,30.0,8.0,26.7,14.0,46.7,233.0,1764.0,764.0,33.0,20.0,14.0,28.0,15.0,237.0,64.0,Matches,275.0,sl SLE,MFFW,21.0,9.6,1.0,20.0,6.0,30.0,2.09,0.63,0.05,0.17,19.4,0.0,0.0,0.0,1.7,1.7,0.08,-0.7,-0.7,Matches,275.0,sl SLE,MFFW,21.0,22.0,8.0,860.0,9.6,1.0,1.0,2.0,1.0,0.0,0.0,1.0,0.0,1.7,1.7,1.5,3.2,33.0,22.0,64.0,0.1,0.1,0.21,0.1,0.21,0.17,0.16,0.33,0.17,0.33,Matches,Yayah Kallon,AM/S RL,21,123,145,Sierra Leone,Genoa CFC,5,9,14,11,12,8,10,10,3,4,11,9,7,12,9,10,11,10,9,9,12,11,10,6,12,7,9,11,16,14,12,8,14,15,12,11,11,7,11,6,13,1,3,2,2,2,2,4,2,2,2,2,14,13,2,13,15,12,13,13,1,1,1,1,8,8,1,12,1,12,15,14,19,20,175,70,20,10,5595999,6150,5512,4509,African_Caribbean,106,15,2001/6/30,0,0,14448.0,Hellas Verona,43459202
664,Yann Karamoh,Torino,1998,277.0,fr FRA,MFFW,24.0,8.0,5.0,2.0,3.0,2.0,0.0,1.0,5.0,20.0,4.0,5.0,0.0,5.0,0.0,5.0,2.0,1.0,Matches,277.0,fr FRA,MFFW,24.0,8.0,22.0,2.77,17.0,0.0,3.0,1.0,1.0,0.0,3.0,0.38,1.0,0.0,2.0,0.0,0.0,0.0,Matches,,,,,,,,,,,,,,,,,,,,,,,,,,,,,,,,,,,,,,,,,,,,,,,,,,,,,,,,277.0,fr FRA,MFFW,24.0,8.0,2.0,0.0,0.0,11.0,13.0,12.0,15.0,0.0,2.0,0.0,0.0,0.0,29.0,7.0,24.0,22.6,Matches,277.0,fr FRA,MFFW,24.0,8.0,216.0,208.0,7.0,1.0,2.0,3.0,15.0,1.0,0.0,0.0,0.0,0.0,163.0,1.0,13.0,Matches,277.0,fr FRA,MFFW,24.0,8.0,163.0,216.0,75.5,2385.0,407.0,98.0,112.0,87.5,55.0,69.0,79.7,6.0,13.0,46.2,0.0,0.7,0.4,-0.7,11.0,5.0,5.0,3.0,12.0,Matches,361,fr FRA,MFFW,24,21,716.0,34.0,20.9,8.0,7,63.0,0,14,19.0,9,1.24,9.0,8.0,1.0,0.13,0.13,11.8,6.9,4.9,0.62,0.72,Matches,277.0,fr FRA,MFFW,24.0,8.0,347.0,4.0,22.0,139.0,192.0,35.0,347.0,57.0,26.0,45.6,25.0,43.9,221.0,1493.0,646.0,27.0,10.0,11.0,33.0,13.0,257.0,74.0,Matches,277.0,fr FRA,MFFW,24.0,8.0,4.0,20.0,12.0,60.0,2.51,1.51,0.2,0.33,15.5,0.0,0.0,0.0,3.3,3.3,0.16,0.7,0.7,Matches,277.0,fr FRA,MFFW,24.0,21.0,7.0,716.0,8.0,4.0,0.0,4.0,4.0,0.0,0.0,2.0,0.0,3.3,3.3,0.7,4.0,27.0,12.0,74.0,0.5,0.0,0.5,0.5,0.5,0.41,0.09,0.5,0.41,0.5,Matches,Yann Karamoh,AM/S RL,24,123,135,"France,Ivory Coast",Torino,6,13,15,12,13,8,10,11,4,4,12,10,4,14,8,10,8,12,8,11,9,12,14,6,13,6,11,7,17,14,12,11,14,15,10,10,10,6,13,8,14,2,2,3,1,2,1,3,1,1,1,3,11,13,10,10,10,12,12,10,1,1,1,1,1,1,1,1,1,1,15,9,20,18,185,77,10,20,1196349,6150,6400,4500,African_Caribbean,116,15,1998/7/8,0,0,42692.0,,85144982
665,Rick Karsdorp,Roma,1995,278.0,nl NED,DF,27.0,7.9,21.0,13.0,11.0,7.0,3.0,13.0,22.0,59.1,9.0,0.0,0.0,0.0,7.0,28.0,15.0,1.0,Matches,278.0,nl NED,DF,27.0,7.9,16.0,2.03,13.0,3.0,0.0,0.0,0.0,0.0,0.0,0.0,0.0,0.0,0.0,0.0,0.0,0.0,Matches,,,,,,,,,,,,,,,,,,,,,,,,,,,,,,,,,,,,,,,,,,,,,,,,,,,,,,,,278.0,nl NED,DF,27.0,7.9,0.0,0.0,0.0,4.0,0.0,1.0,14.0,7.0,13.0,0.0,0.0,0.0,45.0,5.0,2.0,71.4,Matches,278.0,nl NED,DF,27.0,7.9,380.0,306.0,73.0,4.0,3.0,1.0,14.0,69.0,0.0,0.0,0.0,0.0,295.0,1.0,8.0,Matches,278.0,nl NED,DF,27.0,7.9,295.0,380.0,77.6,5109.0,1611.0,134.0,153.0,87.6,131.0,155.0,84.5,27.0,53.0,50.9,0.0,1.2,1.1,-1.2,6.0,13.0,11.0,1.0,24.0,Matches,362,nl NED,DF,27,13,711.0,55.0,20.8,7.9,8,73.0,2,5,26.0,3,1.54,10.0,8.0,2.0,0.25,-0.08,12.3,7.3,5.0,0.63,-0.05,Matches,278.0,nl NED,DF,27.0,7.9,444.0,30.0,156.0,185.0,110.0,9.0,444.0,6.0,0.0,0.0,5.0,83.3,236.0,1148.0,575.0,16.0,8.0,2.0,11.0,6.0,260.0,33.0,Matches,278.0,nl NED,DF,27.0,7.9,0.0,2.0,0.0,0.0,0.25,0.0,0.0,,19.4,0.0,0.0,0.0,0.3,0.3,0.14,-0.3,-0.3,Matches,278.0,nl NED,DF,27.0,13.0,8.0,711.0,7.9,0.0,0.0,0.0,0.0,0.0,0.0,0.0,0.0,0.3,0.3,1.2,1.5,16.0,24.0,33.0,0.0,0.0,0.0,0.0,0.0,0.03,0.15,0.19,0.03,0.19,Matches,Rick Karsdorp,D/WB R,27,142,147,Holland,Associazione Sportiva Roma,6,11,11,5,14,6,8,6,15,11,14,5,12,13,15,14,15,15,14,13,12,17,11,7,17,11,13,16,14,13,14,9,18,18,17,12,15,11,12,7,13,2,3,2,3,1,3,3,3,1,2,2,10,14,11,12,11,15,14,10,1,1,10,20,1,18,1,1,1,14,1,1,1,1,184,80,8,20,33809621,7100,6500,5750,Northern_European,134,1,1995/2/11,3,0,78269.0,,37039938
666,Denso Kasius,Bologna,2002,279.0,nl NED,DF,19.0,3.8,12.0,6.0,7.0,4.0,1.0,8.0,10.0,80.0,2.0,6.0,3.0,3.0,3.0,15.0,6.0,0.0,Matches,279.0,nl NED,DF,19.0,3.8,15.0,3.94,13.0,0.0,2.0,0.0,0.0,0.0,2.0,0.52,2.0,0.0,0.0,0.0,0.0,0.0,Matches,,,,,,,,,,,,,,,,,,,,,,,,,,,,,,,,,,,,,,,,,,,,,,,,,,,,,,,,279.0,nl NED,DF,19.0,3.8,1.0,0.0,0.0,3.0,1.0,0.0,12.0,3.0,6.0,0.0,0.0,0.0,18.0,1.0,4.0,20.0,Matches,279.0,nl NED,DF,19.0,3.8,192.0,156.0,35.0,1.0,0.0,3.0,12.0,34.0,0.0,0.0,0.0,0.0,143.0,1.0,3.0,Matches,279.0,nl NED,DF,19.0,3.8,143.0,192.0,74.5,2576.0,864.0,65.0,72.0,90.3,53.0,74.0,71.6,20.0,36.0,55.6,2.0,0.7,0.8,1.3,6.0,6.0,8.0,6.0,9.0,Matches,363,nl NED,DF,19,7,342.0,49.0,10.0,3.8,4,69.0,1,3,22.0,5,1.14,3.0,7.0,-4.0,-1.05,-1.29,3.9,6.8,-2.9,-0.77,-0.71,Matches,279.0,nl NED,DF,19.0,3.8,243.0,6.0,75.0,105.0,65.0,3.0,243.0,10.0,6.0,60.0,3.0,30.0,127.0,728.0,374.0,9.0,10.0,1.0,11.0,7.0,144.0,21.0,Matches,279.0,nl NED,DF,19.0,3.8,0.0,4.0,0.0,0.0,1.05,0.0,0.0,,23.9,0.0,0.0,0.0,0.1,0.1,0.03,-0.1,-0.1,Matches,279.0,nl NED,DF,19.0,7.0,4.0,342.0,3.8,0.0,2.0,2.0,0.0,0.0,0.0,1.0,0.0,0.1,0.1,0.7,0.8,9.0,9.0,21.0,0.0,0.53,0.53,0.0,0.53,0.03,0.18,0.21,0.03,0.21,Matches,Denso Kasius,D/WB/M R,19,122,-75,Holland,Bologna FC 1909,7,14,12,9,12,7,8,11,10,10,12,5,13,12,14,12,12,10,10,12,10,11,10,7,13,9,13,14,16,13,11,11,16,15,13,10,11,11,7,5,12,3,1,2,3,1,3,2,1,3,4,2,12,8,3,14,11,12,10,9,1,1,1,20,1,20,1,1,1,19,1,1,10,1,185,70,8,20,40240001,6100,5900,4500,Northern_European,111,0,2002/10/6,0,0,8893.0,,37076465
667,Marash Kumbulla,Roma,2000,291.0,al ALB,DF,22.0,2.9,4.0,4.0,2.0,2.0,0.0,2.0,3.0,66.7,1.0,2.0,1.0,1.0,4.0,8.0,6.0,0.0,Matches,291.0,al ALB,DF,22.0,2.9,2.0,0.69,2.0,0.0,0.0,0.0,0.0,0.0,0.0,0.0,0.0,0.0,0.0,0.0,0.0,0.0,Matches,,,,,,,,,,,,,,,,,,,,,,,,,,,,,,,,,,,,,,,,,,,,,,,,,,,,,,,,291.0,al ALB,DF,22.0,2.9,1.0,1.0,0.0,3.0,5.0,0.0,0.0,4.0,4.0,0.0,1.0,0.0,15.0,7.0,4.0,63.6,Matches,291.0,al ALB,DF,22.0,2.9,180.0,176.0,4.0,4.0,0.0,2.0,0.0,0.0,0.0,0.0,0.0,0.0,157.0,0.0,1.0,Matches,291.0,al ALB,DF,22.0,2.9,157.0,180.0,87.2,2847.0,772.0,65.0,67.0,97.0,80.0,85.0,94.1,9.0,22.0,40.9,0.0,0.1,0.0,-0.1,1.0,3.0,0.0,0.0,8.0,Matches,380,al ALB,DF,22,7,259.0,37.0,7.6,2.9,5,48.0,1,2,9.0,19,1.57,4.0,3.0,1.0,0.35,0.03,2.5,2.6,-0.1,-0.04,-0.76,Matches,291.0,al ALB,DF,22.0,2.9,204.0,15.0,102.0,100.0,5.0,2.0,204.0,0.0,0.0,,0.0,,136.0,615.0,316.0,2.0,1.0,0.0,2.0,0.0,155.0,1.0,Matches,291.0,al ALB,DF,22.0,2.9,0.0,1.0,0.0,0.0,0.35,0.0,0.0,,13.8,0.0,0.0,0.0,0.0,0.0,0.02,0.0,0.0,Matches,291.0,al ALB,DF,22.0,7.0,5.0,259.0,2.9,0.0,0.0,0.0,0.0,0.0,0.0,1.0,1.0,0.0,0.0,0.1,0.1,2.0,8.0,1.0,0.0,0.0,0.0,0.0,0.0,0.01,0.03,0.04,0.01,0.04,Matches,Marash Kumbulla,D C,22,135,154,"Albania,Italy",Associazione Sportiva Roma,5,7,8,9,11,5,17,5,13,16,12,6,15,10,8,14,13,11,11,9,12,11,7,6,5,14,16,15,10,9,12,16,15,15,16,15,12,13,11,8,4,1,2,2,2,2,3,2,1,1,4,2,14,15,7,12,8,16,13,12,1,1,20,7,1,1,1,1,1,1,1,1,1,1,191,82,11,20,18188001,6750,6950,5600,Mediterranean_Hispanic,133,2,2000/2/8,15,0,64038.0,,43296495
668,Giorgos Kyriakopoulos,Bologna,1996,293.0,gr GRE,DFFW,26.0,7.8,13.0,6.0,4.0,5.0,4.0,10.0,23.0,43.5,13.0,14.0,2.0,12.0,4.0,17.0,10.0,0.0,Matches,293.0,gr GRE,DFFW,26.0,7.8,20.0,2.56,13.0,4.0,1.0,1.0,1.0,0.0,3.0,0.38,2.0,1.0,0.0,0.0,0.0,0.0,Matches,,,,,,,,,,,,,,,,,,,,,,,,,,,,,,,,,,,,,,,,,,,,,,,,,,,,,,,,293.0,gr GRE,DFFW,26.0,7.8,2.0,0.0,0.0,9.0,12.0,0.0,38.0,4.0,6.0,0.0,0.0,0.0,41.0,5.0,11.0,31.3,Matches,293.0,gr GRE,DFFW,26.0,7.8,413.0,352.0,59.0,12.0,0.0,0.0,38.0,37.0,10.0,9.0,1.0,0.0,318.0,2.0,10.0,Matches,293.0,gr GRE,DFFW,26.0,7.8,318.0,413.0,77.0,4904.0,2157.0,177.0,193.0,91.7,105.0,128.0,82.0,26.0,65.0,40.0,2.0,0.8,1.1,1.2,9.0,22.0,11.0,6.0,23.0,Matches,382,gr GRE,DFFW,26,12,704.0,59.0,20.6,7.8,8,78.0,4,4,20.0,0,1.58,11.0,8.0,3.0,0.38,0.35,7.2,11.5,-4.4,-0.56,-0.54,Matches,293.0,gr GRE,DFFW,26.0,7.8,490.0,20.0,137.0,194.0,163.0,9.0,490.0,17.0,11.0,64.7,4.0,23.5,293.0,1735.0,1021.0,21.0,15.0,1.0,13.0,8.0,331.0,50.0,Matches,293.0,gr GRE,DFFW,26.0,7.8,0.0,7.0,3.0,42.9,0.89,0.38,0.0,0.0,19.5,0.0,0.0,0.0,0.2,0.2,0.03,-0.2,-0.2,Matches,293.0,gr GRE,DFFW,26.0,12.0,8.0,704.0,7.8,0.0,2.0,2.0,0.0,0.0,0.0,2.0,0.0,0.2,0.2,0.8,1.0,21.0,23.0,50.0,0.0,0.26,0.26,0.0,0.26,0.03,0.1,0.13,0.03,0.13,Matches,Giorgos Kyriakopoulos,D/WB/M/AM L,26,133,139,Greece,U.S. Sassuolo,12,12,13,10,13,11,8,10,13,11,13,8,13,13,14,12,15,10,12,13,12,15,12,10,14,13,13,14,14,13,14,11,13,14,14,13,13,10,13,4,12,3,2,1,3,2,2,3,3,1,1,3,16,15,8,13,13,15,15,13,1,20,1,1,18,1,1,17,1,1,16,1,1,1,178,74,20,8,5580955,6645,5937,5162,Mediterranean_Hispanic,128,1,1996/2/5,5,0,9807.0,,36090959
669,Sam Lammers,Empoli,1997,296.0,nl NED,FW,25.0,9.8,20.0,10.0,5.0,9.0,6.0,7.0,11.0,63.6,4.0,4.0,1.0,3.0,3.0,23.0,8.0,0.0,Matches,296.0,nl NED,FW,25.0,9.8,25.0,2.55,18.0,1.0,3.0,1.0,2.0,0.0,1.0,0.1,1.0,0.0,0.0,0.0,0.0,0.0,Matches,,,,,,,,,,,,,,,,,,,,,,,,,,,,,,,,,,,,,,,,,,,,,,,,,,,,,,,,296.0,nl NED,FW,25.0,9.8,0.0,0.0,0.0,6.0,8.0,1.0,4.0,3.0,10.0,0.0,0.0,0.0,27.0,18.0,16.0,52.9,Matches,296.0,nl NED,FW,25.0,9.8,230.0,226.0,3.0,0.0,0.0,0.0,4.0,0.0,0.0,0.0,0.0,0.0,143.0,1.0,8.0,Matches,296.0,nl NED,FW,25.0,9.8,143.0,230.0,62.2,1814.0,451.0,94.0,129.0,72.9,41.0,60.0,68.3,1.0,5.0,20.0,1.0,0.7,0.3,0.3,10.0,13.0,4.0,0.0,19.0,Matches,385,nl NED,FW,25,14,883.0,63.0,25.8,9.8,10,73.0,4,4,38.0,1,1.21,8.0,14.0,-6.0,-0.61,-0.4,9.1,14.8,-5.8,-0.59,-0.1,Matches,296.0,nl NED,FW,25.0,9.8,358.0,12.0,35.0,151.0,179.0,49.0,358.0,23.0,10.0,43.5,12.0,52.2,193.0,1064.0,354.0,9.0,12.0,6.0,37.0,14.0,268.0,67.0,Matches,296.0,nl NED,FW,25.0,9.8,1.0,28.0,7.0,25.0,2.85,0.71,0.04,0.14,15.5,0.0,0.0,0.0,2.3,2.3,0.08,-1.3,-1.3,Matches,296.0,nl NED,FW,25.0,14.0,10.0,883.0,9.8,1.0,1.0,2.0,1.0,0.0,0.0,0.0,0.0,2.3,2.3,0.7,2.9,9.0,19.0,67.0,0.1,0.1,0.2,0.1,0.2,0.23,0.07,0.3,0.23,0.3,Matches,Sam Lammers,AM/S C,25,128,134,Holland,Atalanta,6,9,13,12,14,10,13,11,7,5,11,13,5,13,8,14,12,12,12,13,11,15,13,7,14,6,12,13,12,14,14,14,12,12,13,12,12,7,11,6,12,1,1,2,1,2,1,2,3,1,3,3,11,15,7,11,14,15,12,11,1,1,1,1,1,1,1,7,7,6,8,16,11,20,191,77,20,15,1293112,6400,6000,5250,Northern_European,127,5,1997/4/30,0,0,23384.0,Empoli Football Club,37056187
670,Marko Lazetić,Milan,2004,300.0,rs SRB,FW,18.0,0.1,0.0,0.0,0.0,0.0,0.0,0.0,0.0,,0.0,0.0,0.0,0.0,0.0,0.0,0.0,0.0,Matches,300.0,rs SRB,FW,18.0,0.1,0.0,0.0,0.0,0.0,0.0,0.0,0.0,0.0,0.0,0.0,0.0,0.0,0.0,0.0,0.0,0.0,Matches,,,,,,,,,,,,,,,,,,,,,,,,,,,,,,,,,,,,,,,,,,,,,,,,,,,,,,,,300.0,rs SRB,FW,18.0,0.1,1.0,0.0,0.0,0.0,0.0,0.0,0.0,0.0,0.0,0.0,0.0,0.0,1.0,0.0,1.0,0.0,Matches,300.0,rs SRB,FW,18.0,0.1,1.0,1.0,0.0,0.0,0.0,0.0,0.0,0.0,0.0,0.0,0.0,0.0,1.0,0.0,0.0,Matches,300.0,rs SRB,FW,18.0,0.1,1.0,1.0,100.0,18.0,0.0,0.0,0.0,,1.0,1.0,100.0,0.0,0.0,,0.0,0.0,0.0,0.0,0.0,0.0,0.0,0.0,0.0,Matches,389,rs SRB,FW,18,1,9.0,9.0,0.3,0.1,0,,0,1,9.0,4,1.0,0.0,0.0,0.0,0.0,-0.55,0.1,0.2,-0.1,-1.34,-1.81,Matches,300.0,rs SRB,FW,18.0,0.1,4.0,0.0,0.0,2.0,2.0,1.0,4.0,0.0,0.0,,0.0,,2.0,5.0,0.0,0.0,0.0,0.0,1.0,2.0,3.0,3.0,Matches,300.0,rs SRB,FW,18.0,0.1,0.0,1.0,0.0,0.0,10.0,0.0,0.0,,13.2,0.0,0.0,0.0,0.1,0.1,0.06,-0.1,-0.1,Matches,300.0,rs SRB,FW,18.0,1.0,0.0,9.0,0.1,0.0,0.0,0.0,0.0,0.0,0.0,1.0,0.0,0.1,0.1,0.0,0.1,0.0,0.0,3.0,0.0,0.0,0.0,0.0,0.0,0.63,0.0,0.63,0.63,0.63,Matches,Marko Lazetić,S,18,106,-8,Serbia,AC Milan,8,8,12,11,13,8,12,10,5,7,9,11,7,13,11,11,10,11,9,8,10,9,13,7,13,12,7,12,11,11,11,14,12,13,12,13,12,9,9,9,8,1,1,2,1,2,3,1,3,3,1,3,11,12,11,12,19,10,11,10,1,1,1,1,1,1,1,1,1,1,12,1,10,20,192,80,11,20,36400001,5300,5500,3250,Northern_European,105,1,2004/1/22,0,0,6153.0,,2000013778
671,Matteo Lovato,Salernitana,2000,313.0,it ITA,DF,22.0,9.0,17.0,14.0,14.0,3.0,0.0,10.0,25.0,40.0,15.0,8.0,5.0,3.0,13.0,30.0,33.0,2.0,Matches,313.0,it ITA,DF,22.0,9.0,0.0,0.0,0.0,0.0,0.0,0.0,0.0,0.0,0.0,0.0,0.0,0.0,0.0,0.0,0.0,0.0,Matches,,,,,,,,,,,,,,,,,,,,,,,,,,,,,,,,,,,,,,,,,,,,,,,,,,,,,,,,313.0,it ITA,DF,22.0,9.0,2.0,0.0,0.0,6.0,4.0,0.0,0.0,13.0,14.0,0.0,0.0,0.0,40.0,15.0,16.0,48.4,Matches,313.0,it ITA,DF,22.0,9.0,325.0,307.0,17.0,17.0,1.0,3.0,0.0,0.0,0.0,0.0,0.0,0.0,274.0,1.0,2.0,Matches,313.0,it ITA,DF,22.0,9.0,274.0,325.0,84.3,5071.0,1760.0,99.0,112.0,88.4,136.0,155.0,87.7,30.0,44.0,68.2,0.0,0.0,0.0,0.0,0.0,8.0,0.0,0.0,8.0,Matches,406,it ITA,DF,22,17,814.0,48.0,23.8,9.0,8,74.0,4,9,25.0,9,1.06,11.0,22.0,-11.0,-1.22,-1.11,8.3,19.3,-11.1,-1.22,-0.56,Matches,313.0,it ITA,DF,22.0,9.0,411.0,58.0,233.0,172.0,9.0,0.0,411.0,0.0,0.0,,0.0,,210.0,794.0,386.0,1.0,1.0,1.0,5.0,3.0,227.0,1.0,Matches,313.0,it ITA,DF,22.0,9.0,0.0,1.0,0.0,0.0,0.11,0.0,0.0,,22.0,0.0,0.0,0.0,0.0,0.0,0.02,0.0,0.0,Matches,313.0,it ITA,DF,22.0,17.0,8.0,814.0,9.0,0.0,0.0,0.0,0.0,0.0,0.0,2.0,0.0,0.0,0.0,0.0,0.0,1.0,8.0,1.0,0.0,0.0,0.0,0.0,0.0,0.0,0.0,0.0,0.0,0.0,Matches,Matteo Lovato,D C,22,127,154,Italy,U.S. Salernitana 1919,4,6,8,5,10,5,15,5,6,14,11,6,14,11,14,14,13,13,12,10,12,15,6,13,5,14,13,13,12,11,12,15,14,13,13,15,13,12,13,6,7,1,1,3,2,2,2,2,1,1,2,2,14,15,7,13,16,15,16,11,1,1,20,1,1,1,1,1,1,1,1,1,1,1,188,78,10,20,7913073,6350,6350,3800,Northern_European,126,2,2000/2/14,0,0,14230.0,,43318558
672,José Luis Palomino,Atalanta,1990,317.0,ar ARG,DF,32.0,8.4,23.0,14.0,16.0,7.0,0.0,11.0,19.0,57.9,8.0,11.0,4.0,7.0,28.0,51.0,20.0,0.0,Matches,317.0,ar ARG,DF,32.0,8.4,9.0,1.07,7.0,0.0,1.0,1.0,0.0,0.0,2.0,0.24,1.0,0.0,0.0,1.0,0.0,0.0,Matches,,,,,,,,,,,,,,,,,,,,,,,,,,,,,,,,,,,,,,,,,,,,,,,,,,,,,,,,317.0,ar ARG,DF,32.0,8.4,4.0,0.0,0.0,9.0,5.0,0.0,5.0,28.0,14.0,0.0,0.0,1.0,75.0,24.0,13.0,64.9,Matches,317.0,ar ARG,DF,32.0,8.4,518.0,485.0,33.0,21.0,0.0,0.0,5.0,12.0,0.0,0.0,0.0,0.0,428.0,0.0,8.0,Matches,317.0,ar ARG,DF,32.0,8.4,428.0,518.0,82.6,7998.0,2928.0,169.0,191.0,88.5,214.0,242.0,88.4,44.0,70.0,62.9,0.0,0.3,0.3,-0.3,2.0,26.0,4.0,2.0,29.0,Matches,410,ar ARG,DF,32,15,759.0,51.0,22.2,8.4,8,79.0,6,7,18.0,2,1.8,25.0,15.0,10.0,1.19,0.92,17.2,10.4,6.8,0.8,0.48,Matches,317.0,ar ARG,DF,32.0,8.4,607.0,48.0,261.0,313.0,39.0,9.0,607.0,3.0,2.0,66.7,1.0,33.3,308.0,1514.0,638.0,3.0,1.0,1.0,3.0,3.0,339.0,3.0,Matches,317.0,ar ARG,DF,32.0,8.4,1.0,6.0,3.0,50.0,0.71,0.36,0.17,0.33,12.6,0.0,0.0,0.0,0.5,0.5,0.09,0.5,0.5,Matches,317.0,ar ARG,DF,32.0,15.0,8.0,759.0,8.4,1.0,0.0,1.0,1.0,0.0,0.0,4.0,0.0,0.5,0.5,0.3,0.8,3.0,29.0,3.0,0.12,0.0,0.12,0.12,0.12,0.06,0.03,0.1,0.06,0.1,Matches,José Luis Palomino,D C,32,145,150,"Argentina,Bulgaria",Atalanta,4,8,10,5,12,3,15,4,10,16,12,4,17,12,17,16,17,12,13,10,12,17,8,12,5,14,15,15,14,13,14,14,16,14,14,15,17,9,14,5,8,2,2,1,1,3,2,1,3,2,1,3,15,14,6,13,15,16,11,10,1,14,20,1,1,1,1,1,1,1,1,1,1,1,188,87,20,10,4405627,7250,6800,5750,Mediterranean_Hispanic,144,3,1990/1/5,0,0,28461.0,,14023020
673,Giulio Maggiore,Salernitana,1998,322.0,it ITA,MF,24.0,9.9,20.0,8.0,11.0,6.0,3.0,10.0,21.0,47.6,11.0,19.0,4.0,15.0,8.0,28.0,10.0,0.0,Matches,322.0,it ITA,MF,24.0,9.9,14.0,1.41,11.0,0.0,0.0,2.0,1.0,0.0,1.0,0.1,1.0,0.0,0.0,0.0,0.0,0.0,Matches,,,,,,,,,,,,,,,,,,,,,,,,,,,,,,,,,,,,,,,,,,,,,,,,,,,,,,,,322.0,it ITA,MF,24.0,9.9,2.0,0.0,0.0,20.0,14.0,0.0,3.0,8.0,8.0,0.0,1.0,0.0,75.0,9.0,14.0,39.1,Matches,322.0,it ITA,MF,24.0,9.9,472.0,461.0,7.0,5.0,3.0,5.0,3.0,1.0,0.0,0.0,0.0,0.0,351.0,4.0,8.0,Matches,322.0,it ITA,MF,24.0,9.9,351.0,472.0,74.4,5873.0,1564.0,166.0,208.0,79.8,140.0,163.0,85.9,33.0,67.0,49.3,0.0,0.5,0.6,-0.5,3.0,35.0,11.0,0.0,53.0,Matches,415,it ITA,MF,24,16,894.0,56.0,26.1,9.9,11,65.0,4,5,36.0,7,1.0,15.0,14.0,1.0,0.1,0.64,12.3,14.8,-2.5,-0.25,0.74,Matches,322.0,it ITA,MF,24.0,9.9,580.0,18.0,138.0,351.0,93.0,8.0,580.0,4.0,1.0,25.0,2.0,50.0,300.0,1117.0,427.0,7.0,3.0,1.0,18.0,4.0,365.0,13.0,Matches,322.0,it ITA,MF,24.0,9.9,0.0,6.0,0.0,0.0,0.6,0.0,0.0,,16.7,0.0,0.0,0.0,0.5,0.5,0.08,-0.5,-0.5,Matches,322.0,it ITA,MF,24.0,16.0,11.0,894.0,9.9,0.0,0.0,0.0,0.0,0.0,0.0,2.0,0.0,0.5,0.5,0.5,0.9,7.0,53.0,13.0,0.0,0.0,0.0,0.0,0.0,0.05,0.05,0.1,0.05,0.1,Matches,Giulio Maggiore,DM/M C,24,130,143,Italy,U.S. Salernitana 1919,8,10,14,12,14,9,14,11,10,11,15,11,14,14,13,13,12,12,13,14,14,14,11,10,13,14,13,13,12,12,13,10,15,12,14,13,13,10,13,8,10,2,2,2,1,4,2,1,1,1,3,3,7,14,7,14,12,14,14,12,1,1,1,1,1,1,16,1,20,11,1,1,7,1,184,69,8,20,8948932,6500,6500,3900,Mediterranean_Hispanic,132,2,1998/3/12,0,0,35577.0,,43207148
674,Jean-Victor Makengo,Udinese,1998,326.0,fr FRA,MF,24.0,8.9,16.0,13.0,7.0,7.0,2.0,5.0,9.0,55.6,4.0,8.0,2.0,6.0,9.0,25.0,3.0,0.0,Matches,326.0,fr FRA,MF,24.0,8.9,13.0,1.45,11.0,0.0,1.0,0.0,1.0,0.0,1.0,0.11,1.0,0.0,0.0,0.0,0.0,0.0,Matches,,,,,,,,,,,,,,,,,,,,,,,,,,,,,,,,,,,,,,,,,,,,,,,,,,,,,,,,326.0,fr FRA,MF,24.0,8.9,2.0,0.0,0.0,9.0,13.0,0.0,6.0,9.0,13.0,0.0,0.0,0.0,39.0,5.0,1.0,83.3,Matches,326.0,fr FRA,MF,24.0,8.9,316.0,315.0,1.0,1.0,0.0,0.0,6.0,0.0,0.0,0.0,0.0,0.0,264.0,0.0,9.0,Matches,326.0,fr FRA,MF,24.0,8.9,264.0,316.0,83.5,3718.0,884.0,167.0,180.0,92.8,79.0,96.0,82.3,9.0,13.0,69.2,1.0,0.5,0.4,0.5,5.0,19.0,6.0,1.0,36.0,Matches,420,fr FRA,MF,24,16,805.0,50.0,23.5,8.9,11,65.0,0,5,19.0,1,1.63,13.0,11.0,2.0,0.22,0.33,11.3,12.9,-1.6,-0.18,-0.06,Matches,326.0,fr FRA,MF,24.0,8.9,393.0,11.0,64.0,223.0,112.0,6.0,393.0,15.0,11.0,73.3,1.0,6.7,259.0,1518.0,688.0,18.0,17.0,0.0,15.0,11.0,290.0,31.0,Matches,326.0,fr FRA,MF,24.0,8.9,0.0,7.0,0.0,0.0,0.78,0.0,0.0,,21.4,0.0,0.0,0.0,0.4,0.4,0.05,-0.4,-0.4,Matches,326.0,fr FRA,MF,24.0,16.0,11.0,805.0,8.9,0.0,1.0,1.0,0.0,0.0,0.0,2.0,0.0,0.4,0.4,0.5,0.8,18.0,36.0,31.0,0.0,0.11,0.11,0.0,0.11,0.04,0.05,0.09,0.04,0.09,Matches,Jean-Victor Makengo,DM/M C,24,130,143,"France,Democratic Republic of Congo",Udinese Calcio,6,8,13,9,12,7,6,12,6,12,13,8,13,14,15,13,14,14,14,12,12,15,12,8,13,13,14,14,14,15,13,9,14,13,15,14,12,8,12,4,12,3,1,1,1,2,1,1,3,2,2,3,14,14,5,13,12,14,11,16,1,1,1,1,1,1,17,1,20,1,1,14,1,1,177,75,20,10,3531649,6498,6198,5048,African_Caribbean,130,15,1998/6/12,0,0,7307.0,,85144993
675,Daniel Maldini,Spezia,2001,328.0,it ITA,FWMF,20.0,7.0,12.0,5.0,3.0,4.0,5.0,4.0,11.0,36.4,7.0,9.0,0.0,9.0,1.0,13.0,8.0,0.0,Matches,328.0,it ITA,FWMF,20.0,7.0,22.0,3.16,10.0,1.0,5.0,2.0,4.0,0.0,0.0,0.0,0.0,0.0,0.0,0.0,0.0,0.0,Matches,,,,,,,,,,,,,,,,,,,,,,,,,,,,,,,,,,,,,,,,,,,,,,,,,,,,,,,,328.0,it ITA,FWMF,20.0,7.0,1.0,0.0,0.0,13.0,18.0,0.0,19.0,1.0,5.0,0.0,0.0,0.0,32.0,12.0,17.0,41.4,Matches,328.0,it ITA,FWMF,20.0,7.0,187.0,164.0,22.0,4.0,0.0,1.0,19.0,1.0,9.0,8.0,1.0,0.0,125.0,1.0,7.0,Matches,328.0,it ITA,FWMF,20.0,7.0,125.0,187.0,66.8,1665.0,330.0,72.0,89.0,80.9,33.0,47.0,70.2,7.0,25.0,28.0,0.0,0.5,0.3,-0.5,4.0,9.0,5.0,1.0,10.0,Matches,422,it ITA,FWMF,20,18,628.0,35.0,18.4,7.0,4,57.0,0,14,29.0,10,0.61,5.0,11.0,-6.0,-0.86,-0.05,8.1,12.1,-4.0,-0.57,-0.12,Matches,328.0,it ITA,FWMF,20.0,7.0,289.0,7.0,40.0,121.0,132.0,15.0,289.0,46.0,23.0,50.0,18.0,39.1,158.0,978.0,417.0,13.0,8.0,4.0,24.0,8.0,183.0,34.0,Matches,328.0,it ITA,FWMF,20.0,7.0,2.0,15.0,6.0,40.0,2.15,0.86,0.13,0.33,19.0,1.0,0.0,0.0,1.2,1.2,0.08,0.8,0.8,Matches,328.0,it ITA,FWMF,20.0,18.0,4.0,628.0,7.0,2.0,0.0,2.0,2.0,0.0,0.0,1.0,0.0,1.2,1.2,0.5,1.7,13.0,10.0,34.0,0.29,0.0,0.29,0.29,0.29,0.17,0.07,0.24,0.17,0.24,Matches,Daniel Maldini,AM RLC,20,115,145,"Italy,Venezuela",AC Milan,13,12,12,9,13,14,13,11,5,6,12,11,7,14,9,13,12,11,11,12,11,15,12,7,13,6,13,12,13,13,11,10,12,13,12,11,11,8,5,8,13,1,3,2,1,4,2,1,2,3,2,3,18,13,4,16,11,15,13,12,1,1,1,1,1,1,1,1,1,1,18,20,17,12,181,74,10,20,4780000,5750,6050,3500,Mediterranean_Hispanic,112,2,2001/10/11,0,0,10672.0,Spezia Calcio,43371896
676,Youssef Maleh,Fiorentina,1998,329.0,ma MAR,MF,23.0,3.3,3.0,1.0,0.0,3.0,0.0,0.0,4.0,0.0,4.0,5.0,0.0,5.0,1.0,4.0,3.0,0.0,Matches,329.0,ma MAR,MF,23.0,3.3,7.0,2.12,7.0,0.0,0.0,0.0,0.0,0.0,0.0,0.0,0.0,0.0,0.0,0.0,0.0,0.0,Matches,,,,,,,,,,,,,,,,,,,,,,,,,,,,,,,,,,,,,,,,,,,,,,,,,,,,,,,,329.0,ma MAR,MF,23.0,3.3,2.0,0.0,0.0,8.0,3.0,0.0,7.0,1.0,1.0,0.0,0.0,0.0,20.0,3.0,4.0,42.9,Matches,329.0,ma MAR,MF,23.0,3.3,116.0,111.0,4.0,3.0,0.0,1.0,7.0,1.0,0.0,0.0,0.0,0.0,95.0,1.0,2.0,Matches,329.0,ma MAR,MF,23.0,3.3,95.0,116.0,81.9,1462.0,376.0,55.0,63.0,87.3,31.0,35.0,88.6,7.0,12.0,58.3,0.0,0.6,0.4,-0.6,6.0,8.0,5.0,2.0,11.0,Matches,423,ma MAR,MF,23,7,297.0,42.0,8.7,3.3,4,64.0,0,3,14.0,7,1.29,3.0,6.0,-3.0,-0.91,-1.28,5.3,4.6,0.7,0.21,-0.11,Matches,329.0,ma MAR,MF,23.0,3.3,150.0,4.0,18.0,79.0,53.0,11.0,150.0,3.0,1.0,33.3,2.0,66.7,93.0,321.0,144.0,3.0,4.0,1.0,6.0,6.0,96.0,17.0,Matches,329.0,ma MAR,MF,23.0,3.3,0.0,7.0,0.0,0.0,2.12,0.0,0.0,,15.9,0.0,0.0,0.0,0.6,0.6,0.08,-0.6,-0.6,Matches,329.0,ma MAR,MF,23.0,7.0,4.0,297.0,3.3,0.0,0.0,0.0,0.0,0.0,0.0,2.0,0.0,0.6,0.6,0.6,1.2,3.0,11.0,17.0,0.0,0.0,0.0,0.0,0.0,0.17,0.2,0.36,0.17,0.36,Matches,Youssef Maleh,DM/M/AM LC,23,134,148,"Morocco,Italy",ACF Fiorentina,10,11,12,11,13,8,7,11,8,10,14,11,10,13,12,14,13,13,13,13,13,16,14,10,14,13,15,14,14,14,14,8,12,13,14,13,14,11,12,6,14,3,2,2,3,3,3,3,3,1,2,3,16,16,8,11,14,15,13,12,1,1,1,1,12,1,16,15,20,1,14,16,13,1,179,70,20,9,7400223,6700,6150,5000,North_African__Middle_Eastern,130,8,1998/8/22,0,0,25000.0,,43193946
677,Ruslan Malinovskyi,Atalanta,1993,331.0,ua UKR,MFFW,29.0,6.1,14.0,8.0,5.0,6.0,3.0,6.0,17.0,35.3,11.0,8.0,1.0,7.0,5.0,19.0,2.0,0.0,Matches,331.0,ua UKR,MFFW,29.0,6.1,26.0,4.25,16.0,7.0,1.0,1.0,1.0,0.0,2.0,0.33,2.0,0.0,0.0,0.0,0.0,0.0,Matches,,,,,,,,,,,,,,,,,,,,,,,,,,,,,,,,,,,,,,,,,,,,,,,,,,,,,,,,331.0,ua UKR,MFFW,29.0,6.1,2.0,0.0,0.0,10.0,11.0,0.0,23.0,5.0,8.0,0.0,0.0,0.0,57.0,5.0,7.0,41.7,Matches,331.0,ua UKR,MFFW,29.0,6.1,332.0,304.0,23.0,8.0,2.0,11.0,23.0,2.0,13.0,6.0,6.0,0.0,248.0,5.0,6.0,Matches,331.0,ua UKR,MFFW,29.0,6.1,248.0,332.0,74.7,4851.0,1645.0,106.0,123.0,86.2,97.0,121.0,80.2,39.0,64.0,60.9,2.0,2.0,1.3,0.0,13.0,36.0,15.0,0.0,50.0,Matches,425,ua UKR,MFFW,29,15,553.0,37.0,16.2,6.1,5,68.0,0,10,21.0,1,1.67,9.0,8.0,1.0,0.16,-0.37,8.4,7.0,1.4,0.24,-0.23,Matches,331.0,ua UKR,MFFW,29.0,6.1,425.0,2.0,61.0,220.0,152.0,8.0,425.0,21.0,9.0,42.9,10.0,47.6,279.0,1481.0,643.0,19.0,17.0,3.0,21.0,9.0,303.0,36.0,Matches,331.0,ua UKR,MFFW,29.0,6.1,1.0,19.0,6.0,31.6,3.09,0.98,0.05,0.17,25.6,0.0,0.0,0.0,0.6,0.6,0.03,0.4,0.4,Matches,331.0,ua UKR,MFFW,29.0,15.0,5.0,553.0,6.1,1.0,2.0,3.0,1.0,0.0,0.0,2.0,0.0,0.6,0.6,2.0,2.6,19.0,50.0,36.0,0.16,0.33,0.49,0.16,0.49,0.1,0.33,0.43,0.1,0.43,Matches,Ruslan Malinovskyi,M/AM C,29,146,155,Ukraine,Atalanta,17,14,15,12,16,17,4,19,4,6,15,14,11,17,15,12,12,13,12,14,13,14,16,8,13,6,11,15,14,15,16,9,16,12,11,15,13,12,13,6,12,2,2,3,4,3,3,2,4,2,2,2,15,14,6,14,13,16,14,11,1,1,1,1,1,1,11,1,18,1,10,20,10,14,181,79,20,12,20240319,7300,7050,6300,Northern_European,145,4,1993/5/4,49,7,24615.0,,71048716
678,Riccardo Marchizza,Sassuolo,1998,335.0,it ITA,DF,24.0,3.1,2.0,2.0,1.0,1.0,0.0,2.0,4.0,50.0,2.0,2.0,0.0,2.0,2.0,4.0,8.0,0.0,Matches,335.0,it ITA,DF,24.0,3.1,8.0,2.54,7.0,0.0,1.0,0.0,0.0,0.0,2.0,0.64,2.0,0.0,0.0,0.0,0.0,0.0,Matches,,,,,,,,,,,,,,,,,,,,,,,,,,,,,,,,,,,,,,,,,,,,,,,,,,,,,,,,335.0,it ITA,DF,24.0,3.1,1.0,0.0,0.0,7.0,0.0,1.0,18.0,2.0,2.0,0.0,0.0,0.0,7.0,5.0,2.0,71.4,Matches,335.0,it ITA,DF,24.0,3.1,181.0,148.0,33.0,4.0,0.0,3.0,18.0,25.0,4.0,0.0,4.0,0.0,137.0,0.0,4.0,Matches,335.0,it ITA,DF,24.0,3.1,137.0,181.0,75.7,2272.0,755.0,73.0,78.0,93.6,54.0,67.0,80.6,10.0,31.0,32.3,1.0,0.3,0.1,0.7,3.0,10.0,2.0,1.0,15.0,Matches,429,it ITA,DF,24,10,283.0,28.0,8.3,3.1,3,62.0,0,7,14.0,28,1.7,6.0,9.0,-3.0,-0.95,-0.64,3.4,4.1,-0.8,-0.24,-0.32,Matches,335.0,it ITA,DF,24.0,3.1,205.0,11.0,51.0,106.0,48.0,1.0,205.0,5.0,1.0,20.0,4.0,80.0,129.0,563.0,338.0,3.0,6.0,0.0,2.0,3.0,135.0,15.0,Matches,335.0,it ITA,DF,24.0,3.1,0.0,0.0,0.0,,0.0,0.0,,,,0.0,0.0,0.0,0.0,0.0,,0.0,0.0,Matches,335.0,it ITA,DF,24.0,10.0,3.0,283.0,3.1,0.0,1.0,1.0,0.0,0.0,0.0,1.0,0.0,0.0,0.0,0.3,0.3,3.0,15.0,15.0,0.0,0.32,0.32,0.0,0.32,0.0,0.1,0.1,0.0,0.1,Matches,Riccardo Marchizza,D LC,24,123,135,Italy,U.S. Sassuolo,6,13,11,6,11,9,15,10,11,14,12,11,12,10,11,12,12,11,12,11,13,15,7,9,10,13,13,13,12,12,14,12,13,13,14,14,12,12,13,8,11,2,1,3,1,1,2,1,1,1,4,1,14,12,3,12,13,12,11,15,1,20,18,1,1,1,1,1,1,1,1,1,1,1,187,80,20,7,2202370,6150,6150,5000,Mediterranean_Hispanic,120,4,1998/3/26,0,0,17885.0,,43190965
679,Adam Masina,Udinese,1994,344.0,ma MAR,DF,28.0,8.8,10.0,7.0,7.0,3.0,0.0,6.0,15.0,40.0,9.0,11.0,4.0,7.0,10.0,20.0,28.0,1.0,Matches,344.0,ma MAR,DF,28.0,8.8,5.0,0.57,5.0,0.0,0.0,0.0,0.0,0.0,0.0,0.0,0.0,0.0,0.0,0.0,0.0,0.0,Matches,,,,,,,,,,,,,,,,,,,,,,,,,,,,,,,,,,,,,,,,,,,,,,,,,,,,,,,,344.0,ma MAR,DF,28.0,8.8,2.0,0.0,0.0,11.0,1.0,0.0,10.0,10.0,7.0,0.0,1.0,0.0,44.0,26.0,11.0,70.3,Matches,344.0,ma MAR,DF,28.0,8.8,428.0,386.0,40.0,13.0,1.0,6.0,10.0,27.0,0.0,0.0,0.0,0.0,332.0,2.0,3.0,Matches,344.0,ma MAR,DF,28.0,8.8,332.0,428.0,77.6,7007.0,2817.0,110.0,125.0,88.0,164.0,195.0,84.1,56.0,99.0,56.6,0.0,0.2,0.3,-0.2,2.0,26.0,5.0,3.0,24.0,Matches,442,ma MAR,DF,28,14,789.0,56.0,23.1,8.8,8,82.0,5,6,22.0,6,1.07,12.0,14.0,-2.0,-0.23,-0.26,11.6,14.8,-3.1,-0.36,-0.3,Matches,344.0,ma MAR,DF,28.0,8.8,496.0,55.0,243.0,219.0,41.0,6.0,496.0,4.0,3.0,75.0,0.0,0.0,297.0,1477.0,714.0,4.0,3.0,1.0,4.0,1.0,307.0,6.0,Matches,344.0,ma MAR,DF,28.0,8.8,2.0,2.0,2.0,100.0,0.23,0.23,1.0,1.0,12.3,0.0,0.0,0.0,0.1,0.1,0.04,1.9,1.9,Matches,344.0,ma MAR,DF,28.0,14.0,8.0,789.0,8.8,2.0,0.0,2.0,2.0,0.0,0.0,2.0,0.0,0.1,0.1,0.2,0.3,4.0,24.0,6.0,0.23,0.0,0.23,0.23,0.23,0.01,0.02,0.03,0.01,0.03,Matches,Adam Masina,D/WB LC,28,129,139,"Morocco,Italy",Udinese Calcio,8,12,11,8,11,9,14,9,14,12,12,7,14,11,15,13,14,11,12,11,12,14,12,14,13,10,13,14,13,12,14,14,14,13,17,14,14,12,14,7,13,3,2,3,2,3,3,3,3,1,1,1,14,12,4,14,12,16,18,12,1,20,16,1,20,1,1,13,1,1,5,1,1,1,191,87,20,6,9891439,6450,6550,4750,North_African__Middle_Eastern,125,6,1994/1/2,16,0,23846.0,,43111412
680,Luís Maximiano,Lazio,1999,346.0,pt POR,GK,23.0,0.1,0.0,0.0,0.0,0.0,0.0,0.0,0.0,,0.0,0.0,0.0,0.0,0.0,0.0,0.0,0.0,Matches,346.0,pt POR,GK,23.0,0.1,0.0,0.0,0.0,0.0,0.0,0.0,0.0,0.0,0.0,0.0,0.0,0.0,0.0,0.0,0.0,0.0,Matches,17.0,pt POR,GK,23.0,0.1,,,,,,,,,,2.0,3.0,66.7,,1.0,,,,,,,,,,,19.0,Matches,17.0,pt POR,GK,23.0,1.0,1.0,5.0,0.1,,,,,,1.0,,,,,,,,,,Matches,346.0,pt POR,GK,23.0,0.1,0.0,1.0,0.0,1.0,0.0,0.0,0.0,0.0,0.0,0.0,0.0,0.0,0.0,0.0,0.0,,Matches,346.0,pt POR,GK,23.0,0.1,4.0,4.0,0.0,0.0,0.0,0.0,0.0,0.0,0.0,0.0,0.0,0.0,3.0,0.0,0.0,Matches,346.0,pt POR,GK,23.0,0.1,3.0,4.0,75.0,98.0,90.0,1.0,1.0,100.0,0.0,0.0,,2.0,3.0,66.7,0.0,0.0,0.0,0.0,0.0,0.0,0.0,0.0,0.0,Matches,444,pt POR,GK,23,1,5.0,5.0,0.1,0.1,1,5.0,0,0,,36,3.0,0.0,0.0,0.0,0.0,-0.79,0.1,0.0,0.1,0.99,0.73,Matches,346.0,pt POR,GK,23.0,0.1,4.0,4.0,4.0,0.0,0.0,0.0,4.0,0.0,0.0,,0.0,,3.0,4.0,0.0,0.0,0.0,0.0,0.0,0.0,3.0,0.0,Matches,346.0,pt POR,GK,23.0,0.1,0.0,0.0,0.0,,0.0,0.0,,,,0.0,0.0,0.0,0.0,0.0,,0.0,0.0,Matches,346.0,pt POR,GK,23.0,1.0,1.0,5.0,0.1,0.0,0.0,0.0,0.0,0.0,0.0,0.0,1.0,0.0,0.0,0.0,0.0,0.0,0.0,0.0,0.0,0.0,0.0,0.0,0.0,0.0,0.0,0.0,0.0,0.0,Matches,Luís Maximiano,GK,23,134,155,Portugal,S.S. Lazio,3,1,2,1,9,6,7,2,2,3,10,2,3,9,12,13,14,12,12,9,12,14,1,10,2,13,13,14,13,14,13,15,12,12,13,11,14,7,9,10,16,14,12,12,8,14,12,15,15,12,11,12,12,13,5,18,13,14,15,5,20,1,1,1,1,1,1,1,1,1,1,1,1,1,190,86,10,20,9939284,6700,6700,5400,Mediterranean_Hispanic,133,5,1999/1/5,0,0,24615.0,,83111430
681,Tommaso Milanese,Cremonese,2002,354.0,it ITA,MF,20.0,0.3,0.0,0.0,0.0,0.0,0.0,0.0,0.0,,0.0,1.0,1.0,0.0,0.0,0.0,0.0,0.0,Matches,354.0,it ITA,MF,20.0,0.3,2.0,6.43,1.0,1.0,0.0,0.0,0.0,0.0,0.0,0.0,0.0,0.0,0.0,0.0,0.0,0.0,Matches,,,,,,,,,,,,,,,,,,,,,,,,,,,,,,,,,,,,,,,,,,,,,,,,,,,,,,,,354.0,it ITA,MF,20.0,0.3,0.0,0.0,0.0,1.0,1.0,0.0,2.0,0.0,0.0,0.0,0.0,0.0,0.0,0.0,1.0,0.0,Matches,354.0,it ITA,MF,20.0,0.3,14.0,11.0,3.0,1.0,0.0,0.0,2.0,0.0,1.0,0.0,1.0,0.0,10.0,0.0,0.0,Matches,354.0,it ITA,MF,20.0,0.3,10.0,14.0,71.4,182.0,41.0,4.0,5.0,80.0,3.0,5.0,60.0,2.0,3.0,66.7,0.0,0.2,0.1,-0.2,3.0,3.0,0.0,0.0,2.0,Matches,456,it ITA,MF,20,2,27.0,14.0,0.8,0.3,0,,0,2,14.0,18,0.0,0.0,1.0,-1.0,-3.33,-2.48,0.2,0.9,-0.7,-2.19,-1.48,Matches,354.0,it ITA,MF,20.0,0.3,19.0,0.0,1.0,7.0,12.0,2.0,19.0,2.0,1.0,50.0,1.0,50.0,13.0,71.0,38.0,2.0,1.0,0.0,3.0,1.0,14.0,1.0,Matches,354.0,it ITA,MF,20.0,0.3,0.0,0.0,0.0,,0.0,0.0,,,,0.0,0.0,0.0,0.0,0.0,,0.0,0.0,Matches,354.0,it ITA,MF,20.0,2.0,0.0,27.0,0.3,0.0,0.0,0.0,0.0,0.0,0.0,0.0,0.0,0.0,0.0,0.2,0.2,2.0,2.0,1.0,0.0,0.0,0.0,0.0,0.0,0.0,0.63,0.63,0.0,0.63,Matches,Tommaso Milanese,M C,19,115,-8,Italy,Cremonese,11,10,12,10,14,9,10,12,7,10,13,9,10,13,14,13,13,11,12,12,11,15,11,9,13,10,13,15,13,14,11,8,14,13,12,8,14,10,12,8,13,3,2,2,3,4,1,1,2,2,1,1,11,14,5,11,12,14,12,13,1,1,1,1,1,1,13,1,20,1,1,15,1,1,173,73,10,20,40240001,5749,5749,3105,Mediterranean_Hispanic,115,2,2002/7/31,0,0,855.0,,43425493
682,Antonio Mirante,Milan,1983,361.0,it ITA,GK,39.0,0.0,0.0,0.0,0.0,0.0,0.0,0.0,0.0,,0.0,0.0,0.0,0.0,0.0,0.0,0.0,0.0,Matches,361.0,it ITA,GK,39.0,0.0,0.0,0.0,0.0,0.0,0.0,0.0,0.0,0.0,0.0,0.0,0.0,0.0,0.0,0.0,0.0,0.0,Matches,20.0,it ITA,GK,39.0,0.0,0.0,0.0,0.0,0.0,0.0,0.0,,0.0,0.0,0.0,0.0,,3.0,0.0,0.0,27.0,1.0,0.0,15.0,0.0,0.0,,0.0,0.0,,Matches,20.0,it ITA,GK,39.0,1.0,0.0,2.0,0.0,0.0,0.0,0.0,0.0,,0.0,0.0,0.0,0.0,,0.0,0.0,0.0,0.0,,Matches,361.0,it ITA,GK,39.0,0.0,0.0,0.0,0.0,0.0,0.0,0.0,0.0,0.0,0.0,0.0,0.0,0.0,0.0,0.0,0.0,,Matches,361.0,it ITA,GK,39.0,0.0,4.0,3.0,1.0,0.0,0.0,0.0,0.0,0.0,0.0,0.0,0.0,0.0,4.0,0.0,0.0,Matches,361.0,it ITA,GK,39.0,0.0,4.0,4.0,100.0,96.0,57.0,0.0,0.0,,3.0,3.0,100.0,1.0,1.0,100.0,0.0,0.0,0.0,0.0,0.0,0.0,0.0,0.0,0.0,Matches,463,it ITA,GK,39,1,2.0,2.0,0.1,0.0,0,,0,1,2.0,37,3.0,1.0,0.0,1.0,45.0,44.47,1.1,0.0,1.1,49.3,48.87,Matches,361.0,it ITA,GK,39.0,0.0,4.0,4.0,4.0,0.0,0.0,0.0,4.0,0.0,0.0,,0.0,,2.0,9.0,8.0,0.0,0.0,0.0,0.0,0.0,3.0,0.0,Matches,361.0,it ITA,GK,39.0,0.0,0.0,0.0,0.0,,0.0,0.0,,,,0.0,0.0,0.0,0.0,0.0,,0.0,0.0,Matches,361.0,it ITA,GK,39.0,1.0,0.0,2.0,0.0,0.0,0.0,0.0,0.0,0.0,0.0,0.0,0.0,0.0,0.0,0.0,0.0,0.0,0.0,0.0,0.0,0.0,0.0,0.0,0.0,0.0,0.0,0.0,0.0,0.0,Matches,Antonio Mirante,GK,39,122,143,Italy,AC Milan,1,1,3,1,8,1,8,1,7,2,9,6,4,7,8,12,13,16,13,4,13,19,9,10,1,13,13,14,7,11,12,16,16,10,10,12,12,8,11,9,1,14,13,13,8,14,13,13,15,13,12,13,14,8,4,18,15,19,16,14,20,1,1,1,1,1,1,1,1,1,1,1,1,1,193,79,7,20,133870,6100,6200,5100,Mediterranean_Hispanic,123,3,1983/7/8,0,0,25000.0,,830119
683,João Moutinho,Spezia,1998,370.0,pt POR,DFFW,24.0,0.6,7.0,1.0,5.0,1.0,1.0,3.0,4.0,75.0,1.0,1.0,1.0,0.0,0.0,7.0,0.0,0.0,Matches,370.0,pt POR,DFFW,24.0,0.6,1.0,1.55,1.0,0.0,0.0,0.0,0.0,0.0,0.0,0.0,0.0,0.0,0.0,0.0,0.0,0.0,Matches,,,,,,,,,,,,,,,,,,,,,,,,,,,,,,,,,,,,,,,,,,,,,,,,,,,,,,,,370.0,pt POR,DFFW,24.0,0.6,0.0,0.0,0.0,1.0,0.0,0.0,3.0,0.0,1.0,0.0,0.0,0.0,7.0,0.0,1.0,0.0,Matches,370.0,pt POR,DFFW,24.0,0.6,42.0,34.0,8.0,0.0,0.0,0.0,3.0,8.0,0.0,0.0,0.0,0.0,30.0,0.0,2.0,Matches,370.0,pt POR,DFFW,24.0,0.6,30.0,42.0,71.4,405.0,162.0,18.0,20.0,90.0,9.0,12.0,75.0,1.0,6.0,16.7,0.0,0.0,0.0,0.0,1.0,4.0,0.0,0.0,1.0,Matches,475,pt POR,DFFW,24,4,58.0,15.0,1.7,0.6,0,,0,4,15.0,1,1.0,0.0,2.0,-2.0,-3.1,-2.33,0.1,1.4,-1.3,-1.99,-1.55,Matches,370.0,pt POR,DFFW,24.0,0.6,51.0,3.0,11.0,20.0,20.0,0.0,51.0,0.0,0.0,,0.0,,18.0,55.0,20.0,0.0,1.0,0.0,0.0,0.0,24.0,2.0,Matches,370.0,pt POR,DFFW,24.0,0.6,0.0,0.0,0.0,,0.0,0.0,,,,0.0,0.0,0.0,0.0,0.0,,0.0,0.0,Matches,370.0,pt POR,DFFW,24.0,4.0,0.0,58.0,0.6,0.0,0.0,0.0,0.0,0.0,0.0,0.0,0.0,0.0,0.0,0.0,0.0,0.0,1.0,2.0,0.0,0.0,0.0,0.0,0.0,0.0,0.05,0.05,0.0,0.05,Matches,João Moutinho,DM/M C,35,149,154,Portugal,Wolverhampton Wanderers,13,14,15,10,16,14,7,13,4,11,17,14,13,17,14,16,14,14,15,17,15,16,15,14,12,14,17,16,10,13,13,8,15,10,14,10,16,13,16,8,14,3,3,2,3,2,1,1,2,2,1,3,13,17,7,15,16,17,14,16,1,1,1,1,1,1,20,9,20,9,1,15,1,1,170,61,10,20,4464618,7450,7250,6500,Mediterranean_Hispanic,147,6,1986/9/8,146,7,115992.0,,744539
684,Mert Müldür,Sassuolo,1999,371.0,tr TUR,FWDF,23.0,0.1,0.0,0.0,0.0,0.0,0.0,0.0,0.0,,0.0,0.0,0.0,0.0,0.0,0.0,0.0,0.0,Matches,371.0,tr TUR,FWDF,23.0,0.1,0.0,0.0,0.0,0.0,0.0,0.0,0.0,0.0,0.0,0.0,0.0,0.0,0.0,0.0,0.0,0.0,Matches,,,,,,,,,,,,,,,,,,,,,,,,,,,,,,,,,,,,,,,,,,,,,,,,,,,,,,,,371.0,tr TUR,FWDF,23.0,0.1,0.0,0.0,0.0,1.0,0.0,0.0,0.0,0.0,0.0,0.0,0.0,0.0,0.0,0.0,0.0,,Matches,371.0,tr TUR,FWDF,23.0,0.1,3.0,3.0,0.0,0.0,0.0,0.0,0.0,0.0,0.0,0.0,0.0,0.0,3.0,0.0,0.0,Matches,371.0,tr TUR,FWDF,23.0,0.1,3.0,3.0,100.0,30.0,7.0,3.0,3.0,100.0,0.0,0.0,,0.0,0.0,,0.0,0.0,0.0,0.0,0.0,0.0,0.0,0.0,0.0,Matches,477,tr TUR,FWDF,23,2,13.0,7.0,0.4,0.1,1,6.0,0,1,7.0,6,0.0,0.0,0.0,0.0,0.0,0.37,0.0,0.0,0.0,-0.32,-0.37,Matches,371.0,tr TUR,FWDF,23.0,0.1,3.0,0.0,2.0,1.0,0.0,0.0,3.0,0.0,0.0,,0.0,,3.0,6.0,4.0,0.0,0.0,0.0,0.0,0.0,3.0,0.0,Matches,371.0,tr TUR,FWDF,23.0,0.1,0.0,0.0,0.0,,0.0,0.0,,,,0.0,0.0,0.0,0.0,0.0,,0.0,0.0,Matches,371.0,tr TUR,FWDF,23.0,2.0,1.0,13.0,0.1,0.0,0.0,0.0,0.0,0.0,0.0,0.0,0.0,0.0,0.0,0.0,0.0,0.0,0.0,0.0,0.0,0.0,0.0,0.0,0.0,0.0,0.0,0.0,0.0,0.0,Matches,Mert Müldür,D/WB RL,23,126,142,"Turkey,Austria",U.S. Sassuolo,4,10,12,7,13,5,12,7,10,11,12,5,13,13,14,11,12,11,9,11,12,16,10,9,12,13,13,13,14,13,14,12,13,15,13,13,11,9,12,7,14,2,3,1,3,1,3,2,1,3,1,3,14,14,8,12,11,15,13,13,1,15,12,20,1,17,1,1,1,14,1,1,1,1,188,74,14,20,3677675,6300,6400,5300,North_African__Middle_Eastern,122,5,1999/4/3,18,1,9807.0,,16184687
685,Tanguy Ndombele,Napoli,1996,379.0,fr FRA,MF,25.0,9.0,14.0,8.0,4.0,8.0,2.0,4.0,7.0,57.1,3.0,10.0,1.0,9.0,7.0,21.0,7.0,1.0,Matches,379.0,fr FRA,MF,25.0,9.0,20.0,2.24,15.0,0.0,1.0,1.0,3.0,0.0,0.0,0.0,0.0,0.0,0.0,0.0,0.0,0.0,Matches,,,,,,,,,,,,,,,,,,,,,,,,,,,,,,,,,,,,,,,,,,,,,,,,,,,,,,,,379.0,fr FRA,MF,25.0,9.0,5.0,0.0,0.0,15.0,23.0,0.0,1.0,7.0,8.0,0.0,1.0,0.0,42.0,7.0,3.0,70.0,Matches,379.0,fr FRA,MF,25.0,9.0,574.0,562.0,12.0,8.0,1.0,0.0,1.0,2.0,0.0,0.0,0.0,0.0,504.0,0.0,13.0,Matches,379.0,fr FRA,MF,25.0,9.0,504.0,574.0,87.8,6796.0,1666.0,306.0,336.0,91.1,143.0,154.0,92.9,19.0,29.0,65.5,0.0,0.5,0.5,-0.5,9.0,41.0,9.0,0.0,52.0,Matches,489,fr FRA,MF,25,30,807.0,27.0,23.6,9.0,8,58.0,0,22,16.0,6,2.43,10.0,7.0,3.0,0.33,-1.25,12.2,6.7,5.5,0.62,-0.32,Matches,379.0,fr FRA,MF,25.0,9.0,685.0,12.0,78.0,424.0,189.0,28.0,685.0,37.0,19.0,51.4,12.0,32.4,461.0,2028.0,977.0,27.0,19.0,4.0,26.0,18.0,578.0,33.0,Matches,379.0,fr FRA,MF,25.0,9.0,1.0,16.0,2.0,12.5,1.78,0.22,0.06,0.5,22.4,0.0,0.0,0.0,1.0,1.0,0.06,0.0,0.0,Matches,379.0,fr FRA,MF,25.0,30.0,8.0,807.0,9.0,1.0,0.0,1.0,1.0,0.0,0.0,5.0,0.0,1.0,1.0,0.5,1.4,27.0,52.0,33.0,0.11,0.0,0.11,0.11,0.11,0.11,0.05,0.16,0.11,0.16,Matches,Tanguy Ndombele,DM/M C,25,143,155,"France,Democratic Republic of Congo",Tottenham Hotspur,6,10,16,10,15,8,10,12,4,12,16,7,14,16,12,13,14,15,10,14,13,12,15,9,12,13,14,11,15,14,16,10,12,13,12,16,11,10,15,6,12,3,2,1,1,2,3,3,2,1,1,2,10,16,6,12,12,14,10,10,1,1,1,1,1,1,20,1,20,1,1,15,1,1,181,76,10,20,32727068,7150,7350,6350,African_Caribbean,140,15,1996/12/28,7,0,139190.0,Parthenope,85128159
686,Ilija Nestorovski,Udinese,1990,380.0,mk MKD,FWMF,32.0,7.1,7.0,3.0,2.0,1.0,4.0,5.0,11.0,45.5,6.0,6.0,1.0,5.0,2.0,9.0,10.0,0.0,Matches,380.0,mk MKD,FWMF,32.0,7.1,7.0,0.99,3.0,0.0,0.0,2.0,2.0,0.0,2.0,0.28,1.0,0.0,0.0,0.0,1.0,0.0,Matches,,,,,,,,,,,,,,,,,,,,,,,,,,,,,,,,,,,,,,,,,,,,,,,,,,,,,,,,380.0,mk MKD,FWMF,32.0,7.1,3.0,0.0,0.0,18.0,21.0,5.0,0.0,2.0,3.0,1.0,0.0,0.0,13.0,12.0,35.0,25.5,Matches,380.0,mk MKD,FWMF,32.0,7.1,163.0,153.0,9.0,0.0,6.0,1.0,0.0,0.0,0.0,0.0,0.0,0.0,116.0,1.0,6.0,Matches,380.0,mk MKD,FWMF,32.0,7.1,116.0,163.0,71.2,1638.0,309.0,70.0,92.0,76.1,34.0,44.0,77.3,7.0,11.0,63.6,1.0,0.5,0.4,0.5,2.0,7.0,2.0,0.0,19.0,Matches,490,mk MKD,FWMF,32,21,638.0,30.0,18.7,7.1,5,85.0,4,16,13.0,12,0.95,13.0,8.0,5.0,0.71,0.9,8.1,8.0,0.1,0.01,0.17,Matches,380.0,mk MKD,FWMF,32.0,7.1,228.0,10.0,18.0,125.0,86.0,29.0,228.0,5.0,3.0,60.0,1.0,20.0,118.0,379.0,128.0,1.0,1.0,1.0,14.0,3.0,169.0,29.0,Matches,380.0,mk MKD,FWMF,32.0,7.1,2.0,14.0,4.0,28.6,1.97,0.56,0.14,0.5,15.2,0.0,0.0,0.0,1.6,1.6,0.11,0.4,0.4,Matches,380.0,mk MKD,FWMF,32.0,21.0,5.0,638.0,7.1,2.0,1.0,3.0,2.0,0.0,0.0,3.0,0.0,1.6,1.6,0.5,2.1,1.0,19.0,29.0,0.28,0.14,0.42,0.28,0.42,0.23,0.07,0.29,0.23,0.29,Matches,Ilija Nestorovski,S,32,121,135,North Macedonia,Udinese Calcio,6,8,11,14,12,8,14,11,8,8,11,14,8,12,14,14,13,12,13,10,13,15,13,13,15,6,15,15,13,12,13,11,14,13,11,13,13,14,13,4,10,2,1,3,2,2,3,1,1,1,2,1,15,12,12,13,12,16,12,20,1,1,1,1,1,1,1,1,1,1,1,1,1,20,182,75,20,9,115782,6050,6200,4750,Mediterranean_Hispanic,121,5,1990/3/12,46,10,24903.0,,62035683
687,Hans Nicolussi Caviglia,Salernitana,2000,382.0,it ITA,MF,22.0,6.5,15.0,6.0,5.0,8.0,2.0,9.0,15.0,60.0,6.0,9.0,0.0,9.0,7.0,22.0,7.0,1.0,Matches,382.0,it ITA,MF,22.0,6.5,9.0,1.38,7.0,0.0,1.0,0.0,0.0,1.0,0.0,0.0,0.0,0.0,0.0,0.0,0.0,0.0,Matches,,,,,,,,,,,,,,,,,,,,,,,,,,,,,,,,,,,,,,,,,,,,,,,,,,,,,,,,382.0,it ITA,MF,22.0,6.5,2.0,0.0,0.0,13.0,6.0,0.0,4.0,7.0,6.0,0.0,1.0,0.0,46.0,9.0,11.0,45.0,Matches,382.0,it ITA,MF,22.0,6.5,248.0,236.0,10.0,8.0,0.0,2.0,4.0,0.0,2.0,0.0,0.0,0.0,184.0,2.0,4.0,Matches,382.0,it ITA,MF,22.0,6.5,184.0,248.0,74.2,3241.0,951.0,74.0,90.0,82.2,83.0,105.0,79.0,17.0,29.0,58.6,0.0,0.0,0.1,0.0,2.0,21.0,0.0,0.0,19.0,Matches,493,it ITA,MF,22,12,586.0,49.0,17.1,6.5,6,75.0,3,6,22.0,10,1.0,6.0,17.0,-11.0,-1.69,-1.59,6.2,12.8,-6.7,-1.02,-0.27,Matches,382.0,it ITA,MF,22.0,6.5,313.0,15.0,83.0,184.0,47.0,4.0,313.0,8.0,4.0,50.0,2.0,25.0,139.0,697.0,228.0,4.0,3.0,0.0,11.0,6.0,167.0,2.0,Matches,382.0,it ITA,MF,22.0,6.5,1.0,5.0,1.0,20.0,0.77,0.15,0.2,1.0,23.4,0.0,0.0,0.0,0.4,0.4,0.09,0.6,0.6,Matches,382.0,it ITA,MF,22.0,12.0,6.0,586.0,6.5,1.0,0.0,1.0,1.0,0.0,0.0,2.0,0.0,0.4,0.4,0.0,0.5,4.0,19.0,2.0,0.15,0.0,0.15,0.15,0.15,0.07,0.01,0.07,0.07,0.07,Matches,Hans Nicolussi Caviglia,M/AM RC,22,109,144,Italy,Juventus,9,10,9,10,12,9,8,9,12,8,12,12,9,13,9,11,10,11,11,13,12,10,11,12,13,12,13,13,14,12,11,9,14,13,13,9,9,8,11,13,13,3,1,2,1,2,3,3,1,2,2,3,10,13,1,13,9,13,11,8,1,1,1,1,1,1,11,13,20,18,12,17,15,1,181,71,8,20,84196,5442,5442,3242,Northern_European,108,1,2000/6/18,0,0,5181.0,Südtirol - Alto Adige,43296764
688,Bram Nuytinck,Udinese,1990,385.0,nl NED,DF,32.0,4.3,7.0,4.0,3.0,4.0,0.0,4.0,8.0,50.0,4.0,6.0,6.0,0.0,5.0,12.0,22.0,0.0,Matches,385.0,nl NED,DF,32.0,4.3,2.0,0.47,1.0,0.0,0.0,0.0,1.0,0.0,0.0,0.0,0.0,0.0,0.0,0.0,0.0,0.0,Matches,,,,,,,,,,,,,,,,,,,,,,,,,,,,,,,,,,,,,,,,,,,,,,,,,,,,,,,,385.0,nl NED,DF,32.0,4.3,1.0,0.0,0.0,4.0,2.0,0.0,0.0,5.0,4.0,0.0,0.0,0.0,19.0,7.0,5.0,58.3,Matches,385.0,nl NED,DF,32.0,4.3,139.0,124.0,14.0,4.0,0.0,3.0,0.0,9.0,0.0,0.0,0.0,0.0,113.0,1.0,2.0,Matches,385.0,nl NED,DF,32.0,4.3,113.0,139.0,81.3,2516.0,1038.0,24.0,27.0,88.9,67.0,75.0,89.3,20.0,32.0,62.5,0.0,0.0,0.0,0.0,0.0,4.0,1.0,0.0,4.0,Matches,496,nl NED,DF,32,6,385.0,64.0,11.3,4.3,3,86.0,2,3,42.0,8,1.5,5.0,6.0,-1.0,-0.23,-0.23,4.0,6.6,-2.6,-0.61,-0.55,Matches,385.0,nl NED,DF,32.0,4.3,185.0,37.0,117.0,65.0,4.0,2.0,185.0,1.0,1.0,100.0,0.0,0.0,90.0,425.0,187.0,1.0,0.0,0.0,1.0,0.0,88.0,0.0,Matches,385.0,nl NED,DF,32.0,4.3,0.0,1.0,0.0,0.0,0.23,0.0,0.0,,8.4,0.0,0.0,0.0,0.0,0.0,0.03,0.0,0.0,Matches,385.0,nl NED,DF,32.0,6.0,3.0,385.0,4.3,0.0,0.0,0.0,0.0,0.0,0.0,1.0,0.0,0.0,0.0,0.0,0.0,1.0,4.0,0.0,0.0,0.0,0.0,0.0,0.0,0.01,0.0,0.01,0.01,0.01,Matches,Bram Nuytinck,D C,32,128,135,Holland,Udinese Calcio,6,7,7,5,14,7,14,5,5,15,12,5,14,11,13,13,14,12,14,11,12,15,11,14,13,14,14,12,12,11,13,15,14,12,14,15,14,12,14,11,8,2,3,1,2,2,3,1,2,4,3,1,15,14,13,12,13,13,14,12,1,10,20,1,1,1,1,1,1,1,1,1,1,1,190,80,20,6,1153145,6400,6000,5100,Northern_European,128,3,1990/5/4,0,0,21346.0,,37006661
689,Pedro Obiang,Sassuolo,1992,388.0,gq EQG,MF,30.0,9.7,26.0,17.0,12.0,12.0,2.0,10.0,18.0,55.6,8.0,12.0,2.0,10.0,8.0,34.0,15.0,0.0,Matches,388.0,gq EQG,MF,30.0,9.7,11.0,1.13,9.0,0.0,1.0,1.0,0.0,0.0,1.0,0.1,1.0,0.0,0.0,0.0,0.0,0.0,Matches,,,,,,,,,,,,,,,,,,,,,,,,,,,,,,,,,,,,,,,,,,,,,,,,,,,,,,,,388.0,gq EQG,MF,30.0,9.7,2.0,0.0,0.0,16.0,8.0,0.0,1.0,8.0,17.0,0.0,0.0,0.0,53.0,17.0,20.0,45.9,Matches,388.0,gq EQG,MF,30.0,9.7,438.0,411.0,25.0,25.0,0.0,12.0,1.0,0.0,0.0,0.0,0.0,0.0,363.0,2.0,6.0,Matches,388.0,gq EQG,MF,30.0,9.7,363.0,438.0,82.9,6702.0,2194.0,175.0,204.0,85.8,142.0,158.0,89.9,42.0,60.0,70.0,1.0,0.2,0.2,0.8,3.0,27.0,2.0,0.0,40.0,Matches,499,gq EQG,MF,30,17,876.0,52.0,25.6,9.7,11,72.0,4,6,13.0,21,1.47,17.0,17.0,0.0,0.0,0.5,14.7,12.3,2.4,0.24,0.26,Matches,388.0,gq EQG,MF,30.0,9.7,527.0,34.0,138.0,339.0,53.0,2.0,527.0,8.0,3.0,37.5,4.0,50.0,262.0,1022.0,335.0,0.0,7.0,0.0,6.0,2.0,325.0,6.0,Matches,388.0,gq EQG,MF,30.0,9.7,0.0,7.0,0.0,0.0,0.72,0.0,0.0,,19.9,0.0,0.0,0.0,0.4,0.4,0.06,-0.4,-0.4,Matches,388.0,gq EQG,MF,30.0,17.0,11.0,876.0,9.7,0.0,1.0,1.0,0.0,0.0,0.0,2.0,0.0,0.4,0.4,0.2,0.6,0.0,40.0,6.0,0.0,0.1,0.1,0.0,0.1,0.04,0.02,0.06,0.04,0.06,Matches,Pedro Obiang,DM/M C,30,120,141,"Equatorial Guinea,Spain,Gabon",U.S. Sassuolo,7,7,9,7,13,7,9,9,8,12,13,10,14,14,13,14,12,14,13,13,13,16,10,12,11,15,15,14,10,10,14,10,13,10,15,14,13,14,13,15,12,3,3,2,1,3,1,2,3,1,1,2,16,12,2,12,12,16,15,15,1,1,1,1,1,1,18,1,20,1,1,1,1,1,185,75,8,20,564088,6000,6400,5050,African_Caribbean,118,17,1992/3/27,11,3,20961.0,,43036651
690,Adam Ounas,Napoli,1996,399.0,dz ALG,FW,25.0,0.2,0.0,0.0,0.0,0.0,0.0,0.0,0.0,,0.0,0.0,0.0,0.0,1.0,1.0,0.0,0.0,Matches,399.0,dz ALG,FW,25.0,0.2,2.0,12.0,0.0,0.0,1.0,1.0,0.0,0.0,1.0,6.0,0.0,0.0,0.0,1.0,0.0,0.0,Matches,,,,,,,,,,,,,,,,,,,,,,,,,,,,,,,,,,,,,,,,,,,,,,,,,,,,,,,,399.0,dz ALG,FW,25.0,0.2,0.0,0.0,0.0,0.0,0.0,0.0,0.0,1.0,0.0,0.0,0.0,0.0,0.0,1.0,0.0,100.0,Matches,399.0,dz ALG,FW,25.0,0.2,17.0,16.0,0.0,0.0,0.0,1.0,0.0,0.0,0.0,0.0,0.0,0.0,13.0,1.0,1.0,Matches,399.0,dz ALG,FW,25.0,0.2,13.0,17.0,76.5,297.0,80.0,6.0,7.0,85.7,2.0,3.0,66.7,5.0,5.0,100.0,0.0,0.0,0.0,0.0,0.0,2.0,1.0,0.0,4.0,Matches,511,dz ALG,FW,25,2,15.0,8.0,0.4,0.2,0,,0,2,8.0,0,3.0,1.0,0.0,1.0,6.0,4.73,0.3,0.0,0.3,1.51,0.64,Matches,399.0,dz ALG,FW,25.0,0.2,19.0,0.0,4.0,12.0,5.0,1.0,19.0,2.0,2.0,100.0,0.0,0.0,14.0,121.0,108.0,3.0,2.0,0.0,0.0,0.0,17.0,1.0,Matches,399.0,dz ALG,FW,25.0,0.2,0.0,1.0,0.0,0.0,6.0,0.0,0.0,,27.5,0.0,0.0,0.0,0.0,0.0,0.04,0.0,0.0,Matches,399.0,dz ALG,FW,25.0,2.0,0.0,15.0,0.2,0.0,0.0,0.0,0.0,0.0,0.0,0.0,0.0,0.0,0.0,0.0,0.0,3.0,4.0,1.0,0.0,0.0,0.0,0.0,0.0,0.23,0.0,0.23,0.23,0.23,Matches,Adam Ounas,AM/S RLC,25,131,139,"Algeria,France",LOSC Lille,11,12,17,12,14,7,5,11,4,4,13,10,4,14,8,11,8,12,9,12,10,12,16,8,14,5,10,11,16,15,10,6,14,15,11,7,11,10,14,11,13,2,1,1,1,1,3,4,2,1,3,3,11,14,10,9,11,10,11,10,1,1,1,1,1,1,1,10,1,10,17,17,20,18,172,65,20,10,6496919,6550,6700,5500,North_African__Middle_Eastern,120,11,1996/11/11,19,5,41396.0,,48034668
691,Simone Pafundi,Udinese,2006,400.0,it ITA,MFFW,16.0,0.9,8.0,5.0,1.0,5.0,2.0,2.0,4.0,50.0,2.0,0.0,0.0,0.0,1.0,9.0,0.0,0.0,Matches,400.0,it ITA,MFFW,16.0,0.9,4.0,4.29,3.0,0.0,0.0,0.0,1.0,0.0,0.0,0.0,0.0,0.0,0.0,0.0,0.0,0.0,Matches,,,,,,,,,,,,,,,,,,,,,,,,,,,,,,,,,,,,,,,,,,,,,,,,,,,,,,,,400.0,it ITA,MFFW,16.0,0.9,0.0,0.0,0.0,0.0,3.0,0.0,1.0,1.0,5.0,0.0,0.0,0.0,6.0,1.0,0.0,100.0,Matches,400.0,it ITA,MFFW,16.0,0.9,66.0,61.0,5.0,0.0,1.0,1.0,1.0,3.0,2.0,1.0,0.0,0.0,55.0,0.0,0.0,Matches,400.0,it ITA,MFFW,16.0,0.9,55.0,66.0,83.3,801.0,186.0,31.0,36.0,86.1,14.0,17.0,82.4,5.0,8.0,62.5,0.0,0.1,0.1,-0.1,3.0,7.0,2.0,0.0,6.0,Matches,513,it ITA,MFFW,16,8,85.0,11.0,2.5,0.9,0,,0,8,11.0,15,1.0,1.0,2.0,-1.0,-1.06,-1.06,1.3,1.7,-0.3,-0.37,-0.24,Matches,400.0,it ITA,MFFW,16.0,0.9,90.0,0.0,8.0,55.0,30.0,1.0,90.0,7.0,2.0,28.6,3.0,42.9,66.0,401.0,169.0,3.0,1.0,0.0,2.0,3.0,68.0,9.0,Matches,400.0,it ITA,MFFW,16.0,0.9,0.0,1.0,0.0,0.0,1.06,0.0,0.0,,20.5,0.0,0.0,0.0,0.1,0.1,0.08,-0.1,-0.1,Matches,400.0,it ITA,MFFW,16.0,8.0,0.0,85.0,0.9,0.0,0.0,0.0,0.0,0.0,0.0,0.0,0.0,0.1,0.1,0.1,0.2,3.0,6.0,9.0,0.0,0.0,0.0,0.0,0.0,0.09,0.16,0.25,0.09,0.25,Matches,Simone Pafundi,AM C,16,90,-85,Italy,Udinese Calcio,10,8,11,9,12,8,7,11,4,8,12,11,7,12,6,8,9,11,10,10,12,18,12,7,11,11,11,11,11,13,11,5,12,10,10,9,12,10,11,10,12,2,1,3,3,2,3,1,1,2,3,2,12,14,6,10,14,15,10,12,1,1,1,1,1,1,1,1,8,1,1,20,12,12,164,60,20,11,10554000,4493,3907,1395,Northern_European,90,2,2006/3/14,0,0,255.0,,2000178997
692,Pietro Pellegri,Torino,2001,409.0,it ITA,FW,21.0,5.2,6.0,2.0,1.0,3.0,2.0,2.0,3.0,66.7,1.0,5.0,1.0,4.0,0.0,6.0,4.0,0.0,Matches,409.0,it ITA,FW,21.0,5.2,8.0,1.54,7.0,0.0,1.0,0.0,0.0,0.0,2.0,0.38,1.0,0.0,1.0,0.0,0.0,0.0,Matches,,,,,,,,,,,,,,,,,,,,,,,,,,,,,,,,,,,,,,,,,,,,,,,,,,,,,,,,409.0,it ITA,FW,21.0,5.2,3.0,0.0,0.0,15.0,14.0,7.0,3.0,0.0,2.0,0.0,0.0,0.0,12.0,11.0,33.0,25.0,Matches,409.0,it ITA,FW,21.0,5.2,80.0,71.0,9.0,1.0,0.0,0.0,3.0,0.0,0.0,0.0,0.0,0.0,61.0,0.0,6.0,Matches,409.0,it ITA,FW,21.0,5.2,61.0,80.0,76.3,785.0,70.0,39.0,49.0,79.6,18.0,19.0,94.7,1.0,3.0,33.3,0.0,0.5,0.5,-0.5,5.0,3.0,3.0,0.0,8.0,Matches,526,it ITA,FW,21,18,465.0,26.0,13.6,5.2,4,61.0,0,14,16.0,8,1.22,8.0,5.0,3.0,0.58,0.64,6.7,5.8,0.9,0.17,0.14,Matches,409.0,it ITA,FW,21.0,5.2,159.0,3.0,9.0,58.0,92.0,20.0,159.0,16.0,3.0,18.8,11.0,68.8,101.0,532.0,111.0,4.0,2.0,3.0,24.0,19.0,125.0,50.0,Matches,409.0,it ITA,FW,21.0,5.2,2.0,10.0,5.0,50.0,1.94,0.97,0.2,0.4,12.5,0.0,0.0,0.0,1.5,1.5,0.15,0.5,0.5,Matches,409.0,it ITA,FW,21.0,18.0,4.0,465.0,5.2,2.0,0.0,2.0,2.0,0.0,0.0,3.0,0.0,1.5,1.5,0.5,2.0,4.0,8.0,50.0,0.39,0.0,0.39,0.39,0.39,0.29,0.1,0.39,0.29,0.39,Matches,Pietro Pellegri,S,21,125,155,Italy,Torino,7,7,12,13,13,8,15,11,7,5,12,13,5,13,11,12,16,13,13,11,13,14,12,9,15,6,14,14,12,12,15,15,13,12,13,14,12,9,13,16,11,3,3,4,1,1,1,2,1,1,3,2,10,16,8,12,11,13,14,11,1,1,1,1,1,1,1,1,1,1,6,8,10,20,188,80,9,20,11090000,6250,6250,4900,Mediterranean_Hispanic,125,3,2001/3/17,1,0,24615.0,,43344129
693,Roberto Piccoli,Hellas Verona,2001,422.0,it ITA,FW,21.0,2.1,1.0,0.0,1.0,0.0,0.0,0.0,2.0,0.0,2.0,2.0,0.0,2.0,0.0,1.0,2.0,0.0,Matches,422.0,it ITA,FW,21.0,2.1,1.0,0.47,0.0,0.0,0.0,1.0,0.0,0.0,0.0,0.0,0.0,0.0,0.0,0.0,0.0,0.0,Matches,,,,,,,,,,,,,,,,,,,,,,,,,,,,,,,,,,,,,,,,,,,,,,,,,,,,,,,,422.0,it ITA,FW,21.0,2.1,0.0,0.0,0.0,2.0,3.0,4.0,3.0,0.0,0.0,0.0,0.0,0.0,4.0,3.0,13.0,18.8,Matches,422.0,it ITA,FW,21.0,2.1,25.0,23.0,1.0,0.0,0.0,0.0,3.0,0.0,0.0,0.0,0.0,0.0,13.0,1.0,0.0,Matches,422.0,it ITA,FW,21.0,2.1,13.0,25.0,52.0,178.0,55.0,8.0,12.0,66.7,3.0,6.0,50.0,1.0,4.0,25.0,0.0,0.2,0.0,-0.2,1.0,1.0,0.0,0.0,0.0,Matches,540,it ITA,FW,21,7,192.0,27.0,5.6,2.1,2,45.0,0,5,20.0,5,0.57,2.0,3.0,-1.0,-0.47,0.28,1.6,3.4,-1.9,-0.88,-0.54,Matches,422.0,it ITA,FW,21.0,2.1,55.0,3.0,8.0,16.0,31.0,11.0,55.0,3.0,1.0,33.3,2.0,66.7,36.0,197.0,70.0,2.0,3.0,1.0,7.0,4.0,41.0,8.0,Matches,422.0,it ITA,FW,21.0,2.1,0.0,4.0,2.0,50.0,1.87,0.94,0.0,0.0,12.7,0.0,0.0,0.0,0.4,0.4,0.1,-0.4,-0.4,Matches,422.0,it ITA,FW,21.0,7.0,2.0,192.0,2.1,0.0,0.0,0.0,0.0,0.0,0.0,0.0,0.0,0.4,0.4,0.2,0.6,2.0,0.0,8.0,0.0,0.0,0.0,0.0,0.0,0.19,0.08,0.27,0.19,0.27,Matches,Roberto Piccoli,S,21,124,154,Italy,Atalanta,5,7,10,13,12,5,15,9,6,5,11,12,6,12,10,14,12,14,12,9,13,14,8,9,13,5,15,14,11,12,14,15,16,13,14,16,13,8,12,5,7,3,3,3,2,3,2,2,2,1,1,1,12,14,7,13,13,15,14,13,1,1,1,1,1,1,1,1,1,1,1,1,1,20,190,84,11,20,7878750,6200,6200,4001,Northern_European,124,2,2001/1/27,0,0,10672.0,Hellas Verona,43372280
694,Marko Pjaca,Empoli,1995,428.0,hr CRO,MFFW,27.0,5.8,4.0,3.0,3.0,1.0,0.0,3.0,5.0,60.0,2.0,3.0,0.0,3.0,3.0,7.0,3.0,0.0,Matches,428.0,hr CRO,MFFW,27.0,5.8,27.0,4.64,17.0,4.0,3.0,2.0,1.0,0.0,1.0,0.17,1.0,0.0,0.0,0.0,0.0,0.0,Matches,,,,,,,,,,,,,,,,,,,,,,,,,,,,,,,,,,,,,,,,,,,,,,,,,,,,,,,,428.0,hr CRO,MFFW,27.0,5.8,1.0,0.0,0.0,2.0,7.0,1.0,25.0,3.0,3.0,0.0,0.0,0.0,30.0,7.0,7.0,50.0,Matches,428.0,hr CRO,MFFW,27.0,5.8,246.0,218.0,28.0,4.0,0.0,0.0,25.0,2.0,17.0,8.0,6.0,0.0,195.0,0.0,3.0,Matches,428.0,hr CRO,MFFW,27.0,5.8,195.0,246.0,79.3,3260.0,724.0,97.0,117.0,82.9,69.0,88.0,78.4,21.0,30.0,70.0,0.0,0.4,0.5,-0.4,11.0,16.0,8.0,3.0,18.0,Matches,548,hr CRO,MFFW,27,17,525.0,31.0,15.4,5.8,5,58.0,0,12,20.0,15,1.12,7.0,8.0,-1.0,-0.17,0.17,5.1,11.7,-6.6,-1.13,-0.73,Matches,428.0,hr CRO,MFFW,27.0,5.8,321.0,3.0,34.0,154.0,136.0,17.0,321.0,38.0,23.0,60.5,12.0,31.6,202.0,1350.0,691.0,22.0,8.0,9.0,16.0,19.0,245.0,33.0,Matches,428.0,hr CRO,MFFW,27.0,5.8,0.0,15.0,2.0,13.3,2.57,0.34,0.0,0.0,19.5,0.0,0.0,0.0,0.7,0.7,0.04,-0.7,-0.7,Matches,428.0,hr CRO,MFFW,27.0,17.0,5.0,525.0,5.8,0.0,0.0,0.0,0.0,0.0,0.0,1.0,0.0,0.7,0.7,0.4,1.1,22.0,18.0,33.0,0.0,0.0,0.0,0.0,0.0,0.11,0.08,0.19,0.11,0.19,Matches,Marko Pjaca,AM/S RLC,27,128,145,Croatia,Juventus,8,12,15,13,15,11,10,14,5,5,13,13,6,15,12,11,10,10,9,13,10,12,16,8,14,6,10,10,14,12,14,12,12,13,10,13,10,5,14,15,14,1,3,1,3,1,3,2,1,1,3,3,9,14,5,10,9,15,10,16,1,1,1,1,1,1,1,13,5,10,20,19,17,18,186,80,12,20,1724150,6400,6600,5350,Northern_European,119,3,1995/5/6,24,2,53364.0,Empoli Football Club,24039513
695,Tommaso Pobega,Milan,1999,429.0,it ITA,MF,23.0,9.8,27.0,16.0,8.0,15.0,4.0,13.0,20.0,65.0,7.0,12.0,4.0,8.0,9.0,36.0,11.0,0.0,Matches,429.0,it ITA,MF,23.0,9.8,22.0,2.24,15.0,0.0,1.0,3.0,2.0,1.0,2.0,0.2,2.0,0.0,0.0,0.0,0.0,0.0,Matches,,,,,,,,,,,,,,,,,,,,,,,,,,,,,,,,,,,,,,,,,,,,,,,,,,,,,,,,429.0,it ITA,MF,23.0,9.8,4.0,0.0,0.0,30.0,5.0,0.0,5.0,9.0,16.0,0.0,0.0,0.0,51.0,13.0,18.0,41.9,Matches,429.0,it ITA,MF,23.0,9.8,401.0,391.0,9.0,7.0,0.0,2.0,5.0,1.0,0.0,0.0,0.0,0.0,307.0,1.0,11.0,Matches,429.0,it ITA,MF,23.0,9.8,307.0,401.0,76.6,5520.0,1482.0,138.0,170.0,81.2,133.0,151.0,88.1,32.0,60.0,53.3,0.0,0.3,0.6,-0.3,5.0,36.0,8.0,2.0,36.0,Matches,549,it ITA,MF,23,19,883.0,46.0,25.8,9.8,9,81.0,5,10,16.0,16,2.0,17.0,13.0,4.0,0.41,-0.2,14.7,10.8,4.0,0.4,-0.09,Matches,429.0,it ITA,MF,23.0,9.8,497.0,15.0,107.0,283.0,112.0,17.0,497.0,5.0,2.0,40.0,3.0,60.0,211.0,1105.0,536.0,8.0,12.0,0.0,10.0,6.0,308.0,22.0,Matches,429.0,it ITA,MF,23.0,9.8,2.0,20.0,5.0,25.0,2.04,0.51,0.1,0.4,18.7,0.0,0.0,0.0,1.4,1.4,0.07,0.6,0.6,Matches,429.0,it ITA,MF,23.0,19.0,9.0,883.0,9.8,2.0,0.0,2.0,2.0,0.0,0.0,4.0,0.0,1.4,1.4,0.3,1.7,8.0,36.0,22.0,0.2,0.0,0.2,0.2,0.2,0.15,0.03,0.17,0.15,0.17,Matches,Tommaso Pobega,DM/M C,23,139,158,Italy,AC Milan,4,10,11,12,13,7,11,15,10,12,14,11,14,12,16,15,13,14,13,12,14,16,8,10,14,13,14,14,12,12,14,12,14,13,15,14,14,14,11,6,12,1,3,2,4,1,1,1,3,1,1,3,8,14,4,13,12,19,13,14,1,1,7,1,1,1,18,8,20,8,1,12,1,1,188,75,20,12,10953487,6950,7200,5250,Northern_European,137,0,1999/7/15,1,0,35577.0,,43269242
696,Paul Pogba,Juventus,1993,430.0,fr FRA,MFFW,29.0,1.2,0.0,0.0,0.0,0.0,0.0,0.0,1.0,0.0,1.0,0.0,0.0,0.0,0.0,0.0,2.0,0.0,Matches,430.0,fr FRA,MFFW,29.0,1.2,8.0,6.43,3.0,0.0,1.0,1.0,3.0,0.0,1.0,0.8,0.0,0.0,0.0,0.0,1.0,0.0,Matches,,,,,,,,,,,,,,,,,,,,,,,,,,,,,,,,,,,,,,,,,,,,,,,,,,,,,,,,430.0,fr FRA,MFFW,29.0,1.2,0.0,0.0,0.0,2.0,7.0,0.0,2.0,0.0,0.0,0.0,0.0,0.0,6.0,7.0,3.0,70.0,Matches,430.0,fr FRA,MFFW,29.0,1.2,67.0,67.0,0.0,0.0,1.0,0.0,2.0,0.0,0.0,0.0,0.0,0.0,48.0,0.0,4.0,Matches,430.0,fr FRA,MFFW,29.0,1.2,48.0,67.0,71.6,737.0,199.0,29.0,33.0,87.9,15.0,19.0,78.9,3.0,6.0,50.0,0.0,0.2,0.1,-0.2,2.0,7.0,2.0,0.0,4.0,Matches,551,fr FRA,MFFW,29,6,111.0,19.0,3.2,1.2,1,23.0,0,5,18.0,3,2.0,3.0,0.0,3.0,2.43,1.89,2.1,1.0,1.1,0.91,0.57,Matches,430.0,fr FRA,MFFW,29.0,1.2,83.0,4.0,11.0,38.0,35.0,10.0,83.0,8.0,6.0,75.0,1.0,12.5,52.0,267.0,132.0,5.0,2.0,4.0,2.0,4.0,70.0,15.0,Matches,430.0,fr FRA,MFFW,29.0,1.2,0.0,5.0,2.0,40.0,4.05,1.62,0.0,0.0,18.5,0.0,0.0,0.0,0.3,0.3,0.07,-0.3,-0.3,Matches,430.0,fr FRA,MFFW,29.0,6.0,1.0,111.0,1.2,0.0,0.0,0.0,0.0,0.0,0.0,0.0,0.0,0.3,0.3,0.2,0.6,5.0,4.0,15.0,0.0,0.0,0.0,0.0,0.0,0.27,0.2,0.46,0.27,0.46,Matches,Paul Pogba,M LC,29,160,176,"France,Guinea",Juventus,10,14,16,14,18,15,14,14,4,6,19,15,11,18,12,16,10,14,10,18,12,13,18,13,14,7,15,8,12,13,16,16,15,14,16,16,14,14,13,12,10,3,4,2,3,3,3,2,4,3,3,1,17,19,14,10,14,15,14,13,1,1,1,1,1,1,14,15,20,11,15,15,1,1,191,84,13,20,91437501,8000,8800,8000,African_Caribbean,159,16,1993/3/15,91,11,197308.0,,85028014
697,Marin Pongračić,Lecce,1997,432.0,hr CRO,DF,24.0,8.8,16.0,14.0,8.0,7.0,1.0,5.0,7.0,71.4,2.0,4.0,3.0,1.0,16.0,32.0,31.0,0.0,Matches,432.0,hr CRO,DF,24.0,8.8,6.0,0.68,4.0,1.0,0.0,0.0,0.0,1.0,0.0,0.0,0.0,0.0,0.0,0.0,0.0,0.0,Matches,,,,,,,,,,,,,,,,,,,,,,,,,,,,,,,,,,,,,,,,,,,,,,,,,,,,,,,,432.0,hr CRO,DF,24.0,8.8,2.0,0.0,0.0,15.0,0.0,0.0,0.0,16.0,14.0,0.0,0.0,0.0,59.0,9.0,10.0,47.4,Matches,432.0,hr CRO,DF,24.0,8.8,361.0,324.0,37.0,37.0,0.0,3.0,0.0,0.0,0.0,0.0,0.0,0.0,296.0,0.0,1.0,Matches,432.0,hr CRO,DF,24.0,8.8,296.0,361.0,82.0,6388.0,2314.0,73.0,94.0,77.7,171.0,195.0,87.7,47.0,63.0,74.6,0.0,0.1,0.0,-0.1,2.0,16.0,2.0,0.0,19.0,Matches,553,hr CRO,DF,24,9,790.0,88.0,23.1,8.8,9,88.0,8,0,,10,1.44,9.0,9.0,0.0,0.0,0.44,7.6,8.0,-0.4,-0.04,0.15,Matches,432.0,hr CRO,DF,24.0,8.8,435.0,48.0,232.0,201.0,11.0,4.0,435.0,2.0,2.0,100.0,0.0,0.0,223.0,1491.0,754.0,3.0,1.0,0.0,5.0,0.0,210.0,1.0,Matches,432.0,hr CRO,DF,24.0,8.8,0.0,1.0,0.0,0.0,0.11,0.0,0.0,,16.5,0.0,0.0,0.0,0.0,0.0,0.02,0.0,0.0,Matches,432.0,hr CRO,DF,24.0,9.0,9.0,790.0,8.8,0.0,0.0,0.0,0.0,0.0,0.0,2.0,0.0,0.0,0.0,0.1,0.1,3.0,19.0,1.0,0.0,0.0,0.0,0.0,0.0,0.0,0.01,0.01,0.0,0.01,Matches,Marin Pongračić,D RC,24,130,139,"Croatia,Germany",VfL Wolfsburg,4,7,12,6,12,5,13,6,8,13,13,7,14,12,17,12,16,12,12,12,12,13,11,7,8,13,11,9,13,11,15,15,12,16,12,16,13,15,12,11,10,2,3,2,2,1,3,4,1,4,2,3,11,13,19,5,10,10,5,5,1,1,20,16,1,1,14,1,1,1,1,1,1,1,190,95,13,20,3363593,6500,6800,5500,Mediterranean_Hispanic,129,2,1997/9/11,5,0,42192.0,Salento,91175664
698,Ignacio Pussetto,Sampdoria,1995,435.0,ar ARG,MFDF,26.0,1.7,6.0,3.0,2.0,3.0,1.0,3.0,4.0,75.0,1.0,4.0,0.0,4.0,0.0,6.0,3.0,0.0,Matches,435.0,ar ARG,MFDF,26.0,1.7,2.0,1.18,2.0,0.0,0.0,0.0,0.0,0.0,0.0,0.0,0.0,0.0,0.0,0.0,0.0,0.0,Matches,,,,,,,,,,,,,,,,,,,,,,,,,,,,,,,,,,,,,,,,,,,,,,,,,,,,,,,,435.0,ar ARG,MFDF,26.0,1.7,1.0,0.0,0.0,7.0,1.0,0.0,5.0,0.0,3.0,0.0,0.0,0.0,4.0,4.0,5.0,44.4,Matches,435.0,ar ARG,MFDF,26.0,1.7,56.0,55.0,1.0,1.0,0.0,1.0,5.0,0.0,0.0,0.0,0.0,0.0,34.0,0.0,4.0,Matches,435.0,ar ARG,MFDF,26.0,1.7,34.0,56.0,60.7,404.0,91.0,25.0,32.0,78.1,7.0,12.0,58.3,0.0,4.0,0.0,0.0,0.2,0.1,-0.2,2.0,2.0,0.0,0.0,1.0,Matches,557,ar ARG,MFDF,26,5,152.0,30.0,4.4,1.7,1,53.0,0,4,25.0,3,0.6,0.0,2.0,-2.0,-1.18,0.06,0.7,3.5,-2.8,-1.64,-0.83,Matches,435.0,ar ARG,MFDF,26.0,1.7,81.0,2.0,11.0,23.0,47.0,5.0,81.0,3.0,1.0,33.3,2.0,66.7,34.0,150.0,34.0,2.0,1.0,0.0,7.0,1.0,51.0,17.0,Matches,435.0,ar ARG,MFDF,26.0,1.7,0.0,2.0,2.0,100.0,1.18,1.18,0.0,0.0,14.2,0.0,0.0,0.0,0.2,0.2,0.08,-0.2,-0.2,Matches,435.0,ar ARG,MFDF,26.0,5.0,1.0,152.0,1.7,0.0,0.0,0.0,0.0,0.0,0.0,1.0,0.0,0.2,0.2,0.2,0.3,2.0,1.0,17.0,0.0,0.0,0.0,0.0,0.0,0.09,0.11,0.2,0.09,0.2,Matches,Ignacio Pussetto,AM/S RC,26,127,135,"Argentina,Italy",Watford,11,11,14,12,13,12,10,11,5,6,12,11,10,13,13,12,11,13,9,11,10,14,13,9,14,7,9,11,15,15,11,10,12,14,10,8,12,9,8,12,15,3,2,1,3,3,1,2,3,1,3,3,10,13,2,13,12,17,15,7,1,1,1,1,5,10,1,12,1,15,14,15,18,20,180,74,12,20,6037340,6350,6350,5200,Mediterranean_Hispanic,116,8,1995/12/21,0,0,29999.0,U.C. Sampdoria,14092340
699,Fabio Quagliarella,Sampdoria,1983,437.0,it ITA,FW,39.0,8.9,2.0,1.0,1.0,1.0,0.0,1.0,7.0,14.3,6.0,5.0,1.0,4.0,0.0,2.0,9.0,0.0,Matches,437.0,it ITA,FW,39.0,8.9,23.0,2.57,19.0,0.0,1.0,3.0,0.0,0.0,3.0,0.34,3.0,0.0,0.0,0.0,0.0,0.0,Matches,,,,,,,,,,,,,,,,,,,,,,,,,,,,,,,,,,,,,,,,,,,,,,,,,,,,,,,,437.0,it ITA,FW,39.0,8.9,2.0,0.0,0.0,4.0,19.0,6.0,14.0,0.0,1.0,0.0,0.0,0.0,29.0,9.0,28.0,24.3,Matches,437.0,it ITA,FW,39.0,8.9,245.0,223.0,20.0,1.0,2.0,5.0,14.0,2.0,0.0,0.0,0.0,0.0,159.0,2.0,11.0,Matches,437.0,it ITA,FW,39.0,8.9,159.0,245.0,64.9,2528.0,609.0,78.0,100.0,78.0,49.0,72.0,68.1,18.0,37.0,48.6,1.0,0.7,0.7,0.3,7.0,15.0,7.0,1.0,25.0,Matches,559,it ITA,FW,39,23,800.0,35.0,23.4,8.9,7,73.0,0,16,18.0,10,0.39,6.0,21.0,-15.0,-1.69,-0.59,8.7,18.8,-10.0,-1.12,-0.36,Matches,437.0,it ITA,FW,39.0,8.9,340.0,10.0,34.0,142.0,166.0,46.0,340.0,9.0,4.0,44.4,3.0,33.3,210.0,755.0,206.0,5.0,4.0,3.0,23.0,5.0,257.0,72.0,Matches,437.0,it ITA,FW,39.0,8.9,1.0,36.0,6.0,16.7,4.05,0.68,0.03,0.17,16.5,0.0,0.0,0.0,2.8,2.8,0.08,-1.8,-1.8,Matches,437.0,it ITA,FW,39.0,23.0,7.0,800.0,8.9,1.0,1.0,2.0,1.0,0.0,0.0,2.0,0.0,2.8,2.8,0.7,3.5,5.0,25.0,72.0,0.11,0.11,0.23,0.11,0.23,0.31,0.08,0.4,0.31,0.4,Matches,Fabio Quagliarella,S,39,128,159,Italy,U.C. Sampdoria,6,10,11,16,16,10,13,16,5,5,16,19,6,17,12,17,15,16,15,15,15,20,19,20,19,6,17,19,6,9,13,11,19,6,10,11,14,13,16,11,8,3,1,4,1,3,3,3,3,3,1,3,10,16,10,11,12,20,19,10,1,1,1,1,1,1,1,1,1,1,1,1,1,20,180,79,13,20,275864,6400,6500,6000,Mediterranean_Hispanic,131,4,1983/1/31,28,9,17885.0,,6100739
700,Giacomo Quagliata,Cremonese,2000,438.0,it ITA,DF,22.0,7.8,10.0,8.0,7.0,1.0,2.0,5.0,11.0,45.5,6.0,7.0,2.0,5.0,11.0,21.0,8.0,0.0,Matches,438.0,it ITA,DF,22.0,7.8,28.0,3.61,16.0,7.0,0.0,1.0,4.0,0.0,2.0,0.26,1.0,1.0,0.0,0.0,0.0,0.0,Matches,,,,,,,,,,,,,,,,,,,,,,,,,,,,,,,,,,,,,,,,,,,,,,,,,,,,,,,,438.0,it ITA,DF,22.0,7.8,0.0,1.0,0.0,13.0,12.0,0.0,54.0,11.0,8.0,0.0,0.0,0.0,57.0,2.0,14.0,12.5,Matches,438.0,it ITA,DF,22.0,7.8,338.0,264.0,73.0,5.0,0.0,0.0,54.0,60.0,8.0,3.0,4.0,0.0,221.0,1.0,14.0,Matches,438.0,it ITA,DF,22.0,7.8,221.0,338.0,65.4,3802.0,1660.0,108.0,123.0,87.8,90.0,132.0,68.2,20.0,62.0,32.3,1.0,1.0,1.0,0.0,13.0,21.0,10.0,8.0,28.0,Matches,560,it ITA,DF,22,20,699.0,35.0,20.4,7.8,6,70.0,1,14,20.0,13,0.65,6.0,17.0,-11.0,-1.42,-0.69,7.5,17.6,-10.1,-1.3,-0.73,Matches,438.0,it ITA,DF,22.0,7.8,421.0,15.0,107.0,154.0,171.0,13.0,421.0,25.0,10.0,40.0,11.0,44.0,193.0,1189.0,770.0,19.0,18.0,2.0,10.0,6.0,207.0,45.0,Matches,438.0,it ITA,DF,22.0,7.8,0.0,9.0,1.0,11.1,1.16,0.13,0.0,0.0,19.9,1.0,0.0,0.0,0.5,0.5,0.05,-0.5,-0.5,Matches,438.0,it ITA,DF,22.0,20.0,6.0,699.0,7.8,0.0,1.0,1.0,0.0,0.0,0.0,0.0,1.0,0.5,0.5,1.0,1.5,19.0,28.0,45.0,0.0,0.13,0.13,0.0,0.13,0.06,0.13,0.19,0.06,0.19,Matches,Giacomo Quagliata,D/WB L,22,120,138,Italy,Cremonese,6,12,10,7,9,6,10,10,13,13,12,9,13,11,15,12,13,12,12,10,13,16,8,12,10,13,15,16,13,12,13,11,12,13,15,11,12,15,8,4,12,3,3,2,2,3,1,2,1,1,3,1,12,13,10,11,12,13,9,15,1,20,1,1,19,1,1,12,1,1,1,1,1,1,180,65,20,8,2575999,6000,6000,4250,Mediterranean_Hispanic,119,2,2000/2/19,0,0,3000.0,,43321418
701,Ivan Radovanović,Salernitana,1988,441.0,rs SRB,MFDF,33.0,7.5,12.0,4.0,8.0,4.0,0.0,4.0,10.0,40.0,6.0,9.0,3.0,6.0,7.0,19.0,9.0,1.0,Matches,441.0,rs SRB,MFDF,33.0,7.5,2.0,0.27,0.0,0.0,0.0,0.0,2.0,0.0,0.0,0.0,0.0,0.0,0.0,0.0,0.0,0.0,Matches,,,,,,,,,,,,,,,,,,,,,,,,,,,,,,,,,,,,,,,,,,,,,,,,,,,,,,,,441.0,rs SRB,MFDF,33.0,7.5,1.0,1.0,0.0,4.0,7.0,0.0,0.0,7.0,4.0,0.0,0.0,0.0,47.0,8.0,12.0,40.0,Matches,441.0,rs SRB,MFDF,33.0,7.5,265.0,252.0,12.0,12.0,2.0,3.0,0.0,0.0,0.0,0.0,0.0,0.0,214.0,1.0,1.0,Matches,441.0,rs SRB,MFDF,33.0,7.5,214.0,265.0,80.8,4318.0,1602.0,75.0,84.0,89.3,105.0,115.0,91.3,32.0,57.0,56.1,0.0,0.0,0.1,0.0,1.0,19.0,0.0,0.0,16.0,Matches,563,rs SRB,MFDF,33,10,671.0,67.0,19.6,7.5,7,82.0,4,3,32.0,3,1.1,9.0,13.0,-4.0,-0.54,-0.21,7.5,13.0,-5.4,-0.73,0.09,Matches,441.0,rs SRB,MFDF,33.0,7.5,323.0,30.0,130.0,182.0,14.0,2.0,323.0,1.0,0.0,0.0,1.0,100.0,175.0,815.0,439.0,2.0,1.0,0.0,6.0,0.0,203.0,2.0,Matches,441.0,rs SRB,MFDF,33.0,7.5,0.0,7.0,0.0,0.0,0.94,0.0,0.0,,33.0,0.0,0.0,0.0,0.2,0.2,0.03,-0.2,-0.2,Matches,441.0,rs SRB,MFDF,33.0,10.0,7.0,671.0,7.5,0.0,0.0,0.0,0.0,0.0,0.0,1.0,1.0,0.2,0.2,0.0,0.2,2.0,16.0,2.0,0.0,0.0,0.0,0.0,0.0,0.03,0.0,0.03,0.03,0.03,Matches,Ivan Radovanović,D/DM/M C,33,125,134,Serbia,U.S. Salernitana 1919,10,6,9,7,13,12,13,12,8,13,13,10,13,12,14,13,13,10,13,10,13,16,10,12,10,15,14,15,10,9,12,13,11,10,12,14,13,14,11,15,11,4,2,1,1,4,1,2,1,1,3,1,14,10,2,16,10,18,18,13,1,1,20,1,1,1,20,1,19,1,1,1,1,1,187,80,10,20,427058,6250,6300,4500,Mediterranean_Hispanic,122,3,1988/8/29,10,0,21346.0,,62013021
702,Antonio Raimondo,Bologna,2004,444.0,it ITA,FW,18.0,0.2,0.0,0.0,0.0,0.0,0.0,0.0,0.0,,0.0,0.0,0.0,0.0,0.0,0.0,1.0,0.0,Matches,444.0,it ITA,FW,18.0,0.2,0.0,0.0,0.0,0.0,0.0,0.0,0.0,0.0,0.0,0.0,0.0,0.0,0.0,0.0,0.0,0.0,Matches,,,,,,,,,,,,,,,,,,,,,,,,,,,,,,,,,,,,,,,,,,,,,,,,,,,,,,,,444.0,it ITA,FW,18.0,0.2,0.0,0.0,0.0,0.0,0.0,0.0,0.0,0.0,0.0,0.0,0.0,0.0,0.0,0.0,3.0,0.0,Matches,444.0,it ITA,FW,18.0,0.2,4.0,4.0,0.0,0.0,0.0,0.0,0.0,0.0,0.0,0.0,0.0,0.0,3.0,0.0,0.0,Matches,444.0,it ITA,FW,18.0,0.2,3.0,4.0,75.0,21.0,3.0,2.0,3.0,66.7,0.0,0.0,,0.0,0.0,,0.0,0.0,0.0,0.0,0.0,1.0,0.0,0.0,0.0,Matches,567,it ITA,FW,18,2,15.0,8.0,0.4,0.2,0,,0,2,8.0,6,3.0,1.0,0.0,1.0,6.0,5.92,0.2,0.0,0.2,1.22,1.35,Matches,444.0,it ITA,FW,18.0,0.2,6.0,0.0,1.0,2.0,3.0,1.0,6.0,0.0,0.0,,0.0,,4.0,22.0,4.0,1.0,1.0,0.0,1.0,1.0,5.0,3.0,Matches,444.0,it ITA,FW,18.0,0.2,0.0,0.0,0.0,,0.0,0.0,,,,0.0,0.0,0.0,0.0,0.0,,0.0,0.0,Matches,444.0,it ITA,FW,18.0,2.0,0.0,15.0,0.2,0.0,0.0,0.0,0.0,0.0,0.0,0.0,0.0,0.0,0.0,0.0,0.0,1.0,0.0,3.0,0.0,0.0,0.0,0.0,0.0,0.0,0.0,0.0,0.0,0.0,Matches,Antonio Raimondo,S,18,95,-75,Italy,Bologna FC 1909,5,5,12,13,11,7,11,10,3,3,11,10,6,12,9,12,11,9,11,11,10,13,7,8,13,5,9,13,12,12,12,10,12,13,10,11,13,5,10,5,5,3,2,2,1,1,2,1,3,2,2,1,12,15,6,12,12,14,12,12,1,1,1,1,1,1,1,1,1,1,1,1,1,20,185,71,20,9,6006600,4700,4300,2004,Northern_European,95,2,2004/3/18,0,0,1422.0,,2000021170
703,Luca Ranieri,Fiorentina,1999,445.0,it ITA,DF,23.0,5.6,9.0,4.0,6.0,3.0,0.0,6.0,9.0,66.7,3.0,5.0,3.0,2.0,11.0,20.0,15.0,1.0,Matches,445.0,it ITA,DF,23.0,5.6,4.0,0.71,4.0,0.0,0.0,0.0,0.0,0.0,0.0,0.0,0.0,0.0,0.0,0.0,0.0,0.0,Matches,,,,,,,,,,,,,,,,,,,,,,,,,,,,,,,,,,,,,,,,,,,,,,,,,,,,,,,,445.0,it ITA,DF,23.0,5.6,1.0,0.0,0.0,6.0,2.0,2.0,0.0,11.0,4.0,0.0,0.0,0.0,30.0,11.0,13.0,45.8,Matches,445.0,it ITA,DF,23.0,5.6,334.0,322.0,10.0,5.0,0.0,1.0,0.0,5.0,0.0,0.0,0.0,0.0,278.0,2.0,3.0,Matches,445.0,it ITA,DF,23.0,5.6,278.0,334.0,83.2,5363.0,1832.0,96.0,105.0,91.4,143.0,158.0,90.5,37.0,62.0,59.7,0.0,0.1,0.1,-0.1,2.0,18.0,0.0,0.0,11.0,Matches,568,it ITA,DF,23,9,508.0,56.0,14.9,5.6,5,89.0,4,4,16.0,27,2.0,14.0,5.0,9.0,1.59,1.56,8.6,5.0,3.6,0.63,0.38,Matches,445.0,it ITA,DF,23.0,5.6,381.0,33.0,192.0,179.0,15.0,3.0,381.0,2.0,1.0,50.0,1.0,50.0,208.0,944.0,485.0,4.0,2.0,0.0,4.0,1.0,258.0,0.0,Matches,445.0,it ITA,DF,23.0,5.6,0.0,1.0,0.0,0.0,0.18,0.0,0.0,,5.9,0.0,0.0,0.0,0.1,0.1,0.07,-0.1,-0.1,Matches,445.0,it ITA,DF,23.0,9.0,5.0,508.0,5.6,0.0,0.0,0.0,0.0,0.0,0.0,1.0,0.0,0.1,0.1,0.1,0.2,4.0,11.0,0.0,0.0,0.0,0.0,0.0,0.0,0.01,0.02,0.03,0.01,0.03,Matches,Luca Ranieri,D/WB LC,23,126,143,Italy,ACF Fiorentina,6,12,12,7,12,8,11,8,11,12,12,7,13,12,12,13,13,12,11,11,13,14,10,10,13,13,14,15,14,13,13,11,14,13,14,12,12,12,10,9,13,2,2,1,4,2,2,3,3,4,3,1,11,13,10,13,12,13,9,9,1,20,17,1,20,1,1,15,1,1,1,1,1,1,179,74,20,7,3812675,6300,6100,3653,Mediterranean_Hispanic,122,2,1999/4/23,0,0,21346.0,,43270506
704,Filippo Ranocchia,Monza,2001,447.0,it ITA,MF,21.0,5.9,11.0,6.0,5.0,4.0,2.0,4.0,12.0,33.3,8.0,5.0,1.0,4.0,4.0,15.0,7.0,0.0,Matches,447.0,it ITA,MF,21.0,5.9,19.0,3.23,8.0,4.0,1.0,5.0,1.0,0.0,1.0,0.17,1.0,0.0,0.0,0.0,0.0,0.0,Matches,,,,,,,,,,,,,,,,,,,,,,,,,,,,,,,,,,,,,,,,,,,,,,,,,,,,,,,,447.0,it ITA,MF,21.0,5.9,1.0,0.0,0.0,7.0,12.0,0.0,13.0,4.0,6.0,0.0,0.0,0.0,32.0,2.0,6.0,25.0,Matches,447.0,it ITA,MF,21.0,5.9,255.0,242.0,13.0,7.0,3.0,9.0,13.0,2.0,4.0,0.0,4.0,0.0,201.0,0.0,6.0,Matches,447.0,it ITA,MF,21.0,5.9,201.0,255.0,78.8,3906.0,1183.0,81.0,93.0,87.1,83.0,98.0,84.7,32.0,49.0,65.3,0.0,0.4,0.4,-0.4,7.0,23.0,7.0,1.0,26.0,Matches,570,it ITA,MF,21,14,530.0,38.0,15.5,5.9,5,63.0,1,9,24.0,20,1.29,6.0,9.0,-3.0,-0.51,-0.48,6.3,7.8,-1.5,-0.25,-0.13,Matches,447.0,it ITA,MF,21.0,5.9,328.0,14.0,70.0,174.0,90.0,4.0,328.0,15.0,8.0,53.3,3.0,20.0,213.0,1365.0,656.0,13.0,18.0,0.0,10.0,10.0,236.0,15.0,Matches,447.0,it ITA,MF,21.0,5.9,1.0,19.0,8.0,42.1,3.23,1.36,0.05,0.13,25.2,5.0,0.0,0.0,1.2,1.2,0.07,-0.2,-0.2,Matches,447.0,it ITA,MF,21.0,14.0,5.0,530.0,5.9,1.0,0.0,1.0,1.0,0.0,0.0,1.0,0.0,1.2,1.2,0.4,1.6,13.0,26.0,15.0,0.17,0.0,0.17,0.17,0.17,0.21,0.06,0.27,0.21,0.27,Matches,Filippo Ranocchia,M C,21,117,149,Italy,Juventus,11,12,12,9,13,9,11,12,8,12,13,8,13,13,14,14,13,12,14,12,12,12,10,10,14,12,14,14,12,12,11,11,16,13,13,11,13,11,12,4,13,3,3,1,4,1,3,3,1,1,2,2,11,12,7,14,11,17,13,12,1,1,1,1,1,1,15,1,20,1,1,10,1,1,178,70,7,20,7580000,5849,5849,3699,Mediterranean_Hispanic,119,2,2001/5/14,0,0,766.0,Brianza,43375253
705,Giacomo Raspadori,Sassuolo,2000,448.0,it ITA,FW,22.0,0.5,0.0,0.0,0.0,0.0,0.0,0.0,0.0,,0.0,0.0,0.0,0.0,0.0,0.0,0.0,0.0,Matches,448.0,it ITA,FW,22.0,0.5,0.0,0.0,0.0,0.0,0.0,0.0,0.0,0.0,0.0,0.0,0.0,0.0,0.0,0.0,0.0,0.0,Matches,,,,,,,,,,,,,,,,,,,,,,,,,,,,,,,,,,,,,,,,,,,,,,,,,,,,,,,,448.0,it ITA,FW,22.0,0.5,0.0,0.0,0.0,0.0,0.0,0.0,1.0,0.0,0.0,0.0,0.0,0.0,0.0,0.0,0.0,,Matches,448.0,it ITA,FW,22.0,0.5,12.0,9.0,3.0,0.0,0.0,0.0,1.0,0.0,1.0,1.0,0.0,0.0,10.0,0.0,0.0,Matches,448.0,it ITA,FW,22.0,0.5,10.0,12.0,83.3,207.0,33.0,2.0,2.0,100.0,6.0,7.0,85.7,1.0,2.0,50.0,0.0,0.0,0.0,0.0,0.0,1.0,0.0,0.0,2.0,Matches,571,it ITA,FW,22,1,45.0,45.0,1.3,0.5,0,,0,1,45.0,0,0.0,0.0,1.0,-1.0,-2.0,-1.65,0.4,0.9,-0.5,-1.0,-1.06,Matches,448.0,it ITA,FW,22.0,0.5,15.0,0.0,0.0,7.0,8.0,2.0,15.0,0.0,0.0,,0.0,,10.0,33.0,6.0,0.0,1.0,0.0,2.0,1.0,12.0,4.0,Matches,448.0,it ITA,FW,22.0,0.5,0.0,0.0,0.0,,0.0,0.0,,,,0.0,0.0,0.0,0.0,0.0,,0.0,0.0,Matches,448.0,it ITA,FW,22.0,1.0,0.0,45.0,0.5,0.0,0.0,0.0,0.0,0.0,0.0,0.0,0.0,0.0,0.0,0.0,0.0,0.0,2.0,4.0,0.0,0.0,0.0,0.0,0.0,0.0,0.0,0.0,0.0,0.0,Matches,Giacomo Raspadori,AM/S LC,22,146,165,Italy,U.S. Sassuolo,13,10,13,15,16,14,11,12,6,6,13,13,6,14,12,14,11,14,12,13,13,15,16,11,16,4,14,14,15,16,15,7,15,14,13,11,13,4,14,6,13,2,4,2,4,2,2,1,1,1,4,3,15,15,6,14,13,17,15,14,1,1,1,1,1,1,1,1,1,1,16,17,10,20,172,69,15,20,25000000,7298,7398,5698,Mediterranean_Hispanic,144,2,2000/2/18,13,3,13425.0,Parthenope,43316850
706,Pablo Rodríguez,Lecce,2001,457.0,es ESP,FWMF,20.0,0.6,2.0,1.0,2.0,0.0,0.0,0.0,2.0,0.0,2.0,3.0,0.0,3.0,0.0,2.0,0.0,0.0,Matches,457.0,es ESP,FWMF,20.0,0.6,0.0,0.0,0.0,0.0,0.0,0.0,0.0,0.0,0.0,0.0,0.0,0.0,0.0,0.0,0.0,0.0,Matches,,,,,,,,,,,,,,,,,,,,,,,,,,,,,,,,,,,,,,,,,,,,,,,,,,,,,,,,457.0,es ESP,FWMF,20.0,0.6,0.0,0.0,0.0,1.0,2.0,0.0,4.0,0.0,1.0,0.0,0.0,0.0,2.0,0.0,2.0,0.0,Matches,457.0,es ESP,FWMF,20.0,0.6,21.0,18.0,3.0,0.0,0.0,0.0,4.0,1.0,2.0,0.0,1.0,0.0,14.0,0.0,2.0,Matches,457.0,es ESP,FWMF,20.0,0.6,14.0,21.0,66.7,215.0,66.0,6.0,10.0,60.0,6.0,7.0,85.7,1.0,1.0,100.0,0.0,0.0,0.0,0.0,1.0,2.0,0.0,0.0,3.0,Matches,586,es ESP,FWMF,20,4,54.0,14.0,1.6,0.6,0,,0,4,14.0,14,0.25,0.0,0.0,0.0,0.0,0.35,0.6,0.8,-0.1,-0.21,-0.05,Matches,457.0,es ESP,FWMF,20.0,0.6,32.0,0.0,4.0,18.0,11.0,0.0,32.0,1.0,0.0,0.0,0.0,0.0,21.0,97.0,54.0,2.0,2.0,0.0,1.0,2.0,22.0,7.0,Matches,457.0,es ESP,FWMF,20.0,0.6,0.0,0.0,0.0,,0.0,0.0,,,,0.0,0.0,0.0,0.0,0.0,,0.0,0.0,Matches,457.0,es ESP,FWMF,20.0,4.0,0.0,54.0,0.6,0.0,0.0,0.0,0.0,0.0,0.0,0.0,0.0,0.0,0.0,0.0,0.0,2.0,3.0,7.0,0.0,0.0,0.0,0.0,0.0,0.0,0.04,0.04,0.0,0.04,Matches,Pablo Rodríguez,S L,20,112,142,Spain,Salento,3,7,13,13,13,8,9,4,2,5,12,10,3,15,15,11,9,13,13,13,12,14,12,14,14,4,11,14,15,15,13,7,13,15,11,9,13,10,14,12,7,1,1,3,1,1,2,1,3,2,1,3,15,9,6,12,11,12,11,16,1,1,1,1,1,1,1,1,1,1,15,1,1,20,177,0,9,20,3655999,5600,5600,2502,Mediterranean_Hispanic,111,3,2001/8/4,0,0,768.0,,67277463
707,Simone Romagnoli,Lecce,1990,462.0,it ITA,DF,32.0,1.9,6.0,5.0,3.0,3.0,0.0,2.0,2.0,100.0,0.0,4.0,1.0,3.0,1.0,7.0,11.0,0.0,Matches,462.0,it ITA,DF,32.0,1.9,0.0,0.0,0.0,0.0,0.0,0.0,0.0,0.0,0.0,0.0,0.0,0.0,0.0,0.0,0.0,0.0,Matches,,,,,,,,,,,,,,,,,,,,,,,,,,,,,,,,,,,,,,,,,,,,,,,,,,,,,,,,462.0,it ITA,DF,32.0,1.9,0.0,0.0,0.0,3.0,0.0,0.0,0.0,1.0,5.0,0.0,0.0,0.0,9.0,10.0,8.0,55.6,Matches,462.0,it ITA,DF,32.0,1.9,74.0,71.0,3.0,3.0,0.0,0.0,0.0,0.0,0.0,0.0,0.0,0.0,61.0,0.0,0.0,Matches,462.0,it ITA,DF,32.0,1.9,61.0,74.0,82.4,1136.0,497.0,18.0,19.0,94.7,42.0,49.0,85.7,1.0,6.0,16.7,0.0,0.0,0.0,0.0,0.0,1.0,0.0,0.0,5.0,Matches,591,it ITA,DF,32,7,167.0,24.0,4.9,1.9,1,90.0,1,6,13.0,11,0.71,1.0,4.0,-3.0,-1.62,-1.34,2.9,3.1,-0.3,-0.15,0.01,Matches,462.0,it ITA,DF,32.0,1.9,100.0,20.0,56.0,43.0,2.0,2.0,100.0,0.0,0.0,,0.0,,44.0,159.0,69.0,0.0,0.0,0.0,0.0,0.0,47.0,0.0,Matches,462.0,it ITA,DF,32.0,1.9,0.0,1.0,0.0,0.0,0.54,0.0,0.0,,11.2,0.0,0.0,0.0,0.0,0.0,0.01,0.0,0.0,Matches,462.0,it ITA,DF,32.0,7.0,1.0,167.0,1.9,0.0,0.0,0.0,0.0,0.0,0.0,0.0,0.0,0.0,0.0,0.0,0.0,0.0,5.0,0.0,0.0,0.0,0.0,0.0,0.0,0.01,0.0,0.01,0.01,0.01,Matches,Simone Romagnoli,D C,32,124,131,Italy,Parma Calcio 1913,5,7,6,9,10,5,14,7,11,13,10,5,12,8,13,13,14,12,12,8,12,13,6,14,9,15,12,12,11,10,15,17,15,11,12,15,14,12,12,5,8,3,3,1,3,1,2,3,1,4,1,3,10,14,3,14,12,15,15,14,1,1,20,1,1,1,1,1,1,1,1,1,1,1,193,85,7,20,347975206,6200,6200,4950,Northern_European,120,3,1990/2/9,0,0,35577.0,,43017209
708,Luka Romero,Lazio,2004,463.0,ar ARG,FW,17.0,1.7,0.0,0.0,0.0,0.0,0.0,0.0,3.0,0.0,3.0,4.0,0.0,4.0,3.0,3.0,1.0,0.0,Matches,463.0,ar ARG,FW,17.0,1.7,4.0,2.38,4.0,0.0,0.0,0.0,0.0,0.0,0.0,0.0,0.0,0.0,0.0,0.0,0.0,0.0,Matches,,,,,,,,,,,,,,,,,,,,,,,,,,,,,,,,,,,,,,,,,,,,,,,,,,,,,,,,463.0,ar ARG,FW,17.0,1.7,0.0,0.0,0.0,3.0,6.0,0.0,0.0,3.0,0.0,0.0,0.0,0.0,10.0,2.0,1.0,66.7,Matches,463.0,ar ARG,FW,17.0,1.7,80.0,78.0,2.0,0.0,0.0,0.0,0.0,2.0,0.0,0.0,0.0,0.0,70.0,0.0,1.0,Matches,463.0,ar ARG,FW,17.0,1.7,70.0,80.0,87.5,800.0,152.0,56.0,60.0,93.3,10.0,12.0,83.3,1.0,2.0,50.0,0.0,0.1,0.1,-0.1,2.0,2.0,0.0,0.0,4.0,Matches,592,ar ARG,FW,17,6,151.0,25.0,4.4,1.7,1,68.0,0,5,17.0,28,2.0,1.0,2.0,-1.0,-0.6,-1.45,2.6,1.4,1.2,0.72,0.48,Matches,463.0,ar ARG,FW,17.0,1.7,112.0,2.0,14.0,50.0,48.0,7.0,112.0,10.0,2.0,20.0,7.0,70.0,84.0,496.0,159.0,4.0,3.0,2.0,5.0,4.0,91.0,21.0,Matches,463.0,ar ARG,FW,17.0,1.7,1.0,5.0,1.0,20.0,2.98,0.6,0.2,1.0,15.7,0.0,0.0,0.0,0.9,0.9,0.17,0.1,0.1,Matches,463.0,ar ARG,FW,17.0,6.0,1.0,151.0,1.7,1.0,0.0,1.0,1.0,0.0,0.0,0.0,0.0,0.9,0.9,0.1,0.9,4.0,4.0,21.0,0.6,0.0,0.6,0.6,0.6,0.52,0.04,0.55,0.52,0.55,Matches,Luka Romero,AM RLC,17,112,-85,"Argentina,Mexico,Spain",S.S. Lazio,5,11,13,12,13,11,6,11,5,5,12,9,9,13,13,11,13,11,9,11,11,15,14,5,11,6,13,13,13,14,12,6,18,13,12,8,12,6,12,4,14,1,1,1,4,3,1,1,4,1,1,3,13,14,5,13,13,15,12,13,1,1,1,1,1,1,1,13,11,14,17,20,20,12,165,64,20,11,57680001,5600,5003,4001,Mediterranean_Hispanic,107,2,2004/11/18,0,0,9807.0,,2000032231
709,Nicolò Rovella,Juventus,2001,467.0,it ITA,MF,20.0,0.3,1.0,1.0,0.0,1.0,0.0,1.0,1.0,100.0,0.0,0.0,0.0,0.0,0.0,1.0,0.0,0.0,Matches,467.0,it ITA,MF,20.0,0.3,0.0,0.0,0.0,0.0,0.0,0.0,0.0,0.0,0.0,0.0,0.0,0.0,0.0,0.0,0.0,0.0,Matches,,,,,,,,,,,,,,,,,,,,,,,,,,,,,,,,,,,,,,,,,,,,,,,,,,,,,,,,467.0,it ITA,MF,20.0,0.3,1.0,0.0,0.0,1.0,1.0,0.0,3.0,0.0,1.0,0.0,0.0,0.0,1.0,0.0,0.0,,Matches,467.0,it ITA,MF,20.0,0.3,25.0,22.0,3.0,1.0,0.0,2.0,3.0,1.0,1.0,1.0,0.0,0.0,22.0,0.0,1.0,Matches,467.0,it ITA,MF,20.0,0.3,22.0,25.0,88.0,448.0,82.0,7.0,8.0,87.5,11.0,12.0,91.7,3.0,4.0,75.0,0.0,0.0,0.0,0.0,0.0,3.0,0.0,0.0,1.0,Matches,596,it ITA,MF,20,3,27.0,9.0,0.8,0.3,0,,0,3,9.0,0,1.67,0.0,0.0,0.0,0.0,-0.61,0.7,0.2,0.5,1.75,1.4,Matches,467.0,it ITA,MF,20.0,0.3,29.0,0.0,4.0,17.0,9.0,0.0,29.0,2.0,2.0,100.0,0.0,0.0,21.0,125.0,66.0,1.0,1.0,0.0,1.0,0.0,24.0,2.0,Matches,467.0,it ITA,MF,20.0,0.3,0.0,2.0,0.0,0.0,6.67,0.0,0.0,,27.0,0.0,0.0,0.0,0.1,0.1,0.04,-0.1,-0.1,Matches,467.0,it ITA,MF,20.0,3.0,0.0,27.0,0.3,0.0,0.0,0.0,0.0,0.0,0.0,1.0,0.0,0.1,0.1,0.0,0.1,1.0,1.0,2.0,0.0,0.0,0.0,0.0,0.0,0.3,0.0,0.3,0.3,0.3,Matches,Nicolò Rovella,DM/M C,20,127,-85,Italy,Juventus,14,13,12,8,13,12,8,11,8,11,14,11,15,12,13,12,13,11,13,13,13,15,13,10,13,13,14,13,12,13,13,8,15,13,14,11,14,11,13,6,13,3,2,1,3,2,2,1,2,1,2,2,10,15,4,11,13,15,18,12,1,1,1,1,1,1,20,1,20,1,1,12,1,1,179,70,10,20,63800001,6350,6300,5100,Mediterranean_Hispanic,127,2,2001/12/4,0,0,35576.0,Brianza,43372892
710,Daniele Rugani,Juventus,1994,470.0,it ITA,DF,28.0,6.3,7.0,0.0,6.0,1.0,0.0,4.0,4.0,100.0,0.0,7.0,5.0,2.0,7.0,14.0,32.0,0.0,Matches,470.0,it ITA,DF,28.0,6.3,1.0,0.16,1.0,0.0,0.0,0.0,0.0,0.0,0.0,0.0,0.0,0.0,0.0,0.0,0.0,0.0,Matches,,,,,,,,,,,,,,,,,,,,,,,,,,,,,,,,,,,,,,,,,,,,,,,,,,,,,,,,470.0,it ITA,DF,28.0,6.3,0.0,0.0,0.0,5.0,0.0,1.0,0.0,7.0,0.0,0.0,0.0,0.0,16.0,11.0,9.0,55.0,Matches,470.0,it ITA,DF,28.0,6.3,262.0,255.0,7.0,4.0,0.0,3.0,0.0,0.0,0.0,0.0,0.0,0.0,231.0,0.0,0.0,Matches,470.0,it ITA,DF,28.0,6.3,231.0,262.0,88.2,4696.0,1347.0,64.0,70.0,91.4,150.0,159.0,94.3,17.0,33.0,51.5,0.0,0.0,0.0,0.0,0.0,7.0,0.0,0.0,5.0,Matches,599,it ITA,DF,28,9,564.0,63.0,16.5,6.3,6,88.0,5,3,12.0,29,2.11,9.0,2.0,7.0,1.12,0.61,8.6,6.3,2.3,0.37,0.01,Matches,470.0,it ITA,DF,28.0,6.3,325.0,61.0,204.0,112.0,9.0,4.0,325.0,1.0,1.0,100.0,0.0,0.0,187.0,844.0,496.0,2.0,0.0,0.0,1.0,0.0,213.0,0.0,Matches,470.0,it ITA,DF,28.0,6.3,0.0,4.0,1.0,25.0,0.64,0.16,0.0,0.0,12.1,0.0,0.0,0.0,0.5,0.5,0.12,-0.5,-0.5,Matches,470.0,it ITA,DF,28.0,9.0,6.0,564.0,6.3,0.0,0.0,0.0,0.0,0.0,0.0,0.0,0.0,0.5,0.5,0.0,0.5,2.0,5.0,0.0,0.0,0.0,0.0,0.0,0.0,0.07,0.0,0.07,0.07,0.07,Matches,Daniele Rugani,D C,27,134,140,Italy,Juventus,5,8,9,9,13,5,15,7,7,14,12,6,14,12,7,14,12,10,16,12,11,12,10,7,6,14,17,15,12,12,15,16,15,14,15,14,15,4,11,5,8,1,1,2,3,1,2,1,3,1,3,2,10,15,2,14,11,18,18,20,1,1,20,7,1,1,1,1,1,1,1,1,1,1,190,84,10,20,5510878,6695,6695,5745,Mediterranean_Hispanic,134,2,1994/7/29,7,0,124615.0,,43083931
711,Matteo Ruggeri,Atalanta,2002,471.0,it ITA,DFMF,20.0,9.2,17.0,12.0,5.0,9.0,3.0,8.0,16.0,50.0,8.0,14.0,3.0,11.0,12.0,29.0,16.0,0.0,Matches,471.0,it ITA,DFMF,20.0,9.2,17.0,1.85,17.0,0.0,0.0,0.0,0.0,0.0,1.0,0.11,1.0,0.0,0.0,0.0,0.0,0.0,Matches,,,,,,,,,,,,,,,,,,,,,,,,,,,,,,,,,,,,,,,,,,,,,,,,,,,,,,,,471.0,it ITA,DFMF,20.0,9.2,3.0,0.0,0.0,10.0,5.0,0.0,38.0,12.0,12.0,0.0,0.0,0.0,57.0,13.0,6.0,68.4,Matches,471.0,it ITA,DFMF,20.0,9.2,631.0,527.0,102.0,5.0,0.0,2.0,38.0,96.0,1.0,1.0,0.0,0.0,515.0,2.0,10.0,Matches,471.0,it ITA,DFMF,20.0,9.2,515.0,631.0,81.6,8203.0,3341.0,278.0,311.0,89.4,187.0,227.0,82.4,36.0,57.0,63.2,1.0,0.9,0.9,0.1,10.0,38.0,12.0,6.0,55.0,Matches,601,it ITA,DFMF,20,15,829.0,55.0,24.2,9.2,8,90.0,8,7,16.0,13,1.67,19.0,13.0,6.0,0.65,0.23,16.2,9.5,6.8,0.73,0.4,Matches,471.0,it ITA,DFMF,20.0,9.2,722.0,24.0,198.0,304.0,224.0,17.0,722.0,9.0,4.0,44.4,5.0,55.6,342.0,1508.0,777.0,22.0,14.0,3.0,7.0,5.0,444.0,65.0,Matches,471.0,it ITA,DFMF,20.0,9.2,0.0,10.0,1.0,10.0,1.09,0.11,0.0,0.0,16.7,0.0,0.0,0.0,0.6,0.6,0.06,-0.6,-0.6,Matches,471.0,it ITA,DFMF,20.0,15.0,8.0,829.0,9.2,0.0,1.0,1.0,0.0,0.0,0.0,3.0,0.0,0.6,0.6,0.9,1.5,22.0,55.0,65.0,0.0,0.11,0.11,0.0,0.11,0.06,0.1,0.16,0.06,0.16,Matches,Matteo Ruggeri,D/WB L,20,120,-75,Italy,Atalanta,13,14,11,6,12,13,8,11,8,9,12,5,12,13,11,12,11,13,13,12,12,15,8,8,12,12,14,14,13,13,12,10,16,13,14,12,13,8,13,6,9,2,2,1,1,2,1,2,3,3,3,3,12,15,8,15,13,15,14,12,1,20,13,1,20,1,1,11,1,1,1,1,1,1,179,79,20,8,34500002,5995,5995,3745,Mediterranean_Hispanic,117,2,2002/7/11,0,0,1346.0,,43425834
712,Alessandro Russo,Sassuolo,2001,473.0,it ITA,GK,21.0,1.0,0.0,0.0,0.0,0.0,0.0,0.0,0.0,,0.0,0.0,0.0,0.0,0.0,0.0,1.0,1.0,Matches,473.0,it ITA,GK,21.0,1.0,0.0,0.0,0.0,0.0,0.0,0.0,0.0,0.0,0.0,0.0,0.0,0.0,0.0,0.0,0.0,0.0,Matches,34.0,it ITA,GK,21.0,1.0,3.0,0.0,0.0,0.0,0.0,2.8,0.4,-0.2,-0.22,0.0,12.0,0.0,42.0,2.0,28.6,30.7,8.0,0.0,18.3,14.0,0.0,0.0,0.0,0.0,10.0,Matches,34.0,it ITA,GK,21.0,1.0,1.0,90.0,1.0,3.0,3.0,7.0,4.0,57.1,0.0,0.0,1.0,0.0,0.0,0.0,0.0,0.0,0.0,,Matches,473.0,it ITA,GK,21.0,1.0,0.0,0.0,0.0,0.0,1.0,0.0,0.0,0.0,0.0,0.0,0.0,0.0,0.0,0.0,0.0,,Matches,473.0,it ITA,GK,21.0,1.0,50.0,37.0,13.0,5.0,0.0,0.0,0.0,0.0,0.0,0.0,0.0,0.0,37.0,0.0,0.0,Matches,473.0,it ITA,GK,21.0,1.0,37.0,50.0,74.0,750.0,387.0,16.0,16.0,100.0,15.0,15.0,100.0,6.0,19.0,31.6,0.0,0.0,0.0,0.0,0.0,0.0,0.0,0.0,0.0,Matches,603,it ITA,GK,21,1,90.0,90.0,2.6,1.0,1,90.0,1,0,,33,0.0,1.0,3.0,-2.0,-2.0,-1.68,1.1,1.6,-0.5,-0.5,-0.56,Matches,473.0,it ITA,GK,21.0,1.0,55.0,47.0,55.0,0.0,0.0,0.0,55.0,0.0,0.0,,0.0,,33.0,125.0,68.0,0.0,0.0,0.0,0.0,0.0,33.0,0.0,Matches,473.0,it ITA,GK,21.0,1.0,0.0,0.0,0.0,,0.0,0.0,,,,0.0,0.0,0.0,0.0,0.0,,0.0,0.0,Matches,473.0,it ITA,GK,21.0,1.0,1.0,90.0,1.0,0.0,0.0,0.0,0.0,0.0,0.0,0.0,0.0,0.0,0.0,0.0,0.0,0.0,0.0,0.0,0.0,0.0,0.0,0.0,0.0,0.0,0.0,0.0,0.0,0.0,Matches,Alessandro Russo,GK,21,103,145,Italy,U.S. Sassuolo,1,1,2,3,4,2,4,1,3,3,6,3,2,5,10,11,10,11,12,7,11,13,4,10,4,12,10,9,11,12,13,17,12,13,14,14,10,6,8,7,8,15,9,12,8,11,12,12,13,12,13,10,11,15,9,13,12,14,12,11,20,1,1,1,1,1,1,1,1,1,1,1,1,1,193,82,5,20,2792999,5150,5150,3200,Mediterranean_Hispanic,103,2,2001/3/31,0,0,2115.0,,43384567
713,Jacopo Sala,Spezia,1991,476.0,it ITA,MF,30.0,1.2,1.0,0.0,1.0,0.0,0.0,0.0,2.0,0.0,2.0,2.0,0.0,2.0,1.0,2.0,2.0,0.0,Matches,476.0,it ITA,MF,30.0,1.2,2.0,1.62,0.0,1.0,0.0,0.0,1.0,0.0,0.0,0.0,0.0,0.0,0.0,0.0,0.0,0.0,Matches,,,,,,,,,,,,,,,,,,,,,,,,,,,,,,,,,,,,,,,,,,,,,,,,,,,,,,,,476.0,it ITA,MF,30.0,1.2,1.0,0.0,0.0,3.0,3.0,0.0,4.0,1.0,0.0,0.0,0.0,0.0,5.0,1.0,0.0,100.0,Matches,476.0,it ITA,MF,30.0,1.2,46.0,40.0,6.0,4.0,0.0,0.0,4.0,1.0,0.0,0.0,0.0,0.0,36.0,0.0,5.0,Matches,476.0,it ITA,MF,30.0,1.2,36.0,46.0,78.3,589.0,199.0,20.0,21.0,95.2,13.0,15.0,86.7,3.0,5.0,60.0,0.0,0.0,0.1,0.0,1.0,4.0,2.0,0.0,6.0,Matches,607,it ITA,MF,30,6,112.0,19.0,3.3,1.2,1,66.0,0,5,9.0,22,0.83,0.0,4.0,-4.0,-3.21,-2.48,0.1,3.1,-3.0,-2.47,-2.06,Matches,476.0,it ITA,MF,30.0,1.2,57.0,2.0,14.0,28.0,16.0,2.0,57.0,3.0,0.0,0.0,2.0,66.7,32.0,119.0,68.0,2.0,0.0,0.0,1.0,0.0,34.0,3.0,Matches,476.0,it ITA,MF,30.0,1.2,0.0,0.0,0.0,,0.0,0.0,,,,0.0,0.0,0.0,0.0,0.0,,0.0,0.0,Matches,476.0,it ITA,MF,30.0,6.0,1.0,112.0,1.2,0.0,0.0,0.0,0.0,0.0,0.0,1.0,0.0,0.0,0.0,0.0,0.0,2.0,6.0,3.0,0.0,0.0,0.0,0.0,0.0,0.0,0.01,0.01,0.0,0.01,Matches,Jacopo Sala,D/WB/M R,30,120,132,Italy,Spezia Calcio,11,12,11,8,11,10,8,13,12,11,13,9,15,11,13,11,15,12,11,13,10,11,13,8,13,11,15,16,13,11,11,10,13,13,13,12,13,6,13,5,14,1,1,1,2,1,1,3,2,2,2,2,13,17,5,10,12,12,13,15,1,12,1,20,10,20,1,1,14,18,1,1,1,1,184,75,10,20,698639,5998,6148,5098,Mediterranean_Hispanic,115,2,1991/12/5,0,0,14230.0,,29024855
714,Junior Sambia,Salernitana,1996,478.0,fr FRA,DF,25.0,7.7,12.0,5.0,7.0,4.0,1.0,6.0,10.0,60.0,4.0,9.0,3.0,6.0,8.0,20.0,16.0,1.0,Matches,478.0,fr FRA,DF,25.0,7.7,22.0,2.84,17.0,0.0,4.0,1.0,0.0,0.0,1.0,0.13,1.0,0.0,0.0,0.0,0.0,0.0,Matches,,,,,,,,,,,,,,,,,,,,,,,,,,,,,,,,,,,,,,,,,,,,,,,,,,,,,,,,478.0,fr FRA,DF,25.0,7.7,3.0,0.0,0.0,11.0,17.0,0.0,33.0,8.0,5.0,0.0,0.0,0.0,34.0,15.0,10.0,60.0,Matches,478.0,fr FRA,DF,25.0,7.7,396.0,311.0,85.0,6.0,0.0,1.0,33.0,71.0,8.0,3.0,4.0,0.0,312.0,0.0,7.0,Matches,478.0,fr FRA,DF,25.0,7.7,312.0,396.0,78.8,4617.0,1867.0,178.0,198.0,89.9,107.0,141.0,75.9,14.0,33.0,42.4,1.0,1.6,0.7,-0.6,7.0,14.0,10.0,2.0,27.0,Matches,610,fr FRA,DF,25,22,697.0,32.0,20.4,7.7,7,69.0,1,15,14.0,16,1.0,8.0,10.0,-2.0,-0.26,0.14,7.7,14.3,-6.6,-0.85,-0.06,Matches,478.0,fr FRA,DF,25.0,7.7,504.0,21.0,114.0,221.0,172.0,13.0,504.0,29.0,10.0,34.5,17.0,58.6,258.0,1443.0,803.0,23.0,22.0,6.0,13.0,9.0,301.0,38.0,Matches,478.0,fr FRA,DF,25.0,7.7,0.0,13.0,5.0,38.5,1.68,0.65,0.0,0.0,24.1,5.0,0.0,0.0,0.6,0.6,0.05,-0.6,-0.6,Matches,478.0,fr FRA,DF,25.0,22.0,7.0,697.0,7.7,0.0,1.0,1.0,0.0,0.0,0.0,3.0,0.0,0.6,0.6,1.6,2.2,23.0,27.0,38.0,0.0,0.13,0.13,0.0,0.13,0.08,0.21,0.29,0.08,0.29,Matches,Junior Sambia,D/WB RC,25,125,131,"France,Central African Republic",U.S. Salernitana 1919,8,15,15,8,12,13,8,13,6,10,12,9,12,12,12,11,12,12,9,10,11,11,13,7,14,12,9,10,14,13,14,12,13,14,15,14,11,12,13,10,14,4,1,1,1,1,1,3,3,2,2,2,5,12,9,11,13,10,14,13,1,10,1,18,10,20,13,1,15,1,1,13,1,1,185,73,8,20,2292767,6247,6347,3697,African_Caribbean,122,17,1996/9/7,0,0,17185.0,,36515152
715,Nicola Sansone,Bologna,1991,482.0,it ITA,FW,30.0,8.2,12.0,4.0,6.0,4.0,2.0,5.0,10.0,50.0,5.0,0.0,0.0,0.0,0.0,12.0,4.0,0.0,Matches,482.0,it ITA,FW,30.0,8.2,31.0,3.77,19.0,3.0,3.0,2.0,4.0,0.0,7.0,0.85,3.0,1.0,0.0,1.0,2.0,0.0,Matches,,,,,,,,,,,,,,,,,,,,,,,,,,,,,,,,,,,,,,,,,,,,,,,,,,,,,,,,482.0,it ITA,FW,30.0,8.2,2.0,0.0,0.0,13.0,16.0,11.0,20.0,0.0,4.0,2.0,0.0,0.0,23.0,0.0,13.0,0.0,Matches,482.0,it ITA,FW,30.0,8.2,218.0,194.0,22.0,1.0,0.0,2.0,20.0,1.0,10.0,7.0,2.0,0.0,161.0,2.0,7.0,Matches,482.0,it ITA,FW,30.0,8.2,161.0,218.0,73.9,2232.0,509.0,98.0,118.0,83.1,40.0,56.0,71.4,9.0,18.0,50.0,2.0,1.0,0.8,1.0,8.0,6.0,4.0,1.0,13.0,Matches,615,it ITA,FW,30,18,740.0,41.0,21.6,8.2,8,69.0,2,10,19.0,8,1.33,16.0,9.0,7.0,0.85,0.95,10.6,8.5,2.2,0.26,0.5,Matches,482.0,it ITA,FW,30.0,8.2,314.0,4.0,26.0,139.0,156.0,29.0,314.0,19.0,4.0,21.1,11.0,57.9,209.0,1114.0,446.0,17.0,14.0,7.0,23.0,14.0,246.0,72.0,Matches,482.0,it ITA,FW,30.0,8.2,4.0,22.0,8.0,36.4,2.68,0.97,0.18,0.5,18.0,2.0,0.0,0.0,2.8,2.8,0.13,1.2,1.2,Matches,482.0,it ITA,FW,30.0,18.0,8.0,740.0,8.2,4.0,2.0,6.0,4.0,0.0,0.0,2.0,0.0,2.8,2.8,1.0,3.7,17.0,13.0,72.0,0.49,0.24,0.73,0.49,0.73,0.34,0.12,0.45,0.34,0.45,Matches,Nicola Sansone,AM/S LC,30,128,150,"Italy,Germany",Bologna FC 1909,12,13,14,11,11,13,7,13,5,6,12,13,9,15,10,13,11,13,12,11,12,12,13,10,14,8,12,13,14,14,12,7,14,13,13,9,12,9,12,9,14,2,1,3,3,1,2,3,2,1,1,1,12,12,7,11,12,12,12,12,1,1,1,1,1,1,1,10,1,7,20,15,12,20,172,63,11,20,1890991,6400,6400,5850,Mediterranean_Hispanic,126,4,1991/9/10,3,0,39422.0,,92016695
716,Demba Seck,Torino,2001,489.0,sn SEN,MFFW,21.0,5.8,5.0,2.0,3.0,2.0,0.0,2.0,3.0,66.7,1.0,3.0,1.0,2.0,1.0,6.0,1.0,0.0,Matches,489.0,sn SEN,MFFW,21.0,5.8,14.0,2.42,12.0,0.0,1.0,0.0,1.0,0.0,1.0,0.17,1.0,0.0,0.0,0.0,0.0,0.0,Matches,,,,,,,,,,,,,,,,,,,,,,,,,,,,,,,,,,,,,,,,,,,,,,,,,,,,,,,,489.0,sn SEN,MFFW,21.0,5.8,0.0,0.0,0.0,8.0,18.0,6.0,7.0,1.0,2.0,0.0,0.0,0.0,23.0,7.0,10.0,41.2,Matches,489.0,sn SEN,MFFW,21.0,5.8,166.0,159.0,6.0,1.0,2.0,0.0,7.0,2.0,0.0,0.0,0.0,0.0,127.0,1.0,7.0,Matches,489.0,sn SEN,MFFW,21.0,5.8,127.0,166.0,76.5,1746.0,354.0,79.0,88.0,89.8,41.0,52.0,78.8,3.0,6.0,50.0,0.0,0.6,0.3,-0.6,6.0,8.0,5.0,0.0,17.0,Matches,624,sn SEN,MFFW,21,19,519.0,27.0,15.2,5.8,6,65.0,0,13,10.0,17,1.21,2.0,5.0,-3.0,-0.52,-0.64,5.3,6.5,-1.2,-0.2,-0.29,Matches,489.0,sn SEN,MFFW,21.0,5.8,238.0,2.0,22.0,107.0,117.0,27.0,238.0,30.0,16.0,53.3,9.0,30.0,164.0,1395.0,752.0,29.0,19.0,12.0,24.0,13.0,185.0,42.0,Matches,489.0,sn SEN,MFFW,21.0,5.8,0.0,10.0,3.0,30.0,1.73,0.52,0.0,0.0,16.0,0.0,0.0,0.0,0.6,0.6,0.06,-0.6,-0.6,Matches,489.0,sn SEN,MFFW,21.0,19.0,6.0,519.0,5.8,0.0,0.0,0.0,0.0,0.0,0.0,0.0,0.0,0.6,0.6,0.6,1.2,29.0,17.0,42.0,0.0,0.0,0.0,0.0,0.0,0.1,0.1,0.2,0.1,0.2,Matches,Demba Seck,S,21,118,145,"Senegal,Italy",Torino,6,10,13,12,11,7,12,12,7,6,11,10,9,12,7,11,10,12,11,10,12,12,9,6,12,6,13,8,14,12,11,12,15,16,14,12,9,8,11,10,15,3,2,2,4,1,1,2,3,1,1,1,11,14,9,12,12,14,13,11,1,1,1,1,1,1,1,1,1,1,12,12,13,20,190,76,20,11,4034999,5900,4562,3150,African_Caribbean,116,16,2001/2/10,0,0,10143.0,,43317909
717,Telasco Segovia,Sampdoria,2003,490.0,ve VEN,MF,19.0,0.0,0.0,0.0,0.0,0.0,0.0,0.0,0.0,,0.0,0.0,0.0,0.0,0.0,0.0,0.0,0.0,Matches,490.0,ve VEN,MF,19.0,0.0,0.0,0.0,0.0,0.0,0.0,0.0,0.0,0.0,0.0,0.0,0.0,0.0,0.0,0.0,0.0,0.0,Matches,,,,,,,,,,,,,,,,,,,,,,,,,,,,,,,,,,,,,,,,,,,,,,,,,,,,,,,,490.0,ve VEN,MF,19.0,0.0,0.0,0.0,0.0,0.0,0.0,0.0,0.0,0.0,0.0,0.0,0.0,0.0,0.0,0.0,0.0,,Matches,490.0,ve VEN,MF,19.0,0.0,3.0,3.0,0.0,0.0,0.0,0.0,0.0,0.0,0.0,0.0,0.0,0.0,3.0,0.0,0.0,Matches,490.0,ve VEN,MF,19.0,0.0,3.0,3.0,100.0,38.0,0.0,2.0,2.0,100.0,1.0,1.0,100.0,0.0,0.0,,0.0,0.0,0.0,0.0,0.0,0.0,0.0,0.0,0.0,Matches,626,ve VEN,MF,19,1,4.0,4.0,0.1,0.0,0,,0,1,4.0,5,0.0,0.0,0.0,0.0,0.0,1.24,0.1,0.1,0.0,0.0,0.85,Matches,490.0,ve VEN,MF,19.0,0.0,3.0,0.0,0.0,3.0,0.0,0.0,3.0,0.0,0.0,,0.0,,1.0,1.0,0.0,0.0,0.0,0.0,0.0,0.0,3.0,0.0,Matches,490.0,ve VEN,MF,19.0,0.0,0.0,0.0,0.0,,0.0,0.0,,,,0.0,0.0,0.0,0.0,0.0,,0.0,0.0,Matches,490.0,ve VEN,MF,19.0,1.0,0.0,4.0,0.0,0.0,0.0,0.0,0.0,0.0,0.0,0.0,0.0,0.0,0.0,0.0,0.0,0.0,0.0,0.0,0.0,0.0,0.0,0.0,0.0,0.0,0.0,0.0,0.0,0.0,Matches,Telasco Segovia,M C,19,113,-8,Venezuela,Asociación Civil Deportivo Lara,13,9,11,8,12,12,8,10,5,11,13,5,10,13,12,13,10,12,12,12,13,9,12,8,11,12,13,13,13,13,13,8,14,12,13,10,12,6,13,5,12,4,3,1,3,4,2,3,2,2,3,1,12,13,1,12,9,11,10,13,1,1,1,1,1,1,15,12,20,1,1,1,1,1,178,73,10,20,700000,5500,5500,2250,Mediterranean_Hispanic,113,8,2003/4/2,1,0,994.0,U.C. Sampdoria,86080119
718,Jacopo Segre,Torino,1997,491.0,it ITA,DF,25.0,0.2,0.0,0.0,0.0,0.0,0.0,0.0,0.0,,0.0,0.0,0.0,0.0,0.0,0.0,0.0,0.0,Matches,491.0,it ITA,DF,25.0,0.2,0.0,0.0,0.0,0.0,0.0,0.0,0.0,0.0,0.0,0.0,0.0,0.0,0.0,0.0,0.0,0.0,Matches,,,,,,,,,,,,,,,,,,,,,,,,,,,,,,,,,,,,,,,,,,,,,,,,,,,,,,,,491.0,it ITA,DF,25.0,0.2,0.0,0.0,0.0,0.0,0.0,0.0,0.0,0.0,0.0,0.0,0.0,0.0,2.0,1.0,1.0,50.0,Matches,491.0,it ITA,DF,25.0,0.2,9.0,9.0,0.0,0.0,0.0,0.0,0.0,0.0,0.0,0.0,0.0,0.0,8.0,0.0,0.0,Matches,491.0,it ITA,DF,25.0,0.2,8.0,9.0,88.9,103.0,22.0,6.0,7.0,85.7,2.0,2.0,100.0,0.0,0.0,,0.0,0.0,0.0,0.0,0.0,0.0,0.0,0.0,0.0,Matches,627,it ITA,DF,25,1,21.0,21.0,0.6,0.2,0,,0,1,21.0,1,3.0,0.0,1.0,-1.0,-4.29,-4.34,0.6,1.0,-0.4,-1.63,-1.69,Matches,491.0,it ITA,DF,25.0,0.2,12.0,0.0,4.0,8.0,0.0,0.0,12.0,0.0,0.0,,0.0,,8.0,33.0,12.0,0.0,0.0,0.0,0.0,0.0,7.0,0.0,Matches,491.0,it ITA,DF,25.0,0.2,0.0,0.0,0.0,,0.0,0.0,,,,0.0,0.0,0.0,0.0,0.0,,0.0,0.0,Matches,491.0,it ITA,DF,25.0,1.0,0.0,21.0,0.2,0.0,0.0,0.0,0.0,0.0,0.0,0.0,0.0,0.0,0.0,0.0,0.0,0.0,0.0,0.0,0.0,0.0,0.0,0.0,0.0,0.0,0.0,0.0,0.0,0.0,Matches,Jacopo Segre,DM/M C,25,120,129,Italy,Palermo F.C.,8,10,12,12,12,8,8,13,11,10,12,6,11,12,11,12,12,11,12,11,12,16,10,7,13,12,13,13,13,13,12,12,15,13,16,12,13,7,10,5,12,3,1,1,1,1,1,3,2,1,2,3,13,15,7,15,13,15,16,11,1,1,1,1,1,1,16,9,20,12,1,1,1,1,185,75,10,20,1659081,6000,6000,4000,Mediterranean_Hispanic,119,5,1997/2/17,0,0,7826.0,,43153083
719,Eldor Shomurodov,Spezia,1995,497.0,uz UZB,FW,27.0,9.0,5.0,5.0,3.0,1.0,1.0,2.0,11.0,18.2,9.0,5.0,1.0,4.0,3.0,8.0,4.0,0.0,Matches,497.0,uz UZB,FW,27.0,9.0,19.0,2.12,17.0,0.0,2.0,0.0,0.0,0.0,1.0,0.11,1.0,0.0,0.0,0.0,0.0,0.0,Matches,,,,,,,,,,,,,,,,,,,,,,,,,,,,,,,,,,,,,,,,,,,,,,,,,,,,,,,,497.0,uz UZB,FW,27.0,9.0,2.0,0.0,0.0,9.0,7.0,2.0,3.0,3.0,5.0,0.0,0.0,0.0,30.0,20.0,35.0,36.4,Matches,497.0,uz UZB,FW,27.0,9.0,205.0,186.0,19.0,0.0,3.0,0.0,3.0,0.0,0.0,0.0,0.0,0.0,143.0,0.0,8.0,Matches,497.0,uz UZB,FW,27.0,9.0,143.0,205.0,69.8,1903.0,367.0,86.0,113.0,76.1,44.0,56.0,78.6,5.0,11.0,45.5,1.0,1.4,0.8,-0.4,11.0,7.0,5.0,1.0,15.0,Matches,637,uz UZB,FW,27,15,809.0,54.0,23.7,9.0,9,80.0,6,6,15.0,3,0.56,6.0,16.0,-10.0,-1.11,-0.39,11.1,12.6,-1.5,-0.17,0.4,Matches,497.0,uz UZB,FW,27.0,9.0,316.0,4.0,31.0,140.0,151.0,34.0,316.0,25.0,8.0,32.0,13.0,52.0,170.0,899.0,337.0,7.0,4.0,3.0,37.0,17.0,222.0,53.0,Matches,497.0,uz UZB,FW,27.0,9.0,1.0,18.0,4.0,22.2,2.0,0.44,0.06,0.25,15.7,0.0,0.0,0.0,2.8,2.8,0.16,-1.8,-1.8,Matches,497.0,uz UZB,FW,27.0,15.0,9.0,809.0,9.0,1.0,1.0,2.0,1.0,0.0,0.0,2.0,0.0,2.8,2.8,1.4,4.2,7.0,15.0,53.0,0.11,0.11,0.22,0.11,0.22,0.31,0.15,0.46,0.31,0.46,Matches,Eldor Shomurodov,S L,27,132,141,Uzbekistan,Associazione Sportiva Roma,6,9,14,13,15,7,12,9,5,6,12,11,8,15,13,13,12,12,12,11,11,14,14,4,16,8,15,14,14,14,15,12,16,15,12,12,11,5,8,5,12,2,2,2,3,1,1,4,3,4,4,2,12,16,1,13,8,15,14,17,1,1,1,1,1,1,1,1,1,1,15,10,10,20,185,76,12,20,2375105,6600,7200,5500,Asian,132,3,1995/6/29,57,31,36922.0,,59061760
720,Giovanni Simeone,Napoli,1995,500.0,ar ARG,FW,27.0,4.5,12.0,3.0,3.0,5.0,4.0,3.0,8.0,37.5,5.0,2.0,1.0,1.0,1.0,13.0,4.0,0.0,Matches,500.0,ar ARG,FW,27.0,4.5,11.0,2.43,10.0,0.0,0.0,1.0,0.0,0.0,3.0,0.66,3.0,0.0,0.0,0.0,0.0,0.0,Matches,,,,,,,,,,,,,,,,,,,,,,,,,,,,,,,,,,,,,,,,,,,,,,,,,,,,,,,,500.0,ar ARG,FW,27.0,4.5,1.0,0.0,0.0,7.0,9.0,1.0,2.0,1.0,3.0,0.0,0.0,0.0,15.0,6.0,19.0,24.0,Matches,500.0,ar ARG,FW,27.0,4.5,106.0,104.0,2.0,0.0,0.0,1.0,2.0,0.0,0.0,0.0,0.0,0.0,76.0,0.0,4.0,Matches,500.0,ar ARG,FW,27.0,4.5,76.0,106.0,71.7,1016.0,178.0,44.0,55.0,80.0,18.0,30.0,60.0,5.0,6.0,83.3,1.0,1.2,0.3,-0.2,5.0,3.0,2.0,0.0,9.0,Matches,640,ar ARG,FW,27,25,406.0,16.0,11.9,4.5,1,75.0,0,24,14.0,10,2.2,9.0,7.0,2.0,0.44,-0.96,7.4,7.3,0.1,0.03,-0.95,Matches,500.0,ar ARG,FW,27.0,4.5,194.0,4.0,16.0,87.0,92.0,25.0,194.0,15.0,7.0,46.7,5.0,33.3,144.0,722.0,225.0,11.0,9.0,3.0,27.0,13.0,159.0,34.0,Matches,500.0,ar ARG,FW,27.0,4.5,4.0,14.0,8.0,57.1,3.1,1.77,0.29,0.5,17.5,0.0,0.0,0.0,1.4,1.4,0.1,2.6,2.6,Matches,500.0,ar ARG,FW,27.0,25.0,1.0,406.0,4.5,4.0,1.0,5.0,4.0,0.0,0.0,1.0,0.0,1.4,1.4,1.2,2.5,11.0,9.0,34.0,0.89,0.22,1.11,0.89,1.11,0.3,0.26,0.56,0.3,0.56,Matches,Giovanni Simeone,S,26,143,150,"Argentina,Spain",Hellas Verona,6,8,12,16,13,8,16,12,4,4,11,14,7,13,12,15,14,12,13,11,12,13,11,9,16,3,15,18,14,12,14,16,14,15,16,14,14,8,11,8,8,1,1,3,3,2,2,1,2,1,3,2,14,14,8,12,11,15,10,8,1,1,1,1,1,1,1,1,1,1,8,1,10,20,180,81,10,20,11770090,7146,6996,5746,Mediterranean_Hispanic,143,4,1995/8/9,5,1,53364.0,Parthenope,14031138
721,Salvatore Sirigu,Fiorentina,1987,502.0,it ITA,GK,35.0,1.0,0.0,0.0,0.0,0.0,0.0,0.0,0.0,,0.0,0.0,0.0,0.0,0.0,0.0,1.0,0.0,Matches,502.0,it ITA,GK,35.0,1.0,0.0,0.0,0.0,0.0,0.0,0.0,0.0,0.0,0.0,0.0,0.0,0.0,0.0,0.0,0.0,0.0,Matches,38.0,it ITA,GK,35.0,1.0,0.0,0.0,0.0,0.0,0.0,1.0,0.19,1.0,0.96,6.0,16.0,37.5,30.0,9.0,40.0,37.7,8.0,50.0,41.8,12.0,0.0,0.0,2.0,2.0,26.3,Matches,38.0,it ITA,GK,35.0,1.0,1.0,90.0,1.0,0.0,0.0,5.0,5.0,100.0,1.0,0.0,0.0,1.0,100.0,0.0,0.0,0.0,0.0,,Matches,502.0,it ITA,GK,35.0,1.0,0.0,0.0,0.0,0.0,0.0,0.0,0.0,0.0,0.0,0.0,0.0,0.0,2.0,0.0,0.0,,Matches,502.0,it ITA,GK,35.0,1.0,38.0,26.0,12.0,4.0,0.0,0.0,0.0,0.0,0.0,0.0,0.0,0.0,28.0,0.0,0.0,Matches,502.0,it ITA,GK,35.0,1.0,28.0,38.0,73.7,930.0,572.0,2.0,2.0,100.0,12.0,12.0,100.0,14.0,24.0,58.3,0.0,0.0,0.0,0.0,0.0,0.0,0.0,0.0,0.0,Matches,642,it ITA,GK,35,1,90.0,90.0,2.6,1.0,1,90.0,1,0,,7,3.0,2.0,0.0,2.0,2.0,1.78,1.7,1.8,-0.1,-0.09,-0.41,Matches,502.0,it ITA,GK,35.0,1.0,40.0,38.0,40.0,0.0,0.0,0.0,40.0,0.0,0.0,,0.0,,26.0,237.0,118.0,0.0,0.0,0.0,0.0,0.0,16.0,0.0,Matches,502.0,it ITA,GK,35.0,1.0,0.0,0.0,0.0,,0.0,0.0,,,,0.0,0.0,0.0,0.0,0.0,,0.0,0.0,Matches,502.0,it ITA,GK,35.0,1.0,1.0,90.0,1.0,0.0,0.0,0.0,0.0,0.0,0.0,0.0,0.0,0.0,0.0,0.0,0.0,0.0,0.0,0.0,0.0,0.0,0.0,0.0,0.0,0.0,0.0,0.0,0.0,0.0,Matches,Salvatore Sirigu,GK,35,135,155,Italy,Parthenope,5,1,6,2,8,10,7,2,3,3,8,4,2,8,10,14,15,13,13,7,14,17,7,14,3,14,16,8,9,13,14,16,13,10,9,13,14,8,15,7,14,14,14,15,5,14,12,13,15,13,13,13,15,17,8,15,14,18,16,13,20,1,1,1,1,1,1,1,1,1,1,1,1,1,192,80,6,20,1155312,6750,6500,5500,Mediterranean_Hispanic,136,2,1987/1/12,28,0,25000.0,,1401013
722,Ola Solbakken,Roma,1998,507.0,no NOR,MFFW,23.0,5.6,2.0,2.0,1.0,1.0,0.0,2.0,7.0,28.6,5.0,2.0,0.0,2.0,2.0,4.0,8.0,0.0,Matches,507.0,no NOR,MFFW,23.0,5.6,16.0,2.87,10.0,3.0,2.0,0.0,1.0,0.0,2.0,0.36,2.0,0.0,0.0,0.0,0.0,0.0,Matches,,,,,,,,,,,,,,,,,,,,,,,,,,,,,,,,,,,,,,,,,,,,,,,,,,,,,,,,507.0,no NOR,MFFW,23.0,5.6,2.0,0.0,0.0,6.0,7.0,0.0,12.0,2.0,2.0,0.0,0.0,0.0,21.0,4.0,11.0,26.7,Matches,507.0,no NOR,MFFW,23.0,5.6,159.0,148.0,11.0,3.0,1.0,1.0,12.0,2.0,6.0,6.0,0.0,0.0,112.0,0.0,3.0,Matches,507.0,no NOR,MFFW,23.0,5.6,112.0,159.0,70.4,1770.0,364.0,62.0,77.0,80.5,39.0,49.0,79.6,7.0,20.0,35.0,2.0,1.6,1.0,0.4,11.0,7.0,4.0,1.0,14.0,Matches,648,no NOR,MFFW,23,14,502.0,36.0,14.7,5.6,7,64.0,0,7,8.0,6,1.43,7.0,4.0,3.0,0.54,0.26,6.9,3.9,2.9,0.52,-0.17,Matches,507.0,no NOR,MFFW,23.0,5.6,227.0,8.0,28.0,94.0,109.0,20.0,227.0,14.0,5.0,35.7,6.0,42.9,134.0,613.0,220.0,5.0,11.0,7.0,16.0,13.0,156.0,35.0,Matches,507.0,no NOR,MFFW,23.0,5.6,1.0,9.0,1.0,11.1,1.61,0.18,0.11,1.0,17.1,1.0,0.0,0.0,0.6,0.6,0.07,0.4,0.4,Matches,507.0,no NOR,MFFW,23.0,14.0,7.0,502.0,5.6,1.0,2.0,3.0,1.0,0.0,0.0,2.0,0.0,0.6,0.6,1.6,2.2,5.0,14.0,35.0,0.18,0.36,0.54,0.18,0.54,0.11,0.29,0.4,0.11,0.4,Matches,Ola Solbakken,AM RL,23,132,141,Norway,FK Bodø/Glimt,13,12,14,13,13,12,10,12,8,8,10,13,8,13,10,12,7,13,13,10,12,13,13,12,14,8,14,14,16,14,14,13,14,15,14,12,13,5,18,8,10,3,1,2,1,1,1,2,2,2,3,3,12,18,6,12,10,14,14,13,1,1,1,1,1,1,1,13,1,13,19,1,20,12,186,76,20,5,1925445,6300,6300,4250,Northern_European,132,2,1998/9/7,0,0,1210.0,,53116125
723,Brandon Soppy,Udinese,2002,508.0,fr FRA,DF,20.0,1.0,1.0,1.0,0.0,1.0,0.0,0.0,0.0,,0.0,4.0,0.0,4.0,1.0,2.0,1.0,0.0,Matches,508.0,fr FRA,DF,20.0,1.0,4.0,4.0,2.0,1.0,1.0,0.0,0.0,0.0,0.0,0.0,0.0,0.0,0.0,0.0,0.0,0.0,Matches,,,,,,,,,,,,,,,,,,,,,,,,,,,,,,,,,,,,,,,,,,,,,,,,,,,,,,,,508.0,fr FRA,DF,20.0,1.0,1.0,0.0,0.0,2.0,2.0,0.0,1.0,1.0,1.0,0.0,1.0,0.0,6.0,1.0,0.0,100.0,Matches,508.0,fr FRA,DF,20.0,1.0,32.0,29.0,2.0,0.0,0.0,0.0,1.0,2.0,0.0,0.0,0.0,0.0,22.0,1.0,0.0,Matches,508.0,fr FRA,DF,20.0,1.0,22.0,32.0,68.8,322.0,140.0,13.0,14.0,92.9,7.0,10.0,70.0,1.0,6.0,16.7,0.0,0.2,0.0,-0.2,2.0,2.0,1.0,0.0,4.0,Matches,649,fr FRA,DF,20,1,90.0,90.0,2.6,1.0,1,90.0,1,0,,0,0.0,2.0,4.0,-2.0,-2.0,-2.03,0.5,2.3,-1.8,-1.8,-1.71,Matches,508.0,fr FRA,DF,20.0,1.0,48.0,2.0,8.0,19.0,21.0,3.0,48.0,6.0,1.0,16.7,4.0,66.7,33.0,272.0,137.0,4.0,4.0,0.0,0.0,0.0,27.0,4.0,Matches,508.0,fr FRA,DF,20.0,1.0,0.0,2.0,1.0,50.0,2.0,1.0,0.0,0.0,18.5,0.0,0.0,0.0,0.1,0.1,0.04,-0.1,-0.1,Matches,508.0,fr FRA,DF,20.0,1.0,1.0,90.0,1.0,0.0,0.0,0.0,0.0,0.0,0.0,1.0,0.0,0.1,0.1,0.2,0.3,4.0,4.0,4.0,0.0,0.0,0.0,0.0,0.0,0.07,0.19,0.27,0.07,0.27,Matches,Brandon Soppy,D/WB/M RL,20,134,-85,"France,Ivory Coast",Atalanta,7,12,11,6,11,5,9,8,11,11,11,7,11,12,14,12,14,12,11,10,10,13,12,8,9,11,14,14,16,14,13,11,15,15,13,15,12,13,12,5,13,1,2,2,3,1,2,2,1,1,3,1,10,14,12,15,11,13,11,18,1,18,10,20,18,20,1,14,1,16,1,1,1,1,181,80,10,20,53000000,6700,5778,4773,African_Caribbean,119,17,2002/2/21,0,0,14808.0,,49048382
724,Riccardo Sottil,Fiorentina,1999,512.0,it ITA,FW,23.0,9.3,4.0,3.0,2.0,0.0,2.0,2.0,5.0,40.0,3.0,2.0,0.0,2.0,0.0,4.0,0.0,0.0,Matches,512.0,it ITA,FW,23.0,9.3,40.0,4.32,31.0,0.0,2.0,4.0,3.0,0.0,2.0,0.22,2.0,0.0,0.0,0.0,0.0,0.0,Matches,,,,,,,,,,,,,,,,,,,,,,,,,,,,,,,,,,,,,,,,,,,,,,,,,,,,,,,,512.0,it ITA,FW,23.0,9.3,1.0,0.0,0.0,4.0,27.0,6.0,31.0,0.0,3.0,0.0,0.0,0.0,32.0,3.0,5.0,37.5,Matches,512.0,it ITA,FW,23.0,9.3,266.0,264.0,2.0,1.0,2.0,2.0,31.0,1.0,0.0,0.0,0.0,0.0,209.0,0.0,7.0,Matches,512.0,it ITA,FW,23.0,9.3,209.0,266.0,78.6,3457.0,554.0,102.0,115.0,88.7,84.0,109.0,77.1,18.0,25.0,72.0,2.0,1.1,0.8,0.9,15.0,11.0,8.0,2.0,27.0,Matches,655,it ITA,FW,23,18,833.0,46.0,24.4,9.3,9,69.0,1,9,24.0,5,1.56,12.0,6.0,6.0,0.65,0.51,11.9,8.5,3.4,0.37,0.08,Matches,512.0,it ITA,FW,23.0,9.3,368.0,1.0,17.0,88.0,268.0,52.0,368.0,47.0,13.0,27.7,21.0,44.7,302.0,2822.0,1548.0,65.0,35.0,28.0,28.0,13.0,316.0,123.0,Matches,512.0,it ITA,FW,23.0,9.3,0.0,21.0,8.0,38.1,2.27,0.86,0.0,0.0,19.9,1.0,0.0,0.0,1.0,1.0,0.05,-1.0,-1.0,Matches,512.0,it ITA,FW,23.0,18.0,9.0,833.0,9.3,0.0,2.0,2.0,0.0,0.0,0.0,1.0,0.0,1.0,1.0,1.1,2.2,65.0,27.0,123.0,0.0,0.22,0.22,0.0,0.22,0.11,0.12,0.23,0.11,0.23,Matches,Riccardo Sottil,M/AM RL,23,138,154,Italy,ACF Fiorentina,9,12,14,12,14,10,11,12,4,6,14,12,6,14,7,11,11,12,10,12,10,13,14,8,14,6,14,14,15,14,11,11,17,16,14,12,12,5,11,8,14,1,2,3,3,3,1,1,1,3,3,2,13,13,1,14,12,14,13,10,1,1,1,1,10,10,1,16,1,16,20,14,18,13,180,70,11,20,10271686,6900,6500,5150,Mediterranean_Hispanic,133,2,1999/6/3,0,0,21346.0,,43270713
725,Mile Svilar,Roma,1999,522.0,rs SRB,GK,22.0,3.0,0.0,0.0,0.0,0.0,0.0,0.0,0.0,,0.0,0.0,0.0,0.0,0.0,0.0,1.0,0.0,Matches,522.0,rs SRB,GK,22.0,3.0,0.0,0.0,0.0,0.0,0.0,0.0,0.0,0.0,0.0,0.0,0.0,0.0,0.0,0.0,0.0,0.0,Matches,41.0,rs SRB,GK,22.0,3.0,3.0,0.0,0.0,0.0,0.0,2.9,0.29,-0.1,-0.03,16.0,44.0,36.4,61.0,13.0,50.8,41.4,16.0,81.3,60.1,42.0,6.0,14.3,4.0,1.33,12.1,Matches,41.0,rs SRB,GK,22.0,3.0,3.0,270.0,3.0,3.0,1.0,10.0,7.0,70.0,1.0,1.0,1.0,1.0,33.3,0.0,0.0,0.0,0.0,,Matches,522.0,rs SRB,GK,22.0,3.0,1.0,0.0,0.0,0.0,0.0,0.0,0.0,0.0,0.0,0.0,0.0,0.0,6.0,0.0,0.0,,Matches,522.0,rs SRB,GK,22.0,3.0,77.0,56.0,21.0,5.0,0.0,0.0,0.0,0.0,0.0,0.0,0.0,0.0,49.0,0.0,0.0,Matches,522.0,rs SRB,GK,22.0,3.0,49.0,77.0,63.6,1589.0,1235.0,4.0,4.0,100.0,25.0,25.0,100.0,19.0,47.0,40.4,0.0,0.0,0.0,0.0,0.0,3.0,0.0,0.0,0.0,Matches,668,rs SRB,GK,22,3,270.0,90.0,7.9,3.0,3,90.0,3,0,,35,1.33,3.0,3.0,0.0,0.0,-0.34,4.6,3.7,0.9,0.32,-0.38,Matches,522.0,rs SRB,GK,22.0,3.0,79.0,70.0,79.0,0.0,0.0,0.0,79.0,0.0,0.0,,0.0,,46.0,373.0,243.0,0.0,0.0,0.0,0.0,0.0,26.0,0.0,Matches,522.0,rs SRB,GK,22.0,3.0,0.0,0.0,0.0,,0.0,0.0,,,,0.0,0.0,0.0,0.0,0.0,,0.0,0.0,Matches,522.0,rs SRB,GK,22.0,3.0,3.0,270.0,3.0,0.0,0.0,0.0,0.0,0.0,0.0,1.0,0.0,0.0,0.0,0.0,0.0,0.0,0.0,0.0,0.0,0.0,0.0,0.0,0.0,0.0,0.0,0.0,0.0,0.0,Matches,Mile Svilar,GK,22,122,146,"Serbia,Belgium",Associazione Sportiva Roma,1,3,2,1,12,1,9,2,2,2,12,1,3,12,14,11,15,13,10,9,12,15,8,5,5,10,10,8,14,13,11,15,12,13,11,13,12,5,11,5,1,13,11,8,12,14,14,13,16,16,6,11,13,18,12,7,7,11,8,17,20,1,1,1,1,1,1,1,1,1,1,1,1,1,189,83,5,20,5379999,6091,5991,3941,Northern_European,121,3,1999/8/27,1,0,24615.0,,18087914
726,Filippo Terracciano,Hellas Verona,2003,527.0,it ITA,DFMF,19.0,9.1,20.0,13.0,11.0,7.0,2.0,15.0,20.0,75.0,5.0,7.0,4.0,3.0,10.0,30.0,14.0,0.0,Matches,527.0,it ITA,DFMF,19.0,9.1,14.0,1.53,9.0,2.0,2.0,1.0,0.0,0.0,2.0,0.22,2.0,0.0,0.0,0.0,0.0,0.0,Matches,,,,,,,,,,,,,,,,,,,,,,,,,,,,,,,,,,,,,,,,,,,,,,,,,,,,,,,,527.0,it ITA,DFMF,19.0,9.1,2.0,0.0,0.0,7.0,17.0,0.0,25.0,10.0,13.0,0.0,0.0,0.0,47.0,15.0,20.0,42.9,Matches,527.0,it ITA,DFMF,19.0,9.1,343.0,290.0,51.0,7.0,1.0,4.0,25.0,42.0,2.0,1.0,1.0,0.0,235.0,2.0,12.0,Matches,527.0,it ITA,DFMF,19.0,9.1,235.0,343.0,68.5,4308.0,1770.0,88.0,113.0,77.9,115.0,148.0,77.7,21.0,53.0,39.6,1.0,1.2,1.5,-0.2,8.0,21.0,10.0,4.0,37.0,Matches,674,it ITA,DFMF,19,20,821.0,41.0,24.0,9.1,7,75.0,1,13,23.0,17,1.24,5.0,9.0,-4.0,-0.44,0.39,8.8,10.0,-1.1,-0.12,0.33,Matches,527.0,it ITA,DFMF,19.0,9.1,439.0,21.0,110.0,224.0,113.0,9.0,439.0,12.0,6.0,50.0,3.0,25.0,217.0,1267.0,618.0,16.0,13.0,0.0,17.0,4.0,242.0,24.0,Matches,527.0,it ITA,DFMF,19.0,9.1,0.0,5.0,3.0,60.0,0.55,0.33,0.0,0.0,23.3,0.0,0.0,0.0,0.2,0.2,0.04,-0.2,-0.2,Matches,527.0,it ITA,DFMF,19.0,20.0,7.0,821.0,9.1,0.0,1.0,1.0,0.0,0.0,0.0,2.0,0.0,0.2,0.2,1.2,1.4,16.0,37.0,24.0,0.0,0.11,0.11,0.0,0.11,0.02,0.14,0.16,0.02,0.16,Matches,Filippo Terracciano,D/WB/M R,19,122,-8,Italy,Hellas Verona,5,12,12,8,9,5,10,8,11,12,12,5,12,12,13,11,13,10,11,10,12,13,7,7,13,12,12,13,14,13,13,13,12,14,15,12,12,8,10,7,12,3,4,3,3,2,1,3,3,2,3,1,12,13,12,13,13,15,12,12,1,1,1,20,1,20,1,1,14,18,1,1,1,1,184,0,9,20,19500802,6100,6100,1000,Mediterranean_Hispanic,115,1,2003/2/8,0,0,13815.0,,43500821
727,Florian Thauvin,Udinese,1993,530.0,fr FRA,FWMF,29.0,6.1,2.0,1.0,0.0,2.0,0.0,2.0,13.0,15.4,11.0,5.0,0.0,5.0,2.0,4.0,2.0,0.0,Matches,530.0,fr FRA,FWMF,29.0,6.1,24.0,3.94,13.0,6.0,2.0,1.0,2.0,0.0,1.0,0.16,1.0,0.0,0.0,0.0,0.0,0.0,Matches,,,,,,,,,,,,,,,,,,,,,,,,,,,,,,,,,,,,,,,,,,,,,,,,,,,,,,,,530.0,fr FRA,FWMF,29.0,6.1,1.0,0.0,0.0,9.0,7.0,1.0,37.0,2.0,1.0,0.0,0.0,0.0,18.0,7.0,7.0,50.0,Matches,530.0,fr FRA,FWMF,29.0,6.1,216.0,182.0,33.0,6.0,3.0,1.0,37.0,2.0,18.0,7.0,4.0,0.0,144.0,1.0,6.0,Matches,530.0,fr FRA,FWMF,29.0,6.1,144.0,216.0,66.7,2489.0,708.0,71.0,88.0,80.7,51.0,71.0,71.8,17.0,42.0,40.5,0.0,1.1,1.3,-1.1,10.0,9.0,10.0,2.0,24.0,Matches,677,fr FRA,FWMF,29,16,546.0,34.0,16.0,6.1,5,69.0,0,11,18.0,2,0.88,6.0,9.0,-3.0,-0.49,-0.56,7.5,6.5,1.0,0.16,0.34,Matches,530.0,fr FRA,FWMF,29.0,6.1,292.0,4.0,15.0,138.0,144.0,19.0,292.0,33.0,10.0,30.3,21.0,63.6,187.0,1209.0,518.0,19.0,19.0,5.0,19.0,8.0,216.0,49.0,Matches,530.0,fr FRA,FWMF,29.0,6.1,0.0,10.0,3.0,30.0,1.65,0.49,0.0,0.0,22.3,0.0,0.0,0.0,0.7,0.7,0.07,-0.7,-0.7,Matches,530.0,fr FRA,FWMF,29.0,16.0,5.0,546.0,6.1,0.0,0.0,0.0,0.0,0.0,0.0,1.0,0.0,0.7,0.7,1.1,1.7,19.0,24.0,49.0,0.0,0.0,0.0,0.0,0.0,0.11,0.17,0.29,0.11,0.29,Matches,Florian Thauvin,AM RLC,29,144,154,"France,Spain",Tigres de la UANL,9,14,16,13,16,13,9,14,4,3,15,13,3,15,11,14,13,14,11,15,12,14,16,9,15,6,14,13,15,15,13,8,14,15,14,9,14,7,12,6,13,3,3,3,2,3,3,1,2,3,2,3,10,15,8,14,11,15,14,12,1,1,1,1,1,1,1,13,10,14,16,15,20,10,179,70,20,10,11540039,7192,6894,6265,Mediterranean_Hispanic,144,6,1993/1/26,10,1,97053.0,,85046587
728,William Troost-Ekong,Salernitana,1993,538.0,ng NGA,DF,28.0,4.9,11.0,3.0,7.0,4.0,0.0,6.0,7.0,85.7,1.0,7.0,4.0,3.0,6.0,17.0,10.0,0.0,Matches,538.0,ng NGA,DF,28.0,4.9,1.0,0.2,1.0,0.0,0.0,0.0,0.0,0.0,1.0,0.2,1.0,0.0,0.0,0.0,0.0,0.0,Matches,,,,,,,,,,,,,,,,,,,,,,,,,,,,,,,,,,,,,,,,,,,,,,,,,,,,,,,,538.0,ng NGA,DF,28.0,4.9,1.0,0.0,0.0,7.0,1.0,0.0,1.0,6.0,3.0,0.0,0.0,0.0,13.0,18.0,9.0,66.7,Matches,538.0,ng NGA,DF,28.0,4.9,179.0,176.0,3.0,3.0,0.0,0.0,1.0,0.0,0.0,0.0,0.0,0.0,148.0,0.0,1.0,Matches,538.0,ng NGA,DF,28.0,4.9,148.0,179.0,82.7,3117.0,1047.0,31.0,36.0,86.1,102.0,112.0,91.1,13.0,24.0,54.2,0.0,0.0,0.0,0.0,0.0,1.0,1.0,1.0,6.0,Matches,688,ng NGA,DF,28,9,444.0,49.0,13.0,4.9,4,88.0,3,5,18.0,6,1.33,6.0,8.0,-2.0,-0.41,-0.04,4.2,8.7,-4.5,-0.91,-0.13,Matches,538.0,ng NGA,DF,28.0,4.9,226.0,27.0,128.0,94.0,5.0,3.0,226.0,0.0,0.0,,0.0,,127.0,606.0,200.0,1.0,1.0,0.0,2.0,0.0,130.0,0.0,Matches,538.0,ng NGA,DF,28.0,4.9,1.0,2.0,1.0,50.0,0.41,0.2,0.5,1.0,9.0,0.0,0.0,0.0,0.7,0.7,0.35,0.3,0.3,Matches,538.0,ng NGA,DF,28.0,9.0,4.0,444.0,4.9,1.0,0.0,1.0,1.0,0.0,0.0,1.0,0.0,0.7,0.7,0.0,0.7,1.0,6.0,0.0,0.2,0.0,0.2,0.2,0.2,0.14,0.0,0.14,0.14,0.14,Matches,William Troost-Ekong,D C,28,125,137,"Nigeria,Holland,England",Watford,3,3,5,5,10,7,14,7,6,14,8,6,14,12,14,14,14,12,12,7,12,14,6,15,8,14,14,13,13,12,13,14,11,13,14,15,14,12,12,8,10,2,2,2,2,1,2,3,1,3,3,3,20,15,6,12,11,16,17,15,1,1,20,1,1,1,10,1,1,1,1,1,1,1,191,90,8,20,4269259,6250,6750,5250,African_Caribbean,125,12,1993/9/1,62,4,14673.0,,28060183
729,Alessandro Tuia,Lecce,1990,540.0,it ITA,DF,32.0,5.7,10.0,6.0,6.0,4.0,0.0,3.0,9.0,33.3,6.0,3.0,1.0,2.0,15.0,25.0,29.0,0.0,Matches,540.0,it ITA,DF,32.0,5.7,5.0,0.88,4.0,0.0,0.0,1.0,0.0,0.0,0.0,0.0,0.0,0.0,0.0,0.0,0.0,0.0,Matches,,,,,,,,,,,,,,,,,,,,,,,,,,,,,,,,,,,,,,,,,,,,,,,,,,,,,,,,540.0,it ITA,DF,32.0,5.7,1.0,0.0,0.0,9.0,2.0,0.0,1.0,15.0,6.0,0.0,0.0,0.0,34.0,10.0,14.0,41.7,Matches,540.0,it ITA,DF,32.0,5.7,204.0,193.0,11.0,10.0,0.0,6.0,1.0,0.0,0.0,0.0,0.0,0.0,142.0,0.0,0.0,Matches,540.0,it ITA,DF,32.0,5.7,142.0,204.0,69.6,3226.0,1193.0,31.0,42.0,73.8,82.0,100.0,82.0,26.0,58.0,44.8,0.0,0.0,0.1,0.0,1.0,15.0,1.0,1.0,20.0,Matches,690,it ITA,DF,32,7,509.0,73.0,14.9,5.7,6,82.0,4,1,18.0,29,0.57,2.0,6.0,-4.0,-0.71,-0.43,3.1,7.0,-3.9,-0.69,-0.62,Matches,540.0,it ITA,DF,32.0,5.7,267.0,26.0,136.0,127.0,7.0,2.0,267.0,4.0,2.0,50.0,1.0,25.0,106.0,510.0,264.0,1.0,1.0,0.0,1.0,0.0,123.0,0.0,Matches,540.0,it ITA,DF,32.0,5.7,0.0,2.0,1.0,50.0,0.35,0.18,0.0,0.0,11.6,0.0,0.0,0.0,0.1,0.1,0.05,-0.1,-0.1,Matches,540.0,it ITA,DF,32.0,7.0,6.0,509.0,5.7,0.0,0.0,0.0,0.0,0.0,0.0,1.0,0.0,0.1,0.1,0.0,0.1,1.0,20.0,0.0,0.0,0.0,0.0,0.0,0.0,0.02,0.01,0.02,0.02,0.02,Matches,Alessandro Tuia,D RC,32,124,130,Italy,Salento,6,9,11,6,12,9,15,12,10,15,14,7,14,10,12,15,12,9,12,12,12,13,7,12,10,14,13,12,11,11,13,15,10,11,12,13,12,12,10,13,10,1,1,1,1,1,1,1,1,1,1,1,12,13,10,15,12,13,13,13,1,7,20,17,1,1,1,1,1,1,1,1,1,1,184,78,5,20,1000178,6200,6200,3950,Mediterranean_Hispanic,124,7,1990/6/8,0,0,3654.0,,1414422
730,Martin Turk,Sampdoria,2003,541.0,si SVN,GK,18.0,4.0,0.0,0.0,0.0,0.0,0.0,0.0,0.0,,0.0,0.0,0.0,0.0,0.0,0.0,1.0,0.0,Matches,541.0,si SVN,GK,18.0,4.0,0.0,0.0,0.0,0.0,0.0,0.0,0.0,0.0,0.0,0.0,0.0,0.0,0.0,0.0,0.0,0.0,Matches,45.0,si SVN,GK,18.0,4.0,9.0,1.0,0.0,3.0,0.0,8.0,0.26,-1.0,-0.25,35.0,78.0,44.9,99.0,15.0,41.4,35.1,43.0,86.0,56.3,60.0,0.0,0.0,2.0,0.5,12.3,Matches,45.0,si SVN,GK,18.0,4.0,4.0,360.0,4.0,9.0,2.25,30.0,21.0,73.3,1.0,1.0,2.0,0.0,0.0,2.0,1.0,0.0,1.0,0.0,Matches,541.0,si SVN,GK,18.0,4.0,0.0,0.0,0.0,0.0,0.0,0.0,0.0,0.0,0.0,0.0,0.0,0.0,6.0,1.0,0.0,100.0,Matches,541.0,si SVN,GK,18.0,4.0,142.0,89.0,53.0,10.0,0.0,0.0,0.0,0.0,0.0,0.0,0.0,0.0,89.0,0.0,0.0,Matches,541.0,si SVN,GK,18.0,4.0,89.0,142.0,62.7,3103.0,2663.0,10.0,10.0,100.0,33.0,35.0,94.3,44.0,95.0,46.3,0.0,0.0,0.0,0.0,0.0,1.0,0.0,0.0,0.0,Matches,691,si SVN,GK,18,4,360.0,90.0,10.5,4.0,4,90.0,4,0,,16,1.0,7.0,9.0,-2.0,-0.5,0.82,4.8,9.0,-4.2,-1.06,-0.24,Matches,541.0,si SVN,GK,18.0,4.0,156.0,142.0,156.0,0.0,0.0,0.0,156.0,0.0,0.0,,0.0,,82.0,433.0,271.0,0.0,0.0,0.0,0.0,0.0,59.0,0.0,Matches,541.0,si SVN,GK,18.0,4.0,0.0,0.0,0.0,,0.0,0.0,,,,0.0,0.0,0.0,0.0,0.0,,0.0,0.0,Matches,541.0,si SVN,GK,18.0,4.0,4.0,360.0,4.0,0.0,0.0,0.0,0.0,0.0,0.0,0.0,0.0,0.0,0.0,0.0,0.0,0.0,0.0,0.0,0.0,0.0,0.0,0.0,0.0,0.0,0.0,0.0,0.0,0.0,Matches,Martin Turk,GK,18,102,136,Slovenia,Parma Calcio 1913,2,2,2,2,9,4,2,2,3,2,13,3,3,9,11,11,11,8,13,10,13,12,3,11,1,12,11,10,9,12,11,17,14,10,5,14,20,8,3,13,11,10,11,8,11,12,9,11,12,11,11,7,20,10,4,11,14,9,7,11,20,1,1,1,1,1,1,1,1,1,1,1,1,1,190,72,20,9,1084875,5250,4850,1000,Northern_European,98,3,2003/8/21,0,0,3039.0,Reggiana,43609933
731,Diego Valencia,Salernitana,2000,545.0,cl CHI,MFFW,22.0,2.6,8.0,5.0,4.0,2.0,2.0,2.0,9.0,22.2,7.0,10.0,1.0,9.0,1.0,9.0,2.0,0.0,Matches,545.0,cl CHI,MFFW,22.0,2.6,1.0,0.39,1.0,0.0,0.0,0.0,0.0,0.0,0.0,0.0,0.0,0.0,0.0,0.0,0.0,0.0,Matches,,,,,,,,,,,,,,,,,,,,,,,,,,,,,,,,,,,,,,,,,,,,,,,,,,,,,,,,545.0,cl CHI,MFFW,22.0,2.6,1.0,0.0,0.0,8.0,6.0,0.0,5.0,1.0,5.0,0.0,0.0,0.0,10.0,2.0,4.0,33.3,Matches,545.0,cl CHI,MFFW,22.0,2.6,75.0,69.0,6.0,0.0,0.0,0.0,5.0,6.0,0.0,0.0,0.0,0.0,52.0,0.0,3.0,Matches,545.0,cl CHI,MFFW,22.0,2.6,52.0,75.0,69.3,753.0,195.0,37.0,44.0,84.1,8.0,14.0,57.1,5.0,7.0,71.4,0.0,0.1,0.0,-0.1,2.0,1.0,2.0,1.0,4.0,Matches,696,cl CHI,MFFW,22,12,231.0,19.0,6.8,2.6,0,,0,12,19.0,17,0.5,1.0,4.0,-3.0,-1.17,-0.86,2.1,6.0,-3.9,-1.5,-0.75,Matches,545.0,cl CHI,MFFW,22.0,2.6,109.0,4.0,24.0,46.0,41.0,4.0,109.0,2.0,0.0,0.0,1.0,50.0,59.0,211.0,82.0,1.0,0.0,0.0,7.0,3.0,66.0,21.0,Matches,545.0,cl CHI,MFFW,22.0,2.6,0.0,1.0,1.0,100.0,0.39,0.39,0.0,0.0,10.0,0.0,0.0,0.0,0.1,0.1,0.12,-0.1,-0.1,Matches,545.0,cl CHI,MFFW,22.0,12.0,0.0,231.0,2.6,0.0,0.0,0.0,0.0,0.0,0.0,1.0,0.0,0.1,0.1,0.1,0.2,1.0,4.0,21.0,0.0,0.0,0.0,0.0,0.0,0.05,0.05,0.09,0.05,0.09,Matches,Diego Valencia,AM/S RL,22,118,138,Chile,U.S. Salernitana 1919,5,12,11,13,12,6,12,9,4,4,12,11,6,12,10,14,11,9,12,10,11,13,8,7,14,6,13,14,13,14,12,13,15,13,14,11,13,6,16,5,7,3,3,1,2,1,4,1,3,3,3,2,10,13,3,12,10,11,10,14,1,1,1,1,1,1,1,10,1,10,15,1,16,20,181,68,13,20,2502182,5900,5650,3500,Mediterranean_Hispanic,118,2,2000/1/14,7,0,9503.0,,75044451
732,Mattia Valoti,Monza,1993,547.0,it ITA,MFFW,28.0,5.0,17.0,10.0,7.0,9.0,1.0,5.0,16.0,31.3,11.0,13.0,3.0,10.0,3.0,20.0,6.0,0.0,Matches,547.0,it ITA,MFFW,28.0,5.0,7.0,1.39,4.0,0.0,0.0,0.0,1.0,2.0,0.0,0.0,0.0,0.0,0.0,0.0,0.0,0.0,Matches,,,,,,,,,,,,,,,,,,,,,,,,,,,,,,,,,,,,,,,,,,,,,,,,,,,,,,,,547.0,it ITA,MFFW,28.0,5.0,1.0,0.0,0.0,16.0,12.0,2.0,2.0,3.0,10.0,0.0,0.0,0.0,23.0,17.0,21.0,44.7,Matches,547.0,it ITA,MFFW,28.0,5.0,166.0,164.0,1.0,1.0,0.0,3.0,2.0,0.0,0.0,0.0,0.0,0.0,122.0,1.0,4.0,Matches,547.0,it ITA,MFFW,28.0,5.0,122.0,166.0,73.5,2009.0,466.0,55.0,68.0,80.9,47.0,64.0,73.4,13.0,20.0,65.0,0.0,0.1,0.1,-0.1,3.0,17.0,2.0,1.0,16.0,Matches,698,it ITA,MFFW,28,16,453.0,28.0,13.2,5.0,4,70.0,0,12,15.0,21,1.19,5.0,7.0,-2.0,-0.4,-0.34,5.4,7.9,-2.6,-0.51,-0.43,Matches,547.0,it ITA,MFFW,28.0,5.0,231.0,9.0,53.0,133.0,48.0,5.0,231.0,10.0,3.0,30.0,4.0,40.0,114.0,673.0,281.0,7.0,4.0,0.0,10.0,5.0,152.0,9.0,Matches,547.0,it ITA,MFFW,28.0,5.0,0.0,2.0,1.0,50.0,0.4,0.2,0.0,0.0,9.0,0.0,0.0,0.0,0.2,0.2,0.08,-0.2,-0.2,Matches,547.0,it ITA,MFFW,28.0,16.0,4.0,453.0,5.0,0.0,0.0,0.0,0.0,0.0,0.0,1.0,0.0,0.2,0.2,0.1,0.2,7.0,16.0,9.0,0.0,0.0,0.0,0.0,0.0,0.03,0.01,0.05,0.03,0.05,Matches,Mattia Valoti,M/AM C,28,120,130,Italy,Brianza,12,12,12,12,12,12,11,12,3,6,12,12,9,12,12,13,12,12,13,13,12,13,13,11,14,10,15,14,14,12,12,12,15,13,13,13,11,11,12,12,15,1,2,3,2,3,1,2,2,1,3,2,7,13,7,11,6,15,14,11,1,1,1,1,1,1,12,12,20,12,14,16,10,1,187,73,9,20,243108,6000,6000,4250,Northern_European,118,2,1993/9/6,0,0,12499.0,,43050913
733,Valerio Verre,Sampdoria,1994,554.0,it ITA,MF,28.0,7.5,14.0,7.0,6.0,5.0,3.0,8.0,17.0,47.1,9.0,9.0,1.0,8.0,9.0,23.0,3.0,0.0,Matches,554.0,it ITA,MF,28.0,7.5,30.0,3.98,22.0,2.0,0.0,2.0,2.0,2.0,0.0,0.0,0.0,0.0,0.0,0.0,0.0,0.0,Matches,,,,,,,,,,,,,,,,,,,,,,,,,,,,,,,,,,,,,,,,,,,,,,,,,,,,,,,,554.0,it ITA,MF,28.0,7.5,5.0,0.0,0.0,14.0,13.0,2.0,33.0,9.0,7.0,0.0,0.0,0.0,61.0,12.0,12.0,50.0,Matches,554.0,it ITA,MF,28.0,7.5,398.0,361.0,33.0,16.0,3.0,2.0,33.0,4.0,9.0,2.0,6.0,0.0,282.0,4.0,15.0,Matches,554.0,it ITA,MF,28.0,7.5,282.0,398.0,70.9,5116.0,1682.0,136.0,161.0,84.5,99.0,135.0,73.3,41.0,74.0,55.4,0.0,1.1,0.9,-1.1,13.0,30.0,14.0,4.0,45.0,Matches,707,it ITA,MF,28,18,677.0,38.0,19.8,7.5,6,61.0,0,12,26.0,0,0.5,3.0,12.0,-9.0,-1.2,0.05,6.7,13.1,-6.3,-0.84,0.01,Matches,554.0,it ITA,MF,28.0,7.5,493.0,8.0,64.0,285.0,153.0,16.0,493.0,20.0,10.0,50.0,9.0,45.0,284.0,1351.0,575.0,16.0,13.0,6.0,22.0,20.0,330.0,27.0,Matches,554.0,it ITA,MF,28.0,7.5,0.0,14.0,3.0,21.4,1.86,0.4,0.0,0.0,25.3,0.0,0.0,0.0,0.6,0.6,0.04,-0.6,-0.6,Matches,554.0,it ITA,MF,28.0,18.0,6.0,677.0,7.5,0.0,0.0,0.0,0.0,0.0,0.0,5.0,0.0,0.6,0.6,1.1,1.7,16.0,45.0,27.0,0.0,0.0,0.0,0.0,0.0,0.08,0.14,0.22,0.08,0.22,Matches,Valerio Verre,M/AM C,28,122,135,Italy,U.C. Sampdoria,15,10,12,8,13,12,6,12,2,8,13,9,9,13,10,13,10,11,13,13,12,12,15,10,16,9,10,12,13,13,12,10,15,12,13,10,10,9,12,4,12,1,1,3,1,1,2,1,2,3,3,3,15,12,4,13,9,13,15,16,1,1,1,1,1,1,10,1,19,1,1,20,1,10,181,70,15,20,1889923,6100,6100,5850,Mediterranean_Hispanic,122,3,1994/1/11,0,0,24903.0,,43067334
734,Ronaldo Vieira,Torino,1998,556.0,eng ENG,MF,24.0,0.2,1.0,0.0,0.0,1.0,0.0,1.0,1.0,100.0,0.0,0.0,0.0,0.0,0.0,1.0,2.0,0.0,Matches,556.0,eng ENG,MF,24.0,0.2,0.0,0.0,0.0,0.0,0.0,0.0,0.0,0.0,0.0,0.0,0.0,0.0,0.0,0.0,0.0,0.0,Matches,,,,,,,,,,,,,,,,,,,,,,,,,,,,,,,,,,,,,,,,,,,,,,,,,,,,,,,,556.0,eng ENG,MF,24.0,0.2,0.0,0.0,0.0,1.0,0.0,0.0,1.0,0.0,0.0,0.0,0.0,0.0,2.0,0.0,1.0,0.0,Matches,556.0,eng ENG,MF,24.0,0.2,7.0,7.0,0.0,0.0,0.0,0.0,1.0,0.0,0.0,0.0,0.0,0.0,6.0,0.0,0.0,Matches,556.0,eng ENG,MF,24.0,0.2,6.0,7.0,85.7,93.0,34.0,2.0,2.0,100.0,2.0,3.0,66.7,1.0,1.0,100.0,0.0,0.0,0.1,0.0,0.0,0.0,1.0,1.0,1.0,Matches,710,eng ENG,MF,24,2,16.0,8.0,0.5,0.2,0,,0,2,8.0,6,3.0,0.0,0.0,0.0,0.0,-0.03,0.2,0.1,0.1,0.49,0.44,Matches,556.0,eng ENG,MF,24.0,0.2,13.0,3.0,3.0,5.0,5.0,1.0,13.0,0.0,0.0,,0.0,,2.0,5.0,0.0,0.0,0.0,0.0,2.0,1.0,5.0,0.0,Matches,556.0,eng ENG,MF,24.0,0.2,0.0,0.0,0.0,,0.0,0.0,,,,0.0,0.0,0.0,0.0,0.0,,0.0,0.0,Matches,556.0,eng ENG,MF,24.0,2.0,0.0,16.0,0.2,0.0,0.0,0.0,0.0,0.0,0.0,0.0,0.0,0.0,0.0,0.0,0.0,0.0,1.0,0.0,0.0,0.0,0.0,0.0,0.0,0.0,0.0,0.0,0.0,0.0,Matches,Ronaldo Vieira,DM/M C,24,125,144,"England,Portugal,Guinea-Bissau",U.C. Sampdoria,7,10,12,7,12,9,7,11,7,12,13,9,13,13,12,15,12,13,13,12,13,13,10,9,11,13,13,13,13,13,13,9,13,12,13,12,12,9,10,10,11,1,3,3,3,1,2,3,1,3,1,2,14,14,2,11,12,14,11,12,1,1,1,1,1,1,20,1,20,1,1,1,1,1,178,70,12,20,1921528,6242,6442,5242,African_Caribbean,125,18,1998/7/19,0,0,17885.0,,29161106
735,Emanuel Vignato,Bologna,2000,558.0,it ITA,MFFW,21.0,2.7,4.0,4.0,2.0,2.0,0.0,2.0,4.0,50.0,2.0,2.0,0.0,2.0,3.0,7.0,0.0,0.0,Matches,558.0,it ITA,MFFW,21.0,2.7,5.0,1.86,5.0,0.0,0.0,0.0,0.0,0.0,1.0,0.37,1.0,0.0,0.0,0.0,0.0,0.0,Matches,,,,,,,,,,,,,,,,,,,,,,,,,,,,,,,,,,,,,,,,,,,,,,,,,,,,,,,,558.0,it ITA,MFFW,21.0,2.7,1.0,0.0,0.0,3.0,1.0,0.0,2.0,3.0,4.0,0.0,0.0,0.0,10.0,2.0,2.0,50.0,Matches,558.0,it ITA,MFFW,21.0,2.7,99.0,97.0,2.0,0.0,0.0,2.0,2.0,1.0,1.0,1.0,0.0,0.0,79.0,0.0,2.0,Matches,558.0,it ITA,MFFW,21.0,2.7,79.0,99.0,79.8,1201.0,338.0,40.0,48.0,83.3,29.0,34.0,85.3,5.0,8.0,62.5,1.0,0.4,0.6,0.6,3.0,9.0,2.0,1.0,9.0,Matches,712,it ITA,MFFW,21,8,242.0,30.0,7.1,2.7,2,53.0,0,6,23.0,7,0.63,2.0,4.0,-2.0,-0.74,-0.91,3.6,4.0,-0.3,-0.12,0.01,Matches,558.0,it ITA,MFFW,21.0,2.7,116.0,0.0,23.0,57.0,37.0,2.0,116.0,2.0,1.0,50.0,0.0,0.0,76.0,374.0,119.0,3.0,3.0,0.0,2.0,4.0,89.0,4.0,Matches,558.0,it ITA,MFFW,21.0,2.7,0.0,1.0,1.0,100.0,0.37,0.37,0.0,0.0,14.0,0.0,0.0,0.0,0.1,0.1,0.09,-0.1,-0.1,Matches,558.0,it ITA,MFFW,21.0,8.0,2.0,242.0,2.7,0.0,1.0,1.0,0.0,0.0,0.0,1.0,0.0,0.1,0.1,0.4,0.5,3.0,9.0,4.0,0.0,0.37,0.37,0.0,0.37,0.03,0.14,0.17,0.03,0.17,Matches,Emanuel Vignato,AM RLC,21,123,146,"Italy,Brazil",Bologna FC 1909,12,14,14,11,15,9,6,12,3,4,14,10,7,15,9,13,10,12,11,14,13,10,16,7,14,6,13,13,14,13,11,7,12,12,11,9,11,5,13,3,13,3,2,1,1,2,1,2,3,4,2,1,14,12,5,13,13,15,15,14,1,1,1,1,1,1,5,11,13,11,17,20,18,12,175,68,11,20,6063999,6150,6150,4300,Mediterranean_Hispanic,121,8,2000/8/24,0,0,10769.0,,43296186
736,Samuele Vignato,Monza,2004,560.0,it ITA,MFFW,18.0,0.7,0.0,0.0,0.0,0.0,0.0,0.0,0.0,,0.0,1.0,0.0,1.0,0.0,0.0,0.0,0.0,Matches,560.0,it ITA,MFFW,18.0,0.7,1.0,1.5,1.0,0.0,0.0,0.0,0.0,0.0,1.0,1.5,1.0,0.0,0.0,0.0,0.0,0.0,Matches,,,,,,,,,,,,,,,,,,,,,,,,,,,,,,,,,,,,,,,,,,,,,,,,,,,,,,,,560.0,it ITA,MFFW,18.0,0.7,0.0,0.0,0.0,0.0,0.0,0.0,2.0,0.0,0.0,0.0,0.0,0.0,1.0,1.0,2.0,33.3,Matches,560.0,it ITA,MFFW,18.0,0.7,36.0,35.0,0.0,0.0,0.0,0.0,2.0,0.0,0.0,0.0,0.0,0.0,30.0,1.0,0.0,Matches,560.0,it ITA,MFFW,18.0,0.7,30.0,36.0,83.3,452.0,45.0,13.0,13.0,100.0,13.0,15.0,86.7,2.0,2.0,100.0,1.0,0.3,0.1,0.7,2.0,0.0,1.0,1.0,1.0,Matches,714,it ITA,MFFW,18,5,62.0,12.0,1.8,0.7,0,,0,5,12.0,27,2.0,1.0,1.0,0.0,0.0,0.11,2.7,1.1,1.6,2.42,2.6,Matches,560.0,it ITA,MFFW,18.0,0.7,45.0,0.0,2.0,19.0,24.0,8.0,45.0,4.0,3.0,75.0,1.0,25.0,31.0,266.0,107.0,4.0,1.0,3.0,2.0,0.0,39.0,6.0,Matches,560.0,it ITA,MFFW,18.0,0.7,0.0,1.0,0.0,0.0,1.45,0.0,0.0,,21.9,0.0,0.0,0.0,0.1,0.1,0.07,-0.1,-0.1,Matches,560.0,it ITA,MFFW,18.0,5.0,0.0,62.0,0.7,0.0,1.0,1.0,0.0,0.0,0.0,0.0,0.0,0.1,0.1,0.3,0.4,4.0,1.0,6.0,0.0,1.45,1.45,0.0,1.45,0.11,0.49,0.6,0.11,0.6,Matches,Samuele Vignato,AM RC,18,108,-85,"Italy,Brazil",Brianza,11,10,11,13,12,7,7,10,7,4,11,11,10,13,7,8,11,12,12,12,10,12,11,9,12,8,12,10,14,13,12,7,12,12,12,10,11,8,12,7,12,1,2,2,1,1,1,2,1,2,3,2,12,12,8,11,12,12,12,12,1,1,1,1,1,1,1,1,1,1,10,20,17,15,168,63,11,20,13385601,5398,5598,2998,Mixed_Race,106,8,2004/2/24,0,0,768.0,,2000021407
737,Cristian Volpato,Roma,2003,568.0,it ITA,MF,18.0,2.5,3.0,2.0,1.0,1.0,1.0,0.0,2.0,0.0,2.0,2.0,0.0,2.0,2.0,5.0,0.0,0.0,Matches,568.0,it ITA,MF,18.0,2.5,6.0,2.38,5.0,1.0,0.0,0.0,0.0,0.0,1.0,0.4,1.0,0.0,0.0,0.0,0.0,0.0,Matches,,,,,,,,,,,,,,,,,,,,,,,,,,,,,,,,,,,,,,,,,,,,,,,,,,,,,,,,568.0,it ITA,MF,18.0,2.5,0.0,0.0,0.0,7.0,6.0,0.0,9.0,2.0,2.0,0.0,0.0,0.0,18.0,1.0,1.0,50.0,Matches,568.0,it ITA,MF,18.0,2.5,105.0,100.0,5.0,1.0,1.0,1.0,9.0,1.0,2.0,1.0,1.0,0.0,83.0,0.0,3.0,Matches,568.0,it ITA,MF,18.0,2.5,83.0,105.0,79.0,1507.0,407.0,38.0,43.0,88.4,27.0,33.0,81.8,15.0,22.0,68.2,1.0,1.2,0.3,-0.2,4.0,9.0,5.0,2.0,18.0,Matches,723,it ITA,MF,18,7,227.0,32.0,6.6,2.5,2,59.0,0,5,22.0,27,0.86,3.0,0.0,3.0,1.19,0.94,3.0,1.8,1.2,0.48,-0.19,Matches,568.0,it ITA,MF,18.0,2.5,138.0,2.0,13.0,64.0,63.0,11.0,138.0,9.0,4.0,44.4,5.0,55.6,100.0,723.0,319.0,8.0,8.0,3.0,12.0,6.0,112.0,24.0,Matches,568.0,it ITA,MF,18.0,2.5,1.0,4.0,1.0,25.0,1.59,0.4,0.25,1.0,15.7,0.0,0.0,0.0,0.4,0.4,0.09,0.6,0.6,Matches,568.0,it ITA,MF,18.0,7.0,2.0,227.0,2.5,1.0,1.0,2.0,1.0,0.0,0.0,0.0,0.0,0.4,0.4,1.2,1.5,8.0,18.0,24.0,0.4,0.4,0.79,0.4,0.79,0.14,0.47,0.61,0.14,0.61,Matches,Cristian Volpato,AM RC,18,109,-8,"Italy,Australia",Associazione Sportiva Roma,10,11,15,12,15,10,7,11,2,3,13,11,4,16,7,12,9,12,10,14,11,11,17,4,12,4,12,8,12,13,13,10,12,13,11,11,11,4,11,5,10,4,4,3,3,3,2,2,3,3,1,1,15,12,8,9,13,13,11,12,1,1,1,1,1,1,1,1,12,10,1,20,15,1,183,78,20,9,16409999,4946,4946,1246,Mediterranean_Hispanic,109,4,2003/11/15,0,0,1341.0,,2000034865
738,Sebastian Walukiewicz,Empoli,2000,573.0,pl POL,DF,22.0,6.7,9.0,6.0,7.0,2.0,0.0,4.0,6.0,66.7,2.0,10.0,9.0,1.0,7.0,16.0,30.0,0.0,Matches,573.0,pl POL,DF,22.0,6.7,4.0,0.6,4.0,0.0,0.0,0.0,0.0,0.0,0.0,0.0,0.0,0.0,0.0,0.0,0.0,0.0,Matches,,,,,,,,,,,,,,,,,,,,,,,,,,,,,,,,,,,,,,,,,,,,,,,,,,,,,,,,573.0,pl POL,DF,22.0,6.7,0.0,0.0,0.0,5.0,2.0,0.0,0.0,7.0,6.0,0.0,0.0,0.0,21.0,4.0,7.0,36.4,Matches,573.0,pl POL,DF,22.0,6.7,396.0,383.0,11.0,7.0,0.0,3.0,0.0,0.0,0.0,0.0,0.0,0.0,345.0,2.0,2.0,Matches,573.0,pl POL,DF,22.0,6.7,345.0,396.0,87.1,6702.0,2311.0,115.0,119.0,96.6,184.0,196.0,93.9,40.0,67.0,59.7,0.0,0.1,0.1,-0.1,1.0,13.0,1.0,0.0,13.0,Matches,729,pl POL,DF,22,11,603.0,55.0,17.6,6.7,6,80.0,5,5,24.0,21,1.27,8.0,9.0,-1.0,-0.15,0.2,8.0,11.9,-3.9,-0.59,-0.09,Matches,573.0,pl POL,DF,22.0,6.7,459.0,82.0,298.0,156.0,6.0,3.0,459.0,4.0,4.0,100.0,0.0,0.0,264.0,1558.0,909.0,6.0,2.0,0.0,1.0,1.0,326.0,0.0,Matches,573.0,pl POL,DF,22.0,6.7,0.0,2.0,1.0,50.0,0.3,0.15,0.0,0.0,7.2,0.0,0.0,0.0,0.3,0.3,0.17,-0.3,-0.3,Matches,573.0,pl POL,DF,22.0,11.0,6.0,603.0,6.7,0.0,0.0,0.0,0.0,0.0,0.0,0.0,0.0,0.3,0.3,0.1,0.4,6.0,13.0,0.0,0.0,0.0,0.0,0.0,0.0,0.05,0.01,0.07,0.05,0.07,Matches,Sebastian Walukiewicz,D C,22,123,153,Poland,Cagliari Calcio,4,7,10,7,10,4,13,6,10,12,11,8,13,10,13,14,14,13,14,10,12,14,10,6,11,14,14,15,12,11,15,14,15,13,15,15,13,13,12,10,2,2,2,2,4,3,3,3,2,1,1,3,8,12,2,9,13,11,12,11,1,1,20,1,1,1,12,1,6,1,1,1,1,1,188,85,8,20,8573248,6150,5900,5450,Northern_European,123,1,2000/5/4,3,0,8769.0,Empoli Football Club,96105337
739,Georginio Wijnaldum,Roma,1990,574.0,nl NED,MF,31.0,8.5,4.0,3.0,1.0,3.0,0.0,0.0,2.0,0.0,2.0,7.0,1.0,6.0,2.0,6.0,3.0,0.0,Matches,574.0,nl NED,MF,31.0,8.5,20.0,2.35,15.0,0.0,2.0,1.0,2.0,0.0,4.0,0.47,2.0,0.0,1.0,0.0,1.0,0.0,Matches,,,,,,,,,,,,,,,,,,,,,,,,,,,,,,,,,,,,,,,,,,,,,,,,,,,,,,,,574.0,nl NED,MF,31.0,8.5,0.0,0.0,0.0,3.0,9.0,1.0,4.0,2.0,3.0,1.0,0.0,0.0,32.0,13.0,5.0,72.2,Matches,574.0,nl NED,MF,31.0,8.5,204.0,194.0,9.0,6.0,0.0,0.0,4.0,0.0,0.0,0.0,0.0,0.0,169.0,1.0,7.0,Matches,574.0,nl NED,MF,31.0,8.5,169.0,204.0,82.8,2254.0,502.0,103.0,118.0,87.3,53.0,60.0,88.3,5.0,7.0,71.4,0.0,0.7,0.8,-0.7,8.0,9.0,6.0,2.0,18.0,Matches,730,nl NED,MF,31,14,769.0,55.0,22.5,8.5,10,74.0,4,4,9.0,2,1.71,14.0,9.0,5.0,0.59,0.35,14.2,8.3,6.0,0.7,0.04,Matches,574.0,nl NED,MF,31.0,8.5,274.0,9.0,37.0,151.0,90.0,30.0,274.0,21.0,11.0,52.4,10.0,47.6,154.0,1071.0,507.0,16.0,11.0,5.0,11.0,7.0,181.0,33.0,Matches,574.0,nl NED,MF,31.0,8.5,2.0,20.0,4.0,20.0,2.34,0.47,0.1,0.5,15.2,0.0,0.0,0.0,2.2,2.2,0.11,-0.2,-0.2,Matches,574.0,nl NED,MF,31.0,14.0,10.0,769.0,8.5,2.0,0.0,2.0,2.0,0.0,0.0,0.0,0.0,2.2,2.2,0.7,2.9,16.0,18.0,33.0,0.23,0.0,0.23,0.23,0.23,0.26,0.08,0.34,0.26,0.34,Matches,Georginio Wijnaldum,DM/M/AM LC,31,153,161,"Holland,Suriname",Paris Saint-Germain,8,12,15,12,16,6,12,8,6,12,14,7,13,15,12,15,12,15,16,11,15,15,12,14,14,14,15,15,14,15,17,11,18,13,16,13,15,7,15,5,15,3,1,1,2,1,2,1,4,2,3,2,17,15,6,13,15,17,15,17,1,1,1,1,1,1,20,14,20,14,16,17,12,8,175,74,9,20,35367495,7650,8000,6500,African_Caribbean,148,16,1990/11/11,85,26,210959.0,Associazione Sportiva Roma,859612
740,Luca Zanimacchia,Cremonese,1998,582.0,it ITA,MFFW,24.0,8.3,21.0,13.0,11.0,6.0,4.0,8.0,21.0,38.1,13.0,9.0,0.0,9.0,9.0,30.0,5.0,0.0,Matches,582.0,it ITA,MFFW,24.0,8.3,33.0,3.99,19.0,6.0,1.0,3.0,2.0,2.0,0.0,0.0,0.0,0.0,0.0,0.0,0.0,0.0,Matches,,,,,,,,,,,,,,,,,,,,,,,,,,,,,,,,,,,,,,,,,,,,,,,,,,,,,,,,582.0,it ITA,MFFW,24.0,8.3,2.0,0.0,0.0,9.0,10.0,2.0,46.0,9.0,13.0,1.0,0.0,0.0,48.0,3.0,10.0,23.1,Matches,582.0,it ITA,MFFW,24.0,8.3,312.0,271.0,40.0,8.0,0.0,1.0,46.0,2.0,21.0,9.0,10.0,0.0,213.0,1.0,9.0,Matches,582.0,it ITA,MFFW,24.0,8.3,213.0,312.0,68.3,3230.0,932.0,122.0,155.0,78.7,68.0,102.0,66.7,18.0,37.0,48.6,0.0,0.9,1.0,-0.9,14.0,12.0,12.0,2.0,26.0,Matches,739,it ITA,MFFW,24,15,746.0,50.0,21.8,8.3,9,65.0,1,6,26.0,4,0.33,9.0,17.0,-8.0,-0.97,-0.12,10.0,16.7,-6.8,-0.82,-0.12,Matches,582.0,it ITA,MFFW,24.0,8.3,416.0,8.0,54.0,156.0,211.0,33.0,416.0,14.0,5.0,35.7,8.0,57.1,208.0,1356.0,595.0,22.0,20.0,8.0,20.0,12.0,242.0,70.0,Matches,582.0,it ITA,MFFW,24.0,8.3,0.0,19.0,4.0,21.1,2.29,0.48,0.0,0.0,19.9,2.0,0.0,0.0,1.2,1.2,0.06,-1.2,-1.2,Matches,582.0,it ITA,MFFW,24.0,15.0,9.0,746.0,8.3,0.0,0.0,0.0,0.0,0.0,0.0,2.0,0.0,1.2,1.2,0.9,2.0,22.0,26.0,70.0,0.0,0.0,0.0,0.0,0.0,0.14,0.1,0.25,0.14,0.25,Matches,Luca Zanimacchia,AM RLC,24,125,134,Italy,Juventus,12,14,14,12,14,10,9,11,9,7,12,12,8,13,12,14,12,12,13,13,12,14,11,10,14,9,12,12,13,13,10,10,8,13,14,11,10,7,14,7,16,2,2,4,2,1,3,2,1,1,1,2,12,13,7,12,10,9,13,16,1,1,1,1,1,1,1,12,10,14,19,18,20,12,178,72,8,20,3000000,6241,6241,3991,Mediterranean_Hispanic,125,2,1998/7/19,0,0,2493.0,Cremonese,43215575
741,Nicolò Zaniolo,Roma,1999,583.0,it ITA,MFFW,23.0,9.9,7.0,5.0,2.0,4.0,1.0,2.0,7.0,28.6,5.0,11.0,0.0,11.0,2.0,9.0,0.0,0.0,Matches,583.0,it ITA,MFFW,23.0,9.9,27.0,2.73,19.0,0.0,1.0,4.0,3.0,0.0,1.0,0.1,1.0,0.0,0.0,0.0,0.0,0.0,Matches,,,,,,,,,,,,,,,,,,,,,,,,,,,,,,,,,,,,,,,,,,,,,,,,,,,,,,,,583.0,it ITA,MFFW,23.0,9.9,4.0,0.0,0.0,22.0,32.0,4.0,20.0,2.0,5.0,0.0,0.0,0.0,39.0,5.0,8.0,38.5,Matches,583.0,it ITA,MFFW,23.0,9.9,196.0,184.0,11.0,4.0,3.0,6.0,20.0,1.0,5.0,4.0,1.0,0.0,125.0,1.0,12.0,Matches,583.0,it ITA,MFFW,23.0,9.9,125.0,196.0,63.8,2173.0,488.0,63.0,85.0,74.1,46.0,67.0,68.7,15.0,26.0,57.7,0.0,0.9,0.6,-0.9,8.0,10.0,7.0,1.0,19.0,Matches,740,it ITA,MFFW,23,13,890.0,68.0,26.0,9.9,12,72.0,4,1,23.0,1,1.85,7.0,8.0,-1.0,-0.1,-0.56,14.2,6.5,7.7,0.78,0.16,Matches,583.0,it ITA,MFFW,23.0,9.9,344.0,1.0,36.0,153.0,165.0,45.0,344.0,47.0,10.0,21.3,29.0,61.7,246.0,1695.0,839.0,34.0,27.0,10.0,39.0,35.0,267.0,69.0,Matches,583.0,it ITA,MFFW,23.0,9.9,1.0,28.0,7.0,25.0,2.83,0.71,0.04,0.14,17.2,0.0,0.0,0.0,2.9,2.9,0.1,-1.9,-1.9,Matches,583.0,it ITA,MFFW,23.0,13.0,12.0,890.0,9.9,1.0,0.0,1.0,1.0,0.0,0.0,4.0,0.0,2.9,2.9,0.9,3.8,34.0,19.0,69.0,0.1,0.0,0.1,0.1,0.1,0.29,0.09,0.39,0.29,0.39,Matches,Nicolò Zaniolo,AM RC,23,150,165,Italy,Associazione Sportiva Roma,13,12,16,13,13,9,12,15,6,8,12,12,9,15,18,13,18,15,14,14,12,18,14,9,16,9,8,15,14,13,12,12,13,16,13,17,11,15,14,12,15,3,2,2,1,2,1,1,1,1,4,2,7,17,15,8,19,11,7,6,1,1,1,1,1,1,1,12,15,12,12,20,19,15,189,79,20,9,57585624,7500,7300,6750,Mediterranean_Hispanic,141,1,1999/7/2,9,2,89038.0,,43270517
742,Alessandro Zanoli,Napoli,2000,585.0,it ITA,DF,21.0,0.1,1.0,0.0,0.0,1.0,0.0,0.0,0.0,,0.0,0.0,0.0,0.0,0.0,1.0,1.0,0.0,Matches,585.0,it ITA,DF,21.0,0.1,1.0,7.5,1.0,0.0,0.0,0.0,0.0,0.0,0.0,0.0,0.0,0.0,0.0,0.0,0.0,0.0,Matches,,,,,,,,,,,,,,,,,,,,,,,,,,,,,,,,,,,,,,,,,,,,,,,,,,,,,,,,585.0,it ITA,DF,21.0,0.1,0.0,0.0,0.0,0.0,0.0,0.0,1.0,0.0,0.0,0.0,0.0,0.0,0.0,0.0,1.0,0.0,Matches,585.0,it ITA,DF,21.0,0.1,11.0,10.0,1.0,0.0,0.0,0.0,1.0,1.0,0.0,0.0,0.0,0.0,9.0,0.0,1.0,Matches,585.0,it ITA,DF,21.0,0.1,9.0,11.0,81.8,125.0,20.0,4.0,5.0,80.0,5.0,5.0,100.0,0.0,0.0,,0.0,0.0,0.0,0.0,0.0,0.0,0.0,0.0,0.0,Matches,742,it ITA,DF,21,1,12.0,12.0,0.4,0.1,0,,0,1,12.0,15,3.0,0.0,0.0,0.0,0.0,-1.29,0.1,0.0,0.1,0.7,-0.17,Matches,585.0,it ITA,DF,21.0,0.1,14.0,0.0,5.0,6.0,3.0,1.0,14.0,0.0,0.0,,0.0,,7.0,55.0,45.0,1.0,1.0,1.0,0.0,0.0,11.0,2.0,Matches,585.0,it ITA,DF,21.0,0.1,0.0,1.0,1.0,100.0,7.5,7.5,0.0,0.0,13.0,0.0,0.0,0.0,0.1,0.1,0.06,-0.1,-0.1,Matches,585.0,it ITA,DF,21.0,1.0,0.0,12.0,0.1,0.0,0.0,0.0,0.0,0.0,0.0,0.0,0.0,0.1,0.1,0.0,0.1,1.0,0.0,2.0,0.0,0.0,0.0,0.0,0.0,0.47,0.0,0.47,0.47,0.47,Matches,Alessandro Zanoli,D RC,21,123,146,Italy,Parthenope,8,11,9,6,11,6,11,8,14,12,11,7,14,11,9,13,12,12,14,10,12,13,6,7,12,13,13,13,13,12,14,13,14,14,14,14,12,7,9,6,14,3,3,1,2,3,4,2,2,1,2,2,15,14,6,11,13,14,10,12,1,13,16,20,10,14,1,1,1,14,1,1,1,1,188,81,10,20,4807499,6150,5800,3500,Mediterranean_Hispanic,123,3,2000/10/3,0,0,2115.0,,43390940
743,Mattia Zanotti,Inter,2003,586.0,it ITA,DF,19.0,0.3,0.0,0.0,0.0,0.0,0.0,0.0,1.0,0.0,1.0,2.0,0.0,2.0,0.0,0.0,0.0,0.0,Matches,586.0,it ITA,DF,19.0,0.3,1.0,3.33,1.0,0.0,0.0,0.0,0.0,0.0,0.0,0.0,0.0,0.0,0.0,0.0,0.0,0.0,Matches,,,,,,,,,,,,,,,,,,,,,,,,,,,,,,,,,,,,,,,,,,,,,,,,,,,,,,,,586.0,it ITA,DF,19.0,0.3,0.0,0.0,0.0,2.0,0.0,0.0,0.0,0.0,0.0,0.0,0.0,0.0,2.0,0.0,1.0,0.0,Matches,586.0,it ITA,DF,19.0,0.3,8.0,7.0,1.0,0.0,0.0,0.0,0.0,1.0,0.0,0.0,0.0,0.0,6.0,0.0,0.0,Matches,586.0,it ITA,DF,19.0,0.3,6.0,8.0,75.0,72.0,31.0,4.0,6.0,66.7,2.0,2.0,100.0,0.0,0.0,,0.0,0.1,0.0,-0.1,1.0,1.0,0.0,0.0,1.0,Matches,743,it ITA,DF,19,2,27.0,14.0,0.8,0.3,0,,0,2,14.0,25,3.0,1.0,0.0,1.0,3.33,2.59,0.5,0.1,0.5,1.52,0.7,Matches,586.0,it ITA,DF,19.0,0.3,13.0,0.0,4.0,3.0,7.0,1.0,13.0,0.0,0.0,,0.0,,5.0,17.0,13.0,1.0,1.0,0.0,1.0,0.0,4.0,2.0,Matches,586.0,it ITA,DF,19.0,0.3,0.0,0.0,0.0,,0.0,0.0,,,,0.0,0.0,0.0,0.0,0.0,,0.0,0.0,Matches,586.0,it ITA,DF,19.0,2.0,0.0,27.0,0.3,0.0,0.0,0.0,0.0,0.0,0.0,0.0,0.0,0.0,0.0,0.1,0.1,1.0,1.0,2.0,0.0,0.0,0.0,0.0,0.0,0.0,0.23,0.23,0.0,0.23,Matches,Mattia Zanotti,D/WB/M R,19,102,-75,Italy,FC Internazionale Milano,7,12,9,6,11,4,7,6,9,10,12,4,10,9,13,12,13,12,11,10,13,14,7,11,12,12,12,13,12,12,12,6,14,13,13,8,15,8,12,5,12,4,2,4,3,1,3,2,2,3,2,4,10,15,8,9,12,15,6,19,1,10,1,20,1,18,1,1,1,18,1,1,1,1,177,67,11,20,22192000,5100,4750,1750,Northern_European,99,1,2003/1/11,0,0,3114.0,,43500895
744,Deyovaisio Zeefuik,Hellas Verona,1998,590.0,nl NED,DF,24.0,0.1,1.0,1.0,0.0,1.0,0.0,0.0,0.0,,0.0,0.0,0.0,0.0,0.0,1.0,0.0,0.0,Matches,590.0,nl NED,DF,24.0,0.1,0.0,0.0,0.0,0.0,0.0,0.0,0.0,0.0,0.0,0.0,0.0,0.0,0.0,0.0,0.0,0.0,Matches,,,,,,,,,,,,,,,,,,,,,,,,,,,,,,,,,,,,,,,,,,,,,,,,,,,,,,,,590.0,nl NED,DF,24.0,0.1,0.0,0.0,0.0,0.0,0.0,0.0,1.0,0.0,1.0,0.0,0.0,0.0,1.0,0.0,0.0,,Matches,590.0,nl NED,DF,24.0,0.1,7.0,6.0,1.0,0.0,0.0,1.0,1.0,1.0,0.0,0.0,0.0,0.0,5.0,0.0,0.0,Matches,590.0,nl NED,DF,24.0,0.1,5.0,7.0,71.4,83.0,14.0,2.0,2.0,100.0,3.0,3.0,100.0,0.0,1.0,0.0,0.0,0.0,0.0,0.0,0.0,0.0,0.0,0.0,0.0,Matches,747,nl NED,DF,24,1,10.0,10.0,0.3,0.1,0,,0,1,10.0,14,0.0,0.0,1.0,-1.0,-9.0,-8.29,0.2,0.3,-0.1,-0.65,-0.28,Matches,590.0,nl NED,DF,24.0,0.1,10.0,0.0,2.0,6.0,3.0,2.0,10.0,1.0,0.0,0.0,1.0,100.0,6.0,24.0,4.0,1.0,0.0,1.0,0.0,0.0,5.0,1.0,Matches,590.0,nl NED,DF,24.0,0.1,0.0,0.0,0.0,,0.0,0.0,,,,0.0,0.0,0.0,0.0,0.0,,0.0,0.0,Matches,590.0,nl NED,DF,24.0,1.0,0.0,10.0,0.1,0.0,0.0,0.0,0.0,0.0,0.0,0.0,0.0,0.0,0.0,0.0,0.0,1.0,0.0,1.0,0.0,0.0,0.0,0.0,0.0,0.0,0.0,0.0,0.0,0.0,Matches,Deyovaisio Zeefuik,D/WB R,24,124,135,"Holland,Suriname",Hertha Berlin,7,11,12,5,10,6,14,10,12,10,11,6,15,10,16,9,16,10,8,10,9,16,13,7,9,9,12,15,15,13,14,14,11,17,15,14,12,8,11,3,12,2,3,1,2,2,1,2,3,1,3,3,12,13,8,15,10,11,7,10,1,12,13,20,8,19,11,1,1,13,1,1,11,1,177,76,9,20,2198294,6192,6342,5242,African_Caribbean,116,14,1998/3/11,0,0,19177.0,,37055854
745,Marvin Zeegelaar,Udinese,1990,591.0,nl NED,DF,31.0,3.9,8.0,4.0,6.0,2.0,0.0,3.0,4.0,75.0,1.0,2.0,0.0,2.0,3.0,11.0,5.0,0.0,Matches,591.0,nl NED,DF,31.0,3.9,5.0,1.27,5.0,0.0,0.0,0.0,0.0,0.0,0.0,0.0,0.0,0.0,0.0,0.0,0.0,0.0,Matches,,,,,,,,,,,,,,,,,,,,,,,,,,,,,,,,,,,,,,,,,,,,,,,,,,,,,,,,591.0,nl NED,DF,31.0,3.9,3.0,1.0,1.0,13.0,1.0,1.0,4.0,3.0,4.0,0.0,0.0,0.0,16.0,8.0,2.0,80.0,Matches,591.0,nl NED,DF,31.0,3.9,187.0,165.0,22.0,3.0,0.0,2.0,4.0,19.0,0.0,0.0,0.0,0.0,153.0,0.0,0.0,Matches,591.0,nl NED,DF,31.0,3.9,153.0,187.0,81.8,2535.0,860.0,74.0,87.0,85.1,67.0,75.0,89.3,9.0,18.0,50.0,0.0,0.2,0.1,-0.2,4.0,6.0,3.0,1.0,9.0,Matches,748,nl NED,DF,31,7,353.0,50.0,10.3,3.9,4,78.0,1,3,13.0,5,1.0,4.0,6.0,-2.0,-0.51,-0.54,4.4,3.8,0.7,0.17,0.33,Matches,591.0,nl NED,DF,31.0,3.9,223.0,13.0,90.0,90.0,47.0,7.0,223.0,10.0,8.0,80.0,1.0,10.0,126.0,497.0,234.0,6.0,2.0,1.0,8.0,4.0,139.0,11.0,Matches,591.0,nl NED,DF,31.0,3.9,1.0,3.0,1.0,33.3,0.76,0.25,0.33,1.0,11.7,0.0,0.0,0.0,0.2,0.2,0.07,0.8,0.8,Matches,591.0,nl NED,DF,31.0,7.0,4.0,353.0,3.9,1.0,0.0,1.0,1.0,0.0,0.0,3.0,1.0,0.2,0.2,0.2,0.4,6.0,9.0,11.0,0.25,0.0,0.25,0.25,0.25,0.05,0.04,0.09,0.05,0.09,Matches,Marvin Zeegelaar,D/WB LC,31,124,132,"Holland,Suriname",,10,12,13,7,11,5,11,9,11,9,12,10,12,12,12,13,12,12,12,9,12,14,13,5,12,12,12,12,14,15,12,13,13,14,13,14,13,7,11,6,12,3,3,3,3,3,4,3,1,1,2,2,10,14,8,10,12,10,11,6,1,20,15,1,20,1,1,14,1,1,1,1,1,1,186,84,20,8,-1,6200,6350,4750,African_Caribbean,119,14,1990/8/12,0,0,,,37005651
746,Alessio Zerbin,Napoli,1999,592.0,it ITA,FW,23.0,2.2,10.0,5.0,4.0,5.0,1.0,4.0,8.0,50.0,4.0,2.0,0.0,2.0,2.0,12.0,2.0,0.0,Matches,592.0,it ITA,FW,23.0,2.2,2.0,0.92,2.0,0.0,0.0,0.0,0.0,0.0,0.0,0.0,0.0,0.0,0.0,0.0,0.0,0.0,Matches,,,,,,,,,,,,,,,,,,,,,,,,,,,,,,,,,,,,,,,,,,,,,,,,,,,,,,,,592.0,it ITA,FW,23.0,2.2,1.0,0.0,0.0,9.0,6.0,1.0,1.0,2.0,5.0,0.0,0.0,0.0,8.0,0.0,1.0,0.0,Matches,592.0,it ITA,FW,23.0,2.2,78.0,76.0,0.0,0.0,0.0,0.0,1.0,0.0,0.0,0.0,0.0,0.0,56.0,2.0,2.0,Matches,592.0,it ITA,FW,23.0,2.2,56.0,78.0,71.8,721.0,132.0,31.0,39.0,79.5,16.0,24.0,66.7,3.0,4.0,75.0,0.0,0.0,0.1,0.0,0.0,3.0,1.0,0.0,6.0,Matches,749,it ITA,FW,23,10,198.0,20.0,5.8,2.2,2,62.0,0,8,9.0,28,2.5,5.0,3.0,2.0,0.91,-0.4,2.9,3.9,-1.0,-0.48,-1.43,Matches,592.0,it ITA,FW,23.0,2.2,115.0,5.0,16.0,63.0,36.0,9.0,115.0,5.0,2.0,40.0,3.0,60.0,71.0,322.0,124.0,5.0,0.0,3.0,5.0,5.0,84.0,20.0,Matches,592.0,it ITA,FW,23.0,2.2,0.0,5.0,3.0,60.0,2.27,1.36,0.0,0.0,19.1,0.0,0.0,0.0,0.3,0.3,0.05,-0.3,-0.3,Matches,592.0,it ITA,FW,23.0,10.0,2.0,198.0,2.2,0.0,0.0,0.0,0.0,0.0,0.0,1.0,0.0,0.3,0.3,0.0,0.3,5.0,6.0,20.0,0.0,0.0,0.0,0.0,0.0,0.12,0.0,0.12,0.12,0.12,Matches,Alessio Zerbin,AM/S RL,23,131,149,Italy,Parthenope,10,13,12,13,13,6,9,12,7,5,12,10,6,12,10,14,10,13,12,12,12,14,16,7,14,8,14,14,14,14,13,10,15,14,14,10,14,5,16,4,13,3,1,1,2,2,4,4,3,2,2,2,10,15,6,14,14,14,14,13,1,1,1,1,1,1,1,13,1,12,20,1,18,16,182,77,10,20,3916536,6550,7000,4750,Northern_European,126,2,1999/3/3,1,0,8846.0,,43280475
747,David Zima,Torino,2000,594.0,cz CZE,DF,21.0,4.5,9.0,5.0,5.0,4.0,0.0,3.0,4.0,75.0,1.0,7.0,2.0,5.0,9.0,18.0,11.0,2.0,Matches,594.0,cz CZE,DF,21.0,4.5,4.0,0.89,4.0,0.0,0.0,0.0,0.0,0.0,0.0,0.0,0.0,0.0,0.0,0.0,0.0,0.0,Matches,,,,,,,,,,,,,,,,,,,,,,,,,,,,,,,,,,,,,,,,,,,,,,,,,,,,,,,,594.0,cz CZE,DF,21.0,4.5,0.0,0.0,0.0,4.0,2.0,0.0,0.0,9.0,5.0,0.0,0.0,0.0,24.0,15.0,9.0,62.5,Matches,594.0,cz CZE,DF,21.0,4.5,197.0,194.0,3.0,3.0,0.0,0.0,0.0,0.0,0.0,0.0,0.0,0.0,154.0,0.0,3.0,Matches,594.0,cz CZE,DF,21.0,4.5,154.0,197.0,78.2,2708.0,743.0,60.0,77.0,77.9,73.0,86.0,84.9,12.0,20.0,60.0,0.0,0.1,0.0,-0.1,2.0,6.0,3.0,0.0,12.0,Matches,751,cz CZE,DF,21,9,406.0,45.0,11.9,4.5,4,83.0,3,5,15.0,10,1.56,6.0,5.0,1.0,0.22,0.22,4.9,6.6,-1.7,-0.37,-0.48,Matches,594.0,cz CZE,DF,21.0,4.5,245.0,20.0,114.0,121.0,12.0,5.0,245.0,1.0,1.0,100.0,0.0,0.0,111.0,541.0,279.0,3.0,2.0,0.0,1.0,2.0,129.0,5.0,Matches,594.0,cz CZE,DF,21.0,4.5,0.0,4.0,2.0,50.0,0.89,0.44,0.0,0.0,12.0,0.0,0.0,0.0,0.8,0.8,0.2,-0.8,-0.8,Matches,594.0,cz CZE,DF,21.0,9.0,4.0,406.0,4.5,0.0,0.0,0.0,0.0,0.0,0.0,0.0,0.0,0.8,0.8,0.1,0.9,3.0,12.0,5.0,0.0,0.0,0.0,0.0,0.0,0.17,0.02,0.19,0.17,0.19,Matches,David Zima,D C,21,122,155,Czech Republic,Torino,4,6,9,7,11,6,14,6,10,14,12,7,13,10,8,12,13,12,12,8,13,13,13,8,8,12,13,9,13,11,14,15,12,13,13,15,13,6,12,10,9,3,3,1,2,3,1,2,1,3,1,1,10,13,8,12,11,12,15,9,1,1,20,1,1,1,9,1,1,1,1,1,1,1,190,80,9,20,9919999,6100,5950,4750,Northern_European,121,1,2000/11/8,11,0,14236.0,,25061896
748,Joshua Zirkzee,Bologna,2001,595.0,nl NED,FW,21.0,9.1,4.0,2.0,1.0,1.0,2.0,2.0,7.0,28.6,5.0,4.0,1.0,3.0,4.0,8.0,4.0,0.0,Matches,595.0,nl NED,FW,21.0,9.1,36.0,3.95,23.0,0.0,7.0,4.0,1.0,1.0,4.0,0.44,4.0,0.0,0.0,0.0,0.0,0.0,Matches,,,,,,,,,,,,,,,,,,,,,,,,,,,,,,,,,,,,,,,,,,,,,,,,,,,,,,,,595.0,nl NED,FW,21.0,9.1,1.0,0.0,0.0,8.0,9.0,2.0,1.0,4.0,2.0,0.0,0.0,0.0,19.0,12.0,25.0,32.4,Matches,595.0,nl NED,FW,21.0,9.1,257.0,238.0,17.0,0.0,2.0,0.0,1.0,1.0,0.0,0.0,0.0,0.0,198.0,2.0,9.0,Matches,595.0,nl NED,FW,21.0,9.1,198.0,257.0,77.0,2526.0,434.0,134.0,156.0,85.9,47.0,61.0,77.0,6.0,9.0,66.7,2.0,1.4,0.5,0.6,16.0,12.0,6.0,0.0,17.0,Matches,752,nl NED,FW,21,19,822.0,43.0,24.0,9.1,5,87.0,4,14,28.0,10,1.21,17.0,11.0,6.0,0.66,0.73,14.8,12.7,2.0,0.22,0.46,Matches,595.0,nl NED,FW,21.0,9.1,379.0,8.0,21.0,177.0,185.0,33.0,379.0,37.0,16.0,43.2,19.0,51.4,236.0,1178.0,407.0,10.0,16.0,5.0,36.0,25.0,309.0,74.0,Matches,595.0,nl NED,FW,21.0,9.1,2.0,29.0,8.0,27.6,3.18,0.88,0.07,0.25,16.3,0.0,0.0,0.0,3.1,3.1,0.11,-1.1,-1.1,Matches,595.0,nl NED,FW,21.0,19.0,5.0,822.0,9.1,2.0,2.0,4.0,2.0,0.0,0.0,1.0,0.0,3.1,3.1,1.4,4.5,10.0,17.0,74.0,0.22,0.22,0.44,0.22,0.44,0.34,0.15,0.49,0.34,0.49,Matches,Joshua Zirkzee,S C,21,127,152,"Holland,Nigeria",Bologna FC 1909,4,7,12,14,13,13,12,11,3,5,13,12,7,15,14,14,12,13,12,13,12,11,14,3,15,5,12,10,13,12,15,15,14,13,12,13,12,11,14,8,8,4,3,2,1,1,1,1,2,2,2,2,13,15,15,8,11,8,8,6,1,1,1,1,1,1,1,1,1,1,10,15,10,20,193,89,12,20,8499040,6350,6000,5500,Mixed_Race,127,13,2001/5/22,0,0,47944.0,,37060922
749,Jeroen Zoet,Spezia,1991,596.0,nl NED,GK,31.0,3.7,1.0,1.0,1.0,0.0,0.0,1.0,1.0,100.0,0.0,0.0,0.0,0.0,0.0,1.0,1.0,0.0,Matches,596.0,nl NED,GK,31.0,3.7,1.0,0.27,1.0,0.0,0.0,0.0,0.0,0.0,0.0,0.0,0.0,0.0,0.0,0.0,0.0,0.0,Matches,48.0,nl NED,GK,31.0,3.7,4.0,1.0,0.0,1.0,0.0,2.8,0.14,-1.2,-0.31,25.0,78.0,32.1,110.0,13.0,54.5,39.0,23.0,78.3,58.4,62.0,4.0,6.5,6.0,1.61,14.7,Matches,48.0,nl NED,GK,31.0,5.0,4.0,334.0,3.7,4.0,1.08,13.0,9.0,76.9,0.0,3.0,1.0,0.0,0.0,1.0,1.0,0.0,0.0,0.0,Matches,596.0,nl NED,GK,31.0,3.7,1.0,0.0,0.0,0.0,0.0,0.0,0.0,0.0,1.0,0.0,0.0,0.0,8.0,0.0,0.0,,Matches,596.0,nl NED,GK,31.0,3.7,133.0,104.0,29.0,6.0,0.0,0.0,0.0,0.0,0.0,0.0,0.0,0.0,75.0,0.0,0.0,Matches,596.0,nl NED,GK,31.0,3.7,75.0,133.0,56.4,2316.0,1996.0,18.0,18.0,100.0,30.0,32.0,93.8,26.0,82.0,31.7,0.0,0.0,0.0,0.0,0.0,6.0,0.0,0.0,0.0,Matches,753,nl NED,GK,31,5,334.0,67.0,9.8,3.7,4,72.0,3,1,48.0,24,1.2,6.0,4.0,2.0,0.54,1.5,7.0,5.7,1.3,0.36,0.92,Matches,596.0,nl NED,GK,31.0,3.7,141.0,123.0,140.0,1.0,0.0,0.0,141.0,1.0,1.0,100.0,0.0,0.0,84.0,534.0,277.0,0.0,0.0,0.0,0.0,0.0,59.0,0.0,Matches,596.0,nl NED,GK,31.0,3.7,0.0,0.0,0.0,,0.0,0.0,,,,0.0,0.0,0.0,0.0,0.0,,0.0,0.0,Matches,596.0,nl NED,GK,31.0,5.0,4.0,334.0,3.7,0.0,0.0,0.0,0.0,0.0,0.0,1.0,0.0,0.0,0.0,0.0,0.0,0.0,0.0,0.0,0.0,0.0,0.0,0.0,0.0,0.0,0.0,0.0,0.0,0.0,Matches,Jeroen Zoet,GK,31,123,137,Holland,Spezia Calcio,1,2,3,2,8,4,3,3,3,1,11,5,3,11,7,13,11,13,12,14,11,18,4,13,3,14,14,17,9,12,12,14,15,10,15,12,13,7,15,5,12,13,13,14,6,13,12,14,15,13,10,13,17,17,6,17,16,18,15,10,20,1,1,1,1,1,1,1,1,1,1,1,1,1,189,89,5,20,1554614,6150,6700,5750,Northern_European,123,4,1991/1/6,11,0,24615.0,,29022550
750,Nadir Zortea,Atalanta,1999,597.0,it ITA,DFMF,23.0,2.5,10.0,5.0,3.0,7.0,0.0,3.0,4.0,75.0,1.0,4.0,0.0,4.0,0.0,10.0,4.0,0.0,Matches,597.0,it ITA,DFMF,23.0,2.5,8.0,3.27,5.0,0.0,2.0,1.0,0.0,0.0,1.0,0.41,1.0,0.0,0.0,0.0,0.0,0.0,Matches,,,,,,,,,,,,,,,,,,,,,,,,,,,,,,,,,,,,,,,,,,,,,,,,,,,,,,,,597.0,it ITA,DFMF,23.0,2.5,1.0,0.0,0.0,4.0,0.0,0.0,10.0,0.0,5.0,0.0,0.0,0.0,14.0,5.0,1.0,83.3,Matches,597.0,it ITA,DFMF,23.0,2.5,98.0,83.0,15.0,0.0,1.0,0.0,10.0,15.0,0.0,0.0,0.0,0.0,60.0,0.0,6.0,Matches,597.0,it ITA,DFMF,23.0,2.5,60.0,98.0,61.2,937.0,602.0,31.0,38.0,81.6,22.0,35.0,62.9,5.0,13.0,38.5,0.0,0.6,0.2,-0.6,3.0,3.0,3.0,1.0,9.0,Matches,754,it ITA,DFMF,23,9,222.0,25.0,6.5,2.5,1,79.0,0,8,18.0,10,2.22,6.0,3.0,3.0,1.22,0.79,3.9,1.9,1.9,0.8,0.39,Matches,597.0,it ITA,DFMF,23.0,2.5,153.0,7.0,45.0,50.0,60.0,7.0,153.0,21.0,10.0,47.6,10.0,47.6,78.0,480.0,267.0,11.0,7.0,2.0,6.0,2.0,82.0,13.0,Matches,597.0,it ITA,DFMF,23.0,2.5,1.0,4.0,3.0,75.0,1.62,1.22,0.25,0.33,20.4,0.0,0.0,0.0,0.1,0.1,0.03,0.9,0.9,Matches,597.0,it ITA,DFMF,23.0,9.0,1.0,222.0,2.5,1.0,0.0,1.0,1.0,0.0,0.0,1.0,0.0,0.1,0.1,0.6,0.7,11.0,9.0,13.0,0.41,0.0,0.41,0.41,0.41,0.05,0.23,0.28,0.05,0.28,Matches,Nadir Zortea,D/WB/M RL,23,125,142,Italy,Atalanta,9,14,13,9,12,7,10,11,13,11,12,8,12,12,13,13,10,10,11,13,11,13,8,10,12,12,13,12,13,13,12,10,14,14,14,13,12,9,13,8,13,3,3,1,4,1,2,3,1,2,3,3,11,13,7,9,13,13,8,12,1,12,1,20,15,20,1,13,1,17,1,1,13,1,175,70,7,20,2305744,6248,5998,3598,Mediterranean_Hispanic,116,2,1999/6/19,0,0,20109.0,,43252462
751,Szymon Żurkowski,Fiorentina,1997,600.0,pl POL,MF,24.0,0.4,0.0,0.0,0.0,0.0,0.0,0.0,0.0,,0.0,0.0,0.0,0.0,0.0,0.0,0.0,0.0,Matches,600.0,pl POL,MF,24.0,0.4,2.0,5.63,2.0,0.0,0.0,0.0,0.0,0.0,1.0,2.81,1.0,0.0,0.0,0.0,0.0,0.0,Matches,,,,,,,,,,,,,,,,,,,,,,,,,,,,,,,,,,,,,,,,,,,,,,,,,,,,,,,,600.0,pl POL,MF,24.0,0.4,0.0,0.0,0.0,1.0,0.0,0.0,1.0,0.0,0.0,0.0,0.0,0.0,2.0,1.0,1.0,50.0,Matches,600.0,pl POL,MF,24.0,0.4,19.0,19.0,0.0,0.0,0.0,0.0,1.0,0.0,0.0,0.0,0.0,0.0,17.0,0.0,1.0,Matches,600.0,pl POL,MF,24.0,0.4,17.0,19.0,89.5,298.0,21.0,6.0,7.0,85.7,7.0,7.0,100.0,2.0,2.0,100.0,1.0,0.0,0.0,1.0,1.0,1.0,1.0,0.0,1.0,Matches,758,pl POL,MF,24,2,32.0,16.0,0.9,0.4,0,,0,2,16.0,8,2.0,1.0,0.0,1.0,2.81,2.57,0.9,0.3,0.7,1.83,1.54,Matches,600.0,pl POL,MF,24.0,0.4,25.0,0.0,1.0,8.0,16.0,3.0,25.0,1.0,0.0,0.0,1.0,100.0,16.0,115.0,60.0,3.0,1.0,1.0,1.0,1.0,18.0,4.0,Matches,600.0,pl POL,MF,24.0,0.4,0.0,2.0,1.0,50.0,5.63,2.81,0.0,0.0,15.2,0.0,0.0,0.0,0.1,0.1,0.06,-0.1,-0.1,Matches,600.0,pl POL,MF,24.0,2.0,0.0,32.0,0.4,0.0,1.0,1.0,0.0,0.0,0.0,0.0,0.0,0.1,0.1,0.0,0.1,3.0,1.0,4.0,0.0,2.81,2.81,0.0,2.81,0.33,0.06,0.4,0.33,0.4,Matches,Szymon Żurkowski,M/AM C,24,130,138,Poland,ACF Fiorentina,10,10,12,13,12,9,8,14,10,9,12,10,11,14,15,12,13,10,12,12,12,15,12,10,14,12,13,16,13,13,14,12,14,13,14,14,13,9,13,5,12,3,3,1,2,2,3,1,1,3,3,2,7,10,6,12,12,11,11,19,1,1,1,1,1,1,15,1,20,1,1,16,1,1,185,77,14,20,1822997,6499,5949,4999,Northern_European,130,3,1997/9/25,5,0,17885.0,,96110489
