,_Player_,_Squad_,_Born_,defense__Rk,defense__Nation,defense__Pos,defense__Age,defense__90s,defense_Tackles_Tkl,defense_Tackles_TklW,defense_Tackles_Def 3rd,defense_Tackles_Mid 3rd,defense_Tackles_Att 3rd,defense_Challenges_Tkl,defense_Challenges_Att,defense_Challenges_Tkl%,defense_Challenges_Lost,defense_Blocks_Blocks,defense_Blocks_Sh,defense_Blocks_Pass,defense__Int,defense__Tkl+Int,defense__Clr,defense__Err,defense_Matches,gca__Rk,gca__Nation,gca__Pos,gca__Age,gca__90s,gca_SCA_SCA,gca_SCA_SCA90,gca_SCATypes_PassLive,gca_SCATypes_PassDead,gca_SCATypes_TO,gca_SCATypes_Sh,gca_SCATypes_Fld,gca_SCATypes_Def,gca_GCA_GCA,gca_GCA_GCA90,gca_GCATypes_PassLive,gca_GCATypes_PassDead,gca_GCATypes_TO,gca_GCATypes_Sh,gca_GCATypes_Fld,gca_GCATypes_Def,gca_Matches,keepersadv__Rk,keepersadv__Nation,keepersadv__Pos,keepersadv__Age,keepersadv__90s,keepersadv_Goals_GA,keepersadv_Goals_PKA,keepersadv_Goals_FK,keepersadv_Goals_CK,keepersadv_Goals_OG,keepersadv_Expected_PSxG,keepersadv_Expected_PSxG/SoT,keepersadv_Expected_PSxG+/-,keepersadv_Expected_/90,keepersadv_Launched_Cmp,keepersadv_Launched_Att,keepersadv_Launched_Cmp%,keepersadv_Passes_Att (GK),keepersadv_Passes_Thr,keepersadv_Passes_Launch%,keepersadv_Passes_AvgLen,keepersadv_GoalKicks_Att,keepersadv_GoalKicks_Launch%,keepersadv_GoalKicks_AvgLen,keepersadv_Crosses_Opp,keepersadv_Crosses_Stp,keepersadv_Crosses_Stp%,keepersadv_Sweeper_#OPA,keepersadv_Sweeper_#OPA/90,keepersadv_Sweeper_AvgDist,keepersadv_Matches,keepers__Rk,keepers__Nation,keepers__Pos,keepers__Age,keepers_PlayingTime_MP,keepers_PlayingTime_Starts,keepers_PlayingTime_Min,keepers_PlayingTime_90s,keepers_Performance_GA,keepers_Performance_GA90,keepers_Performance_SoTA,keepers_Performance_Saves,keepers_Performance_Save%,keepers_Performance_W,keepers_Performance_D,keepers_Performance_L,keepers_Performance_CS,keepers_Performance_CS%,keepers_PenaltyKicks_PKatt,keepers_PenaltyKicks_PKA,keepers_PenaltyKicks_PKsv,keepers_PenaltyKicks_PKm,keepers_PenaltyKicks_Save%,keepers_Matches,misc__Rk,misc__Nation,misc__Pos,misc__Age,misc__90s,misc_Performance_CrdY,misc_Performance_CrdR,misc_Performance_2CrdY,misc_Performance_Fls,misc_Performance_Fld,misc_Performance_Off,misc_Performance_Crs,misc_Performance_Int,misc_Performance_TklW,misc_Performance_PKwon,misc_Performance_PKcon,misc_Performance_OG,misc_Performance_Recov,misc_AerialDuels_Won,misc_AerialDuels_Lost,misc_AerialDuels_Won%,misc_Matches,passingtypes__Rk,passingtypes__Nation,passingtypes__Pos,passingtypes__Age,passingtypes__90s,passingtypes__Att,passingtypes_PassTypes_Live,passingtypes_PassTypes_Dead,passingtypes_PassTypes_FK,passingtypes_PassTypes_TB,passingtypes_PassTypes_Sw,passingtypes_PassTypes_Crs,passingtypes_PassTypes_TI,passingtypes_PassTypes_CK,passingtypes_CornerKicks_In,passingtypes_CornerKicks_Out,passingtypes_CornerKicks_Str,passingtypes_Outcomes_Cmp,passingtypes_Outcomes_Off,passingtypes_Outcomes_Blocks,passingtypes_Matches,passing__Rk,passing__Nation,passing__Pos,passing__Age,passing__90s,passing_Total_Cmp,passing_Total_Att,passing_Total_Cmp%,passing_Total_TotDist,passing_Total_PrgDist,passing_Short_Cmp,passing_Short_Att,passing_Short_Cmp%,passing_Medium_Cmp,passing_Medium_Att,passing_Medium_Cmp%,passing_Long_Cmp,passing_Long_Att,passing_Long_Cmp%,passing__Ast,passing__xAG,passing_Expected_xA,passing_Expected_A-xAG,passing__KP,passing__1/3,passing__PPA,passing__CrsPA,passing__PrgP,passing_Matches,playingtime__Rk,playingtime__Nation,playingtime__Pos,playingtime__Age,playingtime_PlayingTime_MP,playingtime_PlayingTime_Min,playingtime_PlayingTime_Mn/MP,playingtime_PlayingTime_Min%,playingtime_PlayingTime_90s,playingtime_Starts_Starts,playingtime_Starts_Mn/Start,playingtime_Starts_Compl,playingtime_Subs_Subs,playingtime_Subs_Mn/Sub,playingtime_Subs_unSub,playingtime_TeamSuccess_PPM,playingtime_TeamSuccess_onG,playingtime_TeamSuccess_onGA,playingtime_TeamSuccess_+/-,playingtime_TeamSuccess_+/-90,playingtime_TeamSuccess_On-Off,playingtime_TeamSuccess(xG)_onxG,playingtime_TeamSuccess(xG)_onxGA,playingtime_TeamSuccess(xG)_xG+/-,playingtime_TeamSuccess(xG)_xG+/-90,playingtime_TeamSuccess(xG)_On-Off,playingtime_Matches,possession__Rk,possession__Nation,possession__Pos,possession__Age,possession__90s,possession_Touches_Touches,possession_Touches_Def Pen,possession_Touches_Def 3rd,possession_Touches_Mid 3rd,possession_Touches_Att 3rd,possession_Touches_Att Pen,possession_Touches_Live,possession_Take-Ons_Att,possession_Take-Ons_Succ,possession_Take-Ons_Succ%,possession_Take-Ons_Tkld,possession_Take-Ons_Tkld%,possession_Carries_Carries,possession_Carries_TotDist,possession_Carries_PrgDist,possession_Carries_PrgC,possession_Carries_1/3,possession_Carries_CPA,possession_Carries_Mis,possession_Carries_Dis,possession_Receiving_Rec,possession_Receiving_PrgR,possession_Matches,shooting__Rk,shooting__Nation,shooting__Pos,shooting__Age,shooting__90s,shooting_Standard_Gls,shooting_Standard_Sh,shooting_Standard_SoT,shooting_Standard_SoT%,shooting_Standard_Sh/90,shooting_Standard_SoT/90,shooting_Standard_G/Sh,shooting_Standard_G/SoT,shooting_Standard_Dist,shooting_Standard_FK,shooting_Standard_PK,shooting_Standard_PKatt,shooting_Expected_xG,shooting_Expected_npxG,shooting_Expected_npxG/Sh,shooting_Expected_G-xG,shooting_Expected_np:G-xG,shooting_Matches,stats__Rk,stats__Nation,stats__Pos,stats__Age,stats_PlayingTime_MP,stats_PlayingTime_Starts,stats_PlayingTime_Min,stats_PlayingTime_90s,stats_Performance_Gls,stats_Performance_Ast,stats_Performance_G+A,stats_Performance_G-PK,stats_Performance_PK,stats_Performance_PKatt,stats_Performance_CrdY,stats_Performance_CrdR,stats_Expected_xG,stats_Expected_npxG,stats_Expected_xAG,stats_Expected_npxG+xAG,stats_Progression_PrgC,stats_Progression_PrgP,stats_Progression_PrgR,stats_Per90Minutes_Gls,stats_Per90Minutes_Ast,stats_Per90Minutes_G+A,stats_Per90Minutes_G-PK,stats_Per90Minutes_G+A-PK,stats_Per90Minutes_xG,stats_Per90Minutes_xAG,stats_Per90Minutes_xG+xAG,stats_Per90Minutes_npxG,stats_Per90Minutes_npxG+xAG,stats_Matches,Name,Position,Age,ca,pa,Nationality,Club,Corners,Crossing,Dribbling,Finishing,First Touch,Free Kick Taking,Heading,Long Shots,Long Throws,Marking,Passing,Penalty Taking,Tackling,Technique,Aggressiion,Anticipation,Bravery,Composure,Concentration,Vision,Decision,Determination,Flair,Leadership,Off The Ball,Positioning,Teamwork,Work Rate,Acceleration,Agility,Balance,Jumping Reach,Natural Fitness,Pace,Stamina,Strength,Stability,Foul,Contest performance,Injury,diversity,Aerial Reach,Command Of Area,Communication,Eccentricity,Handling,Kicking,One On Ones,Reflexes,Rushing Out,Punching,Throwing,Adaptation,Ambition,Argue,Loyal,Resistant to stress,Professional,Sportsmanship,Emotional control,GK,DL,DC,DR,WBL,WBR,DM,ML,MC,MR,AML,AMC,AMR,ST,Height,Weight,Left Foot,Right Foot,Values,Current reputation,Domestic reputation,World reputation,Race,RCA,Colour of skin,Date of birth,Number of national team appearances,Goals scored for the national team,Salary,Rental club,UID
0,Karim Adeyemi,Dortmund,2002,3.0,de GER,FWMF,20.0,15.4,16.0,11.0,6.0,6.0,4.0,8.0,30.0,26.7,22.0,18.0,1.0,17.0,7.0,23.0,3.0,0.0,Matches,3.0,de GER,FWMF,20.0,15.4,59.0,3.83,40.0,0.0,8.0,5.0,4.0,2.0,12.0,0.78,9.0,0.0,2.0,1.0,0.0,0.0,Matches,,,,,,,,,,,,,,,,,,,,,,,,,,,,,,,,,,,,,,,,,,,,,,,,,,,,,,,,3.0,de GER,FWMF,20.0,15.4,9.0,0.0,0.0,21.0,30.0,1.0,25.0,7.0,11.0,0.0,0.0,0.0,66.0,10.0,4.0,71.4,Matches,3.0,de GER,FWMF,20.0,15.4,457.0,431.0,23.0,3.0,2.0,1.0,25.0,12.0,8.0,7.0,1.0,0.0,335.0,3.0,21.0,Matches,3.0,de GER,FWMF,20.0,15.4,335.0,457.0,73.3,4409.0,1278.0,197.0,243.0,81.1,97.0,125.0,77.6,13.0,27.0,48.1,5.0,3.7,3.7,1.3,28.0,17.0,25.0,0.0,47.0,Matches,3,de GER,FWMF,20,24,1386.0,58.0,45.3,15.4,20,64.0,2,4,27.0,1,2.17,41.0,17.0,24.0,1.56,0.75,32.6,17.4,15.2,0.99,0.31,Matches,3.0,de GER,FWMF,20.0,15.4,676.0,11.0,68.0,240.0,384.0,65.0,675.0,94.0,34.0,36.2,48.0,51.1,455.0,3163.0,1489.0,49.0,32.0,21.0,43.0,26.0,478.0,131.0,Matches,3.0,de GER,FWMF,20.0,15.4,6.0,37.0,14.0,37.8,2.4,0.91,0.16,0.43,17.4,0.0,0.0,1.0,5.0,4.3,0.12,1.0,1.7,Matches,3.0,de GER,FWMF,20.0,24.0,20.0,1386.0,15.4,6.0,5.0,11.0,6.0,0.0,1.0,9.0,0.0,5.0,4.3,3.7,8.0,49.0,47.0,131.0,0.39,0.32,0.71,0.39,0.71,0.33,0.24,0.57,0.28,0.52,Matches,Karim Adeyemi,AM/S R,20,138,160,"Germany,Nigeria",Borussia Dortmund,8,9,14,13,12,7,8,9,3,5,9,13,6,13,13,12,12,10,13,12,10,19,12,7,15,5,12,14,18,14,7,11,12,18,13,10,11,8,14,13,5,2,4,1,2,1,2,3,3,2,4,3,16,19,7,10,13,15,10,10,1,1,1,1,1,1,1,1,1,1,13,1,17,20,179,74,20,13,82679995,7000,7000,5750,African_Caribbean,125,12,2002/1/18,4,1,115067.0,,16279486
1,Amine Adli,Leverkusen,2000,4.0,ma MAR,FWMF,22.0,15.9,18.0,10.0,4.0,6.0,8.0,5.0,17.0,29.4,12.0,28.0,2.0,26.0,6.0,24.0,7.0,0.0,Matches,4.0,ma MAR,FWMF,22.0,15.9,56.0,3.5,36.0,3.0,4.0,4.0,8.0,1.0,11.0,0.69,6.0,0.0,3.0,0.0,2.0,0.0,Matches,,,,,,,,,,,,,,,,,,,,,,,,,,,,,,,,,,,,,,,,,,,,,,,,,,,,,,,,4.0,ma MAR,FWMF,22.0,15.9,2.0,2.0,0.0,39.0,47.0,4.0,18.0,6.0,10.0,2.0,1.0,0.0,61.0,29.0,41.0,41.4,Matches,4.0,ma MAR,FWMF,22.0,15.9,565.0,535.0,23.0,4.0,3.0,2.0,18.0,5.0,8.0,2.0,2.0,0.0,427.0,7.0,19.0,Matches,4.0,ma MAR,FWMF,22.0,15.9,427.0,565.0,75.6,5845.0,1373.0,240.0,296.0,81.1,138.0,166.0,83.1,18.0,34.0,52.9,3.0,1.7,1.9,1.3,20.0,26.0,10.0,0.0,49.0,Matches,4,ma MAR,FWMF,22,26,1435.0,55.0,46.9,15.9,16,74.0,1,10,26.0,1,1.69,29.0,17.0,12.0,0.75,0.97,26.3,15.7,10.6,0.66,0.77,Matches,4.0,ma MAR,FWMF,22.0,15.9,786.0,9.0,74.0,394.0,327.0,67.0,786.0,58.0,26.0,44.8,22.0,37.9,467.0,2610.0,1368.0,46.0,29.0,15.0,52.0,18.0,598.0,137.0,Matches,4.0,ma MAR,FWMF,22.0,15.9,5.0,37.0,17.0,45.9,2.32,1.07,0.14,0.29,14.0,1.0,0.0,0.0,5.0,5.0,0.14,0.0,0.0,Matches,4.0,ma MAR,FWMF,22.0,26.0,16.0,1435.0,15.9,5.0,3.0,8.0,5.0,0.0,0.0,2.0,2.0,5.0,5.0,1.7,6.7,46.0,49.0,137.0,0.31,0.19,0.5,0.31,0.5,0.31,0.11,0.42,0.31,0.42,Matches,Amine Adli,AM LC,22,121,145,"France,Morocco",Bayer 04 Leverkusen,11,12,14,12,13,12,10,13,3,6,13,11,5,14,11,13,11,12,10,13,12,14,15,10,13,8,13,14,14,14,12,10,14,15,11,8,12,5,11,5,12,4,3,2,1,3,1,2,2,2,3,2,13,15,11,12,11,13,11,11,1,1,1,1,1,1,1,1,13,1,15,20,13,14,174,72,20,8,4899999,6050,5800,4250,African_Caribbean,120,13,2000/5/10,0,0,23014.0,,49037698
2,Naouirou Ahamada,Stuttgart,2002,6.0,fr FRA,MF,20.0,15.5,17.0,11.0,7.0,7.0,3.0,8.0,20.0,40.0,12.0,16.0,5.0,11.0,8.0,25.0,7.0,0.0,Matches,6.0,fr FRA,MF,20.0,15.5,38.0,2.45,31.0,0.0,3.0,2.0,1.0,1.0,7.0,0.45,7.0,0.0,0.0,0.0,0.0,0.0,Matches,,,,,,,,,,,,,,,,,,,,,,,,,,,,,,,,,,,,,,,,,,,,,,,,,,,,,,,,6.0,fr FRA,MF,20.0,15.5,4.0,1.0,1.0,16.0,17.0,1.0,6.0,8.0,11.0,0.0,1.0,0.0,88.0,7.0,16.0,30.4,Matches,6.0,fr FRA,MF,20.0,15.5,529.0,514.0,13.0,4.0,2.0,1.0,6.0,5.0,0.0,0.0,0.0,0.0,449.0,2.0,13.0,Matches,6.0,fr FRA,MF,20.0,15.5,449.0,529.0,84.9,6965.0,1651.0,223.0,242.0,92.1,187.0,204.0,91.7,21.0,40.0,52.5,2.0,1.2,0.9,0.8,15.0,38.0,7.0,2.0,56.0,Matches,6,fr FRA,MF,20,17,1398.0,82.0,45.7,15.5,17,82.0,6,0,,0,0.94,17.0,26.0,-9.0,-0.58,-0.42,19.5,18.4,1.1,0.07,0.0,Matches,6.0,fr FRA,MF,20.0,15.5,674.0,18.0,139.0,387.0,160.0,22.0,674.0,44.0,20.0,45.5,20.0,45.5,408.0,2988.0,1511.0,43.0,27.0,6.0,34.0,11.0,453.0,54.0,Matches,6.0,fr FRA,MF,20.0,15.5,2.0,16.0,5.0,31.3,1.03,0.32,0.13,0.4,22.1,0.0,0.0,0.0,0.8,0.8,0.05,1.2,1.2,Matches,6.0,fr FRA,MF,20.0,17.0,17.0,1398.0,15.5,2.0,2.0,4.0,2.0,0.0,0.0,4.0,1.0,0.8,0.8,1.2,2.1,43.0,56.0,54.0,0.13,0.13,0.26,0.13,0.26,0.05,0.08,0.13,0.05,0.13,Matches,Naouirou Ahamada,DM/M C,20,115,-75,"France,Comoros",VfB Stuttgart,5,8,13,8,13,6,8,10,5,12,14,6,11,15,14,11,13,12,12,12,12,15,14,7,1,12,12,15,13,13,12,11,12,13,13,13,11,8,10,10,8,2,1,3,3,3,3,2,3,2,1,1,12,13,8,11,10,14,10,10,1,1,1,1,1,1,18,1,20,1,1,14,1,1,183,73,10,20,54000001,5996,4412,4096,African_Caribbean,112,16,2002/3/29,0,0,14383.0,,49048373
3,Ludovic Ajorque,Mainz 05,1994,7.0,fr FRA,FWMF,28.0,13.5,6.0,5.0,1.0,4.0,1.0,1.0,9.0,11.1,8.0,8.0,2.0,6.0,1.0,7.0,8.0,0.0,Matches,7.0,fr FRA,FWMF,28.0,13.5,34.0,2.53,26.0,0.0,0.0,5.0,3.0,0.0,3.0,0.22,2.0,0.0,0.0,1.0,0.0,0.0,Matches,,,,,,,,,,,,,,,,,,,,,,,,,,,,,,,,,,,,,,,,,,,,,,,,,,,,,,,,7.0,fr FRA,FWMF,28.0,13.5,5.0,0.0,0.0,23.0,19.0,5.0,4.0,1.0,5.0,0.0,0.0,0.0,50.0,91.0,85.0,51.7,Matches,7.0,fr FRA,FWMF,28.0,13.5,415.0,398.0,14.0,1.0,1.0,5.0,4.0,2.0,0.0,0.0,0.0,0.0,243.0,3.0,11.0,Matches,7.0,fr FRA,FWMF,28.0,13.5,243.0,415.0,58.6,3550.0,613.0,153.0,231.0,66.2,55.0,104.0,52.9,22.0,28.0,78.6,1.0,1.7,1.6,-0.7,13.0,17.0,8.0,0.0,31.0,Matches,8,fr FRA,FWMF,28,17,1211.0,71.0,39.6,13.5,15,79.0,3,2,15.0,0,1.47,23.0,22.0,1.0,0.07,0.17,18.8,20.7,-1.9,-0.14,0.08,Matches,7.0,fr FRA,FWMF,28.0,13.5,555.0,8.0,34.0,291.0,236.0,76.0,555.0,12.0,7.0,58.3,4.0,33.3,253.0,989.0,267.0,5.0,11.0,1.0,46.0,13.0,415.0,85.0,Matches,7.0,fr FRA,FWMF,28.0,13.5,6.0,32.0,14.0,43.8,2.38,1.04,0.19,0.43,14.8,0.0,0.0,0.0,4.6,4.6,0.14,1.4,1.4,Matches,7.0,fr FRA,FWMF,28.0,17.0,15.0,1211.0,13.5,6.0,1.0,7.0,6.0,0.0,0.0,5.0,0.0,4.6,4.6,1.7,6.4,5.0,31.0,85.0,0.45,0.07,0.52,0.45,0.52,0.34,0.13,0.47,0.34,0.47,Matches,Ludovic Ajorque,S,28,135,136,"France,Réunion",RC Strasbourg Alsace,4,10,12,16,13,7,17,12,4,4,12,15,2,13,13,14,15,13,15,11,13,15,13,12,12,7,15,16,12,12,16,17,15,12,14,16,13,8,12,7,10,2,4,1,2,4,3,1,1,3,3,3,18,14,7,13,10,12,10,10,1,1,1,1,1,1,1,1,1,1,1,1,1,20,197,82,20,7,7963831,6750,6750,4015,Mixed_Race,134,8,1994/2/25,0,0,22559.0,,85103818
4,Kevin Akpoguma,Hoffenheim,1995,8.0,ng NGA,DF,27.0,21.7,75.0,44.0,45.0,27.0,3.0,32.0,45.0,71.1,13.0,45.0,16.0,29.0,24.0,99.0,70.0,1.0,Matches,8.0,ng NGA,DF,27.0,21.7,17.0,0.79,14.0,0.0,3.0,0.0,0.0,0.0,1.0,0.05,1.0,0.0,0.0,0.0,0.0,0.0,Matches,,,,,,,,,,,,,,,,,,,,,,,,,,,,,,,,,,,,,,,,,,,,,,,,,,,,,,,,8.0,ng NGA,DF,27.0,21.7,11.0,0.0,0.0,33.0,19.0,0.0,8.0,24.0,44.0,0.0,0.0,0.0,131.0,57.0,45.0,55.9,Matches,8.0,ng NGA,DF,27.0,21.7,1024.0,966.0,56.0,30.0,1.0,14.0,8.0,26.0,0.0,0.0,0.0,0.0,814.0,2.0,18.0,Matches,8.0,ng NGA,DF,27.0,21.7,814.0,1024.0,79.5,15380.0,5931.0,275.0,319.0,86.2,437.0,495.0,88.3,83.0,162.0,51.2,0.0,0.5,0.8,-0.5,5.0,83.0,10.0,3.0,85.0,Matches,9,ng NGA,DF,27,28,1950.0,70.0,63.7,21.7,21,81.0,14,7,35.0,3,1.04,22.0,29.0,-7.0,-0.32,-0.16,26.8,30.6,-3.8,-0.17,-0.23,Matches,8.0,ng NGA,DF,27.0,21.7,1306.0,143.0,613.0,609.0,93.0,16.0,1306.0,22.0,7.0,31.8,13.0,59.1,691.0,3422.0,1537.0,17.0,13.0,3.0,16.0,7.0,742.0,23.0,Matches,8.0,ng NGA,DF,27.0,21.7,0.0,8.0,1.0,12.5,0.37,0.05,0.0,0.0,19.3,0.0,0.0,0.0,0.6,0.6,0.08,-0.6,-0.6,Matches,8.0,ng NGA,DF,27.0,28.0,21.0,1950.0,21.7,0.0,0.0,0.0,0.0,0.0,0.0,11.0,0.0,0.6,0.6,0.5,1.2,17.0,85.0,23.0,0.0,0.0,0.0,0.0,0.0,0.03,0.03,0.05,0.03,0.05,Matches,Kevin Akpoguma,D RLC,27,134,137,"Nigeria,Germany",TSG Hoffenheim,5,9,9,10,11,8,15,11,15,13,12,10,14,11,12,13,15,11,12,9,11,14,10,9,10,11,15,13,14,12,15,17,16,16,14,14,14,12,12,7,18,2,1,2,2,3,2,2,1,2,1,1,9,15,8,7,11,13,10,11,1,15,20,16,13,14,11,1,11,1,1,1,1,8,192,85,10,20,5925844,6597,6597,4747,Mixed_Race,133,11,1995/4/19,4,0,19164.0,,91109389
5,Nadiem Amiri,Leverkusen,1996,13.0,de GER,MFFW,25.0,10.9,15.0,6.0,5.0,8.0,2.0,9.0,20.0,45.0,11.0,12.0,1.0,11.0,6.0,21.0,10.0,2.0,Matches,13.0,de GER,MFFW,25.0,10.9,36.0,3.32,23.0,4.0,4.0,1.0,4.0,0.0,5.0,0.46,3.0,0.0,1.0,0.0,1.0,0.0,Matches,,,,,,,,,,,,,,,,,,,,,,,,,,,,,,,,,,,,,,,,,,,,,,,,,,,,,,,,13.0,de GER,MFFW,25.0,10.9,6.0,0.0,0.0,14.0,25.0,4.0,16.0,6.0,6.0,0.0,0.0,0.0,75.0,1.0,10.0,9.1,Matches,13.0,de GER,MFFW,25.0,10.9,507.0,472.0,32.0,14.0,4.0,4.0,16.0,4.0,9.0,2.0,7.0,0.0,423.0,3.0,15.0,Matches,13.0,de GER,MFFW,25.0,10.9,423.0,507.0,83.4,6968.0,1759.0,212.0,233.0,91.0,149.0,168.0,88.7,45.0,68.0,66.2,1.0,1.1,1.8,-0.1,15.0,38.0,9.0,1.0,55.0,Matches,14,de GER,MFFW,25,25,977.0,39.0,31.9,10.9,9,75.0,2,16,19.0,4,1.44,19.0,20.0,-1.0,-0.09,-0.48,14.4,12.8,1.6,0.15,-0.16,Matches,13.0,de GER,MFFW,25.0,10.9,624.0,16.0,119.0,339.0,174.0,15.0,623.0,38.0,18.0,47.4,14.0,36.8,352.0,2134.0,1069.0,30.0,26.0,7.0,14.0,10.0,430.0,30.0,Matches,13.0,de GER,MFFW,25.0,10.9,4.0,23.0,8.0,34.8,2.12,0.74,0.13,0.38,24.3,3.0,1.0,1.0,1.9,1.1,0.05,2.1,1.9,Matches,13.0,de GER,MFFW,25.0,25.0,9.0,977.0,10.9,4.0,1.0,5.0,3.0,1.0,1.0,6.0,0.0,1.9,1.1,1.1,2.2,30.0,55.0,30.0,0.37,0.09,0.46,0.28,0.37,0.17,0.1,0.27,0.1,0.2,Matches,Nadiem Amiri,M/AM C,25,129,140,"Germany,Afghanistan",Bayer 04 Leverkusen,15,15,13,11,12,14,5,13,7,9,13,12,11,14,15,13,13,12,11,14,11,15,14,12,13,11,17,15,12,13,13,9,16,12,14,11,11,10,11,8,16,2,4,2,2,2,2,2,1,2,3,2,10,14,11,9,13,11,8,8,1,1,1,1,1,1,1,13,20,1,1,18,1,1,180,77,12,20,3372935,6450,6900,5500,North_African__Middle_Eastern,127,7,1996/10/27,5,0,57692.0,,91143491
6,Robert Andrich,Leverkusen,1994,14.0,de GER,MF,27.0,26.7,61.0,38.0,30.0,27.0,4.0,26.0,45.0,57.8,19.0,27.0,9.0,18.0,42.0,103.0,55.0,2.0,Matches,14.0,de GER,MF,27.0,26.7,45.0,1.68,37.0,0.0,0.0,4.0,1.0,3.0,4.0,0.15,3.0,0.0,0.0,0.0,0.0,1.0,Matches,,,,,,,,,,,,,,,,,,,,,,,,,,,,,,,,,,,,,,,,,,,,,,,,,,,,,,,,14.0,de GER,MF,27.0,26.7,7.0,0.0,0.0,35.0,20.0,0.0,4.0,42.0,38.0,0.0,0.0,1.0,153.0,56.0,43.0,56.6,Matches,14.0,de GER,MF,27.0,26.7,1455.0,1404.0,49.0,42.0,0.0,4.0,4.0,5.0,0.0,0.0,0.0,0.0,1218.0,2.0,12.0,Matches,14.0,de GER,MF,27.0,26.7,1218.0,1455.0,83.7,19896.0,5759.0,594.0,675.0,88.0,496.0,581.0,85.4,82.0,123.0,66.7,2.0,1.2,0.9,0.8,18.0,77.0,11.0,2.0,99.0,Matches,15,de GER,MF,27,29,2406.0,83.0,78.6,26.7,28,85.0,24,1,15.0,0,1.55,50.0,38.0,12.0,0.45,1.0,40.9,34.9,6.0,0.23,-0.13,Matches,14.0,de GER,MF,27.0,26.7,1724.0,113.0,540.0,1021.0,171.0,19.0,1724.0,7.0,5.0,71.4,1.0,14.3,743.0,3500.0,1660.0,12.0,18.0,1.0,20.0,4.0,1073.0,8.0,Matches,14.0,de GER,MF,27.0,26.7,2.0,30.0,9.0,30.0,1.12,0.34,0.07,0.22,21.6,1.0,0.0,0.0,1.6,1.6,0.05,0.4,0.4,Matches,14.0,de GER,MF,27.0,29.0,28.0,2406.0,26.7,2.0,2.0,4.0,2.0,0.0,0.0,7.0,0.0,1.6,1.6,1.2,2.8,12.0,99.0,8.0,0.07,0.07,0.15,0.07,0.15,0.06,0.04,0.11,0.06,0.11,Matches,Robert Andrich,DM/M C,27,138,139,Germany,Bayer 04 Leverkusen,12,10,11,8,12,14,12,13,10,13,13,10,14,12,17,14,16,15,14,12,13,17,8,15,13,12,15,16,12,11,12,14,14,13,16,14,16,14,15,5,11,2,1,3,1,1,1,3,1,2,2,3,10,14,12,8,16,12,8,13,1,1,1,1,1,1,19,1,20,1,1,14,1,1,186,86,12,20,13356831,6900,6900,4600,Northern_European,137,4,1994/9/22,0,0,28766.0,,91108805
7,Angeliño,Hoffenheim,1997,15.0,es ESP,DF,25.0,29.1,40.0,24.0,19.0,18.0,3.0,23.0,37.0,62.2,14.0,32.0,6.0,26.0,25.0,65.0,67.0,0.0,Matches,15.0,es ESP,DF,25.0,29.1,88.0,3.03,61.0,20.0,1.0,2.0,3.0,1.0,10.0,0.34,8.0,1.0,0.0,1.0,0.0,0.0,Matches,,,,,,,,,,,,,,,,,,,,,,,,,,,,,,,,,,,,,,,,,,,,,,,,,,,,,,,,15.0,es ESP,DF,25.0,29.1,2.0,0.0,0.0,12.0,29.0,7.0,179.0,25.0,24.0,0.0,0.0,0.0,148.0,15.0,27.0,35.7,Matches,15.0,es ESP,DF,25.0,29.1,1544.0,1160.0,366.0,42.0,1.0,16.0,179.0,276.0,48.0,18.0,23.0,0.0,1012.0,18.0,40.0,Matches,15.0,es ESP,DF,25.0,29.1,1012.0,1544.0,65.5,19297.0,7991.0,424.0,501.0,84.6,433.0,616.0,70.3,143.0,339.0,42.2,8.0,7.2,7.7,0.8,50.0,82.0,52.0,29.0,108.0,Matches,16,es ESP,DF,25,33,2617.0,79.0,85.5,29.1,30,86.0,23,3,13.0,0,1.09,38.0,51.0,-13.0,-0.45,-1.26,39.9,45.6,-5.7,-0.2,-0.73,Matches,15.0,es ESP,DF,25.0,29.1,1798.0,78.0,506.0,771.0,533.0,32.0,1798.0,28.0,13.0,46.4,11.0,39.3,818.0,3134.0,1459.0,24.0,26.0,4.0,27.0,15.0,966.0,120.0,Matches,15.0,es ESP,DF,25.0,29.1,0.0,21.0,4.0,19.0,0.72,0.14,0.0,0.0,20.5,4.0,0.0,0.0,1.1,1.1,0.05,-1.1,-1.1,Matches,15.0,es ESP,DF,25.0,33.0,30.0,2617.0,29.1,0.0,8.0,8.0,0.0,0.0,0.0,2.0,0.0,1.1,1.1,7.2,8.3,24.0,108.0,120.0,0.0,0.28,0.28,0.0,0.28,0.04,0.25,0.28,0.04,0.28,Matches,Angeliño,D/WB/M L,25,149,156,Spain,RB Leipzig,13,17,13,10,12,13,8,11,10,10,15,10,15,15,13,15,13,14,13,14,15,13,13,9,14,11,16,17,15,14,13,9,13,13,16,10,14,8,13,4,11,4,2,1,1,2,2,2,3,1,3,1,14,16,7,11,10,15,11,14,1,20,8,1,19,1,8,16,8,1,14,1,1,1,175,69,20,8,25253317,7248,7248,5998,Mediterranean_Hispanic,143,5,1997/1/4,0,0,57533.0,TSG Hoffenheim,28095342
8,Waldemar Anton,Stuttgart,1996,16.0,de GER,DF,26.0,32.6,49.0,27.0,27.0,19.0,3.0,27.0,51.0,52.9,24.0,44.0,16.0,28.0,38.0,87.0,123.0,2.0,Matches,16.0,de GER,DF,26.0,32.6,39.0,1.2,28.0,4.0,2.0,5.0,0.0,0.0,5.0,0.15,3.0,0.0,0.0,2.0,0.0,0.0,Matches,,,,,,,,,,,,,,,,,,,,,,,,,,,,,,,,,,,,,,,,,,,,,,,,,,,,,,,,16.0,de GER,DF,26.0,32.6,4.0,0.0,0.0,31.0,31.0,1.0,31.0,38.0,27.0,0.0,0.0,0.0,231.0,55.0,50.0,52.4,Matches,16.0,de GER,DF,26.0,32.6,2059.0,1854.0,201.0,64.0,4.0,21.0,31.0,136.0,0.0,0.0,0.0,0.0,1629.0,4.0,31.0,Matches,16.0,de GER,DF,26.0,32.6,1629.0,2059.0,79.1,32013.0,12155.0,539.0,629.0,85.7,913.0,1044.0,87.5,167.0,324.0,51.5,2.0,1.4,1.4,0.6,10.0,112.0,16.0,4.0,135.0,Matches,17,de GER,DF,26,34,2934.0,86.0,95.9,32.6,34,86.0,27,0,,0,0.97,44.0,54.0,-10.0,-0.31,1.12,44.6,44.0,0.7,0.02,-1.19,Matches,16.0,de GER,DF,26.0,32.6,2435.0,244.0,1128.0,1083.0,249.0,36.0,2435.0,38.0,19.0,50.0,18.0,47.4,1383.0,8281.0,4557.0,56.0,34.0,4.0,24.0,17.0,1531.0,52.0,Matches,16.0,de GER,DF,26.0,32.6,1.0,24.0,5.0,20.8,0.74,0.15,0.04,0.2,18.3,0.0,0.0,0.0,1.6,1.6,0.07,-0.6,-0.6,Matches,16.0,de GER,DF,26.0,34.0,34.0,2934.0,32.6,1.0,2.0,3.0,1.0,0.0,0.0,4.0,0.0,1.6,1.6,1.4,3.0,56.0,135.0,52.0,0.03,0.06,0.09,0.03,0.09,0.05,0.04,0.09,0.05,0.09,Matches,Waldemar Anton,D C,26,132,137,"Germany,Russia,Uzbekistan",VfB Stuttgart,5,9,9,8,11,5,14,8,10,13,12,7,14,11,12,15,14,13,12,12,13,13,7,13,8,15,16,12,11,11,13,15,16,13,14,13,15,9,14,4,16,1,2,3,1,1,3,2,3,4,2,2,10,15,2,15,14,17,15,17,1,10,20,12,8,8,15,1,10,1,1,1,1,1,189,84,10,20,4522165,6500,6450,5000,Northern_European,131,3,1996/7/20,0,0,23972.0,,91137493
9,Christopher Antwi-Adjei,Bochum,1994,17.0,gh GHA,FWMF,28.0,22.0,23.0,15.0,7.0,8.0,8.0,10.0,29.0,34.5,19.0,17.0,0.0,17.0,5.0,28.0,16.0,0.0,Matches,17.0,gh GHA,FWMF,28.0,22.0,79.0,3.59,46.0,16.0,5.0,3.0,9.0,0.0,12.0,0.54,7.0,1.0,2.0,0.0,2.0,0.0,Matches,,,,,,,,,,,,,,,,,,,,,,,,,,,,,,,,,,,,,,,,,,,,,,,,,,,,,,,,17.0,gh GHA,FWMF,28.0,22.0,2.0,0.0,0.0,24.0,40.0,15.0,63.0,5.0,15.0,1.0,0.0,0.0,109.0,16.0,45.0,26.2,Matches,17.0,gh GHA,FWMF,28.0,22.0,712.0,513.0,195.0,3.0,2.0,2.0,63.0,180.0,4.0,0.0,0.0,0.0,432.0,4.0,32.0,Matches,17.0,gh GHA,FWMF,28.0,22.0,432.0,712.0,60.7,6857.0,2576.0,234.0,287.0,81.5,145.0,243.0,59.7,37.0,116.0,31.9,6.0,3.8,3.8,2.2,33.0,17.0,30.0,15.0,36.0,Matches,18,gh GHA,FWMF,28,29,1981.0,68.0,64.7,22.0,22,81.0,10,7,29.0,2,1.21,32.0,40.0,-8.0,-0.36,1.64,29.3,38.3,-9.0,-0.41,0.99,Matches,17.0,gh GHA,FWMF,28.0,22.0,996.0,7.0,102.0,304.0,605.0,63.0,996.0,80.0,31.0,38.8,39.0,48.8,525.0,3766.0,1485.0,67.0,49.0,20.0,89.0,32.0,560.0,231.0,Matches,17.0,gh GHA,FWMF,28.0,22.0,3.0,29.0,8.0,27.6,1.32,0.36,0.1,0.38,20.6,0.0,0.0,0.0,2.2,2.2,0.08,0.8,0.8,Matches,17.0,gh GHA,FWMF,28.0,29.0,22.0,1981.0,22.0,3.0,6.0,9.0,3.0,0.0,0.0,2.0,0.0,2.2,2.2,3.8,6.0,67.0,36.0,231.0,0.14,0.27,0.41,0.14,0.41,0.1,0.17,0.27,0.1,0.27,Matches,Christopher Antwi-Adjei,M/AM RL,28,120,128,"Ghana,Germany",VfL Bochum 1848,10,9,14,11,11,8,5,11,13,6,11,9,7,13,15,10,8,10,10,11,11,12,14,7,13,7,14,11,15,14,10,7,13,15,13,8,8,6,11,4,14,1,1,2,1,2,1,4,2,2,2,1,9,13,6,10,10,14,14,16,1,1,1,1,10,1,1,20,1,16,20,10,16,10,173,72,12,20,1420183,6000,6000,5100,African_Caribbean,110,17,1994/2/7,3,0,3836.0,,92091353
10,Maximilian Arnold,Wolfsburg,1994,19.0,de GER,MF,28.0,30.7,62.0,31.0,25.0,28.0,9.0,28.0,54.0,51.9,26.0,34.0,11.0,23.0,26.0,88.0,65.0,2.0,Matches,19.0,de GER,MF,28.0,30.7,82.0,2.67,41.0,35.0,1.0,3.0,2.0,0.0,10.0,0.33,5.0,3.0,0.0,1.0,1.0,0.0,Matches,,,,,,,,,,,,,,,,,,,,,,,,,,,,,,,,,,,,,,,,,,,,,,,,,,,,,,,,19.0,de GER,MF,28.0,30.7,5.0,0.0,0.0,33.0,64.0,0.0,154.0,26.0,31.0,0.0,0.0,1.0,225.0,30.0,30.0,50.0,Matches,19.0,de GER,MF,28.0,30.7,1642.0,1335.0,296.0,177.0,6.0,32.0,154.0,9.0,87.0,57.0,28.0,0.0,1269.0,11.0,9.0,Matches,19.0,de GER,MF,28.0,30.7,1269.0,1642.0,77.3,28055.0,8726.0,360.0,405.0,88.9,645.0,741.0,87.0,247.0,448.0,55.1,3.0,4.9,4.9,-1.9,43.0,115.0,19.0,2.0,150.0,Matches,21,de GER,MF,28,32,2767.0,86.0,90.4,30.7,32,86.0,24,0,,0,1.47,53.0,44.0,9.0,0.29,0.29,46.8,45.3,1.5,0.05,0.51,Matches,19.0,de GER,MF,28.0,30.7,1927.0,113.0,470.0,1108.0,364.0,11.0,1922.0,17.0,8.0,47.1,5.0,29.4,974.0,4616.0,2330.0,29.0,25.0,1.0,18.0,22.0,1064.0,19.0,Matches,19.0,de GER,MF,28.0,30.7,5.0,29.0,12.0,41.4,0.94,0.39,0.07,0.17,31.4,6.0,3.0,5.0,5.0,1.0,0.04,0.0,1.0,Matches,19.0,de GER,MF,28.0,32.0,32.0,2767.0,30.7,5.0,3.0,8.0,2.0,3.0,5.0,5.0,0.0,5.0,1.0,4.9,5.9,29.0,150.0,19.0,0.16,0.1,0.26,0.07,0.16,0.16,0.16,0.32,0.03,0.19,Matches,Maximilian Arnold,DM/M/AM C,28,143,148,Germany,VfL Wolfsburg,17,13,11,11,13,17,10,17,4,12,14,13,12,14,16,12,13,14,13,14,13,14,10,14,13,13,15,17,12,11,13,11,17,12,17,11,13,16,16,4,16,2,1,1,1,3,3,3,2,1,4,1,11,16,12,19,16,16,7,8,1,8,1,1,8,1,18,10,20,10,10,16,10,1,184,74,20,12,18197746,7150,7150,6150,Northern_European,141,2,1994/5/27,3,0,76711.0,,91100466
11,Takuma Asano,Bochum,1994,20.0,jp JPN,FWMF,27.0,19.0,14.0,9.0,4.0,4.0,6.0,7.0,16.0,43.8,9.0,17.0,1.0,16.0,8.0,22.0,8.0,0.0,Matches,20.0,jp JPN,FWMF,27.0,19.0,56.0,2.94,39.0,1.0,2.0,7.0,6.0,1.0,8.0,0.42,6.0,0.0,1.0,1.0,0.0,0.0,Matches,,,,,,,,,,,,,,,,,,,,,,,,,,,,,,,,,,,,,,,,,,,,,,,,,,,,,,,,20.0,jp JPN,FWMF,27.0,19.0,1.0,0.0,0.0,10.0,24.0,7.0,28.0,8.0,9.0,0.0,0.0,0.0,82.0,19.0,28.0,40.4,Matches,20.0,jp JPN,FWMF,27.0,19.0,342.0,336.0,4.0,1.0,2.0,0.0,28.0,2.0,1.0,0.0,0.0,0.0,237.0,2.0,16.0,Matches,20.0,jp JPN,FWMF,27.0,19.0,237.0,342.0,69.3,3302.0,967.0,147.0,183.0,80.3,72.0,98.0,73.5,8.0,23.0,34.8,3.0,2.1,2.1,0.9,22.0,18.0,18.0,7.0,34.0,Matches,22,jp JPN,FWMF,27,25,1713.0,69.0,56.0,19.0,21,75.0,4,4,33.0,0,0.88,24.0,38.0,-14.0,-0.74,0.47,26.8,37.4,-10.6,-0.56,0.45,Matches,20.0,jp JPN,FWMF,27.0,19.0,556.0,12.0,65.0,213.0,289.0,80.0,556.0,35.0,13.0,37.1,16.0,45.7,343.0,2354.0,919.0,32.0,19.0,16.0,62.0,31.0,391.0,119.0,Matches,20.0,jp JPN,FWMF,27.0,19.0,3.0,53.0,18.0,34.0,2.78,0.95,0.06,0.17,16.1,0.0,0.0,0.0,5.6,5.6,0.11,-2.6,-2.6,Matches,20.0,jp JPN,FWMF,27.0,25.0,21.0,1713.0,19.0,3.0,3.0,6.0,3.0,0.0,0.0,1.0,0.0,5.6,5.6,2.1,7.7,32.0,34.0,119.0,0.16,0.16,0.32,0.16,0.32,0.29,0.11,0.41,0.29,0.41,Matches,Takuma Asano,AM/S RL,27,127,129,Japan,VfL Bochum 1848,7,8,12,12,11,7,11,8,4,6,10,12,7,12,14,13,12,10,10,10,9,13,11,8,14,7,10,15,16,16,10,9,12,16,13,9,12,5,12,6,13,1,3,1,3,1,3,2,4,3,3,1,11,14,12,13,11,10,12,15,1,1,1,1,1,1,1,11,1,12,19,10,20,16,173,71,10,20,1647745,5995,6695,4495,10,116,7,1994/11/10,36,7,7758.0,,45078327
12,Sardar Azmoun,Leverkusen,1995,24.0,ir IRN,FWMF,27.0,10.3,6.0,3.0,1.0,4.0,1.0,1.0,7.0,14.3,6.0,4.0,0.0,4.0,2.0,8.0,14.0,0.0,Matches,24.0,ir IRN,FWMF,27.0,10.3,33.0,3.21,27.0,0.0,1.0,2.0,1.0,2.0,4.0,0.39,1.0,0.0,1.0,1.0,0.0,1.0,Matches,,,,,,,,,,,,,,,,,,,,,,,,,,,,,,,,,,,,,,,,,,,,,,,,,,,,,,,,24.0,ir IRN,FWMF,27.0,10.3,1.0,0.0,0.0,17.0,1.0,8.0,0.0,2.0,3.0,1.0,0.0,0.0,33.0,22.0,46.0,32.4,Matches,24.0,ir IRN,FWMF,27.0,10.3,247.0,232.0,13.0,0.0,2.0,0.0,0.0,1.0,0.0,0.0,0.0,0.0,162.0,2.0,10.0,Matches,24.0,ir IRN,FWMF,27.0,10.3,162.0,247.0,65.6,2373.0,844.0,89.0,130.0,68.5,41.0,56.0,73.2,15.0,20.0,75.0,1.0,2.5,1.4,-1.5,14.0,23.0,9.0,0.0,32.0,Matches,27,ir IRN,FWMF,27,23,927.0,40.0,30.3,10.3,8,81.0,3,15,19.0,3,1.22,13.0,17.0,-4.0,-0.39,-0.89,17.8,13.6,4.2,0.41,0.22,Matches,24.0,ir IRN,FWMF,27.0,10.3,344.0,13.0,43.0,175.0,135.0,48.0,344.0,11.0,6.0,54.5,5.0,45.5,167.0,769.0,343.0,11.0,8.0,8.0,23.0,10.0,256.0,45.0,Matches,24.0,ir IRN,FWMF,27.0,10.3,4.0,28.0,10.0,35.7,2.72,0.97,0.14,0.4,12.1,0.0,0.0,0.0,3.5,3.5,0.13,0.5,0.5,Matches,24.0,ir IRN,FWMF,27.0,23.0,8.0,927.0,10.3,4.0,1.0,5.0,4.0,0.0,0.0,1.0,0.0,3.5,3.5,2.5,6.0,11.0,32.0,45.0,0.39,0.1,0.49,0.39,0.49,0.34,0.24,0.58,0.34,0.58,Matches,Sardar Azmoun,S,27,140,143,Iran,Bayer 04 Leverkusen,10,9,11,15,14,7,13,11,10,10,12,13,9,14,12,13,12,12,13,11,14,14,12,10,16,11,13,9,14,13,12,15,13,16,14,11,12,9,17,5,14,1,3,1,3,3,1,3,4,2,3,3,12,14,6,10,9,10,13,9,1,1,1,1,1,1,1,1,1,1,5,12,7,20,186,82,11,20,14521758,6997,7497,6247,North_African__Middle_Eastern,139,1,1995/1/1,63,40,63287.0,,58098760
13,Mitchel Bakker,Leverkusen,2000,26.0,nl NED,DFMF,22.0,18.4,16.0,8.0,9.0,7.0,0.0,6.0,15.0,40.0,9.0,20.0,2.0,18.0,15.0,31.0,20.0,2.0,Matches,26.0,nl NED,DFMF,22.0,18.4,37.0,2.01,30.0,4.0,0.0,0.0,2.0,1.0,4.0,0.22,3.0,0.0,0.0,0.0,0.0,1.0,Matches,,,,,,,,,,,,,,,,,,,,,,,,,,,,,,,,,,,,,,,,,,,,,,,,,,,,,,,,26.0,nl NED,DFMF,22.0,18.4,6.0,1.0,1.0,18.0,14.0,2.0,26.0,15.0,8.0,0.0,0.0,0.0,114.0,12.0,13.0,48.0,Matches,26.0,nl NED,DFMF,22.0,18.4,968.0,790.0,177.0,14.0,1.0,8.0,26.0,162.0,1.0,0.0,0.0,0.0,764.0,1.0,20.0,Matches,26.0,nl NED,DFMF,22.0,18.4,764.0,968.0,78.9,11670.0,3583.0,443.0,505.0,87.7,258.0,328.0,78.7,47.0,93.0,50.5,2.0,2.0,1.3,0.0,17.0,36.0,14.0,2.0,57.0,Matches,30,nl NED,DFMF,22,28,1659.0,59.0,54.2,18.4,19,80.0,11,9,15.0,4,1.5,33.0,28.0,5.0,0.27,0.08,25.1,22.9,2.2,0.12,-0.29,Matches,26.0,nl NED,DFMF,22.0,18.4,1139.0,32.0,331.0,570.0,250.0,29.0,1139.0,39.0,11.0,28.2,21.0,53.8,575.0,2706.0,1353.0,28.0,17.0,8.0,23.0,15.0,702.0,65.0,Matches,26.0,nl NED,DFMF,22.0,18.4,3.0,17.0,8.0,47.1,0.92,0.43,0.18,0.38,18.9,0.0,0.0,0.0,1.7,1.7,0.1,1.3,1.3,Matches,26.0,nl NED,DFMF,22.0,28.0,19.0,1659.0,18.4,3.0,2.0,5.0,3.0,0.0,0.0,6.0,1.0,1.7,1.7,2.0,3.6,28.0,57.0,65.0,0.16,0.11,0.27,0.16,0.27,0.09,0.11,0.2,0.09,0.2,Matches,Mitchel Bakker,D/WB LC,22,131,145,Holland,Bayer 04 Leverkusen,10,13,11,8,12,12,12,11,10,11,12,10,13,12,14,11,14,13,11,11,11,13,11,9,13,12,14,14,14,12,15,13,12,16,14,14,13,12,12,6,8,3,3,1,1,2,1,1,3,4,2,3,12,14,10,11,11,13,10,10,1,20,15,1,17,1,10,12,1,1,1,1,1,1,185,87,20,8,5400000,6548,5998,5248,Northern_European,126,2,2000/6/20,0,0,28766.0,,37063645
14,Ridle Baku,Wolfsburg,1998,27.0,de GER,DFFW,24.0,28.7,50.0,26.0,29.0,17.0,4.0,32.0,58.0,55.2,26.0,44.0,6.0,38.0,21.0,71.0,59.0,0.0,Matches,27.0,de GER,DFFW,24.0,28.7,64.0,2.23,50.0,2.0,4.0,4.0,4.0,0.0,7.0,0.24,5.0,0.0,1.0,1.0,0.0,0.0,Matches,,,,,,,,,,,,,,,,,,,,,,,,,,,,,,,,,,,,,,,,,,,,,,,,,,,,,,,,27.0,de GER,DFFW,24.0,28.7,6.0,0.0,0.0,27.0,32.0,4.0,70.0,21.0,26.0,0.0,0.0,0.0,156.0,22.0,31.0,41.5,Matches,27.0,de GER,DFFW,24.0,28.7,1551.0,1286.0,258.0,24.0,2.0,7.0,70.0,232.0,2.0,2.0,0.0,0.0,1216.0,7.0,34.0,Matches,27.0,de GER,DFFW,24.0,28.7,1216.0,1551.0,78.4,22159.0,7294.0,486.0,563.0,86.3,593.0,719.0,82.5,121.0,202.0,59.9,3.0,4.1,5.0,-1.1,28.0,116.0,37.0,14.0,126.0,Matches,31,de GER,DFFW,24,33,2580.0,78.0,84.3,28.7,29,86.0,23,4,25.0,0,1.48,52.0,41.0,11.0,0.38,0.76,44.3,42.9,1.4,0.05,0.32,Matches,27.0,de GER,DFFW,24.0,28.7,1889.0,80.0,521.0,880.0,498.0,45.0,1889.0,61.0,23.0,37.7,27.0,44.3,1052.0,4917.0,2381.0,50.0,23.0,8.0,59.0,20.0,1155.0,157.0,Matches,27.0,de GER,DFFW,24.0,28.7,5.0,28.0,12.0,42.9,0.98,0.42,0.18,0.42,19.1,0.0,0.0,0.0,2.9,2.9,0.1,2.1,2.1,Matches,27.0,de GER,DFFW,24.0,33.0,29.0,2580.0,28.7,5.0,3.0,8.0,5.0,0.0,0.0,6.0,0.0,2.9,2.9,4.1,7.0,50.0,126.0,157.0,0.17,0.1,0.28,0.17,0.28,0.1,0.14,0.24,0.1,0.24,Matches,Ridle Baku,D/WB RC,24,141,154,"Germany,Democratic Republic of Congo",VfL Wolfsburg,7,12,13,11,12,7,7,12,8,11,12,6,13,12,13,12,15,12,10,12,12,16,13,6,16,12,16,17,15,12,12,8,18,15,15,12,12,7,15,5,20,2,1,2,2,2,1,3,2,2,2,1,14,17,6,12,14,12,12,12,1,12,10,20,10,18,10,10,15,15,14,10,15,1,176,72,13,20,13342257,7050,7050,6500,African_Caribbean,127,16,1998/4/8,4,1,38355.0,,92079338
15,Maximilian Bauer,Augsburg,2000,31.0,de GER,DF,22.0,20.5,31.0,17.0,18.0,12.0,1.0,17.0,34.0,50.0,17.0,25.0,9.0,16.0,23.0,54.0,79.0,1.0,Matches,31.0,de GER,DF,22.0,20.5,15.0,0.73,5.0,2.0,0.0,4.0,3.0,1.0,1.0,0.05,0.0,1.0,0.0,0.0,0.0,0.0,Matches,,,,,,,,,,,,,,,,,,,,,,,,,,,,,,,,,,,,,,,,,,,,,,,,,,,,,,,,31.0,de GER,DF,22.0,20.5,8.0,0.0,0.0,24.0,23.0,1.0,2.0,23.0,17.0,0.0,1.0,0.0,105.0,71.0,51.0,58.2,Matches,31.0,de GER,DF,22.0,20.5,758.0,722.0,34.0,28.0,0.0,7.0,2.0,6.0,0.0,0.0,0.0,0.0,551.0,2.0,11.0,Matches,31.0,de GER,DF,22.0,20.5,551.0,758.0,72.7,11267.0,4449.0,177.0,208.0,85.1,290.0,342.0,84.8,74.0,178.0,41.6,1.0,0.4,0.2,0.6,4.0,30.0,2.0,0.0,40.0,Matches,35,de GER,DF,22,27,1846.0,68.0,60.3,20.5,20,84.0,17,7,25.0,6,1.11,25.0,41.0,-16.0,-0.78,-0.41,21.0,36.5,-15.5,-0.76,-0.13,Matches,31.0,de GER,DF,22.0,20.5,982.0,135.0,590.0,362.0,36.0,13.0,982.0,5.0,2.0,40.0,1.0,20.0,461.0,2267.0,1272.0,11.0,8.0,0.0,10.0,5.0,501.0,2.0,Matches,31.0,de GER,DF,22.0,20.5,0.0,8.0,0.0,0.0,0.39,0.0,0.0,,8.5,0.0,0.0,0.0,1.6,1.6,0.2,-1.6,-1.6,Matches,31.0,de GER,DF,22.0,27.0,20.0,1846.0,20.5,0.0,1.0,1.0,0.0,0.0,0.0,8.0,0.0,1.6,1.6,0.4,2.0,11.0,40.0,2.0,0.0,0.05,0.05,0.0,0.05,0.08,0.02,0.1,0.08,0.1,Matches,Maximilian Bauer,D C,22,113,136,Germany,FC Augsburg,4,5,7,6,10,4,13,7,8,14,12,9,13,11,10,11,14,13,12,11,12,14,6,11,5,12,14,11,10,10,14,14,14,12,13,14,13,10,14,6,6,1,4,3,2,3,4,2,1,3,3,4,7,14,8,11,15,13,10,12,1,1,20,1,1,1,1,1,1,1,1,1,1,1,189,82,10,20,2649999,5890,5890,3747,Northern_European,113,3,2000/2/9,0,0,4499.0,,91188907
16,Oliver Baumann,Hoffenheim,1990,32.0,de GER,GK,32.0,34.0,0.0,0.0,0.0,0.0,0.0,0.0,0.0,,0.0,0.0,0.0,0.0,0.0,0.0,15.0,1.0,Matches,32.0,de GER,GK,32.0,34.0,4.0,0.12,3.0,1.0,0.0,0.0,0.0,0.0,1.0,0.03,1.0,0.0,0.0,0.0,0.0,0.0,Matches,1.0,de GER,GK,32.0,34.0,57.0,2.0,1.0,11.0,1.0,50.4,0.31,-5.6,-0.16,206.0,525.0,39.2,1164.0,168.0,35.3,33.6,249.0,45.8,39.3,529.0,43.0,8.1,43.0,1.26,13.4,Matches,1.0,de GER,GK,32.0,34.0,34.0,3060.0,34.0,57.0,1.68,161.0,105.0,65.8,10.0,6.0,18.0,5.0,14.7,3.0,2.0,0.0,1.0,0.0,Matches,32.0,de GER,GK,32.0,34.0,2.0,0.0,0.0,0.0,0.0,0.0,0.0,0.0,0.0,0.0,0.0,0.0,71.0,16.0,0.0,100.0,Matches,32.0,de GER,GK,32.0,34.0,1417.0,1081.0,332.0,83.0,0.0,6.0,0.0,0.0,0.0,0.0,0.0,0.0,1068.0,4.0,1.0,Matches,32.0,de GER,GK,32.0,34.0,1068.0,1417.0,75.4,29033.0,20956.0,239.0,239.0,100.0,489.0,493.0,99.2,331.0,670.0,49.4,0.0,0.0,0.1,0.0,1.0,28.0,1.0,0.0,1.0,Matches,36,de GER,GK,32,34,3060.0,90.0,100.0,34.0,34,90.0,34,0,,0,1.06,48.0,57.0,-9.0,-0.26,,48.0,51.1,-3.1,-0.09,,Matches,32.0,de GER,GK,32.0,34.0,1503.0,1219.0,1489.0,15.0,0.0,0.0,1503.0,0.0,0.0,,0.0,,903.0,4083.0,2259.0,0.0,0.0,0.0,0.0,0.0,757.0,0.0,Matches,32.0,de GER,GK,32.0,34.0,0.0,0.0,0.0,,0.0,0.0,,,,0.0,0.0,0.0,0.0,0.0,,0.0,0.0,Matches,32.0,de GER,GK,32.0,34.0,34.0,3060.0,34.0,0.0,0.0,0.0,0.0,0.0,0.0,2.0,0.0,0.0,0.0,0.0,0.0,0.0,1.0,0.0,0.0,0.0,0.0,0.0,0.0,0.0,0.0,0.0,0.0,0.0,Matches,Oliver Baumann,GK,32,137,142,Germany,TSG Hoffenheim,5,3,1,3,9,6,6,3,1,3,8,3,3,9,8,16,11,13,16,7,12,13,4,11,3,8,17,10,12,14,12,14,16,10,12,14,17,5,14,4,14,13,10,14,8,16,11,16,16,16,8,15,8,14,6,14,12,18,16,10,20,1,1,1,1,1,1,1,1,1,1,1,1,1,187,82,7,20,5931272,6734,6734,5984,Northern_European,133,2,1990/6/2,0,0,57692.0,,35017377
17,Christoph Baumgartner,Hoffenheim,1999,35.0,at AUT,MFFW,22.0,28.5,36.0,19.0,12.0,17.0,7.0,9.0,52.0,17.3,43.0,57.0,5.0,52.0,15.0,51.0,19.0,1.0,Matches,35.0,at AUT,MFFW,22.0,28.5,89.0,3.12,60.0,0.0,11.0,5.0,12.0,1.0,12.0,0.42,5.0,0.0,2.0,1.0,4.0,0.0,Matches,,,,,,,,,,,,,,,,,,,,,,,,,,,,,,,,,,,,,,,,,,,,,,,,,,,,,,,,35.0,at AUT,MFFW,22.0,28.5,7.0,0.0,0.0,66.0,49.0,9.0,29.0,15.0,19.0,5.0,0.0,0.0,142.0,72.0,75.0,49.0,Matches,35.0,at AUT,MFFW,22.0,28.5,915.0,850.0,56.0,10.0,4.0,9.0,29.0,31.0,1.0,0.0,0.0,0.0,610.0,9.0,42.0,Matches,35.0,at AUT,MFFW,22.0,28.5,610.0,915.0,66.7,9280.0,2767.0,340.0,449.0,75.7,188.0,257.0,73.2,47.0,86.0,54.7,3.0,4.3,4.3,-1.3,24.0,70.0,35.0,4.0,100.0,Matches,39,at AUT,MFFW,22,33,2567.0,78.0,83.9,28.5,33,78.0,14,0,,0,1.09,40.0,49.0,-9.0,-0.32,-0.32,42.0,42.8,-0.8,-0.03,0.38,Matches,35.0,at AUT,MFFW,22.0,28.5,1340.0,39.0,204.0,655.0,505.0,118.0,1340.0,116.0,54.0,46.6,47.0,40.5,767.0,4948.0,2487.0,76.0,59.0,33.0,81.0,36.0,900.0,145.0,Matches,35.0,at AUT,MFFW,22.0,28.5,7.0,66.0,19.0,28.8,2.31,0.67,0.11,0.37,15.7,0.0,0.0,0.0,7.1,7.1,0.11,-0.1,-0.1,Matches,35.0,at AUT,MFFW,22.0,33.0,33.0,2567.0,28.5,7.0,3.0,10.0,7.0,0.0,0.0,7.0,0.0,7.1,7.1,4.3,11.4,76.0,100.0,145.0,0.25,0.11,0.35,0.25,0.35,0.25,0.15,0.4,0.25,0.4,Matches,Christoph Baumgartner,M/AM LC,22,134,148,Austria,TSG Hoffenheim,13,9,13,13,14,12,11,13,5,9,13,13,9,15,16,14,13,14,12,15,12,17,12,8,16,10,14,16,13,13,13,10,14,13,13,9,14,12,14,7,11,1,2,2,1,2,3,1,2,3,3,1,13,15,7,10,12,15,12,14,1,1,1,1,1,1,12,12,18,12,16,20,14,13,180,71,10,20,20987999,6749,6018,5409,Northern_European,134,4,1999/8/1,21,6,28766.0,,16184707
18,Ihlas Bebou,Hoffenheim,1994,37.0,tg TOG,FWDF,28.0,15.7,19.0,16.0,8.0,7.0,4.0,11.0,17.0,64.7,6.0,9.0,2.0,7.0,7.0,26.0,15.0,0.0,Matches,37.0,tg TOG,FWDF,28.0,15.7,45.0,2.86,30.0,0.0,9.0,1.0,5.0,0.0,5.0,0.32,2.0,0.0,2.0,0.0,1.0,0.0,Matches,,,,,,,,,,,,,,,,,,,,,,,,,,,,,,,,,,,,,,,,,,,,,,,,,,,,,,,,37.0,tg TOG,FWDF,28.0,15.7,2.0,0.0,0.0,22.0,9.0,8.0,11.0,7.0,16.0,1.0,1.0,0.0,65.0,28.0,54.0,34.1,Matches,37.0,tg TOG,FWDF,28.0,15.7,369.0,336.0,30.0,0.0,0.0,2.0,11.0,21.0,0.0,0.0,0.0,0.0,246.0,3.0,12.0,Matches,37.0,tg TOG,FWDF,28.0,15.7,246.0,369.0,66.7,3282.0,756.0,157.0,208.0,75.5,60.0,88.0,68.2,13.0,25.0,52.0,0.0,1.0,1.4,-1.0,15.0,11.0,5.0,0.0,23.0,Matches,42,tg TOG,FWDF,28,19,1416.0,75.0,46.3,15.7,17,79.0,6,2,39.0,0,0.95,21.0,25.0,-4.0,-0.25,0.02,19.5,24.9,-5.4,-0.34,-0.47,Matches,37.0,tg TOG,FWDF,28.0,15.7,576.0,22.0,63.0,235.0,288.0,69.0,575.0,58.0,26.0,44.8,30.0,51.7,307.0,1655.0,680.0,27.0,19.0,15.0,61.0,17.0,376.0,116.0,Matches,37.0,tg TOG,FWDF,28.0,15.7,7.0,28.0,13.0,46.4,1.78,0.83,0.21,0.46,15.0,0.0,1.0,1.0,4.6,3.8,0.14,2.4,2.2,Matches,37.0,tg TOG,FWDF,28.0,19.0,17.0,1416.0,15.7,7.0,0.0,7.0,6.0,1.0,1.0,2.0,0.0,4.6,3.8,1.0,4.8,27.0,23.0,116.0,0.44,0.0,0.44,0.38,0.38,0.29,0.06,0.36,0.24,0.31,Matches,Ihlas Bebou,M/AM/S RL,28,136,140,"Togo,Germany",TSG Hoffenheim,8,10,14,13,12,8,9,9,8,7,12,13,8,14,11,12,13,10,12,11,10,11,15,6,14,7,11,13,15,14,14,12,13,17,13,12,12,7,11,12,16,2,2,3,3,2,2,2,3,4,2,3,10,14,8,9,12,13,12,10,1,1,1,1,10,10,1,12,1,16,16,10,19,20,185,78,9,20,3380204,6650,6650,6250,African_Caribbean,122,17,1994/4/23,26,1,48051.0,,91132870
19,Sheraldo Becker,Union Berlin,1995,38.0,sr SUR,FW,27.0,28.4,15.0,5.0,1.0,7.0,7.0,2.0,11.0,18.2,9.0,13.0,1.0,12.0,3.0,18.0,7.0,1.0,Matches,38.0,sr SUR,FW,27.0,28.4,90.0,3.17,74.0,0.0,6.0,4.0,6.0,0.0,13.0,0.46,12.0,0.0,0.0,1.0,0.0,0.0,Matches,,,,,,,,,,,,,,,,,,,,,,,,,,,,,,,,,,,,,,,,,,,,,,,,,,,,,,,,38.0,sr SUR,FW,27.0,28.4,4.0,0.0,0.0,29.0,26.0,25.0,139.0,3.0,5.0,1.0,0.0,0.0,86.0,16.0,49.0,24.6,Matches,38.0,sr SUR,FW,27.0,28.4,652.0,631.0,17.0,3.0,1.0,1.0,139.0,10.0,2.0,0.0,0.0,0.0,387.0,4.0,44.0,Matches,38.0,sr SUR,FW,27.0,28.4,387.0,652.0,59.4,6499.0,1541.0,183.0,271.0,67.5,140.0,220.0,63.6,47.0,85.0,55.3,7.0,5.6,5.6,1.4,44.0,20.0,44.0,30.0,44.0,Matches,43,sr SUR,FW,27,34,2554.0,75.0,83.5,28.4,33,76.0,4,1,33.0,0,1.82,41.0,32.0,9.0,0.32,-0.39,29.9,36.1,-6.3,-0.22,-0.5,Matches,38.0,sr SUR,FW,27.0,28.4,908.0,7.0,57.0,263.0,602.0,117.0,908.0,59.0,26.0,44.1,28.0,47.5,617.0,4379.0,2043.0,105.0,48.0,45.0,62.0,35.0,679.0,240.0,Matches,38.0,sr SUR,FW,27.0,28.4,11.0,67.0,26.0,38.8,2.36,0.92,0.16,0.42,18.3,0.0,0.0,0.0,6.5,6.5,0.1,4.5,4.5,Matches,38.0,sr SUR,FW,27.0,34.0,33.0,2554.0,28.4,11.0,7.0,18.0,11.0,0.0,0.0,4.0,0.0,6.5,6.5,5.6,12.1,105.0,44.0,240.0,0.39,0.25,0.63,0.39,0.63,0.23,0.2,0.42,0.23,0.42,Matches,Sheraldo Becker,M/AM/S RL,27,140,140,"Suriname,Holland",1. FC Union Berlin,6,13,13,13,13,10,8,9,5,6,12,9,7,14,14,11,13,12,12,12,11,13,14,7,13,6,13,14,17,13,12,11,14,17,13,11,11,6,12,12,11,3,3,2,2,3,3,2,2,3,3,3,15,16,10,8,13,14,9,8,1,1,1,1,1,1,1,10,1,17,16,10,20,18,180,78,8,20,12378126,6994,6218,5334,African_Caribbean,131,16,1995/2/9,5,2,28766.0,,37027194
20,Kevin Behrens,Union Berlin,1991,39.0,de GER,FW,31.0,17.1,11.0,7.0,4.0,4.0,3.0,4.0,18.0,22.2,14.0,18.0,3.0,15.0,5.0,16.0,25.0,0.0,Matches,39.0,de GER,FW,31.0,17.1,49.0,2.87,39.0,0.0,4.0,0.0,5.0,1.0,8.0,0.47,5.0,0.0,2.0,0.0,1.0,0.0,Matches,,,,,,,,,,,,,,,,,,,,,,,,,,,,,,,,,,,,,,,,,,,,,,,,,,,,,,,,39.0,de GER,FW,31.0,17.1,6.0,0.0,0.0,35.0,26.0,12.0,8.0,5.0,7.0,0.0,0.0,0.0,43.0,176.0,145.0,54.8,Matches,39.0,de GER,FW,31.0,17.1,483.0,471.0,8.0,0.0,2.0,0.0,8.0,3.0,0.0,0.0,0.0,0.0,283.0,4.0,11.0,Matches,39.0,de GER,FW,31.0,17.1,283.0,483.0,58.6,4058.0,1156.0,161.0,249.0,64.7,89.0,145.0,61.4,19.0,28.0,67.9,1.0,1.3,1.6,-0.3,21.0,31.0,26.0,1.0,71.0,Matches,44,de GER,FW,31,33,1535.0,47.0,50.2,17.1,17,71.0,1,16,21.0,0,1.85,30.0,23.0,7.0,0.41,0.06,18.7,21.5,-2.8,-0.16,-0.05,Matches,39.0,de GER,FW,31.0,17.1,687.0,30.0,53.0,312.0,327.0,83.0,687.0,24.0,12.0,50.0,8.0,33.3,306.0,1254.0,350.0,11.0,8.0,6.0,45.0,20.0,512.0,92.0,Matches,39.0,de GER,FW,31.0,17.1,8.0,35.0,14.0,40.0,2.05,0.82,0.23,0.57,11.7,0.0,0.0,0.0,4.8,4.8,0.14,3.2,3.2,Matches,39.0,de GER,FW,31.0,33.0,17.0,1535.0,17.1,8.0,1.0,9.0,8.0,0.0,0.0,6.0,0.0,4.8,4.8,1.3,6.1,11.0,71.0,92.0,0.47,0.06,0.53,0.47,0.53,0.28,0.07,0.35,0.28,0.35,Matches,Kevin Behrens,AM/S R,31,125,129,Germany,1. FC Union Berlin,7,6,9,12,12,5,13,9,5,7,11,10,6,11,13,12,16,11,11,13,12,14,11,12,14,7,15,15,13,12,15,15,12,13,15,16,13,10,10,6,14,2,3,1,2,1,2,1,3,2,1,2,6,12,10,10,12,11,12,10,1,1,1,1,1,1,1,13,1,13,13,13,16,20,183,78,10,20,1317496,6150,6150,4750,Northern_European,121,3,1991/2/3,0,0,6999.0,,91103807
21,Stefan Bell,Mainz 05,1991,40.0,de GER,DF,30.0,26.6,43.0,28.0,32.0,10.0,1.0,22.0,44.0,50.0,22.0,42.0,15.0,27.0,44.0,87.0,133.0,0.0,Matches,40.0,de GER,DF,30.0,26.6,17.0,0.64,16.0,0.0,0.0,1.0,0.0,0.0,3.0,0.11,2.0,0.0,0.0,1.0,0.0,0.0,Matches,,,,,,,,,,,,,,,,,,,,,,,,,,,,,,,,,,,,,,,,,,,,,,,,,,,,,,,,40.0,de GER,DF,30.0,26.6,9.0,0.0,0.0,47.0,11.0,4.0,15.0,44.0,28.0,0.0,0.0,0.0,191.0,103.0,65.0,61.3,Matches,40.0,de GER,DF,30.0,26.6,1248.0,1207.0,34.0,32.0,1.0,5.0,15.0,2.0,0.0,0.0,0.0,0.0,945.0,7.0,13.0,Matches,40.0,de GER,DF,30.0,26.6,945.0,1248.0,75.7,18036.0,8543.0,356.0,419.0,85.0,453.0,519.0,87.3,124.0,260.0,47.7,1.0,0.6,0.8,0.4,8.0,67.0,9.0,1.0,92.0,Matches,45,de GER,DF,30,30,2395.0,80.0,78.3,26.6,26,88.0,22,4,30.0,2,1.4,43.0,40.0,3.0,0.11,0.65,36.8,41.9,-5.1,-0.19,0.0,Matches,40.0,de GER,DF,30.0,26.6,1551.0,180.0,849.0,653.0,59.0,18.0,1551.0,7.0,6.0,85.7,0.0,0.0,767.0,3351.0,1604.0,9.0,6.0,0.0,13.0,4.0,760.0,10.0,Matches,40.0,de GER,DF,30.0,26.6,0.0,7.0,2.0,28.6,0.26,0.08,0.0,0.0,10.4,0.0,0.0,0.0,0.7,0.7,0.09,-0.7,-0.7,Matches,40.0,de GER,DF,30.0,30.0,26.0,2395.0,26.6,0.0,1.0,1.0,0.0,0.0,0.0,9.0,0.0,0.7,0.7,0.6,1.2,9.0,92.0,10.0,0.0,0.04,0.04,0.0,0.04,0.02,0.02,0.05,0.02,0.05,Matches,Stefan Bell,D C,30,130,132,Germany,1. FSV Mainz 05,3,6,7,7,10,3,16,6,6,15,11,6,14,10,16,14,17,13,15,10,13,13,7,14,8,15,16,12,9,8,15,18,16,11,13,14,15,10,17,9,10,1,3,2,4,2,3,2,3,3,2,2,6,12,6,18,14,18,12,15,1,1,20,12,1,1,1,1,1,1,1,1,1,1,192,88,8,20,2444155,6495,6495,4995,Northern_European,130,4,1991/8/24,0,0,28766.0,,91004660
22,Jude Bellingham,Dortmund,2003,42.0,eng ENG,MF,19.0,29.9,76.0,42.0,28.0,34.0,14.0,34.0,51.0,66.7,17.0,51.0,4.0,47.0,35.0,111.0,30.0,0.0,Matches,42.0,eng ENG,MF,19.0,29.9,125.0,4.18,89.0,0.0,16.0,8.0,10.0,2.0,17.0,0.57,12.0,0.0,3.0,0.0,2.0,0.0,Matches,,,,,,,,,,,,,,,,,,,,,,,,,,,,,,,,,,,,,,,,,,,,,,,,,,,,,,,,42.0,eng ENG,MF,19.0,29.9,8.0,0.0,0.0,41.0,73.0,3.0,33.0,35.0,42.0,2.0,0.0,0.0,198.0,34.0,33.0,50.7,Matches,42.0,eng ENG,MF,19.0,29.9,1643.0,1583.0,55.0,34.0,9.0,30.0,33.0,17.0,1.0,0.0,0.0,0.0,1342.0,5.0,37.0,Matches,42.0,eng ENG,MF,19.0,29.9,1342.0,1643.0,81.7,23692.0,7381.0,605.0,694.0,87.2,509.0,590.0,86.3,169.0,233.0,72.5,4.0,4.0,4.9,0.0,34.0,194.0,45.0,3.0,252.0,Matches,47,eng ENG,MF,19,31,2691.0,87.0,87.9,29.9,30,89.0,28,1,25.0,1,2.06,73.0,40.0,33.0,1.1,-0.36,60.1,39.0,21.0,0.7,-0.98,Matches,42.0,eng ENG,MF,19.0,29.9,2091.0,48.0,342.0,1171.0,606.0,105.0,2090.0,151.0,86.0,57.0,42.0,27.8,1342.0,7887.0,3912.0,97.0,50.0,24.0,63.0,58.0,1568.0,139.0,Matches,42.0,eng ENG,MF,19.0,29.9,8.0,66.0,23.0,34.8,2.21,0.77,0.11,0.3,18.0,2.0,1.0,1.0,8.2,7.4,0.11,-0.2,-0.4,Matches,42.0,eng ENG,MF,19.0,31.0,30.0,2691.0,29.9,8.0,4.0,12.0,7.0,1.0,1.0,8.0,0.0,8.2,7.4,4.0,11.4,97.0,252.0,139.0,0.27,0.13,0.4,0.23,0.37,0.27,0.14,0.41,0.25,0.38,Matches,Jude Bellingham,DM/M C,19,155,-95,England,Borussia Dortmund,10,11,16,13,16,8,12,12,6,12,15,5,13,16,17,14,18,15,12,13,13,20,16,14,14,10,15,17,15,15,14,12,16,15,16,11,14,10,14,5,14,3,1,4,3,2,1,1,1,3,2,1,13,15,13,16,18,18,12,6,1,1,1,1,1,1,18,12,20,12,10,13,10,1,186,75,11,20,122709606,7500,8000,7050,African_Caribbean,153,13,2003/6/29,15,0,56999.0,,29232937
23,Leonardo Bittencourt,Werder Bremen,1993,47.0,de GER,MFDF,28.0,18.1,53.0,28.0,20.0,25.0,8.0,25.0,62.0,40.3,37.0,13.0,0.0,13.0,10.0,63.0,15.0,0.0,Matches,47.0,de GER,MFDF,28.0,18.1,40.0,2.21,25.0,1.0,2.0,1.0,8.0,3.0,3.0,0.17,2.0,0.0,0.0,0.0,1.0,0.0,Matches,,,,,,,,,,,,,,,,,,,,,,,,,,,,,,,,,,,,,,,,,,,,,,,,,,,,,,,,47.0,de GER,MFDF,28.0,18.1,10.0,0.0,0.0,43.0,40.0,3.0,49.0,10.0,28.0,0.0,0.0,0.0,115.0,11.0,21.0,34.4,Matches,47.0,de GER,MFDF,28.0,18.1,792.0,756.0,35.0,3.0,2.0,6.0,49.0,31.0,1.0,1.0,0.0,0.0,579.0,1.0,28.0,Matches,47.0,de GER,MFDF,28.0,18.1,579.0,792.0,73.1,8839.0,2535.0,316.0,360.0,87.8,212.0,278.0,76.3,30.0,82.0,36.6,2.0,2.7,2.4,-0.7,15.0,44.0,26.0,5.0,74.0,Matches,55,de GER,MFDF,28,25,1629.0,65.0,53.2,18.1,22,71.0,4,3,26.0,1,1.12,26.0,27.0,-1.0,-0.06,0.7,18.9,23.5,-4.6,-0.25,0.2,Matches,47.0,de GER,MFDF,28.0,18.1,1031.0,19.0,176.0,568.0,303.0,38.0,1031.0,64.0,26.0,40.6,30.0,46.9,611.0,3691.0,1649.0,51.0,48.0,7.0,42.0,10.0,706.0,93.0,Matches,47.0,de GER,MFDF,28.0,18.1,3.0,25.0,9.0,36.0,1.38,0.5,0.12,0.33,22.3,2.0,0.0,0.0,1.4,1.4,0.05,1.6,1.6,Matches,47.0,de GER,MFDF,28.0,25.0,22.0,1629.0,18.1,3.0,2.0,5.0,3.0,0.0,0.0,10.0,0.0,1.4,1.4,2.7,4.0,51.0,74.0,93.0,0.17,0.11,0.28,0.17,0.28,0.08,0.15,0.22,0.08,0.22,Matches,Leonardo Bittencourt,M/AM RLC,28,130,135,"Germany,Brazil",SV Werder Bremen,14,14,15,11,13,11,8,11,5,6,12,10,8,13,16,11,14,9,10,12,10,15,15,13,13,7,12,15,15,15,11,6,14,14,11,7,11,9,12,14,17,1,2,1,2,3,1,2,1,1,4,3,9,16,10,12,11,13,11,8,1,1,1,1,1,1,1,20,12,15,20,18,15,10,170,62,12,20,3546515,6399,6549,5249,Mixed_Race,121,9,1993/12/19,0,0,42281.0,,92014331
24,Janis Blaswich,RB Leipzig,1991,48.0,de GER,GK,31.0,26.0,0.0,0.0,0.0,0.0,0.0,0.0,0.0,,0.0,0.0,0.0,0.0,0.0,0.0,10.0,0.0,Matches,48.0,de GER,GK,31.0,26.0,0.0,0.0,0.0,0.0,0.0,0.0,0.0,0.0,0.0,0.0,0.0,0.0,0.0,0.0,0.0,0.0,Matches,2.0,de GER,GK,31.0,26.0,29.0,6.0,0.0,2.0,0.0,26.9,0.27,-2.1,-0.08,59.0,189.0,31.2,985.0,126.0,14.9,25.3,156.0,26.9,30.0,288.0,20.0,6.9,39.0,1.5,17.0,Matches,2.0,de GER,GK,31.0,26.0,26.0,2340.0,26.0,29.0,1.12,75.0,45.0,69.3,16.0,4.0,6.0,7.0,26.9,7.0,6.0,1.0,0.0,14.3,Matches,48.0,de GER,GK,31.0,26.0,0.0,0.0,0.0,1.0,3.0,0.0,0.0,0.0,0.0,0.0,1.0,0.0,46.0,11.0,0.0,100.0,Matches,48.0,de GER,GK,31.0,26.0,1142.0,951.0,190.0,34.0,0.0,1.0,0.0,0.0,0.0,0.0,0.0,0.0,988.0,1.0,2.0,Matches,48.0,de GER,GK,31.0,26.0,988.0,1142.0,86.5,21548.0,10888.0,248.0,249.0,99.6,588.0,593.0,99.2,147.0,292.0,50.3,0.0,0.0,0.0,0.0,0.0,11.0,0.0,0.0,1.0,Matches,56,de GER,GK,31,26,2340.0,90.0,76.5,26.0,26,90.0,26,0,,7,2.0,48.0,29.0,19.0,0.73,0.23,49.3,27.0,22.3,0.86,0.46,Matches,48.0,de GER,GK,31.0,26.0,1191.0,846.0,1160.0,31.0,0.0,0.0,1191.0,1.0,1.0,100.0,0.0,0.0,786.0,2838.0,1493.0,0.0,0.0,0.0,0.0,0.0,752.0,0.0,Matches,48.0,de GER,GK,31.0,26.0,0.0,0.0,0.0,,0.0,0.0,,,,0.0,0.0,0.0,0.0,0.0,,0.0,0.0,Matches,48.0,de GER,GK,31.0,26.0,26.0,2340.0,26.0,0.0,0.0,0.0,0.0,0.0,0.0,0.0,0.0,0.0,0.0,0.0,0.0,0.0,1.0,0.0,0.0,0.0,0.0,0.0,0.0,0.0,0.0,0.0,0.0,0.0,Matches,Janis Blaswich,GK,31,120,122,Germany,RB Leipzig,4,2,1,2,8,7,8,3,1,3,8,3,1,7,10,12,12,12,13,7,12,12,2,8,3,12,12,12,10,12,11,15,12,10,12,14,13,5,10,9,11,13,13,13,9,13,13,14,15,12,9,10,9,11,5,15,13,14,14,15,20,1,1,1,1,1,1,1,1,1,1,1,1,1,193,88,7,20,513882,5750,5750,4500,Northern_European,119,2,1991/5/2,0,0,4999.0,,91017776
25,Jean-Paul Boëtius,Hertha BSC,1994,51.0,nl NED,MF,28.0,11.7,30.0,16.0,19.0,9.0,2.0,8.0,25.0,32.0,17.0,25.0,5.0,20.0,14.0,44.0,10.0,0.0,Matches,51.0,nl NED,MF,28.0,11.7,24.0,2.06,18.0,1.0,1.0,1.0,2.0,1.0,0.0,0.0,0.0,0.0,0.0,0.0,0.0,0.0,Matches,,,,,,,,,,,,,,,,,,,,,,,,,,,,,,,,,,,,,,,,,,,,,,,,,,,,,,,,51.0,nl NED,MF,28.0,11.7,3.0,0.0,0.0,14.0,26.0,0.0,5.0,14.0,16.0,0.0,0.0,0.0,76.0,5.0,16.0,23.8,Matches,51.0,nl NED,MF,28.0,11.7,421.0,390.0,26.0,19.0,4.0,7.0,5.0,0.0,0.0,0.0,0.0,0.0,303.0,5.0,7.0,Matches,51.0,nl NED,MF,28.0,11.7,303.0,421.0,72.0,5386.0,2162.0,127.0,158.0,80.4,117.0,154.0,76.0,41.0,68.0,60.3,0.0,0.7,0.9,-0.7,13.0,38.0,10.0,1.0,61.0,Matches,60,nl NED,MF,28,21,1050.0,50.0,34.3,11.7,10,74.0,3,11,28.0,3,1.05,13.0,23.0,-10.0,-0.86,-0.1,12.4,22.2,-9.9,-0.85,-0.37,Matches,51.0,nl NED,MF,28.0,11.7,564.0,25.0,152.0,313.0,108.0,7.0,564.0,17.0,7.0,41.2,7.0,41.2,275.0,1049.0,413.0,4.0,5.0,0.0,21.0,12.0,323.0,23.0,Matches,51.0,nl NED,MF,28.0,11.7,0.0,5.0,3.0,60.0,0.43,0.26,0.0,0.0,20.6,0.0,0.0,0.0,0.5,0.5,0.11,-0.5,-0.5,Matches,51.0,nl NED,MF,28.0,21.0,10.0,1050.0,11.7,0.0,0.0,0.0,0.0,0.0,0.0,3.0,0.0,0.5,0.5,0.7,1.2,4.0,61.0,23.0,0.0,0.0,0.0,0.0,0.0,0.05,0.06,0.1,0.05,0.1,Matches,Jean-Paul Boëtius,M/AM RLC,28,128,135,"Holland,Suriname",Hertha Berlin,13,13,13,11,14,12,7,12,3,10,13,12,12,14,14,12,11,12,10,15,12,11,15,5,12,11,13,11,14,13,12,7,13,13,12,11,11,9,11,9,8,1,2,2,2,1,3,2,2,3,2,1,12,14,16,12,10,7,10,8,1,1,1,1,1,1,1,12,18,12,18,20,18,11,178,76,12,20,3924192,6400,6100,5400,African_Caribbean,126,13,1994/3/22,1,0,17500.0,,37027632
26,Sebastiaan Bornauw,Wolfsburg,1999,53.0,be BEL,DF,23.0,21.4,29.0,17.0,17.0,10.0,2.0,16.0,22.0,72.7,6.0,27.0,12.0,15.0,31.0,60.0,83.0,1.0,Matches,53.0,be BEL,DF,23.0,21.4,7.0,0.33,7.0,0.0,0.0,0.0,0.0,0.0,2.0,0.09,2.0,0.0,0.0,0.0,0.0,0.0,Matches,,,,,,,,,,,,,,,,,,,,,,,,,,,,,,,,,,,,,,,,,,,,,,,,,,,,,,,,53.0,be BEL,DF,23.0,21.4,8.0,0.0,0.0,24.0,9.0,0.0,3.0,31.0,17.0,0.0,0.0,0.0,112.0,51.0,37.0,58.0,Matches,53.0,be BEL,DF,23.0,21.4,1234.0,1177.0,57.0,34.0,0.0,4.0,3.0,8.0,0.0,0.0,0.0,0.0,1062.0,0.0,14.0,Matches,53.0,be BEL,DF,23.0,21.4,1062.0,1234.0,86.1,20707.0,7058.0,326.0,367.0,88.8,647.0,701.0,92.3,86.0,147.0,58.5,0.0,0.1,0.3,-0.1,1.0,67.0,0.0,0.0,85.0,Matches,63,be BEL,DF,23,26,1928.0,74.0,63.0,21.4,23,82.0,18,3,11.0,7,1.54,41.0,31.0,10.0,0.47,0.55,32.3,33.0,-0.7,-0.03,-0.09,Matches,53.0,be BEL,DF,23.0,21.4,1433.0,170.0,693.0,695.0,54.0,16.0,1433.0,4.0,2.0,50.0,2.0,50.0,871.0,3766.0,2030.0,6.0,3.0,0.0,5.0,3.0,948.0,6.0,Matches,53.0,be BEL,DF,23.0,21.4,1.0,4.0,3.0,75.0,0.19,0.14,0.25,0.33,11.3,0.0,0.0,0.0,0.4,0.4,0.1,0.6,0.6,Matches,53.0,be BEL,DF,23.0,26.0,23.0,1928.0,21.4,1.0,0.0,1.0,1.0,0.0,0.0,8.0,0.0,0.4,0.4,0.1,0.5,6.0,85.0,6.0,0.05,0.0,0.05,0.05,0.05,0.02,0.0,0.02,0.02,0.02,Matches,Sebastiaan Bornauw,D C,23,132,148,Belgium,VfL Wolfsburg,3,7,8,8,11,4,16,7,8,14,12,7,13,11,12,12,16,12,12,10,12,16,7,14,8,14,12,16,11,9,15,17,13,15,13,16,11,7,15,10,6,1,3,2,1,1,3,3,4,3,1,2,13,14,6,9,12,16,12,16,1,1,20,14,1,1,1,1,1,1,1,1,1,1,191,83,9,20,5607681,6594,6244,5594,Northern_European,131,2,1999/3/22,2,0,57533.0,,18087987
27,Julian Brandt,Dortmund,1996,55.0,de GER,MFFW,26.0,26.6,29.0,20.0,6.0,14.0,9.0,12.0,43.0,27.9,31.0,23.0,0.0,23.0,15.0,44.0,9.0,1.0,Matches,55.0,de GER,MFFW,26.0,26.6,133.0,4.99,87.0,32.0,6.0,2.0,5.0,1.0,20.0,0.75,14.0,3.0,1.0,0.0,2.0,0.0,Matches,,,,,,,,,,,,,,,,,,,,,,,,,,,,,,,,,,,,,,,,,,,,,,,,,,,,,,,,55.0,de GER,MFFW,26.0,26.6,2.0,0.0,0.0,9.0,21.0,5.0,165.0,15.0,20.0,0.0,0.0,0.0,138.0,9.0,24.0,27.3,Matches,55.0,de GER,MFFW,26.0,26.6,1368.0,1210.0,153.0,22.0,6.0,18.0,165.0,14.0,114.0,36.0,57.0,3.0,1053.0,5.0,33.0,Matches,55.0,de GER,MFFW,26.0,26.6,1053.0,1368.0,77.0,16552.0,4185.0,583.0,662.0,88.1,284.0,368.0,77.2,120.0,204.0,58.8,8.0,9.2,7.8,-1.2,73.0,60.0,40.0,9.0,119.0,Matches,65,de GER,MFFW,26,32,2397.0,75.0,78.3,26.6,29,80.0,12,3,27.0,0,2.09,67.0,28.0,39.0,1.46,1.46,55.8,29.0,26.8,1.01,0.86,Matches,55.0,de GER,MFFW,26.0,26.6,1634.0,14.0,172.0,668.0,814.0,80.0,1634.0,81.0,41.0,50.6,35.0,43.2,989.0,5335.0,2355.0,67.0,42.0,27.0,50.0,35.0,1186.0,218.0,Matches,55.0,de GER,MFFW,26.0,26.6,9.0,42.0,26.0,61.9,1.58,0.98,0.21,0.35,18.0,1.0,0.0,0.0,5.2,5.2,0.12,3.8,3.8,Matches,55.0,de GER,MFFW,26.0,32.0,29.0,2397.0,26.6,9.0,8.0,17.0,9.0,0.0,0.0,2.0,0.0,5.2,5.2,9.2,14.3,67.0,119.0,218.0,0.34,0.3,0.64,0.34,0.64,0.19,0.34,0.54,0.19,0.54,Matches,Julian Brandt,M/AM RLC,26,146,158,Germany,Borussia Dortmund,11,12,16,12,18,13,6,14,7,5,16,11,8,17,9,14,7,11,10,16,10,10,16,6,13,8,11,11,13,15,12,12,15,15,12,10,9,4,12,4,14,3,1,3,3,3,3,1,1,3,2,1,6,8,4,12,10,11,17,20,1,1,1,1,1,1,1,20,17,15,20,18,15,10,185,83,14,20,34293861,7398,7398,6748,Northern_European,136,1,1996/5/2,38,3,134156.0,,91119265
28,John Brooks,Hoffenheim,1993,58.0,us USA,DF,29.0,15.0,18.0,12.0,10.0,8.0,0.0,13.0,18.0,72.2,5.0,17.0,12.0,5.0,10.0,28.0,105.0,0.0,Matches,58.0,us USA,DF,29.0,15.0,3.0,0.2,2.0,0.0,0.0,1.0,0.0,0.0,2.0,0.13,1.0,0.0,0.0,1.0,0.0,0.0,Matches,,,,,,,,,,,,,,,,,,,,,,,,,,,,,,,,,,,,,,,,,,,,,,,,,,,,,,,,58.0,us USA,DF,29.0,15.0,4.0,0.0,0.0,21.0,14.0,2.0,0.0,10.0,12.0,0.0,1.0,0.0,106.0,64.0,30.0,68.1,Matches,58.0,us USA,DF,29.0,15.0,773.0,725.0,45.0,39.0,0.0,7.0,0.0,1.0,0.0,0.0,0.0,0.0,624.0,3.0,6.0,Matches,58.0,us USA,DF,29.0,15.0,624.0,773.0,80.7,12417.0,4919.0,217.0,241.0,90.0,323.0,370.0,87.3,78.0,141.0,55.3,0.0,0.0,0.1,0.0,0.0,25.0,1.0,0.0,40.0,Matches,68,us USA,DF,29,15,1350.0,90.0,44.1,15.0,15,90.0,15,0,,2,1.13,23.0,28.0,-5.0,-0.33,-0.12,19.4,23.2,-3.8,-0.25,-0.29,Matches,58.0,us USA,DF,29.0,15.0,951.0,159.0,556.0,393.0,11.0,7.0,951.0,5.0,2.0,40.0,1.0,20.0,479.0,2169.0,992.0,2.0,3.0,0.0,1.0,1.0,494.0,1.0,Matches,58.0,us USA,DF,29.0,15.0,0.0,7.0,0.0,0.0,0.47,0.0,0.0,,11.4,0.0,0.0,0.0,0.4,0.4,0.05,-0.4,-0.4,Matches,58.0,us USA,DF,29.0,15.0,15.0,1350.0,15.0,0.0,0.0,0.0,0.0,0.0,0.0,4.0,0.0,0.4,0.4,0.0,0.4,2.0,40.0,1.0,0.0,0.0,0.0,0.0,0.0,0.02,0.0,0.02,0.02,0.02,Matches,John Brooks,D C,29,130,147,"United States,Germany",SL Benfica,4,7,11,6,12,4,14,6,8,14,12,8,14,12,14,11,15,12,12,12,12,13,10,12,7,14,12,12,12,10,15,17,12,12,12,15,11,11,10,13,5,2,2,2,1,1,3,2,3,3,3,1,12,10,13,14,14,13,16,8,1,1,20,1,1,1,1,1,1,1,1,1,1,1,193,78,20,12,275399,6250,6250,5250,Mixed_Race,128,11,1993/1/28,43,3,33500.0,,92025938
29,Cédric Brunner,Schalke 04,1994,60.0,ch SUI,DF,28.0,25.7,39.0,27.0,26.0,11.0,2.0,30.0,45.0,66.7,15.0,24.0,7.0,17.0,43.0,82.0,79.0,0.0,Matches,60.0,ch SUI,DF,28.0,25.7,37.0,1.44,22.0,8.0,0.0,3.0,4.0,0.0,1.0,0.04,0.0,0.0,0.0,0.0,1.0,0.0,Matches,,,,,,,,,,,,,,,,,,,,,,,,,,,,,,,,,,,,,,,,,,,,,,,,,,,,,,,,60.0,ch SUI,DF,28.0,25.7,5.0,0.0,0.0,33.0,38.0,0.0,61.0,43.0,27.0,0.0,1.0,0.0,136.0,37.0,40.0,48.1,Matches,60.0,ch SUI,DF,28.0,25.7,1158.0,886.0,269.0,19.0,1.0,2.0,61.0,250.0,0.0,0.0,0.0,0.0,779.0,3.0,30.0,Matches,60.0,ch SUI,DF,28.0,25.7,779.0,1158.0,67.3,14299.0,6288.0,317.0,373.0,85.0,368.0,510.0,72.2,86.0,221.0,38.9,0.0,1.5,2.2,-1.5,20.0,46.0,26.0,18.0,77.0,Matches,71,ch SUI,DF,28,28,2315.0,83.0,75.7,25.7,28,83.0,18,0,,0,0.79,22.0,54.0,-32.0,-1.24,-0.76,27.8,41.7,-13.9,-0.54,-0.1,Matches,60.0,ch SUI,DF,28.0,25.7,1402.0,106.0,524.0,609.0,279.0,10.0,1402.0,15.0,9.0,60.0,1.0,6.7,621.0,3186.0,1451.0,32.0,32.0,2.0,14.0,13.0,642.0,27.0,Matches,60.0,ch SUI,DF,28.0,25.7,0.0,10.0,0.0,0.0,0.39,0.0,0.0,,24.4,0.0,0.0,0.0,0.3,0.3,0.03,-0.3,-0.3,Matches,60.0,ch SUI,DF,28.0,28.0,28.0,2315.0,25.7,0.0,0.0,0.0,0.0,0.0,0.0,5.0,0.0,0.3,0.3,1.5,1.9,32.0,77.0,27.0,0.0,0.0,0.0,0.0,0.0,0.01,0.06,0.07,0.01,0.07,Matches,Cédric Brunner,D/WB RC,28,125,130,Switzerland,FC Schalke 04,7,12,11,7,11,5,11,6,18,12,11,12,13,11,16,11,14,11,12,11,12,16,8,10,11,12,15,16,13,11,12,12,13,15,15,11,12,12,10,10,17,1,2,2,2,1,3,3,3,1,3,4,13,12,8,12,11,17,11,10,1,12,15,20,10,18,10,1,12,10,1,1,8,1,180,75,10,20,1286575,6229,5979,3979,Northern_European,121,3,1994/2/17,0,0,19177.0,,98010658
30,Marius Bülter,Schalke 04,1993,63.0,de GER,FWMF,29.0,28.9,22.0,11.0,8.0,7.0,7.0,12.0,32.0,37.5,20.0,34.0,1.0,33.0,10.0,32.0,20.0,0.0,Matches,63.0,de GER,FWMF,29.0,28.9,91.0,3.15,62.0,1.0,8.0,9.0,10.0,1.0,5.0,0.17,3.0,0.0,0.0,1.0,1.0,0.0,Matches,,,,,,,,,,,,,,,,,,,,,,,,,,,,,,,,,,,,,,,,,,,,,,,,,,,,,,,,63.0,de GER,FWMF,29.0,28.9,5.0,0.0,0.0,26.0,50.0,7.0,118.0,10.0,11.0,1.0,0.0,0.0,134.0,43.0,56.0,43.4,Matches,63.0,de GER,FWMF,29.0,28.9,762.0,736.0,20.0,0.0,5.0,6.0,118.0,20.0,0.0,0.0,0.0,0.0,439.0,6.0,45.0,Matches,63.0,de GER,FWMF,29.0,28.9,439.0,762.0,57.6,6844.0,2502.0,258.0,332.0,77.7,127.0,230.0,55.2,37.0,94.0,39.4,1.0,4.6,4.6,-3.6,39.0,42.0,44.0,23.0,86.0,Matches,74,de GER,FWMF,29,33,2598.0,79.0,84.9,28.9,30,83.0,20,3,34.0,0,0.91,29.0,60.0,-31.0,-1.07,-0.1,34.6,44.2,-9.6,-0.33,1.22,Matches,63.0,de GER,FWMF,29.0,28.9,1117.0,21.0,130.0,419.0,585.0,136.0,1113.0,96.0,32.0,33.3,53.0,55.2,660.0,4349.0,2038.0,78.0,48.0,24.0,81.0,28.0,773.0,199.0,Matches,63.0,de GER,FWMF,29.0,28.9,11.0,64.0,23.0,35.9,2.22,0.8,0.11,0.3,18.4,1.0,4.0,4.0,9.0,6.1,0.1,2.0,0.9,Matches,63.0,de GER,FWMF,29.0,33.0,30.0,2598.0,28.9,11.0,1.0,12.0,7.0,4.0,4.0,5.0,0.0,9.0,6.1,4.6,10.7,78.0,86.0,199.0,0.38,0.03,0.42,0.24,0.28,0.31,0.16,0.47,0.21,0.37,Matches,Marius Bülter,AM/S RLC,29,128,130,Germany,FC Schalke 04,5,8,13,13,11,5,12,11,4,7,12,13,7,12,14,13,13,12,11,13,11,16,12,8,15,7,12,14,12,11,12,13,13,15,12,12,12,7,14,10,14,1,2,3,2,3,1,1,2,4,3,3,8,11,5,12,13,10,15,13,1,1,1,10,10,12,1,15,1,12,18,17,15,20,190,85,14,20,2048677,6397,6397,4897,Northern_European,121,4,1993/3/29,0,0,25889.0,,91143947
31,Aurélio Buta,Eint Frankfurt,1997,67.0,pt POR,DF,25.0,14.6,33.0,19.0,15.0,13.0,5.0,15.0,27.0,55.6,12.0,18.0,1.0,17.0,9.0,42.0,34.0,0.0,Matches,67.0,pt POR,DF,25.0,14.6,31.0,2.12,30.0,1.0,0.0,0.0,0.0,0.0,4.0,0.27,4.0,0.0,0.0,0.0,0.0,0.0,Matches,,,,,,,,,,,,,,,,,,,,,,,,,,,,,,,,,,,,,,,,,,,,,,,,,,,,,,,,67.0,pt POR,DF,25.0,14.6,3.0,0.0,0.0,31.0,17.0,1.0,62.0,9.0,19.0,0.0,0.0,0.0,66.0,21.0,35.0,37.5,Matches,67.0,pt POR,DF,25.0,14.6,764.0,596.0,168.0,4.0,0.0,0.0,62.0,164.0,0.0,0.0,0.0,0.0,576.0,0.0,28.0,Matches,67.0,pt POR,DF,25.0,14.6,576.0,764.0,75.4,8658.0,2874.0,333.0,391.0,85.2,201.0,264.0,76.1,29.0,62.0,46.8,2.0,3.3,2.3,-1.3,18.0,35.0,20.0,12.0,47.0,Matches,79,pt POR,DF,25,18,1318.0,73.0,43.1,14.6,15,83.0,7,3,26.0,1,1.11,19.0,21.0,-2.0,-0.14,-0.55,21.3,17.9,3.4,0.23,-0.04,Matches,67.0,pt POR,DF,25.0,14.6,928.0,39.0,190.0,395.0,352.0,47.0,928.0,30.0,10.0,33.3,12.0,40.0,423.0,2523.0,1097.0,45.0,19.0,17.0,23.0,9.0,506.0,118.0,Matches,67.0,pt POR,DF,25.0,14.6,3.0,9.0,4.0,44.4,0.61,0.27,0.33,0.75,16.7,0.0,0.0,0.0,0.6,0.6,0.07,2.4,2.4,Matches,67.0,pt POR,DF,25.0,18.0,15.0,1318.0,14.6,3.0,2.0,5.0,3.0,0.0,0.0,3.0,0.0,0.6,0.6,3.3,3.9,45.0,47.0,118.0,0.2,0.14,0.34,0.2,0.34,0.04,0.22,0.26,0.04,0.26,Matches,Aurélio Buta,D/WB R,25,121,128,"Portugal,Angola",Eintracht Frankfurt,5,11,12,6,12,5,5,6,10,11,11,8,11,13,12,13,13,11,11,10,11,13,14,9,16,11,12,13,15,15,11,7,14,15,14,10,13,7,12,18,10,2,2,2,3,2,4,1,3,2,1,1,15,13,6,15,13,14,13,12,1,10,1,20,7,18,1,7,1,14,7,1,10,1,172,66,9,20,1164799,6100,6100,4250,African_Caribbean,112,16,1997/2/10,0,0,8500.0,,55070291
32,Anthony Caci,Mainz 05,1997,69.0,fr FRA,DF,25.0,22.6,58.0,33.0,32.0,20.0,6.0,28.0,42.0,66.7,14.0,28.0,4.0,24.0,54.0,112.0,40.0,0.0,Matches,69.0,fr FRA,DF,25.0,22.6,50.0,2.21,34.0,11.0,1.0,2.0,2.0,0.0,5.0,0.22,4.0,0.0,0.0,1.0,0.0,0.0,Matches,,,,,,,,,,,,,,,,,,,,,,,,,,,,,,,,,,,,,,,,,,,,,,,,,,,,,,,,69.0,fr FRA,DF,25.0,22.6,4.0,0.0,0.0,19.0,9.0,0.0,71.0,54.0,33.0,0.0,1.0,0.0,154.0,20.0,32.0,38.5,Matches,69.0,fr FRA,DF,25.0,22.6,1140.0,939.0,197.0,27.0,0.0,24.0,71.0,153.0,17.0,9.0,6.0,0.0,815.0,4.0,24.0,Matches,69.0,fr FRA,DF,25.0,22.6,815.0,1140.0,71.5,16732.0,7645.0,304.0,360.0,84.4,341.0,461.0,74.0,150.0,262.0,57.3,1.0,2.6,2.3,-1.6,21.0,85.0,29.0,15.0,90.0,Matches,81,fr FRA,DF,25,31,2033.0,66.0,66.4,22.6,23,83.0,14,8,16.0,3,1.26,38.0,38.0,0.0,0.0,0.09,32.7,35.8,-3.1,-0.14,0.16,Matches,69.0,fr FRA,DF,25.0,22.6,1370.0,81.0,458.0,667.0,261.0,20.0,1370.0,21.0,9.0,42.9,11.0,52.4,667.0,3023.0,1468.0,20.0,16.0,1.0,14.0,8.0,681.0,41.0,Matches,69.0,fr FRA,DF,25.0,22.6,2.0,10.0,4.0,40.0,0.44,0.18,0.2,0.5,16.1,0.0,0.0,0.0,0.6,0.6,0.06,1.4,1.4,Matches,69.0,fr FRA,DF,25.0,31.0,23.0,2033.0,22.6,2.0,1.0,3.0,2.0,0.0,0.0,4.0,0.0,0.6,0.6,2.6,3.2,20.0,90.0,41.0,0.09,0.04,0.13,0.09,0.13,0.03,0.11,0.14,0.03,0.14,Matches,Anthony Caci,D/WB RLC,25,132,140,France,1. FSV Mainz 05,5,15,11,8,12,6,12,7,8,13,13,6,14,12,12,12,13,12,12,12,12,13,12,7,13,13,15,12,13,12,12,12,13,13,14,12,13,6,13,7,18,3,1,1,2,3,3,1,2,3,3,3,9,12,4,14,12,12,15,16,1,20,18,15,18,15,10,10,10,10,1,1,1,1,184,76,15,20,5381376,6600,6250,5100,Northern_European,126,5,1997/7/1,0,0,28766.0,,49034179
33,Emre Can,Dortmund,1994,72.0,de GER,MF,28.0,21.1,57.0,28.0,25.0,27.0,5.0,22.0,43.0,51.2,21.0,16.0,6.0,10.0,25.0,82.0,39.0,1.0,Matches,72.0,de GER,MF,28.0,21.1,46.0,2.18,43.0,1.0,0.0,1.0,1.0,0.0,3.0,0.14,3.0,0.0,0.0,0.0,0.0,0.0,Matches,,,,,,,,,,,,,,,,,,,,,,,,,,,,,,,,,,,,,,,,,,,,,,,,,,,,,,,,72.0,de GER,MF,28.0,21.1,8.0,0.0,0.0,30.0,26.0,0.0,4.0,25.0,28.0,0.0,0.0,0.0,167.0,31.0,15.0,67.4,Matches,72.0,de GER,MF,28.0,21.1,1288.0,1253.0,34.0,26.0,2.0,11.0,4.0,7.0,0.0,0.0,0.0,0.0,1153.0,1.0,10.0,Matches,72.0,de GER,MF,28.0,21.1,1153.0,1288.0,89.5,20793.0,5986.0,446.0,483.0,92.3,545.0,586.0,93.0,122.0,158.0,77.2,1.0,1.3,1.4,-0.3,20.0,111.0,7.0,1.0,99.0,Matches,84,de GER,MF,28,27,1900.0,70.0,62.1,21.1,20,87.0,17,7,24.0,5,1.96,55.0,30.0,25.0,1.18,0.1,46.4,26.9,19.5,0.93,0.28,Matches,72.0,de GER,MF,28.0,21.1,1510.0,82.0,448.0,872.0,202.0,18.0,1509.0,25.0,13.0,52.0,7.0,28.0,927.0,4997.0,2356.0,34.0,26.0,1.0,15.0,11.0,1015.0,12.0,Matches,72.0,de GER,MF,28.0,21.1,2.0,15.0,2.0,13.3,0.71,0.09,0.07,0.5,22.3,0.0,1.0,1.0,1.6,0.8,0.06,0.4,0.2,Matches,72.0,de GER,MF,28.0,27.0,20.0,1900.0,21.1,2.0,1.0,3.0,1.0,1.0,1.0,8.0,0.0,1.6,0.8,1.3,2.1,34.0,99.0,12.0,0.09,0.05,0.14,0.05,0.09,0.08,0.06,0.14,0.04,0.1,Matches,Emre Can,DM/M RC,28,146,155,"Germany,Turkey",Borussia Dortmund,9,10,14,11,14,9,13,13,10,13,16,10,16,16,17,12,17,14,9,13,9,17,15,13,13,13,14,17,13,10,18,13,16,13,16,16,10,13,10,12,19,2,1,4,4,3,2,1,2,1,2,1,12,15,12,7,13,14,10,13,1,14,15,15,10,10,20,8,20,8,1,10,1,1,186,86,12,20,24902182,7200,7200,6500,North_African__Middle_Eastern,142,9,1994/1/12,37,1,163014.0,,92021718
34,João Cancelo,Bayern Munich,1994,73.0,pt POR,DFFW,28.0,11.2,23.0,14.0,9.0,10.0,4.0,10.0,23.0,43.5,13.0,14.0,2.0,12.0,15.0,38.0,22.0,0.0,Matches,73.0,pt POR,DFFW,28.0,11.2,35.0,3.11,31.0,0.0,1.0,1.0,2.0,0.0,10.0,0.89,9.0,0.0,1.0,0.0,0.0,0.0,Matches,,,,,,,,,,,,,,,,,,,,,,,,,,,,,,,,,,,,,,,,,,,,,,,,,,,,,,,,73.0,pt POR,DFFW,28.0,11.2,3.0,0.0,0.0,10.0,15.0,3.0,35.0,15.0,14.0,0.0,0.0,0.0,84.0,16.0,12.0,57.1,Matches,73.0,pt POR,DFFW,28.0,11.2,861.0,753.0,107.0,12.0,3.0,12.0,35.0,95.0,0.0,0.0,0.0,0.0,713.0,1.0,17.0,Matches,73.0,pt POR,DFFW,28.0,11.2,713.0,861.0,82.8,11505.0,3272.0,401.0,430.0,93.3,254.0,308.0,82.5,49.0,87.0,56.3,4.0,2.3,2.8,1.7,13.0,55.0,21.0,6.0,61.0,Matches,85,pt POR,DFFW,28,15,1012.0,67.0,33.1,11.2,11,80.0,5,4,32.0,1,2.07,28.0,16.0,12.0,1.07,-0.78,23.1,15.0,8.1,0.72,-0.59,Matches,73.0,pt POR,DFFW,28.0,11.2,1014.0,31.0,224.0,506.0,296.0,38.0,1014.0,65.0,34.0,52.3,26.0,40.0,636.0,3732.0,2011.0,51.0,24.0,19.0,20.0,9.0,701.0,90.0,Matches,73.0,pt POR,DFFW,28.0,11.2,1.0,12.0,4.0,33.3,1.07,0.36,0.08,0.25,18.5,0.0,0.0,0.0,0.7,0.7,0.06,0.3,0.3,Matches,73.0,pt POR,DFFW,28.0,15.0,11.0,1012.0,11.2,1.0,4.0,5.0,1.0,0.0,0.0,3.0,0.0,0.7,0.7,2.3,3.0,51.0,61.0,90.0,0.09,0.36,0.44,0.09,0.44,0.06,0.21,0.26,0.06,0.26,Matches,João Cancelo,D/WB RL,28,167,167,Portugal,Manchester City,12,16,16,11,15,12,10,12,12,9,16,11,13,17,12,14,12,12,12,16,15,13,17,7,14,13,13,14,16,16,14,11,15,16,14,12,14,13,13,9,14,4,1,1,1,4,3,3,3,3,2,1,12,14,11,10,12,15,12,16,1,18,1,20,15,20,1,11,12,15,1,1,14,1,182,74,11,20,269761478,8350,8500,8000,Mediterranean_Hispanic,153,6,1994/5/27,36,7,208785.0,,55041623
35,Koen Casteels,Wolfsburg,1992,75.0,be BEL,GK,30.0,34.0,0.0,0.0,0.0,0.0,0.0,0.0,0.0,,0.0,0.0,0.0,0.0,1.0,1.0,10.0,1.0,Matches,75.0,be BEL,GK,30.0,34.0,9.0,0.26,6.0,2.0,0.0,1.0,0.0,0.0,2.0,0.06,2.0,0.0,0.0,0.0,0.0,0.0,Matches,4.0,be BEL,GK,30.0,34.0,48.0,4.0,0.0,5.0,3.0,43.9,0.27,-1.1,-0.03,257.0,588.0,43.7,1326.0,183.0,33.3,33.7,258.0,57.0,47.5,489.0,29.0,5.9,51.0,1.5,16.5,Matches,4.0,be BEL,GK,30.0,34.0,34.0,3060.0,34.0,48.0,1.41,147.0,101.0,70.1,13.0,10.0,11.0,12.0,35.3,7.0,4.0,1.0,2.0,20.0,Matches,75.0,be BEL,GK,30.0,34.0,0.0,0.0,0.0,0.0,3.0,0.0,0.0,1.0,0.0,0.0,0.0,0.0,63.0,4.0,1.0,80.0,Matches,75.0,be BEL,GK,30.0,34.0,1585.0,1210.0,374.0,116.0,0.0,11.0,0.0,0.0,0.0,0.0,0.0,0.0,1220.0,1.0,0.0,Matches,75.0,be BEL,GK,30.0,34.0,1220.0,1585.0,77.0,36421.0,25230.0,171.0,172.0,99.4,544.0,552.0,98.6,503.0,858.0,58.6,1.0,0.7,0.1,0.3,1.0,40.0,0.0,0.0,2.0,Matches,87,be BEL,GK,30,34,3060.0,90.0,100.0,34.0,34,90.0,34,0,,0,1.44,57.0,48.0,9.0,0.26,,51.3,51.3,0.0,0.0,,Matches,75.0,be BEL,GK,30.0,34.0,1653.0,1196.0,1636.0,17.0,1.0,1.0,1653.0,0.0,0.0,,0.0,,1030.0,4948.0,2681.0,0.0,1.0,1.0,0.0,0.0,884.0,0.0,Matches,75.0,be BEL,GK,30.0,34.0,0.0,1.0,0.0,0.0,0.03,0.0,0.0,,10.5,0.0,0.0,0.0,0.1,0.1,0.07,-0.1,-0.1,Matches,75.0,be BEL,GK,30.0,34.0,34.0,3060.0,34.0,0.0,1.0,1.0,0.0,0.0,0.0,0.0,0.0,0.1,0.1,0.7,0.7,0.0,2.0,0.0,0.0,0.03,0.03,0.0,0.03,0.0,0.02,0.02,0.0,0.02,Matches,Koen Casteels,GK,30,143,152,Belgium,VfL Wolfsburg,3,3,2,1,11,5,8,2,1,2,11,3,3,11,14,13,13,14,13,11,13,15,3,15,2,13,14,13,11,15,12,18,14,11,12,12,15,5,14,9,15,17,13,12,12,13,12,14,16,16,8,14,13,17,6,14,17,18,16,18,20,1,1,1,1,1,1,1,1,1,1,1,1,1,197,86,20,7,17391200,7250,7100,6000,Northern_European,142,5,1992/6/25,4,0,76711.0,,18010782
36,Julian Chabot,Köln,1998,76.0,de GER,DF,24.0,20.0,36.0,23.0,19.0,14.0,3.0,20.0,35.0,57.1,15.0,30.0,18.0,12.0,41.0,77.0,105.0,0.0,Matches,76.0,de GER,DF,24.0,20.0,15.0,0.75,10.0,0.0,0.0,3.0,1.0,1.0,2.0,0.1,1.0,0.0,0.0,1.0,0.0,0.0,Matches,,,,,,,,,,,,,,,,,,,,,,,,,,,,,,,,,,,,,,,,,,,,,,,,,,,,,,,,76.0,de GER,DF,24.0,20.0,3.0,0.0,0.0,29.0,20.0,2.0,3.0,41.0,23.0,0.0,0.0,0.0,124.0,90.0,46.0,66.2,Matches,76.0,de GER,DF,24.0,20.0,1184.0,1106.0,76.0,43.0,1.0,3.0,3.0,1.0,0.0,0.0,0.0,0.0,975.0,2.0,5.0,Matches,76.0,de GER,DF,24.0,20.0,975.0,1184.0,82.3,18978.0,6050.0,320.0,359.0,89.1,560.0,635.0,88.2,89.0,171.0,52.0,2.0,2.0,0.8,0.0,4.0,45.0,0.0,0.0,52.0,Matches,88,de GER,DF,24,21,1803.0,86.0,58.9,20.0,21,86.0,18,0,,5,1.38,30.0,24.0,6.0,0.3,1.09,28.7,22.4,6.3,0.31,0.39,Matches,76.0,de GER,DF,24.0,20.0,1434.0,228.0,831.0,572.0,35.0,17.0,1434.0,8.0,4.0,50.0,1.0,12.5,765.0,3090.0,1438.0,5.0,6.0,1.0,4.0,2.0,825.0,2.0,Matches,76.0,de GER,DF,24.0,20.0,0.0,14.0,3.0,21.4,0.7,0.15,0.0,0.0,9.1,0.0,0.0,0.0,1.6,1.6,0.11,-1.6,-1.6,Matches,76.0,de GER,DF,24.0,21.0,21.0,1803.0,20.0,0.0,2.0,2.0,0.0,0.0,0.0,3.0,0.0,1.6,1.6,2.0,3.6,5.0,52.0,2.0,0.0,0.1,0.1,0.0,0.1,0.08,0.1,0.18,0.08,0.18,Matches,Julian Chabot,D C,24,123,140,"Germany,France",U.C. Sampdoria,6,8,9,8,11,6,16,5,13,13,13,4,13,10,13,12,13,12,11,8,11,13,5,10,9,13,13,13,10,8,15,17,12,10,16,17,11,9,12,4,6,1,2,1,3,1,2,2,3,1,1,2,10,13,7,7,12,11,10,12,1,1,20,1,1,1,12,1,1,1,1,1,1,1,195,85,20,10,1865537,6150,5327,4786,Northern_European,120,6,1998/2/12,0,0,13153.0,1. FC Köln,91177332
37,Oliver Christensen,Hertha BSC,1999,79.0,dk DEN,GK,23.0,33.0,1.0,0.0,1.0,0.0,0.0,0.0,2.0,0.0,2.0,0.0,0.0,0.0,0.0,1.0,22.0,2.0,Matches,79.0,dk DEN,GK,23.0,33.0,7.0,0.21,5.0,2.0,0.0,0.0,0.0,0.0,1.0,0.03,1.0,0.0,0.0,0.0,0.0,0.0,Matches,5.0,dk DEN,GK,23.0,33.0,68.0,5.0,4.0,8.0,0.0,57.9,0.33,-10.1,-0.31,204.0,586.0,34.8,977.0,166.0,42.5,35.9,235.0,72.8,54.3,486.0,33.0,6.8,70.0,2.12,18.8,Matches,5.0,dk DEN,GK,23.0,33.0,33.0,2970.0,33.0,68.0,2.06,163.0,94.0,61.3,6.0,8.0,19.0,3.0,9.1,6.0,5.0,1.0,0.0,16.7,Matches,79.0,dk DEN,GK,23.0,33.0,2.0,0.0,0.0,0.0,7.0,0.0,0.0,0.0,0.0,0.0,0.0,0.0,51.0,6.0,3.0,66.7,Matches,79.0,dk DEN,GK,23.0,33.0,1218.0,858.0,354.0,119.0,0.0,3.0,0.0,0.0,0.0,0.0,0.0,0.0,777.0,6.0,0.0,Matches,79.0,dk DEN,GK,23.0,33.0,777.0,1218.0,63.8,23464.0,18548.0,132.0,132.0,100.0,346.0,353.0,98.0,299.0,727.0,41.1,0.0,0.0,0.1,0.0,0.0,13.0,0.0,0.0,2.0,Matches,92,dk DEN,GK,23,33,2970.0,90.0,97.1,33.0,33,90.0,33,0,,1,0.79,40.0,68.0,-28.0,-0.85,-1.85,37.4,56.6,-19.2,-0.58,0.75,Matches,79.0,dk DEN,GK,23.0,33.0,1306.0,1001.0,1294.0,12.0,0.0,0.0,1306.0,2.0,1.0,50.0,1.0,50.0,709.0,3902.0,2090.0,0.0,0.0,0.0,1.0,1.0,542.0,0.0,Matches,79.0,dk DEN,GK,23.0,33.0,0.0,0.0,0.0,,0.0,0.0,,,,0.0,0.0,0.0,0.0,0.0,,0.0,0.0,Matches,79.0,dk DEN,GK,23.0,33.0,33.0,2970.0,33.0,0.0,0.0,0.0,0.0,0.0,0.0,2.0,0.0,0.0,0.0,0.0,0.0,0.0,2.0,0.0,0.0,0.0,0.0,0.0,0.0,0.0,0.0,0.0,0.0,0.0,Matches,Oliver Christensen,GK,23,125,142,Denmark,Hertha Berlin,3,1,1,1,10,6,6,2,2,2,10,4,2,10,17,15,16,16,12,11,11,17,2,13,1,11,12,10,12,13,12,15,6,11,11,12,13,15,1,5,13,15,14,11,7,12,11,11,14,16,13,11,14,15,1,13,15,15,13,5,20,1,1,1,1,1,1,1,1,1,1,1,1,1,190,82,8,20,2799793,5988,5988,3739,Northern_European,125,4,1999/3/22,1,0,6499.0,,27137069
38,Kingsley Coman,Bayern Munich,1996,83.0,fr FRA,FWMF,26.0,15.7,11.0,8.0,3.0,5.0,3.0,7.0,17.0,41.2,10.0,19.0,1.0,18.0,2.0,13.0,7.0,0.0,Matches,83.0,fr FRA,FWMF,26.0,15.7,85.0,5.43,67.0,1.0,9.0,4.0,4.0,0.0,11.0,0.7,7.0,0.0,1.0,1.0,2.0,0.0,Matches,,,,,,,,,,,,,,,,,,,,,,,,,,,,,,,,,,,,,,,,,,,,,,,,,,,,,,,,83.0,fr FRA,FWMF,26.0,15.7,2.0,1.0,1.0,9.0,21.0,5.0,74.0,2.0,8.0,1.0,0.0,0.0,71.0,11.0,10.0,52.4,Matches,83.0,fr FRA,FWMF,26.0,15.7,806.0,788.0,15.0,1.0,4.0,8.0,74.0,12.0,2.0,0.0,1.0,0.0,640.0,3.0,20.0,Matches,83.0,fr FRA,FWMF,26.0,15.7,640.0,806.0,79.4,10106.0,2128.0,359.0,406.0,88.4,218.0,269.0,81.0,48.0,78.0,61.5,5.0,5.5,6.5,-0.5,42.0,26.0,44.0,17.0,70.0,Matches,97,fr FRA,FWMF,26,24,1409.0,59.0,46.0,15.7,16,71.0,2,8,35.0,3,2.17,43.0,11.0,32.0,2.04,0.84,34.3,12.9,21.4,1.37,0.47,Matches,83.0,fr FRA,FWMF,26.0,15.7,1006.0,9.0,75.0,334.0,615.0,94.0,1006.0,92.0,47.0,51.1,33.0,35.9,723.0,4737.0,2554.0,98.0,49.0,44.0,48.0,20.0,808.0,296.0,Matches,83.0,fr FRA,FWMF,26.0,15.7,8.0,49.0,17.0,34.7,3.13,1.09,0.16,0.47,18.6,0.0,0.0,0.0,4.6,4.6,0.09,3.4,3.4,Matches,83.0,fr FRA,FWMF,26.0,24.0,16.0,1409.0,15.7,8.0,5.0,13.0,8.0,0.0,0.0,2.0,1.0,4.6,4.6,5.5,10.1,98.0,70.0,296.0,0.51,0.32,0.83,0.51,0.83,0.29,0.35,0.65,0.29,0.65,Matches,Kingsley Coman,AM RL,26,162,165,"France,Guinea,Guadeloupe",FC Bayern München,11,13,17,12,15,6,9,14,4,7,13,10,8,17,13,13,12,12,12,14,12,14,17,5,14,8,12,12,19,17,13,9,13,17,12,10,13,5,16,13,16,1,1,2,3,4,1,3,1,3,2,2,16,18,12,14,14,13,11,12,1,1,1,1,12,12,1,15,10,15,20,12,18,12,179,75,12,20,82080002,8100,7750,7600,African_Caribbean,155,16,1996/6/13,40,5,287670.0,,85104424
39,Danny da Costa,Mainz 05,1993,84.0,de GER,DF,29.0,13.7,20.0,16.0,7.0,8.0,5.0,12.0,20.0,60.0,8.0,22.0,3.0,19.0,9.0,29.0,26.0,0.0,Matches,84.0,de GER,DF,29.0,13.7,32.0,2.33,23.0,5.0,1.0,2.0,0.0,1.0,4.0,0.29,2.0,1.0,0.0,0.0,0.0,1.0,Matches,,,,,,,,,,,,,,,,,,,,,,,,,,,,,,,,,,,,,,,,,,,,,,,,,,,,,,,,84.0,de GER,DF,29.0,13.7,0.0,0.0,0.0,8.0,3.0,4.0,52.0,9.0,16.0,0.0,0.0,0.0,81.0,18.0,11.0,62.1,Matches,84.0,de GER,DF,29.0,13.7,607.0,460.0,144.0,0.0,0.0,3.0,52.0,143.0,1.0,0.0,1.0,0.0,372.0,3.0,20.0,Matches,84.0,de GER,DF,29.0,13.7,372.0,607.0,61.3,6633.0,3228.0,140.0,181.0,77.3,191.0,298.0,64.1,27.0,85.0,31.8,2.0,1.0,1.3,1.0,11.0,37.0,21.0,8.0,62.0,Matches,98,de GER,DF,29,23,1236.0,54.0,40.4,13.7,14,75.0,5,9,21.0,4,1.35,21.0,22.0,-1.0,-0.07,-0.07,15.9,20.6,-4.7,-0.34,-0.26,Matches,84.0,de GER,DF,29.0,13.7,767.0,29.0,164.0,362.0,246.0,24.0,767.0,28.0,11.0,39.3,16.0,57.1,346.0,1874.0,913.0,32.0,19.0,11.0,25.0,11.0,386.0,74.0,Matches,84.0,de GER,DF,29.0,13.7,0.0,7.0,1.0,14.3,0.51,0.07,0.0,0.0,14.1,0.0,0.0,0.0,0.5,0.5,0.08,-0.5,-0.5,Matches,84.0,de GER,DF,29.0,23.0,14.0,1236.0,13.7,0.0,2.0,2.0,0.0,0.0,0.0,0.0,0.0,0.5,0.5,1.0,1.5,32.0,62.0,74.0,0.0,0.15,0.15,0.0,0.15,0.04,0.07,0.11,0.04,0.11,Matches,Danny da Costa,D/WB R,29,128,132,"Germany,Angola",1. FSV Mainz 05,3,12,13,8,11,3,13,8,16,12,11,7,13,11,13,12,16,11,10,11,10,15,11,7,15,12,16,18,14,11,13,13,14,15,15,15,12,8,13,10,14,1,3,3,4,1,2,3,2,1,2,1,10,12,2,12,12,16,17,15,1,12,12,18,12,20,1,1,1,10,1,1,8,1,187,87,10,20,3335562,6400,6400,4900,African_Caribbean,126,17,1993/7/13,0,0,16300.0,,92028423
40,Márton Dárdai,Hertha BSC,2002,92.0,hu HUN,DFMF,20.0,10.5,17.0,8.0,9.0,8.0,0.0,9.0,18.0,50.0,9.0,14.0,9.0,5.0,11.0,28.0,45.0,1.0,Matches,92.0,hu HUN,DFMF,20.0,10.5,10.0,0.95,9.0,0.0,0.0,0.0,1.0,0.0,1.0,0.1,1.0,0.0,0.0,0.0,0.0,0.0,Matches,,,,,,,,,,,,,,,,,,,,,,,,,,,,,,,,,,,,,,,,,,,,,,,,,,,,,,,,92.0,hu HUN,DFMF,20.0,10.5,2.0,0.0,0.0,11.0,9.0,0.0,1.0,11.0,8.0,0.0,0.0,0.0,52.0,17.0,17.0,50.0,Matches,92.0,hu HUN,DFMF,20.0,10.5,378.0,359.0,17.0,14.0,1.0,7.0,1.0,2.0,1.0,1.0,0.0,0.0,225.0,2.0,6.0,Matches,92.0,hu HUN,DFMF,20.0,10.5,225.0,378.0,59.5,4843.0,2114.0,66.0,91.0,72.5,120.0,162.0,74.1,38.0,115.0,33.0,0.0,0.2,0.2,-0.2,4.0,19.0,2.0,0.0,21.0,Matches,106,hu HUN,DFMF,20,17,947.0,56.0,30.9,10.5,11,78.0,6,6,15.0,9,1.06,12.0,20.0,-8.0,-0.76,0.05,12.2,18.3,-6.0,-0.57,0.04,Matches,92.0,hu HUN,DFMF,20.0,10.5,485.0,56.0,257.0,217.0,18.0,5.0,485.0,4.0,3.0,75.0,0.0,0.0,219.0,1042.0,608.0,2.0,1.0,0.0,4.0,4.0,236.0,0.0,Matches,92.0,hu HUN,DFMF,20.0,10.5,1.0,2.0,1.0,50.0,0.19,0.1,0.5,1.0,22.2,0.0,0.0,0.0,0.1,0.1,0.04,0.9,0.9,Matches,92.0,hu HUN,DFMF,20.0,17.0,11.0,947.0,10.5,1.0,0.0,1.0,1.0,0.0,0.0,2.0,0.0,0.1,0.1,0.2,0.3,2.0,21.0,0.0,0.1,0.0,0.1,0.1,0.1,0.01,0.02,0.03,0.01,0.03,Matches,Márton Dárdai,D C,20,126,-8,"Germany,Hungary",Hertha Berlin,14,13,11,7,13,13,13,7,8,11,14,11,13,14,10,13,10,13,13,12,12,13,11,9,11,13,13,13,13,13,13,13,13,13,13,13,13,7,13,15,10,4,2,2,1,2,2,2,2,1,3,2,15,8,4,11,14,14,15,18,1,10,20,1,1,1,15,1,1,1,1,1,1,1,188,77,20,10,73100998,6248,5898,4004,Northern_European,126,1,2002/2/12,0,0,7202.0,,91188481
41,Alphonso Davies,Bayern Munich,2000,94.0,ca CAN,DF,21.0,22.7,45.0,28.0,25.0,13.0,7.0,18.0,39.0,46.2,21.0,28.0,4.0,24.0,24.0,69.0,24.0,4.0,Matches,94.0,ca CAN,DF,21.0,22.7,88.0,3.88,76.0,0.0,9.0,1.0,1.0,1.0,8.0,0.35,7.0,0.0,1.0,0.0,0.0,0.0,Matches,,,,,,,,,,,,,,,,,,,,,,,,,,,,,,,,,,,,,,,,,,,,,,,,,,,,,,,,94.0,ca CAN,DF,21.0,22.7,0.0,0.0,0.0,9.0,26.0,3.0,25.0,24.0,28.0,0.0,0.0,0.0,199.0,6.0,6.0,50.0,Matches,94.0,ca CAN,DF,21.0,22.7,1567.0,1378.0,181.0,26.0,2.0,9.0,25.0,155.0,0.0,0.0,0.0,0.0,1361.0,8.0,22.0,Matches,94.0,ca CAN,DF,21.0,22.7,1361.0,1567.0,86.9,21727.0,5882.0,721.0,786.0,91.7,542.0,600.0,90.3,76.0,116.0,65.5,4.0,3.7,4.3,0.3,44.0,110.0,39.0,5.0,133.0,Matches,108,ca CAN,DF,21,26,2042.0,79.0,66.7,22.7,24,82.0,17,2,38.0,0,1.92,59.0,25.0,34.0,1.5,-0.27,47.9,25.0,22.9,1.01,-0.3,Matches,94.0,ca CAN,DF,21.0,22.7,1859.0,51.0,446.0,912.0,545.0,84.0,1859.0,140.0,70.0,50.0,55.0,39.3,1226.0,7671.0,4417.0,117.0,66.0,37.0,50.0,27.0,1229.0,158.0,Matches,94.0,ca CAN,DF,21.0,22.7,1.0,19.0,8.0,42.1,0.84,0.35,0.05,0.13,18.6,0.0,0.0,0.0,1.7,1.7,0.09,-0.7,-0.7,Matches,94.0,ca CAN,DF,21.0,26.0,24.0,2042.0,22.7,1.0,4.0,5.0,1.0,0.0,0.0,0.0,0.0,1.7,1.7,3.7,5.4,117.0,133.0,158.0,0.04,0.18,0.22,0.04,0.22,0.07,0.16,0.24,0.07,0.24,Matches,Alphonso Davies,D/WB L,21,160,172,"Canada,Liberia,Ghana",FC Bayern München,6,12,17,9,12,6,7,9,12,11,12,10,14,14,15,12,15,12,11,12,12,17,16,7,14,11,15,16,19,14,12,10,16,19,16,12,12,7,13,7,15,1,2,1,3,1,2,3,1,2,1,1,18,19,4,14,13,14,12,11,1,20,1,1,18,8,1,15,1,10,15,1,12,10,185,77,20,10,95234402,8100,7500,7500,African_Caribbean,141,16,2000/11/2,32,12,191781.0,,20041862
42,Kerem Demirbay,Leverkusen,1993,96.0,de GER,MF,29.0,17.2,36.0,18.0,16.0,17.0,3.0,18.0,34.0,52.9,16.0,26.0,6.0,20.0,16.0,52.0,11.0,0.0,Matches,96.0,de GER,MF,29.0,17.2,51.0,2.98,25.0,21.0,2.0,2.0,1.0,0.0,6.0,0.35,3.0,3.0,0.0,0.0,0.0,0.0,Matches,,,,,,,,,,,,,,,,,,,,,,,,,,,,,,,,,,,,,,,,,,,,,,,,,,,,,,,,96.0,de GER,MF,29.0,17.2,5.0,0.0,0.0,31.0,22.0,0.0,90.0,16.0,18.0,0.0,0.0,0.0,100.0,9.0,11.0,45.0,Matches,96.0,de GER,MF,29.0,17.2,1069.0,940.0,124.0,56.0,3.0,8.0,90.0,7.0,55.0,29.0,20.0,0.0,827.0,5.0,19.0,Matches,96.0,de GER,MF,29.0,17.2,827.0,1069.0,77.4,14183.0,4379.0,397.0,446.0,89.0,304.0,360.0,84.4,94.0,193.0,48.7,3.0,3.0,4.0,0.0,30.0,70.0,13.0,5.0,86.0,Matches,110,de GER,MF,29,25,1544.0,62.0,50.5,17.2,17,79.0,7,8,26.0,7,1.36,25.0,26.0,-1.0,-0.06,-0.59,27.2,23.5,3.7,0.22,-0.08,Matches,96.0,de GER,MF,29.0,17.2,1253.0,42.0,247.0,700.0,313.0,16.0,1253.0,24.0,8.0,33.3,12.0,50.0,624.0,3184.0,1510.0,22.0,20.0,4.0,25.0,21.0,817.0,21.0,Matches,96.0,de GER,MF,29.0,17.2,4.0,31.0,6.0,19.4,1.81,0.35,0.13,0.67,24.3,8.0,0.0,0.0,2.2,2.2,0.07,1.8,1.8,Matches,96.0,de GER,MF,29.0,25.0,17.0,1544.0,17.2,4.0,3.0,7.0,4.0,0.0,0.0,5.0,0.0,2.2,2.2,3.0,5.2,22.0,86.0,21.0,0.23,0.17,0.41,0.23,0.41,0.13,0.17,0.31,0.13,0.31,Matches,Kerem Demirbay,M/AM C,29,140,150,"Germany,Turkey",Bayer 04 Leverkusen,15,17,13,11,15,15,8,13,7,9,17,13,12,16,12,11,11,14,11,16,13,13,15,10,13,11,12,13,12,15,11,11,14,11,15,10,13,9,13,9,13,1,3,1,1,1,2,1,3,1,1,2,11,15,15,7,12,12,10,8,1,1,1,1,1,1,14,1,20,1,1,19,1,10,183,75,20,10,15231477,7000,7000,5750,North_African__Middle_Eastern,138,6,1993/7/3,2,1,96154.0,,91104583
43,Moussa Diaby,Leverkusen,1999,99.0,fr FRA,FWMF,23.0,30.0,14.0,8.0,4.0,8.0,2.0,7.0,14.0,50.0,7.0,8.0,0.0,8.0,5.0,19.0,3.0,0.0,Matches,99.0,fr FRA,FWMF,23.0,30.0,110.0,3.67,74.0,5.0,14.0,14.0,3.0,0.0,16.0,0.53,10.0,0.0,4.0,0.0,2.0,0.0,Matches,,,,,,,,,,,,,,,,,,,,,,,,,,,,,,,,,,,,,,,,,,,,,,,,,,,,,,,,99.0,fr FRA,FWMF,23.0,30.0,4.0,0.0,0.0,18.0,24.0,10.0,95.0,5.0,8.0,1.0,0.0,0.0,87.0,2.0,20.0,9.1,Matches,99.0,fr FRA,FWMF,23.0,30.0,1003.0,938.0,57.0,6.0,12.0,5.0,95.0,28.0,13.0,4.0,5.0,0.0,741.0,8.0,31.0,Matches,99.0,fr FRA,FWMF,23.0,30.0,741.0,1003.0,73.9,11048.0,2666.0,428.0,516.0,82.9,226.0,292.0,77.4,53.0,94.0,56.4,8.0,8.2,7.0,-0.2,58.0,46.0,52.0,15.0,104.0,Matches,113,fr FRA,FWMF,23,33,2699.0,82.0,88.2,30.0,33,82.0,16,0,,0,1.52,49.0,39.0,10.0,0.33,0.83,44.9,35.8,9.1,0.3,0.44,Matches,99.0,fr FRA,FWMF,23.0,30.0,1279.0,3.0,88.0,539.0,666.0,139.0,1278.0,105.0,51.0,48.6,45.0,42.9,849.0,5736.0,3178.0,125.0,73.0,55.0,64.0,42.0,1040.0,258.0,Matches,99.0,fr FRA,FWMF,23.0,30.0,9.0,79.0,34.0,43.0,2.63,1.13,0.11,0.26,17.8,0.0,0.0,1.0,11.0,10.3,0.13,-2.0,-1.3,Matches,99.0,fr FRA,FWMF,23.0,33.0,33.0,2699.0,30.0,9.0,8.0,17.0,9.0,0.0,1.0,4.0,0.0,11.0,10.3,8.2,18.5,125.0,104.0,258.0,0.3,0.27,0.57,0.3,0.57,0.37,0.27,0.64,0.34,0.62,Matches,Moussa Diaby,M/AM RL,23,150,160,"France,Mali",Bayer 04 Leverkusen,10,12,16,12,13,8,7,11,6,5,13,10,5,14,10,12,10,13,11,12,11,12,15,6,14,6,12,12,18,16,13,6,13,18,14,11,14,4,13,5,10,1,1,4,3,2,1,2,1,3,1,1,11,15,4,13,11,15,13,7,1,1,1,1,1,1,1,20,1,17,20,12,17,1,171,67,20,10,51627374,7500,7250,6000,African_Caribbean,135,15,1999/7/7,8,0,57533.0,,48044574
44,Danilho Doekhi,Union Berlin,1998,106.0,nl NED,DF,24.0,24.6,38.0,23.0,21.0,17.0,0.0,14.0,26.0,53.8,12.0,27.0,12.0,15.0,29.0,67.0,93.0,0.0,Matches,106.0,nl NED,DF,24.0,24.6,21.0,0.85,19.0,0.0,0.0,0.0,2.0,0.0,3.0,0.12,2.0,0.0,0.0,0.0,1.0,0.0,Matches,,,,,,,,,,,,,,,,,,,,,,,,,,,,,,,,,,,,,,,,,,,,,,,,,,,,,,,,106.0,nl NED,DF,24.0,24.6,0.0,0.0,0.0,20.0,14.0,0.0,10.0,29.0,23.0,1.0,1.0,0.0,103.0,61.0,49.0,55.5,Matches,106.0,nl NED,DF,24.0,24.6,955.0,932.0,23.0,15.0,0.0,4.0,10.0,2.0,0.0,0.0,0.0,0.0,756.0,0.0,13.0,Matches,106.0,nl NED,DF,24.0,24.6,756.0,955.0,79.2,13777.0,4912.0,306.0,353.0,86.7,373.0,433.0,86.1,65.0,128.0,50.8,1.0,0.4,0.7,0.6,7.0,69.0,4.0,0.0,73.0,Matches,122,nl NED,DF,24,25,2216.0,89.0,72.4,24.6,25,89.0,23,0,,4,1.84,37.0,26.0,11.0,0.45,0.23,27.6,34.7,-7.1,-0.29,-0.54,Matches,106.0,nl NED,DF,24.0,24.6,1209.0,116.0,563.0,553.0,99.0,27.0,1209.0,7.0,3.0,42.9,1.0,14.3,640.0,2993.0,1470.0,15.0,9.0,1.0,8.0,3.0,703.0,21.0,Matches,106.0,nl NED,DF,24.0,24.6,5.0,17.0,9.0,52.9,0.69,0.37,0.29,0.56,11.6,0.0,0.0,0.0,1.9,1.9,0.11,3.1,3.1,Matches,106.0,nl NED,DF,24.0,25.0,25.0,2216.0,24.6,5.0,1.0,6.0,5.0,0.0,0.0,0.0,0.0,1.9,1.9,0.4,2.3,15.0,73.0,21.0,0.2,0.04,0.24,0.2,0.24,0.08,0.02,0.09,0.08,0.09,Matches,Danilho Doekhi,D/DM RC,24,123,135,"Holland,Suriname",1. FC Union Berlin,9,9,7,5,10,8,13,10,6,12,10,3,15,12,11,12,12,11,12,12,11,12,8,14,9,12,14,14,10,13,14,13,11,10,14,16,12,7,4,6,10,1,2,3,2,2,2,2,1,1,3,2,14,9,8,8,9,9,10,12,1,1,20,16,1,13,16,1,12,1,1,1,1,1,190,83,10,20,2162790,6143,6143,4993,African_Caribbean,116,11,1998/6/30,0,0,10000.0,,37051440
45,Dion Drena Beljo,Augsburg,2002,109.0,hr CRO,FW,20.0,12.5,7.0,6.0,3.0,2.0,2.0,2.0,13.0,15.4,11.0,15.0,2.0,13.0,1.0,8.0,14.0,0.0,Matches,109.0,hr CRO,FW,20.0,12.5,25.0,1.99,20.0,0.0,0.0,3.0,1.0,1.0,5.0,0.4,3.0,0.0,0.0,2.0,0.0,0.0,Matches,,,,,,,,,,,,,,,,,,,,,,,,,,,,,,,,,,,,,,,,,,,,,,,,,,,,,,,,109.0,hr CRO,FW,20.0,12.5,2.0,0.0,0.0,26.0,10.0,7.0,5.0,1.0,6.0,0.0,0.0,0.0,38.0,47.0,56.0,45.6,Matches,109.0,hr CRO,FW,20.0,12.5,250.0,242.0,5.0,0.0,0.0,0.0,5.0,1.0,0.0,0.0,0.0,0.0,159.0,3.0,4.0,Matches,109.0,hr CRO,FW,20.0,12.5,159.0,250.0,63.6,2058.0,467.0,94.0,141.0,66.7,46.0,73.0,63.0,5.0,8.0,62.5,2.0,1.7,0.9,0.3,15.0,11.0,4.0,1.0,15.0,Matches,126,hr CRO,FW,20,18,1128.0,63.0,36.9,12.5,16,69.0,2,2,16.0,1,1.06,18.0,27.0,-9.0,-0.72,-0.16,12.2,23.0,-10.8,-0.86,-0.25,Matches,109.0,hr CRO,FW,20.0,12.5,371.0,18.0,45.0,190.0,140.0,29.0,371.0,15.0,7.0,46.7,6.0,40.0,184.0,951.0,291.0,14.0,7.0,4.0,33.0,23.0,275.0,42.0,Matches,109.0,hr CRO,FW,20.0,12.5,3.0,13.0,5.0,38.5,1.04,0.4,0.23,0.6,15.2,0.0,0.0,0.0,1.6,1.6,0.12,1.4,1.4,Matches,109.0,hr CRO,FW,20.0,18.0,16.0,1128.0,12.5,3.0,2.0,5.0,3.0,0.0,0.0,2.0,0.0,1.6,1.6,1.7,3.2,14.0,15.0,42.0,0.24,0.16,0.4,0.24,0.4,0.12,0.13,0.26,0.12,0.26,Matches,Dion Drena Beljo,S,20,117,-8,Croatia,NK Osijek,3,6,12,15,13,5,12,11,3,3,12,14,4,13,12,14,12,12,12,12,12,14,15,7,14,6,13,11,11,12,13,15,14,12,13,14,13,7,11,7,10,1,4,3,1,2,1,1,1,1,4,2,11,15,11,14,12,18,13,13,1,1,1,1,1,1,1,1,1,1,1,1,7,20,195,0,20,9,3930000,5950,5750,3850,Northern_European,117,1,2002/3/1,0,0,1058.0,,24061498
46,Dominick Drexler,Schalke 04,1990,110.0,de GER,MFFW,32.0,15.2,25.0,17.0,12.0,10.0,3.0,9.0,22.0,40.9,13.0,18.0,2.0,16.0,8.0,33.0,12.0,0.0,Matches,110.0,de GER,MFFW,32.0,15.2,46.0,3.03,34.0,6.0,2.0,1.0,2.0,1.0,5.0,0.33,4.0,0.0,1.0,0.0,0.0,0.0,Matches,,,,,,,,,,,,,,,,,,,,,,,,,,,,,,,,,,,,,,,,,,,,,,,,,,,,,,,,110.0,de GER,MFFW,32.0,15.2,3.0,1.0,0.0,26.0,24.0,2.0,47.0,8.0,17.0,0.0,0.0,0.0,89.0,22.0,28.0,44.0,Matches,110.0,de GER,MFFW,32.0,15.2,498.0,464.0,32.0,5.0,2.0,0.0,47.0,14.0,12.0,6.0,3.0,0.0,325.0,2.0,27.0,Matches,110.0,de GER,MFFW,32.0,15.2,325.0,498.0,65.3,5190.0,1661.0,159.0,215.0,74.0,110.0,154.0,71.4,29.0,57.0,50.9,3.0,2.1,1.6,0.9,19.0,30.0,20.0,9.0,52.0,Matches,127,de GER,MFFW,32,27,1366.0,51.0,44.6,15.2,16,68.0,3,11,25.0,0,0.89,18.0,33.0,-15.0,-0.99,0.13,17.7,25.8,-8.0,-0.53,-0.02,Matches,110.0,de GER,MFFW,32.0,15.2,628.0,20.0,113.0,304.0,223.0,41.0,628.0,21.0,10.0,47.6,9.0,42.9,324.0,1557.0,696.0,17.0,17.0,2.0,22.0,18.0,374.0,69.0,Matches,110.0,de GER,MFFW,32.0,15.2,4.0,16.0,6.0,37.5,1.05,0.4,0.25,0.67,14.6,0.0,0.0,0.0,2.4,2.4,0.15,1.6,1.6,Matches,110.0,de GER,MFFW,32.0,27.0,16.0,1366.0,15.2,4.0,3.0,7.0,4.0,0.0,0.0,3.0,1.0,2.4,2.4,2.1,4.5,17.0,52.0,69.0,0.26,0.2,0.46,0.26,0.46,0.16,0.14,0.3,0.16,0.3,Matches,Dominick Drexler,AM RLC,32,123,135,Germany,FC Schalke 04,11,13,13,11,15,11,11,11,6,8,14,13,11,15,14,13,11,13,12,15,13,10,14,8,12,10,12,12,12,12,14,11,12,12,13,9,11,11,12,12,12,2,3,2,2,3,2,1,2,1,2,2,8,12,13,7,12,12,8,10,1,1,1,1,1,1,8,12,15,12,15,20,15,14,183,71,9,20,591141,6150,6150,4650,Northern_European,123,5,1990/5/26,0,0,25889.0,,91005018
47,Marvin Ducksch,Werder Bremen,1994,111.0,de GER,FW,28.0,31.7,8.0,3.0,2.0,4.0,2.0,3.0,16.0,18.8,13.0,13.0,2.0,11.0,9.0,17.0,41.0,1.0,Matches,111.0,de GER,FW,28.0,31.7,109.0,3.44,67.0,30.0,5.0,4.0,3.0,0.0,24.0,0.76,16.0,4.0,2.0,1.0,1.0,0.0,Matches,,,,,,,,,,,,,,,,,,,,,,,,,,,,,,,,,,,,,,,,,,,,,,,,,,,,,,,,111.0,de GER,FW,28.0,31.7,4.0,0.0,0.0,3.0,17.0,12.0,164.0,9.0,3.0,1.0,0.0,0.0,98.0,25.0,34.0,42.4,Matches,111.0,de GER,FW,28.0,31.7,956.0,742.0,206.0,69.0,8.0,15.0,164.0,6.0,91.0,25.0,46.0,1.0,583.0,8.0,15.0,Matches,111.0,de GER,FW,28.0,31.7,583.0,956.0,61.0,9974.0,2854.0,294.0,390.0,75.4,170.0,288.0,59.0,81.0,198.0,40.9,6.0,5.5,6.0,0.5,52.0,42.0,21.0,6.0,58.0,Matches,128,de GER,FW,28,34,2852.0,84.0,93.2,31.7,34,84.0,19,0,,0,1.06,41.0,57.0,-16.0,-0.5,-1.8,37.8,47.4,-9.6,-0.3,0.66,Matches,111.0,de GER,FW,28.0,31.7,1251.0,50.0,116.0,463.0,676.0,149.0,1250.0,38.0,15.0,39.5,20.0,52.6,576.0,2035.0,851.0,31.0,15.0,24.0,63.0,16.0,762.0,215.0,Matches,111.0,de GER,FW,28.0,31.7,12.0,94.0,43.0,45.7,2.97,1.36,0.13,0.28,19.1,14.0,0.0,1.0,11.3,10.5,0.11,0.7,1.5,Matches,111.0,de GER,FW,28.0,34.0,34.0,2852.0,31.7,12.0,6.0,18.0,12.0,0.0,1.0,4.0,0.0,11.3,10.5,5.5,16.0,31.0,58.0,215.0,0.38,0.19,0.57,0.38,0.57,0.36,0.17,0.53,0.33,0.5,Matches,Marvin Ducksch,S,28,128,132,Germany,SV Werder Bremen,13,11,10,15,12,14,15,14,6,5,12,13,7,12,11,14,10,12,11,13,11,10,13,5,12,6,12,9,13,14,10,14,11,14,13,13,10,8,13,12,12,3,2,1,1,1,3,3,1,3,2,1,5,14,14,12,11,8,8,8,1,1,1,1,1,1,1,12,1,12,12,14,12,20,188,79,12,20,5130302,6395,6395,5295,Northern_European,128,3,1994/3/7,0,0,29753.0,,92023402
48,Maximilian Eggestein,Freiburg,1996,114.0,de GER,MF,25.0,27.2,51.0,29.0,21.0,24.0,6.0,17.0,35.0,48.6,18.0,37.0,8.0,29.0,36.0,87.0,27.0,0.0,Matches,114.0,de GER,MF,25.0,27.2,50.0,1.84,44.0,0.0,1.0,1.0,3.0,1.0,5.0,0.18,4.0,0.0,0.0,0.0,1.0,0.0,Matches,,,,,,,,,,,,,,,,,,,,,,,,,,,,,,,,,,,,,,,,,,,,,,,,,,,,,,,,114.0,de GER,MF,25.0,27.2,6.0,0.0,0.0,31.0,21.0,1.0,12.0,36.0,29.0,0.0,0.0,0.0,142.0,57.0,50.0,53.3,Matches,114.0,de GER,MF,25.0,27.2,864.0,852.0,9.0,9.0,2.0,2.0,12.0,0.0,0.0,0.0,0.0,0.0,660.0,3.0,31.0,Matches,114.0,de GER,MF,25.0,27.2,660.0,864.0,76.4,10099.0,3171.0,355.0,435.0,81.6,239.0,282.0,84.8,36.0,56.0,64.3,2.0,1.7,1.9,0.3,23.0,83.0,18.0,2.0,93.0,Matches,131,de GER,MF,25,31,2451.0,79.0,80.1,27.2,27,87.0,17,4,25.0,1,1.71,36.0,34.0,2.0,0.07,-0.67,33.1,40.9,-7.8,-0.29,-1.31,Matches,114.0,de GER,MF,25.0,27.2,1098.0,38.0,235.0,598.0,276.0,34.0,1098.0,16.0,9.0,56.3,5.0,31.3,494.0,2396.0,990.0,20.0,23.0,2.0,21.0,23.0,581.0,46.0,Matches,114.0,de GER,MF,25.0,27.2,1.0,16.0,4.0,25.0,0.59,0.15,0.06,0.25,21.6,0.0,0.0,0.0,0.9,0.9,0.06,0.1,0.1,Matches,114.0,de GER,MF,25.0,31.0,27.0,2451.0,27.2,1.0,2.0,3.0,1.0,0.0,0.0,6.0,0.0,0.9,0.9,1.7,2.6,20.0,93.0,46.0,0.04,0.07,0.11,0.04,0.11,0.03,0.06,0.1,0.03,0.1,Matches,Maximilian Eggestein,DM/M C,25,140,148,Germany,Sport-Club Freiburg,10,12,10,11,15,10,7,13,6,11,14,15,12,15,12,15,9,14,13,13,13,11,10,12,14,12,17,18,10,12,13,10,16,11,17,11,14,8,12,4,13,3,2,3,1,3,1,2,2,2,2,1,8,12,4,15,14,17,13,15,1,1,1,1,1,1,18,11,20,11,11,15,11,1,181,77,12,20,10388646,6900,6900,5250,Northern_European,137,3,1996/12/8,0,0,14499.0,,91126294
49,Nico Elvedi,Gladbach,1996,119.0,ch SUI,DF,25.0,31.4,46.0,24.0,32.0,12.0,2.0,27.0,41.0,65.9,14.0,31.0,16.0,15.0,35.0,81.0,149.0,3.0,Matches,119.0,ch SUI,DF,25.0,31.4,17.0,0.54,17.0,0.0,0.0,0.0,0.0,0.0,1.0,0.03,1.0,0.0,0.0,0.0,0.0,0.0,Matches,,,,,,,,,,,,,,,,,,,,,,,,,,,,,,,,,,,,,,,,,,,,,,,,,,,,,,,,119.0,ch SUI,DF,25.0,31.4,2.0,0.0,0.0,24.0,11.0,1.0,0.0,35.0,24.0,0.0,0.0,0.0,149.0,71.0,48.0,59.7,Matches,119.0,ch SUI,DF,25.0,31.4,2149.0,2072.0,74.0,55.0,2.0,3.0,0.0,1.0,0.0,0.0,0.0,0.0,1967.0,3.0,13.0,Matches,119.0,ch SUI,DF,25.0,31.4,1967.0,2149.0,91.5,36425.0,11114.0,704.0,749.0,94.0,1082.0,1140.0,94.9,157.0,209.0,75.1,0.0,0.3,0.5,-0.3,5.0,50.0,1.0,0.0,83.0,Matches,136,ch SUI,DF,25,32,2826.0,88.0,92.4,31.4,32,88.0,30,0,,0,1.22,48.0,52.0,-4.0,-0.13,-0.51,49.4,49.9,-0.5,-0.02,0.3,Matches,119.0,ch SUI,DF,25.0,31.4,2492.0,366.0,1398.0,1042.0,61.0,27.0,2492.0,3.0,1.0,33.3,2.0,66.7,1517.0,7687.0,4018.0,20.0,19.0,1.0,8.0,3.0,1748.0,5.0,Matches,119.0,ch SUI,DF,25.0,31.4,3.0,18.0,9.0,50.0,0.57,0.29,0.17,0.33,10.5,0.0,0.0,0.0,2.6,2.6,0.14,0.4,0.4,Matches,119.0,ch SUI,DF,25.0,32.0,32.0,2826.0,31.4,3.0,0.0,3.0,3.0,0.0,0.0,2.0,0.0,2.6,2.6,0.3,2.9,20.0,83.0,5.0,0.1,0.0,0.1,0.1,0.1,0.08,0.01,0.09,0.08,0.09,Matches,Nico Elvedi,D RLC,25,137,145,Switzerland,Borussia Mönchengladbach,4,8,8,7,12,4,14,6,8,14,14,7,13,12,13,13,13,14,14,12,13,12,7,11,10,14,16,12,13,11,15,15,13,15,14,13,13,10,12,10,17,3,2,3,2,1,4,3,1,3,2,3,12,15,4,12,16,14,14,18,1,15,20,17,12,14,12,1,10,1,1,1,1,1,189,84,14,20,11670804,6994,7294,5994,Northern_European,137,2,1996/9/30,38,1,57533.0,,98033057
50,Edimilson Fernandes,Mainz 05,1996,126.0,ch SUI,DF,26.0,27.1,35.0,25.0,26.0,5.0,4.0,18.0,34.0,52.9,16.0,37.0,16.0,21.0,54.0,89.0,87.0,2.0,Matches,126.0,ch SUI,DF,26.0,27.1,36.0,1.33,18.0,13.0,2.0,2.0,1.0,0.0,5.0,0.18,1.0,3.0,0.0,1.0,0.0,0.0,Matches,,,,,,,,,,,,,,,,,,,,,,,,,,,,,,,,,,,,,,,,,,,,,,,,,,,,,,,,126.0,ch SUI,DF,26.0,27.1,4.0,0.0,0.0,29.0,14.0,0.0,80.0,54.0,25.0,0.0,0.0,0.0,228.0,38.0,42.0,47.5,Matches,126.0,ch SUI,DF,26.0,27.1,1190.0,1051.0,133.0,44.0,0.0,16.0,80.0,42.0,47.0,24.0,22.0,0.0,832.0,6.0,26.0,Matches,126.0,ch SUI,DF,26.0,27.1,832.0,1190.0,69.9,17686.0,6806.0,286.0,323.0,88.5,372.0,456.0,81.6,157.0,352.0,44.6,3.0,1.3,2.0,1.7,15.0,67.0,14.0,5.0,67.0,Matches,144,ch SUI,DF,26,32,2437.0,76.0,79.6,27.1,28,84.0,17,4,20.0,2,1.41,47.0,45.0,2.0,0.07,0.51,39.0,41.4,-2.4,-0.09,0.51,Matches,126.0,ch SUI,DF,26.0,27.1,1485.0,158.0,671.0,666.0,166.0,6.0,1485.0,25.0,17.0,68.0,4.0,16.0,768.0,3634.0,1792.0,15.0,12.0,3.0,15.0,14.0,739.0,23.0,Matches,126.0,ch SUI,DF,26.0,27.1,0.0,15.0,3.0,20.0,0.55,0.11,0.0,0.0,25.0,4.0,0.0,0.0,0.7,0.7,0.04,-0.7,-0.7,Matches,126.0,ch SUI,DF,26.0,32.0,28.0,2437.0,27.1,0.0,3.0,3.0,0.0,0.0,0.0,4.0,0.0,0.7,0.7,1.3,1.9,15.0,67.0,23.0,0.0,0.11,0.11,0.0,0.11,0.02,0.05,0.07,0.02,0.07,Matches,Edimilson Fernandes,D/M RLC,26,128,135,"Switzerland,Cape Verde Islands,Portugal",1. FSV Mainz 05,13,12,12,8,13,12,11,12,7,12,13,6,12,15,13,13,12,12,12,13,12,13,13,4,12,12,12,11,12,12,14,12,12,13,14,13,13,11,13,11,19,2,2,1,2,2,1,3,2,2,2,3,12,12,14,8,11,10,11,13,1,10,18,12,10,15,15,15,20,12,10,12,10,8,187,77,10,20,2816697,6400,6450,5500,African_Caribbean,122,15,1996/4/15,22,2,34614.0,,98030084
51,Mark Flekken,Freiburg,1993,128.0,nl NED,GK,29.0,34.0,0.0,0.0,0.0,0.0,0.0,0.0,1.0,0.0,1.0,1.0,0.0,1.0,0.0,0.0,9.0,5.0,Matches,128.0,nl NED,GK,29.0,34.0,10.0,0.29,6.0,4.0,0.0,0.0,0.0,0.0,1.0,0.03,0.0,1.0,0.0,0.0,0.0,0.0,Matches,9.0,nl NED,GK,29.0,34.0,44.0,5.0,0.0,4.0,0.0,46.4,0.28,2.4,0.07,271.0,665.0,40.8,1231.0,121.0,40.2,37.6,231.0,73.6,58.0,434.0,32.0,7.4,43.0,1.26,15.0,Matches,9.0,nl NED,GK,29.0,34.0,34.0,3060.0,34.0,44.0,1.29,150.0,106.0,74.0,17.0,8.0,9.0,13.0,38.2,6.0,5.0,0.0,1.0,0.0,Matches,128.0,nl NED,GK,29.0,34.0,0.0,0.0,0.0,0.0,3.0,0.0,0.0,0.0,0.0,0.0,0.0,0.0,69.0,7.0,0.0,100.0,Matches,128.0,nl NED,GK,29.0,34.0,1468.0,1138.0,324.0,93.0,0.0,15.0,0.0,0.0,0.0,0.0,0.0,0.0,1035.0,6.0,2.0,Matches,128.0,nl NED,GK,29.0,34.0,1035.0,1468.0,70.5,34098.0,25402.0,93.0,97.0,95.9,498.0,506.0,98.4,443.0,856.0,51.8,0.0,0.3,0.3,-0.3,4.0,58.0,3.0,0.0,0.0,Matches,146,nl NED,GK,29,34,3060.0,90.0,100.0,34.0,34,90.0,34,0,,0,1.74,51.0,44.0,7.0,0.21,,48.0,48.8,-0.8,-0.02,,Matches,128.0,nl NED,GK,29.0,34.0,1550.0,1234.0,1536.0,17.0,0.0,0.0,1550.0,3.0,3.0,100.0,0.0,0.0,942.0,5638.0,3160.0,0.0,0.0,0.0,0.0,0.0,739.0,0.0,Matches,128.0,nl NED,GK,29.0,34.0,0.0,0.0,0.0,,0.0,0.0,,,,0.0,0.0,0.0,0.0,0.0,,0.0,0.0,Matches,128.0,nl NED,GK,29.0,34.0,34.0,3060.0,34.0,0.0,0.0,0.0,0.0,0.0,0.0,0.0,0.0,0.0,0.0,0.3,0.3,0.0,0.0,0.0,0.0,0.0,0.0,0.0,0.0,0.0,0.01,0.01,0.0,0.01,Matches,Mark Flekken,GK,29,138,142,Holland,Sport-Club Freiburg,6,2,1,1,13,7,7,3,3,2,12,3,3,12,10,12,13,15,12,9,12,14,2,14,1,11,14,10,11,15,13,15,12,10,10,16,13,12,14,7,15,15,12,14,13,12,14,14,16,15,9,14,13,16,8,10,16,14,12,10,20,1,1,1,1,1,1,1,1,1,1,1,1,1,194,82,7,20,6315334,6791,6641,4991,Northern_European,137,2,1993/6/13,4,0,6999.0,,92056834
52,Emil Forsberg,RB Leipzig,1991,130.0,se SWE,MFFW,30.0,16.5,16.0,11.0,1.0,8.0,7.0,6.0,20.0,30.0,14.0,25.0,2.0,23.0,3.0,19.0,7.0,0.0,Matches,130.0,se SWE,MFFW,30.0,16.5,39.0,2.37,28.0,3.0,0.0,4.0,3.0,1.0,7.0,0.43,5.0,1.0,0.0,0.0,0.0,1.0,Matches,,,,,,,,,,,,,,,,,,,,,,,,,,,,,,,,,,,,,,,,,,,,,,,,,,,,,,,,130.0,se SWE,MFFW,30.0,16.5,2.0,0.0,0.0,22.0,25.0,7.0,17.0,3.0,11.0,0.0,0.0,0.0,59.0,12.0,17.0,41.4,Matches,130.0,se SWE,MFFW,30.0,16.5,520.0,499.0,18.0,4.0,3.0,2.0,17.0,4.0,8.0,3.0,4.0,0.0,422.0,3.0,10.0,Matches,130.0,se SWE,MFFW,30.0,16.5,422.0,520.0,81.2,5980.0,1691.0,259.0,300.0,86.3,124.0,145.0,85.5,20.0,32.0,62.5,4.0,2.3,2.6,1.7,18.0,47.0,21.0,1.0,67.0,Matches,148,se SWE,MFFW,30,30,1482.0,49.0,48.4,16.5,16,72.0,2,14,23.0,3,1.87,28.0,26.0,2.0,0.12,-1.08,26.8,23.7,3.1,0.19,-1.08,Matches,130.0,se SWE,MFFW,30.0,16.5,672.0,5.0,45.0,332.0,300.0,28.0,670.0,29.0,15.0,51.7,13.0,44.8,430.0,1978.0,855.0,20.0,29.0,3.0,28.0,12.0,497.0,77.0,Matches,130.0,se SWE,MFFW,30.0,16.5,6.0,21.0,9.0,42.9,1.28,0.55,0.19,0.44,18.1,1.0,2.0,2.0,4.9,3.3,0.16,1.1,0.7,Matches,130.0,se SWE,MFFW,30.0,30.0,16.0,1482.0,16.5,6.0,4.0,10.0,4.0,2.0,2.0,2.0,0.0,4.9,3.3,2.3,5.6,20.0,67.0,77.0,0.36,0.24,0.61,0.24,0.49,0.3,0.14,0.43,0.2,0.34,Matches,Emil Forsberg,M/AM RLC,30,145,150,Sweden,RB Leipzig,16,12,16,13,15,13,6,15,8,6,14,13,8,15,11,12,10,14,11,15,14,14,14,12,15,9,15,13,14,13,16,7,14,12,14,10,16,6,13,7,12,1,3,1,2,1,2,3,1,3,3,1,14,17,12,8,13,15,7,12,1,1,1,1,1,1,1,18,12,15,18,20,15,12,177,76,12,20,25680440,7250,7100,6250,Northern_European,142,3,1991/10/23,74,17,76660.0,,93011051
53,Marco Friedl,Werder Bremen,1998,137.0,at AUT,DF,24.0,28.8,62.0,46.0,40.0,22.0,0.0,41.0,68.0,60.3,27.0,46.0,17.0,29.0,58.0,120.0,127.0,1.0,Matches,137.0,at AUT,DF,24.0,28.8,24.0,0.83,20.0,3.0,1.0,0.0,0.0,0.0,1.0,0.03,1.0,0.0,0.0,0.0,0.0,0.0,Matches,,,,,,,,,,,,,,,,,,,,,,,,,,,,,,,,,,,,,,,,,,,,,,,,,,,,,,,,137.0,at AUT,DF,24.0,28.8,8.0,1.0,0.0,24.0,24.0,2.0,27.0,58.0,46.0,0.0,0.0,2.0,247.0,46.0,47.0,49.5,Matches,137.0,at AUT,DF,24.0,28.8,1731.0,1636.0,90.0,58.0,1.0,35.0,27.0,22.0,10.0,0.0,3.0,0.0,1407.0,5.0,18.0,Matches,137.0,at AUT,DF,24.0,28.8,1407.0,1731.0,81.3,30355.0,10867.0,436.0,468.0,93.2,692.0,784.0,88.3,260.0,424.0,61.3,0.0,0.4,1.6,-0.4,8.0,114.0,18.0,6.0,115.0,Matches,155,at AUT,DF,24,30,2594.0,86.0,84.8,28.8,30,86.0,27,0,,0,1.07,45.0,54.0,-9.0,-0.31,0.46,35.1,42.3,-7.2,-0.25,0.64,Matches,137.0,at AUT,DF,24.0,28.8,2074.0,218.0,1052.0,934.0,101.0,7.0,2074.0,16.0,10.0,62.5,5.0,31.3,1186.0,5378.0,2540.0,14.0,11.0,0.0,19.0,9.0,1242.0,11.0,Matches,137.0,at AUT,DF,24.0,28.8,0.0,6.0,1.0,16.7,0.21,0.03,0.0,0.0,20.8,0.0,0.0,0.0,0.5,0.5,0.09,-0.5,-0.5,Matches,137.0,at AUT,DF,24.0,30.0,30.0,2594.0,28.8,0.0,0.0,0.0,0.0,0.0,0.0,8.0,1.0,0.5,0.5,0.4,1.0,14.0,115.0,11.0,0.0,0.0,0.0,0.0,0.0,0.02,0.02,0.03,0.02,0.03,Matches,Marco Friedl,D/WB LC,24,124,139,Austria,SV Werder Bremen,10,12,8,7,12,14,11,10,15,11,13,12,12,14,12,11,13,15,12,12,11,14,8,9,9,11,14,12,12,12,13,15,16,14,15,13,12,9,15,7,16,2,3,1,2,2,2,3,2,2,1,2,12,16,9,12,15,13,10,8,1,18,20,10,16,8,12,12,11,1,8,1,1,1,187,78,20,8,2616127,6200,6200,4250,Northern_European,117,2,1998/3/16,5,0,10805.0,,91143703
54,Marvin Friedrich,Gladbach,1995,138.0,de GER,DF,26.0,13.9,17.0,11.0,13.0,3.0,1.0,10.0,13.0,76.9,3.0,14.0,6.0,8.0,11.0,28.0,52.0,0.0,Matches,138.0,de GER,DF,26.0,13.9,10.0,0.72,9.0,1.0,0.0,0.0,0.0,0.0,0.0,0.0,0.0,0.0,0.0,0.0,0.0,0.0,Matches,,,,,,,,,,,,,,,,,,,,,,,,,,,,,,,,,,,,,,,,,,,,,,,,,,,,,,,,138.0,de GER,DF,26.0,13.9,2.0,0.0,0.0,3.0,3.0,0.0,1.0,11.0,11.0,0.0,0.0,0.0,67.0,41.0,30.0,57.7,Matches,138.0,de GER,DF,26.0,13.9,965.0,928.0,33.0,30.0,1.0,7.0,1.0,3.0,0.0,0.0,0.0,0.0,830.0,4.0,8.0,Matches,138.0,de GER,DF,26.0,13.9,830.0,965.0,86.0,15811.0,5285.0,281.0,301.0,93.4,481.0,517.0,93.0,64.0,125.0,51.2,0.0,0.5,0.6,-0.5,5.0,21.0,1.0,0.0,35.0,Matches,156,de GER,DF,26,23,1248.0,54.0,40.8,13.9,13,90.0,13,10,8.0,10,1.3,27.0,29.0,-2.0,-0.14,-0.09,22.0,25.1,-3.1,-0.23,-0.32,Matches,138.0,de GER,DF,26.0,13.9,1094.0,121.0,640.0,426.0,38.0,21.0,1094.0,2.0,2.0,100.0,0.0,0.0,650.0,2870.0,1387.0,3.0,3.0,0.0,6.0,2.0,789.0,6.0,Matches,138.0,de GER,DF,26.0,13.9,1.0,9.0,4.0,44.4,0.65,0.29,0.11,0.25,12.9,0.0,0.0,0.0,0.9,0.9,0.09,0.1,0.1,Matches,138.0,de GER,DF,26.0,23.0,13.0,1248.0,13.9,1.0,0.0,1.0,1.0,0.0,0.0,2.0,0.0,0.9,0.9,0.5,1.3,3.0,35.0,6.0,0.07,0.0,0.07,0.07,0.07,0.06,0.03,0.09,0.06,0.09,Matches,Marvin Friedrich,D C,26,132,142,Germany,Borussia Mönchengladbach,4,8,8,7,11,4,16,7,6,14,12,7,14,11,14,13,16,12,13,11,12,14,8,14,10,14,13,13,11,8,15,17,13,13,12,16,12,11,14,8,9,2,3,1,3,1,3,3,1,3,2,2,8,13,5,10,12,15,11,10,1,10,20,14,1,1,1,1,1,1,1,1,1,1,193,83,11,20,4741001,6590,6590,5490,Northern_European,131,3,1995/12/13,0,0,47944.0,,92067018
55,Jeremie Frimpong,Leverkusen,2000,139.0,nl NED,DFMF,21.0,30.1,53.0,27.0,22.0,26.0,5.0,23.0,44.0,52.3,21.0,24.0,3.0,21.0,16.0,69.0,40.0,0.0,Matches,139.0,nl NED,DFMF,21.0,30.1,103.0,3.42,65.0,2.0,20.0,6.0,10.0,0.0,16.0,0.53,9.0,0.0,5.0,0.0,2.0,0.0,Matches,,,,,,,,,,,,,,,,,,,,,,,,,,,,,,,,,,,,,,,,,,,,,,,,,,,,,,,,139.0,nl NED,DFMF,21.0,30.1,4.0,0.0,0.0,22.0,58.0,8.0,70.0,16.0,27.0,1.0,0.0,0.0,118.0,12.0,23.0,34.3,Matches,139.0,nl NED,DFMF,21.0,30.1,1232.0,992.0,239.0,13.0,0.0,4.0,70.0,226.0,0.0,0.0,0.0,0.0,982.0,1.0,35.0,Matches,139.0,nl NED,DFMF,21.0,30.1,982.0,1232.0,79.7,12784.0,3814.0,684.0,768.0,89.1,230.0,302.0,76.2,30.0,69.0,43.5,7.0,6.2,6.3,0.8,45.0,39.0,27.0,11.0,62.0,Matches,157,nl NED,DFMF,21,34,2708.0,80.0,88.5,30.1,32,82.0,16,2,41.0,0,1.47,50.0,40.0,10.0,0.33,0.84,46.3,36.7,9.6,0.32,0.59,Matches,139.0,nl NED,DFMF,21.0,30.1,1621.0,47.0,349.0,670.0,636.0,122.0,1621.0,165.0,85.0,51.5,51.0,30.9,909.0,7276.0,4495.0,155.0,103.0,46.0,88.0,49.0,1009.0,250.0,Matches,139.0,nl NED,DFMF,21.0,30.1,8.0,38.0,19.0,50.0,1.26,0.63,0.21,0.42,11.9,0.0,0.0,0.0,7.6,7.6,0.2,0.4,0.4,Matches,139.0,nl NED,DFMF,21.0,34.0,32.0,2708.0,30.1,8.0,7.0,15.0,8.0,0.0,0.0,4.0,0.0,7.6,7.6,6.2,13.8,155.0,62.0,250.0,0.27,0.23,0.5,0.27,0.5,0.25,0.21,0.46,0.25,0.46,Matches,Jeremie Frimpong,D/WB/M RL,21,142,162,"Holland,Ghana,England",Bayer 04 Leverkusen,11,11,15,10,11,10,6,9,6,11,11,8,12,14,13,12,14,11,11,12,11,14,13,8,14,10,13,14,18,15,11,6,14,18,14,11,12,6,12,5,12,1,1,1,3,1,3,1,3,2,3,3,13,12,6,11,12,12,13,13,1,16,1,20,16,20,1,1,1,17,1,1,12,1,171,64,6,20,69660001,7100,6343,5696,African_Caribbean,122,17,2000/12/10,0,0,28766.0,,28113828
56,Chris Führich,Stuttgart,1998,140.0,de GER,FWMF,24.0,20.9,36.0,14.0,15.0,14.0,7.0,24.0,44.0,54.5,20.0,29.0,2.0,27.0,7.0,43.0,13.0,0.0,Matches,140.0,de GER,FWMF,24.0,20.9,79.0,3.77,52.0,11.0,7.0,6.0,3.0,0.0,9.0,0.43,7.0,2.0,0.0,0.0,0.0,0.0,Matches,,,,,,,,,,,,,,,,,,,,,,,,,,,,,,,,,,,,,,,,,,,,,,,,,,,,,,,,140.0,de GER,FWMF,24.0,20.9,2.0,0.0,0.0,6.0,10.0,3.0,50.0,7.0,14.0,0.0,0.0,0.0,104.0,3.0,10.0,23.1,Matches,140.0,de GER,FWMF,24.0,20.9,704.0,633.0,69.0,9.0,2.0,13.0,50.0,21.0,31.0,6.0,18.0,0.0,552.0,2.0,15.0,Matches,140.0,de GER,FWMF,24.0,20.9,552.0,704.0,78.4,8781.0,2032.0,300.0,342.0,87.7,195.0,236.0,82.6,43.0,78.0,55.1,2.0,4.8,3.5,-2.8,24.0,43.0,21.0,3.0,83.0,Matches,158,de GER,FWMF,24,33,1884.0,57.0,61.6,20.9,21,72.0,1,12,31.0,0,0.91,27.0,35.0,-8.0,-0.38,-0.08,27.8,28.7,-0.9,-0.04,-0.3,Matches,140.0,de GER,FWMF,24.0,20.9,948.0,16.0,131.0,376.0,461.0,69.0,947.0,106.0,50.0,47.2,45.0,42.5,575.0,4471.0,2403.0,93.0,60.0,31.0,36.0,29.0,641.0,142.0,Matches,140.0,de GER,FWMF,24.0,20.9,5.0,43.0,13.0,30.2,2.05,0.62,0.09,0.31,18.5,0.0,1.0,1.0,3.6,2.9,0.07,1.4,1.1,Matches,140.0,de GER,FWMF,24.0,33.0,21.0,1884.0,20.9,5.0,2.0,7.0,4.0,1.0,1.0,2.0,0.0,3.6,2.9,4.8,7.6,93.0,83.0,142.0,0.24,0.1,0.33,0.19,0.29,0.17,0.23,0.4,0.14,0.37,Matches,Chris Führich,M/AM RLC,24,130,136,Germany,VfB Stuttgart,13,13,14,11,13,13,7,13,5,8,13,12,11,13,10,12,13,11,11,13,12,15,14,8,14,10,13,13,13,14,12,9,13,14,13,10,12,6,11,6,16,2,3,2,3,2,2,3,2,3,2,3,7,13,7,13,13,15,13,13,1,1,1,1,10,14,1,10,16,15,15,16,20,10,178,69,12,20,4339450,6450,6450,4850,Northern_European,129,2,1998/1/9,0,0,14383.0,,91178612
57,Niclas Füllkrug,Werder Bremen,1993,142.0,de GER,FW,29.0,27.5,9.0,4.0,0.0,6.0,3.0,3.0,13.0,23.1,10.0,13.0,4.0,9.0,1.0,10.0,24.0,0.0,Matches,142.0,de GER,FW,29.0,27.5,74.0,2.69,54.0,0.0,3.0,8.0,9.0,0.0,10.0,0.36,8.0,0.0,0.0,1.0,1.0,0.0,Matches,,,,,,,,,,,,,,,,,,,,,,,,,,,,,,,,,,,,,,,,,,,,,,,,,,,,,,,,142.0,de GER,FW,29.0,27.5,4.0,0.0,0.0,33.0,48.0,27.0,20.0,1.0,4.0,0.0,0.0,0.0,84.0,153.0,130.0,54.1,Matches,142.0,de GER,FW,29.0,27.5,929.0,908.0,17.0,0.0,4.0,15.0,20.0,1.0,0.0,0.0,0.0,0.0,581.0,4.0,36.0,Matches,142.0,de GER,FW,29.0,27.5,581.0,929.0,62.5,9105.0,1989.0,323.0,457.0,70.7,167.0,271.0,61.6,59.0,91.0,64.8,5.0,3.6,3.4,1.4,34.0,48.0,27.0,1.0,90.0,Matches,160,de GER,FW,29,28,2477.0,88.0,80.9,27.5,28,88.0,26,0,,1,1.18,41.0,46.0,-5.0,-0.18,1.05,32.3,40.3,-8.0,-0.29,0.29,Matches,142.0,de GER,FW,29.0,27.5,1227.0,31.0,70.0,635.0,534.0,131.0,1222.0,60.0,31.0,51.7,22.0,36.7,668.0,2854.0,1216.0,41.0,33.0,21.0,74.0,51.0,1005.0,200.0,Matches,142.0,de GER,FW,29.0,27.5,16.0,74.0,32.0,43.2,2.69,1.16,0.15,0.34,16.0,0.0,5.0,5.0,12.8,8.6,0.12,3.2,2.4,Matches,142.0,de GER,FW,29.0,28.0,28.0,2477.0,27.5,16.0,5.0,21.0,11.0,5.0,5.0,4.0,0.0,12.8,8.6,3.6,12.2,41.0,90.0,200.0,0.58,0.18,0.76,0.4,0.58,0.47,0.13,0.6,0.31,0.44,Matches,Niclas Füllkrug,S L,29,129,143,Germany,SV Werder Bremen,7,9,13,13,12,14,15,13,6,7,10,14,6,11,14,13,16,13,12,10,11,11,12,12,12,7,12,14,13,11,14,16,11,13,12,15,11,8,13,16,11,4,2,2,2,1,1,4,2,3,2,2,7,15,9,13,13,12,14,14,1,1,1,1,1,1,1,15,1,12,15,10,12,20,189,81,12,20,3936650,6448,6448,5098,Northern_European,128,4,1993/2/9,0,0,37499.0,,92018043
58,Cristian Gamboa,Bochum,1989,143.0,cr CRC,DF,32.0,16.4,42.0,24.0,27.0,14.0,1.0,21.0,31.0,67.7,10.0,20.0,7.0,13.0,16.0,58.0,34.0,1.0,Matches,143.0,cr CRC,DF,32.0,16.4,28.0,1.71,20.0,6.0,1.0,0.0,0.0,1.0,2.0,0.12,0.0,2.0,0.0,0.0,0.0,0.0,Matches,,,,,,,,,,,,,,,,,,,,,,,,,,,,,,,,,,,,,,,,,,,,,,,,,,,,,,,,143.0,cr CRC,DF,32.0,16.4,2.0,0.0,0.0,14.0,5.0,2.0,43.0,16.0,24.0,0.0,1.0,1.0,91.0,12.0,9.0,57.1,Matches,143.0,cr CRC,DF,32.0,16.4,684.0,572.0,109.0,2.0,1.0,3.0,43.0,107.0,0.0,0.0,0.0,0.0,458.0,3.0,12.0,Matches,143.0,cr CRC,DF,32.0,16.4,458.0,684.0,67.0,9419.0,3894.0,171.0,206.0,83.0,190.0,271.0,70.1,92.0,178.0,51.7,0.0,0.5,0.7,-0.5,9.0,57.0,14.0,9.0,56.0,Matches,161,cr CRC,DF,32,19,1477.0,78.0,48.3,16.4,17,82.0,8,2,42.0,3,0.79,15.0,37.0,-22.0,-1.34,-0.77,17.5,34.8,-17.3,-1.06,-0.58,Matches,143.0,cr CRC,DF,32.0,16.4,830.0,62.0,295.0,393.0,147.0,2.0,830.0,14.0,6.0,42.9,6.0,42.9,339.0,1516.0,718.0,10.0,9.0,1.0,10.0,4.0,415.0,21.0,Matches,143.0,cr CRC,DF,32.0,16.4,0.0,8.0,1.0,12.5,0.49,0.06,0.0,0.0,29.6,0.0,0.0,0.0,0.2,0.2,0.02,-0.2,-0.2,Matches,143.0,cr CRC,DF,32.0,19.0,17.0,1477.0,16.4,0.0,0.0,0.0,0.0,0.0,0.0,2.0,0.0,0.2,0.2,0.5,0.7,10.0,56.0,21.0,0.0,0.0,0.0,0.0,0.0,0.01,0.03,0.04,0.01,0.04,Matches,Cristian Gamboa,D/WB R,32,121,130,Costa Rica,VfL Bochum 1848,8,11,12,6,13,7,8,9,14,11,10,7,14,12,15,10,10,10,10,8,10,12,12,6,9,8,14,15,15,14,8,8,10,18,16,10,9,6,12,8,15,3,3,1,2,4,1,3,2,2,3,3,14,13,5,10,11,15,14,7,1,1,1,20,1,17,1,1,1,1,1,1,1,1,175,70,7,20,642498,5990,5990,4490,Mediterranean_Hispanic,110,4,1989/10/24,79,3,10000.0,,80000968
59,Dennis Geiger,Hoffenheim,1998,146.0,de GER,MF,24.0,21.7,45.0,25.0,15.0,28.0,2.0,22.0,35.0,62.9,13.0,27.0,3.0,24.0,24.0,69.0,18.0,2.0,Matches,146.0,de GER,MF,24.0,21.7,57.0,2.63,38.0,14.0,2.0,1.0,0.0,2.0,7.0,0.32,6.0,1.0,0.0,0.0,0.0,0.0,Matches,,,,,,,,,,,,,,,,,,,,,,,,,,,,,,,,,,,,,,,,,,,,,,,,,,,,,,,,146.0,de GER,MF,24.0,21.7,9.0,0.0,0.0,42.0,20.0,1.0,49.0,24.0,25.0,0.0,0.0,0.0,115.0,8.0,18.0,30.8,Matches,146.0,de GER,MF,24.0,21.7,852.0,741.0,107.0,42.0,2.0,4.0,49.0,3.0,42.0,7.0,26.0,1.0,697.0,4.0,17.0,Matches,146.0,de GER,MF,24.0,21.7,697.0,852.0,81.8,12742.0,4292.0,293.0,325.0,90.2,306.0,351.0,87.2,79.0,127.0,62.2,3.0,2.7,3.4,0.3,35.0,74.0,15.0,1.0,99.0,Matches,165,de GER,MF,24,27,1952.0,72.0,63.8,21.7,27,72.0,6,0,,1,1.26,31.0,36.0,-5.0,-0.23,0.09,30.7,33.4,-2.7,-0.12,-0.09,Matches,146.0,de GER,MF,24.0,21.7,1027.0,36.0,218.0,618.0,202.0,7.0,1027.0,16.0,9.0,56.3,5.0,31.3,525.0,2874.0,1267.0,21.0,11.0,0.0,22.0,8.0,582.0,22.0,Matches,146.0,de GER,MF,24.0,21.7,1.0,5.0,3.0,60.0,0.23,0.14,0.2,0.33,24.7,0.0,0.0,0.0,0.2,0.2,0.03,0.8,0.8,Matches,146.0,de GER,MF,24.0,27.0,27.0,1952.0,21.7,1.0,3.0,4.0,1.0,0.0,0.0,9.0,0.0,0.2,0.2,2.7,2.9,21.0,99.0,22.0,0.05,0.14,0.18,0.05,0.18,0.01,0.12,0.13,0.01,0.13,Matches,Dennis Geiger,DM/M C,24,135,144,Germany,TSG Hoffenheim,15,13,11,8,15,14,7,12,6,12,15,12,12,15,15,14,14,16,13,15,14,13,11,9,10,12,17,13,12,14,13,6,12,10,14,10,13,12,12,13,11,4,2,3,2,1,3,1,2,1,2,1,9,14,7,12,15,13,15,11,1,1,1,1,1,1,20,1,20,1,1,14,1,1,173,65,10,20,6480280,6749,6749,5299,Northern_European,132,2,1998/6/10,0,0,26370.0,,91143563
60,Yannick Gerhardt,Wolfsburg,1994,147.0,de GER,MF,28.0,20.7,29.0,15.0,10.0,11.0,8.0,12.0,30.0,40.0,18.0,26.0,5.0,21.0,7.0,36.0,24.0,0.0,Matches,147.0,de GER,MF,28.0,20.7,45.0,2.17,36.0,0.0,0.0,3.0,5.0,1.0,8.0,0.39,7.0,0.0,0.0,0.0,1.0,0.0,Matches,,,,,,,,,,,,,,,,,,,,,,,,,,,,,,,,,,,,,,,,,,,,,,,,,,,,,,,,147.0,de GER,MF,28.0,20.7,3.0,0.0,0.0,18.0,21.0,2.0,18.0,7.0,15.0,0.0,1.0,0.0,87.0,22.0,40.0,35.5,Matches,147.0,de GER,MF,28.0,20.7,674.0,639.0,30.0,13.0,2.0,4.0,18.0,5.0,3.0,2.0,1.0,0.0,503.0,5.0,25.0,Matches,147.0,de GER,MF,28.0,20.7,503.0,674.0,74.6,8116.0,2535.0,269.0,313.0,85.9,193.0,246.0,78.5,30.0,63.0,47.6,4.0,2.2,2.0,1.8,20.0,63.0,13.0,3.0,82.0,Matches,166,de GER,MF,28,29,1866.0,64.0,61.0,20.7,22,79.0,12,7,18.0,0,1.62,37.0,25.0,12.0,0.58,0.8,34.3,27.1,7.2,0.35,0.89,Matches,147.0,de GER,MF,28.0,20.7,856.0,34.0,161.0,445.0,254.0,55.0,856.0,16.0,4.0,25.0,11.0,68.8,468.0,2089.0,842.0,12.0,11.0,3.0,22.0,10.0,557.0,88.0,Matches,147.0,de GER,MF,28.0,20.7,6.0,27.0,13.0,48.1,1.3,0.63,0.22,0.46,12.0,0.0,0.0,0.0,5.7,5.7,0.21,0.3,0.3,Matches,147.0,de GER,MF,28.0,29.0,22.0,1866.0,20.7,6.0,4.0,10.0,6.0,0.0,0.0,3.0,0.0,5.7,5.7,2.2,7.9,12.0,82.0,88.0,0.29,0.19,0.48,0.29,0.48,0.28,0.11,0.38,0.28,0.38,Matches,Yannick Gerhardt,DM/M LC,28,134,140,Germany,VfL Wolfsburg,11,11,11,11,13,7,12,9,6,12,12,6,14,12,13,13,14,12,12,12,13,13,10,8,14,12,17,16,12,11,12,12,17,13,16,12,13,8,13,7,18,2,3,3,3,1,3,1,1,3,1,1,9,12,8,16,12,17,13,13,1,15,1,1,15,1,17,12,20,10,12,15,10,1,184,79,20,13,7472536,6700,6700,5700,Northern_European,128,4,1994/3/13,1,0,67122.0,,91105029
61,Niko Gießelmann,Union Berlin,1991,148.0,de GER,DF,30.0,14.5,21.0,11.0,9.0,9.0,3.0,13.0,31.0,41.9,18.0,17.0,5.0,12.0,9.0,30.0,28.0,0.0,Matches,148.0,de GER,DF,30.0,14.5,47.0,3.25,22.0,19.0,2.0,2.0,2.0,0.0,7.0,0.48,3.0,2.0,1.0,1.0,0.0,0.0,Matches,,,,,,,,,,,,,,,,,,,,,,,,,,,,,,,,,,,,,,,,,,,,,,,,,,,,,,,,148.0,de GER,DF,30.0,14.5,4.0,0.0,0.0,16.0,21.0,0.0,88.0,9.0,11.0,0.0,0.0,0.0,60.0,21.0,18.0,53.8,Matches,148.0,de GER,DF,30.0,14.5,744.0,521.0,221.0,23.0,0.0,3.0,88.0,165.0,33.0,21.0,6.0,0.0,496.0,2.0,25.0,Matches,148.0,de GER,DF,30.0,14.5,496.0,744.0,66.7,9352.0,3543.0,219.0,265.0,82.6,192.0,288.0,66.7,77.0,146.0,52.7,2.0,1.7,1.9,0.3,22.0,36.0,22.0,11.0,50.0,Matches,167,de GER,DF,30,26,1302.0,50.0,42.5,14.5,14,82.0,7,12,12.0,6,1.88,23.0,13.0,10.0,0.69,0.54,15.0,16.6,-1.6,-0.11,0.05,Matches,148.0,de GER,DF,30.0,14.5,889.0,37.0,254.0,322.0,319.0,22.0,889.0,14.0,4.0,28.6,8.0,57.1,349.0,1310.0,593.0,14.0,8.0,0.0,17.0,6.0,416.0,50.0,Matches,148.0,de GER,DF,30.0,14.5,0.0,20.0,3.0,15.0,1.38,0.21,0.0,0.0,20.2,2.0,0.0,0.0,1.1,1.1,0.06,-1.1,-1.1,Matches,148.0,de GER,DF,30.0,26.0,14.0,1302.0,14.5,0.0,2.0,2.0,0.0,0.0,0.0,4.0,0.0,1.1,1.1,1.7,2.8,14.0,50.0,50.0,0.0,0.14,0.14,0.0,0.14,0.08,0.11,0.19,0.08,0.19,Matches,Niko Gießelmann,D/WB L,30,137,138,Germany,1. FC Union Berlin,12,14,12,9,12,13,8,13,16,12,13,13,13,11,14,13,15,12,14,12,14,14,11,11,13,13,16,16,13,12,11,12,14,13,15,11,16,10,16,7,14,3,1,1,1,3,1,2,2,2,1,2,8,12,5,12,11,14,13,10,1,20,1,1,20,1,1,12,1,1,10,1,1,1,182,76,20,11,3433771,6599,6599,4999,Northern_European,136,5,1991/9/26,0,0,9588.0,,92025551
62,Rafał Gikiewicz,Augsburg,1987,149.0,pl POL,GK,34.0,23.0,2.0,2.0,2.0,0.0,0.0,2.0,3.0,66.7,1.0,0.0,0.0,0.0,0.0,2.0,15.0,5.0,Matches,149.0,pl POL,GK,34.0,23.0,7.0,0.3,3.0,4.0,0.0,0.0,0.0,0.0,1.0,0.04,0.0,1.0,0.0,0.0,0.0,0.0,Matches,10.0,pl POL,GK,34.0,23.0,41.0,1.0,1.0,4.0,0.0,41.3,0.28,0.3,0.01,185.0,452.0,40.9,916.0,127.0,33.3,33.0,234.0,62.8,48.9,363.0,21.0,5.8,45.0,1.96,16.7,Matches,10.0,pl POL,GK,34.0,23.0,23.0,2070.0,23.0,41.0,1.78,136.0,93.0,70.6,8.0,3.0,12.0,5.0,21.7,4.0,1.0,2.0,1.0,66.7,Matches,149.0,pl POL,GK,34.0,23.0,3.0,0.0,0.0,0.0,4.0,0.0,0.0,0.0,2.0,0.0,0.0,0.0,58.0,6.0,1.0,85.7,Matches,149.0,pl POL,GK,34.0,23.0,1152.0,829.0,321.0,87.0,0.0,3.0,0.0,0.0,0.0,0.0,0.0,0.0,846.0,2.0,1.0,Matches,149.0,pl POL,GK,34.0,23.0,846.0,1152.0,73.4,24931.0,17753.0,134.0,137.0,97.8,410.0,417.0,98.3,300.0,593.0,50.6,0.0,0.0,0.1,0.0,0.0,23.0,1.0,0.0,0.0,Matches,168,pl POL,GK,34,23,2070.0,90.0,67.6,23.0,23,90.0,23,0,,0,1.17,28.0,41.0,-13.0,-0.57,0.16,24.3,38.9,-14.6,-0.64,0.21,Matches,149.0,pl POL,GK,34.0,23.0,1221.0,960.0,1213.0,10.0,0.0,0.0,1221.0,0.0,0.0,,0.0,,713.0,4039.0,2275.0,0.0,0.0,0.0,2.0,0.0,552.0,0.0,Matches,149.0,pl POL,GK,34.0,23.0,0.0,0.0,0.0,,0.0,0.0,,,,0.0,0.0,0.0,0.0,0.0,,0.0,0.0,Matches,149.0,pl POL,GK,34.0,23.0,23.0,2070.0,23.0,0.0,0.0,0.0,0.0,0.0,0.0,3.0,0.0,0.0,0.0,0.0,0.0,0.0,0.0,0.0,0.0,0.0,0.0,0.0,0.0,0.0,0.0,0.0,0.0,0.0,Matches,Rafał Gikiewicz,GK,34,127,129,Poland,FC Augsburg,3,2,1,2,10,6,3,2,2,2,12,1,2,6,16,12,15,12,12,10,12,13,1,12,1,11,8,12,10,13,15,16,14,10,12,13,15,4,13,4,10,15,14,13,15,12,8,14,16,16,10,12,12,15,16,5,8,10,6,4,20,1,1,1,1,1,1,1,1,1,1,1,1,1,190,81,7,20,817802,6334,5884,4734,Northern_European,124,5,1987/10/26,0,0,14999.0,,54008309
63,Matthias Ginter,Freiburg,1994,150.0,de GER,DF,28.0,34.0,43.0,20.0,29.0,12.0,2.0,26.0,40.0,65.0,14.0,40.0,24.0,16.0,35.0,78.0,153.0,3.0,Matches,150.0,de GER,DF,28.0,34.0,32.0,0.94,27.0,0.0,0.0,4.0,1.0,0.0,2.0,0.06,2.0,0.0,0.0,0.0,0.0,0.0,Matches,,,,,,,,,,,,,,,,,,,,,,,,,,,,,,,,,,,,,,,,,,,,,,,,,,,,,,,,150.0,de GER,DF,28.0,34.0,3.0,0.0,0.0,23.0,28.0,1.0,8.0,35.0,20.0,0.0,0.0,0.0,184.0,119.0,69.0,63.3,Matches,150.0,de GER,DF,28.0,34.0,1903.0,1826.0,68.0,58.0,2.0,12.0,8.0,4.0,0.0,0.0,0.0,0.0,1566.0,9.0,10.0,Matches,150.0,de GER,DF,28.0,34.0,1566.0,1903.0,82.3,32228.0,12401.0,436.0,506.0,86.2,903.0,1006.0,89.8,216.0,350.0,61.7,1.0,0.9,1.5,0.1,13.0,122.0,12.0,1.0,122.0,Matches,169,de GER,DF,28,34,3060.0,90.0,100.0,34.0,34,90.0,34,0,,0,1.74,51.0,44.0,7.0,0.21,,48.0,48.8,-0.8,-0.02,,Matches,150.0,de GER,DF,28.0,34.0,2230.0,240.0,1151.0,993.0,94.0,46.0,2230.0,4.0,2.0,50.0,2.0,50.0,1305.0,7344.0,4228.0,23.0,12.0,0.0,12.0,4.0,1412.0,11.0,Matches,150.0,de GER,DF,28.0,34.0,4.0,21.0,11.0,52.4,0.62,0.32,0.19,0.36,11.1,0.0,0.0,0.0,1.9,1.9,0.09,2.1,2.1,Matches,150.0,de GER,DF,28.0,34.0,34.0,3060.0,34.0,4.0,1.0,5.0,4.0,0.0,0.0,3.0,0.0,1.9,1.9,0.9,2.9,23.0,122.0,11.0,0.12,0.03,0.15,0.12,0.15,0.06,0.03,0.08,0.06,0.08,Matches,Matthias Ginter,D RC,28,141,148,Germany,Sport-Club Freiburg,6,9,7,7,13,7,15,10,11,14,13,11,14,13,7,15,12,15,15,12,15,14,8,13,10,15,15,14,11,9,13,14,16,11,14,14,15,6,13,7,16,1,1,2,3,2,3,1,3,2,2,2,8,15,3,15,15,16,18,18,1,1,20,15,1,11,14,1,12,1,1,10,1,8,191,86,12,20,10532532,6950,6950,6400,Northern_European,141,2,1994/1/19,46,2,44999.0,,91107789
64,Serge Gnabry,Bayern Munich,1995,151.0,de GER,FWMF,27.0,21.6,35.0,23.0,11.0,14.0,10.0,17.0,43.0,39.5,26.0,24.0,1.0,23.0,11.0,46.0,5.0,1.0,Matches,151.0,de GER,FWMF,27.0,21.6,88.0,4.08,59.0,3.0,10.0,10.0,3.0,3.0,14.0,0.65,9.0,0.0,3.0,0.0,2.0,0.0,Matches,,,,,,,,,,,,,,,,,,,,,,,,,,,,,,,,,,,,,,,,,,,,,,,,,,,,,,,,151.0,de GER,FWMF,27.0,21.6,0.0,0.0,0.0,33.0,10.0,9.0,39.0,11.0,23.0,2.0,2.0,0.0,91.0,11.0,19.0,36.7,Matches,151.0,de GER,FWMF,27.0,21.6,873.0,830.0,37.0,0.0,4.0,1.0,39.0,14.0,9.0,4.0,5.0,0.0,693.0,6.0,22.0,Matches,151.0,de GER,FWMF,27.0,21.6,693.0,873.0,79.4,9720.0,2515.0,443.0,516.0,85.9,193.0,229.0,84.3,37.0,68.0,54.4,5.0,5.3,4.8,-0.3,36.0,49.0,33.0,5.0,82.0,Matches,171,de GER,FWMF,27,34,1941.0,57.0,63.4,21.6,22,74.0,9,12,26.0,0,2.09,59.0,21.0,38.0,1.76,0.48,49.0,21.9,27.1,1.26,0.4,Matches,151.0,de GER,FWMF,27.0,21.6,1149.0,7.0,124.0,474.0,565.0,146.0,1148.0,64.0,28.0,43.8,30.0,46.9,747.0,4275.0,2010.0,74.0,50.0,41.0,51.0,26.0,880.0,217.0,Matches,151.0,de GER,FWMF,27.0,21.6,14.0,81.0,40.0,49.4,3.76,1.85,0.16,0.33,15.5,1.0,1.0,1.0,11.2,10.4,0.13,2.8,2.6,Matches,151.0,de GER,FWMF,27.0,34.0,22.0,1941.0,21.6,14.0,5.0,19.0,13.0,1.0,1.0,0.0,0.0,11.2,10.4,5.3,15.7,74.0,82.0,217.0,0.65,0.23,0.88,0.6,0.83,0.52,0.25,0.76,0.48,0.73,Matches,Serge Gnabry,AM/S RL,27,160,170,"Germany,Ivory Coast",FC Bayern München,12,11,15,15,14,11,11,16,6,8,13,11,9,15,11,16,12,14,11,14,12,12,15,5,17,8,12,12,16,15,16,8,13,15,12,12,12,6,14,10,16,1,1,3,2,2,2,1,2,3,3,3,14,18,12,14,12,14,14,13,1,1,1,1,10,14,1,15,10,15,18,12,20,18,176,77,16,20,78165002,7998,7998,7498,Mixed_Race,151,13,1995/7/14,34,20,306848.0,,28066083
65,Leon Goretzka,Bayern Munich,1995,153.0,de GER,MF,27.0,19.2,43.0,24.0,21.0,16.0,6.0,27.0,48.0,56.3,21.0,40.0,3.0,37.0,30.0,73.0,32.0,0.0,Matches,153.0,de GER,MF,27.0,19.2,49.0,2.55,36.0,0.0,1.0,10.0,1.0,1.0,6.0,0.31,2.0,0.0,1.0,3.0,0.0,0.0,Matches,,,,,,,,,,,,,,,,,,,,,,,,,,,,,,,,,,,,,,,,,,,,,,,,,,,,,,,,153.0,de GER,MF,27.0,19.2,5.0,0.0,0.0,23.0,19.0,3.0,10.0,30.0,24.0,0.0,0.0,0.0,140.0,46.0,23.0,66.7,Matches,153.0,de GER,MF,27.0,19.2,1012.0,984.0,24.0,18.0,4.0,2.0,10.0,4.0,0.0,0.0,0.0,0.0,826.0,4.0,13.0,Matches,153.0,de GER,MF,27.0,19.2,826.0,1012.0,81.6,12312.0,3833.0,455.0,515.0,88.3,290.0,354.0,81.9,45.0,72.0,62.5,2.0,2.3,2.5,-0.3,21.0,80.0,19.0,0.0,114.0,Matches,174,de GER,MF,27,27,1728.0,64.0,56.5,19.2,22,74.0,7,5,18.0,1,2.0,48.0,23.0,25.0,1.3,-0.66,40.2,24.8,15.4,0.8,-0.71,Matches,153.0,de GER,MF,27.0,19.2,1272.0,56.0,296.0,678.0,312.0,43.0,1272.0,17.0,9.0,52.9,6.0,35.3,646.0,3087.0,1775.0,42.0,32.0,6.0,20.0,11.0,817.0,62.0,Matches,153.0,de GER,MF,27.0,19.2,3.0,40.0,13.0,32.5,2.08,0.68,0.08,0.23,17.2,0.0,0.0,0.0,4.7,4.7,0.12,-1.7,-1.7,Matches,153.0,de GER,MF,27.0,27.0,22.0,1728.0,19.2,3.0,2.0,5.0,3.0,0.0,0.0,5.0,0.0,4.7,4.7,2.3,7.1,42.0,114.0,62.0,0.16,0.1,0.26,0.16,0.26,0.25,0.12,0.37,0.25,0.37,Matches,Leon Goretzka,DM/M/AM C,27,164,170,Germany,FC Bayern München,5,11,12,14,15,6,16,15,6,12,15,11,15,15,14,17,16,16,15,15,15,18,12,14,18,13,17,18,12,11,15,16,12,15,17,17,16,9,14,14,18,2,1,2,3,2,3,2,3,2,1,1,12,18,10,10,16,18,15,8,1,10,1,10,10,10,17,12,20,12,10,16,10,1,189,82,10,20,89723700,8200,8200,8000,Northern_European,164,4,1995/2/6,44,14,268492.0,,91104807
66,Mario Götze,Eint Frankfurt,1992,154.0,de GER,MF,30.0,30.4,42.0,25.0,13.0,22.0,7.0,14.0,47.0,29.8,33.0,25.0,0.0,25.0,13.0,55.0,12.0,0.0,Matches,154.0,de GER,MF,30.0,30.4,101.0,3.32,79.0,13.0,2.0,5.0,1.0,1.0,14.0,0.46,12.0,0.0,0.0,2.0,0.0,0.0,Matches,,,,,,,,,,,,,,,,,,,,,,,,,,,,,,,,,,,,,,,,,,,,,,,,,,,,,,,,154.0,de GER,MF,30.0,30.4,6.0,0.0,0.0,25.0,44.0,3.0,102.0,13.0,25.0,0.0,0.0,0.0,167.0,2.0,19.0,9.5,Matches,154.0,de GER,MF,30.0,30.4,1527.0,1397.0,119.0,28.0,12.0,9.0,102.0,14.0,38.0,15.0,13.0,1.0,1130.0,11.0,48.0,Matches,154.0,de GER,MF,30.0,30.4,1130.0,1527.0,74.0,16936.0,4802.0,621.0,724.0,85.8,376.0,496.0,75.8,72.0,161.0,44.7,1.0,5.3,6.7,-4.3,42.0,90.0,44.0,10.0,149.0,Matches,176,de GER,MF,30,32,2740.0,86.0,89.5,30.4,32,86.0,22,0,,0,1.53,55.0,43.0,12.0,0.39,2.08,47.8,36.7,11.0,0.36,1.04,Matches,154.0,de GER,MF,30.0,30.4,1820.0,19.0,214.0,920.0,704.0,78.0,1820.0,75.0,25.0,33.3,45.0,60.0,1043.0,4368.0,1987.0,57.0,49.0,15.0,56.0,46.0,1325.0,212.0,Matches,154.0,de GER,MF,30.0,30.4,3.0,26.0,7.0,26.9,0.85,0.23,0.12,0.43,16.4,0.0,0.0,0.0,3.2,3.2,0.12,-0.2,-0.2,Matches,154.0,de GER,MF,30.0,32.0,32.0,2740.0,30.4,3.0,1.0,4.0,3.0,0.0,0.0,6.0,0.0,3.2,3.2,5.3,8.5,57.0,149.0,212.0,0.1,0.03,0.13,0.1,0.13,0.11,0.17,0.28,0.11,0.28,Matches,Mario Götze,M/AM/S C,30,147,171,Germany,Eintracht Frankfurt,12,13,16,12,16,11,8,10,5,7,16,10,9,17,8,16,8,16,15,16,16,12,14,12,15,7,18,18,12,14,17,7,7,11,11,8,15,5,15,16,15,1,3,1,3,1,2,1,2,3,1,2,9,14,13,10,7,13,14,18,1,1,1,1,1,1,6,12,16,12,13,20,13,16,176,75,10,20,26726078,7350,7350,6500,Northern_European,143,5,1992/6/3,63,17,62500.0,,35017438
67,Jeffrey Gouweleeuw,Augsburg,1991,155.0,nl NED,DF,31.0,31.1,42.0,27.0,19.0,17.0,6.0,24.0,49.0,49.0,25.0,41.0,23.0,18.0,50.0,92.0,141.0,2.0,Matches,155.0,nl NED,DF,31.0,31.1,35.0,1.13,24.0,3.0,3.0,4.0,0.0,1.0,3.0,0.1,1.0,0.0,0.0,2.0,0.0,0.0,Matches,,,,,,,,,,,,,,,,,,,,,,,,,,,,,,,,,,,,,,,,,,,,,,,,,,,,,,,,155.0,nl NED,DF,31.0,31.1,12.0,0.0,0.0,36.0,8.0,2.0,8.0,50.0,27.0,0.0,1.0,1.0,214.0,81.0,65.0,55.5,Matches,155.0,nl NED,DF,31.0,31.1,1481.0,1375.0,95.0,89.0,7.0,12.0,8.0,5.0,0.0,0.0,0.0,0.0,1036.0,11.0,16.0,Matches,155.0,nl NED,DF,31.0,31.1,1036.0,1481.0,70.0,22964.0,9746.0,301.0,381.0,79.0,549.0,647.0,84.9,176.0,392.0,44.9,1.0,2.1,1.5,-1.1,12.0,102.0,14.0,1.0,80.0,Matches,177,nl NED,DF,31,32,2795.0,87.0,91.3,31.1,32,87.0,30,0,,0,1.03,39.0,56.0,-17.0,-0.55,0.81,31.9,54.2,-22.2,-0.72,-0.12,Matches,155.0,nl NED,DF,31.0,31.1,1829.0,236.0,1074.0,673.0,97.0,23.0,1829.0,19.0,13.0,68.4,6.0,31.6,912.0,4873.0,2635.0,18.0,12.0,0.0,25.0,7.0,946.0,10.0,Matches,155.0,nl NED,DF,31.0,31.1,0.0,15.0,4.0,26.7,0.48,0.13,0.0,0.0,15.4,0.0,0.0,0.0,1.4,1.4,0.1,-1.4,-1.4,Matches,155.0,nl NED,DF,31.0,32.0,32.0,2795.0,31.1,0.0,1.0,1.0,0.0,0.0,0.0,12.0,0.0,1.4,1.4,2.1,3.6,18.0,80.0,10.0,0.0,0.03,0.03,0.0,0.03,0.05,0.07,0.12,0.05,0.12,Matches,Jeffrey Gouweleeuw,D C,31,126,135,Holland,FC Augsburg,7,10,12,8,12,8,12,10,10,13,13,12,14,13,14,14,10,15,11,13,13,12,10,12,8,12,10,13,12,11,15,14,15,14,13,12,13,10,13,5,9,1,1,1,1,1,3,4,2,3,3,1,11,14,10,12,13,11,16,14,1,1,20,10,1,8,12,1,12,1,1,1,1,1,188,78,10,20,2838964,6400,6150,4750,Northern_European,125,5,1991/7/10,0,0,23077.0,,37004721
68,Michael Gregoritsch,Freiburg,1994,157.0,at AUT,FW,28.0,23.9,19.0,12.0,6.0,9.0,4.0,3.0,21.0,14.3,18.0,23.0,4.0,19.0,5.0,24.0,10.0,0.0,Matches,157.0,at AUT,FW,28.0,23.9,67.0,2.8,49.0,1.0,2.0,10.0,5.0,0.0,10.0,0.42,7.0,0.0,0.0,2.0,1.0,0.0,Matches,,,,,,,,,,,,,,,,,,,,,,,,,,,,,,,,,,,,,,,,,,,,,,,,,,,,,,,,157.0,at AUT,FW,28.0,23.9,6.0,0.0,0.0,25.0,43.0,13.0,13.0,5.0,12.0,1.0,0.0,0.0,71.0,141.0,150.0,48.5,Matches,157.0,at AUT,FW,28.0,23.9,541.0,529.0,7.0,1.0,1.0,3.0,13.0,5.0,0.0,0.0,0.0,0.0,297.0,5.0,14.0,Matches,157.0,at AUT,FW,28.0,23.9,297.0,541.0,54.9,3845.0,1141.0,178.0,290.0,61.4,80.0,145.0,55.2,14.0,28.0,50.0,4.0,3.0,2.6,1.0,24.0,28.0,16.0,1.0,57.0,Matches,180,at AUT,FW,28,30,2150.0,72.0,70.3,23.9,27,77.0,2,3,24.0,1,1.7,37.0,26.0,11.0,0.46,0.86,38.5,30.6,7.9,0.33,1.19,Matches,157.0,at AUT,FW,28.0,23.9,793.0,13.0,57.0,313.0,426.0,130.0,793.0,38.0,11.0,28.9,18.0,47.4,375.0,1339.0,577.0,22.0,12.0,15.0,50.0,22.0,601.0,124.0,Matches,157.0,at AUT,FW,28.0,23.9,10.0,67.0,38.0,56.7,2.8,1.59,0.15,0.26,14.6,1.0,0.0,0.0,10.0,10.0,0.15,0.0,0.0,Matches,157.0,at AUT,FW,28.0,30.0,27.0,2150.0,23.9,10.0,4.0,14.0,10.0,0.0,0.0,6.0,0.0,10.0,10.0,3.0,13.0,22.0,57.0,124.0,0.42,0.17,0.59,0.42,0.59,0.42,0.12,0.54,0.42,0.54,Matches,Michael Gregoritsch,AM/S RC,28,130,142,Austria,Sport-Club Freiburg,8,11,12,15,15,15,13,14,7,6,13,14,6,14,9,12,12,11,9,14,11,9,14,7,15,7,10,11,12,10,10,17,13,15,12,14,10,6,12,5,15,3,3,3,2,1,2,1,1,1,1,1,12,17,13,8,14,14,10,11,1,1,1,1,1,1,1,12,1,13,12,18,15,20,193,87,20,8,3737327,6500,6750,6000,Northern_European,126,2,1994/4/18,39,7,19164.0,,16045723
69,Vincenzo Grifo,Freiburg,1993,159.0,it ITA,MFFW,29.0,26.8,29.0,16.0,6.0,15.0,8.0,13.0,31.0,41.9,18.0,18.0,1.0,17.0,19.0,48.0,19.0,0.0,Matches,159.0,it ITA,MFFW,29.0,26.8,131.0,4.9,83.0,33.0,3.0,8.0,1.0,3.0,15.0,0.56,5.0,7.0,0.0,2.0,1.0,0.0,Matches,,,,,,,,,,,,,,,,,,,,,,,,,,,,,,,,,,,,,,,,,,,,,,,,,,,,,,,,159.0,it ITA,MFFW,29.0,26.8,2.0,0.0,0.0,7.0,31.0,5.0,135.0,19.0,16.0,1.0,0.0,0.0,155.0,16.0,18.0,47.1,Matches,159.0,it ITA,MFFW,29.0,26.8,1336.0,1155.0,174.0,80.0,5.0,16.0,135.0,16.0,67.0,39.0,19.0,0.0,977.0,7.0,27.0,Matches,159.0,it ITA,MFFW,29.0,26.8,977.0,1336.0,73.1,17577.0,5272.0,459.0,538.0,85.3,370.0,474.0,78.1,123.0,256.0,48.0,5.0,5.5,6.2,-0.5,55.0,82.0,46.0,4.0,128.0,Matches,182,it ITA,MFFW,29,33,2408.0,73.0,78.7,26.8,30,79.0,3,3,18.0,0,1.79,45.0,26.0,19.0,0.71,2.37,40.0,33.2,6.8,0.25,1.3,Matches,159.0,it ITA,MFFW,29.0,26.8,1595.0,31.0,216.0,776.0,619.0,65.0,1587.0,74.0,42.0,56.8,21.0,28.4,913.0,4875.0,2274.0,65.0,44.0,18.0,42.0,28.0,1060.0,124.0,Matches,159.0,it ITA,MFFW,29.0,26.8,15.0,58.0,25.0,43.1,2.17,0.93,0.14,0.32,22.6,15.0,7.0,8.0,10.3,3.9,0.07,4.7,4.1,Matches,159.0,it ITA,MFFW,29.0,33.0,30.0,2408.0,26.8,15.0,5.0,20.0,8.0,7.0,8.0,2.0,0.0,10.3,3.9,5.5,9.4,65.0,128.0,124.0,0.56,0.19,0.75,0.3,0.49,0.39,0.21,0.59,0.14,0.35,Matches,Vincenzo Grifo,M/AM RLC,29,140,144,"Italy,Germany",Sport-Club Freiburg,18,16,13,13,16,17,6,16,8,7,14,13,7,15,11,12,8,14,10,17,14,11,16,13,13,7,14,14,13,15,11,9,11,12,14,9,13,4,12,7,14,1,1,3,2,2,2,3,2,2,4,2,10,15,13,7,12,10,11,9,1,1,1,1,1,1,1,20,12,15,20,18,15,8,180,80,8,20,9615877,6847,7047,5497,Mediterranean_Hispanic,138,6,1993/4/7,6,2,19230.0,,91105243
70,Christian Groß,Werder Bremen,1989,161.0,de GER,MF,33.0,21.0,56.0,25.0,20.0,34.0,2.0,29.0,60.0,48.3,31.0,20.0,5.0,15.0,23.0,79.0,38.0,1.0,Matches,161.0,de GER,MF,33.0,21.0,23.0,1.1,20.0,0.0,1.0,1.0,0.0,1.0,1.0,0.05,1.0,0.0,0.0,0.0,0.0,0.0,Matches,,,,,,,,,,,,,,,,,,,,,,,,,,,,,,,,,,,,,,,,,,,,,,,,,,,,,,,,161.0,de GER,MF,33.0,21.0,4.0,0.0,0.0,53.0,14.0,1.0,6.0,23.0,25.0,0.0,0.0,0.0,155.0,26.0,30.0,46.4,Matches,161.0,de GER,MF,33.0,21.0,860.0,824.0,34.0,24.0,1.0,5.0,6.0,1.0,0.0,0.0,0.0,0.0,695.0,2.0,19.0,Matches,161.0,de GER,MF,33.0,21.0,695.0,860.0,80.8,10815.0,3306.0,367.0,426.0,86.2,262.0,317.0,82.6,41.0,59.0,69.5,1.0,0.5,0.7,0.5,5.0,63.0,10.0,3.0,67.0,Matches,184,de GER,MF,33,26,1886.0,73.0,61.6,21.0,23,78.0,4,3,32.0,2,1.31,32.0,42.0,-10.0,-0.48,-0.25,26.6,29.7,-3.1,-0.15,0.52,Matches,161.0,de GER,MF,33.0,21.0,1067.0,59.0,290.0,672.0,114.0,7.0,1067.0,23.0,15.0,65.2,8.0,34.8,462.0,2134.0,1038.0,22.0,16.0,2.0,18.0,8.0,520.0,17.0,Matches,161.0,de GER,MF,33.0,21.0,1.0,5.0,1.0,20.0,0.24,0.05,0.2,1.0,26.0,0.0,0.0,0.0,0.2,0.2,0.03,0.8,0.8,Matches,161.0,de GER,MF,33.0,26.0,23.0,1886.0,21.0,1.0,1.0,2.0,1.0,0.0,0.0,4.0,0.0,0.2,0.2,0.5,0.6,22.0,67.0,17.0,0.05,0.05,0.1,0.05,0.1,0.01,0.02,0.03,0.01,0.03,Matches,Christian Groß,DM/M C,33,121,125,Germany,SV Werder Bremen,5,7,11,7,11,6,13,9,7,13,13,11,14,10,15,13,15,12,14,10,14,16,8,14,9,14,16,15,11,9,14,12,12,11,15,13,14,12,13,10,12,2,2,2,3,2,1,1,1,2,1,1,7,12,5,12,14,16,10,10,1,1,15,10,1,10,20,1,18,8,1,8,1,1,182,75,10,20,522561,6046,6046,4496,Northern_European,119,4,1989/2/8,0,0,14383.0,,91018467
71,Carlos Gruezo,Augsburg,1995,164.0,ec ECU,MF,27.0,10.7,21.0,12.0,12.0,9.0,0.0,9.0,16.0,56.3,7.0,13.0,4.0,9.0,10.0,31.0,15.0,0.0,Matches,164.0,ec ECU,MF,27.0,10.7,12.0,1.12,12.0,0.0,0.0,0.0,0.0,0.0,4.0,0.37,4.0,0.0,0.0,0.0,0.0,0.0,Matches,,,,,,,,,,,,,,,,,,,,,,,,,,,,,,,,,,,,,,,,,,,,,,,,,,,,,,,,164.0,ec ECU,MF,27.0,10.7,5.0,0.0,0.0,12.0,9.0,0.0,2.0,10.0,12.0,0.0,1.0,0.0,71.0,9.0,13.0,40.9,Matches,164.0,ec ECU,MF,27.0,10.7,276.0,270.0,5.0,5.0,1.0,5.0,2.0,0.0,0.0,0.0,0.0,0.0,199.0,1.0,3.0,Matches,164.0,ec ECU,MF,27.0,10.7,199.0,276.0,72.1,4090.0,1319.0,63.0,80.0,78.8,88.0,110.0,80.0,40.0,70.0,57.1,0.0,0.3,0.4,-0.3,6.0,25.0,6.0,0.0,29.0,Matches,187,ec ECU,MF,27,13,961.0,74.0,31.4,10.7,12,79.0,7,1,11.0,1,1.08,15.0,17.0,-2.0,-0.19,0.63,11.7,20.0,-8.3,-0.77,-0.1,Matches,164.0,ec ECU,MF,27.0,10.7,360.0,27.0,132.0,196.0,37.0,1.0,360.0,7.0,5.0,71.4,2.0,28.6,154.0,808.0,319.0,2.0,6.0,0.0,7.0,3.0,144.0,5.0,Matches,164.0,ec ECU,MF,27.0,10.7,0.0,2.0,0.0,0.0,0.19,0.0,0.0,,32.1,0.0,0.0,0.0,0.0,0.0,0.02,0.0,0.0,Matches,164.0,ec ECU,MF,27.0,13.0,12.0,961.0,10.7,0.0,0.0,0.0,0.0,0.0,0.0,5.0,0.0,0.0,0.0,0.3,0.3,2.0,29.0,5.0,0.0,0.0,0.0,0.0,0.0,0.0,0.03,0.03,0.0,0.03,Matches,Carlos Gruezo,DM/M C,27,125,131,Ecuador,FC Augsburg,8,10,11,8,12,6,8,10,11,13,15,9,15,13,16,13,15,12,11,13,12,16,9,11,9,12,15,16,13,14,14,8,16,11,13,12,11,10,11,7,17,3,1,3,2,3,2,1,1,3,1,2,13,15,9,10,13,12,10,8,1,1,1,14,1,12,20,1,20,11,1,10,11,8,171,67,8,20,3094225,6247,6497,5247,African_Caribbean,125,14,1995/4/19,46,1,28747.0,,86029647
72,Raphaël Guerreiro,Dortmund,1993,165.0,pt POR,DFMF,28.0,25.4,36.0,20.0,13.0,15.0,8.0,21.0,34.0,61.8,13.0,21.0,2.0,19.0,36.0,72.0,23.0,0.0,Matches,165.0,pt POR,DFMF,28.0,25.4,111.0,4.36,83.0,17.0,4.0,5.0,1.0,1.0,15.0,0.59,14.0,1.0,0.0,0.0,0.0,0.0,Matches,,,,,,,,,,,,,,,,,,,,,,,,,,,,,,,,,,,,,,,,,,,,,,,,,,,,,,,,165.0,pt POR,DFMF,28.0,25.4,4.0,0.0,0.0,8.0,10.0,2.0,114.0,36.0,20.0,1.0,0.0,0.0,177.0,5.0,12.0,29.4,Matches,165.0,pt POR,DFMF,28.0,25.4,1811.0,1544.0,266.0,54.0,5.0,6.0,114.0,164.0,48.0,8.0,31.0,0.0,1495.0,1.0,38.0,Matches,165.0,pt POR,DFMF,28.0,25.4,1495.0,1811.0,82.6,21673.0,8387.0,874.0,956.0,91.4,466.0,550.0,84.7,78.0,171.0,45.6,12.0,7.6,7.8,4.4,58.0,135.0,54.0,11.0,191.0,Matches,188,pt POR,DFMF,28,27,2290.0,85.0,74.8,25.4,26,87.0,19,1,32.0,4,1.85,58.0,41.0,17.0,0.67,-1.9,53.1,33.3,19.8,0.78,-0.16,Matches,165.0,pt POR,DFMF,28.0,25.4,2028.0,54.0,433.0,951.0,666.0,68.0,2028.0,47.0,27.0,57.4,19.0,40.4,1175.0,6066.0,3439.0,85.0,59.0,18.0,28.0,18.0,1340.0,163.0,Matches,165.0,pt POR,DFMF,28.0,25.4,4.0,33.0,14.0,42.4,1.3,0.55,0.12,0.29,19.8,6.0,0.0,0.0,2.7,2.7,0.08,1.3,1.3,Matches,165.0,pt POR,DFMF,28.0,27.0,26.0,2290.0,25.4,4.0,12.0,16.0,4.0,0.0,0.0,4.0,0.0,2.7,2.7,7.6,10.3,85.0,191.0,163.0,0.16,0.47,0.63,0.16,0.63,0.11,0.3,0.41,0.11,0.41,Matches,Raphaël Guerreiro,D/WB LC,28,149,159,"Portugal,France",Borussia Dortmund,15,15,15,11,17,16,8,15,13,11,16,14,11,17,11,16,11,17,12,16,15,11,16,5,17,11,14,13,14,15,11,6,11,14,15,8,13,6,15,15,17,1,1,1,1,1,2,1,2,2,1,1,12,10,8,11,15,13,16,16,1,20,1,1,20,1,10,13,15,1,12,8,1,5,170,71,20,8,34898357,7600,7500,6250,Mediterranean_Hispanic,142,6,1993/12/22,56,3,95825.0,,85045409
73,Josuha Guilavogui,Wolfsburg,1990,166.0,fr FRA,DFMF,31.0,13.1,18.0,11.0,7.0,10.0,1.0,6.0,17.0,35.3,11.0,19.0,13.0,6.0,23.0,41.0,52.0,0.0,Matches,166.0,fr FRA,DFMF,31.0,13.1,16.0,1.22,13.0,0.0,0.0,0.0,2.0,1.0,0.0,0.0,0.0,0.0,0.0,0.0,0.0,0.0,Matches,,,,,,,,,,,,,,,,,,,,,,,,,,,,,,,,,,,,,,,,,,,,,,,,,,,,,,,,166.0,fr FRA,DFMF,31.0,13.1,4.0,0.0,0.0,29.0,8.0,2.0,2.0,23.0,11.0,0.0,1.0,1.0,95.0,43.0,32.0,57.3,Matches,166.0,fr FRA,DFMF,31.0,13.1,805.0,770.0,34.0,22.0,0.0,4.0,2.0,3.0,0.0,0.0,0.0,0.0,678.0,1.0,7.0,Matches,166.0,fr FRA,DFMF,31.0,13.1,678.0,805.0,84.2,13280.0,5021.0,217.0,253.0,85.8,380.0,423.0,89.8,75.0,109.0,68.8,0.0,0.4,1.0,-0.4,4.0,63.0,6.0,0.0,64.0,Matches,189,fr FRA,DFMF,31,23,1180.0,51.0,38.6,13.1,11,82.0,9,12,23.0,9,1.26,15.0,19.0,-4.0,-0.31,-0.93,18.2,22.4,-4.2,-0.32,-0.52,Matches,166.0,fr FRA,DFMF,31.0,13.1,949.0,100.0,354.0,542.0,55.0,10.0,949.0,5.0,3.0,60.0,0.0,0.0,523.0,2117.0,1072.0,4.0,5.0,0.0,8.0,6.0,577.0,6.0,Matches,166.0,fr FRA,DFMF,31.0,13.1,1.0,6.0,1.0,16.7,0.46,0.08,0.17,1.0,11.9,0.0,0.0,0.0,0.5,0.5,0.09,0.5,0.5,Matches,166.0,fr FRA,DFMF,31.0,23.0,11.0,1180.0,13.1,1.0,0.0,1.0,1.0,0.0,0.0,4.0,0.0,0.5,0.5,0.4,1.0,4.0,64.0,6.0,0.08,0.0,0.08,0.08,0.08,0.04,0.03,0.07,0.04,0.07,Matches,Josuha Guilavogui,D/DM/M C,31,131,140,"France,Guinea",VfL Wolfsburg,4,7,9,8,12,4,14,9,7,13,13,7,15,12,16,13,15,12,13,12,12,15,8,16,11,14,17,14,12,9,14,14,13,13,15,15,14,13,12,13,10,2,2,2,1,2,3,3,1,2,2,3,13,15,10,14,14,17,13,11,1,1,18,8,1,8,20,1,18,1,1,10,1,1,188,77,10,20,2568939,6550,6600,6000,African_Caribbean,124,17,1990/9/19,7,0,57692.0,,34009731
74,Serhou Guirassy,Stuttgart,1996,167.0,gn GUI,FW,26.0,18.3,4.0,1.0,2.0,2.0,0.0,1.0,2.0,50.0,1.0,7.0,2.0,5.0,0.0,4.0,14.0,0.0,Matches,167.0,gn GUI,FW,26.0,18.3,47.0,2.57,28.0,0.0,3.0,8.0,8.0,0.0,1.0,0.05,0.0,0.0,0.0,0.0,1.0,0.0,Matches,,,,,,,,,,,,,,,,,,,,,,,,,,,,,,,,,,,,,,,,,,,,,,,,,,,,,,,,167.0,gn GUI,FW,26.0,18.3,4.0,1.0,1.0,17.0,43.0,10.0,6.0,0.0,1.0,1.0,0.0,0.0,43.0,42.0,39.0,51.9,Matches,167.0,gn GUI,FW,26.0,18.3,448.0,417.0,30.0,1.0,4.0,5.0,6.0,2.0,1.0,0.0,0.0,0.0,329.0,1.0,14.0,Matches,167.0,gn GUI,FW,26.0,18.3,329.0,448.0,73.4,4462.0,708.0,204.0,243.0,84.0,92.0,125.0,73.6,14.0,27.0,51.9,0.0,1.4,1.0,-1.4,19.0,20.0,6.0,0.0,30.0,Matches,190,gn GUI,FW,26,22,1646.0,75.0,53.8,18.3,20,81.0,11,2,18.0,1,1.05,24.0,33.0,-9.0,-0.49,-0.3,25.2,24.3,1.0,0.05,-0.04,Matches,167.0,gn GUI,FW,26.0,18.3,647.0,17.0,40.0,333.0,278.0,89.0,645.0,35.0,14.0,40.0,13.0,37.1,379.0,1676.0,675.0,20.0,19.0,14.0,53.0,20.0,525.0,97.0,Matches,167.0,gn GUI,FW,26.0,18.3,11.0,47.0,18.0,38.3,2.57,0.98,0.19,0.5,15.7,4.0,2.0,2.0,10.8,9.2,0.2,0.2,-0.2,Matches,167.0,gn GUI,FW,26.0,22.0,20.0,1646.0,18.3,11.0,0.0,11.0,9.0,2.0,2.0,4.0,1.0,10.8,9.2,1.4,10.6,20.0,30.0,97.0,0.6,0.0,0.6,0.49,0.49,0.59,0.08,0.67,0.5,0.58,Matches,Serhou Guirassy,AM/S L,26,129,135,"France,Guinea",Stade Rennais FC,6,9,11,14,12,10,15,11,5,5,13,13,6,12,12,13,15,11,8,11,12,13,14,6,12,6,15,14,13,12,15,15,14,15,14,15,13,5,12,12,7,2,1,1,3,3,3,2,3,2,3,3,9,16,13,9,11,12,14,14,1,1,1,1,1,1,1,12,1,10,16,8,10,20,187,82,10,20,4615653,6449,6449,3999,African_Caribbean,126,16,1996/3/12,0,0,22998.0,VfB Stuttgart,85111795
75,Christian Günter,Freiburg,1993,171.0,de GER,DFMF,29.0,30.5,29.0,21.0,18.0,9.0,2.0,13.0,43.0,30.2,30.0,22.0,4.0,18.0,16.0,45.0,41.0,0.0,Matches,171.0,de GER,DFMF,29.0,30.5,101.0,3.31,61.0,32.0,4.0,3.0,1.0,0.0,8.0,0.26,6.0,2.0,0.0,0.0,0.0,0.0,Matches,,,,,,,,,,,,,,,,,,,,,,,,,,,,,,,,,,,,,,,,,,,,,,,,,,,,,,,,171.0,de GER,DFMF,29.0,30.5,5.0,0.0,0.0,32.0,14.0,6.0,198.0,16.0,21.0,0.0,1.0,0.0,121.0,13.0,29.0,31.0,Matches,171.0,de GER,DFMF,29.0,30.5,1400.0,1050.0,348.0,48.0,1.0,18.0,198.0,231.0,68.0,41.0,22.0,0.0,996.0,2.0,41.0,Matches,171.0,de GER,DFMF,29.0,30.5,996.0,1400.0,71.1,17192.0,6168.0,456.0,534.0,85.4,385.0,517.0,74.5,101.0,231.0,43.7,4.0,5.1,5.3,-1.1,59.0,55.0,36.0,28.0,77.0,Matches,194,de GER,DFMF,29,33,2748.0,83.0,89.8,30.5,31,87.0,28,2,23.0,0,1.76,46.0,40.0,6.0,0.2,-0.09,43.2,43.6,-0.4,-0.01,0.11,Matches,171.0,de GER,DFMF,29.0,30.5,1583.0,59.0,337.0,680.0,576.0,49.0,1583.0,16.0,10.0,62.5,5.0,31.3,726.0,3238.0,1416.0,43.0,33.0,6.0,18.0,12.0,889.0,128.0,Matches,171.0,de GER,DFMF,29.0,30.5,1.0,27.0,7.0,25.9,0.88,0.23,0.04,0.14,21.8,0.0,0.0,0.0,1.2,1.2,0.05,-0.2,-0.2,Matches,171.0,de GER,DFMF,29.0,33.0,31.0,2748.0,30.5,1.0,4.0,5.0,1.0,0.0,0.0,5.0,0.0,1.2,1.2,5.1,6.4,43.0,77.0,128.0,0.03,0.13,0.16,0.03,0.16,0.04,0.17,0.21,0.04,0.21,Matches,Christian Günter,D/WB/M L,29,137,139,Germany,Sport-Club Freiburg,13,15,14,9,11,13,9,12,16,12,12,8,12,11,14,10,14,9,12,8,9,13,11,14,12,11,13,16,14,11,14,12,18,17,15,13,13,10,12,3,14,2,2,3,1,2,2,3,1,2,2,4,4,14,4,17,11,17,14,14,1,20,10,12,20,12,1,16,1,1,15,1,1,1,185,87,20,10,5851022,6636,6636,5986,Northern_European,123,3,1993/2/28,6,0,16781.0,,91105585
76,Joško Gvardiol,RB Leipzig,2002,172.0,hr CRO,DF,20.0,24.1,23.0,17.0,15.0,8.0,0.0,9.0,22.0,40.9,13.0,34.0,17.0,17.0,34.0,57.0,76.0,1.0,Matches,172.0,hr CRO,DF,20.0,24.1,29.0,1.2,27.0,0.0,1.0,1.0,0.0,0.0,2.0,0.08,2.0,0.0,0.0,0.0,0.0,0.0,Matches,,,,,,,,,,,,,,,,,,,,,,,,,,,,,,,,,,,,,,,,,,,,,,,,,,,,,,,,172.0,hr CRO,DF,20.0,24.1,2.0,0.0,0.0,20.0,13.0,1.0,4.0,34.0,17.0,0.0,1.0,1.0,167.0,43.0,34.0,55.8,Matches,172.0,hr CRO,DF,20.0,24.1,2149.0,2092.0,53.0,50.0,1.0,20.0,4.0,3.0,0.0,0.0,0.0,0.0,1914.0,4.0,16.0,Matches,172.0,hr CRO,DF,20.0,24.1,1914.0,2149.0,89.1,38395.0,13386.0,588.0,632.0,93.0,1096.0,1159.0,94.6,217.0,314.0,69.1,0.0,0.6,1.0,-0.6,12.0,137.0,10.0,1.0,116.0,Matches,195,hr CRO,DF,20,30,2170.0,72.0,70.9,24.1,24,83.0,19,6,30.0,2,1.87,45.0,32.0,13.0,0.54,-0.47,45.2,27.7,17.4,0.72,-0.09,Matches,172.0,hr CRO,DF,20.0,24.1,2369.0,244.0,1099.0,1212.0,71.0,22.0,2369.0,18.0,16.0,88.9,2.0,11.1,1710.0,8087.0,4336.0,27.0,13.0,3.0,9.0,6.0,1795.0,4.0,Matches,172.0,hr CRO,DF,20.0,24.1,1.0,14.0,4.0,28.6,0.58,0.17,0.07,0.25,14.2,0.0,0.0,0.0,1.8,1.8,0.13,-0.8,-0.8,Matches,172.0,hr CRO,DF,20.0,30.0,24.0,2170.0,24.1,1.0,0.0,1.0,1.0,0.0,0.0,2.0,0.0,1.8,1.8,0.6,2.5,27.0,116.0,4.0,0.04,0.0,0.04,0.04,0.04,0.08,0.03,0.1,0.08,0.1,Matches,Joško Gvardiol,D LC,20,139,-9,Croatia,RB Leipzig,2,10,12,7,13,8,13,10,14,13,14,10,15,13,16,14,17,15,12,12,12,17,13,10,11,11,14,15,14,11,14,14,16,17,14,16,14,9,13,6,11,3,2,2,2,3,3,3,3,3,1,3,7,18,4,15,18,16,10,13,1,20,20,1,1,1,1,1,1,1,1,1,1,1,185,80,20,10,100224005,6743,7243,5743,Northern_European,138,4,2002/1/23,10,1,68499.0,,24060473
77,Janik Haberer,Union Berlin,1994,173.0,de GER,MF,28.0,24.3,29.0,17.0,8.0,18.0,3.0,17.0,48.0,35.4,31.0,35.0,2.0,33.0,14.0,43.0,25.0,0.0,Matches,173.0,de GER,MF,28.0,24.3,60.0,2.47,47.0,0.0,1.0,7.0,4.0,1.0,5.0,0.21,5.0,0.0,0.0,0.0,0.0,0.0,Matches,,,,,,,,,,,,,,,,,,,,,,,,,,,,,,,,,,,,,,,,,,,,,,,,,,,,,,,,173.0,de GER,MF,28.0,24.3,1.0,0.0,0.0,34.0,38.0,1.0,14.0,14.0,17.0,0.0,0.0,0.0,144.0,38.0,51.0,42.7,Matches,173.0,de GER,MF,28.0,24.3,677.0,662.0,8.0,1.0,4.0,2.0,14.0,7.0,0.0,0.0,0.0,0.0,489.0,7.0,26.0,Matches,173.0,de GER,MF,28.0,24.3,489.0,677.0,72.2,7369.0,2013.0,279.0,339.0,82.3,146.0,202.0,72.3,34.0,55.0,61.8,1.0,2.1,1.4,-1.1,23.0,58.0,14.0,4.0,78.0,Matches,196,de GER,MF,28,32,2187.0,68.0,71.5,24.3,30,72.0,0,2,14.0,0,1.81,35.0,26.0,9.0,0.37,-0.04,25.4,27.3,-1.9,-0.08,0.21,Matches,173.0,de GER,MF,28.0,24.3,926.0,26.0,169.0,468.0,304.0,48.0,926.0,31.0,11.0,35.5,14.0,45.2,468.0,1930.0,897.0,21.0,15.0,5.0,36.0,19.0,540.0,84.0,Matches,173.0,de GER,MF,28.0,24.3,5.0,32.0,14.0,43.8,1.32,0.58,0.16,0.36,19.0,0.0,0.0,0.0,3.3,3.3,0.1,1.7,1.7,Matches,173.0,de GER,MF,28.0,32.0,30.0,2187.0,24.3,5.0,1.0,6.0,5.0,0.0,0.0,1.0,0.0,3.3,3.3,2.1,5.4,21.0,78.0,84.0,0.21,0.04,0.25,0.21,0.25,0.13,0.09,0.22,0.13,0.22,Matches,Janik Haberer,M/AM RC,28,130,132,Germany,1. FC Union Berlin,7,11,11,10,13,7,12,8,8,8,12,13,10,12,18,12,16,13,13,12,13,14,13,11,14,10,16,18,12,13,9,15,17,13,17,10,11,6,11,7,17,1,2,3,3,1,3,4,2,3,1,3,9,17,8,12,10,16,13,16,1,1,1,1,1,1,8,14,19,16,14,20,16,12,186,80,12,20,3270160,6250,6250,5750,Northern_European,126,3,1994/4/2,0,0,19177.0,,92056736
78,Alexander Hack,Mainz 05,1993,174.0,de GER,DF,28.0,12.6,30.0,18.0,21.0,9.0,0.0,19.0,33.0,57.6,14.0,18.0,5.0,13.0,24.0,54.0,45.0,1.0,Matches,174.0,de GER,DF,28.0,12.6,11.0,0.87,11.0,0.0,0.0,0.0,0.0,0.0,0.0,0.0,0.0,0.0,0.0,0.0,0.0,0.0,Matches,,,,,,,,,,,,,,,,,,,,,,,,,,,,,,,,,,,,,,,,,,,,,,,,,,,,,,,,174.0,de GER,DF,28.0,12.6,2.0,1.0,0.0,25.0,12.0,1.0,2.0,24.0,18.0,0.0,2.0,0.0,87.0,33.0,32.0,50.8,Matches,174.0,de GER,DF,28.0,12.6,586.0,550.0,33.0,30.0,0.0,7.0,2.0,3.0,0.0,0.0,0.0,0.0,430.0,3.0,12.0,Matches,174.0,de GER,DF,28.0,12.6,430.0,586.0,73.4,9125.0,4776.0,144.0,171.0,84.2,191.0,236.0,80.9,87.0,149.0,58.4,0.0,0.1,0.8,-0.1,4.0,35.0,4.0,1.0,52.0,Matches,197,de GER,DF,28,19,1132.0,60.0,37.0,12.6,14,77.0,10,5,11.0,11,1.63,17.0,19.0,-2.0,-0.16,-0.21,16.7,17.9,-1.2,-0.1,0.15,Matches,174.0,de GER,DF,28.0,12.6,735.0,74.0,350.0,367.0,27.0,13.0,735.0,2.0,2.0,100.0,0.0,0.0,344.0,1473.0,818.0,1.0,4.0,0.0,3.0,1.0,336.0,0.0,Matches,174.0,de GER,DF,28.0,12.6,0.0,3.0,0.0,0.0,0.24,0.0,0.0,,12.7,0.0,0.0,0.0,0.1,0.1,0.03,-0.1,-0.1,Matches,174.0,de GER,DF,28.0,19.0,14.0,1132.0,12.6,0.0,0.0,0.0,0.0,0.0,0.0,2.0,1.0,0.1,0.1,0.1,0.2,1.0,52.0,0.0,0.0,0.0,0.0,0.0,0.0,0.01,0.01,0.02,0.01,0.02,Matches,Alexander Hack,D C,28,130,132,Germany,1. FSV Mainz 05,3,6,11,6,11,3,14,6,6,13,12,6,16,11,14,13,16,12,12,11,13,16,11,11,9,14,13,13,12,12,15,16,13,13,12,15,14,11,13,11,8,1,1,3,2,4,2,2,2,1,3,2,7,13,10,16,14,15,12,8,1,12,20,1,1,1,10,1,8,1,1,1,1,1,193,88,20,8,3904571,6495,6495,4995,Northern_European,130,4,1993/9/8,0,0,25889.0,,92026384
79,Sébastien Haller,Dortmund,1994,177.0,ci CIV,FW,28.0,13.6,5.0,4.0,2.0,1.0,2.0,0.0,4.0,0.0,4.0,8.0,0.0,8.0,1.0,6.0,10.0,0.0,Matches,177.0,ci CIV,FW,28.0,13.6,40.0,2.94,22.0,0.0,4.0,10.0,4.0,0.0,8.0,0.59,4.0,0.0,2.0,1.0,1.0,0.0,Matches,,,,,,,,,,,,,,,,,,,,,,,,,,,,,,,,,,,,,,,,,,,,,,,,,,,,,,,,177.0,ci CIV,FW,28.0,13.6,1.0,0.0,0.0,13.0,14.0,4.0,3.0,1.0,4.0,1.0,0.0,0.0,32.0,42.0,40.0,51.2,Matches,177.0,ci CIV,FW,28.0,13.6,309.0,287.0,22.0,0.0,1.0,1.0,3.0,1.0,0.0,0.0,0.0,0.0,216.0,0.0,8.0,Matches,177.0,ci CIV,FW,28.0,13.6,216.0,309.0,69.9,2676.0,504.0,130.0,174.0,74.7,60.0,82.0,73.2,6.0,9.0,66.7,3.0,2.3,1.5,0.7,16.0,13.0,4.0,0.0,22.0,Matches,201,ci CIV,FW,28,19,1225.0,64.0,40.0,13.6,15,72.0,2,4,36.0,0,2.42,45.0,14.0,31.0,2.28,1.89,33.5,16.2,17.3,1.27,0.76,Matches,177.0,ci CIV,FW,28.0,13.6,417.0,9.0,34.0,185.0,203.0,68.0,416.0,16.0,9.0,56.3,7.0,43.8,203.0,788.0,300.0,11.0,3.0,4.0,18.0,15.0,305.0,65.0,Matches,177.0,ci CIV,FW,28.0,13.6,9.0,33.0,19.0,57.6,2.42,1.4,0.27,0.47,9.9,0.0,0.0,1.0,8.4,7.7,0.23,0.6,1.3,Matches,177.0,ci CIV,FW,28.0,19.0,15.0,1225.0,13.6,9.0,3.0,12.0,9.0,0.0,1.0,1.0,0.0,8.4,7.7,2.3,10.0,11.0,22.0,65.0,0.66,0.22,0.88,0.66,0.88,0.62,0.17,0.79,0.56,0.73,Matches,Sébastien Haller,S,28,141,145,"Ivory Coast,France",Borussia Dortmund,6,9,10,15,12,7,14,9,4,7,11,17,6,13,12,15,16,15,15,12,15,12,15,10,12,7,14,15,12,11,16,17,16,13,16,18,15,6,15,6,5,1,2,1,2,3,1,3,2,2,1,1,14,16,6,13,13,11,14,16,1,1,1,1,1,1,1,1,1,1,1,10,1,20,190,82,10,20,25127735,7000,6900,6100,Mixed_Race,139,13,1994/6/22,15,4,210959.0,,85051578
80,Marcel Halstenberg,RB Leipzig,1991,178.0,de GER,DF,30.0,17.3,40.0,21.0,20.0,15.0,5.0,23.0,41.0,56.1,18.0,22.0,1.0,21.0,21.0,61.0,29.0,0.0,Matches,178.0,de GER,DF,30.0,17.3,37.0,2.14,25.0,7.0,1.0,2.0,1.0,1.0,2.0,0.12,2.0,0.0,0.0,0.0,0.0,0.0,Matches,,,,,,,,,,,,,,,,,,,,,,,,,,,,,,,,,,,,,,,,,,,,,,,,,,,,,,,,178.0,de GER,DF,30.0,17.3,2.0,0.0,0.0,19.0,7.0,0.0,45.0,21.0,21.0,1.0,0.0,0.0,102.0,26.0,16.0,61.9,Matches,178.0,de GER,DF,30.0,17.3,1171.0,967.0,199.0,32.0,0.0,6.0,45.0,150.0,17.0,7.0,7.0,0.0,918.0,5.0,22.0,Matches,178.0,de GER,DF,30.0,17.3,918.0,1171.0,78.4,15582.0,5277.0,432.0,490.0,88.2,414.0,498.0,83.1,62.0,127.0,48.8,1.0,2.1,1.8,-1.1,19.0,49.0,16.0,5.0,59.0,Matches,202,de GER,DF,30,31,1557.0,50.0,50.9,17.3,17,76.0,4,14,19.0,1,2.0,33.0,21.0,12.0,0.69,0.03,31.8,17.6,14.2,0.82,0.14,Matches,178.0,de GER,DF,30.0,17.3,1330.0,38.0,408.0,653.0,282.0,21.0,1330.0,17.0,10.0,58.8,7.0,41.2,717.0,3048.0,1498.0,22.0,19.0,4.0,19.0,7.0,819.0,66.0,Matches,178.0,de GER,DF,30.0,17.3,1.0,9.0,3.0,33.3,0.52,0.17,0.11,0.33,12.8,0.0,0.0,0.0,1.1,1.1,0.12,-0.1,-0.1,Matches,178.0,de GER,DF,30.0,31.0,17.0,1557.0,17.3,1.0,1.0,2.0,1.0,0.0,0.0,2.0,0.0,1.1,1.1,2.1,3.3,22.0,59.0,66.0,0.06,0.06,0.12,0.06,0.12,0.06,0.12,0.19,0.06,0.19,Matches,Marcel Halstenberg,D/WB LC,30,132,143,Germany,RB Leipzig,13,14,9,8,11,14,14,13,15,12,13,12,12,12,12,13,15,11,13,12,12,13,13,12,12,12,14,16,12,10,13,15,13,12,15,14,13,9,11,12,15,3,4,1,2,3,1,4,2,2,3,3,9,16,6,10,11,14,10,16,1,20,18,1,18,1,10,12,10,1,12,1,1,1,188,87,20,10,4378925,6696,6696,5346,Northern_European,129,3,1991/9/27,9,1,57496.0,,92025552
81,Andreas Hanche-Olsen,Mainz 05,1997,179.0,no NOR,DF,25.0,16.6,35.0,23.0,24.0,7.0,4.0,22.0,39.0,56.4,17.0,16.0,8.0,8.0,33.0,68.0,77.0,2.0,Matches,179.0,no NOR,DF,25.0,16.6,8.0,0.48,6.0,0.0,0.0,1.0,0.0,1.0,2.0,0.12,1.0,0.0,0.0,1.0,0.0,0.0,Matches,,,,,,,,,,,,,,,,,,,,,,,,,,,,,,,,,,,,,,,,,,,,,,,,,,,,,,,,179.0,no NOR,DF,25.0,16.6,5.0,0.0,0.0,22.0,9.0,0.0,6.0,33.0,23.0,0.0,1.0,0.0,117.0,69.0,40.0,63.3,Matches,179.0,no NOR,DF,25.0,16.6,754.0,737.0,14.0,12.0,1.0,5.0,6.0,2.0,0.0,0.0,0.0,0.0,536.0,3.0,10.0,Matches,179.0,no NOR,DF,25.0,16.6,536.0,754.0,71.1,10059.0,4036.0,218.0,260.0,83.8,251.0,319.0,78.7,62.0,149.0,41.6,3.0,1.2,0.5,1.8,5.0,45.0,4.0,0.0,43.0,Matches,203,no NOR,DF,25,17,1497.0,88.0,48.9,16.6,17,88.0,16,0,,1,1.53,31.0,26.0,5.0,0.3,0.65,25.3,28.3,-3.0,-0.18,0.02,Matches,179.0,no NOR,DF,25.0,16.6,949.0,111.0,512.0,382.0,65.0,16.0,949.0,5.0,4.0,80.0,1.0,20.0,487.0,2295.0,1118.0,6.0,11.0,0.0,12.0,6.0,489.0,10.0,Matches,179.0,no NOR,DF,25.0,16.6,1.0,7.0,2.0,28.6,0.42,0.12,0.14,0.5,13.5,0.0,0.0,0.0,0.4,0.4,0.06,0.6,0.6,Matches,179.0,no NOR,DF,25.0,17.0,17.0,1497.0,16.6,1.0,3.0,4.0,1.0,0.0,0.0,5.0,0.0,0.4,0.4,1.2,1.6,6.0,43.0,10.0,0.06,0.18,0.24,0.06,0.24,0.03,0.07,0.1,0.03,0.1,Matches,Andreas Hanche-Olsen,D/WB RLC,25,123,127,Norway,KAA Gent,6,7,5,8,8,6,14,4,7,13,11,11,15,6,14,12,16,11,14,6,13,18,6,15,11,12,13,11,12,14,13,14,14,11,13,15,12,8,13,3,12,3,1,1,1,2,1,3,2,2,4,1,14,16,12,16,11,15,14,12,1,10,20,17,16,1,1,15,1,1,1,1,1,1,185,70,5,20,2158649,6011,6401,5004,Northern_European,121,3,1997/1/17,12,0,8500.0,,53102029
82,Makoto Hasebe,Eint Frankfurt,1984,182.0,jp JPN,DF,38.0,14.5,18.0,12.0,16.0,2.0,0.0,7.0,22.0,31.8,15.0,22.0,9.0,13.0,17.0,35.0,45.0,0.0,Matches,182.0,jp JPN,DF,38.0,14.5,6.0,0.41,6.0,0.0,0.0,0.0,0.0,0.0,0.0,0.0,0.0,0.0,0.0,0.0,0.0,0.0,Matches,,,,,,,,,,,,,,,,,,,,,,,,,,,,,,,,,,,,,,,,,,,,,,,,,,,,,,,,182.0,jp JPN,DF,38.0,14.5,1.0,0.0,0.0,7.0,15.0,0.0,2.0,17.0,12.0,0.0,0.0,0.0,98.0,15.0,24.0,38.5,Matches,182.0,jp JPN,DF,38.0,14.5,1013.0,952.0,57.0,51.0,1.0,3.0,2.0,4.0,0.0,0.0,0.0,0.0,887.0,4.0,7.0,Matches,182.0,jp JPN,DF,38.0,14.5,887.0,1013.0,87.6,17636.0,6066.0,268.0,289.0,92.7,511.0,551.0,92.7,97.0,152.0,63.8,0.0,0.4,0.5,-0.4,2.0,51.0,6.0,0.0,57.0,Matches,206,jp JPN,DF,38,18,1306.0,73.0,42.7,14.5,15,85.0,10,3,13.0,9,1.22,17.0,23.0,-6.0,-0.41,-1.03,17.1,20.3,-3.2,-0.22,-0.83,Matches,182.0,jp JPN,DF,38.0,14.5,1131.0,139.0,542.0,569.0,24.0,0.0,1131.0,0.0,0.0,,0.0,,713.0,3744.0,2109.0,9.0,7.0,1.0,3.0,1.0,744.0,2.0,Matches,182.0,jp JPN,DF,38.0,14.5,0.0,0.0,0.0,,0.0,0.0,,,,0.0,0.0,0.0,0.0,0.0,,0.0,0.0,Matches,182.0,jp JPN,DF,38.0,18.0,15.0,1306.0,14.5,0.0,0.0,0.0,0.0,0.0,0.0,1.0,0.0,0.0,0.0,0.4,0.4,9.0,57.0,2.0,0.0,0.0,0.0,0.0,0.0,0.0,0.03,0.03,0.0,0.03,Matches,Makoto Hasebe,D/DM/M C,38,131,136,Japan,Eintracht Frankfurt,11,13,10,7,12,9,11,9,9,12,14,9,14,13,10,16,13,15,17,10,15,14,7,17,7,14,18,13,10,12,11,8,15,11,12,10,18,7,16,8,17,2,2,2,3,3,4,2,3,3,2,4,13,11,3,17,17,19,12,15,1,1,20,12,1,10,19,1,16,8,1,10,8,1,180,72,12,20,325490,6498,7221,5483,Asian,127,7,1984/1/18,114,2,19657.0,,778087
83,Jonas Hector,Köln,1990,184.0,de GER,DF,32.0,31.4,112.0,66.0,59.0,43.0,10.0,66.0,113.0,58.4,47.0,61.0,9.0,52.0,39.0,151.0,74.0,1.0,Matches,184.0,de GER,DF,32.0,31.4,74.0,2.36,49.0,12.0,5.0,1.0,4.0,3.0,6.0,0.19,4.0,1.0,0.0,0.0,1.0,0.0,Matches,,,,,,,,,,,,,,,,,,,,,,,,,,,,,,,,,,,,,,,,,,,,,,,,,,,,,,,,184.0,de GER,DF,32.0,31.4,3.0,0.0,0.0,23.0,77.0,1.0,114.0,39.0,66.0,0.0,1.0,0.0,221.0,56.0,33.0,62.9,Matches,184.0,de GER,DF,32.0,31.4,1830.0,1449.0,375.0,69.0,1.0,4.0,114.0,280.0,23.0,12.0,4.0,0.0,1378.0,6.0,46.0,Matches,184.0,de GER,DF,32.0,31.4,1378.0,1830.0,75.3,24579.0,7977.0,609.0,681.0,89.4,596.0,744.0,80.1,145.0,307.0,47.2,2.0,3.9,4.3,-1.9,32.0,86.0,16.0,9.0,129.0,Matches,208,de GER,DF,32,32,2824.0,88.0,92.3,31.4,32,88.0,30,0,,0,1.28,48.0,50.0,-2.0,-0.06,1.08,46.0,39.2,6.9,0.22,0.82,Matches,184.0,de GER,DF,32.0,31.4,2247.0,127.0,668.0,1061.0,545.0,56.0,2247.0,59.0,33.0,55.9,15.0,25.4,1125.0,5762.0,2579.0,54.0,44.0,9.0,36.0,19.0,1226.0,122.0,Matches,184.0,de GER,DF,32.0,31.4,0.0,25.0,5.0,20.0,0.8,0.16,0.0,0.0,16.2,0.0,0.0,0.0,1.7,1.7,0.07,-1.7,-1.7,Matches,184.0,de GER,DF,32.0,32.0,32.0,2824.0,31.4,0.0,2.0,2.0,0.0,0.0,0.0,3.0,0.0,1.7,1.7,3.9,5.6,54.0,129.0,122.0,0.0,0.06,0.06,0.0,0.06,0.05,0.12,0.18,0.05,0.18,Matches,Jonas Hector,D/WB/DM LC,32,141,148,Germany,1. FC Köln,11,12,11,8,12,11,8,10,14,10,13,8,14,12,10,16,12,15,15,11,15,12,9,15,11,12,18,13,12,11,13,11,16,14,16,10,16,7,17,5,18,3,3,3,2,1,3,3,3,2,2,1,6,10,3,16,15,18,17,19,1,20,1,10,18,10,18,12,15,1,10,7,1,1,185,75,20,12,5834036,7049,7049,5749,Northern_European,135,5,1990/5/27,43,3,57496.0,,92016242
84,Benjamin Henrichs,RB Leipzig,1997,186.0,de GER,DFMF,25.0,24.3,73.0,46.0,41.0,29.0,3.0,43.0,66.0,65.2,23.0,48.0,4.0,44.0,35.0,108.0,46.0,0.0,Matches,186.0,de GER,DFMF,25.0,24.3,55.0,2.26,41.0,1.0,3.0,6.0,4.0,0.0,5.0,0.21,5.0,0.0,0.0,0.0,0.0,0.0,Matches,,,,,,,,,,,,,,,,,,,,,,,,,,,,,,,,,,,,,,,,,,,,,,,,,,,,,,,,186.0,de GER,DFMF,25.0,24.3,8.0,0.0,0.0,37.0,28.0,3.0,47.0,35.0,46.0,0.0,0.0,0.0,169.0,22.0,14.0,61.1,Matches,186.0,de GER,DFMF,25.0,24.3,1538.0,1331.0,198.0,17.0,4.0,3.0,47.0,180.0,1.0,1.0,0.0,0.0,1198.0,9.0,42.0,Matches,186.0,de GER,DFMF,25.0,24.3,1198.0,1538.0,77.9,19513.0,5932.0,624.0,711.0,87.8,480.0,576.0,83.3,77.0,165.0,46.7,2.0,1.8,3.5,0.2,20.0,92.0,31.0,10.0,109.0,Matches,211,de GER,DFMF,25,30,2188.0,73.0,71.5,24.3,23,85.0,17,7,32.0,3,1.87,39.0,35.0,4.0,0.16,-1.8,41.3,29.3,12.1,0.5,-0.88,Matches,186.0,de GER,DFMF,25.0,24.3,1856.0,65.0,520.0,872.0,479.0,49.0,1856.0,38.0,20.0,52.6,13.0,34.2,1076.0,4998.0,2346.0,48.0,36.0,8.0,32.0,17.0,1156.0,149.0,Matches,186.0,de GER,DFMF,25.0,24.3,2.0,31.0,4.0,12.9,1.28,0.16,0.06,0.5,21.3,0.0,0.0,0.0,1.2,1.2,0.04,0.8,0.8,Matches,186.0,de GER,DFMF,25.0,30.0,23.0,2188.0,24.3,2.0,2.0,4.0,2.0,0.0,0.0,8.0,0.0,1.2,1.2,1.8,3.0,48.0,109.0,149.0,0.08,0.08,0.16,0.08,0.16,0.05,0.07,0.12,0.05,0.12,Matches,Benjamin Henrichs,D RL,25,134,141,"Germany,Ghana",RB Leipzig,7,13,13,7,13,9,11,9,13,12,14,11,13,14,11,12,12,13,12,12,12,14,11,10,14,11,14,14,13,14,14,12,12,14,15,14,12,8,14,10,18,1,3,3,3,3,3,3,1,1,2,3,12,14,8,14,14,15,13,13,1,17,11,20,12,14,14,10,14,12,8,8,10,1,183,79,12,20,7814751,6700,6700,5250,Mixed_Race,134,12,1997/2/23,7,0,47944.0,,91132680
85,Piero Hincapié,Leverkusen,2002,189.0,ec ECU,DFMF,20.0,27.3,51.0,34.0,28.0,20.0,3.0,25.0,38.0,65.8,13.0,41.0,20.0,21.0,31.0,82.0,83.0,1.0,Matches,189.0,ec ECU,DFMF,20.0,27.3,21.0,0.77,17.0,0.0,1.0,1.0,1.0,1.0,3.0,0.11,3.0,0.0,0.0,0.0,0.0,0.0,Matches,,,,,,,,,,,,,,,,,,,,,,,,,,,,,,,,,,,,,,,,,,,,,,,,,,,,,,,,189.0,ec ECU,DFMF,20.0,27.3,13.0,3.0,2.0,40.0,35.0,1.0,26.0,31.0,34.0,0.0,2.0,0.0,177.0,59.0,48.0,55.1,Matches,189.0,ec ECU,DFMF,20.0,27.3,1798.0,1646.0,152.0,32.0,2.0,4.0,26.0,102.0,0.0,0.0,0.0,0.0,1480.0,0.0,30.0,Matches,189.0,ec ECU,DFMF,20.0,27.3,1480.0,1798.0,82.3,23892.0,7623.0,754.0,822.0,91.7,611.0,707.0,86.4,93.0,199.0,46.7,1.0,1.0,1.1,0.0,10.0,66.0,6.0,3.0,83.0,Matches,214,ec ECU,DFMF,20,30,2457.0,82.0,80.3,27.3,27,87.0,16,3,39.0,0,1.6,46.0,32.0,14.0,0.51,1.41,38.9,33.3,5.6,0.2,-0.24,Matches,189.0,ec ECU,DFMF,20.0,27.3,2112.0,173.0,862.0,1067.0,195.0,28.0,2112.0,31.0,14.0,45.2,15.0,48.4,1173.0,6019.0,3607.0,46.0,36.0,8.0,21.0,9.0,1395.0,42.0,Matches,189.0,ec ECU,DFMF,20.0,27.3,1.0,17.0,6.0,35.3,0.62,0.22,0.06,0.17,16.6,0.0,0.0,0.0,1.3,1.3,0.08,-0.3,-0.3,Matches,189.0,ec ECU,DFMF,20.0,30.0,27.0,2457.0,27.3,1.0,1.0,2.0,1.0,0.0,0.0,13.0,3.0,1.3,1.3,1.0,2.4,46.0,83.0,42.0,0.04,0.04,0.07,0.04,0.07,0.05,0.04,0.09,0.05,0.09,Matches,Piero Hincapié,D LC,20,132,-85,Ecuador,Bayer 04 Leverkusen,4,8,12,6,12,6,12,6,11,14,14,10,14,13,12,14,13,13,13,12,12,13,9,10,10,15,13,13,14,13,12,12,12,13,15,13,13,11,12,5,15,2,1,3,2,2,2,2,2,3,1,1,12,12,6,11,13,15,11,12,1,15,20,1,12,1,1,1,1,1,1,1,1,1,184,76,20,10,97308000,6740,6490,4740,Mixed_Race,132,12,2002/1/9,21,1,19177.0,,86066853
86,Adam Hložek,Leverkusen,2002,190.0,cz CZE,FWMF,20.0,14.3,9.0,4.0,4.0,3.0,2.0,3.0,9.0,33.3,6.0,9.0,2.0,7.0,6.0,15.0,9.0,0.0,Matches,190.0,cz CZE,FWMF,20.0,14.3,39.0,2.73,30.0,3.0,1.0,4.0,1.0,0.0,8.0,0.56,6.0,0.0,0.0,2.0,0.0,0.0,Matches,,,,,,,,,,,,,,,,,,,,,,,,,,,,,,,,,,,,,,,,,,,,,,,,,,,,,,,,190.0,cz CZE,FWMF,20.0,14.3,2.0,0.0,0.0,19.0,20.0,1.0,15.0,6.0,4.0,0.0,0.0,0.0,37.0,24.0,43.0,35.8,Matches,190.0,cz CZE,FWMF,20.0,14.3,332.0,309.0,23.0,1.0,1.0,2.0,15.0,1.0,11.0,5.0,4.0,0.0,241.0,0.0,10.0,Matches,190.0,cz CZE,FWMF,20.0,14.3,241.0,332.0,72.6,3525.0,988.0,145.0,178.0,81.5,63.0,88.0,71.6,20.0,30.0,66.7,3.0,2.5,1.3,0.5,18.0,21.0,6.0,0.0,32.0,Matches,215,cz CZE,FWMF,20,29,1286.0,44.0,42.0,14.3,16,66.0,0,13,18.0,3,1.31,21.0,17.0,4.0,0.28,0.08,19.3,18.2,1.1,0.08,-0.3,Matches,190.0,cz CZE,FWMF,20.0,14.3,490.0,11.0,49.0,236.0,210.0,42.0,490.0,22.0,9.0,40.9,7.0,31.8,251.0,1125.0,535.0,22.0,17.0,9.0,43.0,22.0,356.0,70.0,Matches,190.0,cz CZE,FWMF,20.0,14.3,5.0,30.0,11.0,36.7,2.1,0.77,0.17,0.45,16.9,2.0,0.0,0.0,2.7,2.7,0.09,2.3,2.3,Matches,190.0,cz CZE,FWMF,20.0,29.0,16.0,1286.0,14.3,5.0,3.0,8.0,5.0,0.0,0.0,2.0,0.0,2.7,2.7,2.5,5.3,22.0,32.0,70.0,0.35,0.21,0.56,0.35,0.56,0.19,0.18,0.37,0.19,0.37,Matches,Adam Hložek,AM/S RL,20,129,-85,Czech Republic,Bayer 04 Leverkusen,6,8,13,14,13,7,12,12,7,7,9,14,7,12,13,11,11,13,12,11,10,12,17,7,11,3,9,11,16,14,14,12,12,16,12,12,13,11,11,11,7,4,1,1,1,1,1,3,1,2,3,3,12,16,8,7,10,13,12,11,1,1,1,1,1,1,1,1,1,1,20,11,15,19,188,83,11,20,75104000,6450,6450,4750,Northern_European,121,2,2002/7/25,18,1,28766.0,,31041522
87,Nicolas Höfler,Freiburg,1990,191.0,de GER,MF,32.0,31.3,66.0,35.0,28.0,35.0,3.0,27.0,61.0,44.3,34.0,40.0,13.0,27.0,58.0,124.0,49.0,0.0,Matches,191.0,de GER,MF,32.0,31.3,40.0,1.28,31.0,2.0,0.0,3.0,2.0,2.0,9.0,0.29,6.0,0.0,0.0,2.0,1.0,0.0,Matches,,,,,,,,,,,,,,,,,,,,,,,,,,,,,,,,,,,,,,,,,,,,,,,,,,,,,,,,191.0,de GER,MF,32.0,31.3,9.0,1.0,0.0,66.0,50.0,1.0,1.0,58.0,35.0,0.0,2.0,0.0,204.0,69.0,53.0,56.6,Matches,191.0,de GER,MF,32.0,31.3,1386.0,1284.0,97.0,50.0,1.0,4.0,1.0,1.0,0.0,0.0,0.0,0.0,1149.0,5.0,23.0,Matches,191.0,de GER,MF,32.0,31.3,1149.0,1386.0,82.9,19559.0,5565.0,478.0,554.0,86.3,534.0,609.0,87.7,88.0,125.0,70.4,1.0,0.9,0.8,0.1,5.0,88.0,8.0,0.0,110.0,Matches,216,de GER,MF,32,32,2816.0,88.0,92.0,31.3,32,88.0,26,0,,0,1.75,47.0,39.0,8.0,0.26,0.62,43.9,43.3,0.5,0.02,0.52,Matches,191.0,de GER,MF,32.0,31.3,1690.0,100.0,474.0,1027.0,202.0,31.0,1690.0,28.0,17.0,60.7,10.0,35.7,804.0,3733.0,1448.0,12.0,11.0,2.0,33.0,13.0,896.0,10.0,Matches,191.0,de GER,MF,32.0,31.3,0.0,21.0,4.0,19.0,0.67,0.13,0.0,0.0,14.9,0.0,0.0,0.0,1.7,1.7,0.08,-1.7,-1.7,Matches,191.0,de GER,MF,32.0,32.0,32.0,2816.0,31.3,0.0,1.0,1.0,0.0,0.0,0.0,9.0,1.0,1.7,1.7,0.9,2.7,12.0,110.0,10.0,0.0,0.03,0.03,0.0,0.03,0.06,0.03,0.09,0.06,0.09,Matches,Nicolas Höfler,DM/M C,32,135,138,Germany,Sport-Club Freiburg,8,11,9,7,13,6,9,8,10,12,15,7,12,14,12,13,11,16,17,14,16,12,7,12,10,13,18,15,11,13,12,9,16,12,16,12,17,8,15,7,16,2,2,1,2,3,2,3,1,1,3,1,7,10,3,16,13,16,14,18,1,1,13,12,1,12,20,1,20,1,1,1,1,1,181,81,10,20,1848645,6500,6500,4750,Northern_European,133,4,1990/3/9,0,0,11538.0,,35017386
88,Jonas Hofmann,Gladbach,1992,192.0,de GER,FWMF,30.0,29.8,31.0,16.0,17.0,8.0,6.0,15.0,52.0,28.8,37.0,36.0,2.0,34.0,16.0,47.0,21.0,0.0,Matches,192.0,de GER,FWMF,30.0,29.8,163.0,5.47,83.0,64.0,2.0,7.0,6.0,1.0,16.0,0.54,9.0,4.0,1.0,1.0,1.0,0.0,Matches,,,,,,,,,,,,,,,,,,,,,,,,,,,,,,,,,,,,,,,,,,,,,,,,,,,,,,,,192.0,de GER,FWMF,30.0,29.8,2.0,0.0,0.0,17.0,39.0,23.0,203.0,16.0,16.0,2.0,1.0,0.0,141.0,10.0,21.0,32.3,Matches,192.0,de GER,FWMF,30.0,29.8,1543.0,1272.0,259.0,79.0,12.0,8.0,203.0,31.0,132.0,53.0,64.0,1.0,1149.0,12.0,46.0,Matches,192.0,de GER,FWMF,30.0,29.8,1149.0,1543.0,74.5,19856.0,6442.0,553.0,633.0,87.4,413.0,507.0,81.5,134.0,276.0,48.6,9.0,11.1,10.9,-2.1,99.0,66.0,42.0,8.0,119.0,Matches,217,de GER,FWMF,30,31,2680.0,86.0,87.6,29.8,30,89.0,16,1,22.0,0,1.39,43.0,47.0,-4.0,-0.13,-0.37,46.3,46.6,-0.3,-0.01,0.25,Matches,192.0,de GER,FWMF,30.0,29.8,1779.0,27.0,263.0,802.0,733.0,95.0,1778.0,32.0,14.0,43.8,16.0,50.0,1019.0,5005.0,2444.0,73.0,50.0,24.0,42.0,34.0,1217.0,197.0,Matches,192.0,de GER,FWMF,30.0,29.8,12.0,44.0,22.0,50.0,1.48,0.74,0.27,0.55,19.0,5.0,0.0,1.0,7.2,6.6,0.15,4.8,5.4,Matches,192.0,de GER,FWMF,30.0,31.0,30.0,2680.0,29.8,12.0,9.0,21.0,12.0,0.0,1.0,2.0,0.0,7.2,6.6,11.1,17.6,73.0,119.0,197.0,0.4,0.3,0.71,0.4,0.71,0.24,0.37,0.61,0.22,0.59,Matches,Jonas Hofmann,M/AM RC,30,148,152,Germany,Borussia Mönchengladbach,17,13,12,13,13,14,7,11,12,11,14,13,12,13,13,16,13,13,13,15,13,17,13,12,17,11,16,17,14,12,12,7,14,14,16,11,16,6,14,11,19,1,2,2,3,3,4,1,3,2,2,2,8,14,6,12,16,18,15,16,1,1,1,14,10,14,10,10,17,15,14,15,20,10,176,73,12,20,26500880,7250,7250,6000,Northern_European,147,4,1992/7/14,14,4,76711.0,,92027981
89,Philipp Hofmann,Bochum,1993,193.0,de GER,FW,29.0,29.2,18.0,11.0,0.0,13.0,5.0,5.0,12.0,41.7,7.0,20.0,8.0,12.0,6.0,24.0,48.0,0.0,Matches,193.0,de GER,FW,29.0,29.2,59.0,2.02,46.0,0.0,2.0,3.0,7.0,1.0,7.0,0.24,6.0,0.0,1.0,0.0,0.0,0.0,Matches,,,,,,,,,,,,,,,,,,,,,,,,,,,,,,,,,,,,,,,,,,,,,,,,,,,,,,,,193.0,de GER,FW,29.0,29.2,5.0,0.0,0.0,46.0,41.0,16.0,4.0,6.0,11.0,0.0,0.0,0.0,82.0,214.0,171.0,55.6,Matches,193.0,de GER,FW,29.0,29.2,743.0,716.0,23.0,0.0,1.0,0.0,4.0,0.0,0.0,0.0,0.0,0.0,433.0,4.0,12.0,Matches,193.0,de GER,FW,29.0,29.2,433.0,743.0,58.3,5894.0,1381.0,269.0,418.0,64.4,130.0,240.0,54.2,15.0,24.0,62.5,2.0,2.7,3.2,-0.7,27.0,41.0,17.0,0.0,71.0,Matches,218,de GER,FW,29,34,2631.0,77.0,86.0,29.2,31,82.0,16,3,29.0,0,1.03,34.0,60.0,-26.0,-0.89,0.37,34.7,51.9,-17.2,-0.59,1.18,Matches,193.0,de GER,FW,29.0,29.2,992.0,59.0,82.0,497.0,419.0,117.0,992.0,21.0,9.0,42.9,10.0,47.6,403.0,1203.0,321.0,7.0,8.0,3.0,50.0,37.0,747.0,117.0,Matches,193.0,de GER,FW,29.0,29.2,8.0,52.0,21.0,40.4,1.78,0.72,0.15,0.38,12.8,0.0,0.0,0.0,8.8,8.8,0.17,-0.8,-0.8,Matches,193.0,de GER,FW,29.0,34.0,31.0,2631.0,29.2,8.0,2.0,10.0,8.0,0.0,0.0,5.0,0.0,8.8,8.8,2.7,11.5,7.0,71.0,117.0,0.27,0.07,0.34,0.27,0.34,0.3,0.09,0.39,0.3,0.39,Matches,Philipp Hofmann,S,29,125,125,Germany,VfL Bochum 1848,5,8,9,14,13,9,15,13,4,8,12,13,7,11,10,13,16,13,14,10,15,11,9,10,13,8,15,13,10,11,14,17,12,12,14,17,13,5,14,5,4,2,3,1,1,2,3,1,2,3,3,2,11,14,6,10,14,12,15,15,1,1,1,1,1,1,1,1,1,1,1,1,1,20,195,89,20,8,2156022,6149,6149,4999,Northern_European,125,3,1993/3/30,0,0,7499.0,,91100532
90,Lucas Höler,Freiburg,1994,194.0,de GER,FWMF,28.0,16.7,19.0,14.0,5.0,7.0,7.0,6.0,22.0,27.3,16.0,22.0,5.0,17.0,10.0,29.0,17.0,0.0,Matches,194.0,de GER,FWMF,28.0,16.7,41.0,2.45,27.0,0.0,2.0,6.0,6.0,0.0,3.0,0.18,3.0,0.0,0.0,0.0,0.0,0.0,Matches,,,,,,,,,,,,,,,,,,,,,,,,,,,,,,,,,,,,,,,,,,,,,,,,,,,,,,,,194.0,de GER,FWMF,28.0,16.7,1.0,0.0,0.0,21.0,37.0,9.0,11.0,10.0,14.0,0.0,0.0,0.0,60.0,70.0,49.0,58.8,Matches,194.0,de GER,FWMF,28.0,16.7,483.0,469.0,13.0,2.0,0.0,0.0,11.0,2.0,0.0,0.0,0.0,0.0,314.0,1.0,20.0,Matches,194.0,de GER,FWMF,28.0,16.7,314.0,483.0,65.0,4218.0,902.0,188.0,259.0,72.6,91.0,139.0,65.5,15.0,23.0,65.2,2.0,1.9,2.0,0.1,13.0,22.0,11.0,1.0,33.0,Matches,219,de GER,FWMF,28,26,1503.0,58.0,49.1,16.7,16,83.0,4,10,17.0,0,1.62,22.0,23.0,-1.0,-0.06,-0.52,19.7,27.8,-8.1,-0.48,-0.9,Matches,194.0,de GER,FWMF,28.0,16.7,671.0,25.0,99.0,286.0,295.0,65.0,671.0,21.0,11.0,52.4,7.0,33.3,307.0,1432.0,630.0,19.0,11.0,4.0,29.0,14.0,468.0,87.0,Matches,194.0,de GER,FWMF,28.0,16.7,5.0,30.0,15.0,50.0,1.8,0.9,0.17,0.33,14.2,0.0,0.0,0.0,3.3,3.3,0.11,1.7,1.7,Matches,194.0,de GER,FWMF,28.0,26.0,16.0,1503.0,16.7,5.0,2.0,7.0,5.0,0.0,0.0,1.0,0.0,3.3,3.3,1.9,5.1,19.0,33.0,87.0,0.3,0.12,0.42,0.3,0.42,0.19,0.11,0.31,0.19,0.31,Matches,Lucas Höler,S,28,133,136,Germany,Sport-Club Freiburg,7,9,13,13,11,8,14,12,4,6,12,11,8,11,16,12,14,12,12,12,12,15,8,10,15,7,13,17,13,12,14,13,15,16,16,12,17,5,16,5,7,4,2,3,1,3,1,2,3,3,1,2,7,15,6,12,14,13,14,14,1,1,1,1,1,1,1,13,8,13,13,10,13,20,184,83,12,20,2635506,6300,6300,4750,Northern_European,131,3,1994/7/10,0,0,9000.0,,91137228
91,Gerrit Holtmann,Bochum,1995,195.0,ph PHI,FWMF,27.0,10.5,14.0,7.0,6.0,7.0,1.0,12.0,21.0,57.1,9.0,15.0,1.0,14.0,2.0,16.0,4.0,0.0,Matches,195.0,ph PHI,FWMF,27.0,10.5,22.0,2.1,16.0,0.0,2.0,3.0,1.0,0.0,1.0,0.1,1.0,0.0,0.0,0.0,0.0,0.0,Matches,,,,,,,,,,,,,,,,,,,,,,,,,,,,,,,,,,,,,,,,,,,,,,,,,,,,,,,,195.0,ph PHI,FWMF,27.0,10.5,0.0,0.0,0.0,7.0,7.0,3.0,52.0,2.0,7.0,0.0,0.0,0.0,57.0,14.0,19.0,42.4,Matches,195.0,ph PHI,FWMF,27.0,10.5,270.0,259.0,10.0,1.0,1.0,0.0,52.0,6.0,1.0,0.0,0.0,0.0,155.0,1.0,22.0,Matches,195.0,ph PHI,FWMF,27.0,10.5,155.0,270.0,57.4,2007.0,519.0,104.0,132.0,78.8,35.0,66.0,53.0,7.0,26.0,26.9,1.0,0.8,0.8,0.2,10.0,5.0,8.0,4.0,8.0,Matches,220,ph PHI,FWMF,27,23,945.0,41.0,30.9,10.5,8,71.0,2,15,25.0,6,0.91,9.0,25.0,-16.0,-1.52,-0.84,10.9,24.9,-14.1,-1.34,-0.85,Matches,195.0,ph PHI,FWMF,27.0,10.5,424.0,2.0,44.0,146.0,242.0,38.0,424.0,41.0,16.0,39.0,23.0,56.1,230.0,1900.0,872.0,37.0,22.0,8.0,31.0,16.0,272.0,83.0,Matches,195.0,ph PHI,FWMF,27.0,10.5,1.0,30.0,14.0,46.7,2.86,1.33,0.03,0.07,19.6,0.0,0.0,0.0,2.4,2.4,0.08,-1.4,-1.4,Matches,195.0,ph PHI,FWMF,27.0,23.0,8.0,945.0,10.5,1.0,1.0,2.0,1.0,0.0,0.0,0.0,0.0,2.4,2.4,0.8,3.1,37.0,8.0,83.0,0.1,0.1,0.19,0.1,0.19,0.23,0.07,0.3,0.23,0.3,Matches,Gerrit Holtmann,WB/M/AM L,27,126,129,"Philippines,Germany",VfL Bochum 1848,10,11,13,11,12,9,5,12,10,8,10,9,10,13,14,9,10,8,10,9,8,11,15,5,12,8,10,14,17,14,10,10,13,17,12,8,12,6,11,9,16,2,1,3,1,3,1,1,2,1,2,2,9,14,6,8,10,12,13,15,1,10,1,1,16,1,1,20,1,14,20,12,14,10,185,77,20,8,2515303,6297,6297,4797,Mediterranean_Hispanic,108,7,1995/3/25,2,1,9588.0,,91147351
92,Timo Hübers,Köln,1996,198.0,de GER,DF,26.0,28.4,43.0,28.0,35.0,8.0,0.0,24.0,52.0,46.2,28.0,27.0,13.0,14.0,58.0,101.0,153.0,0.0,Matches,198.0,de GER,DF,26.0,28.4,13.0,0.46,13.0,0.0,0.0,0.0,0.0,0.0,1.0,0.04,1.0,0.0,0.0,0.0,0.0,0.0,Matches,,,,,,,,,,,,,,,,,,,,,,,,,,,,,,,,,,,,,,,,,,,,,,,,,,,,,,,,198.0,de GER,DF,26.0,28.4,8.0,0.0,0.0,31.0,23.0,1.0,2.0,58.0,28.0,0.0,1.0,1.0,232.0,94.0,65.0,59.1,Matches,198.0,de GER,DF,26.0,28.4,1702.0,1627.0,73.0,45.0,1.0,3.0,2.0,5.0,0.0,0.0,0.0,0.0,1400.0,2.0,10.0,Matches,198.0,de GER,DF,26.0,28.4,1400.0,1702.0,82.3,28853.0,9551.0,334.0,381.0,87.7,908.0,1010.0,89.9,149.0,274.0,54.4,0.0,0.1,0.6,-0.1,2.0,60.0,4.0,0.0,84.0,Matches,225,de GER,DF,26,29,2559.0,88.0,83.6,28.4,28,90.0,28,1,39.0,0,1.31,44.0,45.0,-1.0,-0.04,0.68,40.2,35.3,5.0,0.18,0.12,Matches,198.0,de GER,DF,26.0,28.4,2020.0,272.0,1191.0,787.0,57.0,24.0,2020.0,6.0,6.0,100.0,0.0,0.0,1146.0,5506.0,2832.0,10.0,7.0,0.0,10.0,2.0,1217.0,2.0,Matches,198.0,de GER,DF,26.0,28.4,3.0,15.0,7.0,46.7,0.53,0.25,0.2,0.43,10.9,0.0,0.0,0.0,1.8,1.8,0.12,1.2,1.2,Matches,198.0,de GER,DF,26.0,29.0,28.0,2559.0,28.4,3.0,0.0,3.0,3.0,0.0,0.0,8.0,0.0,1.8,1.8,0.1,1.9,10.0,84.0,2.0,0.11,0.0,0.11,0.11,0.11,0.06,0.0,0.07,0.06,0.07,Matches,Timo Hübers,D C,26,131,135,Germany,1. FC Köln,4,7,7,6,10,6,14,10,8,14,11,6,14,10,6,15,15,13,12,9,13,14,5,13,6,14,14,14,11,10,14,15,13,13,12,15,14,10,15,15,7,4,1,4,2,2,3,1,3,3,2,3,7,12,5,14,10,16,12,16,1,10,20,10,6,6,12,1,1,1,1,1,1,1,190,82,12,20,3439336,6550,6550,4500,Northern_European,131,2,1996/7/20,0,0,4794.0,,91153061
93,Mats Hummels,Dortmund,1988,200.0,de GER,DF,33.0,22.4,62.0,34.0,38.0,22.0,2.0,32.0,55.0,58.2,23.0,30.0,16.0,14.0,33.0,95.0,100.0,1.0,Matches,200.0,de GER,DF,33.0,22.4,41.0,1.83,35.0,1.0,0.0,4.0,0.0,1.0,3.0,0.13,2.0,0.0,0.0,0.0,0.0,1.0,Matches,,,,,,,,,,,,,,,,,,,,,,,,,,,,,,,,,,,,,,,,,,,,,,,,,,,,,,,,200.0,de GER,DF,33.0,22.4,4.0,0.0,0.0,18.0,19.0,2.0,6.0,33.0,34.0,0.0,0.0,0.0,137.0,71.0,40.0,64.0,Matches,200.0,de GER,DF,33.0,22.4,1677.0,1615.0,58.0,53.0,2.0,25.0,6.0,5.0,0.0,0.0,0.0,0.0,1468.0,4.0,14.0,Matches,200.0,de GER,DF,33.0,22.4,1468.0,1677.0,87.5,31464.0,10587.0,403.0,447.0,90.2,800.0,841.0,95.1,247.0,338.0,73.1,0.0,1.1,1.4,-1.1,12.0,100.0,10.0,3.0,114.0,Matches,227,de GER,DF,33,30,2018.0,67.0,65.9,22.4,24,81.0,16,6,13.0,3,2.17,53.0,22.0,31.0,1.38,0.69,47.1,26.7,20.4,0.91,0.26,Matches,200.0,de GER,DF,33.0,22.4,1952.0,185.0,879.0,993.0,89.0,31.0,1952.0,10.0,6.0,60.0,4.0,40.0,1236.0,6862.0,4009.0,21.0,18.0,0.0,4.0,8.0,1310.0,6.0,Matches,200.0,de GER,DF,33.0,22.4,1.0,17.0,3.0,17.6,0.76,0.13,0.06,0.33,10.2,0.0,0.0,0.0,2.2,2.2,0.13,-1.2,-1.2,Matches,200.0,de GER,DF,33.0,30.0,24.0,2018.0,22.4,1.0,0.0,1.0,1.0,0.0,0.0,4.0,0.0,2.2,2.2,1.1,3.3,21.0,114.0,6.0,0.04,0.0,0.04,0.04,0.04,0.1,0.05,0.15,0.1,0.15,Matches,Mats Hummels,D C,33,151,177,Germany,Borussia Dortmund,5,11,11,10,14,8,17,9,8,15,16,11,16,15,11,17,14,17,15,16,17,16,13,15,13,16,16,9,8,7,16,16,13,8,10,16,17,8,17,15,7,1,1,1,2,2,1,1,1,3,2,1,6,13,10,16,14,17,18,16,1,1,20,10,1,6,12,1,1,1,1,1,1,1,191,94,14,20,19730268,7849,7849,7249,Northern_European,154,5,1988/12/16,76,5,191781.0,,35007944
94,Iago,Augsburg,1997,202.0,br BRA,DFMF,25.0,17.8,34.0,16.0,20.0,10.0,4.0,11.0,29.0,37.9,18.0,18.0,5.0,13.0,17.0,51.0,53.0,0.0,Matches,202.0,br BRA,DFMF,25.0,17.8,40.0,2.25,27.0,8.0,4.0,0.0,1.0,0.0,6.0,0.34,6.0,0.0,0.0,0.0,0.0,0.0,Matches,,,,,,,,,,,,,,,,,,,,,,,,,,,,,,,,,,,,,,,,,,,,,,,,,,,,,,,,202.0,br BRA,DFMF,25.0,17.8,6.0,1.0,1.0,13.0,13.0,1.0,43.0,17.0,16.0,0.0,0.0,0.0,97.0,13.0,25.0,34.2,Matches,202.0,br BRA,DFMF,25.0,17.8,725.0,520.0,202.0,4.0,1.0,1.0,43.0,197.0,1.0,1.0,0.0,0.0,449.0,3.0,27.0,Matches,202.0,br BRA,DFMF,25.0,17.8,449.0,725.0,61.9,8133.0,4177.0,182.0,229.0,79.5,205.0,323.0,63.5,52.0,118.0,44.1,2.0,1.1,1.7,0.9,10.0,33.0,17.0,7.0,53.0,Matches,229,br BRA,DFMF,25,22,1600.0,73.0,52.3,17.8,19,80.0,11,3,28.0,0,1.09,26.0,30.0,-4.0,-0.23,0.82,19.8,28.9,-9.1,-0.51,0.41,Matches,202.0,br BRA,DFMF,25.0,17.8,948.0,66.0,301.0,396.0,259.0,26.0,948.0,38.0,15.0,39.5,19.0,50.0,365.0,2231.0,1053.0,27.0,12.0,5.0,26.0,10.0,396.0,49.0,Matches,202.0,br BRA,DFMF,25.0,17.8,0.0,9.0,0.0,0.0,0.51,0.0,0.0,,19.2,0.0,0.0,0.0,0.4,0.4,0.04,-0.4,-0.4,Matches,202.0,br BRA,DFMF,25.0,22.0,19.0,1600.0,17.8,0.0,2.0,2.0,0.0,0.0,0.0,6.0,1.0,0.4,0.4,1.1,1.5,27.0,53.0,49.0,0.0,0.11,0.11,0.0,0.11,0.02,0.06,0.08,0.02,0.08,Matches,Iago,D/WB L,25,132,141,"Brazil,Italy",FC Augsburg,13,13,13,11,14,11,8,11,10,10,14,10,11,13,12,13,11,12,12,13,14,14,13,11,14,10,14,12,16,15,11,12,14,15,13,11,14,8,11,9,12,2,1,2,1,3,2,3,3,3,1,1,12,12,7,12,12,11,7,12,1,20,1,1,19,1,1,1,1,1,1,1,1,1,181,68,20,5,4729089,6550,6550,5000,Northern_European,128,9,1997/3/23,0,0,19230.0,,19287778
95,Marcus Ingvartsen,Mainz 05,1996,204.0,dk DEN,FWMF,26.0,14.6,4.0,1.0,0.0,2.0,2.0,1.0,10.0,10.0,9.0,9.0,1.0,8.0,4.0,8.0,10.0,0.0,Matches,204.0,dk DEN,FWMF,26.0,14.6,21.0,1.44,14.0,0.0,3.0,2.0,2.0,0.0,3.0,0.21,3.0,0.0,0.0,0.0,0.0,0.0,Matches,,,,,,,,,,,,,,,,,,,,,,,,,,,,,,,,,,,,,,,,,,,,,,,,,,,,,,,,204.0,dk DEN,FWMF,26.0,14.6,2.0,0.0,0.0,33.0,21.0,9.0,6.0,4.0,1.0,0.0,0.0,0.0,48.0,30.0,55.0,35.3,Matches,204.0,dk DEN,FWMF,26.0,14.6,350.0,336.0,12.0,1.0,1.0,0.0,6.0,1.0,0.0,0.0,0.0,0.0,231.0,2.0,15.0,Matches,204.0,dk DEN,FWMF,26.0,14.6,231.0,350.0,66.0,3193.0,735.0,133.0,186.0,71.5,80.0,112.0,71.4,6.0,11.0,54.5,0.0,0.7,0.7,-0.7,6.0,17.0,6.0,1.0,30.0,Matches,231,dk DEN,FWMF,26,28,1314.0,47.0,42.9,14.6,16,67.0,1,12,20.0,2,1.32,25.0,18.0,7.0,0.48,0.89,19.2,19.8,-0.6,-0.04,0.26,Matches,204.0,dk DEN,FWMF,26.0,14.6,539.0,13.0,60.0,255.0,229.0,66.0,535.0,36.0,12.0,33.3,20.0,55.6,295.0,1308.0,372.0,16.0,6.0,9.0,54.0,19.0,402.0,81.0,Matches,204.0,dk DEN,FWMF,26.0,14.6,10.0,32.0,13.0,40.6,2.19,0.89,0.19,0.46,15.5,1.0,4.0,4.0,8.4,5.2,0.16,1.6,0.8,Matches,204.0,dk DEN,FWMF,26.0,28.0,16.0,1314.0,14.6,10.0,0.0,10.0,6.0,4.0,4.0,2.0,0.0,8.4,5.2,0.7,5.9,16.0,30.0,81.0,0.68,0.0,0.68,0.41,0.41,0.57,0.05,0.62,0.36,0.41,Matches,Marcus Ingvartsen,AM/S C,26,129,132,Denmark,1. FSV Mainz 05,13,9,12,14,14,14,12,13,4,7,13,14,7,14,14,15,12,13,12,14,12,15,13,6,15,8,14,12,12,12,13,12,12,12,12,13,13,10,14,10,15,3,3,1,3,1,2,1,3,1,3,3,15,14,11,8,12,13,14,12,1,1,1,1,1,1,1,10,14,10,12,16,12,20,187,79,20,12,4142203,6450,6250,5000,Northern_European,129,4,1996/1/4,1,1,24931.0,,27088228
96,Paul Jaeckel,Union Berlin,1998,209.0,de GER,DF,24.0,13.3,24.0,18.0,11.0,11.0,2.0,17.0,35.0,48.6,18.0,11.0,5.0,6.0,19.0,43.0,44.0,1.0,Matches,209.0,de GER,DF,24.0,13.3,11.0,0.83,8.0,3.0,0.0,0.0,0.0,0.0,0.0,0.0,0.0,0.0,0.0,0.0,0.0,0.0,Matches,,,,,,,,,,,,,,,,,,,,,,,,,,,,,,,,,,,,,,,,,,,,,,,,,,,,,,,,209.0,de GER,DF,24.0,13.3,4.0,1.0,1.0,16.0,3.0,0.0,3.0,19.0,18.0,0.0,0.0,0.0,69.0,19.0,22.0,46.3,Matches,209.0,de GER,DF,24.0,13.3,622.0,600.0,21.0,13.0,1.0,3.0,3.0,8.0,0.0,0.0,0.0,0.0,507.0,1.0,8.0,Matches,209.0,de GER,DF,24.0,13.3,507.0,622.0,81.5,10133.0,3950.0,167.0,181.0,92.3,270.0,297.0,90.9,64.0,125.0,51.2,0.0,0.0,0.8,0.0,1.0,55.0,4.0,1.0,41.0,Matches,236,de GER,DF,24,16,1196.0,75.0,39.1,13.3,13,86.0,10,3,27.0,11,1.5,19.0,14.0,5.0,0.38,-0.01,14.0,14.0,0.0,0.0,0.23,Matches,209.0,de GER,DF,24.0,13.3,748.0,60.0,369.0,347.0,40.0,4.0,748.0,9.0,7.0,77.8,2.0,22.2,426.0,1858.0,966.0,6.0,4.0,0.0,6.0,2.0,471.0,8.0,Matches,209.0,de GER,DF,24.0,13.3,1.0,2.0,2.0,100.0,0.15,0.15,0.5,0.5,11.3,0.0,0.0,0.0,0.1,0.1,0.07,0.9,0.9,Matches,209.0,de GER,DF,24.0,16.0,13.0,1196.0,13.3,1.0,0.0,1.0,1.0,0.0,0.0,4.0,1.0,0.1,0.1,0.0,0.2,6.0,41.0,8.0,0.08,0.0,0.08,0.08,0.08,0.01,0.0,0.01,0.01,0.01,Matches,Paul Jaeckel,D/DM/M C,24,135,139,Germany,1. FC Union Berlin,4,8,7,6,11,4,14,9,10,15,12,5,15,12,12,15,15,11,13,11,12,14,5,9,6,14,14,13,12,11,13,15,14,14,13,14,14,9,13,7,7,3,2,3,4,2,2,3,3,3,1,3,8,13,6,13,10,14,14,16,1,1,20,1,1,1,20,1,18,1,1,1,1,1,189,84,10,20,1177256,5750,6005,3847,Northern_European,131,2,1998/7/22,0,0,6711.0,,91175877
97,Kristijan Jakić,Eint Frankfurt,1997,210.0,hr CRO,DFMF,25.0,16.2,33.0,21.0,19.0,12.0,2.0,22.0,41.0,53.7,19.0,32.0,10.0,22.0,14.0,47.0,49.0,1.0,Matches,210.0,hr CRO,DFMF,25.0,16.2,18.0,1.11,15.0,2.0,0.0,0.0,0.0,1.0,0.0,0.0,0.0,0.0,0.0,0.0,0.0,0.0,Matches,,,,,,,,,,,,,,,,,,,,,,,,,,,,,,,,,,,,,,,,,,,,,,,,,,,,,,,,210.0,hr CRO,DFMF,25.0,16.2,4.0,0.0,0.0,18.0,7.0,1.0,10.0,14.0,21.0,0.0,0.0,0.0,135.0,29.0,30.0,49.2,Matches,210.0,hr CRO,DFMF,25.0,16.2,954.0,867.0,84.0,28.0,1.0,4.0,10.0,54.0,0.0,0.0,0.0,0.0,741.0,3.0,21.0,Matches,210.0,hr CRO,DFMF,25.0,16.2,741.0,954.0,77.7,13042.0,5310.0,317.0,370.0,85.7,354.0,417.0,84.9,58.0,122.0,47.5,0.0,0.7,0.9,-0.7,7.0,39.0,8.0,2.0,59.0,Matches,237,hr CRO,DFMF,25,24,1460.0,61.0,47.7,16.2,17,79.0,12,7,18.0,4,1.58,37.0,21.0,16.0,0.99,1.55,28.0,17.7,10.2,0.63,0.72,Matches,210.0,hr CRO,DFMF,25.0,16.2,1129.0,89.0,469.0,550.0,121.0,14.0,1129.0,15.0,8.0,53.3,7.0,46.7,578.0,2250.0,1054.0,16.0,13.0,2.0,13.0,6.0,651.0,19.0,Matches,210.0,hr CRO,DFMF,25.0,16.2,1.0,8.0,4.0,50.0,0.49,0.25,0.13,0.25,17.5,0.0,0.0,0.0,0.7,0.7,0.09,0.3,0.3,Matches,210.0,hr CRO,DFMF,25.0,24.0,17.0,1460.0,16.2,1.0,0.0,1.0,1.0,0.0,0.0,4.0,0.0,0.7,0.7,0.7,1.5,16.0,59.0,19.0,0.06,0.0,0.06,0.06,0.06,0.05,0.05,0.09,0.05,0.09,Matches,Kristijan Jakić,DM C,25,132,137,Croatia,Eintracht Frankfurt,3,8,10,8,11,5,13,11,10,15,12,7,15,12,16,13,17,10,14,11,12,16,8,12,10,14,15,17,13,11,13,13,16,12,17,15,13,9,13,7,17,3,3,3,3,2,2,3,1,2,1,1,11,13,8,12,13,13,10,7,1,1,14,14,1,14,20,7,15,7,7,8,1,1,180,0,10,20,8201562,6750,6000,4500,Northern_European,130,2,1997/5/14,4,0,17500.0,,24051635
98,Fredrik Jensen,Augsburg,1997,213.0,fi FIN,FWMF,24.0,10.3,15.0,10.0,8.0,3.0,4.0,5.0,10.0,50.0,5.0,12.0,5.0,7.0,4.0,19.0,12.0,0.0,Matches,213.0,fi FIN,FWMF,24.0,10.3,20.0,1.95,17.0,3.0,0.0,0.0,0.0,0.0,1.0,0.1,1.0,0.0,0.0,0.0,0.0,0.0,Matches,,,,,,,,,,,,,,,,,,,,,,,,,,,,,,,,,,,,,,,,,,,,,,,,,,,,,,,,213.0,fi FIN,FWMF,24.0,10.3,1.0,0.0,0.0,15.0,7.0,3.0,31.0,4.0,10.0,0.0,0.0,0.0,29.0,19.0,33.0,36.5,Matches,213.0,fi FIN,FWMF,24.0,10.3,297.0,259.0,35.0,3.0,0.0,1.0,31.0,18.0,13.0,4.0,9.0,0.0,160.0,3.0,17.0,Matches,213.0,fi FIN,FWMF,24.0,10.3,160.0,297.0,53.9,2978.0,1073.0,75.0,104.0,72.1,56.0,103.0,54.4,24.0,57.0,42.1,1.0,1.4,1.6,-0.4,13.0,22.0,11.0,2.0,24.0,Matches,241,fi FIN,FWMF,24,20,924.0,46.0,30.2,10.3,8,78.0,1,12,25.0,3,1.2,13.0,17.0,-4.0,-0.39,0.33,11.6,17.7,-6.1,-0.59,0.16,Matches,213.0,fi FIN,FWMF,24.0,10.3,410.0,22.0,67.0,166.0,178.0,35.0,410.0,12.0,4.0,33.3,8.0,66.7,206.0,853.0,306.0,3.0,9.0,2.0,23.0,19.0,243.0,62.0,Matches,213.0,fi FIN,FWMF,24.0,10.3,2.0,11.0,3.0,27.3,1.07,0.29,0.18,0.67,16.6,0.0,0.0,0.0,1.8,1.8,0.16,0.2,0.2,Matches,213.0,fi FIN,FWMF,24.0,20.0,8.0,924.0,10.3,2.0,1.0,3.0,2.0,0.0,0.0,1.0,0.0,1.8,1.8,1.4,3.2,3.0,24.0,62.0,0.19,0.1,0.29,0.19,0.29,0.17,0.13,0.31,0.17,0.31,Matches,Fredrik Jensen,AM/S LC,24,120,130,Finland,FC Augsburg,10,11,11,11,11,10,7,13,6,6,12,10,7,14,10,12,8,14,10,13,12,11,13,7,15,9,13,16,11,12,10,10,16,13,14,11,11,7,12,7,15,3,3,2,1,2,4,3,4,1,2,3,14,12,5,13,15,13,15,18,1,1,1,1,1,1,1,15,15,13,17,20,14,16,183,80,10,20,1298928,5950,5750,4257,Northern_European,114,1,1997/9/9,20,7,9581.0,,33049957
99,Moritz Jenz,Schalke 04,1999,214.0,de GER,DF,23.0,10.5,14.0,11.0,8.0,5.0,1.0,5.0,8.0,62.5,3.0,16.0,10.0,6.0,8.0,22.0,53.0,1.0,Matches,214.0,de GER,DF,23.0,10.5,12.0,1.14,8.0,2.0,0.0,0.0,0.0,2.0,0.0,0.0,0.0,0.0,0.0,0.0,0.0,0.0,Matches,,,,,,,,,,,,,,,,,,,,,,,,,,,,,,,,,,,,,,,,,,,,,,,,,,,,,,,,214.0,de GER,DF,23.0,10.5,5.0,0.0,0.0,19.0,5.0,2.0,1.0,8.0,11.0,0.0,1.0,0.0,62.0,34.0,19.0,64.2,Matches,214.0,de GER,DF,23.0,10.5,489.0,450.0,37.0,32.0,0.0,4.0,1.0,0.0,0.0,0.0,0.0,0.0,374.0,2.0,4.0,Matches,214.0,de GER,DF,23.0,10.5,374.0,489.0,76.5,8350.0,3387.0,103.0,126.0,81.7,201.0,231.0,87.0,69.0,121.0,57.0,0.0,0.0,0.2,0.0,1.0,20.0,2.0,1.0,18.0,Matches,242,de GER,DF,23,11,945.0,86.0,30.9,10.5,11,86.0,10,0,,0,1.45,14.0,10.0,4.0,0.38,2.08,12.6,12.8,-0.2,-0.02,0.72,Matches,214.0,de GER,DF,23.0,10.5,614.0,100.0,381.0,217.0,24.0,14.0,614.0,2.0,1.0,50.0,1.0,50.0,317.0,1705.0,1018.0,6.0,1.0,0.0,9.0,2.0,333.0,1.0,Matches,214.0,de GER,DF,23.0,10.5,0.0,10.0,3.0,30.0,0.95,0.29,0.0,0.0,9.7,0.0,0.0,0.0,1.0,1.0,0.1,-1.0,-1.0,Matches,214.0,de GER,DF,23.0,11.0,11.0,945.0,10.5,0.0,0.0,0.0,0.0,0.0,0.0,5.0,0.0,1.0,1.0,0.0,1.1,6.0,18.0,1.0,0.0,0.0,0.0,0.0,0.0,0.1,0.0,0.1,0.1,0.1,Matches,Moritz Jenz,D C,23,118,140,"Germany,Nigeria",FC Lorient,5,6,6,7,9,6,14,6,8,13,10,10,13,10,11,11,15,12,12,8,12,14,6,12,7,13,13,12,12,9,15,15,16,13,14,15,11,11,11,8,8,1,3,4,3,4,3,3,1,3,4,2,13,13,4,12,12,16,13,13,1,1,20,10,1,1,1,1,1,1,1,1,1,1,190,0,8,20,1984064,5900,5900,3250,Mixed_Race,117,12,1999/4/30,0,0,5757.0,Celtic,29162924
100,Anthony Jung,Werder Bremen,1991,216.0,de GER,DFFW,30.0,29.1,46.0,27.0,19.0,20.0,7.0,31.0,58.0,53.4,27.0,30.0,6.0,24.0,22.0,68.0,63.0,0.0,Matches,216.0,de GER,DFFW,30.0,29.1,40.0,1.38,37.0,1.0,1.0,0.0,1.0,0.0,7.0,0.24,7.0,0.0,0.0,0.0,0.0,0.0,Matches,,,,,,,,,,,,,,,,,,,,,,,,,,,,,,,,,,,,,,,,,,,,,,,,,,,,,,,,216.0,de GER,DFFW,30.0,29.1,2.0,0.0,0.0,23.0,24.0,1.0,46.0,22.0,27.0,0.0,0.0,0.0,174.0,37.0,29.0,56.1,Matches,216.0,de GER,DFFW,30.0,29.1,1422.0,1193.0,224.0,15.0,0.0,3.0,46.0,209.0,0.0,0.0,0.0,0.0,1085.0,5.0,31.0,Matches,216.0,de GER,DFFW,30.0,29.1,1085.0,1422.0,76.3,17239.0,5726.0,559.0,641.0,87.2,428.0,536.0,79.9,66.0,150.0,44.0,5.0,1.6,1.7,3.4,22.0,56.0,18.0,8.0,73.0,Matches,245,de GER,DFFW,30,34,2617.0,77.0,85.5,29.1,32,80.0,11,2,27.0,0,1.06,37.0,59.0,-22.0,-0.76,-2.59,31.6,46.3,-14.7,-0.5,-1.09,Matches,216.0,de GER,DFFW,30.0,29.1,1687.0,92.0,569.0,767.0,361.0,34.0,1687.0,24.0,13.0,54.2,11.0,45.8,808.0,3566.0,1560.0,28.0,21.0,1.0,30.0,17.0,966.0,109.0,Matches,216.0,de GER,DFFW,30.0,29.1,2.0,17.0,6.0,35.3,0.58,0.21,0.12,0.33,17.0,0.0,0.0,0.0,1.3,1.3,0.08,0.7,0.7,Matches,216.0,de GER,DFFW,30.0,34.0,32.0,2617.0,29.1,2.0,5.0,7.0,2.0,0.0,0.0,2.0,0.0,1.3,1.3,1.6,2.9,28.0,73.0,109.0,0.07,0.17,0.24,0.07,0.24,0.04,0.06,0.1,0.04,0.1,Matches,Anthony Jung,D/WB LC,30,125,135,"Germany,Spain",SV Werder Bremen,13,13,10,7,11,12,10,13,14,12,14,9,12,10,13,13,13,15,13,11,13,12,11,10,13,12,13,15,11,10,14,13,14,13,15,13,14,13,12,6,13,2,2,1,1,1,3,2,2,1,3,3,10,14,12,6,11,10,8,8,1,20,19,12,18,12,10,12,1,10,1,1,1,1,186,87,20,7,1725682,6246,6246,4496,Mediterranean_Hispanic,121,7,1991/11/3,0,0,13310.0,,92021650
101,Josip Juranović,Union Berlin,1995,217.0,hr CRO,DF,26.0,10.4,9.0,7.0,5.0,2.0,2.0,7.0,18.0,38.9,11.0,9.0,3.0,6.0,6.0,15.0,22.0,1.0,Matches,217.0,hr CRO,DF,26.0,10.4,30.0,2.89,14.0,14.0,0.0,2.0,0.0,0.0,3.0,0.29,1.0,2.0,0.0,0.0,0.0,0.0,Matches,,,,,,,,,,,,,,,,,,,,,,,,,,,,,,,,,,,,,,,,,,,,,,,,,,,,,,,,217.0,hr CRO,DF,26.0,10.4,0.0,0.0,0.0,2.0,4.0,3.0,74.0,6.0,7.0,0.0,0.0,0.0,63.0,3.0,7.0,30.0,Matches,217.0,hr CRO,DF,26.0,10.4,492.0,313.0,177.0,30.0,0.0,1.0,74.0,109.0,37.0,19.0,15.0,0.0,318.0,2.0,18.0,Matches,217.0,hr CRO,DF,26.0,10.4,318.0,492.0,64.6,5817.0,2450.0,141.0,163.0,86.5,121.0,172.0,70.3,46.0,117.0,39.3,1.0,1.5,1.7,-0.5,22.0,22.0,11.0,9.0,27.0,Matches,246,hr CRO,DF,26,12,935.0,78.0,30.6,10.4,10,90.0,10,2,18.0,6,1.58,12.0,9.0,3.0,0.29,-0.13,11.3,14.5,-3.2,-0.31,-0.24,Matches,217.0,hr CRO,DF,26.0,10.4,553.0,33.0,154.0,215.0,194.0,10.0,552.0,11.0,7.0,63.6,4.0,36.4,216.0,996.0,435.0,11.0,3.0,2.0,6.0,3.0,224.0,33.0,Matches,217.0,hr CRO,DF,26.0,10.4,2.0,6.0,1.0,16.7,0.58,0.1,0.17,1.0,29.6,2.0,1.0,1.0,1.6,0.8,0.14,0.4,0.2,Matches,217.0,hr CRO,DF,26.0,12.0,10.0,935.0,10.4,2.0,1.0,3.0,1.0,1.0,1.0,0.0,0.0,1.6,0.8,1.5,2.3,11.0,27.0,33.0,0.19,0.1,0.29,0.1,0.19,0.15,0.14,0.3,0.08,0.22,Matches,Josip Juranović,D/WB RL,26,131,138,Croatia,Celtic,12,14,12,8,12,13,12,12,4,9,13,18,12,13,14,13,16,12,11,12,12,17,13,15,12,12,13,14,14,13,12,7,13,16,15,11,13,8,13,6,17,3,2,1,2,1,3,2,2,1,1,3,15,12,6,16,8,16,19,14,1,15,1,20,13,20,1,1,1,1,1,1,1,1,173,69,10,20,9893494,6443,6443,5743,Northern_European,129,4,1995/8/16,20,0,20879.0,,24047634
102,Ozan Kabak,Hoffenheim,2000,218.0,tr TUR,DF,22.0,26.5,51.0,34.0,27.0,21.0,3.0,17.0,30.0,56.7,13.0,35.0,23.0,12.0,45.0,96.0,83.0,0.0,Matches,218.0,tr TUR,DF,22.0,26.5,15.0,0.57,7.0,0.0,1.0,3.0,1.0,3.0,4.0,0.15,1.0,0.0,1.0,1.0,0.0,1.0,Matches,,,,,,,,,,,,,,,,,,,,,,,,,,,,,,,,,,,,,,,,,,,,,,,,,,,,,,,,218.0,tr TUR,DF,22.0,26.5,12.0,2.0,2.0,55.0,16.0,0.0,6.0,45.0,34.0,0.0,0.0,1.0,144.0,80.0,52.0,60.6,Matches,218.0,tr TUR,DF,22.0,26.5,1277.0,1230.0,41.0,28.0,0.0,11.0,6.0,3.0,0.0,0.0,0.0,0.0,1056.0,6.0,21.0,Matches,218.0,tr TUR,DF,22.0,26.5,1056.0,1277.0,82.7,19695.0,5984.0,398.0,448.0,88.8,561.0,625.0,89.8,88.0,157.0,56.1,2.0,1.3,1.0,0.7,4.0,62.0,2.0,0.0,76.0,Matches,247,tr TUR,DF,22,30,2388.0,80.0,78.0,26.5,28,83.0,21,2,31.0,1,1.07,34.0,41.0,-7.0,-0.26,0.0,36.9,39.2,-2.3,-0.09,0.02,Matches,218.0,tr TUR,DF,22.0,26.5,1588.0,168.0,772.0,746.0,93.0,26.0,1588.0,30.0,15.0,50.0,11.0,36.7,899.0,4654.0,2411.0,23.0,16.0,0.0,25.0,7.0,968.0,13.0,Matches,218.0,tr TUR,DF,22.0,26.5,2.0,24.0,6.0,25.0,0.9,0.23,0.08,0.33,13.8,0.0,0.0,0.0,1.3,1.3,0.05,0.7,0.7,Matches,218.0,tr TUR,DF,22.0,30.0,28.0,2388.0,26.5,2.0,2.0,4.0,2.0,0.0,0.0,12.0,2.0,1.3,1.3,1.3,2.6,23.0,76.0,13.0,0.08,0.08,0.15,0.08,0.15,0.05,0.05,0.1,0.05,0.1,Matches,Ozan Kabak,D C,22,130,150,Turkey,TSG Hoffenheim,3,6,12,6,12,4,16,6,6,14,12,6,15,12,15,13,16,12,12,11,12,14,11,10,8,14,11,12,13,11,14,14,12,14,12,15,12,12,13,12,6,1,3,2,1,4,1,2,3,3,1,1,11,13,14,8,11,12,8,9,1,1,20,1,1,1,10,1,1,1,1,1,1,1,186,80,10,20,8999999,6500,6750,5500,North_African__Middle_Eastern,130,7,2000/3/25,17,0,52739.0,,70110530
103,Pavel Kadeřábek,Hoffenheim,1992,219.0,cz CZE,DF,30.0,18.5,26.0,20.0,10.0,9.0,7.0,15.0,23.0,65.2,8.0,12.0,2.0,10.0,14.0,40.0,37.0,1.0,Matches,219.0,cz CZE,DF,30.0,18.5,38.0,2.05,33.0,3.0,1.0,0.0,1.0,0.0,3.0,0.16,3.0,0.0,0.0,0.0,0.0,0.0,Matches,,,,,,,,,,,,,,,,,,,,,,,,,,,,,,,,,,,,,,,,,,,,,,,,,,,,,,,,219.0,cz CZE,DF,30.0,18.5,1.0,0.0,0.0,24.0,18.0,2.0,74.0,14.0,20.0,0.0,0.0,0.0,72.0,46.0,48.0,48.9,Matches,219.0,cz CZE,DF,30.0,18.5,883.0,672.0,209.0,7.0,1.0,0.0,74.0,202.0,0.0,0.0,0.0,0.0,615.0,2.0,25.0,Matches,219.0,cz CZE,DF,30.0,18.5,615.0,883.0,69.6,9816.0,4412.0,318.0,391.0,81.3,254.0,350.0,72.6,33.0,94.0,35.1,1.0,1.7,3.9,-0.7,18.0,46.0,29.0,20.0,61.0,Matches,248,cz CZE,DF,30,26,1665.0,64.0,54.4,18.5,17,82.0,12,9,30.0,2,0.96,22.0,26.0,-4.0,-0.22,0.11,25.2,22.0,3.1,0.17,0.57,Matches,219.0,cz CZE,DF,30.0,18.5,1024.0,45.0,231.0,429.0,371.0,39.0,1024.0,13.0,3.0,23.1,8.0,61.5,438.0,2047.0,1108.0,30.0,25.0,4.0,13.0,7.0,564.0,114.0,Matches,219.0,cz CZE,DF,30.0,18.5,1.0,8.0,1.0,12.5,0.43,0.05,0.13,1.0,10.5,0.0,0.0,0.0,1.3,1.3,0.17,-0.3,-0.3,Matches,219.0,cz CZE,DF,30.0,26.0,17.0,1665.0,18.5,1.0,1.0,2.0,1.0,0.0,0.0,1.0,0.0,1.3,1.3,1.7,3.1,30.0,61.0,114.0,0.05,0.05,0.11,0.05,0.11,0.07,0.09,0.17,0.07,0.17,Matches,Pavel Kadeřábek,D/WB R,30,135,139,Czech Republic,TSG Hoffenheim,7,14,11,9,10,7,11,11,15,11,10,11,13,10,13,10,15,8,13,10,9,16,10,12,14,11,14,16,14,11,16,11,14,16,17,14,15,12,14,11,10,1,3,1,2,2,3,2,2,3,2,1,12,15,3,13,12,16,14,17,1,12,1,20,10,20,1,1,1,15,1,1,15,1,182,81,10,20,6832812,6743,6843,6493,Northern_European,124,2,1992/4/25,48,3,38462.0,,25019787
104,Florian Kainz,Köln,1992,220.0,at AUT,MFFW,29.0,26.0,21.0,10.0,7.0,12.0,2.0,8.0,26.0,30.8,18.0,27.0,6.0,21.0,32.0,53.0,30.0,1.0,Matches,220.0,at AUT,MFFW,29.0,26.0,127.0,4.87,67.0,44.0,6.0,4.0,5.0,1.0,17.0,0.65,13.0,2.0,0.0,1.0,1.0,0.0,Matches,,,,,,,,,,,,,,,,,,,,,,,,,,,,,,,,,,,,,,,,,,,,,,,,,,,,,,,,220.0,at AUT,MFFW,29.0,26.0,6.0,1.0,1.0,30.0,40.0,1.0,251.0,32.0,10.0,1.0,1.0,0.0,151.0,9.0,31.0,22.5,Matches,220.0,at AUT,MFFW,29.0,26.0,1207.0,943.0,251.0,62.0,8.0,10.0,251.0,26.0,152.0,61.0,66.0,0.0,759.0,13.0,51.0,Matches,220.0,at AUT,MFFW,29.0,26.0,759.0,1207.0,62.9,15078.0,6097.0,285.0,341.0,83.6,319.0,443.0,72.0,134.0,325.0,41.2,10.0,8.7,8.7,1.3,70.0,82.0,57.0,18.0,159.0,Matches,249,at AUT,MFFW,29,32,2344.0,73.0,76.6,26.0,31,75.0,5,1,31.0,0,1.22,37.0,38.0,-1.0,-0.04,0.46,36.3,31.3,5.0,0.19,0.16,Matches,220.0,at AUT,MFFW,29.0,26.0,1496.0,24.0,207.0,641.0,673.0,45.0,1493.0,82.0,33.0,40.2,35.0,42.7,812.0,4905.0,2154.0,64.0,54.0,8.0,39.0,36.0,877.0,147.0,Matches,220.0,at AUT,MFFW,29.0,26.0,6.0,51.0,19.0,37.3,1.96,0.73,0.06,0.16,22.2,6.0,3.0,3.0,6.0,3.6,0.07,0.0,-0.6,Matches,220.0,at AUT,MFFW,29.0,32.0,31.0,2344.0,26.0,6.0,10.0,16.0,3.0,3.0,3.0,6.0,1.0,6.0,3.6,8.7,12.3,64.0,159.0,147.0,0.23,0.38,0.61,0.12,0.5,0.23,0.33,0.56,0.14,0.47,Matches,Florian Kainz,M/AM LC,29,132,135,Austria,1. FC Köln,15,14,14,12,12,14,7,15,8,7,13,13,9,14,14,11,9,11,12,15,11,10,16,10,13,9,12,14,14,15,9,8,13,13,14,9,13,4,12,5,12,1,2,1,1,1,1,1,1,2,3,1,8,15,12,12,13,12,10,10,1,1,1,1,1,1,1,20,10,14,20,17,14,1,176,72,12,20,5467708,6600,6400,4650,Northern_European,130,2,1992/10/24,20,0,23014.0,,16042540
105,Daichi Kamada,Eint Frankfurt,1996,222.0,jp JPN,MF,25.0,25.2,51.0,31.0,10.0,37.0,4.0,31.0,57.0,54.4,26.0,31.0,2.0,29.0,16.0,67.0,17.0,1.0,Matches,222.0,jp JPN,MF,25.0,25.2,85.0,3.38,67.0,4.0,5.0,3.0,5.0,1.0,17.0,0.68,13.0,1.0,0.0,1.0,2.0,0.0,Matches,,,,,,,,,,,,,,,,,,,,,,,,,,,,,,,,,,,,,,,,,,,,,,,,,,,,,,,,222.0,jp JPN,MF,25.0,25.2,3.0,0.0,0.0,40.0,26.0,7.0,50.0,16.0,31.0,1.0,1.0,0.0,142.0,18.0,34.0,34.6,Matches,222.0,jp JPN,MF,25.0,25.2,1245.0,1182.0,59.0,26.0,5.0,12.0,50.0,2.0,31.0,16.0,8.0,0.0,1005.0,4.0,26.0,Matches,222.0,jp JPN,MF,25.0,25.2,1005.0,1245.0,80.7,16631.0,4782.0,499.0,571.0,87.4,410.0,478.0,85.8,74.0,135.0,54.8,6.0,3.4,3.5,2.6,34.0,117.0,28.0,4.0,160.0,Matches,251,jp JPN,MF,25,32,2265.0,71.0,74.0,25.2,25,83.0,13,7,28.0,1,1.47,49.0,37.0,12.0,0.48,1.16,42.3,31.0,11.3,0.45,0.75,Matches,222.0,jp JPN,MF,25.0,25.2,1503.0,24.0,206.0,898.0,410.0,69.0,1500.0,36.0,15.0,41.7,19.0,52.8,871.0,4152.0,1923.0,47.0,37.0,13.0,32.0,24.0,1041.0,105.0,Matches,222.0,jp JPN,MF,25.0,25.2,9.0,41.0,11.0,26.8,1.63,0.44,0.15,0.55,16.6,4.0,3.0,3.0,9.9,7.5,0.18,-0.9,-1.5,Matches,222.0,jp JPN,MF,25.0,32.0,25.0,2265.0,25.2,9.0,6.0,15.0,6.0,3.0,3.0,3.0,0.0,9.9,7.5,3.4,10.9,47.0,160.0,105.0,0.36,0.24,0.6,0.24,0.48,0.39,0.14,0.53,0.3,0.44,Matches,Daichi Kamada,M/AM RLC,25,139,141,Japan,Eintracht Frankfurt,11,12,16,13,16,9,7,9,3,6,14,12,10,15,13,10,8,13,13,15,14,11,14,6,14,6,15,14,14,16,10,11,14,13,14,8,13,5,11,5,13,1,1,2,1,1,1,2,2,1,3,3,9,15,3,13,9,17,14,17,1,1,1,1,1,1,1,12,18,12,16,20,16,13,184,76,12,20,9421939,7000,7100,6000,10,136,6,1996/8/5,19,5,8500.0,,45092714
106,Jakub Kamiński,Wolfsburg,2002,223.0,pl POL,FWDF,20.0,22.9,36.0,25.0,15.0,13.0,8.0,20.0,40.0,50.0,20.0,37.0,2.0,35.0,8.0,44.0,15.0,0.0,Matches,223.0,pl POL,FWDF,20.0,22.9,69.0,3.02,61.0,0.0,4.0,1.0,1.0,2.0,14.0,0.61,14.0,0.0,0.0,0.0,0.0,0.0,Matches,,,,,,,,,,,,,,,,,,,,,,,,,,,,,,,,,,,,,,,,,,,,,,,,,,,,,,,,223.0,pl POL,FWDF,20.0,22.9,0.0,0.0,0.0,9.0,13.0,3.0,35.0,8.0,25.0,1.0,0.0,0.0,98.0,13.0,27.0,32.5,Matches,223.0,pl POL,FWDF,20.0,22.9,667.0,623.0,42.0,0.0,4.0,4.0,35.0,42.0,0.0,0.0,0.0,0.0,495.0,2.0,28.0,Matches,223.0,pl POL,FWDF,20.0,22.9,495.0,667.0,74.2,7398.0,2278.0,275.0,335.0,82.1,169.0,214.0,79.0,30.0,56.0,53.6,2.0,3.7,3.9,-1.7,28.0,30.0,39.0,5.0,78.0,Matches,253,pl POL,FWDF,20,31,2058.0,66.0,67.3,22.9,25,76.0,5,6,25.0,2,1.48,47.0,27.0,20.0,0.87,1.86,37.6,33.3,4.4,0.19,0.58,Matches,223.0,pl POL,FWDF,20.0,22.9,942.0,21.0,145.0,334.0,470.0,78.0,942.0,66.0,28.0,42.4,34.0,51.5,550.0,2883.0,1463.0,47.0,30.0,18.0,57.0,32.0,606.0,171.0,Matches,223.0,pl POL,FWDF,20.0,22.9,4.0,39.0,14.0,35.9,1.71,0.61,0.1,0.29,15.9,0.0,0.0,0.0,5.0,4.8,0.12,-1.0,-0.8,Matches,223.0,pl POL,FWDF,20.0,31.0,25.0,2058.0,22.9,4.0,2.0,6.0,4.0,0.0,0.0,0.0,0.0,5.0,4.8,3.7,8.5,47.0,78.0,171.0,0.17,0.09,0.26,0.17,0.26,0.22,0.16,0.38,0.21,0.37,Matches,Jakub Kamiński,AM RL,20,123,-8,Poland,VfL Wolfsburg,9,10,14,11,12,7,8,10,5,8,12,7,9,13,11,11,13,12,10,12,10,13,14,11,13,8,12,14,15,13,11,8,15,15,13,8,12,8,12,5,19,1,2,2,1,3,2,1,2,2,2,2,12,15,5,12,12,15,13,13,1,12,1,12,12,12,1,15,8,15,20,10,18,10,179,68,11,20,60800000,6150,5600,4650,Northern_European,119,1,2002/6/5,3,1,19177.0,,96121228
107,Kevin Kampl,RB Leipzig,1990,225.0,si SVN,MF,31.0,15.2,21.0,11.0,6.0,14.0,1.0,6.0,27.0,22.2,21.0,26.0,9.0,17.0,22.0,43.0,11.0,0.0,Matches,225.0,si SVN,MF,31.0,15.2,41.0,2.69,39.0,0.0,0.0,1.0,0.0,1.0,5.0,0.33,5.0,0.0,0.0,0.0,0.0,0.0,Matches,,,,,,,,,,,,,,,,,,,,,,,,,,,,,,,,,,,,,,,,,,,,,,,,,,,,,,,,225.0,si SVN,MF,31.0,15.2,8.0,0.0,0.0,22.0,7.0,1.0,4.0,22.0,11.0,0.0,0.0,0.0,117.0,7.0,19.0,26.9,Matches,225.0,si SVN,MF,31.0,15.2,898.0,872.0,24.0,23.0,6.0,2.0,4.0,1.0,0.0,0.0,0.0,0.0,791.0,2.0,25.0,Matches,225.0,si SVN,MF,31.0,15.2,791.0,898.0,88.1,12894.0,3384.0,396.0,436.0,90.8,328.0,354.0,92.7,50.0,64.0,78.1,2.0,1.0,1.1,1.0,12.0,71.0,14.0,1.0,80.0,Matches,255,si SVN,MF,31,30,1372.0,46.0,44.8,15.2,16,69.0,5,14,20.0,3,2.03,28.0,20.0,8.0,0.52,-0.27,28.3,16.2,12.1,0.8,0.09,Matches,225.0,si SVN,MF,31.0,15.2,1016.0,26.0,201.0,656.0,169.0,4.0,1016.0,12.0,9.0,75.0,2.0,16.7,652.0,3395.0,1668.0,23.0,23.0,2.0,19.0,10.0,707.0,15.0,Matches,225.0,si SVN,MF,31.0,15.2,2.0,7.0,2.0,28.6,0.46,0.13,0.29,1.0,19.4,0.0,0.0,0.0,1.1,1.1,0.16,0.9,0.9,Matches,225.0,si SVN,MF,31.0,30.0,16.0,1372.0,15.2,2.0,2.0,4.0,2.0,0.0,0.0,8.0,0.0,1.1,1.1,1.0,2.2,23.0,80.0,15.0,0.13,0.13,0.26,0.13,0.26,0.07,0.07,0.14,0.07,0.14,Matches,Kevin Kampl,M/AM RLC,31,141,150,"Slovenia,Germany",RB Leipzig,11,11,14,10,14,11,5,13,6,8,14,10,12,15,18,12,8,14,11,14,15,14,15,10,12,11,16,18,14,15,10,8,15,12,16,6,15,9,14,13,17,3,2,2,4,3,3,3,3,2,3,1,9,17,13,6,13,12,10,10,1,1,1,1,1,1,10,15,20,19,15,16,19,1,178,66,12,20,347975206,7250,6500,6000,Northern_European,135,3,1990/10/9,28,2,40077.0,,91005023
108,Wilfried Kanga,Hertha BSC,1998,226.0,ci CIV,FW,24.0,15.7,5.0,4.0,2.0,1.0,2.0,2.0,4.0,50.0,2.0,14.0,3.0,11.0,2.0,7.0,13.0,0.0,Matches,226.0,ci CIV,FW,24.0,15.7,34.0,2.16,28.0,0.0,3.0,1.0,2.0,0.0,1.0,0.06,1.0,0.0,0.0,0.0,0.0,0.0,Matches,,,,,,,,,,,,,,,,,,,,,,,,,,,,,,,,,,,,,,,,,,,,,,,,,,,,,,,,226.0,ci CIV,FW,24.0,15.7,3.0,0.0,0.0,18.0,12.0,11.0,8.0,2.0,4.0,0.0,0.0,0.0,25.0,53.0,61.0,46.5,Matches,226.0,ci CIV,FW,24.0,15.7,251.0,239.0,11.0,0.0,1.0,0.0,8.0,0.0,0.0,0.0,0.0,0.0,154.0,1.0,5.0,Matches,226.0,ci CIV,FW,24.0,15.7,154.0,251.0,61.4,1915.0,277.0,91.0,135.0,67.4,41.0,75.0,54.7,5.0,8.0,62.5,0.0,1.5,1.3,-1.5,20.0,8.0,5.0,2.0,12.0,Matches,256,ci CIV,FW,24,23,1417.0,62.0,46.3,15.7,15,80.0,4,8,28.0,1,0.65,17.0,24.0,-7.0,-0.44,0.65,16.7,24.1,-7.4,-0.47,0.25,Matches,226.0,ci CIV,FW,24.0,15.7,400.0,15.0,29.0,160.0,215.0,69.0,400.0,24.0,8.0,33.3,14.0,58.3,183.0,783.0,288.0,11.0,5.0,5.0,38.0,18.0,293.0,72.0,Matches,226.0,ci CIV,FW,24.0,15.7,2.0,25.0,9.0,36.0,1.59,0.57,0.08,0.22,11.7,0.0,0.0,0.0,3.3,3.3,0.13,-1.3,-1.3,Matches,226.0,ci CIV,FW,24.0,23.0,15.0,1417.0,15.7,2.0,0.0,2.0,2.0,0.0,0.0,3.0,0.0,3.3,3.3,1.5,4.8,11.0,12.0,72.0,0.13,0.0,0.13,0.13,0.13,0.21,0.09,0.31,0.21,0.31,Matches,Wilfried Kanga,S,24,128,138,"Ivory Coast,France",Hertha Berlin,6,9,11,13,12,8,13,6,4,8,11,12,6,12,13,13,11,12,11,10,13,12,13,8,14,9,12,13,13,11,13,14,9,14,13,16,12,5,11,6,10,3,1,1,3,2,2,3,2,1,2,3,8,11,5,13,7,14,10,11,1,1,1,1,1,1,1,1,1,1,13,1,13,20,189,90,15,20,3999242,6400,6400,4500,African_Caribbean,127,14,1998/2/21,0,0,19588.0,,48042435
109,Kenan Karaman,Schalke 04,1994,227.0,tr TUR,FW,28.0,10.8,11.0,8.0,3.0,5.0,3.0,3.0,12.0,25.0,9.0,9.0,1.0,8.0,3.0,14.0,9.0,0.0,Matches,227.0,tr TUR,FW,28.0,10.8,21.0,1.94,15.0,0.0,1.0,2.0,3.0,0.0,5.0,0.46,3.0,0.0,1.0,0.0,1.0,0.0,Matches,,,,,,,,,,,,,,,,,,,,,,,,,,,,,,,,,,,,,,,,,,,,,,,,,,,,,,,,227.0,tr TUR,FW,28.0,10.8,2.0,0.0,0.0,12.0,24.0,7.0,22.0,3.0,8.0,0.0,0.0,0.0,34.0,32.0,23.0,58.2,Matches,227.0,tr TUR,FW,28.0,10.8,209.0,207.0,1.0,0.0,0.0,0.0,22.0,1.0,0.0,0.0,0.0,0.0,129.0,1.0,10.0,Matches,227.0,tr TUR,FW,28.0,10.8,129.0,209.0,61.7,1740.0,514.0,84.0,118.0,71.2,35.0,55.0,63.6,5.0,12.0,41.7,2.0,1.4,1.3,0.6,7.0,13.0,9.0,2.0,18.0,Matches,257,tr TUR,FW,28,21,976.0,46.0,31.9,10.8,10,76.0,4,11,20.0,5,1.05,12.0,28.0,-16.0,-1.48,-0.61,12.0,21.4,-9.4,-0.87,-0.52,Matches,227.0,tr TUR,FW,28.0,10.8,339.0,11.0,45.0,136.0,165.0,42.0,339.0,39.0,11.0,28.2,14.0,35.9,206.0,1401.0,662.0,23.0,13.0,7.0,29.0,18.0,253.0,55.0,Matches,227.0,tr TUR,FW,28.0,10.8,1.0,22.0,8.0,36.4,2.03,0.74,0.05,0.13,13.8,0.0,0.0,0.0,2.5,2.5,0.11,-1.5,-1.5,Matches,227.0,tr TUR,FW,28.0,21.0,10.0,976.0,10.8,1.0,2.0,3.0,1.0,0.0,0.0,2.0,0.0,2.5,2.5,1.4,3.8,23.0,18.0,55.0,0.09,0.18,0.28,0.09,0.28,0.23,0.13,0.35,0.23,0.35,Matches,Kenan Karaman,AM/S RL,28,120,130,"Turkey,Germany",FC Schalke 04,4,8,12,11,11,5,13,10,6,10,11,8,11,12,13,12,13,12,11,11,10,13,12,6,13,10,14,16,12,12,12,13,13,14,14,13,11,7,12,11,17,3,3,1,1,3,4,2,3,1,4,3,9,12,10,12,10,13,12,12,1,1,1,10,1,14,1,12,1,12,17,12,16,20,189,83,12,20,934331,6000,6300,5250,North_African__Middle_Eastern,116,6,1994/3/5,31,6,16300.0,,91121536
110,Atakan Karazor,Stuttgart,1996,228.0,de GER,MF,25.0,21.8,49.0,30.0,18.0,25.0,6.0,24.0,47.0,51.1,23.0,39.0,11.0,28.0,31.0,80.0,44.0,0.0,Matches,228.0,de GER,MF,25.0,21.8,25.0,1.15,21.0,1.0,0.0,1.0,1.0,1.0,3.0,0.14,3.0,0.0,0.0,0.0,0.0,0.0,Matches,,,,,,,,,,,,,,,,,,,,,,,,,,,,,,,,,,,,,,,,,,,,,,,,,,,,,,,,228.0,de GER,MF,25.0,21.8,10.0,0.0,0.0,24.0,31.0,0.0,0.0,31.0,30.0,0.0,0.0,0.0,173.0,49.0,33.0,59.8,Matches,228.0,de GER,MF,25.0,21.8,1116.0,1070.0,42.0,40.0,2.0,9.0,0.0,2.0,0.0,0.0,0.0,0.0,945.0,4.0,11.0,Matches,228.0,de GER,MF,25.0,21.8,945.0,1116.0,84.7,16475.0,4393.0,407.0,468.0,87.0,444.0,498.0,89.2,75.0,105.0,71.4,1.0,0.6,1.2,0.4,14.0,73.0,7.0,0.0,79.0,Matches,258,de GER,MF,25,29,1962.0,68.0,64.1,21.8,22,86.0,16,7,11.0,3,1.03,29.0,36.0,-7.0,-0.32,0.09,28.7,29.5,-0.8,-0.04,-0.29,Matches,228.0,de GER,MF,25.0,21.8,1349.0,79.0,415.0,802.0,147.0,7.0,1349.0,23.0,14.0,60.9,5.0,21.7,598.0,2253.0,888.0,5.0,10.0,0.0,20.0,17.0,783.0,12.0,Matches,228.0,de GER,MF,25.0,21.8,0.0,6.0,0.0,0.0,0.28,0.0,0.0,,20.9,0.0,0.0,0.0,0.3,0.3,0.05,-0.3,-0.3,Matches,228.0,de GER,MF,25.0,29.0,22.0,1962.0,21.8,0.0,1.0,1.0,0.0,0.0,0.0,10.0,0.0,0.3,0.3,0.6,0.9,5.0,79.0,12.0,0.0,0.05,0.05,0.0,0.05,0.01,0.03,0.04,0.01,0.04,Matches,Atakan Karazor,D/DM/M C,25,128,131,"Germany,Turkey",VfB Stuttgart,7,9,10,7,13,6,12,8,10,12,14,8,12,14,11,15,12,15,13,15,15,13,10,12,11,14,17,11,10,11,12,15,13,12,14,12,15,8,13,6,8,2,2,4,3,1,3,1,2,3,3,1,12,15,8,14,14,14,14,15,1,1,16,1,1,1,20,1,18,1,1,1,1,1,191,76,10,20,3250247,6249,6249,4255,North_African__Middle_Eastern,125,7,1996/10/13,0,0,8500.0,,92074021
111,Marc-Oliver Kempf,Hertha BSC,1995,232.0,de GER,DF,27.0,30.1,44.0,27.0,29.0,14.0,1.0,16.0,22.0,72.7,6.0,42.0,32.0,10.0,51.0,95.0,143.0,0.0,Matches,232.0,de GER,DF,27.0,30.1,27.0,0.9,22.0,1.0,1.0,2.0,0.0,1.0,0.0,0.0,0.0,0.0,0.0,0.0,0.0,0.0,Matches,,,,,,,,,,,,,,,,,,,,,,,,,,,,,,,,,,,,,,,,,,,,,,,,,,,,,,,,232.0,de GER,DF,27.0,30.1,5.0,0.0,0.0,27.0,24.0,0.0,2.0,51.0,27.0,0.0,0.0,0.0,190.0,129.0,83.0,60.8,Matches,232.0,de GER,DF,27.0,30.1,1303.0,1230.0,68.0,67.0,2.0,17.0,2.0,0.0,0.0,0.0,0.0,0.0,1011.0,5.0,15.0,Matches,232.0,de GER,DF,27.0,30.1,1011.0,1303.0,77.6,19044.0,8004.0,379.0,441.0,85.9,518.0,608.0,85.2,99.0,197.0,50.3,0.0,1.1,0.9,-1.1,9.0,57.0,6.0,0.0,81.0,Matches,264,de GER,DF,27,31,2709.0,87.0,88.5,30.1,31,87.0,27,0,,0,0.9,40.0,62.0,-22.0,-0.73,0.55,37.0,52.2,-15.2,-0.5,0.87,Matches,232.0,de GER,DF,27.0,30.1,1644.0,231.0,906.0,701.0,52.0,32.0,1644.0,17.0,11.0,64.7,4.0,23.5,774.0,3738.0,1855.0,11.0,2.0,0.0,14.0,7.0,808.0,1.0,Matches,232.0,de GER,DF,27.0,30.1,1.0,16.0,5.0,31.3,0.53,0.17,0.06,0.2,11.5,0.0,0.0,0.0,1.5,1.5,0.1,-0.5,-0.5,Matches,232.0,de GER,DF,27.0,31.0,31.0,2709.0,30.1,1.0,0.0,1.0,1.0,0.0,0.0,5.0,0.0,1.5,1.5,1.1,2.7,11.0,81.0,1.0,0.03,0.0,0.03,0.03,0.03,0.05,0.04,0.09,0.05,0.09,Matches,Marc-Oliver Kempf,D C,27,127,134,Germany,Hertha Berlin,5,8,9,6,12,5,15,6,10,13,13,8,15,13,15,12,16,14,10,13,10,16,7,14,6,13,16,13,12,11,14,15,11,14,12,16,12,10,14,10,10,2,3,3,1,3,1,1,4,3,3,1,9,14,7,10,11,12,10,14,1,1,20,1,1,1,14,1,12,1,1,1,1,1,186,87,20,10,4248218,6342,6342,4692,Northern_European,127,4,1995/1/28,0,0,19230.0,,92027023
112,Jonjoe Kenny,Hertha BSC,1997,233.0,eng ENG,DF,25.0,24.9,46.0,34.0,27.0,16.0,3.0,24.0,42.0,57.1,18.0,38.0,9.0,29.0,46.0,92.0,74.0,0.0,Matches,233.0,eng ENG,DF,25.0,24.9,44.0,1.76,34.0,5.0,0.0,2.0,1.0,2.0,3.0,0.12,2.0,0.0,0.0,0.0,1.0,0.0,Matches,,,,,,,,,,,,,,,,,,,,,,,,,,,,,,,,,,,,,,,,,,,,,,,,,,,,,,,,233.0,eng ENG,DF,25.0,24.9,3.0,0.0,0.0,29.0,6.0,0.0,54.0,46.0,34.0,0.0,0.0,0.0,146.0,25.0,21.0,54.3,Matches,233.0,eng ENG,DF,25.0,24.9,1207.0,955.0,245.0,9.0,0.0,3.0,54.0,235.0,1.0,0.0,0.0,0.0,879.0,7.0,35.0,Matches,233.0,eng ENG,DF,25.0,24.9,879.0,1207.0,72.8,16249.0,7774.0,356.0,424.0,84.0,406.0,526.0,77.2,98.0,192.0,51.0,1.0,2.1,1.7,-1.1,17.0,89.0,13.0,9.0,98.0,Matches,265,eng ENG,DF,25,29,2244.0,77.0,73.3,24.9,25,87.0,22,4,18.0,4,0.9,29.0,44.0,-15.0,-0.6,0.72,27.3,45.5,-18.2,-0.73,-0.47,Matches,233.0,eng ENG,DF,25.0,24.9,1477.0,92.0,507.0,717.0,269.0,12.0,1477.0,23.0,12.0,52.2,7.0,30.4,661.0,2930.0,1466.0,30.0,24.0,5.0,25.0,8.0,709.0,59.0,Matches,233.0,eng ENG,DF,25.0,24.9,0.0,6.0,1.0,16.7,0.24,0.04,0.0,0.0,24.9,0.0,0.0,0.0,0.3,0.3,0.04,-0.3,-0.3,Matches,233.0,eng ENG,DF,25.0,29.0,25.0,2244.0,24.9,0.0,1.0,1.0,0.0,0.0,0.0,3.0,0.0,0.3,0.3,2.1,2.4,30.0,98.0,59.0,0.0,0.04,0.04,0.0,0.04,0.01,0.09,0.1,0.01,0.1,Matches,Jonjoe Kenny,D/WB R,25,127,132,England,Hertha Berlin,8,12,10,6,11,6,10,11,12,13,8,11,14,11,14,12,15,10,12,10,12,15,6,13,14,13,13,15,14,12,13,9,14,14,16,12,10,11,8,6,13,2,2,3,1,3,1,1,2,2,3,2,16,13,7,15,13,14,13,14,1,10,14,20,1,18,10,1,8,8,1,1,1,1,176,67,10,20,3335560,6200,6200,4850,Northern_European,124,4,1997/3/15,0,0,17500.0,,28090682
113,Rani Khedira,Union Berlin,1994,234.0,de GER,MF,28.0,32.0,60.0,33.0,21.0,32.0,7.0,25.0,50.0,50.0,25.0,33.0,10.0,23.0,40.0,100.0,33.0,0.0,Matches,234.0,de GER,MF,28.0,32.0,34.0,1.06,27.0,0.0,1.0,0.0,1.0,5.0,3.0,0.09,2.0,0.0,0.0,0.0,0.0,1.0,Matches,,,,,,,,,,,,,,,,,,,,,,,,,,,,,,,,,,,,,,,,,,,,,,,,,,,,,,,,234.0,de GER,MF,28.0,32.0,8.0,0.0,0.0,52.0,14.0,0.0,11.0,40.0,33.0,0.0,0.0,0.0,194.0,44.0,30.0,59.5,Matches,234.0,de GER,MF,28.0,32.0,1039.0,1007.0,30.0,14.0,1.0,3.0,11.0,1.0,1.0,1.0,0.0,0.0,778.0,2.0,20.0,Matches,234.0,de GER,MF,28.0,32.0,778.0,1039.0,74.9,12596.0,3156.0,371.0,439.0,84.5,326.0,408.0,79.9,52.0,119.0,43.7,0.0,0.7,1.2,-0.7,8.0,63.0,7.0,3.0,69.0,Matches,266,de GER,MF,28,33,2882.0,87.0,94.2,32.0,33,87.0,28,0,,0,1.88,49.0,32.0,17.0,0.53,2.55,34.4,39.5,-5.1,-0.16,-0.37,Matches,234.0,de GER,MF,28.0,32.0,1308.0,54.0,368.0,738.0,218.0,19.0,1308.0,18.0,10.0,55.6,7.0,38.9,561.0,2487.0,762.0,14.0,11.0,1.0,25.0,17.0,687.0,26.0,Matches,234.0,de GER,MF,28.0,32.0,2.0,24.0,3.0,12.5,0.75,0.09,0.08,0.67,22.1,0.0,0.0,0.0,1.7,1.7,0.07,0.3,0.3,Matches,234.0,de GER,MF,28.0,33.0,33.0,2882.0,32.0,2.0,0.0,2.0,2.0,0.0,0.0,8.0,0.0,1.7,1.7,0.7,2.3,14.0,69.0,26.0,0.06,0.0,0.06,0.06,0.06,0.05,0.02,0.07,0.05,0.07,Matches,Rani Khedira,DM/M C,28,138,138,"Germany,Tunisia",1. FC Union Berlin,6,7,10,7,12,6,13,8,10,14,13,9,14,12,15,16,16,13,17,11,14,13,6,14,14,14,17,17,12,11,14,15,18,11,17,15,18,10,14,6,16,3,2,1,2,3,1,4,1,1,3,4,12,17,5,13,10,16,16,18,1,1,12,1,1,1,20,1,20,1,1,1,1,1,188,85,10,20,3088038,6397,6397,4747,North_African__Middle_Eastern,138,8,1994/1/27,0,0,17260.0,,92017509
114,Luca Kilian,Köln,1999,235.0,de GER,DF,22.0,12.5,22.0,16.0,14.0,7.0,1.0,12.0,21.0,57.1,9.0,16.0,8.0,8.0,11.0,33.0,48.0,0.0,Matches,235.0,de GER,DF,22.0,12.5,10.0,0.8,10.0,0.0,0.0,0.0,0.0,0.0,1.0,0.08,1.0,0.0,0.0,0.0,0.0,0.0,Matches,,,,,,,,,,,,,,,,,,,,,,,,,,,,,,,,,,,,,,,,,,,,,,,,,,,,,,,,235.0,de GER,DF,22.0,12.5,5.0,2.0,2.0,7.0,2.0,0.0,1.0,11.0,16.0,0.0,2.0,0.0,62.0,23.0,19.0,54.8,Matches,235.0,de GER,DF,22.0,12.5,685.0,662.0,20.0,13.0,0.0,5.0,1.0,4.0,0.0,0.0,0.0,0.0,585.0,3.0,5.0,Matches,235.0,de GER,DF,22.0,12.5,585.0,685.0,85.4,11572.0,3324.0,147.0,169.0,87.0,377.0,399.0,94.5,56.0,101.0,55.4,0.0,0.2,0.2,-0.2,3.0,38.0,1.0,0.0,53.0,Matches,267,de GER,DF,22,16,1123.0,70.0,36.7,12.5,13,84.0,11,3,9.0,6,1.5,21.0,24.0,-3.0,-0.24,-0.15,20.3,18.3,2.0,0.16,0.01,Matches,235.0,de GER,DF,22.0,12.5,801.0,87.0,442.0,326.0,37.0,7.0,801.0,4.0,2.0,50.0,1.0,25.0,510.0,2877.0,1621.0,14.0,8.0,0.0,4.0,3.0,528.0,4.0,Matches,235.0,de GER,DF,22.0,12.5,1.0,4.0,1.0,25.0,0.32,0.08,0.25,1.0,9.8,0.0,0.0,0.0,1.1,1.1,0.28,-0.1,-0.1,Matches,235.0,de GER,DF,22.0,16.0,13.0,1123.0,12.5,1.0,0.0,1.0,1.0,0.0,0.0,5.0,2.0,1.1,1.1,0.2,1.3,14.0,53.0,4.0,0.08,0.0,0.08,0.08,0.08,0.09,0.01,0.1,0.09,0.1,Matches,Luca Kilian,D C,22,125,138,Germany,1. FC Köln,4,7,6,8,11,5,15,7,11,14,12,9,13,10,14,12,16,10,13,8,11,12,6,9,9,13,15,12,12,8,12,15,13,16,13,15,15,8,14,5,11,2,2,1,1,2,2,3,1,1,1,2,8,14,6,12,13,13,15,17,1,1,20,14,1,1,12,1,1,1,1,1,1,1,192,91,13,20,4674999,6227,6227,3981,Northern_European,125,4,1999/9/1,0,0,5499.0,,91172547
115,Joshua Kimmich,Bayern Munich,1995,236.0,de GER,MF,27.0,31.2,78.0,49.0,24.0,46.0,8.0,38.0,72.0,52.8,34.0,36.0,7.0,29.0,41.0,119.0,39.0,2.0,Matches,236.0,de GER,MF,27.0,31.2,142.0,4.55,82.0,55.0,1.0,2.0,1.0,1.0,15.0,0.48,12.0,2.0,0.0,1.0,0.0,0.0,Matches,,,,,,,,,,,,,,,,,,,,,,,,,,,,,,,,,,,,,,,,,,,,,,,,,,,,,,,,236.0,de GER,MF,27.0,31.2,6.0,1.0,1.0,22.0,51.0,0.0,240.0,41.0,49.0,0.0,0.0,0.0,262.0,16.0,32.0,33.3,Matches,236.0,de GER,MF,27.0,31.2,2767.0,2407.0,351.0,119.0,29.0,10.0,240.0,28.0,204.0,83.0,98.0,4.0,2333.0,9.0,24.0,Matches,236.0,de GER,MF,27.0,31.2,2333.0,2767.0,84.3,43859.0,14050.0,954.0,1017.0,93.8,1036.0,1151.0,90.0,306.0,512.0,59.8,6.0,7.0,9.0,-1.0,84.0,272.0,68.0,4.0,315.0,Matches,268,de GER,MF,27,33,2809.0,85.0,91.8,31.2,32,86.0,27,1,45.0,0,2.06,85.0,36.0,49.0,1.57,-0.22,68.4,35.1,33.3,1.07,-0.55,Matches,236.0,de GER,MF,27.0,31.2,3073.0,115.0,618.0,1669.0,809.0,20.0,3072.0,25.0,13.0,52.0,8.0,32.0,1762.0,8923.0,3443.0,42.0,31.0,4.0,26.0,26.0,2065.0,56.0,Matches,236.0,de GER,MF,27.0,31.2,5.0,27.0,11.0,40.7,0.87,0.35,0.15,0.36,26.0,3.0,1.0,1.0,2.2,1.4,0.05,2.8,2.6,Matches,236.0,de GER,MF,27.0,33.0,32.0,2809.0,31.2,5.0,6.0,11.0,4.0,1.0,1.0,6.0,1.0,2.2,1.4,7.0,8.4,42.0,315.0,56.0,0.16,0.19,0.35,0.13,0.32,0.07,0.22,0.3,0.05,0.27,Matches,Joshua Kimmich,D/DM/M RC,27,178,183,Germany,FC Bayern München,15,17,12,11,16,15,11,14,12,13,18,11,12,16,15,15,15,17,13,18,16,20,13,16,12,13,17,20,12,12,13,10,20,12,20,11,18,11,17,6,19,2,3,3,2,3,3,1,1,3,2,2,14,20,8,16,16,20,12,10,1,1,14,16,1,15,20,10,18,12,8,11,8,1,177,75,12,20,120657610,8900,8900,8500,Northern_European,164,3,1995/2/8,68,5,345204.0,,92039023
116,Lukas Klostermann,RB Leipzig,1996,238.0,de GER,DF,26.0,10.1,16.0,8.0,7.0,9.0,0.0,8.0,15.0,53.3,7.0,6.0,3.0,3.0,13.0,29.0,31.0,0.0,Matches,238.0,de GER,DF,26.0,10.1,4.0,0.4,4.0,0.0,0.0,0.0,0.0,0.0,0.0,0.0,0.0,0.0,0.0,0.0,0.0,0.0,Matches,,,,,,,,,,,,,,,,,,,,,,,,,,,,,,,,,,,,,,,,,,,,,,,,,,,,,,,,238.0,de GER,DF,26.0,10.1,0.0,0.0,0.0,6.0,3.0,1.0,4.0,13.0,8.0,0.0,0.0,0.0,72.0,15.0,18.0,45.5,Matches,238.0,de GER,DF,26.0,10.1,784.0,752.0,29.0,15.0,2.0,0.0,4.0,14.0,0.0,0.0,0.0,0.0,687.0,3.0,6.0,Matches,238.0,de GER,DF,26.0,10.1,687.0,784.0,87.6,12138.0,3677.0,282.0,305.0,92.5,355.0,380.0,93.4,44.0,79.0,55.7,0.0,0.1,0.5,-0.1,1.0,36.0,3.0,0.0,40.0,Matches,273,de GER,DF,26,15,907.0,60.0,29.6,10.1,10,86.0,8,5,9.0,6,2.0,14.0,9.0,5.0,0.5,-0.26,17.3,8.7,8.6,0.86,0.15,Matches,238.0,de GER,DF,26.0,10.1,873.0,54.0,372.0,458.0,48.0,5.0,873.0,2.0,1.0,50.0,1.0,50.0,549.0,2340.0,1092.0,5.0,8.0,0.0,3.0,4.0,634.0,12.0,Matches,238.0,de GER,DF,26.0,10.1,0.0,6.0,1.0,16.7,0.6,0.1,0.0,0.0,17.9,0.0,0.0,0.0,0.3,0.3,0.06,-0.3,-0.3,Matches,238.0,de GER,DF,26.0,15.0,10.0,907.0,10.1,0.0,0.0,0.0,0.0,0.0,0.0,0.0,0.0,0.3,0.3,0.1,0.5,5.0,40.0,12.0,0.0,0.0,0.0,0.0,0.0,0.03,0.01,0.05,0.03,0.05,Matches,Lukas Klostermann,D/WB RLC,26,137,142,Germany,RB Leipzig,5,10,8,9,10,6,12,6,15,12,11,7,13,11,12,14,16,10,12,9,11,15,7,11,14,11,13,14,13,9,15,15,16,18,17,15,13,10,15,7,16,1,2,1,1,1,1,2,3,2,1,3,12,16,6,7,13,13,15,17,1,16,15,20,14,18,1,8,1,10,8,1,10,1,187,88,11,20,13628164,7000,7000,5250,Northern_European,126,3,1996/6/3,18,0,95889.0,,91134708
117,Ansgar Knauff,Eint Frankfurt,2002,239.0,de GER,DF,20.0,14.3,36.0,25.0,22.0,11.0,3.0,15.0,34.0,44.1,19.0,19.0,1.0,18.0,15.0,51.0,26.0,0.0,Matches,239.0,de GER,DF,20.0,14.3,24.0,1.68,18.0,0.0,1.0,0.0,5.0,0.0,4.0,0.28,2.0,0.0,0.0,0.0,2.0,0.0,Matches,,,,,,,,,,,,,,,,,,,,,,,,,,,,,,,,,,,,,,,,,,,,,,,,,,,,,,,,239.0,de GER,DF,20.0,14.3,1.0,0.0,0.0,15.0,17.0,2.0,29.0,15.0,25.0,1.0,0.0,0.0,97.0,9.0,16.0,36.0,Matches,239.0,de GER,DF,20.0,14.3,683.0,523.0,158.0,5.0,1.0,0.0,29.0,153.0,0.0,0.0,0.0,0.0,455.0,2.0,32.0,Matches,239.0,de GER,DF,20.0,14.3,455.0,683.0,66.6,7020.0,2807.0,236.0,301.0,78.4,183.0,268.0,68.3,25.0,57.0,43.9,1.0,1.6,2.4,-0.6,8.0,27.0,14.0,4.0,40.0,Matches,274,de GER,DF,20,24,1286.0,54.0,42.0,14.3,14,72.0,5,10,28.0,6,1.38,20.0,26.0,-6.0,-0.42,-1.03,16.6,21.1,-4.4,-0.31,-0.97,Matches,239.0,de GER,DF,20.0,14.3,879.0,31.0,263.0,373.0,265.0,43.0,879.0,63.0,22.0,34.9,33.0,52.4,410.0,2879.0,1677.0,47.0,26.0,15.0,31.0,9.0,433.0,74.0,Matches,239.0,de GER,DF,20.0,14.3,1.0,15.0,7.0,46.7,1.05,0.49,0.07,0.14,19.7,0.0,0.0,0.0,0.9,0.9,0.06,0.1,0.1,Matches,239.0,de GER,DF,20.0,24.0,14.0,1286.0,14.3,1.0,1.0,2.0,1.0,0.0,0.0,1.0,0.0,0.9,0.9,1.6,2.5,47.0,40.0,74.0,0.07,0.07,0.14,0.07,0.14,0.06,0.12,0.18,0.06,0.18,Matches,Ansgar Knauff,WB/M/AM RL,20,128,152,"Germany,Ghana",Borussia Dortmund,5,11,14,10,12,5,8,10,12,9,11,8,11,13,12,11,12,10,10,11,10,15,14,4,13,10,12,13,16,14,10,10,15,15,12,9,12,7,14,4,17,1,1,3,1,3,2,1,2,1,4,2,10,14,8,16,11,11,10,9,1,10,1,14,16,18,1,16,1,18,16,10,20,10,180,73,8,20,17399999,6399,6399,4999,African_Caribbean,117,13,2002/1/10,0,0,10000.0,Eintracht Frankfurt,91203087
118,Robin Knoche,Union Berlin,1992,240.0,de GER,DF,30.0,31.9,45.0,29.0,29.0,12.0,4.0,24.0,47.0,51.1,23.0,35.0,18.0,17.0,38.0,83.0,140.0,0.0,Matches,240.0,de GER,DF,30.0,31.9,23.0,0.72,18.0,2.0,0.0,3.0,0.0,0.0,4.0,0.13,3.0,0.0,0.0,1.0,0.0,0.0,Matches,,,,,,,,,,,,,,,,,,,,,,,,,,,,,,,,,,,,,,,,,,,,,,,,,,,,,,,,240.0,de GER,DF,30.0,31.9,4.0,0.0,0.0,14.0,23.0,0.0,5.0,38.0,29.0,0.0,1.0,0.0,246.0,55.0,56.0,49.5,Matches,240.0,de GER,DF,30.0,31.9,1643.0,1578.0,59.0,56.0,1.0,7.0,5.0,3.0,0.0,0.0,0.0,0.0,1332.0,6.0,20.0,Matches,240.0,de GER,DF,30.0,31.9,1332.0,1643.0,81.1,28246.0,10955.0,362.0,409.0,88.5,764.0,843.0,90.6,199.0,347.0,57.3,3.0,0.8,1.1,2.2,5.0,98.0,7.0,3.0,98.0,Matches,275,de GER,DF,30,32,2873.0,90.0,93.9,31.9,32,90.0,31,0,,1,1.94,49.0,32.0,17.0,0.53,2.46,35.0,39.1,-4.2,-0.13,0.14,Matches,240.0,de GER,DF,30.0,31.9,1965.0,234.0,1045.0,887.0,45.0,23.0,1963.0,13.0,11.0,84.6,1.0,7.7,1093.0,5352.0,2849.0,12.0,3.0,1.0,15.0,7.0,1110.0,6.0,Matches,240.0,de GER,DF,30.0,31.9,2.0,8.0,1.0,12.5,0.25,0.03,0.13,1.0,16.0,0.0,1.0,2.0,2.4,0.8,0.1,-0.4,0.2,Matches,240.0,de GER,DF,30.0,32.0,32.0,2873.0,31.9,2.0,3.0,5.0,1.0,1.0,2.0,4.0,0.0,2.4,0.8,0.8,1.6,12.0,98.0,6.0,0.06,0.09,0.16,0.03,0.13,0.07,0.03,0.1,0.03,0.05,Matches,Robin Knoche,D C,30,140,143,Germany,1. FC Union Berlin,5,8,7,7,11,5,15,6,12,16,12,6,15,10,10,15,15,16,16,8,15,11,4,8,6,16,18,13,10,9,13,14,16,10,14,15,17,6,13,8,12,3,1,2,2,2,2,1,2,3,2,1,5,10,3,16,13,15,16,18,1,1,20,10,1,1,12,1,10,1,1,1,1,1,190,78,11,20,6358887,6699,6699,5099,Northern_European,139,4,1992/5/22,0,0,23014.0,,91100465
119,Gregor Kobel,Dortmund,1997,241.0,ch SUI,GK,24.0,27.0,0.0,0.0,0.0,0.0,0.0,0.0,1.0,0.0,1.0,1.0,0.0,1.0,0.0,0.0,7.0,2.0,Matches,241.0,ch SUI,GK,24.0,27.0,4.0,0.15,4.0,0.0,0.0,0.0,0.0,0.0,0.0,0.0,0.0,0.0,0.0,0.0,0.0,0.0,Matches,14.0,ch SUI,GK,24.0,27.0,32.0,1.0,0.0,5.0,1.0,33.8,0.29,2.8,0.1,100.0,252.0,39.7,855.0,122.0,20.9,28.9,192.0,38.0,36.5,295.0,15.0,5.1,37.0,1.37,17.1,Matches,14.0,ch SUI,GK,24.0,27.0,27.0,2430.0,27.0,32.0,1.19,119.0,88.0,73.9,19.0,3.0,5.0,11.0,40.7,1.0,1.0,0.0,0.0,0.0,Matches,241.0,ch SUI,GK,24.0,27.0,0.0,0.0,0.0,0.0,4.0,0.0,0.0,0.0,0.0,0.0,0.0,1.0,43.0,4.0,0.0,100.0,Matches,241.0,ch SUI,GK,24.0,27.0,1049.0,800.0,247.0,55.0,0.0,2.0,0.0,0.0,0.0,0.0,0.0,0.0,871.0,2.0,0.0,Matches,241.0,ch SUI,GK,24.0,27.0,871.0,1049.0,83.0,22004.0,13496.0,179.0,179.0,100.0,455.0,459.0,99.1,234.0,406.0,57.6,0.0,0.0,0.1,0.0,0.0,13.0,1.0,0.0,0.0,Matches,277,ch SUI,GK,24,27,2430.0,90.0,79.4,27.0,27,90.0,27,0,,2,2.22,68.0,32.0,36.0,1.33,0.9,58.2,33.3,24.9,0.92,0.49,Matches,241.0,ch SUI,GK,24.0,27.0,1115.0,855.0,1108.0,8.0,0.0,0.0,1115.0,1.0,1.0,100.0,0.0,0.0,671.0,2981.0,1423.0,0.0,0.0,0.0,1.0,0.0,613.0,0.0,Matches,241.0,ch SUI,GK,24.0,27.0,0.0,0.0,0.0,,0.0,0.0,,,,0.0,0.0,0.0,0.0,0.0,,0.0,0.0,Matches,241.0,ch SUI,GK,24.0,27.0,27.0,2430.0,27.0,0.0,0.0,0.0,0.0,0.0,0.0,0.0,0.0,0.0,0.0,0.0,0.0,0.0,0.0,0.0,0.0,0.0,0.0,0.0,0.0,0.0,0.0,0.0,0.0,0.0,Matches,Gregor Kobel,GK,24,145,155,Switzerland,Borussia Dortmund,4,1,1,1,12,6,7,1,2,2,13,6,2,11,13,15,15,17,12,12,11,17,1,14,1,14,14,11,11,14,14,16,13,10,10,12,14,4,15,4,11,16,14,15,14,13,13,16,16,15,10,14,12,17,4,10,14,17,13,16,20,1,1,1,1,1,1,1,1,1,1,1,1,1,195,88,7,20,44042647,7250,6650,5250,Northern_European,145,3,1997/12/6,3,0,38355.0,,98040383
120,Dominik Kohr,Mainz 05,1994,242.0,de GER,MF,28.0,25.5,59.0,33.0,23.0,31.0,5.0,29.0,61.0,47.5,32.0,46.0,9.0,37.0,34.0,93.0,26.0,1.0,Matches,242.0,de GER,MF,28.0,25.5,54.0,2.12,42.0,0.0,2.0,6.0,4.0,0.0,4.0,0.16,2.0,0.0,0.0,1.0,1.0,0.0,Matches,,,,,,,,,,,,,,,,,,,,,,,,,,,,,,,,,,,,,,,,,,,,,,,,,,,,,,,,242.0,de GER,MF,28.0,25.5,11.0,0.0,0.0,45.0,35.0,1.0,5.0,34.0,33.0,0.0,1.0,0.0,205.0,35.0,41.0,46.1,Matches,242.0,de GER,MF,28.0,25.5,1183.0,1139.0,39.0,34.0,4.0,8.0,5.0,5.0,0.0,0.0,0.0,0.0,865.0,5.0,24.0,Matches,242.0,de GER,MF,28.0,25.5,865.0,1183.0,73.1,14381.0,4919.0,413.0,494.0,83.6,361.0,467.0,77.3,64.0,141.0,45.4,0.0,1.0,1.5,-1.0,16.0,111.0,16.0,0.0,144.0,Matches,279,de GER,MF,28,30,2292.0,76.0,74.9,25.5,27,83.0,21,3,18.0,1,1.43,39.0,38.0,1.0,0.04,0.27,34.8,39.1,-4.3,-0.17,0.09,Matches,242.0,de GER,MF,28.0,25.5,1447.0,57.0,344.0,867.0,250.0,32.0,1447.0,22.0,10.0,45.5,10.0,45.5,680.0,2806.0,1114.0,17.0,15.0,3.0,19.0,8.0,779.0,39.0,Matches,242.0,de GER,MF,28.0,25.5,3.0,39.0,8.0,20.5,1.53,0.31,0.08,0.38,20.5,0.0,0.0,0.0,2.3,2.3,0.06,0.7,0.7,Matches,242.0,de GER,MF,28.0,30.0,27.0,2292.0,25.5,3.0,0.0,3.0,3.0,0.0,0.0,11.0,0.0,2.3,2.3,1.0,3.3,17.0,144.0,39.0,0.12,0.0,0.12,0.12,0.12,0.09,0.04,0.13,0.09,0.13,Matches,Dominik Kohr,DM/M C,28,131,135,Germany,1. FSV Mainz 05,4,7,10,7,12,4,13,8,4,14,12,7,16,11,17,14,17,12,14,11,12,16,8,12,10,13,17,16,13,11,14,12,16,16,15,14,13,14,14,7,17,3,4,2,1,3,2,2,3,1,4,1,8,13,6,12,12,14,12,17,1,1,14,14,1,14,20,10,20,14,1,10,1,1,183,77,11,20,5212548,6545,6545,5045,Northern_European,130,3,1994/1/31,0,0,32603.0,,91108278
121,Randal Kolo Muani,Eint Frankfurt,1998,243.0,fr FRA,FW,23.0,29.2,14.0,10.0,3.0,3.0,8.0,1.0,9.0,11.1,8.0,19.0,2.0,17.0,3.0,17.0,13.0,0.0,Matches,243.0,fr FRA,FW,23.0,29.2,105.0,3.59,60.0,0.0,20.0,12.0,13.0,0.0,22.0,0.75,13.0,0.0,4.0,2.0,3.0,0.0,Matches,,,,,,,,,,,,,,,,,,,,,,,,,,,,,,,,,,,,,,,,,,,,,,,,,,,,,,,,243.0,fr FRA,FW,23.0,29.2,6.0,1.0,1.0,50.0,71.0,21.0,25.0,3.0,10.0,3.0,0.0,0.0,96.0,60.0,79.0,43.2,Matches,243.0,fr FRA,FW,23.0,29.2,649.0,624.0,21.0,0.0,4.0,3.0,25.0,1.0,0.0,0.0,0.0,0.0,419.0,4.0,36.0,Matches,243.0,fr FRA,FW,23.0,29.2,419.0,649.0,64.6,5454.0,1212.0,263.0,373.0,70.5,109.0,158.0,69.0,18.0,34.0,52.9,11.0,6.5,5.8,4.5,41.0,25.0,23.0,2.0,61.0,Matches,280,fr FRA,FW,23,32,2631.0,82.0,86.0,29.2,31,83.0,14,1,45.0,0,1.53,51.0,39.0,12.0,0.41,1.67,45.4,35.1,10.3,0.35,0.71,Matches,243.0,fr FRA,FW,23.0,29.2,1057.0,17.0,53.0,427.0,597.0,196.0,1055.0,161.0,71.0,44.1,68.0,42.2,632.0,4510.0,2287.0,97.0,54.0,66.0,108.0,65.0,824.0,240.0,Matches,243.0,fr FRA,FW,23.0,29.2,15.0,75.0,30.0,40.0,2.57,1.03,0.17,0.43,13.0,0.0,2.0,2.0,13.2,11.6,0.16,1.8,1.4,Matches,243.0,fr FRA,FW,23.0,32.0,31.0,2631.0,29.2,15.0,11.0,26.0,13.0,2.0,2.0,6.0,1.0,13.2,11.6,6.5,18.1,97.0,61.0,240.0,0.51,0.38,0.89,0.44,0.82,0.45,0.22,0.67,0.4,0.62,Matches,Randal Kolo Muani,AM/S R,23,140,149,"France,Congo",Eintracht Frankfurt,8,11,15,14,14,8,13,10,4,7,14,10,7,15,7,13,12,13,13,12,13,13,15,8,12,7,12,11,15,14,12,13,14,16,14,14,12,8,10,4,12,2,3,3,2,3,2,2,3,1,3,2,12,12,5,14,12,13,14,15,1,1,1,1,1,1,1,1,1,14,13,1,17,20,187,73,10,20,16252107,7000,6700,5400,North_African__Middle_Eastern,138,15,1998/12/5,0,0,28766.0,,48043873
122,Manu Koné,Gladbach,2001,245.0,fr FRA,MF,21.0,29.0,74.0,39.0,37.0,33.0,4.0,24.0,47.0,51.1,23.0,44.0,12.0,32.0,32.0,106.0,21.0,0.0,Matches,245.0,fr FRA,MF,21.0,29.0,61.0,2.1,44.0,0.0,5.0,3.0,6.0,3.0,5.0,0.17,5.0,0.0,0.0,0.0,0.0,0.0,Matches,,,,,,,,,,,,,,,,,,,,,,,,,,,,,,,,,,,,,,,,,,,,,,,,,,,,,,,,245.0,fr FRA,MF,21.0,29.0,12.0,0.0,0.0,52.0,74.0,0.0,6.0,32.0,39.0,0.0,1.0,0.0,221.0,16.0,25.0,39.0,Matches,245.0,fr FRA,MF,21.0,29.0,1377.0,1345.0,21.0,19.0,2.0,5.0,6.0,2.0,0.0,0.0,0.0,0.0,1187.0,11.0,26.0,Matches,245.0,fr FRA,MF,21.0,29.0,1187.0,1377.0,86.2,18142.0,5847.0,644.0,704.0,91.5,451.0,505.0,89.3,58.0,89.0,65.2,1.0,1.3,1.3,-0.3,20.0,139.0,16.0,0.0,166.0,Matches,283,fr FRA,MF,21,30,2608.0,87.0,85.2,29.0,30,87.0,18,0,,0,1.23,41.0,49.0,-8.0,-0.28,-1.27,43.0,45.3,-2.4,-0.08,-0.29,Matches,245.0,fr FRA,MF,21.0,29.0,1796.0,61.0,404.0,1127.0,302.0,24.0,1796.0,118.0,57.0,48.3,38.0,32.2,1164.0,6283.0,3307.0,59.0,52.0,6.0,81.0,50.0,1268.0,55.0,Matches,245.0,fr FRA,MF,21.0,29.0,1.0,26.0,14.0,53.8,0.9,0.48,0.04,0.07,25.1,0.0,0.0,0.0,1.2,1.2,0.05,-0.2,-0.2,Matches,245.0,fr FRA,MF,21.0,30.0,30.0,2608.0,29.0,1.0,1.0,2.0,1.0,0.0,0.0,12.0,0.0,1.2,1.2,1.3,2.5,59.0,166.0,55.0,0.03,0.03,0.07,0.03,0.07,0.04,0.05,0.09,0.04,0.09,Matches,Manu Koné,DM/M C,21,134,162,"France,Ivory Coast",Borussia Mönchengladbach,4,8,16,11,13,5,11,11,4,12,14,7,15,15,16,13,16,13,12,13,13,16,16,6,13,12,13,15,14,13,13,11,15,13,15,16,13,14,14,7,12,2,1,1,1,2,3,1,3,2,4,4,17,16,8,10,15,14,8,8,1,1,1,1,1,1,18,1,20,1,1,14,1,1,185,80,8,20,27060002,6800,5886,6036,African_Caribbean,133,18,2001/5/17,0,0,44490.0,,49047182
123,Tomáš Koubek,Augsburg,1992,248.0,cz CZE,GK,29.0,11.0,0.0,0.0,0.0,0.0,0.0,0.0,0.0,,0.0,0.0,0.0,0.0,0.0,0.0,7.0,0.0,Matches,248.0,cz CZE,GK,29.0,11.0,4.0,0.36,3.0,1.0,0.0,0.0,0.0,0.0,1.0,0.09,1.0,0.0,0.0,0.0,0.0,0.0,Matches,15.0,cz CZE,GK,29.0,11.0,22.0,0.0,1.0,0.0,2.0,22.0,0.36,2.0,0.19,77.0,225.0,34.2,414.0,48.0,37.9,36.5,96.0,70.8,52.5,176.0,10.0,5.7,22.0,2.0,16.8,Matches,15.0,cz CZE,GK,29.0,11.0,11.0,990.0,11.0,22.0,2.0,65.0,45.0,66.2,1.0,4.0,6.0,1.0,9.1,0.0,0.0,0.0,0.0,,Matches,248.0,cz CZE,GK,29.0,11.0,0.0,0.0,0.0,0.0,1.0,0.0,0.0,0.0,0.0,0.0,0.0,0.0,27.0,8.0,0.0,100.0,Matches,248.0,cz CZE,GK,29.0,11.0,510.0,385.0,125.0,29.0,0.0,0.0,0.0,0.0,0.0,0.0,0.0,0.0,349.0,0.0,0.0,Matches,248.0,cz CZE,GK,29.0,11.0,349.0,510.0,68.4,10659.0,7933.0,62.0,62.0,100.0,167.0,168.0,99.4,120.0,280.0,42.9,0.0,0.0,0.0,0.0,0.0,15.0,0.0,0.0,0.0,Matches,286,cz CZE,GK,29,11,990.0,90.0,32.4,11.0,11,90.0,11,0,,15,0.64,14.0,22.0,-8.0,-0.73,-0.16,10.5,19.8,-9.4,-0.85,-0.21,Matches,248.0,cz CZE,GK,29.0,11.0,546.0,431.0,539.0,7.0,0.0,0.0,546.0,0.0,0.0,,0.0,,321.0,1860.0,997.0,0.0,0.0,0.0,0.0,0.0,263.0,0.0,Matches,248.0,cz CZE,GK,29.0,11.0,0.0,0.0,0.0,,0.0,0.0,,,,0.0,0.0,0.0,0.0,0.0,,0.0,0.0,Matches,248.0,cz CZE,GK,29.0,11.0,11.0,990.0,11.0,0.0,0.0,0.0,0.0,0.0,0.0,0.0,0.0,0.0,0.0,0.0,0.0,0.0,0.0,0.0,0.0,0.0,0.0,0.0,0.0,0.0,0.0,0.0,0.0,0.0,Matches,Tomáš Koubek,GK,29,120,136,Czech Republic,FC Augsburg,2,1,1,1,7,2,2,2,5,6,9,5,8,6,10,12,13,11,12,6,11,15,15,16,4,12,11,8,12,12,12,13,13,12,9,15,12,10,11,8,1,16,14,15,11,10,10,14,14,11,13,14,12,13,10,15,17,8,11,8,20,1,1,1,1,1,1,1,1,1,1,1,1,1,198,95,5,20,953017,5800,6100,4600,Northern_European,120,1,1992/8/26,11,0,21152.0,,25022748
124,Alex Král,Schalke 04,1998,250.0,cz CZE,MF,24.0,26.2,34.0,24.0,10.0,22.0,2.0,17.0,37.0,45.9,20.0,31.0,6.0,25.0,17.0,51.0,53.0,0.0,Matches,250.0,cz CZE,MF,24.0,26.2,53.0,2.02,45.0,0.0,2.0,2.0,3.0,1.0,2.0,0.08,2.0,0.0,0.0,0.0,0.0,0.0,Matches,,,,,,,,,,,,,,,,,,,,,,,,,,,,,,,,,,,,,,,,,,,,,,,,,,,,,,,,250.0,cz CZE,MF,24.0,26.2,3.0,0.0,0.0,21.0,18.0,3.0,27.0,17.0,24.0,0.0,0.0,1.0,158.0,48.0,50.0,49.0,Matches,250.0,cz CZE,MF,24.0,26.2,847.0,796.0,45.0,16.0,2.0,2.0,27.0,2.0,0.0,0.0,0.0,0.0,586.0,6.0,28.0,Matches,250.0,cz CZE,MF,24.0,26.2,586.0,847.0,69.2,10138.0,3421.0,255.0,335.0,76.1,256.0,331.0,77.3,51.0,103.0,49.5,0.0,0.7,1.8,-0.7,11.0,73.0,16.0,5.0,100.0,Matches,288,cz CZE,MF,24,29,2357.0,81.0,77.0,26.2,26,89.0,23,3,18.0,3,0.93,27.0,52.0,-25.0,-0.95,0.45,28.7,47.1,-18.4,-0.7,-0.81,Matches,250.0,cz CZE,MF,24.0,26.2,1108.0,72.0,273.0,610.0,241.0,47.0,1108.0,51.0,23.0,45.1,22.0,43.1,552.0,2960.0,1364.0,41.0,21.0,4.0,30.0,21.0,600.0,70.0,Matches,250.0,cz CZE,MF,24.0,26.2,0.0,32.0,2.0,6.3,1.22,0.08,0.0,0.0,20.1,0.0,0.0,0.0,1.5,1.5,0.05,-1.5,-1.5,Matches,250.0,cz CZE,MF,24.0,29.0,26.0,2357.0,26.2,0.0,0.0,0.0,0.0,0.0,0.0,3.0,0.0,1.5,1.5,0.7,2.2,41.0,100.0,70.0,0.0,0.0,0.0,0.0,0.0,0.06,0.03,0.08,0.06,0.08,Matches,Alex Král,DM/M C,24,127,145,Czech Republic,Spartak Moscow,4,8,13,7,12,4,12,9,4,12,14,6,13,13,12,16,14,14,12,13,12,14,12,7,11,13,15,14,12,12,13,13,13,13,16,13,12,7,13,5,13,1,1,4,1,3,2,4,2,4,2,2,7,13,5,11,11,14,14,10,1,8,14,10,8,10,20,1,18,1,1,1,1,1,186,80,12,20,6242754,6346,6246,5346,Northern_European,127,1,1998/5/19,31,2,29120.0,FC Schalke 04,25045644
125,Andrej Kramarić,Hoffenheim,1991,251.0,hr CRO,MFFW,31.0,26.5,5.0,2.0,2.0,1.0,2.0,1.0,11.0,9.1,10.0,14.0,2.0,12.0,6.0,11.0,13.0,0.0,Matches,251.0,hr CRO,MFFW,31.0,26.5,89.0,3.35,71.0,3.0,3.0,7.0,5.0,0.0,12.0,0.45,9.0,0.0,0.0,2.0,1.0,0.0,Matches,,,,,,,,,,,,,,,,,,,,,,,,,,,,,,,,,,,,,,,,,,,,,,,,,,,,,,,,251.0,hr CRO,MFFW,31.0,26.5,3.0,0.0,0.0,9.0,36.0,9.0,47.0,6.0,2.0,0.0,0.0,0.0,119.0,8.0,16.0,33.3,Matches,251.0,hr CRO,MFFW,31.0,26.5,998.0,937.0,54.0,3.0,0.0,12.0,47.0,18.0,6.0,1.0,1.0,0.0,790.0,7.0,25.0,Matches,251.0,hr CRO,MFFW,31.0,26.5,790.0,998.0,79.2,11993.0,2558.0,449.0,512.0,87.7,234.0,295.0,79.3,65.0,95.0,68.4,4.0,2.2,2.8,1.8,34.0,83.0,23.0,3.0,100.0,Matches,289,hr CRO,MFFW,31,32,2386.0,75.0,78.0,26.5,26,83.0,15,6,39.0,1,1.03,39.0,45.0,-6.0,-0.23,0.17,36.5,39.3,-2.8,-0.11,-0.07,Matches,251.0,hr CRO,MFFW,31.0,26.5,1244.0,15.0,127.0,637.0,493.0,106.0,1238.0,58.0,28.0,48.3,22.0,37.9,825.0,4203.0,1674.0,49.0,34.0,16.0,61.0,33.0,945.0,191.0,Matches,251.0,hr CRO,MFFW,31.0,26.5,12.0,57.0,21.0,36.8,2.15,0.79,0.14,0.38,18.0,4.0,4.0,6.0,13.2,8.5,0.15,-1.2,-0.5,Matches,251.0,hr CRO,MFFW,31.0,32.0,26.0,2386.0,26.5,12.0,4.0,16.0,8.0,4.0,6.0,3.0,0.0,13.2,8.5,2.2,10.7,49.0,100.0,191.0,0.45,0.15,0.6,0.3,0.45,0.5,0.08,0.58,0.32,0.4,Matches,Andrej Kramarić,AM/S C,31,147,152,Croatia,TSG Hoffenheim,12,13,13,14,15,15,14,13,6,5,13,16,7,15,13,15,9,13,12,15,12,14,16,11,14,7,11,15,14,16,12,10,14,13,16,11,14,4,14,6,10,3,2,2,3,2,2,1,3,3,3,1,12,17,13,12,10,14,8,17,1,1,1,1,1,1,1,12,1,10,14,16,12,20,177,73,15,20,347975206,7350,7800,7000,Northern_European,147,3,1991/6/19,71,19,76711.0,,24004434
126,Christoph Kramer,Gladbach,1991,252.0,de GER,MF,31.0,24.7,44.0,33.0,24.0,15.0,5.0,22.0,55.0,40.0,33.0,34.0,2.0,32.0,17.0,61.0,40.0,0.0,Matches,252.0,de GER,MF,31.0,24.7,39.0,1.58,34.0,0.0,2.0,1.0,2.0,0.0,2.0,0.08,2.0,0.0,0.0,0.0,0.0,0.0,Matches,,,,,,,,,,,,,,,,,,,,,,,,,,,,,,,,,,,,,,,,,,,,,,,,,,,,,,,,252.0,de GER,MF,31.0,24.7,4.0,0.0,0.0,37.0,13.0,4.0,11.0,17.0,33.0,0.0,0.0,0.0,109.0,24.0,28.0,46.2,Matches,252.0,de GER,MF,31.0,24.7,1233.0,1170.0,58.0,37.0,2.0,4.0,11.0,11.0,0.0,0.0,0.0,0.0,1020.0,5.0,36.0,Matches,252.0,de GER,MF,31.0,24.7,1020.0,1233.0,82.7,14647.0,4393.0,595.0,663.0,89.7,331.0,392.0,84.4,43.0,70.0,61.4,0.0,2.0,1.9,-2.0,15.0,61.0,11.0,2.0,79.0,Matches,290,de GER,MF,31,29,2222.0,77.0,72.6,24.7,27,81.0,17,2,12.0,2,1.31,38.0,39.0,-1.0,-0.04,0.17,38.7,37.4,1.3,0.05,0.33,Matches,252.0,de GER,MF,31.0,24.7,1482.0,68.0,450.0,769.0,277.0,41.0,1482.0,48.0,21.0,43.8,24.0,50.0,772.0,3287.0,1556.0,26.0,28.0,6.0,26.0,30.0,1013.0,60.0,Matches,252.0,de GER,MF,31.0,24.7,0.0,6.0,1.0,16.7,0.24,0.04,0.0,0.0,22.1,0.0,0.0,0.0,0.4,0.4,0.06,-0.4,-0.4,Matches,252.0,de GER,MF,31.0,29.0,27.0,2222.0,24.7,0.0,0.0,0.0,0.0,0.0,0.0,4.0,0.0,0.4,0.4,2.0,2.4,26.0,79.0,60.0,0.0,0.0,0.0,0.0,0.0,0.01,0.08,0.1,0.01,0.1,Matches,Christoph Kramer,DM/M C,31,135,144,Germany,Borussia Mönchengladbach,8,8,11,8,13,12,12,9,4,13,13,7,15,13,15,14,17,15,14,12,14,15,10,14,11,14,18,17,10,10,14,13,13,12,17,12,13,10,14,12,14,3,3,2,1,4,2,3,2,3,2,3,8,12,8,14,15,19,12,15,1,1,14,1,1,1,20,1,18,1,1,14,1,1,191,80,12,20,4683256,6746,6746,5746,Northern_European,135,3,1991/2/19,12,0,67122.0,,91014709
127,Tom Krauß,Schalke 04,2001,253.0,de GER,MF,21.0,27.9,112.0,68.0,39.0,62.0,11.0,51.0,100.0,51.0,49.0,39.0,6.0,33.0,36.0,148.0,35.0,0.0,Matches,253.0,de GER,MF,21.0,27.9,44.0,1.58,37.0,0.0,3.0,1.0,2.0,1.0,4.0,0.14,3.0,0.0,0.0,0.0,1.0,0.0,Matches,,,,,,,,,,,,,,,,,,,,,,,,,,,,,,,,,,,,,,,,,,,,,,,,,,,,,,,,253.0,de GER,MF,21.0,27.9,8.0,0.0,0.0,46.0,32.0,0.0,16.0,36.0,68.0,0.0,0.0,0.0,223.0,27.0,34.0,44.3,Matches,253.0,de GER,MF,21.0,27.9,804.0,776.0,24.0,6.0,2.0,2.0,16.0,1.0,0.0,0.0,0.0,0.0,578.0,4.0,31.0,Matches,253.0,de GER,MF,21.0,27.9,578.0,804.0,71.9,8976.0,2927.0,291.0,376.0,77.4,233.0,284.0,82.0,35.0,70.0,50.0,0.0,0.9,1.4,-0.9,11.0,55.0,15.0,3.0,86.0,Matches,291,de GER,MF,21,32,2514.0,79.0,82.2,27.9,31,80.0,15,1,26.0,0,0.97,23.0,52.0,-29.0,-1.04,0.12,31.1,43.1,-12.0,-0.43,0.49,Matches,253.0,de GER,MF,21.0,27.9,1140.0,55.0,313.0,612.0,241.0,16.0,1140.0,33.0,20.0,60.6,12.0,36.4,466.0,2630.0,1272.0,35.0,26.0,2.0,26.0,31.0,431.0,38.0,Matches,253.0,de GER,MF,21.0,27.9,2.0,25.0,9.0,36.0,0.89,0.32,0.08,0.22,19.3,0.0,0.0,0.0,2.2,2.2,0.09,-0.2,-0.2,Matches,253.0,de GER,MF,21.0,32.0,31.0,2514.0,27.9,2.0,0.0,2.0,2.0,0.0,0.0,8.0,0.0,2.2,2.2,0.9,3.1,35.0,86.0,38.0,0.07,0.0,0.07,0.07,0.07,0.08,0.03,0.11,0.08,0.11,Matches,Tom Krauß,DM/M C,21,129,151,Germany,RB Leipzig,4,8,12,9,13,11,7,12,4,12,13,12,16,13,15,13,17,12,12,12,12,17,12,11,12,12,15,16,12,12,13,10,17,13,15,11,15,11,13,3,12,4,2,2,1,1,3,2,2,1,2,3,11,15,7,12,14,17,10,9,1,1,12,12,1,12,18,12,20,12,1,10,1,1,182,72,11,20,10440000,6447,6447,4947,Northern_European,126,5,2001/6/22,0,0,19177.0,FC Schalke 04,91177336
128,Lukas Kübler,Freiburg,1992,255.0,de GER,DF,29.0,18.2,37.0,25.0,24.0,9.0,4.0,18.0,30.0,60.0,12.0,25.0,11.0,14.0,29.0,66.0,50.0,0.0,Matches,255.0,de GER,DF,29.0,18.2,18.0,0.99,13.0,4.0,0.0,0.0,1.0,0.0,1.0,0.05,1.0,0.0,0.0,0.0,0.0,0.0,Matches,,,,,,,,,,,,,,,,,,,,,,,,,,,,,,,,,,,,,,,,,,,,,,,,,,,,,,,,255.0,de GER,DF,29.0,18.2,1.0,0.0,0.0,18.0,15.0,1.0,33.0,29.0,25.0,0.0,1.0,0.0,101.0,25.0,17.0,59.5,Matches,255.0,de GER,DF,29.0,18.2,827.0,701.0,123.0,8.0,1.0,2.0,33.0,115.0,0.0,0.0,0.0,0.0,569.0,3.0,20.0,Matches,255.0,de GER,DF,29.0,18.2,569.0,827.0,68.8,10273.0,3706.0,240.0,294.0,81.6,244.0,333.0,73.3,67.0,146.0,45.9,1.0,0.4,0.7,0.6,7.0,59.0,9.0,4.0,57.0,Matches,293,de GER,DF,29,22,1639.0,75.0,53.6,18.2,19,83.0,10,3,22.0,6,1.82,32.0,18.0,14.0,0.77,1.21,26.5,25.2,1.3,0.07,0.21,Matches,255.0,de GER,DF,29.0,18.2,1017.0,78.0,345.0,486.0,191.0,20.0,1017.0,8.0,5.0,62.5,3.0,37.5,419.0,1778.0,776.0,11.0,10.0,1.0,13.0,2.0,515.0,50.0,Matches,255.0,de GER,DF,29.0,18.2,2.0,9.0,4.0,44.4,0.49,0.22,0.22,0.5,12.2,0.0,0.0,0.0,0.9,0.9,0.1,1.1,1.1,Matches,255.0,de GER,DF,29.0,22.0,19.0,1639.0,18.2,2.0,1.0,3.0,2.0,0.0,0.0,1.0,0.0,0.9,0.9,0.4,1.3,11.0,57.0,50.0,0.11,0.05,0.16,0.11,0.16,0.05,0.02,0.07,0.05,0.07,Matches,Lukas Kübler,D/WB R,29,124,127,Germany,Sport-Club Freiburg,6,12,8,6,10,6,11,7,13,15,11,11,16,11,11,13,16,10,15,8,10,13,6,10,7,14,16,14,12,11,16,13,15,12,16,12,13,12,11,10,14,3,1,1,1,2,1,2,3,2,2,2,6,14,9,13,11,15,12,13,1,1,14,20,1,16,10,1,10,1,1,1,1,1,181,75,10,20,1557725,6149,6149,4549,Northern_European,123,2,1992/8/30,0,0,4999.0,,91101321
129,Maxence Lacroix,Wolfsburg,2000,259.0,fr FRA,DF,22.0,18.1,22.0,13.0,15.0,7.0,0.0,8.0,16.0,50.0,8.0,22.0,11.0,11.0,26.0,48.0,85.0,0.0,Matches,259.0,fr FRA,DF,22.0,18.1,13.0,0.72,12.0,1.0,0.0,0.0,0.0,0.0,0.0,0.0,0.0,0.0,0.0,0.0,0.0,0.0,Matches,,,,,,,,,,,,,,,,,,,,,,,,,,,,,,,,,,,,,,,,,,,,,,,,,,,,,,,,259.0,fr FRA,DF,22.0,18.1,1.0,0.0,0.0,19.0,11.0,0.0,3.0,26.0,13.0,0.0,1.0,0.0,85.0,50.0,33.0,60.2,Matches,259.0,fr FRA,DF,22.0,18.1,1095.0,1029.0,64.0,48.0,1.0,11.0,3.0,5.0,0.0,0.0,0.0,0.0,952.0,2.0,6.0,Matches,259.0,fr FRA,DF,22.0,18.1,952.0,1095.0,86.9,19895.0,7749.0,242.0,272.0,89.0,589.0,628.0,93.8,115.0,176.0,65.3,0.0,0.1,0.2,-0.1,3.0,71.0,0.0,0.0,83.0,Matches,298,fr FRA,DF,22,24,1627.0,68.0,53.2,18.1,18,83.0,13,6,23.0,6,1.38,31.0,26.0,5.0,0.28,0.03,28.5,26.5,2.0,0.11,0.23,Matches,259.0,fr FRA,DF,22.0,18.1,1298.0,160.0,690.0,586.0,29.0,9.0,1298.0,8.0,7.0,87.5,1.0,12.5,777.0,3937.0,2250.0,15.0,9.0,0.0,10.0,6.0,833.0,4.0,Matches,259.0,fr FRA,DF,22.0,18.1,1.0,4.0,1.0,25.0,0.22,0.06,0.25,1.0,8.6,0.0,0.0,0.0,0.5,0.5,0.13,0.5,0.5,Matches,259.0,fr FRA,DF,22.0,24.0,18.0,1627.0,18.1,1.0,0.0,1.0,1.0,0.0,0.0,1.0,0.0,0.5,0.5,0.1,0.6,15.0,83.0,4.0,0.06,0.0,0.06,0.06,0.06,0.03,0.01,0.04,0.03,0.04,Matches,Maxence Lacroix,D C,22,140,160,"France,Guadeloupe",VfL Wolfsburg,4,6,13,6,12,4,14,6,5,14,13,6,14,13,15,14,14,12,12,12,13,17,13,9,8,14,13,12,16,12,15,15,16,17,13,14,13,11,12,3,8,2,2,1,3,2,3,1,1,3,1,3,16,16,12,12,12,14,12,9,1,1,20,1,1,1,14,1,1,1,1,1,1,1,190,88,11,20,40000001,7000,6074,5904,Mixed_Race,139,12,2000/4/6,0,0,76711.0,,49038271
130,Konrad Laimer,RB Leipzig,1997,261.0,at AUT,MF,25.0,16.3,60.0,31.0,23.0,30.0,7.0,30.0,54.0,55.6,24.0,31.0,4.0,27.0,18.0,78.0,8.0,0.0,Matches,261.0,at AUT,MF,25.0,16.3,41.0,2.52,34.0,0.0,2.0,1.0,1.0,3.0,5.0,0.31,4.0,0.0,0.0,0.0,0.0,1.0,Matches,,,,,,,,,,,,,,,,,,,,,,,,,,,,,,,,,,,,,,,,,,,,,,,,,,,,,,,,261.0,at AUT,MF,25.0,16.3,8.0,0.0,0.0,30.0,22.0,2.0,12.0,18.0,31.0,0.0,0.0,0.0,121.0,3.0,17.0,15.0,Matches,261.0,at AUT,MF,25.0,16.3,751.0,720.0,28.0,19.0,7.0,5.0,12.0,9.0,0.0,0.0,0.0,0.0,596.0,3.0,22.0,Matches,261.0,at AUT,MF,25.0,16.3,596.0,751.0,79.4,9538.0,2846.0,294.0,339.0,86.7,241.0,279.0,86.4,39.0,77.0,50.6,0.0,2.3,1.7,-2.3,16.0,63.0,17.0,2.0,93.0,Matches,300,at AUT,MF,25,21,1468.0,70.0,48.0,16.3,17,82.0,7,4,17.0,1,1.95,25.0,20.0,5.0,0.31,-0.71,26.8,18.8,8.0,0.49,-0.5,Matches,261.0,at AUT,MF,25.0,16.3,985.0,26.0,203.0,553.0,249.0,38.0,985.0,56.0,32.0,57.1,18.0,32.1,611.0,3339.0,1895.0,51.0,29.0,10.0,35.0,22.0,645.0,52.0,Matches,261.0,at AUT,MF,25.0,16.3,3.0,20.0,10.0,50.0,1.23,0.61,0.15,0.3,19.9,0.0,0.0,0.0,2.4,2.4,0.12,0.6,0.6,Matches,261.0,at AUT,MF,25.0,21.0,17.0,1468.0,16.3,3.0,0.0,3.0,3.0,0.0,0.0,8.0,0.0,2.4,2.4,2.3,4.7,51.0,93.0,52.0,0.18,0.0,0.18,0.18,0.18,0.15,0.14,0.29,0.15,0.29,Matches,Konrad Laimer,D/WB/DM/M RC,25,149,155,Austria,RB Leipzig,8,9,12,10,11,7,6,10,8,15,13,8,15,13,18,15,16,13,14,12,12,18,9,10,11,14,17,18,14,14,12,9,15,15,17,12,13,12,14,4,17,2,1,1,1,3,1,3,1,4,3,2,13,16,8,12,13,14,16,9,1,1,1,16,1,16,17,14,20,13,13,10,12,1,180,72,12,20,32787087,7444,6894,6094,Northern_European,138,2,1997/5/27,24,2,57496.0,,16147659
131,Diogo Leite,Union Berlin,1999,266.0,pt POR,DF,23.0,25.0,35.0,20.0,21.0,14.0,0.0,21.0,34.0,61.8,13.0,23.0,14.0,9.0,26.0,61.0,99.0,1.0,Matches,266.0,pt POR,DF,23.0,25.0,20.0,0.8,15.0,0.0,0.0,1.0,3.0,1.0,4.0,0.16,3.0,0.0,0.0,0.0,1.0,0.0,Matches,,,,,,,,,,,,,,,,,,,,,,,,,,,,,,,,,,,,,,,,,,,,,,,,,,,,,,,,266.0,pt POR,DF,23.0,25.0,6.0,1.0,0.0,44.0,32.0,1.0,4.0,26.0,20.0,1.0,2.0,0.0,144.0,70.0,50.0,58.3,Matches,266.0,pt POR,DF,23.0,25.0,1366.0,1291.0,71.0,35.0,0.0,9.0,4.0,6.0,0.0,0.0,0.0,0.0,1071.0,4.0,16.0,Matches,266.0,pt POR,DF,23.0,25.0,1071.0,1366.0,78.4,21437.0,7772.0,358.0,420.0,85.2,555.0,643.0,86.3,146.0,260.0,56.2,1.0,0.4,0.7,0.6,4.0,97.0,4.0,1.0,111.0,Matches,307,pt POR,DF,23,28,2254.0,81.0,73.7,25.0,26,86.0,24,2,16.0,2,1.93,40.0,28.0,12.0,0.48,0.37,27.9,29.2,-1.3,-0.05,0.33,Matches,266.0,pt POR,DF,23.0,25.0,1626.0,200.0,765.0,765.0,110.0,20.0,1626.0,5.0,1.0,20.0,1.0,20.0,895.0,4279.0,2430.0,19.0,18.0,1.0,20.0,10.0,962.0,14.0,Matches,266.0,pt POR,DF,23.0,25.0,0.0,12.0,0.0,0.0,0.48,0.0,0.0,,14.8,0.0,0.0,0.0,0.8,0.8,0.07,-0.8,-0.8,Matches,266.0,pt POR,DF,23.0,28.0,26.0,2254.0,25.0,0.0,1.0,1.0,0.0,0.0,0.0,6.0,1.0,0.8,0.8,0.4,1.2,19.0,111.0,14.0,0.0,0.04,0.04,0.0,0.04,0.03,0.01,0.05,0.03,0.05,Matches,Diogo Leite,D C,23,130,144,Portugal,FC Porto,8,10,11,8,12,8,13,8,10,15,14,8,12,13,11,13,11,14,11,13,13,12,7,13,8,13,14,13,11,13,14,14,14,12,13,13,13,7,11,4,6,2,4,2,1,1,1,2,1,1,1,1,9,12,7,16,11,15,13,14,1,5,20,1,1,1,1,1,1,1,1,1,1,1,188,83,20,9,1856376,6496,6496,4996,Mediterranean_Hispanic,128,5,1999/1/23,0,0,5521.0,1. FC Union Berlin,83111536
132,Christopher Lenz,Eint Frankfurt,1994,269.0,de GER,DF,27.0,14.3,29.0,21.0,17.0,7.0,5.0,16.0,37.0,43.2,21.0,16.0,3.0,13.0,21.0,50.0,34.0,0.0,Matches,269.0,de GER,DF,27.0,14.3,41.0,2.86,25.0,14.0,1.0,1.0,0.0,0.0,5.0,0.35,4.0,1.0,0.0,0.0,0.0,0.0,Matches,,,,,,,,,,,,,,,,,,,,,,,,,,,,,,,,,,,,,,,,,,,,,,,,,,,,,,,,269.0,de GER,DF,27.0,14.3,1.0,0.0,0.0,19.0,13.0,0.0,93.0,21.0,21.0,0.0,0.0,0.0,94.0,14.0,22.0,38.9,Matches,269.0,de GER,DF,27.0,14.3,824.0,645.0,176.0,32.0,0.0,5.0,93.0,101.0,43.0,20.0,14.0,0.0,621.0,3.0,17.0,Matches,269.0,de GER,DF,27.0,14.3,621.0,824.0,75.4,11180.0,4287.0,276.0,309.0,89.3,261.0,329.0,79.3,70.0,149.0,47.0,2.0,2.6,3.1,-0.6,24.0,46.0,17.0,8.0,63.0,Matches,310,de GER,DF,27,24,1290.0,54.0,42.2,14.3,13,81.0,8,11,21.0,3,1.58,27.0,21.0,6.0,0.42,0.42,23.8,17.6,6.2,0.43,0.31,Matches,269.0,de GER,DF,27.0,14.3,966.0,51.0,249.0,439.0,288.0,19.0,966.0,14.0,11.0,78.6,2.0,14.3,465.0,2346.0,1297.0,30.0,24.0,3.0,11.0,5.0,517.0,67.0,Matches,269.0,de GER,DF,27.0,14.3,0.0,12.0,2.0,16.7,0.84,0.14,0.0,0.0,23.4,1.0,0.0,0.0,0.6,0.6,0.05,-0.6,-0.6,Matches,269.0,de GER,DF,27.0,24.0,13.0,1290.0,14.3,0.0,2.0,2.0,0.0,0.0,0.0,1.0,0.0,0.6,0.6,2.6,3.1,30.0,63.0,67.0,0.0,0.14,0.14,0.0,0.14,0.04,0.18,0.22,0.04,0.22,Matches,Christopher Lenz,D/WB/M L,27,134,135,Germany,Eintracht Frankfurt,9,12,12,6,12,9,11,9,12,13,12,9,14,13,13,12,14,13,14,11,13,12,11,12,11,13,16,14,13,12,13,12,14,12,16,12,15,5,13,12,6,3,2,2,1,2,3,1,2,1,2,2,6,12,6,11,13,13,13,13,1,20,14,1,19,1,1,16,1,1,8,1,1,1,180,75,20,11,6659860,6698,6548,4748,Northern_European,132,2,1994/9/22,0,0,8000.0,,91119808
133,Philipp Lienhart,Freiburg,1996,271.0,at AUT,DF,26.0,27.8,29.0,18.0,19.0,10.0,0.0,13.0,27.0,48.1,14.0,29.0,15.0,14.0,35.0,64.0,97.0,0.0,Matches,271.0,at AUT,DF,26.0,27.8,20.0,0.72,16.0,0.0,1.0,3.0,0.0,0.0,2.0,0.07,2.0,0.0,0.0,0.0,0.0,0.0,Matches,,,,,,,,,,,,,,,,,,,,,,,,,,,,,,,,,,,,,,,,,,,,,,,,,,,,,,,,271.0,at AUT,DF,26.0,27.8,3.0,0.0,0.0,17.0,31.0,1.0,1.0,35.0,18.0,0.0,0.0,0.0,155.0,64.0,40.0,61.5,Matches,271.0,at AUT,DF,26.0,27.8,1612.0,1519.0,90.0,47.0,3.0,21.0,1.0,17.0,0.0,0.0,0.0,0.0,1369.0,3.0,11.0,Matches,271.0,at AUT,DF,26.0,27.8,1369.0,1612.0,84.9,29859.0,8951.0,332.0,375.0,88.5,833.0,896.0,93.0,196.0,308.0,63.6,0.0,0.3,0.5,-0.3,3.0,74.0,4.0,0.0,79.0,Matches,312,at AUT,DF,26,29,2498.0,86.0,81.6,27.8,27,89.0,25,2,45.0,0,1.86,45.0,30.0,15.0,0.54,1.82,40.7,38.0,2.8,0.1,0.68,Matches,271.0,at AUT,DF,26.0,27.8,1864.0,220.0,999.0,812.0,63.0,20.0,1864.0,8.0,4.0,50.0,0.0,0.0,1126.0,7190.0,3580.0,16.0,12.0,2.0,19.0,1.0,1206.0,4.0,Matches,271.0,at AUT,DF,26.0,27.8,1.0,17.0,3.0,17.6,0.61,0.11,0.06,0.33,16.4,0.0,0.0,0.0,1.4,1.4,0.08,-0.4,-0.4,Matches,271.0,at AUT,DF,26.0,29.0,27.0,2498.0,27.8,1.0,0.0,1.0,1.0,0.0,0.0,3.0,0.0,1.4,1.4,0.3,1.7,16.0,79.0,4.0,0.04,0.0,0.04,0.04,0.04,0.05,0.01,0.06,0.05,0.06,Matches,Philipp Lienhart,D C,26,132,138,Austria,Sport-Club Freiburg,4,6,11,6,11,4,15,5,8,12,12,6,14,10,5,14,12,16,16,9,14,11,6,10,7,13,16,12,12,10,14,15,17,16,14,12,15,7,14,6,7,1,4,4,3,2,1,3,2,1,2,1,12,14,4,13,14,16,15,18,1,1,20,1,1,1,15,1,12,1,1,1,1,1,189,83,12,20,3916343,6498,6248,4248,Northern_European,131,2,1996/7/11,9,0,12499.0,,16130398
134,Matthijs de Ligt,Bayern Munich,1999,272.0,nl NED,DF,22.0,26.7,32.0,23.0,15.0,16.0,1.0,15.0,24.0,62.5,9.0,31.0,20.0,11.0,23.0,55.0,85.0,0.0,Matches,272.0,nl NED,DF,22.0,26.7,25.0,0.94,21.0,0.0,0.0,4.0,0.0,0.0,3.0,0.11,0.0,0.0,0.0,3.0,0.0,0.0,Matches,,,,,,,,,,,,,,,,,,,,,,,,,,,,,,,,,,,,,,,,,,,,,,,,,,,,,,,,272.0,nl NED,DF,22.0,26.7,4.0,0.0,0.0,19.0,17.0,2.0,2.0,23.0,23.0,0.0,2.0,0.0,165.0,96.0,64.0,60.0,Matches,272.0,nl NED,DF,22.0,26.7,2088.0,2038.0,45.0,38.0,0.0,15.0,2.0,6.0,0.0,0.0,0.0,0.0,1902.0,5.0,8.0,Matches,272.0,nl NED,DF,22.0,26.7,1902.0,2088.0,91.1,36626.0,12291.0,619.0,660.0,93.8,1114.0,1178.0,94.6,162.0,216.0,75.0,1.0,0.5,0.8,0.5,6.0,155.0,6.0,1.0,143.0,Matches,313,nl NED,DF,22,31,2403.0,78.0,78.5,26.7,27,86.0,22,4,19.0,1,2.0,67.0,27.0,40.0,1.5,-0.42,55.4,27.8,27.5,1.03,-0.38,Matches,272.0,nl NED,DF,22.0,26.7,2322.0,205.0,1018.0,1183.0,132.0,39.0,2322.0,4.0,0.0,0.0,4.0,100.0,1592.0,7491.0,3942.0,17.0,12.0,0.0,11.0,3.0,1704.0,14.0,Matches,272.0,nl NED,DF,22.0,26.7,3.0,23.0,8.0,34.8,0.86,0.3,0.13,0.38,16.0,0.0,0.0,0.0,1.1,1.1,0.05,1.9,1.9,Matches,272.0,nl NED,DF,22.0,31.0,27.0,2403.0,26.7,3.0,1.0,4.0,3.0,0.0,0.0,4.0,0.0,1.1,1.1,0.5,1.6,17.0,143.0,14.0,0.11,0.04,0.15,0.11,0.15,0.04,0.02,0.06,0.04,0.06,Matches,Matthijs de Ligt,D C,22,158,176,Holland,FC Bayern München,6,7,11,8,13,10,16,10,5,15,14,8,16,14,16,14,17,15,13,12,14,16,10,17,8,15,15,15,12,12,15,16,13,13,15,18,14,9,14,7,12,1,2,3,1,2,1,1,1,1,2,1,15,15,3,14,15,19,15,12,1,7,20,9,1,1,12,1,8,1,1,1,1,5,189,89,11,20,131681715,8000,8000,8000,Northern_European,157,1,1999/8/12,37,2,306848.0,,37055843
135,Jesper Lindstrøm,Eint Frankfurt,2000,274.0,dk DEN,MFFW,22.0,18.7,26.0,11.0,15.0,7.0,4.0,7.0,22.0,31.8,15.0,25.0,3.0,22.0,9.0,35.0,9.0,0.0,Matches,274.0,dk DEN,MFFW,22.0,18.7,55.0,2.94,25.0,7.0,8.0,10.0,4.0,1.0,10.0,0.54,2.0,0.0,4.0,3.0,1.0,0.0,Matches,,,,,,,,,,,,,,,,,,,,,,,,,,,,,,,,,,,,,,,,,,,,,,,,,,,,,,,,274.0,dk DEN,MFFW,22.0,18.7,2.0,0.0,0.0,19.0,19.0,3.0,46.0,9.0,11.0,1.0,0.0,0.0,94.0,6.0,24.0,20.0,Matches,274.0,dk DEN,MFFW,22.0,18.7,514.0,469.0,42.0,7.0,4.0,0.0,46.0,7.0,24.0,14.0,6.0,0.0,325.0,3.0,24.0,Matches,274.0,dk DEN,MFFW,22.0,18.7,325.0,514.0,63.2,4294.0,1166.0,208.0,279.0,74.6,83.0,129.0,64.3,14.0,39.0,35.9,2.0,2.8,3.2,-0.8,19.0,20.0,15.0,2.0,33.0,Matches,315,dk DEN,MFFW,22,27,1679.0,62.0,54.9,18.7,22,72.0,2,5,20.0,0,1.63,33.0,28.0,5.0,0.27,0.2,25.3,26.5,-1.2,-0.06,-0.7,Matches,274.0,dk DEN,MFFW,22.0,18.7,791.0,12.0,106.0,316.0,383.0,94.0,791.0,86.0,28.0,32.6,52.0,60.5,440.0,2951.0,1473.0,65.0,41.0,40.0,65.0,34.0,507.0,136.0,Matches,274.0,dk DEN,MFFW,22.0,18.7,7.0,45.0,19.0,42.2,2.41,1.02,0.16,0.37,18.3,4.0,0.0,0.0,5.9,5.9,0.13,1.1,1.1,Matches,274.0,dk DEN,MFFW,22.0,27.0,22.0,1679.0,18.7,7.0,2.0,9.0,7.0,0.0,0.0,2.0,0.0,5.9,5.9,2.8,8.8,65.0,33.0,136.0,0.38,0.11,0.48,0.38,0.48,0.32,0.15,0.47,0.32,0.47,Matches,Jesper Lindstrøm,AM RLC,22,135,151,Denmark,Eintracht Frankfurt,12,11,14,12,13,12,7,13,7,8,13,12,10,13,9,13,12,12,11,13,13,13,13,8,14,9,12,15,15,14,11,8,15,15,13,8,12,7,12,5,12,3,1,3,1,2,3,3,2,1,4,3,12,14,5,14,15,14,12,12,1,1,1,1,1,1,8,12,14,12,17,20,16,14,182,66,11,20,10962000,6750,6500,4500,Northern_European,131,3,2000/2/29,5,1,21999.0,,27143432
136,Anthony Losilla,Bochum,1986,276.0,fr FRA,MF,36.0,30.2,76.0,49.0,32.0,34.0,10.0,38.0,77.0,49.4,39.0,39.0,12.0,27.0,37.0,113.0,67.0,0.0,Matches,276.0,fr FRA,MF,36.0,30.2,41.0,1.36,32.0,0.0,0.0,4.0,2.0,3.0,6.0,0.2,5.0,0.0,0.0,1.0,0.0,0.0,Matches,,,,,,,,,,,,,,,,,,,,,,,,,,,,,,,,,,,,,,,,,,,,,,,,,,,,,,,,276.0,fr FRA,MF,36.0,30.2,6.0,1.0,0.0,47.0,17.0,3.0,10.0,37.0,49.0,0.0,1.0,0.0,203.0,92.0,76.0,54.8,Matches,276.0,fr FRA,MF,36.0,30.2,962.0,951.0,8.0,6.0,4.0,4.0,10.0,0.0,0.0,0.0,0.0,0.0,650.0,3.0,20.0,Matches,276.0,fr FRA,MF,36.0,30.2,650.0,962.0,67.6,10825.0,3793.0,311.0,413.0,75.3,266.0,376.0,70.7,52.0,110.0,47.3,2.0,2.2,2.2,-0.2,14.0,62.0,8.0,2.0,93.0,Matches,318,fr FRA,MF,36,31,2720.0,88.0,88.9,30.2,31,88.0,26,0,,0,1.1,39.0,64.0,-25.0,-0.83,1.03,35.3,59.3,-24.0,-0.8,-0.35,Matches,276.0,fr FRA,MF,36.0,30.2,1286.0,90.0,366.0,705.0,234.0,39.0,1286.0,20.0,9.0,45.0,10.0,50.0,410.0,1715.0,645.0,13.0,14.0,1.0,24.0,10.0,551.0,42.0,Matches,276.0,fr FRA,MF,36.0,30.2,2.0,27.0,8.0,29.6,0.89,0.26,0.07,0.25,17.2,0.0,0.0,0.0,1.9,1.9,0.07,0.1,0.1,Matches,276.0,fr FRA,MF,36.0,31.0,31.0,2720.0,30.2,2.0,2.0,4.0,2.0,0.0,0.0,6.0,1.0,1.9,1.9,2.2,4.1,13.0,93.0,42.0,0.07,0.07,0.13,0.07,0.13,0.06,0.07,0.14,0.06,0.14,Matches,Anthony Losilla,DM/M C,36,123,125,"France,Spain",VfL Bochum 1848,4,8,11,6,11,7,15,8,5,13,12,8,13,12,16,13,15,12,15,12,12,17,9,17,9,14,16,13,11,11,14,13,18,12,16,14,15,12,14,2,9,3,2,2,2,3,2,2,3,2,3,1,16,13,6,15,13,18,16,16,1,1,14,1,1,1,20,1,20,1,1,1,1,1,185,80,12,20,168657,6143,5943,4843,Northern_European,122,4,1986/3/10,0,0,6904.0,,8434242
137,Arne Maier,Augsburg,1999,279.0,de GER,MF,23.0,21.8,31.0,22.0,17.0,11.0,3.0,10.0,18.0,55.6,8.0,21.0,0.0,21.0,15.0,46.0,22.0,0.0,Matches,279.0,de GER,MF,23.0,21.8,42.0,1.93,25.0,8.0,0.0,3.0,3.0,3.0,5.0,0.23,2.0,0.0,0.0,2.0,0.0,1.0,Matches,,,,,,,,,,,,,,,,,,,,,,,,,,,,,,,,,,,,,,,,,,,,,,,,,,,,,,,,279.0,de GER,MF,23.0,21.8,3.0,0.0,0.0,12.0,18.0,2.0,64.0,15.0,22.0,0.0,1.0,0.0,118.0,12.0,17.0,41.4,Matches,279.0,de GER,MF,23.0,21.8,658.0,588.0,68.0,21.0,6.0,2.0,64.0,11.0,32.0,13.0,17.0,0.0,421.0,2.0,27.0,Matches,279.0,de GER,MF,23.0,21.8,421.0,658.0,64.0,7205.0,2336.0,196.0,264.0,74.2,161.0,223.0,72.2,45.0,102.0,44.1,1.0,1.8,2.1,-0.8,21.0,41.0,15.0,1.0,66.0,Matches,324,de GER,MF,23,30,1960.0,65.0,64.1,21.8,24,77.0,7,6,19.0,3,0.9,23.0,44.0,-21.0,-0.96,-0.96,18.4,37.1,-18.7,-0.86,-0.43,Matches,279.0,de GER,MF,23.0,21.8,862.0,23.0,167.0,380.0,320.0,38.0,862.0,37.0,16.0,43.2,17.0,45.9,418.0,2307.0,1020.0,32.0,15.0,15.0,39.0,26.0,483.0,77.0,Matches,279.0,de GER,MF,23.0,21.8,5.0,28.0,10.0,35.7,1.29,0.46,0.18,0.5,21.1,3.0,0.0,0.0,1.6,1.6,0.06,3.4,3.4,Matches,279.0,de GER,MF,23.0,30.0,24.0,1960.0,21.8,5.0,1.0,6.0,5.0,0.0,0.0,3.0,0.0,1.6,1.6,1.8,3.4,32.0,66.0,77.0,0.23,0.05,0.28,0.23,0.28,0.07,0.08,0.16,0.07,0.16,Matches,Arne Maier,DM/M C,23,129,143,Germany,FC Augsburg,11,11,13,10,15,9,7,11,6,9,15,10,10,15,10,12,11,16,12,14,11,11,13,11,10,10,15,13,13,13,12,10,10,11,14,13,13,8,13,13,12,3,1,2,1,2,3,3,2,1,3,2,10,16,12,10,12,11,14,15,1,1,1,1,1,1,20,10,20,10,10,15,10,1,186,82,11,20,5656656,6496,6496,4996,Northern_European,120,4,1999/1/8,0,0,19999.0,,91151073
138,Linton Maina,Köln,1999,280.0,de GER,FWMF,23.0,24.9,18.0,12.0,5.0,11.0,2.0,7.0,30.0,23.3,23.0,19.0,0.0,19.0,5.0,23.0,9.0,0.0,Matches,280.0,de GER,FWMF,23.0,24.9,71.0,2.85,54.0,5.0,5.0,5.0,1.0,1.0,12.0,0.48,9.0,0.0,2.0,0.0,1.0,0.0,Matches,,,,,,,,,,,,,,,,,,,,,,,,,,,,,,,,,,,,,,,,,,,,,,,,,,,,,,,,280.0,de GER,FWMF,23.0,24.9,1.0,0.0,0.0,17.0,21.0,18.0,87.0,5.0,12.0,0.0,0.0,0.0,104.0,1.0,26.0,3.7,Matches,280.0,de GER,FWMF,23.0,24.9,684.0,640.0,43.0,5.0,1.0,1.0,87.0,15.0,18.0,10.0,5.0,0.0,474.0,1.0,47.0,Matches,280.0,de GER,FWMF,23.0,24.9,474.0,684.0,69.3,6857.0,1622.0,279.0,332.0,84.0,155.0,213.0,72.8,23.0,62.0,37.1,7.0,5.9,4.8,1.1,35.0,32.0,25.0,9.0,61.0,Matches,325,de GER,FWMF,23,33,2239.0,68.0,73.2,24.9,27,77.0,1,6,28.0,1,1.24,37.0,36.0,1.0,0.04,0.7,34.6,30.2,4.4,0.18,0.08,Matches,280.0,de GER,FWMF,23.0,24.9,932.0,11.0,81.0,349.0,523.0,99.0,932.0,68.0,22.0,32.4,38.0,55.9,597.0,5016.0,2421.0,90.0,53.0,37.0,55.0,26.0,626.0,173.0,Matches,280.0,de GER,FWMF,23.0,24.9,3.0,35.0,13.0,37.1,1.41,0.52,0.09,0.23,15.3,0.0,0.0,0.0,4.6,4.6,0.13,-1.6,-1.6,Matches,280.0,de GER,FWMF,23.0,33.0,27.0,2239.0,24.9,3.0,7.0,10.0,3.0,0.0,0.0,1.0,0.0,4.6,4.6,5.9,10.5,90.0,61.0,173.0,0.12,0.28,0.4,0.12,0.4,0.19,0.24,0.42,0.19,0.42,Matches,Linton Maina,M/AM RLC,23,126,142,"Germany,Kenya",1. FC Köln,10,10,14,10,13,9,6,9,8,6,12,9,7,14,13,12,10,11,12,14,12,11,15,5,13,7,11,13,15,16,8,6,13,14,13,6,10,5,13,7,16,3,3,2,1,1,2,3,1,3,4,1,7,15,13,9,12,15,12,14,1,1,1,1,1,12,1,17,10,17,19,17,20,1,173,70,10,20,3607430,6300,6300,4500,Mixed_Race,119,11,1999/6/23,0,0,3999.0,,91151069
139,Donyell Malen,Dortmund,1999,281.0,nl NED,FW,23.0,19.0,13.0,5.0,3.0,4.0,6.0,5.0,12.0,41.7,7.0,14.0,1.0,13.0,4.0,17.0,11.0,0.0,Matches,281.0,nl NED,FW,23.0,19.0,80.0,4.22,50.0,9.0,12.0,4.0,5.0,0.0,14.0,0.74,9.0,0.0,3.0,1.0,1.0,0.0,Matches,,,,,,,,,,,,,,,,,,,,,,,,,,,,,,,,,,,,,,,,,,,,,,,,,,,,,,,,281.0,nl NED,FW,23.0,19.0,0.0,0.0,0.0,12.0,39.0,3.0,69.0,4.0,5.0,1.0,0.0,0.0,51.0,6.0,11.0,35.3,Matches,281.0,nl NED,FW,23.0,19.0,625.0,587.0,34.0,2.0,1.0,5.0,69.0,7.0,23.0,14.0,5.0,0.0,463.0,4.0,24.0,Matches,281.0,nl NED,FW,23.0,19.0,463.0,625.0,74.1,6680.0,1678.0,271.0,315.0,86.0,128.0,178.0,71.9,33.0,64.0,51.6,6.0,4.4,5.2,1.6,29.0,41.0,26.0,9.0,60.0,Matches,326,nl NED,FW,23,26,1706.0,66.0,55.8,19.0,22,71.0,1,4,34.0,2,2.04,44.0,24.0,20.0,1.06,-0.21,41.7,21.3,20.4,1.08,0.58,Matches,281.0,nl NED,FW,23.0,19.0,869.0,10.0,64.0,321.0,498.0,101.0,869.0,115.0,51.0,44.3,51.0,44.3,628.0,4019.0,2138.0,87.0,37.0,38.0,38.0,40.0,715.0,182.0,Matches,281.0,nl NED,FW,23.0,19.0,9.0,64.0,30.0,46.9,3.38,1.58,0.14,0.3,15.9,3.0,0.0,0.0,9.1,9.1,0.15,-0.1,-0.1,Matches,281.0,nl NED,FW,23.0,26.0,22.0,1706.0,19.0,9.0,6.0,15.0,9.0,0.0,0.0,0.0,0.0,9.1,9.1,4.4,13.5,87.0,60.0,182.0,0.47,0.32,0.79,0.47,0.79,0.48,0.23,0.71,0.48,0.71,Matches,Donyell Malen,AM/S RL,23,137,157,"Holland,Suriname",Borussia Dortmund,8,8,13,14,14,9,12,11,4,5,11,14,6,14,11,12,12,13,13,10,11,14,14,5,14,5,12,12,16,15,14,10,12,16,14,12,12,10,11,7,12,3,1,1,1,2,2,3,3,2,3,2,12,13,7,9,11,13,11,12,1,1,1,1,1,1,1,13,10,13,15,13,16,20,178,74,10,20,20158525,7000,6850,6000,African_Caribbean,131,12,1999/1/19,18,4,76711.0,,37055844
140,Sadio Mané,Bayern Munich,1992,282.0,sn SEN,FWMF,30.0,15.8,11.0,5.0,3.0,3.0,5.0,1.0,9.0,11.1,8.0,15.0,2.0,13.0,0.0,11.0,4.0,0.0,Matches,282.0,sn SEN,FWMF,30.0,15.8,61.0,3.85,44.0,0.0,4.0,9.0,4.0,0.0,11.0,0.69,8.0,0.0,1.0,2.0,0.0,0.0,Matches,,,,,,,,,,,,,,,,,,,,,,,,,,,,,,,,,,,,,,,,,,,,,,,,,,,,,,,,282.0,sn SEN,FWMF,30.0,15.8,2.0,0.0,0.0,16.0,24.0,21.0,22.0,0.0,5.0,1.0,0.0,0.0,42.0,22.0,18.0,55.0,Matches,282.0,sn SEN,FWMF,30.0,15.8,418.0,390.0,23.0,2.0,3.0,3.0,22.0,5.0,1.0,0.0,0.0,0.0,307.0,5.0,31.0,Matches,282.0,sn SEN,FWMF,30.0,15.8,307.0,418.0,73.4,4444.0,1192.0,185.0,222.0,83.3,98.0,118.0,83.1,15.0,23.0,65.2,5.0,3.9,3.6,1.1,24.0,17.0,30.0,5.0,43.0,Matches,328,sn SEN,FWMF,30,25,1425.0,57.0,46.6,15.8,18,72.0,4,7,18.0,1,2.2,43.0,19.0,24.0,1.52,-0.14,36.3,16.9,19.3,1.22,0.2,Matches,282.0,sn SEN,FWMF,30.0,15.8,622.0,9.0,39.0,218.0,375.0,130.0,620.0,53.0,24.0,45.3,25.0,47.2,410.0,2602.0,1295.0,59.0,26.0,33.0,53.0,14.0,486.0,164.0,Matches,282.0,sn SEN,FWMF,30.0,15.8,7.0,53.0,20.0,37.7,3.35,1.26,0.11,0.3,12.8,0.0,1.0,2.0,8.9,7.2,0.14,-1.9,-1.2,Matches,282.0,sn SEN,FWMF,30.0,25.0,18.0,1425.0,15.8,7.0,5.0,12.0,6.0,1.0,2.0,2.0,0.0,8.9,7.2,3.9,11.1,59.0,43.0,164.0,0.44,0.32,0.76,0.38,0.69,0.56,0.25,0.81,0.46,0.7,Matches,Sadio Mané,AM/S RLC,30,172,184,Senegal,FC Bayern München,11,12,16,15,16,8,14,12,3,8,14,13,10,17,14,17,15,15,12,14,14,17,16,13,18,9,16,17,15,16,16,12,17,15,14,11,12,9,17,5,11,1,3,1,3,1,3,1,1,2,2,3,18,17,8,13,15,18,12,12,1,1,1,1,1,1,1,1,1,1,20,17,19,18,174,69,14,20,109296006,8600,8800,8600,African_Caribbean,166,17,1992/4/10,87,32,354794.0,,85100467
141,Omar Marmoush,Wolfsburg,1999,284.0,eg EGY,FW,23.0,16.4,16.0,10.0,8.0,2.0,6.0,4.0,16.0,25.0,12.0,21.0,1.0,20.0,7.0,23.0,4.0,0.0,Matches,284.0,eg EGY,FW,23.0,16.4,43.0,2.62,26.0,1.0,9.0,3.0,4.0,0.0,5.0,0.3,3.0,0.0,2.0,0.0,0.0,0.0,Matches,,,,,,,,,,,,,,,,,,,,,,,,,,,,,,,,,,,,,,,,,,,,,,,,,,,,,,,,284.0,eg EGY,FW,23.0,16.4,2.0,0.0,0.0,29.0,32.0,13.0,25.0,7.0,10.0,0.0,0.0,0.0,74.0,43.0,45.0,48.9,Matches,284.0,eg EGY,FW,23.0,16.4,458.0,444.0,13.0,1.0,1.0,7.0,25.0,0.0,5.0,5.0,0.0,0.0,299.0,1.0,21.0,Matches,284.0,eg EGY,FW,23.0,16.4,299.0,458.0,65.3,4423.0,987.0,161.0,233.0,69.1,99.0,136.0,72.8,21.0,36.0,58.3,1.0,1.2,1.4,-0.2,11.0,29.0,14.0,1.0,51.0,Matches,330,eg EGY,FW,23,33,1476.0,45.0,48.2,16.4,15,69.0,1,18,24.0,1,1.45,24.0,24.0,0.0,0.0,-0.51,24.4,23.4,1.0,0.06,0.12,Matches,284.0,eg EGY,FW,23.0,16.4,744.0,10.0,79.0,290.0,392.0,91.0,744.0,99.0,38.0,38.4,52.0,52.5,473.0,2737.0,1076.0,36.0,31.0,22.0,75.0,42.0,562.0,160.0,Matches,284.0,eg EGY,FW,23.0,16.4,5.0,48.0,16.0,33.3,2.93,0.98,0.1,0.31,15.0,1.0,0.0,0.0,6.1,6.1,0.13,-1.1,-1.1,Matches,284.0,eg EGY,FW,23.0,33.0,15.0,1476.0,16.4,5.0,1.0,6.0,5.0,0.0,0.0,2.0,0.0,6.1,6.1,1.2,7.3,36.0,51.0,160.0,0.3,0.06,0.37,0.3,0.37,0.37,0.07,0.44,0.37,0.44,Matches,Omar Marmoush,AM/S RL,23,135,148,"Egypt,Canada",VfL Wolfsburg,13,11,16,11,12,14,11,12,6,8,12,12,8,15,13,13,12,12,10,12,11,13,16,6,13,8,12,12,16,15,12,11,13,15,12,11,11,9,12,7,16,1,3,1,3,2,1,2,1,1,2,3,16,14,8,11,12,12,12,12,1,1,1,1,10,10,1,11,1,10,18,10,15,20,183,81,8,20,5128346,6748,6248,5748,North_African__Middle_Eastern,124,7,1999/2/7,13,1,28009.0,,91205962
142,Eric Martel,Köln,2002,285.0,de GER,MF,20.0,22.4,66.0,41.0,29.0,30.0,7.0,30.0,60.0,50.0,30.0,29.0,9.0,20.0,33.0,99.0,49.0,0.0,Matches,285.0,de GER,MF,20.0,22.4,30.0,1.34,23.0,0.0,3.0,3.0,1.0,0.0,1.0,0.04,1.0,0.0,0.0,0.0,0.0,0.0,Matches,,,,,,,,,,,,,,,,,,,,,,,,,,,,,,,,,,,,,,,,,,,,,,,,,,,,,,,,285.0,de GER,MF,20.0,22.4,6.0,0.0,0.0,40.0,27.0,0.0,20.0,33.0,41.0,0.0,0.0,0.0,154.0,57.0,51.0,52.8,Matches,285.0,de GER,MF,20.0,22.4,888.0,876.0,10.0,9.0,1.0,3.0,20.0,1.0,0.0,0.0,0.0,0.0,695.0,2.0,25.0,Matches,285.0,de GER,MF,20.0,22.4,695.0,888.0,78.3,11692.0,2691.0,307.0,360.0,85.3,321.0,385.0,83.4,48.0,84.0,57.1,1.0,0.8,1.3,0.2,7.0,50.0,8.0,4.0,72.0,Matches,331,de GER,MF,20,29,2019.0,70.0,66.0,22.4,23,81.0,14,6,25.0,4,1.21,29.0,33.0,-4.0,-0.18,-0.09,30.2,27.3,3.0,0.13,-0.07,Matches,285.0,de GER,MF,20.0,22.4,1196.0,72.0,333.0,661.0,213.0,35.0,1196.0,13.0,7.0,53.8,5.0,38.5,595.0,2557.0,839.0,17.0,20.0,1.0,35.0,25.0,651.0,46.0,Matches,285.0,de GER,MF,20.0,22.4,1.0,28.0,8.0,28.6,1.25,0.36,0.04,0.13,20.6,0.0,0.0,0.0,1.7,1.7,0.06,-0.7,-0.7,Matches,285.0,de GER,MF,20.0,29.0,23.0,2019.0,22.4,1.0,1.0,2.0,1.0,0.0,0.0,6.0,0.0,1.7,1.7,0.8,2.5,17.0,72.0,46.0,0.04,0.04,0.09,0.04,0.09,0.08,0.04,0.11,0.08,0.11,Matches,Eric Martel,DM,20,115,-8,Germany,1. FC Köln,8,12,12,8,13,9,13,9,10,13,13,9,13,13,8,12,12,12,13,9,10,13,8,8,10,15,11,12,13,13,12,14,13,14,14,14,13,8,8,5,12,1,2,3,1,3,2,1,2,3,3,1,19,12,7,12,11,12,11,12,1,1,14,1,1,1,20,1,13,1,1,1,1,1,188,81,11,20,38250000,5743,5743,3244,Northern_European,121,2,2002/4/29,0,0,4999.0,,91205203
143,Konstantinos Mavropanos,Stuttgart,1997,289.0,gr GRE,DF,24.0,25.4,50.0,27.0,32.0,15.0,3.0,28.0,38.0,73.7,10.0,39.0,18.0,21.0,63.0,113.0,99.0,0.0,Matches,289.0,gr GRE,DF,24.0,25.4,37.0,1.46,26.0,2.0,2.0,5.0,1.0,1.0,4.0,0.16,3.0,0.0,0.0,0.0,0.0,1.0,Matches,,,,,,,,,,,,,,,,,,,,,,,,,,,,,,,,,,,,,,,,,,,,,,,,,,,,,,,,289.0,gr GRE,DF,24.0,25.4,9.0,1.0,1.0,24.0,23.0,1.0,6.0,63.0,27.0,0.0,0.0,0.0,183.0,81.0,34.0,70.4,Matches,289.0,gr GRE,DF,24.0,25.4,1512.0,1339.0,166.0,59.0,2.0,49.0,6.0,107.0,0.0,0.0,0.0,0.0,1255.0,7.0,17.0,Matches,289.0,gr GRE,DF,24.0,25.4,1255.0,1512.0,83.0,27727.0,9978.0,370.0,430.0,86.0,631.0,711.0,88.7,246.0,329.0,74.8,1.0,1.1,0.9,-0.1,15.0,92.0,12.0,2.0,120.0,Matches,336,gr GRE,DF,24,28,2286.0,82.0,74.7,25.4,26,87.0,23,2,11.0,0,1.0,32.0,44.0,-12.0,-0.47,-0.47,35.8,33.3,2.5,0.1,0.11,Matches,289.0,gr GRE,DF,24.0,25.4,1875.0,217.0,874.0,875.0,157.0,47.0,1875.0,40.0,16.0,40.0,16.0,40.0,982.0,4958.0,2663.0,34.0,26.0,2.0,31.0,5.0,1099.0,13.0,Matches,289.0,gr GRE,DF,24.0,25.4,2.0,48.0,12.0,25.0,1.89,0.47,0.04,0.17,15.5,0.0,0.0,0.0,4.0,4.0,0.08,-2.0,-2.0,Matches,289.0,gr GRE,DF,24.0,28.0,26.0,2286.0,25.4,2.0,1.0,3.0,2.0,0.0,0.0,9.0,1.0,4.0,4.0,1.1,5.2,34.0,120.0,13.0,0.08,0.04,0.12,0.08,0.12,0.16,0.05,0.2,0.16,0.2,Matches,Konstantinos Mavropanos,D RC,24,135,145,Greece,VfB Stuttgart,4,8,12,7,12,6,14,11,9,13,12,6,16,12,16,12,17,12,11,11,12,18,11,12,11,13,13,17,14,11,15,16,13,14,13,16,13,13,13,11,6,3,3,1,2,3,2,3,2,2,1,2,15,17,6,12,16,16,12,13,1,1,20,16,1,13,13,1,1,1,1,1,1,1,194,89,8,20,8139896,6750,6250,5250,Mediterranean_Hispanic,135,2,1997/12/11,13,0,25000.0,,36116501
144,Eric Maxim Choupo-Moting,Bayern Munich,1989,291.0,cm CMR,FW,33.0,12.4,10.0,7.0,2.0,6.0,2.0,1.0,2.0,50.0,1.0,8.0,0.0,8.0,0.0,10.0,5.0,0.0,Matches,291.0,cm CMR,FW,33.0,12.4,42.0,3.4,33.0,0.0,4.0,4.0,0.0,1.0,5.0,0.4,5.0,0.0,0.0,0.0,0.0,0.0,Matches,,,,,,,,,,,,,,,,,,,,,,,,,,,,,,,,,,,,,,,,,,,,,,,,,,,,,,,,291.0,cm CMR,FW,33.0,12.4,0.0,0.0,0.0,4.0,7.0,11.0,3.0,0.0,7.0,0.0,0.0,0.0,28.0,18.0,21.0,46.2,Matches,291.0,cm CMR,FW,33.0,12.4,290.0,273.0,16.0,0.0,3.0,1.0,3.0,0.0,0.0,0.0,0.0,0.0,223.0,1.0,10.0,Matches,291.0,cm CMR,FW,33.0,12.4,223.0,290.0,76.9,2934.0,827.0,137.0,167.0,82.0,55.0,66.0,83.3,10.0,16.0,62.5,2.0,1.9,2.1,0.1,16.0,23.0,12.0,1.0,43.0,Matches,338,cm CMR,FW,33,19,1112.0,59.0,36.3,12.4,14,74.0,4,5,16.0,1,2.16,38.0,13.0,25.0,2.02,0.68,28.3,14.0,14.4,1.16,0.08,Matches,291.0,cm CMR,FW,33.0,12.4,407.0,6.0,19.0,175.0,214.0,68.0,406.0,29.0,20.0,69.0,6.0,20.7,252.0,960.0,247.0,11.0,5.0,7.0,32.0,16.0,317.0,77.0,Matches,291.0,cm CMR,FW,33.0,12.4,10.0,30.0,15.0,50.0,2.43,1.21,0.33,0.67,12.6,0.0,0.0,1.0,6.1,5.3,0.18,3.9,4.7,Matches,291.0,cm CMR,FW,33.0,19.0,14.0,1112.0,12.4,10.0,2.0,12.0,10.0,0.0,1.0,0.0,0.0,6.1,5.3,1.9,7.3,11.0,43.0,77.0,0.81,0.16,0.97,0.81,0.97,0.49,0.16,0.65,0.43,0.59,Matches,Eric Maxim Choupo-Moting,AM/S RLC,33,134,145,"Cameroon,Germany",FC Bayern München,5,9,12,12,14,6,14,9,5,6,13,14,7,15,12,13,12,14,12,13,13,12,15,12,14,7,12,11,12,11,13,15,9,13,11,15,12,6,13,14,14,1,2,1,3,2,3,2,3,2,2,2,19,12,14,5,11,12,11,18,1,1,1,1,1,1,1,12,1,12,18,16,18,20,191,91,13,20,1066746,6748,7248,5748,Mixed_Race,129,12,1989/3/23,68,18,67122.0,,35015916
145,Noussair Mazraoui,Bayern Munich,1997,294.0,ma MAR,DF,24.0,11.9,29.0,21.0,9.0,9.0,11.0,15.0,24.0,62.5,9.0,13.0,2.0,11.0,10.0,39.0,25.0,0.0,Matches,294.0,ma MAR,DF,24.0,11.9,33.0,2.77,29.0,0.0,0.0,2.0,1.0,1.0,5.0,0.42,4.0,0.0,0.0,0.0,0.0,1.0,Matches,,,,,,,,,,,,,,,,,,,,,,,,,,,,,,,,,,,,,,,,,,,,,,,,,,,,,,,,294.0,ma MAR,DF,24.0,11.9,0.0,0.0,0.0,16.0,11.0,3.0,22.0,10.0,21.0,0.0,1.0,0.0,46.0,17.0,16.0,51.5,Matches,294.0,ma MAR,DF,24.0,11.9,867.0,751.0,113.0,11.0,2.0,1.0,22.0,102.0,0.0,0.0,0.0,0.0,738.0,3.0,16.0,Matches,294.0,ma MAR,DF,24.0,11.9,738.0,867.0,85.1,10684.0,3976.0,432.0,475.0,90.9,264.0,301.0,87.7,24.0,44.0,54.5,4.0,1.9,1.7,2.1,19.0,58.0,19.0,3.0,99.0,Matches,341,ma MAR,DF,24,19,1075.0,57.0,35.1,11.9,11,81.0,5,8,23.0,7,2.32,37.0,18.0,19.0,1.59,0.0,28.2,16.1,12.1,1.02,-0.15,Matches,294.0,ma MAR,DF,24.0,11.9,977.0,26.0,252.0,449.0,282.0,27.0,977.0,27.0,18.0,66.7,6.0,22.2,569.0,2683.0,1478.0,39.0,26.0,8.0,11.0,5.0,680.0,81.0,Matches,294.0,ma MAR,DF,24.0,11.9,1.0,8.0,2.0,25.0,0.67,0.17,0.13,0.5,18.5,0.0,0.0,0.0,1.1,1.1,0.14,-0.1,-0.1,Matches,294.0,ma MAR,DF,24.0,19.0,11.0,1075.0,11.9,1.0,4.0,5.0,1.0,0.0,0.0,0.0,0.0,1.1,1.1,1.9,3.0,39.0,99.0,81.0,0.08,0.33,0.42,0.08,0.42,0.09,0.16,0.25,0.09,0.25,Matches,Noussair Mazraoui,D/WB/DM/M/AM RC,24,145,153,"Morocco,Holland",FC Bayern München,8,12,13,11,15,7,11,12,12,13,14,9,14,13,13,12,14,13,13,14,13,12,14,11,16,13,16,16,14,13,13,11,12,13,15,10,13,6,12,8,17,3,3,2,3,2,1,3,4,3,3,1,10,12,4,11,10,12,13,10,1,12,10,20,12,18,18,1,16,16,1,10,16,1,183,65,8,20,15118068,7241,6511,5753,North_African__Middle_Eastern,136,7,1997/11/14,12,2,153425.0,,37052470
146,Youssoufa Moukoko,Dortmund,2004,307.0,de GER,FW,17.0,12.7,13.0,7.0,3.0,6.0,4.0,3.0,6.0,50.0,3.0,9.0,0.0,9.0,2.0,15.0,1.0,0.0,Matches,307.0,de GER,FW,17.0,12.7,29.0,2.29,19.0,0.0,7.0,2.0,1.0,0.0,7.0,0.55,5.0,0.0,2.0,0.0,0.0,0.0,Matches,,,,,,,,,,,,,,,,,,,,,,,,,,,,,,,,,,,,,,,,,,,,,,,,,,,,,,,,307.0,de GER,FW,17.0,12.7,0.0,0.0,0.0,8.0,8.0,1.0,5.0,2.0,7.0,0.0,0.0,0.0,36.0,5.0,4.0,55.6,Matches,307.0,de GER,FW,17.0,12.7,202.0,176.0,25.0,0.0,1.0,1.0,5.0,1.0,0.0,0.0,0.0,0.0,142.0,1.0,11.0,Matches,307.0,de GER,FW,17.0,12.7,142.0,202.0,70.3,1813.0,340.0,72.0,92.0,78.3,38.0,48.0,79.2,8.0,12.0,66.7,3.0,1.8,1.0,1.2,12.0,6.0,8.0,2.0,11.0,Matches,356,de GER,FW,17,26,1141.0,44.0,37.3,12.7,11,73.0,4,15,22.0,3,1.88,32.0,23.0,9.0,0.71,-0.7,28.5,18.4,10.1,0.8,-0.04,Matches,307.0,de GER,FW,17.0,12.7,346.0,1.0,24.0,137.0,191.0,62.0,346.0,45.0,17.0,37.8,26.0,57.8,209.0,1111.0,420.0,9.0,7.0,6.0,30.0,20.0,215.0,61.0,Matches,307.0,de GER,FW,17.0,12.7,7.0,35.0,19.0,54.3,2.76,1.5,0.2,0.37,14.9,0.0,0.0,0.0,6.4,6.4,0.18,0.6,0.6,Matches,307.0,de GER,FW,17.0,26.0,11.0,1141.0,12.7,7.0,3.0,10.0,7.0,0.0,0.0,0.0,0.0,6.4,6.4,1.8,8.2,9.0,11.0,61.0,0.55,0.24,0.79,0.55,0.79,0.5,0.14,0.65,0.5,0.65,Matches,Youssoufa Moukoko,S,17,121,-95,"Germany,Cameroon",Borussia Dortmund,11,12,16,16,14,11,6,11,7,5,11,13,5,16,13,11,11,14,11,9,7,13,15,5,9,6,10,13,16,16,13,7,15,15,11,11,8,5,17,12,14,1,3,2,2,1,2,3,2,1,2,2,10,18,2,15,16,16,15,16,1,1,1,1,1,1,1,1,1,1,10,10,10,20,179,72,20,10,68024000,6500,6500,5750,African_Caribbean,118,15,2004/11/20,0,0,5999.0,,2000074825
147,Florian Müller,Stuttgart,1997,308.0,de GER,GK,24.0,19.0,0.0,0.0,0.0,0.0,0.0,0.0,0.0,,0.0,0.0,0.0,0.0,0.0,0.0,7.0,4.0,Matches,308.0,de GER,GK,24.0,19.0,4.0,0.21,3.0,1.0,0.0,0.0,0.0,0.0,0.0,0.0,0.0,0.0,0.0,0.0,0.0,0.0,Matches,18.0,de GER,GK,24.0,19.0,34.0,1.0,2.0,3.0,0.0,27.2,0.3,-6.8,-0.36,98.0,212.0,46.2,599.0,98.0,26.9,29.2,133.0,38.3,36.6,260.0,6.0,2.3,28.0,1.47,18.9,Matches,18.0,de GER,GK,24.0,19.0,19.0,1710.0,19.0,34.0,1.79,87.0,53.0,62.1,3.0,7.0,9.0,1.0,5.3,1.0,1.0,0.0,0.0,0.0,Matches,308.0,de GER,GK,24.0,19.0,0.0,0.0,0.0,0.0,2.0,0.0,0.0,0.0,0.0,0.0,0.0,0.0,39.0,3.0,0.0,100.0,Matches,308.0,de GER,GK,24.0,19.0,733.0,575.0,157.0,23.0,0.0,1.0,0.0,1.0,0.0,0.0,0.0,0.0,597.0,1.0,1.0,Matches,308.0,de GER,GK,24.0,19.0,597.0,733.0,81.4,15453.0,10711.0,130.0,131.0,99.2,299.0,304.0,98.4,164.0,292.0,56.2,0.0,0.1,0.1,-0.1,2.0,7.0,1.0,0.0,2.0,Matches,358,de GER,GK,24,19,1710.0,90.0,55.9,19.0,19,90.0,19,0,,14,0.84,22.0,34.0,-12.0,-0.63,-0.63,25.4,24.6,0.8,0.04,-0.07,Matches,308.0,de GER,GK,24.0,19.0,775.0,628.0,761.0,16.0,0.0,0.0,775.0,0.0,0.0,,0.0,,447.0,2237.0,1279.0,0.0,0.0,0.0,0.0,0.0,419.0,0.0,Matches,308.0,de GER,GK,24.0,19.0,0.0,0.0,0.0,,0.0,0.0,,,,0.0,0.0,0.0,0.0,0.0,,0.0,0.0,Matches,308.0,de GER,GK,24.0,19.0,19.0,1710.0,19.0,0.0,0.0,0.0,0.0,0.0,0.0,0.0,0.0,0.0,0.0,0.1,0.1,0.0,2.0,0.0,0.0,0.0,0.0,0.0,0.0,0.0,0.0,0.0,0.0,0.0,Matches,Florian Müller,GK,24,127,137,Germany,VfB Stuttgart,2,3,3,3,12,7,8,1,3,2,12,6,2,11,10,12,13,14,12,11,12,16,3,11,2,11,16,13,12,14,12,15,14,11,12,12,12,5,16,6,11,13,12,12,13,12,13,13,15,17,9,14,10,13,6,10,16,12,14,17,20,1,1,1,1,1,1,1,1,1,1,1,1,1,190,88,20,5,4478545,6350,6350,5100,Northern_European,127,1,1997/11/13,0,0,5999.0,,92082045
148,Thomas Müller,Bayern Munich,1989,309.0,de GER,FWMF,32.0,18.5,21.0,12.0,5.0,9.0,7.0,6.0,16.0,37.5,10.0,19.0,3.0,16.0,4.0,25.0,16.0,0.0,Matches,309.0,de GER,FWMF,32.0,18.5,86.0,4.65,74.0,2.0,4.0,5.0,0.0,1.0,12.0,0.65,10.0,0.0,0.0,2.0,0.0,0.0,Matches,,,,,,,,,,,,,,,,,,,,,,,,,,,,,,,,,,,,,,,,,,,,,,,,,,,,,,,,309.0,de GER,FWMF,32.0,18.5,0.0,0.0,0.0,9.0,11.0,5.0,31.0,4.0,12.0,0.0,0.0,0.0,70.0,39.0,24.0,61.9,Matches,309.0,de GER,FWMF,32.0,18.5,831.0,794.0,29.0,3.0,9.0,4.0,31.0,16.0,3.0,0.0,0.0,0.0,621.0,8.0,20.0,Matches,309.0,de GER,FWMF,32.0,18.5,621.0,831.0,74.7,8689.0,2465.0,351.0,417.0,84.2,214.0,281.0,76.2,22.0,52.0,42.3,8.0,6.6,7.1,1.4,40.0,39.0,37.0,4.0,88.0,Matches,360,de GER,FWMF,32,27,1665.0,62.0,54.4,18.5,21,73.0,8,6,23.0,0,1.93,50.0,15.0,35.0,1.89,0.67,43.4,17.0,26.4,1.43,0.69,Matches,309.0,de GER,FWMF,32.0,18.5,1020.0,18.0,93.0,409.0,521.0,114.0,1020.0,18.0,9.0,50.0,9.0,50.0,574.0,2013.0,1010.0,33.0,24.0,11.0,49.0,20.0,791.0,182.0,Matches,309.0,de GER,FWMF,32.0,18.5,7.0,47.0,23.0,48.9,2.54,1.24,0.15,0.3,12.5,0.0,0.0,0.0,8.9,8.9,0.19,-1.9,-1.9,Matches,309.0,de GER,FWMF,32.0,27.0,21.0,1665.0,18.5,7.0,8.0,15.0,7.0,0.0,0.0,0.0,0.0,8.9,8.9,6.6,15.5,33.0,88.0,182.0,0.38,0.43,0.81,0.38,0.81,0.48,0.36,0.84,0.48,0.84,Matches,Thomas Müller,AM RC,32,171,174,Germany,FC Bayern München,11,17,11,13,13,7,14,10,8,9,16,13,11,13,17,20,13,16,16,18,16,18,13,17,20,11,20,17,12,12,13,13,20,14,19,11,16,9,17,2,18,2,3,2,2,1,1,1,1,3,1,1,10,17,10,20,19,16,10,10,1,1,1,1,1,1,10,10,14,15,11,20,18,15,185,76,13,20,347975206,8545,8545,8495,Northern_European,165,3,1989/9/13,115,42,335615.0,,35011448
149,Jamal Musiala,Bayern Munich,2003,310.0,de GER,MFFW,19.0,24.4,34.0,23.0,9.0,16.0,9.0,13.0,35.0,37.1,22.0,30.0,3.0,27.0,19.0,53.0,3.0,0.0,Matches,310.0,de GER,MFFW,19.0,24.4,120.0,4.91,90.0,0.0,17.0,8.0,3.0,2.0,26.0,1.06,18.0,0.0,3.0,2.0,1.0,2.0,Matches,,,,,,,,,,,,,,,,,,,,,,,,,,,,,,,,,,,,,,,,,,,,,,,,,,,,,,,,310.0,de GER,MFFW,19.0,24.4,1.0,0.0,0.0,23.0,43.0,1.0,11.0,19.0,23.0,1.0,0.0,0.0,144.0,12.0,12.0,50.0,Matches,310.0,de GER,MFFW,19.0,24.4,1018.0,995.0,16.0,0.0,3.0,2.0,11.0,10.0,0.0,0.0,0.0,0.0,857.0,7.0,29.0,Matches,310.0,de GER,MFFW,19.0,24.4,857.0,1018.0,84.2,12410.0,2603.0,490.0,553.0,88.6,303.0,332.0,91.3,31.0,47.0,66.0,10.0,6.6,5.4,3.4,52.0,67.0,37.0,3.0,124.0,Matches,362,de GER,MFFW,19,33,2198.0,67.0,71.8,24.4,26,77.0,7,7,27.0,0,2.06,63.0,29.0,34.0,1.39,-0.7,53.6,28.4,25.2,1.03,-0.29,Matches,310.0,de GER,MFFW,19.0,24.4,1401.0,19.0,142.0,667.0,616.0,144.0,1401.0,152.0,77.0,50.7,63.0,41.4,1018.0,6027.0,2802.0,89.0,61.0,33.0,79.0,70.0,1089.0,196.0,Matches,310.0,de GER,MFFW,19.0,24.4,12.0,66.0,25.0,37.9,2.7,1.02,0.18,0.48,15.8,0.0,0.0,0.0,8.0,8.0,0.12,4.0,4.0,Matches,310.0,de GER,MFFW,19.0,33.0,26.0,2198.0,24.4,12.0,10.0,22.0,12.0,0.0,0.0,1.0,0.0,8.0,8.0,6.6,14.6,89.0,124.0,196.0,0.49,0.41,0.9,0.49,0.9,0.33,0.27,0.6,0.33,0.6,Matches,Jamal Musiala,M/AM RLC,19,155,180,"Germany,England,Nigeria",FC Bayern München,7,8,18,13,16,6,9,13,6,11,14,12,12,18,12,14,12,13,12,15,13,16,18,6,14,11,15,15,15,17,15,10,16,15,12,9,16,6,17,4,16,2,1,1,1,2,2,2,3,3,1,2,18,19,4,14,17,17,16,18,1,1,1,1,1,1,10,12,17,12,18,20,15,12,183,70,12,20,88884003,8098,8098,7598,African_Caribbean,153,10,2003/2/26,15,1,105478.0,,28124579
150,Manuel Neuer,Bayern Munich,1986,317.0,de GER,GK,36.0,12.0,0.0,0.0,0.0,0.0,0.0,0.0,0.0,,0.0,0.0,0.0,0.0,0.0,0.0,4.0,1.0,Matches,317.0,de GER,GK,36.0,12.0,2.0,0.17,1.0,1.0,0.0,0.0,0.0,0.0,0.0,0.0,0.0,0.0,0.0,0.0,0.0,0.0,Matches,19.0,de GER,GK,36.0,12.0,11.0,2.0,0.0,0.0,0.0,14.7,0.29,3.7,0.31,39.0,79.0,49.4,435.0,81.0,16.6,26.8,69.0,10.1,23.8,103.0,4.0,3.9,23.0,1.92,19.5,Matches,19.0,de GER,GK,36.0,12.0,12.0,1080.0,12.0,11.0,0.92,44.0,33.0,79.5,7.0,4.0,1.0,4.0,33.3,2.0,2.0,0.0,0.0,0.0,Matches,317.0,de GER,GK,36.0,12.0,0.0,0.0,0.0,0.0,1.0,0.0,0.0,0.0,0.0,0.0,0.0,0.0,21.0,3.0,0.0,100.0,Matches,317.0,de GER,GK,36.0,12.0,504.0,415.0,89.0,19.0,0.0,0.0,0.0,1.0,0.0,0.0,0.0,0.0,449.0,0.0,0.0,Matches,317.0,de GER,GK,36.0,12.0,449.0,504.0,89.1,10571.0,7280.0,96.0,96.0,100.0,234.0,238.0,98.3,118.0,169.0,69.8,0.0,0.0,0.0,0.0,0.0,1.0,0.0,0.0,1.0,Matches,369,de GER,GK,36,12,1080.0,90.0,35.3,12.0,12,90.0,12,0,,0,2.08,36.0,11.0,25.0,2.08,0.77,27.6,11.4,16.2,1.35,0.37,Matches,317.0,de GER,GK,36.0,12.0,528.0,436.0,519.0,8.0,2.0,2.0,528.0,0.0,0.0,,0.0,,338.0,1534.0,910.0,0.0,0.0,0.0,1.0,0.0,318.0,0.0,Matches,317.0,de GER,GK,36.0,12.0,0.0,2.0,1.0,50.0,0.17,0.08,0.0,0.0,9.0,0.0,0.0,0.0,0.2,0.2,0.11,-0.2,-0.2,Matches,317.0,de GER,GK,36.0,12.0,12.0,1080.0,12.0,0.0,0.0,0.0,0.0,0.0,0.0,0.0,0.0,0.2,0.2,0.0,0.2,0.0,1.0,0.0,0.0,0.0,0.0,0.0,0.0,0.02,0.0,0.02,0.02,0.02,Matches,Manuel Neuer,GK,36,175,193,Germany,FC Bayern München,2,6,12,7,12,8,11,7,12,9,15,13,11,12,13,16,15,20,15,15,15,18,12,18,13,16,13,16,11,13,14,17,19,11,12,16,17,4,19,8,5,15,16,14,18,14,18,16,16,20,8,18,8,16,12,18,20,18,12,18,20,1,1,1,1,1,1,1,1,1,1,1,1,1,193,93,12,20,347975206,8750,8750,8500,Northern_European,176,2,1986/3/27,112,0,345204.0,,8718372
151,Florian Neuhaus,Gladbach,1997,318.0,de GER,MF,25.0,15.6,19.0,9.0,9.0,5.0,5.0,8.0,27.0,29.6,19.0,20.0,3.0,17.0,12.0,31.0,5.0,0.0,Matches,318.0,de GER,MF,25.0,15.6,46.0,2.95,40.0,0.0,1.0,2.0,2.0,1.0,4.0,0.26,4.0,0.0,0.0,0.0,0.0,0.0,Matches,,,,,,,,,,,,,,,,,,,,,,,,,,,,,,,,,,,,,,,,,,,,,,,,,,,,,,,,318.0,de GER,MF,25.0,15.6,2.0,0.0,0.0,10.0,21.0,2.0,7.0,12.0,9.0,0.0,1.0,0.0,76.0,3.0,10.0,23.1,Matches,318.0,de GER,MF,25.0,15.6,644.0,625.0,14.0,8.0,5.0,4.0,7.0,2.0,0.0,0.0,0.0,0.0,510.0,5.0,21.0,Matches,318.0,de GER,MF,25.0,15.6,510.0,644.0,79.2,7872.0,2540.0,282.0,318.0,88.7,183.0,220.0,83.2,30.0,53.0,56.6,0.0,2.3,2.3,-2.3,16.0,55.0,15.0,2.0,78.0,Matches,370,de GER,MF,25,23,1405.0,61.0,45.9,15.6,16,79.0,5,7,19.0,2,1.13,19.0,20.0,-1.0,-0.06,0.04,25.0,22.0,3.0,0.19,0.42,Matches,318.0,de GER,MF,25.0,15.6,804.0,22.0,133.0,448.0,232.0,41.0,804.0,34.0,12.0,35.3,15.0,44.1,488.0,2184.0,1238.0,26.0,26.0,4.0,22.0,14.0,597.0,56.0,Matches,318.0,de GER,MF,25.0,15.6,1.0,28.0,6.0,21.4,1.79,0.38,0.04,0.17,21.6,0.0,0.0,0.0,2.0,2.0,0.07,-1.0,-1.0,Matches,318.0,de GER,MF,25.0,23.0,16.0,1405.0,15.6,1.0,0.0,1.0,1.0,0.0,0.0,2.0,0.0,2.0,2.0,2.3,4.3,26.0,78.0,56.0,0.06,0.0,0.06,0.06,0.06,0.13,0.15,0.27,0.13,0.27,Matches,Florian Neuhaus,M C,25,141,150,Germany,Borussia Mönchengladbach,11,9,13,11,15,12,7,14,4,12,15,8,13,15,13,13,13,15,13,15,14,13,13,8,12,12,12,13,12,12,14,11,17,13,16,11,12,11,14,6,16,3,4,2,2,1,2,2,3,3,3,2,8,13,8,12,12,14,11,12,1,1,1,1,1,1,15,12,20,12,10,15,10,8,185,77,12,20,19064308,7150,7150,6150,Northern_European,140,4,1997/3/16,10,2,57533.0,,91167376
152,Florian Niederlechner,Augsburg,1990,320.0,de GER,FWMF,31.0,10.1,10.0,5.0,5.0,4.0,1.0,4.0,7.0,57.1,3.0,16.0,2.0,14.0,1.0,11.0,9.0,0.0,Matches,320.0,de GER,FWMF,31.0,10.1,15.0,1.48,11.0,0.0,1.0,3.0,0.0,0.0,2.0,0.2,2.0,0.0,0.0,0.0,0.0,0.0,Matches,,,,,,,,,,,,,,,,,,,,,,,,,,,,,,,,,,,,,,,,,,,,,,,,,,,,,,,,320.0,de GER,FWMF,31.0,10.1,1.0,0.0,0.0,13.0,12.0,8.0,4.0,1.0,5.0,0.0,0.0,0.0,28.0,29.0,39.0,42.6,Matches,320.0,de GER,FWMF,31.0,10.1,200.0,175.0,24.0,1.0,2.0,0.0,4.0,3.0,0.0,0.0,0.0,0.0,118.0,1.0,9.0,Matches,320.0,de GER,FWMF,31.0,10.1,118.0,200.0,59.0,1833.0,417.0,57.0,89.0,64.0,47.0,67.0,70.1,5.0,16.0,31.3,1.0,0.4,0.7,0.6,5.0,13.0,6.0,0.0,18.0,Matches,374,de GER,FWMF,31,14,910.0,65.0,29.7,10.1,10,80.0,4,4,28.0,1,1.07,15.0,15.0,0.0,0.0,0.88,13.3,16.0,-2.7,-0.27,0.62,Matches,320.0,de GER,FWMF,31.0,10.1,332.0,13.0,40.0,143.0,151.0,39.0,332.0,20.0,5.0,25.0,12.0,60.0,142.0,487.0,175.0,1.0,5.0,1.0,16.0,11.0,189.0,51.0,Matches,320.0,de GER,FWMF,31.0,10.1,4.0,28.0,15.0,53.6,2.77,1.48,0.14,0.27,15.7,0.0,0.0,0.0,2.9,2.9,0.1,1.1,1.1,Matches,320.0,de GER,FWMF,31.0,14.0,10.0,910.0,10.1,4.0,1.0,5.0,4.0,0.0,0.0,1.0,0.0,2.9,2.9,0.4,3.3,1.0,18.0,51.0,0.4,0.1,0.49,0.4,0.49,0.28,0.04,0.33,0.28,0.33,Matches,Florian Niederlechner,S,31,132,135,Germany,FC Augsburg,6,9,12,13,14,8,13,11,5,6,11,12,7,13,16,14,16,13,13,13,13,15,11,7,12,7,15,16,11,13,15,13,11,12,14,16,12,8,15,7,5,2,1,2,2,3,4,2,1,1,2,3,7,12,6,10,12,11,14,10,1,1,1,1,1,1,1,1,1,1,1,10,1,20,187,86,14,20,3168870,6600,6600,5750,Northern_European,131,4,1990/10/24,0,0,19177.0,,92037896
153,Christopher Nkunku,RB Leipzig,1997,323.0,fr FRA,FWMF,24.0,21.1,6.0,4.0,2.0,1.0,3.0,1.0,6.0,16.7,5.0,8.0,3.0,5.0,8.0,14.0,11.0,0.0,Matches,323.0,fr FRA,FWMF,24.0,21.1,98.0,4.65,62.0,3.0,16.0,10.0,7.0,0.0,14.0,0.66,7.0,0.0,3.0,1.0,3.0,0.0,Matches,,,,,,,,,,,,,,,,,,,,,,,,,,,,,,,,,,,,,,,,,,,,,,,,,,,,,,,,323.0,fr FRA,FWMF,24.0,21.1,4.0,0.0,0.0,18.0,37.0,12.0,17.0,8.0,4.0,3.0,0.0,0.0,59.0,17.0,26.0,39.5,Matches,323.0,fr FRA,FWMF,24.0,21.1,620.0,580.0,37.0,11.0,11.0,5.0,17.0,5.0,6.0,2.0,2.0,0.0,497.0,3.0,20.0,Matches,323.0,fr FRA,FWMF,24.0,21.1,497.0,620.0,80.2,7415.0,1852.0,289.0,335.0,86.3,136.0,160.0,85.0,44.0,66.0,66.7,4.0,4.3,4.6,-0.3,39.0,35.0,28.0,2.0,71.0,Matches,377,fr FRA,FWMF,24,25,1897.0,76.0,62.0,21.1,20,88.0,15,5,29.0,0,2.08,44.0,28.0,16.0,0.76,0.22,43.4,22.3,21.1,1.0,0.66,Matches,323.0,fr FRA,FWMF,24.0,21.1,854.0,17.0,57.0,356.0,448.0,128.0,850.0,77.0,38.0,49.4,27.0,35.1,588.0,2929.0,1225.0,43.0,23.0,23.0,45.0,38.0,672.0,176.0,Matches,323.0,fr FRA,FWMF,24.0,21.1,16.0,70.0,25.0,35.7,3.32,1.19,0.19,0.52,15.9,7.0,3.0,4.0,14.4,11.3,0.16,1.6,1.7,Matches,323.0,fr FRA,FWMF,24.0,25.0,20.0,1897.0,21.1,16.0,4.0,20.0,13.0,3.0,4.0,4.0,0.0,14.4,11.3,4.3,15.6,43.0,71.0,176.0,0.76,0.19,0.95,0.62,0.81,0.68,0.2,0.89,0.54,0.74,Matches,Christopher Nkunku,M/AM RLC,24,158,163,"France,Democratic Republic of Congo",RB Leipzig,14,13,14,14,14,14,6,13,7,7,16,11,7,15,14,15,12,16,15,15,16,11,15,6,15,7,16,15,15,15,13,9,14,15,16,11,15,11,13,4,18,3,3,2,3,2,1,2,1,2,2,2,8,12,8,12,10,13,14,14,1,1,1,1,1,10,1,15,17,15,16,20,17,14,175,73,12,20,65000001,7850,6981,6718,African_Caribbean,157,13,1997/11/14,6,0,143836.0,,85140301
154,Felix Nmecha,Wolfsburg,2000,324.0,de GER,MF,21.0,20.4,41.0,24.0,11.0,23.0,7.0,16.0,34.0,47.1,18.0,26.0,10.0,16.0,25.0,66.0,31.0,0.0,Matches,324.0,de GER,MF,21.0,20.4,50.0,2.45,38.0,0.0,3.0,3.0,4.0,2.0,7.0,0.34,6.0,0.0,0.0,0.0,1.0,0.0,Matches,,,,,,,,,,,,,,,,,,,,,,,,,,,,,,,,,,,,,,,,,,,,,,,,,,,,,,,,324.0,de GER,MF,21.0,20.4,3.0,0.0,0.0,29.0,38.0,1.0,7.0,25.0,24.0,1.0,0.0,0.0,117.0,44.0,30.0,59.5,Matches,324.0,de GER,MF,21.0,20.4,706.0,691.0,10.0,2.0,8.0,9.0,7.0,3.0,0.0,0.0,0.0,0.0,534.0,5.0,14.0,Matches,324.0,de GER,MF,21.0,20.4,534.0,706.0,75.6,9025.0,2662.0,249.0,311.0,80.1,218.0,264.0,82.6,50.0,82.0,61.0,5.0,3.3,1.6,1.7,20.0,70.0,11.0,1.0,86.0,Matches,378,de GER,MF,21,30,1836.0,61.0,60.0,20.4,19,82.0,11,11,25.0,1,1.47,34.0,25.0,9.0,0.44,0.44,31.6,33.3,-1.7,-0.09,-0.21,Matches,324.0,de GER,MF,21.0,20.4,967.0,38.0,183.0,536.0,258.0,40.0,967.0,46.0,26.0,56.5,13.0,28.3,540.0,2356.0,1235.0,23.0,22.0,2.0,41.0,13.0,615.0,54.0,Matches,324.0,de GER,MF,21.0,20.4,3.0,37.0,9.0,24.3,1.81,0.44,0.08,0.33,17.1,0.0,0.0,0.0,2.7,2.7,0.07,0.3,0.3,Matches,324.0,de GER,MF,21.0,30.0,19.0,1836.0,20.4,3.0,5.0,8.0,3.0,0.0,0.0,3.0,0.0,2.7,2.7,3.3,6.1,23.0,86.0,54.0,0.15,0.25,0.39,0.15,0.39,0.13,0.16,0.3,0.13,0.3,Matches,Felix Nmecha,M/AM RLC,21,122,142,"Germany,England,Nigeria",VfL Wolfsburg,12,8,13,11,14,12,12,12,5,9,13,13,10,15,12,12,11,12,10,13,12,12,15,5,12,10,12,11,13,12,14,14,12,15,12,12,11,7,10,8,13,1,3,1,3,3,1,1,3,4,3,1,15,13,4,8,12,12,12,9,1,1,1,1,1,1,10,12,18,12,15,20,15,14,188,73,9,20,3739999,6100,6100,4600,Mixed_Race,122,13,2000/10/10,0,0,14383.0,,28113827
155,Lukas Nmecha,Wolfsburg,1998,325.0,de GER,FW,23.0,10.0,5.0,3.0,0.0,2.0,3.0,3.0,3.0,100.0,0.0,5.0,1.0,4.0,3.0,8.0,4.0,0.0,Matches,325.0,de GER,FW,23.0,10.0,27.0,2.7,15.0,1.0,1.0,3.0,7.0,0.0,2.0,0.2,0.0,0.0,0.0,1.0,1.0,0.0,Matches,,,,,,,,,,,,,,,,,,,,,,,,,,,,,,,,,,,,,,,,,,,,,,,,,,,,,,,,325.0,de GER,FW,23.0,10.0,3.0,0.0,0.0,6.0,27.0,8.0,2.0,3.0,3.0,0.0,0.0,0.0,19.0,17.0,19.0,47.2,Matches,325.0,de GER,FW,23.0,10.0,201.0,188.0,12.0,0.0,1.0,2.0,2.0,3.0,0.0,0.0,0.0,0.0,133.0,1.0,8.0,Matches,325.0,de GER,FW,23.0,10.0,133.0,201.0,66.2,1973.0,348.0,69.0,92.0,75.0,43.0,62.0,69.4,10.0,14.0,71.4,0.0,0.5,0.4,-0.5,6.0,17.0,5.0,0.0,18.0,Matches,379,de GER,FW,23,16,899.0,56.0,29.4,10.0,10,79.0,5,6,19.0,2,1.13,13.0,16.0,-3.0,-0.3,-0.8,10.2,14.7,-4.4,-0.44,-0.63,Matches,325.0,de GER,FW,23.0,10.0,317.0,6.0,19.0,131.0,169.0,34.0,317.0,26.0,10.0,38.5,8.0,30.8,189.0,1050.0,304.0,15.0,7.0,5.0,38.0,11.0,251.0,70.0,Matches,325.0,de GER,FW,23.0,10.0,4.0,22.0,7.0,31.8,2.2,0.7,0.18,0.57,14.1,0.0,0.0,0.0,3.0,3.0,0.14,1.0,1.0,Matches,325.0,de GER,FW,23.0,16.0,10.0,899.0,10.0,4.0,0.0,4.0,4.0,0.0,0.0,3.0,0.0,3.0,3.0,0.5,3.5,15.0,18.0,70.0,0.4,0.0,0.4,0.4,0.4,0.3,0.05,0.35,0.3,0.35,Matches,Lukas Nmecha,S RL,23,138,152,"Germany,England,Nigeria",VfL Wolfsburg,4,8,13,15,13,12,13,9,3,5,12,17,6,15,11,13,12,13,12,12,13,13,15,7,15,6,12,12,14,13,15,13,13,16,12,13,12,6,16,8,14,2,1,2,1,1,1,2,3,4,2,3,16,16,12,8,13,11,14,14,1,1,1,1,1,1,1,10,1,10,15,14,15,20,185,80,12,20,14899890,6999,7099,5999,Mixed_Race,136,13,1998/12/14,6,0,67122.0,,28106360
156,Dani Olmo,RB Leipzig,1998,331.0,es ESP,MFFW,24.0,14.2,15.0,9.0,1.0,10.0,4.0,6.0,14.0,42.9,8.0,15.0,0.0,15.0,6.0,21.0,6.0,0.0,Matches,331.0,es ESP,MFFW,24.0,14.2,64.0,4.5,51.0,3.0,4.0,4.0,2.0,0.0,11.0,0.77,5.0,0.0,2.0,3.0,1.0,0.0,Matches,,,,,,,,,,,,,,,,,,,,,,,,,,,,,,,,,,,,,,,,,,,,,,,,,,,,,,,,331.0,es ESP,MFFW,24.0,14.2,2.0,0.0,0.0,17.0,40.0,1.0,11.0,6.0,9.0,0.0,0.0,0.0,84.0,8.0,17.0,32.0,Matches,331.0,es ESP,MFFW,24.0,14.2,596.0,560.0,29.0,10.0,21.0,6.0,11.0,3.0,10.0,2.0,0.0,0.0,450.0,7.0,23.0,Matches,331.0,es ESP,MFFW,24.0,14.2,450.0,596.0,75.5,6561.0,1888.0,258.0,300.0,86.0,134.0,173.0,77.5,31.0,57.0,54.4,5.0,4.5,5.1,0.5,38.0,36.0,27.0,1.0,68.0,Matches,388,es ESP,MFFW,24,23,1282.0,56.0,41.9,14.2,15,74.0,4,8,21.0,0,2.0,32.0,16.0,16.0,1.12,0.77,28.6,11.6,17.0,1.19,0.77,Matches,331.0,es ESP,MFFW,24.0,14.2,802.0,6.0,71.0,385.0,360.0,53.0,802.0,74.0,38.0,51.4,24.0,32.4,508.0,2620.0,1358.0,34.0,36.0,15.0,45.0,30.0,599.0,86.0,Matches,331.0,es ESP,MFFW,24.0,14.2,2.0,43.0,16.0,37.2,3.02,1.12,0.05,0.13,21.6,0.0,0.0,0.0,2.9,2.9,0.07,-0.9,-0.9,Matches,331.0,es ESP,MFFW,24.0,23.0,15.0,1282.0,14.2,2.0,5.0,7.0,2.0,0.0,0.0,2.0,0.0,2.9,2.9,4.5,7.4,34.0,68.0,86.0,0.14,0.35,0.49,0.14,0.49,0.21,0.32,0.52,0.21,0.52,Matches,Dani Olmo,M/AM RLC,24,152,163,Spain,RB Leipzig,14,13,17,13,16,14,8,13,4,8,15,13,10,16,12,15,13,14,14,17,14,14,17,8,16,10,16,14,13,14,15,8,13,12,15,10,13,7,16,5,14,4,2,2,3,3,3,3,3,2,3,3,13,16,2,12,15,17,13,10,1,1,1,1,1,1,1,13,18,13,16,20,16,10,179,72,11,20,56430002,7600,7600,6600,Northern_European,151,1,1998/5/7,24,4,76922.0,,24048100
157,Jonas Omlin,Gladbach,1994,333.0,ch SUI,GK,28.0,14.3,1.0,1.0,1.0,0.0,0.0,1.0,3.0,33.3,2.0,1.0,0.0,1.0,0.0,1.0,9.0,1.0,Matches,333.0,ch SUI,GK,28.0,14.3,3.0,0.21,2.0,1.0,0.0,0.0,0.0,0.0,0.0,0.0,0.0,0.0,0.0,0.0,0.0,0.0,Matches,22.0,ch SUI,GK,28.0,14.3,18.0,2.0,0.0,0.0,0.0,18.1,0.29,0.1,0.0,57.0,177.0,32.2,638.0,74.0,22.3,28.7,100.0,35.0,35.3,220.0,15.0,6.8,20.0,1.4,14.8,Matches,22.0,ch SUI,GK,28.0,15.0,15.0,1290.0,14.3,18.0,1.26,56.0,38.0,71.4,5.0,4.0,6.0,5.0,33.3,2.0,2.0,0.0,0.0,0.0,Matches,333.0,ch SUI,GK,28.0,14.3,0.0,0.0,0.0,0.0,2.0,0.0,0.0,0.0,1.0,0.0,0.0,0.0,31.0,3.0,0.0,100.0,Matches,333.0,ch SUI,GK,28.0,14.3,738.0,604.0,134.0,34.0,0.0,3.0,0.0,0.0,0.0,0.0,0.0,0.0,595.0,0.0,0.0,Matches,333.0,ch SUI,GK,28.0,14.3,595.0,738.0,80.6,14423.0,9281.0,130.0,132.0,98.5,323.0,328.0,98.5,141.0,277.0,50.9,0.0,0.4,0.0,-0.4,2.0,5.0,1.0,0.0,0.0,Matches,390,ch SUI,GK,28,15,1290.0,86.0,42.2,14.3,15,86.0,14,0,,0,1.27,20.0,18.0,2.0,0.14,0.39,21.5,21.1,0.4,0.03,0.11,Matches,333.0,ch SUI,GK,28.0,14.3,773.0,608.0,769.0,4.0,0.0,0.0,773.0,0.0,0.0,,0.0,,452.0,2122.0,1262.0,0.0,0.0,0.0,0.0,0.0,459.0,0.0,Matches,333.0,ch SUI,GK,28.0,14.3,0.0,0.0,0.0,,0.0,0.0,,,,0.0,0.0,0.0,0.0,0.0,,0.0,0.0,Matches,333.0,ch SUI,GK,28.0,15.0,15.0,1290.0,14.3,0.0,0.0,0.0,0.0,0.0,0.0,0.0,0.0,0.0,0.0,0.4,0.4,0.0,0.0,0.0,0.0,0.0,0.0,0.0,0.0,0.0,0.03,0.03,0.0,0.03,Matches,Jonas Omlin,GK,28,138,140,Switzerland,Montpellier Hérault SC,2,3,2,3,8,7,2,1,1,1,11,5,1,7,8,14,14,13,14,6,13,12,4,13,3,16,11,7,10,13,12,15,10,10,12,13,14,6,12,12,13,13,14,13,6,12,13,14,16,13,14,14,11,12,6,11,12,16,13,14,20,1,1,1,1,1,1,1,1,1,1,1,1,1,189,80,11,20,5972873,6750,6850,5350,Northern_European,136,1,1994/1/10,4,0,22559.0,,98033113
158,Karim Onisiwo,Mainz 05,1992,334.0,at AUT,FWMF,30.0,28.2,19.0,12.0,3.0,10.0,6.0,4.0,21.0,19.0,17.0,19.0,0.0,19.0,2.0,21.0,7.0,0.0,Matches,334.0,at AUT,FWMF,30.0,28.2,85.0,3.01,58.0,0.0,9.0,9.0,8.0,1.0,11.0,0.39,4.0,0.0,1.0,3.0,3.0,0.0,Matches,,,,,,,,,,,,,,,,,,,,,,,,,,,,,,,,,,,,,,,,,,,,,,,,,,,,,,,,334.0,at AUT,FWMF,30.0,28.2,4.0,0.0,0.0,49.0,33.0,22.0,57.0,2.0,12.0,1.0,0.0,0.0,67.0,56.0,67.0,45.5,Matches,334.0,at AUT,FWMF,30.0,28.2,608.0,538.0,67.0,0.0,2.0,1.0,57.0,7.0,0.0,0.0,0.0,0.0,343.0,3.0,44.0,Matches,334.0,at AUT,FWMF,30.0,28.2,343.0,608.0,56.4,4970.0,1063.0,189.0,300.0,63.0,111.0,179.0,62.0,16.0,32.0,50.0,2.0,3.4,4.2,-1.4,33.0,23.0,22.0,7.0,48.0,Matches,392,at AUT,FWMF,30,31,2539.0,82.0,83.0,28.2,28,87.0,17,3,32.0,0,1.19,43.0,48.0,-5.0,-0.18,-0.87,38.4,45.5,-7.1,-0.25,-0.36,Matches,334.0,at AUT,FWMF,30.0,28.2,978.0,8.0,42.0,387.0,569.0,157.0,978.0,104.0,37.0,35.6,55.0,52.9,571.0,3458.0,1365.0,72.0,39.0,33.0,111.0,50.0,695.0,220.0,Matches,334.0,at AUT,FWMF,30.0,28.2,10.0,68.0,32.0,47.1,2.41,1.13,0.15,0.31,15.6,0.0,0.0,0.0,8.2,8.2,0.12,1.8,1.8,Matches,334.0,at AUT,FWMF,30.0,31.0,28.0,2539.0,28.2,10.0,2.0,12.0,10.0,0.0,0.0,4.0,0.0,8.2,8.2,3.4,11.6,72.0,48.0,220.0,0.35,0.07,0.43,0.35,0.43,0.29,0.12,0.41,0.29,0.41,Matches,Karim Onisiwo,S RL,30,130,132,"Austria,Nigeria",1. FSV Mainz 05,4,9,13,12,11,4,12,9,4,7,11,8,9,12,15,12,16,11,11,12,10,12,14,6,14,9,16,17,16,12,13,14,15,15,12,15,11,13,12,8,15,1,3,1,2,3,1,2,4,2,3,3,9,15,14,6,11,10,12,10,1,1,1,1,10,10,1,10,1,10,15,14,15,20,188,85,12,20,3353503,6497,6097,4997,Mixed_Race,126,13,1992/3/17,18,1,24931.0,,16037392
159,Ivan Ordets,Bochum,1992,336.0,ua UKR,DF,30.0,27.2,31.0,19.0,21.0,9.0,1.0,16.0,28.0,57.1,12.0,34.0,17.0,17.0,57.0,88.0,139.0,0.0,Matches,336.0,ua UKR,DF,30.0,27.2,22.0,0.81,15.0,0.0,1.0,4.0,2.0,0.0,2.0,0.07,0.0,0.0,0.0,1.0,1.0,0.0,Matches,,,,,,,,,,,,,,,,,,,,,,,,,,,,,,,,,,,,,,,,,,,,,,,,,,,,,,,,336.0,ua UKR,DF,30.0,27.2,4.0,0.0,0.0,32.0,23.0,3.0,1.0,57.0,19.0,1.0,1.0,0.0,150.0,138.0,70.0,66.3,Matches,336.0,ua UKR,DF,30.0,27.2,1005.0,980.0,23.0,10.0,1.0,9.0,1.0,9.0,0.0,0.0,0.0,0.0,731.0,2.0,4.0,Matches,336.0,ua UKR,DF,30.0,27.2,731.0,1005.0,72.7,14758.0,4989.0,195.0,269.0,72.5,452.0,542.0,83.4,75.0,160.0,46.9,0.0,0.8,1.0,-0.8,8.0,30.0,3.0,0.0,53.0,Matches,394,ua UKR,DF,30,30,2449.0,82.0,80.0,27.2,28,87.0,24,2,4.0,2,1.17,39.0,58.0,-19.0,-0.7,1.22,34.0,54.2,-20.2,-0.74,0.07,Matches,336.0,ua UKR,DF,30.0,27.2,1335.0,184.0,716.0,520.0,103.0,66.0,1335.0,3.0,2.0,66.7,1.0,33.3,531.0,1737.0,647.0,3.0,4.0,1.0,9.0,4.0,600.0,14.0,Matches,336.0,ua UKR,DF,30.0,27.2,0.0,17.0,1.0,5.9,0.62,0.04,0.0,0.0,11.7,0.0,0.0,0.0,1.4,1.4,0.08,-1.4,-1.4,Matches,336.0,ua UKR,DF,30.0,30.0,28.0,2449.0,27.2,0.0,0.0,0.0,0.0,0.0,0.0,4.0,0.0,1.4,1.4,0.8,2.1,3.0,53.0,14.0,0.0,0.0,0.0,0.0,0.0,0.05,0.03,0.08,0.05,0.08,Matches,Ivan Ordets,D C,30,126,130,Ukraine,Dinamo Moscow,5,7,7,8,11,9,16,8,9,13,10,7,14,11,9,15,16,12,13,13,11,16,3,9,10,14,15,14,11,9,14,15,16,11,12,15,15,11,12,8,2,3,2,2,1,3,3,2,2,1,2,3,13,11,7,13,14,16,13,15,1,1,20,1,1,1,5,1,1,1,1,1,1,1,195,93,10,20,4451829,6000,4814,4334,Northern_European,125,1,1992/7/8,12,1,19229.0,VfL Bochum 1848,71023433
160,Paulo Otávio,Wolfsburg,1994,339.0,br BRA,DF,27.0,22.7,72.0,46.0,46.0,17.0,9.0,44.0,66.0,66.7,22.0,42.0,6.0,36.0,30.0,102.0,70.0,1.0,Matches,339.0,br BRA,DF,27.0,22.7,39.0,1.72,33.0,2.0,1.0,3.0,0.0,0.0,7.0,0.31,7.0,0.0,0.0,0.0,0.0,0.0,Matches,,,,,,,,,,,,,,,,,,,,,,,,,,,,,,,,,,,,,,,,,,,,,,,,,,,,,,,,339.0,br BRA,DF,27.0,22.7,7.0,0.0,0.0,25.0,40.0,0.0,68.0,30.0,46.0,0.0,0.0,1.0,110.0,27.0,36.0,42.9,Matches,339.0,br BRA,DF,27.0,22.7,1182.0,974.0,204.0,14.0,2.0,5.0,68.0,190.0,0.0,0.0,0.0,0.0,873.0,4.0,36.0,Matches,339.0,br BRA,DF,27.0,22.7,873.0,1182.0,73.9,15683.0,5876.0,376.0,442.0,85.1,417.0,526.0,79.3,72.0,163.0,44.2,5.0,2.7,3.3,2.3,23.0,69.0,28.0,17.0,98.0,Matches,397,br BRA,DF,27,25,2041.0,82.0,66.7,22.7,25,82.0,15,0,,2,1.44,33.0,26.0,7.0,0.31,0.13,31.7,30.4,1.3,0.06,0.17,Matches,339.0,br BRA,DF,27.0,22.7,1507.0,83.0,508.0,676.0,338.0,29.0,1507.0,47.0,22.0,46.8,19.0,40.4,744.0,3969.0,2264.0,41.0,24.0,2.0,28.0,7.0,808.0,84.0,Matches,339.0,br BRA,DF,27.0,22.7,0.0,19.0,1.0,5.3,0.84,0.04,0.0,0.0,23.9,0.0,0.0,0.0,0.8,0.8,0.04,-0.8,-0.8,Matches,339.0,br BRA,DF,27.0,25.0,25.0,2041.0,22.7,0.0,5.0,5.0,0.0,0.0,0.0,7.0,0.0,0.8,0.8,2.7,3.5,41.0,98.0,84.0,0.0,0.22,0.22,0.0,0.22,0.04,0.12,0.16,0.04,0.16,Matches,Paulo Otávio,D/WB L,27,134,136,Brazil,VfL Wolfsburg,5,13,13,7,12,5,8,7,12,13,11,6,15,12,16,12,15,12,12,10,12,16,13,6,13,13,15,15,16,13,11,8,13,17,14,10,12,13,13,13,12,1,1,2,1,3,3,2,3,2,2,2,16,14,14,8,13,10,8,8,1,20,1,10,18,10,1,14,1,1,12,1,1,1,173,68,20,10,5051611,6700,5681,5332,Mixed_Race,127,11,1994/11/23,0,0,28766.0,,19172406
161,Thomas Ouwejan,Schalke 04,1996,340.0,nl NED,DF,25.0,10.0,20.0,8.0,13.0,5.0,2.0,6.0,10.0,60.0,4.0,17.0,4.0,13.0,13.0,33.0,27.0,0.0,Matches,340.0,nl NED,DF,25.0,10.0,29.0,2.89,12.0,16.0,0.0,0.0,0.0,1.0,2.0,0.2,0.0,2.0,0.0,0.0,0.0,0.0,Matches,,,,,,,,,,,,,,,,,,,,,,,,,,,,,,,,,,,,,,,,,,,,,,,,,,,,,,,,340.0,nl NED,DF,25.0,10.0,1.0,0.0,0.0,6.0,6.0,1.0,96.0,13.0,8.0,0.0,1.0,0.0,61.0,4.0,13.0,23.5,Matches,340.0,nl NED,DF,25.0,10.0,503.0,332.0,164.0,32.0,0.0,2.0,96.0,91.0,41.0,22.0,18.0,0.0,295.0,7.0,17.0,Matches,340.0,nl NED,DF,25.0,10.0,295.0,503.0,58.6,5638.0,3049.0,118.0,149.0,79.2,135.0,190.0,71.1,36.0,123.0,29.3,1.0,1.2,1.7,-0.2,18.0,21.0,15.0,7.0,41.0,Matches,398,nl NED,DF,25,17,903.0,53.0,29.5,10.0,10,73.0,5,7,25.0,6,0.47,9.0,27.0,-18.0,-1.79,-1.04,9.4,19.4,-10.0,-1.0,-0.69,Matches,340.0,nl NED,DF,25.0,10.0,604.0,32.0,172.0,245.0,196.0,9.0,604.0,5.0,1.0,20.0,4.0,80.0,238.0,1297.0,525.0,14.0,13.0,1.0,9.0,4.0,251.0,21.0,Matches,340.0,nl NED,DF,25.0,10.0,0.0,5.0,1.0,20.0,0.5,0.1,0.0,0.0,25.8,0.0,0.0,0.0,0.1,0.1,0.03,-0.1,-0.1,Matches,340.0,nl NED,DF,25.0,17.0,10.0,903.0,10.0,0.0,1.0,1.0,0.0,0.0,0.0,1.0,0.0,0.1,0.1,1.2,1.4,14.0,41.0,21.0,0.0,0.1,0.1,0.0,0.1,0.01,0.12,0.14,0.01,0.14,Matches,Thomas Ouwejan,D/WB/DM LC,25,130,137,Holland,FC Schalke 04,17,16,11,9,12,15,7,11,15,11,13,7,12,13,11,13,12,12,11,13,12,15,12,8,16,11,12,15,13,12,13,8,16,13,15,11,14,5,13,6,17,1,1,4,3,3,3,3,1,2,3,2,12,15,6,13,14,14,14,16,1,20,10,1,18,1,16,15,15,1,10,8,1,1,181,74,20,8,2956287,6600,6250,5100,Northern_European,121,1,1996/9/30,0,0,19177.0,,37047791
162,Salih Özcan,Dortmund,1998,342.0,tr TUR,MF,24.0,17.5,31.0,18.0,10.0,16.0,5.0,16.0,39.0,41.0,23.0,24.0,2.0,22.0,28.0,59.0,19.0,1.0,Matches,342.0,tr TUR,MF,24.0,17.5,24.0,1.37,21.0,2.0,0.0,0.0,0.0,1.0,1.0,0.06,1.0,0.0,0.0,0.0,0.0,0.0,Matches,,,,,,,,,,,,,,,,,,,,,,,,,,,,,,,,,,,,,,,,,,,,,,,,,,,,,,,,342.0,tr TUR,MF,24.0,17.5,6.0,0.0,0.0,26.0,24.0,0.0,3.0,28.0,18.0,0.0,0.0,0.0,126.0,20.0,19.0,51.3,Matches,342.0,tr TUR,MF,24.0,17.5,999.0,959.0,39.0,31.0,1.0,6.0,3.0,6.0,0.0,0.0,0.0,0.0,882.0,1.0,7.0,Matches,342.0,tr TUR,MF,24.0,17.5,882.0,999.0,88.3,13911.0,3887.0,446.0,489.0,91.2,317.0,357.0,88.8,69.0,91.0,75.8,1.0,0.5,0.5,0.5,9.0,75.0,7.0,1.0,81.0,Matches,400,tr TUR,MF,24,26,1576.0,61.0,51.5,17.5,17,80.0,10,9,24.0,5,2.15,37.0,22.0,15.0,0.86,-0.6,34.2,23.4,10.8,0.61,-0.42,Matches,342.0,tr TUR,MF,24.0,17.5,1171.0,39.0,286.0,773.0,115.0,7.0,1171.0,12.0,6.0,50.0,5.0,41.7,663.0,2578.0,1014.0,6.0,10.0,0.0,18.0,21.0,759.0,23.0,Matches,342.0,tr TUR,MF,24.0,17.5,0.0,3.0,1.0,33.3,0.17,0.06,0.0,0.0,9.3,0.0,0.0,0.0,0.6,0.6,0.19,-0.6,-0.6,Matches,342.0,tr TUR,MF,24.0,26.0,17.0,1576.0,17.5,0.0,1.0,1.0,0.0,0.0,0.0,6.0,0.0,0.6,0.6,0.5,1.1,6.0,81.0,23.0,0.0,0.06,0.06,0.0,0.06,0.03,0.03,0.06,0.03,0.06,Matches,Salih Özcan,DM/M C,24,141,150,"Turkey,Germany",Borussia Dortmund,10,12,13,9,12,11,12,11,6,14,15,12,14,13,17,14,17,13,12,13,14,16,12,13,12,13,14,16,12,12,16,12,16,13,15,15,13,10,15,5,17,1,3,3,2,3,1,1,1,2,1,1,8,16,7,12,13,13,17,14,1,1,1,1,1,1,18,7,20,7,1,10,1,1,182,75,10,20,15221217,7046,7046,5496,Northern_European,139,6,1998/1/11,5,0,76711.0,,91139869
163,Exequiel Palacios,Leverkusen,1998,344.0,ar ARG,MF,23.0,18.4,59.0,36.0,20.0,33.0,6.0,29.0,48.0,60.4,19.0,29.0,2.0,27.0,33.0,92.0,28.0,0.0,Matches,344.0,ar ARG,MF,23.0,18.4,51.0,2.78,44.0,0.0,1.0,1.0,3.0,2.0,5.0,0.27,5.0,0.0,0.0,0.0,0.0,0.0,Matches,,,,,,,,,,,,,,,,,,,,,,,,,,,,,,,,,,,,,,,,,,,,,,,,,,,,,,,,344.0,ar ARG,MF,23.0,18.4,4.0,0.0,0.0,23.0,40.0,1.0,5.0,33.0,36.0,0.0,1.0,0.0,172.0,13.0,14.0,48.1,Matches,344.0,ar ARG,MF,23.0,18.4,1204.0,1152.0,46.0,37.0,4.0,4.0,5.0,7.0,0.0,0.0,0.0,0.0,1022.0,6.0,15.0,Matches,344.0,ar ARG,MF,23.0,18.4,1022.0,1204.0,84.9,15831.0,5084.0,513.0,578.0,88.8,418.0,473.0,88.4,51.0,77.0,66.2,2.0,1.3,1.6,0.7,15.0,95.0,11.0,1.0,105.0,Matches,402,ar ARG,MF,23,25,1654.0,66.0,54.1,18.4,19,78.0,11,6,27.0,1,1.6,32.0,25.0,7.0,0.38,0.32,29.4,20.4,9.0,0.49,0.51,Matches,344.0,ar ARG,MF,23.0,18.4,1430.0,54.0,364.0,861.0,220.0,16.0,1427.0,16.0,10.0,62.5,5.0,31.3,745.0,2951.0,1349.0,12.0,15.0,2.0,19.0,24.0,959.0,27.0,Matches,344.0,ar ARG,MF,23.0,18.4,4.0,17.0,4.0,23.5,0.93,0.22,0.06,0.25,26.3,0.0,3.0,3.0,3.0,0.6,0.04,1.0,0.4,Matches,344.0,ar ARG,MF,23.0,25.0,19.0,1654.0,18.4,4.0,2.0,6.0,1.0,3.0,3.0,4.0,0.0,3.0,0.6,1.3,1.9,12.0,105.0,27.0,0.22,0.11,0.33,0.05,0.16,0.16,0.07,0.23,0.03,0.11,Matches,Exequiel Palacios,DM/M C,23,138,155,Argentina,Bayer 04 Leverkusen,9,11,12,9,14,10,8,11,8,12,15,11,14,15,15,13,16,14,12,15,13,16,11,12,14,11,14,16,12,14,13,9,15,11,14,11,12,12,15,14,13,1,1,1,4,1,3,2,2,3,3,1,10,13,12,11,14,11,8,8,1,1,1,1,1,1,19,1,20,8,1,14,8,1,177,71,12,20,26037416,6900,7000,5750,Native_American,137,11,1998/10/5,20,0,60999.0,,14110846
164,Benjamin Pavard,Bayern Munich,1996,351.0,fr FRA,DF,26.0,27.0,70.0,41.0,36.0,26.0,8.0,36.0,48.0,75.0,12.0,35.0,16.0,19.0,44.0,114.0,83.0,0.0,Matches,351.0,fr FRA,DF,26.0,27.0,45.0,1.67,37.0,0.0,0.0,4.0,0.0,4.0,3.0,0.11,2.0,0.0,0.0,0.0,0.0,1.0,Matches,,,,,,,,,,,,,,,,,,,,,,,,,,,,,,,,,,,,,,,,,,,,,,,,,,,,,,,,351.0,fr FRA,DF,26.0,27.0,6.0,0.0,0.0,28.0,17.0,5.0,45.0,44.0,41.0,0.0,3.0,0.0,153.0,64.0,33.0,66.0,Matches,351.0,fr FRA,DF,26.0,27.0,2400.0,2242.0,152.0,34.0,2.0,16.0,45.0,117.0,0.0,0.0,0.0,0.0,2120.0,6.0,20.0,Matches,351.0,fr FRA,DF,26.0,27.0,2120.0,2400.0,88.3,37520.0,14296.0,867.0,940.0,92.2,1064.0,1162.0,91.6,155.0,231.0,67.1,1.0,2.4,3.9,-1.4,19.0,184.0,21.0,9.0,202.0,Matches,410,fr FRA,DF,26,30,2431.0,81.0,79.4,27.0,27,87.0,24,3,23.0,3,2.3,76.0,29.0,47.0,1.74,0.74,61.6,28.4,33.2,1.23,0.57,Matches,351.0,fr FRA,DF,26.0,27.0,2699.0,166.0,1017.0,1351.0,337.0,47.0,2699.0,6.0,0.0,0.0,1.0,16.7,1660.0,7436.0,4097.0,37.0,21.0,2.0,11.0,2.0,1947.0,65.0,Matches,351.0,fr FRA,DF,26.0,27.0,4.0,34.0,12.0,35.3,1.26,0.44,0.12,0.33,18.3,0.0,0.0,0.0,2.5,2.5,0.07,1.5,1.5,Matches,351.0,fr FRA,DF,26.0,30.0,27.0,2431.0,27.0,4.0,1.0,5.0,4.0,0.0,0.0,6.0,0.0,2.5,2.5,2.4,5.0,37.0,202.0,65.0,0.15,0.04,0.19,0.15,0.19,0.09,0.09,0.18,0.09,0.18,Matches,Benjamin Pavard,D/WB RC,26,152,156,France,FC Bayern München,4,12,11,8,14,6,14,9,12,15,15,7,15,14,11,16,14,17,16,13,15,13,11,8,12,15,17,15,12,12,16,15,15,14,16,12,15,8,16,7,16,2,3,1,3,4,1,4,2,2,1,2,13,15,8,13,15,18,14,17,1,12,20,20,10,16,12,1,10,1,1,1,1,1,186,76,8,20,30739499,7599,7549,7099,Northern_European,151,4,1996/3/28,45,2,134247.0,,85120944
165,Jiří Pavlenka,Werder Bremen,1992,352.0,cz CZE,GK,30.0,32.3,1.0,0.0,1.0,0.0,0.0,1.0,5.0,20.0,4.0,1.0,0.0,1.0,3.0,4.0,21.0,1.0,Matches,352.0,cz CZE,GK,30.0,32.3,3.0,0.09,3.0,0.0,0.0,0.0,0.0,0.0,1.0,0.03,1.0,0.0,0.0,0.0,0.0,0.0,Matches,23.0,cz CZE,GK,30.0,32.3,61.0,2.0,0.0,5.0,2.0,51.9,0.29,-7.1,-0.22,198.0,497.0,39.8,893.0,152.0,40.1,36.3,279.0,49.8,42.9,481.0,22.0,4.6,38.0,1.18,14.9,Matches,23.0,cz CZE,GK,30.0,33.0,33.0,2908.0,32.3,61.0,1.89,170.0,110.0,65.3,10.0,5.0,18.0,4.0,12.1,3.0,2.0,1.0,0.0,33.3,Matches,352.0,cz CZE,GK,30.0,32.3,1.0,0.0,0.0,0.0,7.0,0.0,0.0,3.0,0.0,0.0,0.0,0.0,50.0,8.0,1.0,88.9,Matches,352.0,cz CZE,GK,30.0,32.3,1176.0,780.0,392.0,113.0,0.0,1.0,0.0,0.0,0.0,0.0,0.0,0.0,832.0,4.0,3.0,Matches,352.0,cz CZE,GK,30.0,32.3,832.0,1176.0,70.7,25281.0,18992.0,148.0,150.0,98.7,362.0,367.0,98.6,321.0,651.0,49.3,0.0,0.0,0.1,0.0,0.0,20.0,1.0,0.0,0.0,Matches,411,cz CZE,GK,30,33,2908.0,88.0,95.0,32.3,33,88.0,32,0,,0,1.06,49.0,61.0,-12.0,-0.37,0.22,38.8,49.0,-10.2,-0.32,0.63,Matches,352.0,cz CZE,GK,30.0,32.3,1280.0,1137.0,1275.0,5.0,0.0,0.0,1280.0,1.0,0.0,0.0,1.0,100.0,663.0,3880.0,2157.0,0.0,2.0,2.0,1.0,0.0,521.0,0.0,Matches,352.0,cz CZE,GK,30.0,32.3,0.0,0.0,0.0,,0.0,0.0,,,,0.0,0.0,0.0,0.0,0.0,,0.0,0.0,Matches,352.0,cz CZE,GK,30.0,33.0,33.0,2908.0,32.3,0.0,0.0,0.0,0.0,0.0,0.0,1.0,0.0,0.0,0.0,0.0,0.0,0.0,0.0,0.0,0.0,0.0,0.0,0.0,0.0,0.0,0.0,0.0,0.0,0.0,Matches,Jiří Pavlenka,GK,30,132,160,Czech Republic,SV Werder Bremen,5,2,1,2,8,8,9,3,1,2,9,2,3,8,8,12,15,11,14,7,11,13,1,10,2,8,12,10,12,16,15,15,14,10,10,16,15,6,16,5,14,14,14,12,6,12,9,17,17,13,13,10,14,18,5,12,14,17,15,17,20,1,1,1,1,1,1,1,1,1,1,1,1,1,196,85,7,20,4423499,6591,6991,5741,Northern_European,130,3,1992/4/14,14,0,42281.0,,25039108
166,Amos Pieper,Werder Bremen,1998,366.0,de GER,DF,24.0,21.7,46.0,28.0,25.0,19.0,2.0,24.0,40.0,60.0,16.0,23.0,11.0,12.0,30.0,76.0,94.0,1.0,Matches,366.0,de GER,DF,24.0,21.7,19.0,0.87,17.0,0.0,0.0,1.0,1.0,0.0,2.0,0.09,2.0,0.0,0.0,0.0,0.0,0.0,Matches,,,,,,,,,,,,,,,,,,,,,,,,,,,,,,,,,,,,,,,,,,,,,,,,,,,,,,,,366.0,de GER,DF,24.0,21.7,9.0,0.0,0.0,24.0,15.0,2.0,17.0,30.0,28.0,0.0,1.0,0.0,131.0,68.0,31.0,68.7,Matches,366.0,de GER,DF,24.0,21.7,1206.0,1156.0,43.0,30.0,0.0,10.0,17.0,13.0,0.0,0.0,0.0,0.0,943.0,7.0,6.0,Matches,366.0,de GER,DF,24.0,21.7,943.0,1206.0,78.2,18821.0,6486.0,295.0,351.0,84.0,513.0,589.0,87.1,127.0,224.0,56.7,1.0,0.3,0.9,0.7,5.0,64.0,12.0,5.0,84.0,Matches,430,de GER,DF,24,29,1957.0,67.0,64.0,21.7,22,84.0,15,7,16.0,0,1.07,29.0,39.0,-10.0,-0.46,-0.22,26.4,31.1,-4.7,-0.21,0.37,Matches,366.0,de GER,DF,24.0,21.7,1448.0,125.0,627.0,742.0,83.0,22.0,1448.0,3.0,1.0,33.3,0.0,0.0,751.0,3815.0,1935.0,14.0,12.0,0.0,9.0,8.0,893.0,4.0,Matches,366.0,de GER,DF,24.0,21.7,2.0,11.0,4.0,36.4,0.51,0.18,0.18,0.5,13.0,0.0,0.0,0.0,0.7,0.7,0.07,1.3,1.3,Matches,366.0,de GER,DF,24.0,29.0,22.0,1957.0,21.7,2.0,1.0,3.0,2.0,0.0,0.0,9.0,0.0,0.7,0.7,0.3,1.1,14.0,84.0,4.0,0.09,0.05,0.14,0.09,0.14,0.03,0.02,0.05,0.03,0.05,Matches,Amos Pieper,D C,24,127,137,Germany,SV Werder Bremen,4,6,9,7,11,6,13,7,9,13,12,5,13,11,9,12,13,11,13,11,14,12,5,13,7,12,15,12,12,10,14,16,15,13,15,15,15,7,14,6,13,3,1,2,4,3,2,2,4,2,2,1,9,13,4,12,12,15,13,16,1,1,20,1,1,1,1,1,1,1,1,1,1,1,192,86,10,20,3042181,6240,6240,4490,Northern_European,126,4,1998/1/17,0,0,4999.0,,91173279
167,Marvin Plattenhardt,Hertha BSC,1992,367.0,de GER,DF,30.0,26.7,43.0,33.0,24.0,15.0,4.0,29.0,47.0,61.7,18.0,25.0,11.0,14.0,15.0,58.0,82.0,0.0,Matches,367.0,de GER,DF,30.0,26.7,59.0,2.21,25.0,30.0,1.0,0.0,3.0,0.0,6.0,0.22,3.0,1.0,1.0,0.0,1.0,0.0,Matches,,,,,,,,,,,,,,,,,,,,,,,,,,,,,,,,,,,,,,,,,,,,,,,,,,,,,,,,367.0,de GER,DF,30.0,26.7,3.0,0.0,0.0,21.0,31.0,1.0,156.0,15.0,33.0,1.0,0.0,0.0,117.0,19.0,17.0,52.8,Matches,367.0,de GER,DF,30.0,26.7,1208.0,801.0,403.0,81.0,0.0,9.0,156.0,262.0,60.0,19.0,33.0,0.0,794.0,4.0,26.0,Matches,367.0,de GER,DF,30.0,26.7,794.0,1208.0,65.7,13900.0,7002.0,385.0,431.0,89.3,306.0,457.0,67.0,88.0,258.0,34.1,2.0,3.0,3.9,-1.0,30.0,38.0,8.0,6.0,84.0,Matches,431,de GER,DF,30,31,2402.0,77.0,78.5,26.7,29,81.0,22,2,25.0,1,0.9,34.0,58.0,-24.0,-0.9,-0.49,29.5,47.3,-17.8,-0.67,-0.3,Matches,367.0,de GER,DF,30.0,26.7,1445.0,94.0,450.0,649.0,356.0,7.0,1445.0,18.0,3.0,16.7,10.0,55.6,557.0,2212.0,1123.0,24.0,21.0,5.0,16.0,6.0,621.0,52.0,Matches,367.0,de GER,DF,30.0,26.7,0.0,8.0,1.0,12.5,0.3,0.04,0.0,0.0,27.3,4.0,0.0,0.0,0.3,0.3,0.04,-0.3,-0.3,Matches,367.0,de GER,DF,30.0,31.0,29.0,2402.0,26.7,0.0,2.0,2.0,0.0,0.0,0.0,3.0,0.0,0.3,0.3,3.0,3.3,24.0,84.0,52.0,0.0,0.07,0.07,0.0,0.07,0.01,0.11,0.12,0.01,0.12,Matches,Marvin Plattenhardt,D/WB L,30,128,139,Germany,Hertha Berlin,15,17,12,8,14,17,8,11,16,10,13,10,12,15,10,11,12,13,13,14,13,13,10,12,12,11,16,13,13,12,14,9,10,12,13,12,13,7,12,8,9,2,3,3,3,1,2,4,4,3,1,1,8,13,6,11,11,14,16,14,1,20,1,10,20,10,1,13,1,1,10,1,1,1,181,78,20,7,3230542,6497,6497,5497,Northern_European,125,6,1992/1/26,7,0,28747.0,,92021287
168,Alassane Pléa,Gladbach,1993,368.0,fr FRA,FW,29.0,19.7,16.0,8.0,5.0,7.0,4.0,8.0,26.0,30.8,18.0,23.0,3.0,20.0,12.0,28.0,14.0,0.0,Matches,368.0,fr FRA,FW,29.0,19.7,67.0,3.4,56.0,2.0,2.0,3.0,3.0,1.0,12.0,0.61,11.0,0.0,1.0,0.0,0.0,0.0,Matches,,,,,,,,,,,,,,,,,,,,,,,,,,,,,,,,,,,,,,,,,,,,,,,,,,,,,,,,368.0,fr FRA,FW,29.0,19.7,5.0,0.0,0.0,24.0,32.0,4.0,48.0,12.0,8.0,0.0,1.0,0.0,88.0,14.0,29.0,32.6,Matches,368.0,fr FRA,FW,29.0,19.7,763.0,730.0,30.0,9.0,14.0,4.0,48.0,11.0,2.0,2.0,0.0,0.0,529.0,3.0,41.0,Matches,368.0,fr FRA,FW,29.0,19.7,529.0,763.0,69.3,8211.0,2867.0,295.0,355.0,83.1,153.0,219.0,69.9,47.0,92.0,51.1,9.0,4.0,5.3,5.0,32.0,72.0,34.0,7.0,94.0,Matches,432,fr FRA,FW,29,29,1774.0,61.0,58.0,19.7,20,80.0,6,9,20.0,1,1.24,27.0,27.0,0.0,0.0,0.21,28.7,25.1,3.6,0.18,0.53,Matches,368.0,fr FRA,FW,29.0,19.7,947.0,18.0,94.0,462.0,400.0,57.0,945.0,31.0,16.0,51.6,13.0,41.9,568.0,2803.0,1321.0,41.0,32.0,13.0,39.0,22.0,727.0,156.0,Matches,368.0,fr FRA,FW,29.0,19.7,2.0,27.0,11.0,40.7,1.37,0.56,0.04,0.09,18.6,1.0,1.0,2.0,5.0,3.4,0.13,-3.0,-2.4,Matches,368.0,fr FRA,FW,29.0,29.0,20.0,1774.0,19.7,2.0,9.0,11.0,1.0,1.0,2.0,5.0,0.0,5.0,3.4,4.0,7.4,41.0,94.0,156.0,0.1,0.46,0.56,0.05,0.51,0.25,0.2,0.46,0.17,0.38,Matches,Alassane Pléa,AM/S L,29,138,147,"France,Mali",Borussia Mönchengladbach,5,12,13,14,15,11,13,15,4,6,14,13,6,16,15,16,11,13,11,16,14,12,13,6,15,6,11,10,13,12,15,11,13,14,13,13,13,6,14,11,13,3,4,2,1,2,3,1,4,3,2,2,8,12,8,12,10,10,10,10,1,1,1,1,1,1,1,12,1,10,18,13,14,20,181,79,11,20,10312365,6893,6843,5893,African_Caribbean,137,15,1993/3/10,1,0,67122.0,,85050636
169,Grischa Prömel,Hoffenheim,1995,373.0,de GER,MF,27.0,16.2,27.0,19.0,14.0,11.0,2.0,9.0,25.0,36.0,16.0,22.0,4.0,18.0,8.0,35.0,23.0,0.0,Matches,373.0,de GER,MF,27.0,16.2,20.0,1.24,12.0,1.0,0.0,2.0,3.0,2.0,1.0,0.06,1.0,0.0,0.0,0.0,0.0,0.0,Matches,,,,,,,,,,,,,,,,,,,,,,,,,,,,,,,,,,,,,,,,,,,,,,,,,,,,,,,,373.0,de GER,MF,27.0,16.2,4.0,0.0,0.0,32.0,36.0,2.0,6.0,8.0,19.0,0.0,0.0,0.0,83.0,21.0,29.0,42.0,Matches,373.0,de GER,MF,27.0,16.2,473.0,454.0,14.0,7.0,0.0,0.0,6.0,4.0,0.0,0.0,0.0,0.0,363.0,5.0,12.0,Matches,373.0,de GER,MF,27.0,16.2,363.0,473.0,76.7,5687.0,1378.0,201.0,242.0,83.1,128.0,154.0,83.1,25.0,45.0,55.6,1.0,1.1,0.8,-0.1,8.0,29.0,5.0,1.0,39.0,Matches,437,de GER,MF,27,18,1454.0,81.0,47.5,16.2,17,84.0,12,1,30.0,0,1.39,26.0,20.0,6.0,0.37,1.21,26.3,23.8,2.5,0.15,0.47,Matches,373.0,de GER,MF,27.0,16.2,652.0,35.0,159.0,327.0,170.0,39.0,652.0,14.0,5.0,35.7,6.0,42.9,329.0,1568.0,674.0,19.0,12.0,6.0,24.0,13.0,402.0,46.0,Matches,373.0,de GER,MF,27.0,16.2,1.0,24.0,5.0,20.8,1.49,0.31,0.04,0.2,16.2,0.0,0.0,0.0,2.5,2.5,0.11,-1.5,-1.5,Matches,373.0,de GER,MF,27.0,18.0,17.0,1454.0,16.2,1.0,1.0,2.0,1.0,0.0,0.0,4.0,0.0,2.5,2.5,1.1,3.6,19.0,39.0,46.0,0.06,0.06,0.12,0.06,0.12,0.16,0.07,0.22,0.16,0.22,Matches,Grischa Prömel,DM/M C,27,138,141,Germany,TSG Hoffenheim,6,9,12,9,12,6,12,11,10,13,12,9,13,11,16,14,17,11,16,11,13,16,7,13,11,15,16,18,12,12,13,13,17,13,19,13,16,13,15,10,14,2,2,2,4,1,2,2,1,3,3,4,9,15,6,12,14,14,12,16,1,1,1,14,1,12,20,1,20,1,1,8,1,1,184,78,10,20,10852795,6898,6898,5248,Northern_European,136,4,1995/1/9,0,0,12499.0,,91144397
170,David Raum,RB Leipzig,1998,379.0,de GER,DFMF,24.0,18.7,39.0,25.0,23.0,12.0,4.0,17.0,29.0,58.6,12.0,24.0,6.0,18.0,16.0,55.0,26.0,1.0,Matches,379.0,de GER,DFMF,24.0,18.7,57.0,3.04,28.0,22.0,3.0,3.0,1.0,0.0,3.0,0.16,2.0,1.0,0.0,0.0,0.0,0.0,Matches,,,,,,,,,,,,,,,,,,,,,,,,,,,,,,,,,,,,,,,,,,,,,,,,,,,,,,,,379.0,de GER,DFMF,24.0,18.7,5.0,0.0,0.0,21.0,14.0,2.0,141.0,16.0,25.0,0.0,2.0,0.0,113.0,16.0,12.0,57.1,Matches,379.0,de GER,DFMF,24.0,18.7,1189.0,937.0,248.0,22.0,3.0,4.0,141.0,170.0,56.0,16.0,31.0,0.0,898.0,4.0,40.0,Matches,379.0,de GER,DFMF,24.0,18.7,898.0,1189.0,75.5,15022.0,4628.0,454.0,503.0,90.3,347.0,436.0,79.6,79.0,178.0,44.4,2.0,4.6,5.0,-2.6,36.0,42.0,26.0,15.0,69.0,Matches,443,de GER,DFMF,24,28,1685.0,60.0,55.1,18.7,19,81.0,9,9,17.0,5,1.89,37.0,21.0,16.0,0.85,0.4,33.9,20.9,13.0,0.69,-0.12,Matches,379.0,de GER,DFMF,24.0,18.7,1367.0,41.0,365.0,547.0,471.0,34.0,1367.0,34.0,8.0,23.5,21.0,61.8,721.0,3092.0,1564.0,44.0,23.0,10.0,17.0,9.0,817.0,127.0,Matches,379.0,de GER,DFMF,24.0,18.7,0.0,14.0,5.0,35.7,0.75,0.27,0.0,0.0,23.1,0.0,0.0,0.0,0.6,0.6,0.04,-0.6,-0.6,Matches,379.0,de GER,DFMF,24.0,28.0,19.0,1685.0,18.7,0.0,2.0,2.0,0.0,0.0,0.0,5.0,0.0,0.6,0.6,4.6,5.2,44.0,69.0,127.0,0.0,0.11,0.11,0.0,0.11,0.03,0.25,0.28,0.03,0.28,Matches,David Raum,D/WB/M L,24,143,150,Germany,RB Leipzig,15,16,12,11,11,13,7,11,15,11,13,9,11,11,15,13,13,12,13,13,14,16,13,10,15,11,16,17,15,13,12,9,17,15,16,12,13,10,15,4,12,1,1,4,2,1,2,2,3,1,4,1,6,14,10,13,14,14,8,10,1,20,1,10,19,10,1,17,1,10,13,1,10,1,180,75,20,8,51689341,7150,7150,6000,Northern_European,135,3,1998/4/22,9,0,71917.0,,91175517
171,Marco Reus,Dortmund,1989,381.0,de GER,MFFW,33.0,15.0,30.0,17.0,12.0,14.0,4.0,7.0,24.0,29.2,17.0,12.0,4.0,8.0,8.0,38.0,8.0,0.0,Matches,381.0,de GER,MFFW,33.0,15.0,52.0,3.46,36.0,4.0,1.0,9.0,2.0,0.0,7.0,0.47,3.0,1.0,0.0,2.0,1.0,0.0,Matches,,,,,,,,,,,,,,,,,,,,,,,,,,,,,,,,,,,,,,,,,,,,,,,,,,,,,,,,381.0,de GER,MFFW,33.0,15.0,4.0,0.0,0.0,18.0,18.0,3.0,19.0,8.0,17.0,1.0,0.0,0.0,52.0,12.0,21.0,36.4,Matches,381.0,de GER,MFFW,33.0,15.0,568.0,525.0,42.0,19.0,0.0,1.0,19.0,3.0,6.0,1.0,0.0,0.0,450.0,1.0,21.0,Matches,381.0,de GER,MFFW,33.0,15.0,450.0,568.0,79.2,5844.0,1398.0,259.0,309.0,83.8,148.0,170.0,87.1,9.0,24.0,37.5,4.0,2.6,1.4,1.4,20.0,27.0,9.0,1.0,45.0,Matches,446,de GER,MFFW,33,25,1353.0,54.0,44.2,15.0,14,77.0,5,11,25.0,0,2.28,32.0,19.0,13.0,0.86,-0.51,29.4,17.1,12.4,0.82,0.0,Matches,381.0,de GER,MFFW,33.0,15.0,731.0,15.0,106.0,329.0,308.0,61.0,730.0,25.0,9.0,36.0,13.0,52.0,426.0,2098.0,1006.0,33.0,25.0,11.0,29.0,16.0,510.0,78.0,Matches,381.0,de GER,MFFW,33.0,15.0,6.0,36.0,10.0,27.8,2.39,0.67,0.14,0.5,16.6,6.0,1.0,1.0,5.1,4.3,0.12,0.9,0.7,Matches,381.0,de GER,MFFW,33.0,25.0,14.0,1353.0,15.0,6.0,4.0,10.0,5.0,1.0,1.0,4.0,0.0,5.1,4.3,2.6,6.9,33.0,45.0,78.0,0.4,0.27,0.67,0.33,0.6,0.34,0.17,0.51,0.29,0.46,Matches,Marco Reus,AM RLC,33,159,170,Germany,Borussia Dortmund,15,13,13,16,16,16,6,15,7,6,15,15,9,16,15,15,12,16,15,14,15,18,13,13,18,10,14,15,14,12,14,8,12,13,13,9,17,4,17,19,16,1,2,1,2,2,1,2,1,3,3,2,9,16,9,18,17,17,10,10,1,1,1,1,1,1,1,13,8,10,20,20,15,15,180,71,14,20,33067483,8000,8000,7500,Northern_European,154,2,1989/5/31,48,15,191780.0,,91013383
172,Marco Richter,Hertha BSC,1997,384.0,de GER,MFFW,24.0,20.4,43.0,23.0,18.0,17.0,8.0,19.0,48.0,39.6,29.0,29.0,2.0,27.0,24.0,67.0,25.0,0.0,Matches,384.0,de GER,MFFW,24.0,20.4,58.0,2.84,37.0,7.0,5.0,7.0,1.0,1.0,11.0,0.54,8.0,1.0,0.0,1.0,1.0,0.0,Matches,,,,,,,,,,,,,,,,,,,,,,,,,,,,,,,,,,,,,,,,,,,,,,,,,,,,,,,,384.0,de GER,MFFW,24.0,20.4,8.0,0.0,0.0,36.0,33.0,6.0,82.0,24.0,23.0,0.0,0.0,0.0,161.0,12.0,31.0,27.9,Matches,384.0,de GER,MFFW,24.0,20.4,747.0,609.0,134.0,18.0,1.0,9.0,82.0,80.0,28.0,4.0,21.0,0.0,461.0,4.0,33.0,Matches,384.0,de GER,MFFW,24.0,20.4,461.0,747.0,61.7,8175.0,3008.0,206.0,264.0,78.0,170.0,260.0,65.4,62.0,149.0,41.6,5.0,2.9,2.7,2.1,20.0,38.0,26.0,5.0,68.0,Matches,449,de GER,MFFW,24,29,1836.0,63.0,60.0,20.4,21,78.0,7,8,26.0,1,0.93,30.0,51.0,-21.0,-1.03,-0.59,24.7,38.7,-14.0,-0.69,-0.21,Matches,384.0,de GER,MFFW,24.0,20.4,1074.0,31.0,202.0,482.0,412.0,44.0,1074.0,88.0,36.0,40.9,43.0,48.9,541.0,2789.0,1173.0,38.0,28.0,8.0,57.0,34.0,553.0,102.0,Matches,384.0,de GER,MFFW,24.0,20.4,6.0,49.0,15.0,30.6,2.4,0.74,0.12,0.4,22.3,4.0,0.0,0.0,3.7,3.7,0.08,2.3,2.3,Matches,384.0,de GER,MFFW,24.0,29.0,21.0,1836.0,20.4,6.0,5.0,11.0,6.0,0.0,0.0,8.0,0.0,3.7,3.7,2.9,6.6,38.0,68.0,102.0,0.29,0.25,0.54,0.29,0.54,0.18,0.14,0.32,0.18,0.32,Matches,Marco Richter,M/AM/S RL,24,132,140,Germany,Hertha Berlin,8,11,14,13,13,12,13,14,5,6,11,11,8,13,14,11,12,11,9,12,9,13,15,6,13,7,10,15,14,14,12,8,12,14,14,12,10,6,13,5,15,2,1,3,1,1,2,2,3,1,1,1,12,11,9,13,16,12,12,12,1,1,1,1,1,1,1,15,1,18,15,12,20,18,176,74,13,20,7298737,6500,6500,4750,Northern_European,125,5,1997/11/24,0,0,14999.0,,91155514
173,Manuel Riemann,Bochum,1988,385.0,de GER,GK,33.0,34.0,3.0,2.0,3.0,0.0,0.0,3.0,5.0,60.0,2.0,1.0,0.0,1.0,5.0,8.0,23.0,7.0,Matches,385.0,de GER,GK,33.0,34.0,21.0,0.62,17.0,4.0,0.0,0.0,0.0,0.0,0.0,0.0,0.0,0.0,0.0,0.0,0.0,0.0,Matches,25.0,de GER,GK,33.0,34.0,72.0,8.0,2.0,9.0,3.0,69.0,0.3,0.0,0.0,554.0,1175.0,47.1,1489.0,83.0,66.8,44.7,261.0,69.0,50.6,536.0,31.0,5.8,121.0,3.56,22.2,Matches,25.0,de GER,GK,33.0,34.0,34.0,3060.0,34.0,72.0,2.12,200.0,128.0,68.0,10.0,5.0,19.0,5.0,14.7,14.0,8.0,3.0,3.0,27.3,Matches,385.0,de GER,GK,33.0,34.0,3.0,0.0,0.0,1.0,4.0,0.0,1.0,5.0,2.0,0.0,1.0,1.0,105.0,11.0,3.0,78.6,Matches,385.0,de GER,GK,33.0,34.0,1761.0,1297.0,453.0,191.0,0.0,21.0,1.0,1.0,0.0,0.0,0.0,0.0,1065.0,11.0,3.0,Matches,385.0,de GER,GK,33.0,34.0,1065.0,1761.0,60.5,41782.0,36334.0,86.0,87.0,98.9,302.0,312.0,96.8,677.0,1348.0,50.2,0.0,0.1,0.8,-0.1,2.0,136.0,7.0,1.0,18.0,Matches,450,de GER,GK,33,34,3060.0,90.0,100.0,34.0,34,90.0,34,0,,0,1.03,40.0,72.0,-32.0,-0.94,,40.0,65.7,-25.7,-0.76,,Matches,385.0,de GER,GK,33.0,34.0,1879.0,1193.0,1736.0,148.0,1.0,1.0,1879.0,0.0,0.0,,0.0,,1072.0,5772.0,3752.0,1.0,0.0,0.0,1.0,0.0,887.0,0.0,Matches,385.0,de GER,GK,33.0,34.0,0.0,1.0,0.0,0.0,0.03,0.0,0.0,,11.5,0.0,0.0,0.0,0.0,0.0,0.04,0.0,0.0,Matches,385.0,de GER,GK,33.0,34.0,34.0,3060.0,34.0,0.0,0.0,0.0,0.0,0.0,0.0,3.0,0.0,0.0,0.0,0.1,0.1,1.0,18.0,0.0,0.0,0.0,0.0,0.0,0.0,0.0,0.0,0.0,0.0,0.0,Matches,Manuel Riemann,GK,33,130,130,Germany,VfL Bochum 1848,2,2,2,2,11,6,5,2,3,3,12,12,3,12,16,14,13,16,12,10,12,18,10,16,1,13,13,13,11,13,14,14,17,11,11,12,18,13,16,7,14,13,13,15,15,12,12,14,15,18,8,11,10,17,13,12,15,17,10,7,20,1,1,1,1,1,1,1,1,1,1,1,1,1,186,83,5,20,347975206,6500,6500,4500,Northern_European,130,5,1988/9/9,0,0,16781.0,,35014447
174,Sebastian Rode,Eint Frankfurt,1990,386.0,de GER,MF,31.0,15.7,38.0,24.0,7.0,28.0,3.0,14.0,45.0,31.1,31.0,18.0,2.0,16.0,16.0,54.0,12.0,0.0,Matches,386.0,de GER,MF,31.0,15.7,32.0,2.04,29.0,0.0,0.0,1.0,2.0,0.0,2.0,0.13,2.0,0.0,0.0,0.0,0.0,0.0,Matches,,,,,,,,,,,,,,,,,,,,,,,,,,,,,,,,,,,,,,,,,,,,,,,,,,,,,,,,386.0,de GER,MF,31.0,15.7,6.0,0.0,0.0,22.0,18.0,0.0,8.0,16.0,24.0,0.0,0.0,0.0,108.0,12.0,10.0,54.5,Matches,386.0,de GER,MF,31.0,15.7,857.0,828.0,24.0,17.0,4.0,1.0,8.0,2.0,0.0,0.0,0.0,0.0,711.0,5.0,14.0,Matches,386.0,de GER,MF,31.0,15.7,711.0,857.0,83.0,11453.0,3658.0,346.0,392.0,88.3,293.0,339.0,86.4,51.0,78.0,65.4,1.0,0.9,1.3,0.1,12.0,98.0,12.0,0.0,105.0,Matches,452,de GER,MF,31,27,1414.0,52.0,46.2,15.7,19,64.0,1,8,24.0,1,1.48,27.0,29.0,-2.0,-0.13,-0.56,20.9,19.9,1.0,0.06,-0.36,Matches,386.0,de GER,MF,31.0,15.7,997.0,29.0,164.0,661.0,178.0,21.0,997.0,14.0,7.0,50.0,4.0,28.6,529.0,2380.0,1321.0,23.0,16.0,3.0,12.0,6.0,688.0,39.0,Matches,386.0,de GER,MF,31.0,15.7,4.0,9.0,4.0,44.4,0.57,0.25,0.44,1.0,18.7,0.0,0.0,0.0,0.9,0.9,0.1,3.1,3.1,Matches,386.0,de GER,MF,31.0,27.0,19.0,1414.0,15.7,4.0,1.0,5.0,4.0,0.0,0.0,6.0,0.0,0.9,0.9,0.9,1.8,23.0,105.0,39.0,0.25,0.06,0.32,0.25,0.32,0.06,0.06,0.11,0.06,0.11,Matches,Sebastian Rode,DM/M C,31,132,140,Germany,Eintracht Frankfurt,10,11,13,8,12,7,10,8,10,12,13,7,16,12,18,15,16,12,14,10,12,17,8,14,11,12,16,17,13,13,16,9,14,12,14,12,15,12,14,17,16,1,2,2,2,3,3,3,2,1,2,1,10,17,9,8,13,16,12,12,1,1,1,13,1,13,18,8,20,12,8,10,12,1,180,71,10,20,347975206,6600,6600,4700,Northern_European,124,1,1990/10/11,0,0,38462.0,,35023651
175,Agustín Rogel,Hertha BSC,1997,387.0,uy URU,DF,24.0,15.8,18.0,9.0,13.0,5.0,0.0,11.0,17.0,64.7,6.0,15.0,8.0,7.0,11.0,29.0,74.0,1.0,Matches,387.0,uy URU,DF,24.0,15.8,7.0,0.44,5.0,1.0,0.0,0.0,1.0,0.0,1.0,0.06,0.0,1.0,0.0,0.0,0.0,0.0,Matches,,,,,,,,,,,,,,,,,,,,,,,,,,,,,,,,,,,,,,,,,,,,,,,,,,,,,,,,387.0,uy URU,DF,24.0,15.8,7.0,0.0,0.0,21.0,6.0,1.0,0.0,11.0,9.0,0.0,0.0,0.0,62.0,49.0,35.0,58.3,Matches,387.0,uy URU,DF,24.0,15.8,572.0,538.0,31.0,29.0,0.0,6.0,0.0,2.0,0.0,0.0,0.0,0.0,426.0,3.0,7.0,Matches,387.0,uy URU,DF,24.0,15.8,426.0,572.0,74.5,8612.0,3341.0,117.0,155.0,75.5,251.0,298.0,84.2,51.0,100.0,51.0,1.0,0.0,0.1,1.0,1.0,11.0,0.0,0.0,23.0,Matches,453,uy URU,DF,24,20,1426.0,71.0,46.6,15.8,14,87.0,13,6,35.0,4,0.8,21.0,36.0,-15.0,-0.95,-0.29,16.7,30.1,-13.4,-0.84,-0.45,Matches,387.0,uy URU,DF,24.0,15.8,726.0,110.0,434.0,275.0,20.0,11.0,726.0,0.0,0.0,,0.0,,305.0,1300.0,668.0,1.0,1.0,0.0,12.0,0.0,349.0,2.0,Matches,387.0,uy URU,DF,24.0,15.8,0.0,5.0,0.0,0.0,0.32,0.0,0.0,,7.6,0.0,0.0,0.0,0.8,0.8,0.16,-0.8,-0.8,Matches,387.0,uy URU,DF,24.0,20.0,14.0,1426.0,15.8,0.0,1.0,1.0,0.0,0.0,0.0,7.0,0.0,0.8,0.8,0.0,0.8,1.0,23.0,2.0,0.0,0.06,0.06,0.0,0.06,0.05,0.0,0.05,0.05,0.05,Matches,Agustín Rogel,D C,24,126,134,Uruguay,Hertha Berlin,4,8,9,7,9,2,15,6,5,14,10,3,15,9,13,14,15,10,12,8,12,12,4,12,8,14,13,13,10,9,14,14,13,11,13,16,13,8,4,13,15,1,1,2,3,1,2,3,1,1,4,2,14,12,7,11,12,13,12,14,1,1,20,1,1,1,1,1,1,1,1,1,1,1,190,84,8,20,2522694,6250,6250,4500,Mediterranean_Hispanic,118,4,1997/10/17,1,0,17795.0,,78078857
176,Jérôme Roussillon,Union Berlin,1993,392.0,fr FRA,DF,29.0,10.6,16.0,9.0,6.0,8.0,2.0,8.0,12.0,66.7,4.0,7.0,2.0,5.0,4.0,20.0,22.0,0.0,Matches,392.0,fr FRA,DF,29.0,10.6,22.0,2.07,16.0,1.0,4.0,0.0,1.0,0.0,4.0,0.38,3.0,0.0,0.0,0.0,1.0,0.0,Matches,,,,,,,,,,,,,,,,,,,,,,,,,,,,,,,,,,,,,,,,,,,,,,,,,,,,,,,,392.0,fr FRA,DF,29.0,10.6,2.0,0.0,0.0,12.0,13.0,0.0,36.0,4.0,9.0,0.0,0.0,0.0,54.0,6.0,11.0,35.3,Matches,392.0,fr FRA,DF,29.0,10.6,438.0,332.0,102.0,4.0,2.0,0.0,36.0,98.0,0.0,0.0,0.0,0.0,307.0,4.0,14.0,Matches,392.0,fr FRA,DF,29.0,10.6,307.0,438.0,70.1,4732.0,2037.0,177.0,217.0,81.6,106.0,143.0,74.1,19.0,54.0,35.2,2.0,1.1,1.5,0.9,6.0,19.0,9.0,5.0,28.0,Matches,458,fr FRA,DF,29,16,957.0,60.0,31.3,10.6,11,81.0,1,5,14.0,0,1.94,16.0,13.0,3.0,0.28,-0.15,13.7,16.0,-2.3,-0.22,-0.12,Matches,392.0,fr FRA,DF,29.0,10.6,551.0,26.0,142.0,222.0,193.0,13.0,551.0,28.0,11.0,39.3,14.0,50.0,250.0,1206.0,551.0,18.0,11.0,4.0,12.0,8.0,271.0,42.0,Matches,392.0,fr FRA,DF,29.0,10.6,0.0,9.0,2.0,22.2,0.85,0.19,0.0,0.0,22.1,0.0,0.0,0.0,0.5,0.5,0.06,-0.5,-0.5,Matches,392.0,fr FRA,DF,29.0,16.0,11.0,957.0,10.6,0.0,2.0,2.0,0.0,0.0,0.0,2.0,0.0,0.5,0.5,1.1,1.7,18.0,28.0,42.0,0.0,0.19,0.19,0.0,0.19,0.05,0.11,0.16,0.05,0.16,Matches,Jérôme Roussillon,D/WB L,29,128,140,"France,Guadeloupe",VfL Wolfsburg,6,13,13,9,11,6,8,10,12,11,12,7,12,12,13,12,14,11,10,11,10,13,13,8,14,11,12,12,16,12,14,7,14,16,14,13,11,10,14,10,9,1,2,4,3,2,1,3,3,2,1,2,11,13,10,12,12,13,15,15,1,20,1,12,18,10,1,12,1,10,12,1,1,1,175,80,20,11,2419346,6400,6650,5500,African_Caribbean,118,17,1993/1/6,0,0,72876.0,,85057004
177,Georginio Rutter,Hoffenheim,2002,394.0,fr FRA,FW,20.0,11.2,7.0,4.0,1.0,4.0,2.0,1.0,3.0,33.3,2.0,10.0,2.0,8.0,5.0,12.0,6.0,0.0,Matches,394.0,fr FRA,FW,20.0,11.2,37.0,3.3,22.0,0.0,9.0,2.0,4.0,0.0,4.0,0.36,2.0,0.0,2.0,0.0,0.0,0.0,Matches,,,,,,,,,,,,,,,,,,,,,,,,,,,,,,,,,,,,,,,,,,,,,,,,,,,,,,,,394.0,fr FRA,FW,20.0,11.2,2.0,0.0,0.0,17.0,19.0,17.0,11.0,5.0,4.0,1.0,0.0,0.0,25.0,9.0,23.0,28.1,Matches,394.0,fr FRA,FW,20.0,11.2,158.0,157.0,1.0,0.0,1.0,2.0,11.0,0.0,0.0,0.0,0.0,0.0,95.0,0.0,12.0,Matches,394.0,fr FRA,FW,20.0,11.2,95.0,158.0,60.1,1532.0,455.0,49.0,73.0,67.1,31.0,52.0,59.6,10.0,12.0,83.3,2.0,2.3,3.2,-0.3,10.0,11.0,9.0,0.0,25.0,Matches,460,fr FRA,FW,20,15,1009.0,67.0,33.0,11.2,11,83.0,4,4,25.0,0,1.2,17.0,15.0,2.0,0.18,0.66,16.4,16.1,0.3,0.03,0.18,Matches,394.0,fr FRA,FW,20.0,11.2,338.0,9.0,27.0,98.0,219.0,67.0,338.0,71.0,34.0,47.9,34.0,47.9,235.0,1541.0,723.0,32.0,11.0,24.0,46.0,25.0,260.0,75.0,Matches,394.0,fr FRA,FW,20.0,11.2,2.0,27.0,14.0,51.9,2.41,1.25,0.07,0.14,15.7,0.0,0.0,0.0,3.0,3.0,0.11,-1.0,-1.0,Matches,394.0,fr FRA,FW,20.0,15.0,11.0,1009.0,11.2,2.0,2.0,4.0,2.0,0.0,0.0,2.0,0.0,3.0,3.0,2.3,5.4,32.0,25.0,75.0,0.18,0.18,0.36,0.18,0.36,0.27,0.21,0.48,0.27,0.48,Matches,Georginio Rutter,AM/S R,20,131,160,"France,Martinique",TSG Hoffenheim,8,9,15,12,13,7,12,12,6,6,12,12,6,15,8,11,12,12,10,12,10,11,16,7,12,6,11,11,15,14,11,11,13,15,12,12,11,7,9,7,13,1,3,3,2,3,2,2,4,1,2,2,18,13,7,14,10,12,10,14,1,1,1,1,1,1,1,1,1,1,12,10,17,20,182,77,20,17,26400001,6550,5364,5197,African_Caribbean,128,13,2002/4/20,0,0,16781.0,,49048380
178,Julian Ryerson,Union Berlin,1997,395.0,no NOR,DF,24.0,11.5,28.0,17.0,17.0,10.0,1.0,15.0,25.0,60.0,10.0,15.0,3.0,12.0,12.0,40.0,19.0,0.0,Matches,395.0,no NOR,DF,24.0,11.5,27.0,2.34,18.0,1.0,5.0,2.0,1.0,0.0,0.0,0.0,0.0,0.0,0.0,0.0,0.0,0.0,Matches,,,,,,,,,,,,,,,,,,,,,,,,,,,,,,,,,,,,,,,,,,,,,,,,,,,,,,,,395.0,no NOR,DF,24.0,11.5,2.0,0.0,0.0,16.0,12.0,1.0,41.0,12.0,17.0,0.0,0.0,0.0,77.0,5.0,11.0,31.3,Matches,395.0,no NOR,DF,24.0,11.5,501.0,374.0,125.0,4.0,1.0,4.0,41.0,119.0,2.0,0.0,2.0,0.0,350.0,2.0,16.0,Matches,395.0,no NOR,DF,24.0,11.5,350.0,501.0,69.9,5692.0,2097.0,183.0,215.0,85.1,121.0,167.0,72.5,33.0,81.0,40.7,0.0,0.5,1.7,-0.5,8.0,22.0,12.0,8.0,32.0,Matches,461,no NOR,DF,24,13,1037.0,80.0,33.9,11.5,12,84.0,7,1,29.0,1,1.85,21.0,15.0,6.0,0.52,0.21,11.5,13.0,-1.5,-0.13,0.01,Matches,395.0,no NOR,DF,24.0,11.5,627.0,29.0,176.0,246.0,215.0,12.0,627.0,38.0,18.0,47.4,15.0,39.5,292.0,1652.0,690.0,20.0,16.0,4.0,11.0,14.0,293.0,32.0,Matches,395.0,no NOR,DF,24.0,11.5,0.0,16.0,5.0,31.3,1.39,0.43,0.0,0.0,24.0,0.0,0.0,0.0,0.7,0.7,0.04,-0.7,-0.7,Matches,395.0,no NOR,DF,24.0,13.0,12.0,1037.0,11.5,0.0,0.0,0.0,0.0,0.0,0.0,2.0,0.0,0.7,0.7,0.5,1.2,20.0,32.0,32.0,0.0,0.0,0.0,0.0,0.0,0.06,0.04,0.1,0.06,0.1,Matches,Julian Ryerson,D/WB RC,24,134,137,Norway,1. FC Union Berlin,7,12,13,9,12,6,11,9,12,13,12,9,14,13,15,12,15,13,12,10,12,15,12,12,12,13,17,14,13,13,15,10,15,13,16,13,13,8,15,5,18,3,1,2,2,1,4,3,2,3,1,2,10,14,8,10,12,12,14,11,1,10,1,20,10,20,15,10,15,14,1,1,10,1,183,81,7,20,2769143,6399,6499,4999,Northern_European,128,3,1997/11/17,11,0,10000.0,,53113114
179,Frederik Rønnow,Union Berlin,1992,397.0,dk DEN,GK,29.0,29.0,0.0,0.0,0.0,0.0,0.0,0.0,5.0,0.0,5.0,0.0,0.0,0.0,0.0,0.0,9.0,1.0,Matches,397.0,dk DEN,GK,29.0,29.0,7.0,0.24,7.0,0.0,0.0,0.0,0.0,0.0,1.0,0.03,1.0,0.0,0.0,0.0,0.0,0.0,Matches,26.0,dk DEN,GK,29.0,29.0,27.0,5.0,0.0,5.0,0.0,35.2,0.26,8.2,0.28,240.0,605.0,39.7,1115.0,109.0,44.6,36.5,163.0,66.3,49.4,434.0,43.0,9.9,29.0,1.0,13.5,Matches,26.0,dk DEN,GK,29.0,29.0,29.0,2610.0,29.0,27.0,0.93,119.0,92.0,81.5,16.0,7.0,6.0,11.0,37.9,5.0,5.0,0.0,0.0,0.0,Matches,397.0,dk DEN,GK,29.0,29.0,2.0,0.0,0.0,0.0,4.0,0.0,0.0,0.0,0.0,0.0,0.0,0.0,42.0,10.0,2.0,83.3,Matches,397.0,dk DEN,GK,29.0,29.0,1280.0,1021.0,257.0,94.0,0.0,0.0,0.0,0.0,0.0,0.0,0.0,0.0,888.0,2.0,2.0,Matches,397.0,dk DEN,GK,29.0,29.0,888.0,1280.0,69.4,26806.0,20811.0,142.0,143.0,99.3,436.0,436.0,100.0,308.0,696.0,44.3,1.0,0.0,0.2,1.0,1.0,69.0,3.0,0.0,0.0,Matches,463,dk DEN,GK,29,29,2610.0,90.0,85.3,29.0,29,90.0,29,0,,0,1.9,44.0,27.0,17.0,0.59,1.39,31.3,35.1,-3.8,-0.13,0.06,Matches,397.0,dk DEN,GK,29.0,29.0,1340.0,883.0,1318.0,23.0,0.0,0.0,1340.0,0.0,0.0,,0.0,,861.0,4709.0,3107.0,0.0,0.0,0.0,0.0,0.0,727.0,0.0,Matches,397.0,dk DEN,GK,29.0,29.0,0.0,0.0,0.0,,0.0,0.0,,,,0.0,0.0,0.0,0.0,0.0,,0.0,0.0,Matches,397.0,dk DEN,GK,29.0,29.0,29.0,2610.0,29.0,0.0,1.0,1.0,0.0,0.0,0.0,2.0,0.0,0.0,0.0,0.0,0.0,0.0,0.0,0.0,0.0,0.03,0.03,0.0,0.03,0.0,0.0,0.0,0.0,0.0,Matches,Frederik Rønnow,GK,29,134,142,Denmark,1. FC Union Berlin,4,3,2,3,12,8,1,3,1,2,11,4,2,11,6,14,12,13,15,5,13,12,5,11,2,9,16,10,13,14,12,14,14,10,10,13,13,5,15,8,13,14,11,13,4,13,14,14,15,14,13,14,11,16,3,18,12,12,15,15,20,1,1,1,1,1,1,1,1,1,1,1,1,1,190,81,7,20,5310741,6695,6245,4995,Northern_European,132,4,1992/8/4,8,0,19230.0,,27014576
180,Roland Sallai,Freiburg,1997,400.0,hu HUN,MFFW,25.0,11.1,11.0,8.0,4.0,3.0,4.0,4.0,10.0,40.0,6.0,7.0,1.0,6.0,2.0,13.0,11.0,0.0,Matches,400.0,hu HUN,MFFW,25.0,11.1,39.0,3.5,23.0,1.0,4.0,2.0,8.0,1.0,5.0,0.45,3.0,0.0,1.0,0.0,1.0,0.0,Matches,,,,,,,,,,,,,,,,,,,,,,,,,,,,,,,,,,,,,,,,,,,,,,,,,,,,,,,,400.0,hu HUN,MFFW,25.0,11.1,6.0,0.0,0.0,29.0,30.0,3.0,35.0,2.0,8.0,2.0,0.0,0.0,58.0,21.0,18.0,53.8,Matches,400.0,hu HUN,MFFW,25.0,11.1,342.0,328.0,10.0,4.0,2.0,3.0,35.0,5.0,1.0,1.0,0.0,0.0,238.0,4.0,12.0,Matches,400.0,hu HUN,MFFW,25.0,11.1,238.0,342.0,69.6,3506.0,824.0,136.0,160.0,85.0,74.0,106.0,69.8,13.0,35.0,37.1,3.0,1.3,1.6,1.7,17.0,11.0,12.0,7.0,17.0,Matches,466,hu HUN,MFFW,25,19,1002.0,53.0,32.7,11.1,10,73.0,2,9,31.0,4,1.84,16.0,16.0,0.0,0.0,-0.31,15.9,17.6,-1.6,-0.15,-0.18,Matches,400.0,hu HUN,MFFW,25.0,11.1,465.0,11.0,72.0,194.0,202.0,40.0,465.0,27.0,12.0,44.4,12.0,44.4,274.0,1435.0,579.0,22.0,11.0,3.0,21.0,10.0,328.0,71.0,Matches,400.0,hu HUN,MFFW,25.0,11.1,1.0,32.0,11.0,34.4,2.87,0.99,0.03,0.09,17.4,0.0,0.0,0.0,2.6,2.6,0.08,-1.6,-1.6,Matches,400.0,hu HUN,MFFW,25.0,19.0,10.0,1002.0,11.1,1.0,3.0,4.0,1.0,0.0,0.0,6.0,0.0,2.6,2.6,1.3,3.9,22.0,17.0,71.0,0.09,0.27,0.36,0.09,0.36,0.24,0.11,0.35,0.24,0.35,Matches,Roland Sallai,M/AM RLC,25,140,150,Hungary,Sport-Club Freiburg,12,12,15,14,14,13,10,14,6,5,14,10,7,14,10,12,12,13,9,15,11,12,15,8,14,7,12,10,14,13,12,11,12,13,11,10,12,9,11,4,15,1,2,4,2,3,1,3,2,1,3,3,15,16,7,8,10,14,10,13,1,1,1,1,1,1,1,18,10,18,18,20,15,15,182,78,15,20,8633224,6750,6450,5250,Northern_European,130,3,1997/5/22,36,8,14383.0,,38039385
181,Leroy Sané,Bayern Munich,1996,402.0,de GER,MFFW,26.0,22.3,38.0,30.0,11.0,19.0,8.0,18.0,36.0,50.0,18.0,11.0,1.0,10.0,3.0,41.0,1.0,2.0,Matches,402.0,de GER,MFFW,26.0,22.3,93.0,4.17,72.0,1.0,7.0,7.0,4.0,2.0,15.0,0.67,13.0,0.0,0.0,2.0,0.0,0.0,Matches,,,,,,,,,,,,,,,,,,,,,,,,,,,,,,,,,,,,,,,,,,,,,,,,,,,,,,,,402.0,de GER,MFFW,26.0,22.3,4.0,0.0,0.0,17.0,23.0,7.0,16.0,3.0,30.0,0.0,0.0,0.0,115.0,6.0,7.0,46.2,Matches,402.0,de GER,MFFW,26.0,22.3,1078.0,1053.0,20.0,0.0,9.0,3.0,16.0,9.0,5.0,3.0,0.0,0.0,880.0,5.0,22.0,Matches,402.0,de GER,MFFW,26.0,22.3,880.0,1078.0,81.6,12202.0,3032.0,533.0,614.0,86.8,264.0,311.0,84.9,43.0,69.0,62.3,7.0,4.3,5.1,2.7,35.0,58.0,47.0,1.0,134.0,Matches,468,de GER,MFFW,26,32,2010.0,63.0,65.7,22.3,20,82.0,11,12,32.0,0,2.03,59.0,24.0,35.0,1.57,-0.06,45.5,25.3,20.2,0.91,-0.6,Matches,402.0,de GER,MFFW,26.0,22.3,1379.0,10.0,111.0,616.0,683.0,101.0,1379.0,136.0,75.0,55.1,56.0,41.2,941.0,6150.0,2650.0,77.0,69.0,30.0,60.0,60.0,1134.0,198.0,Matches,402.0,de GER,MFFW,26.0,22.3,8.0,78.0,29.0,37.2,3.49,1.3,0.1,0.28,19.7,6.0,0.0,0.0,8.5,8.5,0.11,-0.5,-0.5,Matches,402.0,de GER,MFFW,26.0,32.0,20.0,2010.0,22.3,8.0,7.0,15.0,8.0,0.0,0.0,4.0,0.0,8.5,8.5,4.3,12.8,77.0,134.0,198.0,0.36,0.31,0.67,0.36,0.67,0.38,0.19,0.57,0.38,0.57,Matches,Leroy Sané,AM RLC,26,165,175,"Germany,France,Senegal",FC Bayern München,14,14,18,14,15,16,7,17,3,7,14,11,8,17,13,15,10,14,12,15,14,11,16,4,15,8,11,9,17,16,14,10,15,18,13,11,12,4,14,6,12,2,2,2,4,3,2,1,1,2,4,3,11,16,13,10,12,11,9,7,1,1,1,1,12,12,1,15,10,15,20,17,18,10,183,80,20,9,96400267,8247,8247,7997,Mixed_Race,160,12,1996/1/11,45,11,326026.0,,91138280
182,Joe Scally,Gladbach,2002,405.0,us USA,DF,19.0,24.5,31.0,20.0,25.0,5.0,1.0,24.0,31.0,77.4,7.0,17.0,6.0,11.0,8.0,39.0,61.0,0.0,Matches,405.0,us USA,DF,19.0,24.5,35.0,1.43,26.0,4.0,1.0,1.0,3.0,0.0,3.0,0.12,2.0,1.0,0.0,0.0,0.0,0.0,Matches,,,,,,,,,,,,,,,,,,,,,,,,,,,,,,,,,,,,,,,,,,,,,,,,,,,,,,,,405.0,us USA,DF,19.0,24.5,2.0,0.0,0.0,13.0,51.0,3.0,41.0,8.0,20.0,0.0,0.0,0.0,94.0,18.0,15.0,54.5,Matches,405.0,us USA,DF,19.0,24.5,1173.0,940.0,231.0,25.0,0.0,1.0,41.0,206.0,0.0,0.0,0.0,0.0,921.0,2.0,39.0,Matches,405.0,us USA,DF,19.0,24.5,921.0,1173.0,78.5,14499.0,4462.0,482.0,547.0,88.1,366.0,434.0,84.3,60.0,121.0,49.6,0.0,1.8,2.4,-1.8,13.0,40.0,20.0,13.0,57.0,Matches,471,us USA,DF,19,28,2208.0,79.0,72.2,24.5,25,86.0,15,3,16.0,6,1.29,39.0,35.0,4.0,0.16,0.9,35.7,36.7,-1.0,-0.04,0.0,Matches,405.0,us USA,DF,19.0,24.5,1373.0,84.0,456.0,663.0,263.0,20.0,1373.0,28.0,11.0,39.3,13.0,46.4,704.0,3297.0,1544.0,29.0,23.0,1.0,22.0,14.0,804.0,60.0,Matches,405.0,us USA,DF,19.0,24.5,0.0,7.0,1.0,14.3,0.29,0.04,0.0,0.0,17.6,0.0,0.0,0.0,0.5,0.5,0.07,-0.5,-0.5,Matches,405.0,us USA,DF,19.0,28.0,25.0,2208.0,24.5,0.0,0.0,0.0,0.0,0.0,0.0,2.0,0.0,0.5,0.5,1.8,2.3,29.0,57.0,60.0,0.0,0.0,0.0,0.0,0.0,0.02,0.07,0.09,0.02,0.09,Matches,Joe Scally,D/WB RL,19,125,-8,United States,Borussia Mönchengladbach,5,12,12,7,11,4,8,7,12,11,12,6,12,12,14,11,14,11,12,11,11,16,12,5,12,12,15,16,14,12,12,11,17,15,14,11,12,8,11,4,16,2,1,3,3,3,1,3,3,2,1,3,18,14,7,12,12,16,10,10,1,17,1,20,16,18,1,10,1,12,1,1,1,1,184,80,12,20,60800000,6250,6000,4750,Northern_European,116,2,2002/12/31,2,0,16684.0,,72051619
183,Patrik Schick,Leverkusen,1996,409.0,cz CZE,FW,26.0,10.5,0.0,0.0,0.0,0.0,0.0,0.0,1.0,0.0,1.0,4.0,1.0,3.0,1.0,1.0,7.0,0.0,Matches,409.0,cz CZE,FW,26.0,10.5,28.0,2.68,21.0,0.0,1.0,3.0,3.0,0.0,2.0,0.19,2.0,0.0,0.0,0.0,0.0,0.0,Matches,,,,,,,,,,,,,,,,,,,,,,,,,,,,,,,,,,,,,,,,,,,,,,,,,,,,,,,,409.0,cz CZE,FW,26.0,10.5,0.0,0.0,0.0,5.0,16.0,0.0,4.0,1.0,0.0,0.0,0.0,0.0,18.0,30.0,38.0,44.1,Matches,409.0,cz CZE,FW,26.0,10.5,253.0,233.0,19.0,2.0,1.0,0.0,4.0,6.0,0.0,0.0,0.0,0.0,176.0,1.0,5.0,Matches,409.0,cz CZE,FW,26.0,10.5,176.0,253.0,69.6,2172.0,435.0,110.0,153.0,71.9,48.0,70.0,68.6,3.0,5.0,60.0,1.0,0.6,0.4,0.4,10.0,3.0,7.0,1.0,11.0,Matches,477,cz CZE,FW,26,14,941.0,67.0,30.8,10.5,10,83.0,6,4,27.0,0,0.86,16.0,21.0,-5.0,-0.48,-1.03,16.4,17.8,-1.4,-0.13,-0.56,Matches,409.0,cz CZE,FW,26.0,10.5,358.0,8.0,22.0,168.0,172.0,48.0,358.0,16.0,7.0,43.8,8.0,50.0,195.0,697.0,234.0,8.0,9.0,3.0,28.0,13.0,298.0,68.0,Matches,409.0,cz CZE,FW,26.0,10.5,3.0,34.0,14.0,41.2,3.25,1.34,0.09,0.21,12.8,1.0,0.0,0.0,4.6,4.6,0.14,-1.6,-1.6,Matches,409.0,cz CZE,FW,26.0,14.0,10.0,941.0,10.5,3.0,1.0,4.0,3.0,0.0,0.0,0.0,0.0,4.6,4.6,0.6,5.1,8.0,11.0,68.0,0.29,0.1,0.38,0.29,0.38,0.44,0.05,0.49,0.44,0.49,Matches,Patrik Schick,S,26,152,155,Czech Republic,Bayer 04 Leverkusen,8,10,15,16,16,9,14,14,4,6,12,12,7,15,12,14,13,14,13,14,14,11,15,6,14,7,12,12,15,14,14,15,13,15,14,12,15,6,14,9,8,1,3,2,3,2,2,2,1,4,1,3,14,16,12,9,12,14,12,17,1,1,1,1,1,1,1,10,1,14,10,12,14,20,191,86,20,12,56430002,7600,7000,6250,Northern_European,151,3,1996/1/24,33,17,110000.0,,25042141
184,Kingsley Schindler,Köln,1993,410.0,gh GHA,DFMF,29.0,12.1,23.0,12.0,13.0,8.0,2.0,18.0,28.0,64.3,10.0,14.0,2.0,12.0,15.0,38.0,24.0,0.0,Matches,410.0,gh GHA,DFMF,29.0,12.1,27.0,2.24,20.0,2.0,0.0,3.0,2.0,0.0,4.0,0.33,2.0,1.0,0.0,1.0,0.0,0.0,Matches,,,,,,,,,,,,,,,,,,,,,,,,,,,,,,,,,,,,,,,,,,,,,,,,,,,,,,,,410.0,gh GHA,DFMF,29.0,12.1,4.0,0.0,0.0,11.0,12.0,2.0,45.0,15.0,12.0,0.0,0.0,0.0,66.0,24.0,11.0,68.6,Matches,410.0,gh GHA,DFMF,29.0,12.1,546.0,438.0,106.0,4.0,0.0,1.0,45.0,99.0,3.0,1.0,1.0,0.0,352.0,2.0,28.0,Matches,410.0,gh GHA,DFMF,29.0,12.1,352.0,546.0,64.5,6455.0,2445.0,133.0,169.0,78.7,173.0,243.0,71.2,37.0,86.0,43.0,1.0,0.7,0.7,0.3,10.0,30.0,12.0,3.0,50.0,Matches,478,gh GHA,DFMF,29,29,1088.0,38.0,35.6,12.1,8,72.0,2,21,24.0,4,1.24,20.0,22.0,-2.0,-0.17,-0.03,19.7,16.0,3.7,0.31,0.24,Matches,410.0,gh GHA,DFMF,29.0,12.1,699.0,37.0,165.0,305.0,234.0,25.0,699.0,22.0,8.0,36.4,11.0,50.0,345.0,1642.0,684.0,20.0,14.0,5.0,27.0,15.0,382.0,75.0,Matches,410.0,gh GHA,DFMF,29.0,12.1,0.0,11.0,4.0,36.4,0.91,0.33,0.0,0.0,12.8,0.0,0.0,0.0,2.2,2.2,0.2,-2.2,-2.2,Matches,410.0,gh GHA,DFMF,29.0,29.0,8.0,1088.0,12.1,0.0,1.0,1.0,0.0,0.0,0.0,4.0,0.0,2.2,2.2,0.7,2.9,20.0,50.0,75.0,0.0,0.08,0.08,0.0,0.08,0.18,0.06,0.24,0.18,0.24,Matches,Kingsley Schindler,M/AM/S R,29,124,129,"Ghana,Germany",1. FC Köln,7,11,12,11,11,7,8,10,10,8,10,13,8,12,15,11,14,11,12,10,9,12,13,8,13,7,12,14,15,13,13,11,16,14,13,12,13,6,14,6,16,3,2,2,1,1,3,4,3,3,3,1,6,12,6,11,13,13,13,13,1,1,1,13,1,13,1,1,1,20,1,1,20,16,183,77,12,20,1877798,6200,6200,4500,African_Caribbean,114,16,1993/7/12,0,0,19164.0,,91137354
185,Xaver Schlager,RB Leipzig,1997,411.0,at AUT,MF,24.0,16.7,41.0,24.0,13.0,26.0,2.0,20.0,43.0,46.5,23.0,19.0,2.0,17.0,17.0,58.0,23.0,0.0,Matches,411.0,at AUT,MF,24.0,16.7,30.0,1.8,26.0,0.0,0.0,0.0,2.0,2.0,6.0,0.36,6.0,0.0,0.0,0.0,0.0,0.0,Matches,,,,,,,,,,,,,,,,,,,,,,,,,,,,,,,,,,,,,,,,,,,,,,,,,,,,,,,,411.0,at AUT,MF,24.0,16.7,2.0,0.0,0.0,27.0,24.0,1.0,2.0,17.0,24.0,0.0,0.0,0.0,132.0,13.0,20.0,39.4,Matches,411.0,at AUT,MF,24.0,16.7,928.0,910.0,11.0,10.0,4.0,5.0,2.0,1.0,0.0,0.0,0.0,0.0,771.0,7.0,15.0,Matches,411.0,at AUT,MF,24.0,16.7,771.0,928.0,83.1,13466.0,4066.0,370.0,411.0,90.0,324.0,369.0,87.8,74.0,106.0,69.8,1.0,0.7,1.6,0.3,8.0,87.0,10.0,1.0,77.0,Matches,479,at AUT,MF,24,22,1506.0,68.0,49.2,16.7,16,87.0,12,6,19.0,5,2.23,40.0,17.0,23.0,1.37,1.37,34.8,16.4,18.4,1.1,0.69,Matches,411.0,at AUT,MF,24.0,16.7,1090.0,35.0,275.0,677.0,160.0,3.0,1090.0,24.0,13.0,54.2,8.0,33.3,680.0,3392.0,1828.0,23.0,22.0,1.0,21.0,14.0,734.0,12.0,Matches,411.0,at AUT,MF,24.0,16.7,1.0,5.0,1.0,20.0,0.3,0.06,0.2,1.0,23.6,0.0,0.0,0.0,0.3,0.3,0.06,0.7,0.7,Matches,411.0,at AUT,MF,24.0,22.0,16.0,1506.0,16.7,1.0,1.0,2.0,1.0,0.0,0.0,2.0,0.0,0.3,0.3,0.7,0.9,23.0,77.0,12.0,0.06,0.06,0.12,0.06,0.12,0.02,0.04,0.06,0.02,0.06,Matches,Xaver Schlager,DM/M C,24,145,156,Austria,RB Leipzig,4,8,12,9,14,12,8,12,4,13,14,8,16,14,16,15,16,14,15,14,13,17,11,14,13,14,16,17,12,12,14,9,16,12,16,12,15,12,12,9,14,3,2,1,3,1,2,3,2,2,4,3,13,17,12,12,14,15,12,12,1,12,1,1,10,1,18,12,20,12,10,14,10,1,174,76,20,13,28322813,7250,6950,6500,Northern_European,142,4,1997/9/28,29,2,86479.0,,16147660
186,Nico Schlotterbeck,Dortmund,1999,414.0,de GER,DF,22.0,25.0,59.0,34.0,34.0,24.0,1.0,37.0,53.0,69.8,16.0,38.0,21.0,17.0,32.0,91.0,71.0,1.0,Matches,414.0,de GER,DF,22.0,25.0,32.0,1.28,24.0,0.0,2.0,3.0,1.0,2.0,7.0,0.28,5.0,0.0,0.0,0.0,0.0,2.0,Matches,,,,,,,,,,,,,,,,,,,,,,,,,,,,,,,,,,,,,,,,,,,,,,,,,,,,,,,,414.0,de GER,DF,22.0,25.0,3.0,0.0,0.0,16.0,17.0,1.0,11.0,32.0,34.0,0.0,0.0,0.0,194.0,60.0,33.0,64.5,Matches,414.0,de GER,DF,22.0,25.0,1910.0,1846.0,62.0,53.0,2.0,49.0,11.0,9.0,0.0,0.0,0.0,0.0,1648.0,2.0,25.0,Matches,414.0,de GER,DF,22.0,25.0,1648.0,1910.0,86.3,33135.0,11360.0,558.0,609.0,91.6,860.0,920.0,93.5,215.0,335.0,64.2,5.0,1.7,1.3,3.3,14.0,137.0,11.0,0.0,159.0,Matches,482,de GER,DF,22,28,2252.0,80.0,73.6,25.0,27,83.0,23,1,1.0,3,2.11,57.0,34.0,23.0,0.92,-0.86,44.3,32.5,11.9,0.47,-1.31,Matches,414.0,de GER,DF,22.0,25.0,2173.0,202.0,988.0,1097.0,111.0,23.0,2173.0,19.0,11.0,57.9,4.0,21.1,1342.0,6598.0,4158.0,39.0,39.0,1.0,14.0,8.0,1510.0,14.0,Matches,414.0,de GER,DF,22.0,25.0,4.0,18.0,6.0,33.3,0.72,0.24,0.22,0.67,16.9,0.0,0.0,0.0,1.6,1.6,0.09,2.4,2.4,Matches,414.0,de GER,DF,22.0,28.0,27.0,2252.0,25.0,4.0,5.0,9.0,4.0,0.0,0.0,3.0,0.0,1.6,1.6,1.7,3.3,39.0,159.0,14.0,0.16,0.2,0.36,0.16,0.36,0.06,0.07,0.13,0.06,0.13,Matches,Nico Schlotterbeck,D LC,22,141,162,Germany,Borussia Dortmund,5,8,12,7,11,7,13,7,10,14,12,8,16,12,12,13,16,15,14,14,14,14,11,11,11,14,15,15,12,12,15,15,12,12,14,13,13,10,15,7,14,2,3,2,1,1,1,4,1,1,2,2,9,13,8,12,15,13,15,10,1,15,20,12,11,1,12,1,10,1,1,1,1,1,191,89,20,12,50309996,7000,7000,5750,Northern_European,140,1,1999/12/1,4,0,55000.0,,92088306
187,Romano Schmid,Werder Bremen,2000,416.0,at AUT,MFFW,22.0,16.9,24.0,15.0,5.0,13.0,6.0,10.0,22.0,45.5,12.0,21.0,3.0,18.0,7.0,31.0,12.0,0.0,Matches,416.0,at AUT,MFFW,22.0,16.9,49.0,2.9,43.0,0.0,3.0,1.0,2.0,0.0,3.0,0.18,3.0,0.0,0.0,0.0,0.0,0.0,Matches,,,,,,,,,,,,,,,,,,,,,,,,,,,,,,,,,,,,,,,,,,,,,,,,,,,,,,,,416.0,at AUT,MFFW,22.0,16.9,3.0,0.0,0.0,16.0,23.0,2.0,20.0,7.0,15.0,0.0,0.0,0.0,97.0,18.0,33.0,35.3,Matches,416.0,at AUT,MFFW,22.0,16.9,750.0,728.0,17.0,1.0,5.0,2.0,20.0,15.0,0.0,0.0,0.0,0.0,561.0,5.0,31.0,Matches,416.0,at AUT,MFFW,22.0,16.9,561.0,750.0,74.8,8443.0,2852.0,309.0,379.0,81.5,180.0,225.0,80.0,44.0,71.0,62.0,3.0,2.0,2.2,1.0,22.0,59.0,19.0,2.0,75.0,Matches,485,at AUT,MFFW,22,27,1520.0,56.0,49.7,16.9,15,81.0,5,12,26.0,1,1.07,23.0,29.0,-6.0,-0.36,0.05,20.5,26.0,-5.5,-0.33,0.04,Matches,416.0,at AUT,MFFW,22.0,16.9,948.0,17.0,139.0,495.0,325.0,34.0,948.0,47.0,16.0,34.0,25.0,53.2,540.0,2606.0,1324.0,34.0,30.0,7.0,47.0,25.0,661.0,84.0,Matches,416.0,at AUT,MFFW,22.0,16.9,1.0,18.0,3.0,16.7,1.07,0.18,0.06,0.33,21.4,0.0,0.0,0.0,1.5,1.5,0.08,-0.5,-0.5,Matches,416.0,at AUT,MFFW,22.0,27.0,15.0,1520.0,16.9,1.0,3.0,4.0,1.0,0.0,0.0,3.0,0.0,1.5,1.5,2.0,3.5,34.0,75.0,84.0,0.06,0.18,0.24,0.06,0.24,0.09,0.12,0.21,0.09,0.21,Matches,Romano Schmid,AM C,22,116,137,Austria,SV Werder Bremen,9,13,13,8,13,9,4,11,5,6,14,9,7,14,6,12,11,11,11,12,12,15,13,7,14,11,13,13,14,14,10,7,12,13,11,6,10,6,12,8,11,3,2,2,3,2,1,2,4,3,2,3,14,17,6,13,10,13,13,12,1,1,1,1,1,1,1,12,14,12,12,20,12,10,168,69,12,20,2874999,5800,5800,4400,Northern_European,114,4,2000/1/27,0,0,5794.0,,16184737
188,Benno Schmitz,Köln,1994,419.0,de GER,DF,27.0,26.9,64.0,42.0,31.0,28.0,5.0,42.0,82.0,51.2,40.0,34.0,4.0,30.0,26.0,90.0,57.0,0.0,Matches,419.0,de GER,DF,27.0,26.9,52.0,1.93,42.0,9.0,0.0,0.0,1.0,0.0,4.0,0.15,4.0,0.0,0.0,0.0,0.0,0.0,Matches,,,,,,,,,,,,,,,,,,,,,,,,,,,,,,,,,,,,,,,,,,,,,,,,,,,,,,,,419.0,de GER,DF,27.0,26.9,6.0,0.0,0.0,32.0,18.0,0.0,96.0,26.0,42.0,0.0,0.0,2.0,152.0,30.0,30.0,50.0,Matches,419.0,de GER,DF,27.0,26.9,1499.0,1183.0,307.0,13.0,1.0,1.0,96.0,294.0,0.0,0.0,0.0,0.0,938.0,9.0,49.0,Matches,419.0,de GER,DF,27.0,26.9,938.0,1499.0,62.6,16734.0,8969.0,398.0,488.0,81.6,435.0,644.0,67.5,91.0,272.0,33.5,0.0,2.4,3.1,-2.4,19.0,108.0,42.0,19.0,149.0,Matches,488,de GER,DF,27,31,2420.0,78.0,79.1,26.9,30,80.0,18,1,29.0,0,1.16,34.0,38.0,-4.0,-0.15,-0.01,33.1,33.4,-0.3,-0.01,-0.8,Matches,419.0,de GER,DF,27.0,26.9,1757.0,83.0,485.0,799.0,483.0,22.0,1757.0,11.0,3.0,27.3,7.0,63.6,777.0,3363.0,1919.0,48.0,39.0,3.0,24.0,8.0,915.0,126.0,Matches,419.0,de GER,DF,27.0,26.9,1.0,10.0,2.0,20.0,0.37,0.07,0.1,0.5,19.5,0.0,0.0,0.0,0.4,0.4,0.04,0.6,0.6,Matches,419.0,de GER,DF,27.0,31.0,30.0,2420.0,26.9,1.0,0.0,1.0,1.0,0.0,0.0,6.0,0.0,0.4,0.4,2.4,2.9,48.0,149.0,126.0,0.04,0.0,0.04,0.04,0.04,0.02,0.09,0.11,0.02,0.11,Matches,Benno Schmitz,D/WB/M R,27,129,132,Germany,1. FC Köln,12,14,11,7,11,10,9,10,14,12,14,9,13,12,11,14,12,13,12,12,13,12,6,8,12,12,16,14,12,11,13,10,16,12,14,12,14,7,14,4,17,3,1,2,2,1,3,2,1,1,3,3,9,15,7,12,13,16,14,16,1,14,10,20,12,18,15,1,12,16,1,1,1,1,182,75,10,20,3517166,6449,6449,4899,Northern_European,122,4,1994/11/17,0,0,12657.0,,91126210
189,Marvin Schwäbe,Köln,1995,420.0,de GER,GK,27.0,34.0,1.0,0.0,1.0,0.0,0.0,1.0,1.0,100.0,0.0,0.0,0.0,0.0,2.0,3.0,8.0,2.0,Matches,420.0,de GER,GK,27.0,34.0,4.0,0.12,4.0,0.0,0.0,0.0,0.0,0.0,1.0,0.03,1.0,0.0,0.0,0.0,0.0,0.0,Matches,27.0,de GER,GK,27.0,34.0,54.0,4.0,4.0,4.0,3.0,42.3,0.3,-8.7,-0.26,154.0,404.0,38.1,1203.0,117.0,28.8,31.3,185.0,31.4,33.9,468.0,19.0,4.1,22.0,0.65,13.4,Matches,27.0,de GER,GK,27.0,34.0,34.0,3060.0,34.0,54.0,1.59,129.0,77.0,61.2,10.0,12.0,12.0,6.0,17.6,5.0,4.0,1.0,0.0,20.0,Matches,420.0,de GER,GK,27.0,34.0,1.0,0.0,0.0,0.0,2.0,0.0,0.0,2.0,0.0,0.0,0.0,0.0,33.0,6.0,1.0,85.7,Matches,420.0,de GER,GK,27.0,34.0,1390.0,1135.0,253.0,68.0,0.0,1.0,0.0,0.0,0.0,0.0,0.0,0.0,1091.0,2.0,1.0,Matches,420.0,de GER,GK,27.0,34.0,1091.0,1390.0,78.5,28445.0,18655.0,168.0,170.0,98.8,636.0,646.0,98.5,287.0,569.0,50.4,0.0,0.0,0.1,0.0,0.0,22.0,1.0,0.0,1.0,Matches,490,de GER,GK,27,34,3060.0,90.0,100.0,34.0,34,90.0,34,0,,0,1.24,49.0,54.0,-5.0,-0.15,,47.9,42.6,5.3,0.16,,Matches,420.0,de GER,GK,27.0,34.0,1457.0,1025.0,1439.0,20.0,0.0,0.0,1457.0,0.0,0.0,,0.0,,940.0,4444.0,2678.0,0.0,1.0,1.0,1.0,0.0,911.0,0.0,Matches,420.0,de GER,GK,27.0,34.0,0.0,0.0,0.0,,0.0,0.0,,,,0.0,0.0,0.0,0.0,0.0,,0.0,0.0,Matches,420.0,de GER,GK,27.0,34.0,34.0,3060.0,34.0,0.0,0.0,0.0,0.0,0.0,0.0,1.0,0.0,0.0,0.0,0.0,0.0,0.0,1.0,0.0,0.0,0.0,0.0,0.0,0.0,0.0,0.0,0.0,0.0,0.0,Matches,Marvin Schwäbe,GK,27,132,132,Germany,1. FC Köln,3,4,3,3,10,1,7,1,3,2,10,4,1,10,10,13,12,13,13,9,13,12,3,9,2,14,16,12,13,13,14,15,13,11,9,15,14,5,16,6,3,12,11,9,15,12,15,16,16,13,10,13,11,14,6,12,16,14,15,18,20,1,1,1,1,1,1,1,1,1,1,1,1,1,190,87,7,20,4295683,6598,6598,4149,Northern_European,132,2,1995/4/25,0,0,13499.0,,91108114
190,Alexander Schwolow,Schalke 04,1992,421.0,de GER,GK,30.0,22.6,0.0,0.0,0.0,0.0,0.0,0.0,2.0,0.0,2.0,0.0,0.0,0.0,1.0,1.0,6.0,3.0,Matches,421.0,de GER,GK,30.0,22.6,10.0,0.44,4.0,5.0,0.0,1.0,0.0,0.0,0.0,0.0,0.0,0.0,0.0,0.0,0.0,0.0,Matches,28.0,de GER,GK,30.0,22.6,58.0,4.0,1.0,6.0,0.0,45.8,0.31,-12.2,-0.54,180.0,441.0,40.8,676.0,79.0,46.4,38.4,174.0,73.0,55.2,321.0,7.0,2.2,23.0,1.02,15.0,Matches,28.0,de GER,GK,30.0,23.0,22.0,2035.0,22.6,58.0,2.57,138.0,80.0,60.9,4.0,4.0,14.0,2.0,9.1,4.0,4.0,0.0,0.0,0.0,Matches,421.0,de GER,GK,30.0,22.6,1.0,0.0,0.0,0.0,4.0,0.0,0.0,1.0,0.0,0.0,0.0,0.0,30.0,3.0,1.0,75.0,Matches,421.0,de GER,GK,30.0,22.6,853.0,612.0,238.0,64.0,0.0,0.0,0.0,0.0,0.0,0.0,0.0,0.0,567.0,3.0,1.0,Matches,421.0,de GER,GK,30.0,22.6,567.0,853.0,66.5,18860.0,15113.0,87.0,88.0,98.9,231.0,234.0,98.7,246.0,524.0,46.9,0.0,0.1,0.2,-0.1,1.0,32.0,2.0,0.0,0.0,Matches,492,de GER,GK,30,23,2035.0,88.0,66.5,22.6,22,90.0,22,1,55.0,11,0.83,24.0,58.0,-34.0,-1.5,-1.33,26.5,40.8,-14.3,-0.63,-0.35,Matches,421.0,de GER,GK,30.0,22.6,916.0,752.0,910.0,5.0,1.0,1.0,916.0,0.0,0.0,,0.0,,494.0,2288.0,1124.0,0.0,0.0,0.0,0.0,0.0,443.0,0.0,Matches,421.0,de GER,GK,30.0,22.6,0.0,1.0,0.0,0.0,0.04,0.0,0.0,,5.5,0.0,0.0,0.0,0.1,0.1,0.08,-0.1,-0.1,Matches,421.0,de GER,GK,30.0,23.0,22.0,2035.0,22.6,0.0,0.0,0.0,0.0,0.0,0.0,1.0,0.0,0.1,0.1,0.1,0.2,0.0,0.0,0.0,0.0,0.0,0.0,0.0,0.0,0.0,0.0,0.01,0.0,0.01,Matches,Alexander Schwolow,GK,30,126,136,Germany,Hertha Berlin,5,1,2,1,11,7,5,1,3,1,11,2,1,11,11,12,12,13,12,11,12,11,6,12,1,13,12,10,11,14,12,15,12,12,12,12,8,9,11,8,14,13,12,13,12,12,14,14,13,11,14,12,5,12,7,14,9,15,14,17,20,1,1,1,1,1,1,1,1,1,1,1,1,1,190,84,11,20,2228380,6295,6295,5295,Northern_European,126,3,1992/6/2,0,0,47944.0,FC Schalke 04,91105570
191,Suat Serdar,Hertha BSC,1997,425.0,de GER,MF,25.0,22.5,51.0,23.0,14.0,30.0,7.0,20.0,41.0,48.8,21.0,48.0,12.0,36.0,29.0,80.0,24.0,0.0,Matches,425.0,de GER,MF,25.0,22.5,41.0,1.82,29.0,1.0,4.0,2.0,4.0,1.0,4.0,0.18,4.0,0.0,0.0,0.0,0.0,0.0,Matches,,,,,,,,,,,,,,,,,,,,,,,,,,,,,,,,,,,,,,,,,,,,,,,,,,,,,,,,425.0,de GER,MF,25.0,22.5,7.0,0.0,0.0,33.0,31.0,1.0,5.0,29.0,23.0,0.0,0.0,0.0,139.0,30.0,31.0,49.2,Matches,425.0,de GER,MF,25.0,22.5,615.0,583.0,30.0,8.0,3.0,7.0,5.0,0.0,4.0,1.0,2.0,0.0,431.0,2.0,27.0,Matches,425.0,de GER,MF,25.0,22.5,431.0,615.0,70.1,7626.0,2154.0,196.0,249.0,78.7,175.0,231.0,75.8,50.0,77.0,64.9,2.0,1.6,1.8,0.4,18.0,50.0,14.0,0.0,78.0,Matches,497,de GER,MF,25,32,2021.0,63.0,66.0,22.5,24,74.0,5,8,30.0,0,0.88,26.0,44.0,-18.0,-0.8,-0.02,25.5,39.1,-13.5,-0.6,0.01,Matches,425.0,de GER,MF,25.0,22.5,936.0,32.0,189.0,549.0,219.0,32.0,936.0,74.0,36.0,48.6,31.0,41.9,463.0,2623.0,1226.0,33.0,23.0,3.0,35.0,32.0,465.0,48.0,Matches,425.0,de GER,MF,25.0,22.5,4.0,23.0,7.0,30.4,1.02,0.31,0.17,0.57,19.3,0.0,0.0,0.0,1.9,1.9,0.08,2.1,2.1,Matches,425.0,de GER,MF,25.0,32.0,24.0,2021.0,22.5,4.0,2.0,6.0,4.0,0.0,0.0,7.0,0.0,1.9,1.9,1.6,3.5,33.0,78.0,48.0,0.18,0.09,0.27,0.18,0.27,0.09,0.07,0.16,0.09,0.16,Matches,Suat Serdar,DM/M C,25,136,143,"Germany,Turkey",Hertha Berlin,7,9,15,11,14,7,10,13,9,11,13,10,12,15,18,12,17,14,11,12,11,13,12,11,14,10,15,16,14,13,13,12,11,14,15,12,9,10,15,7,15,1,3,3,2,2,3,1,2,4,1,2,14,17,8,10,10,13,14,10,1,1,1,1,1,1,18,12,20,12,13,15,13,1,184,75,10,20,8520252,6642,6642,4892,North_African__Middle_Eastern,132,7,1997/4/11,4,0,28846.0,,91137136
192,Kiliann Sildillia,Freiburg,2002,427.0,fr FRA,DFMF,20.0,22.0,33.0,20.0,10.0,19.0,4.0,18.0,30.0,60.0,12.0,24.0,9.0,15.0,21.0,54.0,47.0,1.0,Matches,427.0,fr FRA,DFMF,20.0,22.0,28.0,1.28,16.0,8.0,1.0,1.0,2.0,0.0,5.0,0.23,2.0,1.0,1.0,1.0,0.0,0.0,Matches,,,,,,,,,,,,,,,,,,,,,,,,,,,,,,,,,,,,,,,,,,,,,,,,,,,,,,,,427.0,fr FRA,DFMF,20.0,22.0,4.0,1.0,1.0,38.0,6.0,2.0,26.0,21.0,20.0,0.0,0.0,0.0,107.0,42.0,43.0,49.4,Matches,427.0,fr FRA,DFMF,20.0,22.0,1103.0,893.0,207.0,20.0,1.0,5.0,26.0,187.0,0.0,0.0,0.0,0.0,787.0,3.0,26.0,Matches,427.0,fr FRA,DFMF,20.0,22.0,787.0,1103.0,71.4,14814.0,5194.0,316.0,402.0,78.6,333.0,448.0,74.3,118.0,183.0,64.5,2.0,0.7,1.3,1.3,10.0,69.0,9.0,4.0,81.0,Matches,500,fr FRA,DFMF,20,27,1977.0,73.0,64.6,22.0,23,83.0,18,4,16.0,4,1.63,29.0,32.0,-3.0,-0.14,-0.97,28.9,33.0,-4.2,-0.19,-0.47,Matches,427.0,fr FRA,DFMF,20.0,22.0,1306.0,67.0,337.0,706.0,271.0,18.0,1306.0,27.0,12.0,44.4,14.0,51.9,650.0,3159.0,1546.0,20.0,24.0,2.0,21.0,15.0,693.0,47.0,Matches,427.0,fr FRA,DFMF,20.0,22.0,0.0,10.0,0.0,0.0,0.46,0.0,0.0,,19.3,0.0,0.0,0.0,0.8,0.8,0.08,-0.8,-0.8,Matches,427.0,fr FRA,DFMF,20.0,27.0,23.0,1977.0,22.0,0.0,2.0,2.0,0.0,0.0,0.0,4.0,1.0,0.8,0.8,0.7,1.6,20.0,81.0,47.0,0.0,0.09,0.09,0.0,0.09,0.04,0.03,0.07,0.04,0.07,Matches,Kiliann Sildillia,D/WB RC,20,122,-8,"France,Guadeloupe",Sport-Club Freiburg,6,10,9,6,12,7,15,6,16,12,11,7,13,11,10,12,12,8,11,8,12,13,9,11,11,12,14,14,15,12,7,13,13,14,14,10,12,9,12,7,11,3,1,1,1,3,2,3,1,3,4,1,14,12,9,14,14,12,11,7,1,1,19,20,1,17,13,1,1,12,1,1,1,1,186,79,11,20,60800000,6087,5130,4575,African_Caribbean,116,12,2002/5/16,0,0,5273.0,,49048381
193,André Silva,RB Leipzig,1995,428.0,pt POR,FW,26.0,19.3,12.0,6.0,2.0,5.0,5.0,3.0,8.0,37.5,5.0,11.0,1.0,10.0,3.0,15.0,3.0,0.0,Matches,428.0,pt POR,FW,26.0,19.3,63.0,3.26,46.0,0.0,4.0,7.0,6.0,0.0,10.0,0.52,7.0,0.0,0.0,3.0,0.0,0.0,Matches,,,,,,,,,,,,,,,,,,,,,,,,,,,,,,,,,,,,,,,,,,,,,,,,,,,,,,,,428.0,pt POR,FW,26.0,19.3,3.0,0.0,0.0,32.0,44.0,10.0,4.0,3.0,6.0,0.0,0.0,0.0,48.0,20.0,35.0,36.4,Matches,428.0,pt POR,FW,26.0,19.3,477.0,443.0,33.0,1.0,5.0,2.0,4.0,4.0,0.0,0.0,0.0,0.0,349.0,1.0,25.0,Matches,428.0,pt POR,FW,26.0,19.3,349.0,477.0,73.2,4277.0,862.0,241.0,291.0,82.8,75.0,104.0,72.1,9.0,14.0,64.3,3.0,2.9,2.9,0.1,26.0,16.0,13.0,0.0,37.0,Matches,501,pt POR,FW,26,31,1738.0,56.0,56.8,19.3,20,77.0,6,11,17.0,3,1.84,37.0,25.0,12.0,0.62,-0.13,36.5,23.0,13.5,0.7,-0.11,Matches,428.0,pt POR,FW,26.0,19.3,717.0,8.0,39.0,281.0,409.0,120.0,717.0,61.0,21.0,34.4,29.0,47.5,478.0,2386.0,984.0,35.0,21.0,23.0,65.0,43.0,556.0,142.0,Matches,428.0,pt POR,FW,26.0,19.3,4.0,60.0,22.0,36.7,3.11,1.14,0.07,0.18,13.5,0.0,0.0,0.0,9.2,9.2,0.15,-5.2,-5.2,Matches,428.0,pt POR,FW,26.0,31.0,20.0,1738.0,19.3,4.0,3.0,7.0,4.0,0.0,0.0,3.0,0.0,9.2,9.2,2.9,12.0,35.0,37.0,142.0,0.21,0.16,0.36,0.21,0.36,0.47,0.15,0.62,0.47,0.62,Matches,André Silva,S,26,148,154,Portugal,RB Leipzig,7,11,12,16,14,7,14,9,5,6,13,14,8,13,13,17,14,14,15,12,14,12,14,7,17,8,15,15,12,14,13,13,16,13,15,13,14,7,12,6,9,2,3,1,2,2,3,3,1,3,3,1,8,15,10,13,11,16,12,9,1,1,1,1,1,1,1,10,1,9,10,12,9,20,185,84,13,20,24627377,7050,7050,6750,Mediterranean_Hispanic,146,6,1995/11/6,51,19,79999.0,,55041694
194,Mohamed Simakan,RB Leipzig,2000,429.0,fr FRA,DF,22.0,16.2,21.0,14.0,12.0,5.0,4.0,14.0,21.0,66.7,7.0,21.0,4.0,17.0,16.0,37.0,55.0,0.0,Matches,429.0,fr FRA,DF,22.0,16.2,28.0,1.73,21.0,0.0,3.0,2.0,2.0,0.0,1.0,0.06,0.0,0.0,0.0,1.0,0.0,0.0,Matches,,,,,,,,,,,,,,,,,,,,,,,,,,,,,,,,,,,,,,,,,,,,,,,,,,,,,,,,429.0,fr FRA,DF,22.0,16.2,2.0,0.0,0.0,24.0,25.0,2.0,14.0,16.0,14.0,0.0,1.0,0.0,92.0,38.0,25.0,60.3,Matches,429.0,fr FRA,DF,22.0,16.2,1108.0,992.0,113.0,13.0,3.0,7.0,14.0,100.0,0.0,0.0,0.0,0.0,901.0,3.0,26.0,Matches,429.0,fr FRA,DF,22.0,16.2,901.0,1108.0,81.3,14885.0,5523.0,451.0,508.0,88.8,368.0,431.0,85.4,65.0,120.0,54.2,1.0,1.2,1.4,-0.2,11.0,81.0,16.0,2.0,88.0,Matches,503,fr FRA,DF,22,24,1454.0,61.0,47.5,16.2,18,76.0,8,6,14.0,5,1.88,29.0,17.0,12.0,0.74,0.13,29.8,15.0,14.8,0.91,0.31,Matches,429.0,fr FRA,DF,22.0,16.2,1301.0,89.0,434.0,668.0,211.0,28.0,1301.0,31.0,12.0,38.7,15.0,48.4,768.0,3765.0,2170.0,32.0,23.0,2.0,22.0,6.0,869.0,72.0,Matches,429.0,fr FRA,DF,22.0,16.2,1.0,12.0,3.0,25.0,0.74,0.19,0.08,0.33,12.3,0.0,0.0,0.0,1.7,1.7,0.14,-0.7,-0.7,Matches,429.0,fr FRA,DF,22.0,24.0,18.0,1454.0,16.2,1.0,1.0,2.0,1.0,0.0,0.0,2.0,0.0,1.7,1.7,1.2,2.9,32.0,88.0,72.0,0.06,0.06,0.12,0.06,0.12,0.1,0.08,0.18,0.1,0.18,Matches,Mohamed Simakan,D/WB RC,22,139,160,"France,Guinea",RB Leipzig,5,11,12,7,12,5,13,6,10,14,12,8,15,12,13,14,15,14,13,12,13,16,13,9,12,14,12,14,14,13,14,14,13,15,14,15,12,8,14,11,11,3,4,2,3,2,2,3,1,2,2,1,11,14,4,12,14,13,10,10,1,1,20,17,1,16,12,1,1,1,1,1,1,1,187,82,8,20,28349999,6931,6187,5313,African_Caribbean,139,15,2000/5/3,0,0,48062.0,,49047065
195,Ellyes Skhiri,Köln,1995,435.0,tn TUN,MF,27.0,31.7,79.0,44.0,29.0,42.0,8.0,26.0,66.0,39.4,40.0,52.0,12.0,40.0,56.0,135.0,48.0,0.0,Matches,435.0,tn TUN,MF,27.0,31.7,56.0,1.76,48.0,0.0,1.0,5.0,0.0,2.0,5.0,0.16,5.0,0.0,0.0,0.0,0.0,0.0,Matches,,,,,,,,,,,,,,,,,,,,,,,,,,,,,,,,,,,,,,,,,,,,,,,,,,,,,,,,435.0,tn TUN,MF,27.0,31.7,5.0,0.0,0.0,34.0,11.0,4.0,13.0,56.0,44.0,0.0,0.0,0.0,250.0,40.0,22.0,64.5,Matches,435.0,tn TUN,MF,27.0,31.7,1717.0,1647.0,65.0,52.0,1.0,9.0,13.0,12.0,0.0,0.0,0.0,0.0,1505.0,5.0,23.0,Matches,435.0,tn TUN,MF,27.0,31.7,1505.0,1717.0,87.7,26548.0,8222.0,615.0,688.0,89.4,739.0,804.0,91.9,126.0,152.0,82.9,1.0,1.8,1.8,-0.8,27.0,112.0,13.0,2.0,155.0,Matches,509,tn TUN,MF,27,32,2856.0,89.0,93.3,31.7,32,89.0,31,0,,0,1.25,46.0,52.0,-6.0,-0.19,-0.63,45.3,40.8,4.5,0.14,-0.22,Matches,435.0,tn TUN,MF,27.0,31.7,2056.0,105.0,583.0,1207.0,287.0,54.0,2056.0,32.0,24.0,75.0,8.0,25.0,1123.0,6762.0,3462.0,50.0,35.0,7.0,27.0,20.0,1263.0,61.0,Matches,435.0,tn TUN,MF,27.0,31.7,7.0,32.0,11.0,34.4,1.01,0.35,0.22,0.64,15.3,0.0,0.0,0.0,5.3,5.3,0.17,1.7,1.7,Matches,435.0,tn TUN,MF,27.0,32.0,32.0,2856.0,31.7,7.0,1.0,8.0,7.0,0.0,0.0,5.0,0.0,5.3,5.3,1.8,7.1,50.0,155.0,61.0,0.22,0.03,0.25,0.22,0.25,0.17,0.06,0.22,0.17,0.22,Matches,Ellyes Skhiri,DM/M C,27,139,143,"Tunisia,France",1. FC Köln,5,11,13,12,14,13,12,15,5,13,14,8,13,13,14,16,13,12,13,12,12,15,12,13,11,14,15,15,13,13,13,13,15,13,19,12,12,10,12,6,13,1,3,2,3,2,2,1,2,2,1,1,14,14,6,15,12,15,12,14,1,1,10,1,5,5,20,7,18,7,1,8,1,1,185,73,8,20,6174703,6748,6748,4998,North_African__Middle_Eastern,139,8,1995/5/10,45,3,28846.0,,85126092
196,Robert Skov,Hoffenheim,1996,436.0,dk DEN,DF,26.0,15.0,22.0,11.0,14.0,7.0,1.0,10.0,26.0,38.5,16.0,22.0,8.0,14.0,8.0,30.0,20.0,2.0,Matches,436.0,dk DEN,DF,26.0,15.0,46.0,3.07,28.0,8.0,2.0,5.0,3.0,0.0,3.0,0.2,2.0,0.0,0.0,1.0,0.0,0.0,Matches,,,,,,,,,,,,,,,,,,,,,,,,,,,,,,,,,,,,,,,,,,,,,,,,,,,,,,,,436.0,dk DEN,DF,26.0,15.0,1.0,0.0,0.0,17.0,21.0,1.0,75.0,8.0,11.0,0.0,0.0,0.0,74.0,15.0,17.0,46.9,Matches,436.0,dk DEN,DF,26.0,15.0,728.0,533.0,195.0,18.0,2.0,7.0,75.0,146.0,31.0,10.0,10.0,1.0,509.0,0.0,21.0,Matches,436.0,dk DEN,DF,26.0,15.0,509.0,728.0,69.9,9105.0,3139.0,232.0,274.0,84.7,213.0,297.0,71.7,54.0,115.0,47.0,2.0,1.8,2.3,0.2,21.0,35.0,22.0,9.0,49.0,Matches,510,dk DEN,DF,26,23,1349.0,59.0,44.1,15.0,16,72.0,4,7,28.0,2,0.96,26.0,22.0,4.0,0.27,0.95,22.8,22.0,0.8,0.05,0.26,Matches,436.0,dk DEN,DF,26.0,15.0,906.0,32.0,210.0,373.0,335.0,37.0,904.0,27.0,7.0,25.9,16.0,59.3,453.0,2377.0,1188.0,43.0,26.0,12.0,21.0,11.0,481.0,97.0,Matches,436.0,dk DEN,DF,26.0,15.0,3.0,39.0,12.0,30.8,2.6,0.8,0.03,0.08,22.5,8.0,2.0,2.0,3.4,1.8,0.05,-0.4,-0.8,Matches,436.0,dk DEN,DF,26.0,23.0,16.0,1349.0,15.0,3.0,2.0,5.0,1.0,2.0,2.0,1.0,0.0,3.4,1.8,1.8,3.6,43.0,49.0,97.0,0.2,0.13,0.33,0.07,0.2,0.23,0.12,0.34,0.12,0.24,Matches,Robert Skov,WB/M/AM RL,26,142,145,"Denmark,Spain",TSG Hoffenheim,15,13,12,10,11,16,9,15,8,8,14,15,10,14,12,14,10,15,13,14,13,13,15,8,16,9,13,13,13,13,10,11,12,13,14,10,13,8,11,10,19,1,3,2,3,1,2,3,2,1,1,2,12,15,4,12,15,14,17,16,1,15,1,10,15,16,1,15,10,18,16,12,20,8,185,81,20,12,17083737,7100,6750,6100,Northern_European,133,4,1996/5/20,11,5,38462.0,,27094768
197,Danilo Soares,Bochum,1991,438.0,br BRA,DF,30.0,19.6,72.0,46.0,42.0,23.0,7.0,43.0,72.0,59.7,29.0,29.0,6.0,23.0,30.0,102.0,56.0,1.0,Matches,438.0,br BRA,DF,30.0,19.6,34.0,1.73,30.0,1.0,0.0,0.0,2.0,1.0,2.0,0.1,2.0,0.0,0.0,0.0,0.0,0.0,Matches,,,,,,,,,,,,,,,,,,,,,,,,,,,,,,,,,,,,,,,,,,,,,,,,,,,,,,,,438.0,br BRA,DF,30.0,19.6,6.0,0.0,0.0,28.0,24.0,0.0,17.0,30.0,46.0,0.0,2.0,0.0,175.0,24.0,18.0,57.1,Matches,438.0,br BRA,DF,30.0,19.6,1004.0,798.0,199.0,9.0,1.0,2.0,17.0,189.0,1.0,0.0,1.0,0.0,751.0,7.0,20.0,Matches,438.0,br BRA,DF,30.0,19.6,751.0,1004.0,74.8,13624.0,5004.0,333.0,383.0,86.9,312.0,412.0,75.7,92.0,159.0,57.9,0.0,1.3,1.1,-1.3,11.0,82.0,14.0,5.0,93.0,Matches,513,br BRA,DF,30,23,1766.0,77.0,57.7,19.6,23,77.0,13,0,,4,1.17,26.0,40.0,-14.0,-0.71,0.54,24.9,32.5,-7.6,-0.39,0.88,Matches,438.0,br BRA,DF,30.0,19.6,1251.0,90.0,469.0,643.0,154.0,2.0,1251.0,22.0,8.0,36.4,12.0,54.5,507.0,2188.0,908.0,17.0,18.0,2.0,17.0,13.0,522.0,24.0,Matches,438.0,br BRA,DF,30.0,19.6,0.0,2.0,0.0,0.0,0.1,0.0,0.0,,29.1,0.0,0.0,0.0,0.0,0.0,0.01,0.0,0.0,Matches,438.0,br BRA,DF,30.0,23.0,23.0,1766.0,19.6,0.0,0.0,0.0,0.0,0.0,0.0,6.0,0.0,0.0,0.0,1.3,1.3,17.0,93.0,24.0,0.0,0.0,0.0,0.0,0.0,0.0,0.06,0.07,0.0,0.07,Matches,Danilo Soares,D/WB L,30,126,134,Brazil,VfL Bochum 1848,8,15,12,6,12,7,10,8,12,12,13,8,15,13,14,13,14,13,10,12,11,14,12,8,11,11,12,15,14,15,15,7,10,12,13,10,15,13,14,8,9,3,2,3,1,3,2,1,3,2,3,3,13,15,12,12,11,11,8,10,1,20,1,1,20,1,1,14,1,1,14,1,1,1,170,72,20,11,2148593,6300,5548,4350,Mediterranean_Hispanic,121,6,1991/10/29,0,0,7499.0,,16063849
198,Yann Sommer,Gladbach,1988,440.0,ch SUI,GK,33.0,10.0,1.0,0.0,1.0,0.0,0.0,1.0,1.0,100.0,0.0,0.0,0.0,0.0,0.0,1.0,8.0,0.0,Matches,440.0,ch SUI,GK,33.0,10.0,2.0,0.2,2.0,0.0,0.0,0.0,0.0,0.0,0.0,0.0,0.0,0.0,0.0,0.0,0.0,0.0,Matches,30.0,ch SUI,GK,33.0,10.0,14.0,2.0,1.0,0.0,1.0,16.7,0.25,3.7,0.37,48.0,141.0,34.0,517.0,52.0,23.0,28.2,90.0,24.4,28.6,162.0,5.0,3.1,13.0,1.3,14.6,Matches,30.0,ch SUI,GK,33.0,10.0,10.0,900.0,10.0,14.0,1.4,60.0,47.0,80.0,4.0,4.0,2.0,3.0,30.0,2.0,2.0,0.0,0.0,0.0,Matches,440.0,ch SUI,GK,33.0,10.0,0.0,0.0,0.0,0.0,0.0,0.0,0.0,0.0,0.0,0.0,0.0,0.0,14.0,0.0,1.0,0.0,Matches,440.0,ch SUI,GK,33.0,10.0,609.0,483.0,124.0,34.0,0.0,2.0,0.0,0.0,0.0,0.0,0.0,0.0,499.0,2.0,0.0,Matches,440.0,ch SUI,GK,33.0,10.0,499.0,609.0,81.9,11448.0,7432.0,124.0,125.0,99.2,280.0,285.0,98.2,94.0,196.0,48.0,0.0,0.0,0.0,0.0,0.0,5.0,0.0,0.0,0.0,Matches,515,ch SUI,GK,33,10,900.0,90.0,29.4,10.0,10,90.0,10,0,,0,1.6,18.0,14.0,4.0,0.4,0.69,17.5,12.8,4.7,0.47,0.72,Matches,440.0,ch SUI,GK,33.0,10.0,638.0,444.0,636.0,2.0,0.0,0.0,638.0,0.0,0.0,,0.0,,420.0,1803.0,981.0,0.0,0.0,0.0,0.0,0.0,405.0,0.0,Matches,440.0,ch SUI,GK,33.0,10.0,0.0,0.0,0.0,,0.0,0.0,,,,0.0,0.0,0.0,0.0,0.0,,0.0,0.0,Matches,440.0,ch SUI,GK,33.0,10.0,10.0,900.0,10.0,0.0,0.0,0.0,0.0,0.0,0.0,0.0,0.0,0.0,0.0,0.0,0.0,0.0,0.0,0.0,0.0,0.0,0.0,0.0,0.0,0.0,0.0,0.0,0.0,0.0,Matches,Yann Sommer,GK,33,153,155,Switzerland,Borussia Mönchengladbach,3,3,2,1,11,6,6,2,2,2,12,3,3,12,13,14,14,16,15,11,15,16,10,16,1,16,12,12,11,14,14,13,18,11,12,11,16,7,18,4,16,12,13,14,14,14,13,16,18,18,8,12,14,15,6,15,12,17,12,14,20,1,1,5,1,5,1,1,1,3,1,1,3,1,183,79,8,20,20922652,7649,7699,6649,Northern_European,152,7,1988/12/17,74,0,76711.0,,69000199
199,Borna Sosa,Stuttgart,1998,442.0,hr CRO,DF,24.0,21.7,27.0,21.0,18.0,8.0,1.0,21.0,32.0,65.6,11.0,20.0,5.0,15.0,19.0,46.0,37.0,0.0,Matches,442.0,hr CRO,DF,24.0,21.7,109.0,5.01,70.0,36.0,1.0,1.0,1.0,0.0,10.0,0.46,9.0,1.0,0.0,0.0,0.0,0.0,Matches,,,,,,,,,,,,,,,,,,,,,,,,,,,,,,,,,,,,,,,,,,,,,,,,,,,,,,,,442.0,hr CRO,DF,24.0,21.7,5.0,0.0,0.0,12.0,12.0,0.0,255.0,19.0,21.0,0.0,0.0,0.0,113.0,15.0,13.0,53.6,Matches,442.0,hr CRO,DF,24.0,21.7,1458.0,1134.0,322.0,68.0,1.0,12.0,255.0,175.0,79.0,29.0,44.0,0.0,1076.0,2.0,23.0,Matches,442.0,hr CRO,DF,24.0,21.7,1076.0,1458.0,73.8,18458.0,7607.0,558.0,626.0,89.1,375.0,515.0,72.8,116.0,256.0,45.3,7.0,6.5,8.2,0.5,67.0,80.0,57.0,37.0,128.0,Matches,517,hr CRO,DF,24,25,1955.0,78.0,63.9,21.7,22,85.0,16,3,25.0,0,1.08,31.0,38.0,-7.0,-0.32,0.08,31.9,27.7,4.3,0.2,0.35,Matches,442.0,hr CRO,DF,24.0,21.7,1630.0,51.0,386.0,631.0,630.0,20.0,1630.0,33.0,17.0,51.5,13.0,39.4,890.0,4751.0,2414.0,58.0,54.0,8.0,20.0,16.0,999.0,152.0,Matches,442.0,hr CRO,DF,24.0,21.7,2.0,15.0,6.0,40.0,0.69,0.28,0.13,0.33,20.7,6.0,0.0,0.0,1.0,1.0,0.07,1.0,1.0,Matches,442.0,hr CRO,DF,24.0,25.0,22.0,1955.0,21.7,2.0,7.0,9.0,2.0,0.0,0.0,5.0,0.0,1.0,1.0,6.5,7.6,58.0,128.0,152.0,0.09,0.32,0.41,0.09,0.41,0.05,0.3,0.35,0.05,0.35,Matches,Borna Sosa,D/WB/M L,24,134,142,"Croatia,Germany",VfB Stuttgart,14,16,14,7,13,14,10,9,13,11,14,8,12,14,9,12,12,12,12,14,14,12,14,10,13,11,14,13,14,13,10,11,14,16,13,11,14,7,14,8,11,1,1,2,2,3,3,3,2,1,2,2,14,17,8,9,13,15,12,14,1,20,1,1,20,1,1,16,1,1,10,1,1,1,187,79,20,8,6320982,6650,6550,5750,Mediterranean_Hispanic,129,6,1998/1/21,6,0,13461.0,,24048099
200,Djibril Sow,Eint Frankfurt,1997,443.0,ch SUI,MF,25.0,29.4,41.0,25.0,13.0,25.0,3.0,22.0,44.0,50.0,22.0,22.0,4.0,18.0,28.0,69.0,23.0,0.0,Matches,443.0,ch SUI,MF,25.0,29.4,49.0,1.67,40.0,0.0,2.0,3.0,2.0,2.0,3.0,0.1,1.0,0.0,1.0,1.0,0.0,0.0,Matches,,,,,,,,,,,,,,,,,,,,,,,,,,,,,,,,,,,,,,,,,,,,,,,,,,,,,,,,443.0,ch SUI,MF,25.0,29.4,9.0,0.0,0.0,39.0,49.0,0.0,5.0,28.0,25.0,0.0,0.0,0.0,210.0,24.0,28.0,46.2,Matches,443.0,ch SUI,MF,25.0,29.4,1557.0,1510.0,38.0,32.0,6.0,2.0,5.0,3.0,0.0,0.0,0.0,0.0,1324.0,9.0,20.0,Matches,443.0,ch SUI,MF,25.0,29.4,1324.0,1557.0,85.0,22905.0,6804.0,566.0,639.0,88.6,627.0,694.0,90.3,103.0,147.0,70.1,0.0,1.0,1.3,-1.0,17.0,137.0,20.0,1.0,186.0,Matches,518,ch SUI,MF,25,32,2646.0,83.0,86.5,29.4,30,87.0,23,2,22.0,1,1.5,48.0,43.0,5.0,0.17,-0.05,45.8,38.3,7.5,0.26,0.01,Matches,443.0,ch SUI,MF,25.0,29.4,1810.0,50.0,361.0,1190.0,276.0,25.0,1810.0,21.0,11.0,52.4,6.0,28.6,1100.0,5055.0,2447.0,35.0,36.0,4.0,24.0,16.0,1234.0,29.0,Matches,443.0,ch SUI,MF,25.0,29.4,4.0,28.0,10.0,35.7,0.95,0.34,0.14,0.4,24.8,0.0,0.0,0.0,1.7,1.7,0.06,2.3,2.3,Matches,443.0,ch SUI,MF,25.0,32.0,30.0,2646.0,29.4,4.0,0.0,4.0,4.0,0.0,0.0,9.0,0.0,1.7,1.7,1.0,2.8,35.0,186.0,29.0,0.14,0.0,0.14,0.14,0.14,0.06,0.04,0.09,0.06,0.09,Matches,Djibril Sow,DM/M C,25,137,144,"Switzerland,Senegal",Eintracht Frankfurt,8,10,13,9,13,8,9,12,7,10,14,10,12,14,15,12,10,13,11,14,13,12,10,9,14,11,13,16,13,13,12,12,17,17,16,12,12,8,11,7,12,2,2,2,3,2,3,2,1,1,1,1,9,16,5,12,10,15,14,17,1,1,1,1,1,1,16,10,20,10,10,14,10,1,184,76,11,20,11846703,7000,6750,6250,Mixed_Race,135,13,1997/2/6,30,0,41665.0,,98034373
201,Anton Stach,Mainz 05,1998,444.0,de GER,MF,23.0,23.0,27.0,21.0,10.0,15.0,2.0,16.0,38.0,42.1,22.0,28.0,2.0,26.0,41.0,68.0,25.0,0.0,Matches,444.0,de GER,MF,23.0,23.0,59.0,2.56,36.0,10.0,4.0,1.0,5.0,3.0,6.0,0.26,4.0,1.0,1.0,0.0,0.0,0.0,Matches,,,,,,,,,,,,,,,,,,,,,,,,,,,,,,,,,,,,,,,,,,,,,,,,,,,,,,,,444.0,de GER,MF,23.0,23.0,4.0,0.0,0.0,26.0,40.0,3.0,62.0,41.0,21.0,0.0,1.0,0.0,167.0,72.0,31.0,69.9,Matches,444.0,de GER,MF,23.0,23.0,897.0,832.0,60.0,29.0,6.0,5.0,62.0,5.0,26.0,20.0,3.0,0.0,619.0,5.0,23.0,Matches,444.0,de GER,MF,23.0,23.0,619.0,897.0,69.0,9824.0,3597.0,321.0,423.0,75.9,218.0,298.0,73.2,50.0,105.0,47.6,4.0,3.6,4.0,0.4,31.0,70.0,25.0,6.0,106.0,Matches,519,de GER,MF,23,30,2070.0,69.0,67.6,23.0,22,83.0,9,8,32.0,1,1.4,35.0,36.0,-1.0,-0.04,-0.04,31.5,35.0,-3.4,-0.15,0.13,Matches,444.0,de GER,MF,23.0,23.0,1172.0,34.0,212.0,644.0,345.0,50.0,1172.0,51.0,25.0,49.0,21.0,41.2,549.0,3090.0,1519.0,37.0,28.0,7.0,45.0,16.0,655.0,77.0,Matches,444.0,de GER,MF,23.0,23.0,1.0,36.0,10.0,27.8,1.57,0.43,0.03,0.1,22.6,4.0,0.0,0.0,2.2,2.2,0.06,-1.2,-1.2,Matches,444.0,de GER,MF,23.0,30.0,22.0,2070.0,23.0,1.0,4.0,5.0,1.0,0.0,0.0,4.0,0.0,2.2,2.2,3.6,5.8,37.0,106.0,77.0,0.04,0.17,0.22,0.04,0.22,0.1,0.16,0.25,0.1,0.25,Matches,Anton Stach,DM/M/AM C,23,135,148,Germany,1. FSV Mainz 05,14,9,12,10,12,13,12,13,3,13,13,7,13,13,16,13,15,13,12,13,12,19,13,11,12,13,16,17,12,11,13,16,17,15,14,14,15,12,14,6,17,1,1,1,1,3,2,2,1,3,3,1,15,17,4,8,16,18,10,10,1,1,10,1,1,1,18,10,20,10,10,16,10,8,193,86,12,20,13109780,6750,6750,5500,Northern_European,134,2,1998/11/15,2,0,16300.0,,91194540
202,Kostas Stafylidis,Bochum,1993,445.0,gr GRE,DFMF,28.0,11.6,27.0,16.0,13.0,8.0,6.0,10.0,24.0,41.7,14.0,21.0,8.0,13.0,20.0,47.0,31.0,1.0,Matches,445.0,gr GRE,DFMF,28.0,11.6,18.0,1.56,10.0,4.0,1.0,2.0,1.0,0.0,3.0,0.26,2.0,1.0,0.0,0.0,0.0,0.0,Matches,,,,,,,,,,,,,,,,,,,,,,,,,,,,,,,,,,,,,,,,,,,,,,,,,,,,,,,,445.0,gr GRE,DFMF,28.0,11.6,4.0,0.0,0.0,16.0,16.0,0.0,26.0,20.0,16.0,0.0,0.0,0.0,73.0,14.0,20.0,41.2,Matches,445.0,gr GRE,DFMF,28.0,11.6,423.0,360.0,61.0,10.0,1.0,8.0,26.0,48.0,3.0,1.0,2.0,0.0,297.0,2.0,9.0,Matches,445.0,gr GRE,DFMF,28.0,11.6,297.0,423.0,70.2,5874.0,2037.0,113.0,128.0,88.3,139.0,190.0,73.2,42.0,89.0,47.2,2.0,0.7,0.7,1.3,7.0,23.0,5.0,4.0,26.0,Matches,520,gr GRE,DFMF,28,19,1043.0,55.0,34.1,11.6,11,75.0,5,8,28.0,3,1.21,12.0,23.0,-11.0,-0.95,-0.01,12.7,24.0,-11.4,-0.98,-0.35,Matches,445.0,gr GRE,DFMF,28.0,11.6,564.0,43.0,187.0,288.0,92.0,3.0,564.0,14.0,8.0,57.1,4.0,28.6,240.0,1139.0,520.0,9.0,7.0,1.0,11.0,3.0,267.0,14.0,Matches,445.0,gr GRE,DFMF,28.0,11.6,0.0,14.0,2.0,14.3,1.21,0.17,0.0,0.0,29.5,1.0,0.0,0.0,0.4,0.4,0.03,-0.4,-0.4,Matches,445.0,gr GRE,DFMF,28.0,19.0,11.0,1043.0,11.6,0.0,2.0,2.0,0.0,0.0,0.0,4.0,0.0,0.4,0.4,0.7,1.1,9.0,26.0,14.0,0.0,0.17,0.17,0.0,0.17,0.03,0.06,0.09,0.03,0.09,Matches,Kostas Stafylidis,D/WB L,28,125,132,Greece,VfL Bochum 1848,15,14,9,8,11,13,10,14,14,10,13,12,16,12,12,12,16,14,10,12,14,16,9,13,10,11,12,14,11,12,16,10,15,12,14,13,11,13,12,11,10,1,3,3,3,3,3,2,1,1,3,3,13,15,8,12,16,12,11,8,1,20,14,1,18,1,10,12,10,1,12,1,1,1,178,72,20,8,842467,6150,5750,4750,Mediterranean_Hispanic,125,6,1993/12/2,32,2,12499.0,,36045448
203,Jens Stage,Werder Bremen,1996,446.0,dk DEN,MF,25.0,20.6,34.0,17.0,15.0,18.0,1.0,10.0,37.0,27.0,27.0,34.0,11.0,23.0,16.0,50.0,37.0,0.0,Matches,446.0,dk DEN,MF,25.0,20.6,31.0,1.51,29.0,0.0,0.0,0.0,1.0,1.0,6.0,0.29,6.0,0.0,0.0,0.0,0.0,0.0,Matches,,,,,,,,,,,,,,,,,,,,,,,,,,,,,,,,,,,,,,,,,,,,,,,,,,,,,,,,446.0,dk DEN,MF,25.0,20.6,5.0,0.0,0.0,32.0,19.0,0.0,13.0,16.0,17.0,0.0,0.0,0.0,95.0,52.0,45.0,53.6,Matches,446.0,dk DEN,MF,25.0,20.6,622.0,609.0,5.0,2.0,2.0,6.0,13.0,0.0,0.0,0.0,0.0,0.0,412.0,8.0,27.0,Matches,446.0,dk DEN,MF,25.0,20.6,412.0,622.0,66.2,6130.0,2060.0,236.0,307.0,76.9,142.0,196.0,72.4,19.0,51.0,37.3,3.0,1.8,2.6,1.2,16.0,34.0,20.0,3.0,61.0,Matches,521,dk DEN,MF,25,32,1855.0,58.0,60.6,20.6,21,79.0,7,11,18.0,1,1.09,31.0,37.0,-6.0,-0.29,0.23,23.3,29.7,-6.4,-0.31,0.09,Matches,446.0,dk DEN,MF,25.0,20.6,834.0,47.0,200.0,429.0,213.0,57.0,834.0,16.0,9.0,56.3,5.0,31.3,368.0,1523.0,655.0,19.0,17.0,6.0,25.0,11.0,485.0,55.0,Matches,446.0,dk DEN,MF,25.0,20.6,3.0,19.0,7.0,36.8,0.92,0.34,0.16,0.43,12.5,0.0,0.0,0.0,3.1,3.1,0.16,-0.1,-0.1,Matches,446.0,dk DEN,MF,25.0,32.0,21.0,1855.0,20.6,3.0,3.0,6.0,3.0,0.0,0.0,5.0,0.0,3.1,3.1,1.8,4.9,19.0,61.0,55.0,0.15,0.15,0.29,0.15,0.29,0.15,0.09,0.24,0.15,0.24,Matches,Jens Stage,M RC,25,130,133,Denmark,SV Werder Bremen,5,9,10,12,11,7,14,11,11,13,12,10,14,10,16,14,15,13,13,11,13,16,8,15,14,13,15,18,13,11,11,15,14,13,16,14,13,7,15,8,20,1,1,4,4,2,3,4,1,3,1,1,10,13,1,14,15,16,15,15,1,10,1,10,1,1,14,12,20,15,1,1,13,1,187,83,9,20,7811012,6750,6350,2504,Northern_European,127,4,1996/11/8,1,0,11474.0,,27104982
204,Niklas Stark,Werder Bremen,1995,449.0,de GER,DF,27.0,23.1,56.0,36.0,29.0,24.0,3.0,27.0,42.0,64.3,15.0,24.0,13.0,11.0,37.0,93.0,110.0,0.0,Matches,449.0,de GER,DF,27.0,23.1,11.0,0.48,11.0,0.0,0.0,0.0,0.0,0.0,0.0,0.0,0.0,0.0,0.0,0.0,0.0,0.0,Matches,,,,,,,,,,,,,,,,,,,,,,,,,,,,,,,,,,,,,,,,,,,,,,,,,,,,,,,,449.0,de GER,DF,27.0,23.1,9.0,0.0,0.0,41.0,18.0,1.0,2.0,37.0,36.0,0.0,0.0,0.0,113.0,45.0,53.0,45.9,Matches,449.0,de GER,DF,27.0,23.1,1244.0,1205.0,38.0,34.0,1.0,5.0,2.0,4.0,0.0,0.0,0.0,0.0,1027.0,1.0,10.0,Matches,449.0,de GER,DF,27.0,23.1,1027.0,1244.0,82.6,21155.0,8160.0,287.0,324.0,88.6,587.0,660.0,88.9,145.0,229.0,63.3,0.0,0.3,0.4,-0.3,4.0,57.0,5.0,1.0,65.0,Matches,524,de GER,DF,27,27,2077.0,77.0,67.9,23.1,23,86.0,18,4,26.0,4,1.07,35.0,42.0,-7.0,-0.3,0.25,26.5,38.0,-11.5,-0.5,-0.47,Matches,449.0,de GER,DF,27.0,23.1,1516.0,174.0,812.0,673.0,39.0,11.0,1516.0,2.0,2.0,100.0,0.0,0.0,839.0,4648.0,2452.0,9.0,6.0,0.0,11.0,4.0,909.0,3.0,Matches,449.0,de GER,DF,27.0,23.1,0.0,3.0,1.0,33.3,0.13,0.04,0.0,0.0,10.1,0.0,0.0,0.0,0.2,0.2,0.07,-0.2,-0.2,Matches,449.0,de GER,DF,27.0,27.0,23.0,2077.0,23.1,0.0,0.0,0.0,0.0,0.0,0.0,9.0,0.0,0.2,0.2,0.3,0.5,9.0,65.0,3.0,0.0,0.0,0.0,0.0,0.0,0.01,0.01,0.02,0.01,0.02,Matches,Niklas Stark,D C,27,135,138,Germany,SV Werder Bremen,6,8,10,9,12,7,13,10,10,13,12,8,13,11,13,13,14,13,11,10,13,13,7,11,10,13,18,16,13,12,13,15,15,14,14,14,10,11,12,13,14,3,3,1,2,1,3,2,1,4,2,4,11,17,8,13,9,18,15,14,1,10,20,1,1,1,12,1,8,1,1,1,1,1,190,88,12,20,9909595,6878,6878,6228,Northern_European,133,5,1995/4/14,2,0,27499.0,,91109615
205,Lars Stindl,Gladbach,1988,452.0,de GER,FWMF,33.0,19.3,24.0,14.0,4.0,17.0,3.0,10.0,28.0,35.7,18.0,24.0,5.0,19.0,11.0,35.0,19.0,0.0,Matches,452.0,de GER,FWMF,33.0,19.3,81.0,4.2,53.0,9.0,2.0,9.0,6.0,2.0,10.0,0.52,7.0,1.0,0.0,2.0,0.0,0.0,Matches,,,,,,,,,,,,,,,,,,,,,,,,,,,,,,,,,,,,,,,,,,,,,,,,,,,,,,,,452.0,de GER,FWMF,33.0,19.3,9.0,0.0,0.0,30.0,39.0,8.0,19.0,11.0,14.0,0.0,0.0,0.0,72.0,9.0,28.0,24.3,Matches,452.0,de GER,FWMF,33.0,19.3,776.0,742.0,31.0,15.0,6.0,4.0,19.0,3.0,11.0,2.0,9.0,0.0,624.0,3.0,28.0,Matches,452.0,de GER,FWMF,33.0,19.3,624.0,776.0,80.4,9604.0,2627.0,341.0,398.0,85.7,203.0,238.0,85.3,45.0,64.0,70.3,7.0,6.2,3.5,0.8,40.0,67.0,17.0,1.0,77.0,Matches,527,de GER,FWMF,33,29,1734.0,60.0,56.7,19.3,20,77.0,1,9,21.0,2,1.21,33.0,30.0,3.0,0.16,0.56,29.7,31.1,-1.4,-0.07,-0.08,Matches,452.0,de GER,FWMF,33.0,19.3,980.0,22.0,127.0,554.0,301.0,47.0,980.0,22.0,8.0,36.4,11.0,50.0,552.0,2050.0,903.0,22.0,21.0,2.0,33.0,27.0,771.0,89.0,Matches,452.0,de GER,FWMF,33.0,19.3,8.0,50.0,22.0,44.0,2.6,1.14,0.16,0.36,20.7,3.0,0.0,0.0,5.0,5.0,0.1,3.0,3.0,Matches,452.0,de GER,FWMF,33.0,29.0,20.0,1734.0,19.3,8.0,7.0,15.0,8.0,0.0,0.0,9.0,0.0,5.0,5.0,6.2,11.2,22.0,77.0,89.0,0.42,0.36,0.78,0.42,0.78,0.26,0.32,0.58,0.26,0.58,Matches,Lars Stindl,AM/S LC,33,135,142,Germany,Borussia Mönchengladbach,13,12,11,13,14,14,12,13,4,8,14,15,9,14,17,12,13,14,13,15,13,16,12,16,13,9,17,16,12,12,13,10,17,11,13,11,12,14,14,10,17,2,2,3,3,2,1,4,3,2,2,1,9,12,11,17,12,17,8,9,1,1,1,1,1,1,8,10,15,10,15,18,12,20,181,80,12,20,1429674,6750,6750,5750,Northern_European,127,4,1988/8/26,11,4,67122.0,,35011818
206,Kevin Stöger,Bochum,1993,453.0,at AUT,MF,28.0,28.9,84.0,45.0,38.0,32.0,14.0,31.0,94.0,33.0,63.0,27.0,4.0,23.0,26.0,110.0,21.0,1.0,Matches,453.0,at AUT,MF,28.0,28.9,138.0,4.78,81.0,40.0,3.0,5.0,7.0,2.0,11.0,0.38,8.0,2.0,0.0,0.0,1.0,0.0,Matches,,,,,,,,,,,,,,,,,,,,,,,,,,,,,,,,,,,,,,,,,,,,,,,,,,,,,,,,453.0,at AUT,MF,28.0,28.9,3.0,0.0,0.0,41.0,54.0,0.0,156.0,26.0,45.0,0.0,0.0,0.0,181.0,11.0,42.0,20.8,Matches,453.0,at AUT,MF,28.0,28.9,1607.0,1351.0,242.0,99.0,9.0,8.0,156.0,18.0,85.0,37.0,37.0,1.0,1114.0,14.0,36.0,Matches,453.0,at AUT,MF,28.0,28.9,1114.0,1607.0,69.3,20465.0,7740.0,504.0,609.0,82.8,414.0,570.0,72.6,163.0,321.0,50.8,3.0,5.7,7.8,-2.7,68.0,153.0,46.0,11.0,214.0,Matches,528,at AUT,MF,28,32,2599.0,81.0,84.9,28.9,29,85.0,18,3,48.0,0,1.0,33.0,62.0,-29.0,-1.0,-0.42,35.0,55.6,-20.6,-0.71,0.28,Matches,453.0,at AUT,MF,28.0,28.9,1917.0,32.0,281.0,1081.0,571.0,37.0,1914.0,52.0,22.0,42.3,21.0,40.4,901.0,4339.0,2056.0,43.0,40.0,3.0,43.0,35.0,1134.0,98.0,Matches,453.0,at AUT,MF,28.0,28.9,5.0,45.0,11.0,24.4,1.56,0.38,0.04,0.18,25.8,7.0,3.0,3.0,4.4,2.1,0.05,0.6,-0.1,Matches,453.0,at AUT,MF,28.0,32.0,29.0,2599.0,28.9,5.0,3.0,8.0,2.0,3.0,3.0,3.0,0.0,4.4,2.1,5.7,7.7,43.0,214.0,98.0,0.17,0.1,0.28,0.07,0.17,0.15,0.2,0.35,0.07,0.27,Matches,Kevin Stöger,M/AM C,28,125,136,Austria,VfL Bochum 1848,14,13,12,10,13,14,4,11,3,11,16,9,12,15,16,12,13,15,11,15,13,11,13,4,11,12,12,13,11,12,13,6,13,10,15,9,12,11,13,7,12,1,1,3,1,3,1,2,3,3,3,2,11,12,10,9,12,12,9,10,1,1,1,1,1,1,15,10,20,10,10,16,10,8,175,74,20,11,2596726,6248,6098,4498,Northern_European,123,5,1993/8/27,0,0,12499.0,,92012093
207,Niklas Süle,Dortmund,1995,454.0,de GER,DF,26.0,23.5,25.0,19.0,18.0,3.0,4.0,14.0,23.0,60.9,9.0,28.0,19.0,9.0,17.0,42.0,53.0,0.0,Matches,454.0,de GER,DF,26.0,23.5,41.0,1.74,32.0,0.0,3.0,6.0,0.0,0.0,6.0,0.25,3.0,0.0,1.0,2.0,0.0,0.0,Matches,,,,,,,,,,,,,,,,,,,,,,,,,,,,,,,,,,,,,,,,,,,,,,,,,,,,,,,,454.0,de GER,DF,26.0,23.5,2.0,0.0,0.0,8.0,5.0,0.0,16.0,17.0,19.0,0.0,0.0,0.0,150.0,32.0,17.0,65.3,Matches,454.0,de GER,DF,26.0,23.5,1851.0,1751.0,99.0,47.0,1.0,34.0,16.0,52.0,0.0,0.0,0.0,0.0,1677.0,1.0,17.0,Matches,454.0,de GER,DF,26.0,23.5,1677.0,1851.0,90.6,31584.0,10145.0,659.0,701.0,94.0,770.0,830.0,92.8,211.0,260.0,81.2,3.0,2.2,1.6,0.8,17.0,116.0,9.0,2.0,137.0,Matches,530,de GER,DF,26,29,2118.0,73.0,69.2,23.5,23,87.0,20,6,19.0,2,2.07,61.0,33.0,28.0,1.19,0.14,52.6,32.8,19.8,0.84,0.07,Matches,454.0,de GER,DF,26.0,23.5,2031.0,178.0,811.0,1013.0,217.0,40.0,2031.0,10.0,9.0,90.0,1.0,10.0,1321.0,6298.0,3500.0,37.0,36.0,1.0,10.0,8.0,1527.0,57.0,Matches,454.0,de GER,DF,26.0,23.5,2.0,33.0,7.0,21.2,1.4,0.3,0.06,0.29,17.2,0.0,0.0,0.0,2.2,2.2,0.07,-0.2,-0.2,Matches,454.0,de GER,DF,26.0,29.0,23.0,2118.0,23.5,2.0,3.0,5.0,2.0,0.0,0.0,2.0,0.0,2.2,2.2,2.2,4.4,37.0,137.0,57.0,0.08,0.13,0.21,0.08,0.21,0.09,0.09,0.19,0.09,0.19,Matches,Niklas Süle,D RC,26,154,162,Germany,Borussia Dortmund,4,12,12,8,12,5,15,12,11,15,13,10,16,12,11,14,15,14,14,12,13,15,11,11,11,15,12,12,12,10,17,17,12,16,13,18,14,8,16,8,12,2,2,1,2,2,2,2,3,1,1,2,6,12,13,9,13,9,10,12,1,10,20,17,8,12,12,1,10,1,1,1,1,1,195,99,12,20,42162119,7494,7494,6994,Northern_European,154,3,1995/9/3,40,1,192307.0,,91107360
208,Ivan Šunjić,Hertha BSC,1996,455.0,hr CRO,MF,25.0,11.0,38.0,20.0,16.0,21.0,1.0,16.0,24.0,66.7,8.0,17.0,5.0,12.0,13.0,51.0,19.0,1.0,Matches,455.0,hr CRO,MF,25.0,11.0,17.0,1.54,14.0,0.0,0.0,2.0,1.0,0.0,2.0,0.18,2.0,0.0,0.0,0.0,0.0,0.0,Matches,,,,,,,,,,,,,,,,,,,,,,,,,,,,,,,,,,,,,,,,,,,,,,,,,,,,,,,,455.0,hr CRO,MF,25.0,11.0,4.0,0.0,0.0,17.0,9.0,1.0,1.0,13.0,20.0,0.0,0.0,0.0,67.0,7.0,14.0,33.3,Matches,455.0,hr CRO,MF,25.0,11.0,361.0,350.0,11.0,4.0,2.0,3.0,1.0,0.0,0.0,0.0,0.0,0.0,270.0,0.0,11.0,Matches,455.0,hr CRO,MF,25.0,11.0,270.0,361.0,74.8,4449.0,1498.0,144.0,172.0,83.7,92.0,118.0,78.0,24.0,45.0,53.3,0.0,0.2,0.4,-0.2,4.0,34.0,4.0,0.0,30.0,Matches,531,hr CRO,MF,25,18,993.0,55.0,32.5,11.0,12,74.0,6,6,18.0,7,1.0,14.0,23.0,-9.0,-0.82,-0.03,12.8,17.1,-4.3,-0.39,0.32,Matches,455.0,hr CRO,MF,25.0,11.0,478.0,31.0,127.0,305.0,54.0,7.0,478.0,6.0,0.0,0.0,5.0,83.3,199.0,778.0,321.0,6.0,5.0,2.0,7.0,6.0,240.0,6.0,Matches,455.0,hr CRO,MF,25.0,11.0,0.0,6.0,3.0,50.0,0.54,0.27,0.0,0.0,16.8,0.0,0.0,0.0,0.6,0.6,0.11,-0.6,-0.6,Matches,455.0,hr CRO,MF,25.0,18.0,12.0,993.0,11.0,0.0,0.0,0.0,0.0,0.0,0.0,4.0,0.0,0.6,0.6,0.2,0.8,6.0,30.0,6.0,0.0,0.0,0.0,0.0,0.0,0.06,0.01,0.07,0.06,0.07,Matches,Ivan Šunjić,DM/M C,25,126,144,"Croatia,Bosnia and Herzegovina",Birmingham City,7,5,9,8,10,3,13,13,9,14,10,6,14,10,15,15,18,9,14,10,11,18,6,13,8,16,17,18,12,11,12,13,15,12,16,13,11,8,13,5,9,1,2,1,1,2,2,4,2,3,1,2,9,12,3,15,14,14,15,12,1,1,10,1,1,1,20,1,19,1,1,1,1,1,184,75,10,20,4690706,6148,5848,4023,Northern_European,123,2,1996/10/9,1,0,19719.0,Hertha Berlin,24039617
209,Mattias Svanberg,Wolfsburg,1999,456.0,se SWE,MFFW,23.0,20.4,25.0,16.0,8.0,16.0,1.0,10.0,30.0,33.3,20.0,27.0,5.0,22.0,21.0,46.0,25.0,1.0,Matches,456.0,se SWE,MFFW,23.0,20.4,53.0,2.6,35.0,4.0,4.0,5.0,5.0,0.0,9.0,0.44,6.0,0.0,0.0,1.0,2.0,0.0,Matches,,,,,,,,,,,,,,,,,,,,,,,,,,,,,,,,,,,,,,,,,,,,,,,,,,,,,,,,456.0,se SWE,MFFW,23.0,20.4,4.0,0.0,0.0,27.0,28.0,4.0,37.0,21.0,16.0,0.0,0.0,0.0,97.0,20.0,34.0,37.0,Matches,456.0,se SWE,MFFW,23.0,20.4,567.0,532.0,34.0,8.0,3.0,5.0,37.0,5.0,13.0,11.0,2.0,0.0,394.0,1.0,14.0,Matches,456.0,se SWE,MFFW,23.0,20.4,394.0,567.0,69.5,6388.0,1971.0,188.0,247.0,76.1,146.0,191.0,76.4,38.0,74.0,51.4,6.0,5.0,4.4,1.0,27.0,34.0,23.0,6.0,74.0,Matches,532,se SWE,MFFW,23,32,1835.0,57.0,60.0,20.4,21,74.0,7,11,26.0,1,1.41,35.0,35.0,0.0,0.0,-0.66,32.2,29.9,2.2,0.11,0.27,Matches,456.0,se SWE,MFFW,23.0,20.4,811.0,29.0,137.0,393.0,300.0,59.0,811.0,45.0,17.0,37.8,22.0,48.9,431.0,2119.0,1024.0,29.0,21.0,8.0,48.0,19.0,483.0,85.0,Matches,456.0,se SWE,MFFW,23.0,20.4,4.0,30.0,10.0,33.3,1.47,0.49,0.13,0.4,16.9,4.0,0.0,0.0,4.4,4.4,0.15,-0.4,-0.4,Matches,456.0,se SWE,MFFW,23.0,32.0,21.0,1835.0,20.4,4.0,6.0,10.0,4.0,0.0,0.0,4.0,0.0,4.4,4.4,5.0,9.4,29.0,74.0,85.0,0.2,0.29,0.49,0.2,0.49,0.22,0.25,0.46,0.22,0.46,Matches,Mattias Svanberg,M C,23,135,155,Sweden,VfL Wolfsburg,14,11,13,11,14,14,11,15,4,11,13,11,12,14,13,12,13,13,13,14,13,14,14,8,14,12,12,14,13,12,14,11,15,14,14,12,12,11,12,6,14,3,3,3,3,4,2,4,1,3,3,3,11,14,6,12,12,14,12,12,1,1,1,1,1,1,15,10,20,12,10,15,12,8,185,77,11,20,19135911,6747,6397,5747,Northern_European,135,1,1999/1/5,21,1,57533.0,,93065023
210,Dominik Szoboszlai,RB Leipzig,2000,457.0,hu HUN,MFFW,21.0,27.2,45.0,28.0,12.0,20.0,13.0,17.0,42.0,40.5,25.0,43.0,2.0,41.0,17.0,62.0,27.0,0.0,Matches,457.0,hu HUN,MFFW,21.0,27.2,150.0,5.52,94.0,31.0,8.0,5.0,10.0,2.0,17.0,0.63,11.0,3.0,0.0,1.0,2.0,0.0,Matches,,,,,,,,,,,,,,,,,,,,,,,,,,,,,,,,,,,,,,,,,,,,,,,,,,,,,,,,457.0,hu HUN,MFFW,21.0,27.2,5.0,2.0,1.0,25.0,39.0,2.0,117.0,17.0,28.0,0.0,1.0,0.0,151.0,7.0,18.0,28.0,Matches,457.0,hu HUN,MFFW,21.0,27.2,1580.0,1373.0,200.0,66.0,16.0,24.0,117.0,56.0,68.0,19.0,30.0,2.0,1262.0,7.0,46.0,Matches,457.0,hu HUN,MFFW,21.0,27.2,1262.0,1580.0,79.9,21421.0,5686.0,665.0,757.0,87.8,405.0,491.0,82.5,145.0,210.0,69.0,8.0,8.1,8.6,-0.1,70.0,107.0,46.0,9.0,151.0,Matches,533,hu HUN,MFFW,21,31,2444.0,79.0,79.9,27.2,28,84.0,17,3,33.0,0,1.94,51.0,32.0,19.0,0.7,0.12,52.5,31.5,21.0,0.77,0.12,Matches,457.0,hu HUN,MFFW,21.0,27.2,1908.0,28.0,235.0,952.0,750.0,56.0,1907.0,105.0,53.0,50.5,41.0,39.0,1134.0,6004.0,2911.0,75.0,68.0,12.0,57.0,33.0,1294.0,157.0,Matches,457.0,hu HUN,MFFW,21.0,27.2,6.0,58.0,28.0,48.3,2.14,1.03,0.09,0.18,23.2,9.0,1.0,1.0,5.5,4.7,0.08,0.5,0.3,Matches,457.0,hu HUN,MFFW,21.0,31.0,28.0,2444.0,27.2,6.0,8.0,14.0,5.0,1.0,1.0,5.0,2.0,5.5,4.7,8.1,12.9,75.0,151.0,157.0,0.22,0.29,0.52,0.18,0.48,0.2,0.3,0.5,0.17,0.47,Matches,Dominik Szoboszlai,M/AM LC,21,143,-9,Hungary,RB Leipzig,16,13,13,12,14,16,9,15,5,8,14,16,9,16,8,13,12,12,12,14,13,15,16,9,14,9,14,14,15,12,12,13,13,15,13,11,14,5,12,5,12,1,3,2,1,1,2,3,1,3,3,3,12,14,8,12,13,13,11,12,1,1,1,1,1,1,1,16,20,12,16,18,11,1,186,74,13,20,102384003,7000,7000,6000,Northern_European,138,4,2000/10/25,24,6,37806.0,,16202373
211,Jonathan Tah,Leverkusen,1996,459.0,de GER,DF,26.0,27.6,25.0,12.0,21.0,4.0,0.0,12.0,18.0,66.7,6.0,30.0,18.0,12.0,40.0,65.0,118.0,0.0,Matches,459.0,de GER,DF,26.0,27.6,15.0,0.54,12.0,2.0,0.0,1.0,0.0,0.0,0.0,0.0,0.0,0.0,0.0,0.0,0.0,0.0,Matches,,,,,,,,,,,,,,,,,,,,,,,,,,,,,,,,,,,,,,,,,,,,,,,,,,,,,,,,459.0,de GER,DF,26.0,27.6,6.0,0.0,0.0,22.0,3.0,2.0,3.0,40.0,12.0,0.0,0.0,0.0,167.0,57.0,46.0,55.3,Matches,459.0,de GER,DF,26.0,27.6,1637.0,1591.0,44.0,30.0,0.0,6.0,3.0,2.0,0.0,0.0,0.0,0.0,1455.0,2.0,8.0,Matches,459.0,de GER,DF,26.0,27.6,1455.0,1637.0,88.9,27748.0,9605.0,495.0,533.0,92.9,812.0,875.0,92.8,137.0,196.0,69.9,0.0,0.5,0.3,-0.5,6.0,59.0,3.0,0.0,56.0,Matches,535,de GER,DF,26,33,2487.0,75.0,81.3,27.6,28,86.0,24,5,13.0,0,1.48,44.0,45.0,-1.0,-0.04,-1.45,39.6,36.8,2.9,0.1,-0.79,Matches,459.0,de GER,DF,26.0,27.6,1895.0,223.0,952.0,915.0,40.0,19.0,1895.0,9.0,7.0,77.8,1.0,11.1,1075.0,6032.0,2961.0,8.0,4.0,0.0,5.0,10.0,1269.0,4.0,Matches,459.0,de GER,DF,26.0,27.6,1.0,10.0,2.0,20.0,0.36,0.07,0.1,0.5,9.7,0.0,0.0,0.0,1.1,1.1,0.11,-0.1,-0.1,Matches,459.0,de GER,DF,26.0,33.0,28.0,2487.0,27.6,1.0,0.0,1.0,1.0,0.0,0.0,6.0,0.0,1.1,1.1,0.5,1.5,8.0,56.0,4.0,0.04,0.0,0.04,0.04,0.04,0.04,0.02,0.06,0.04,0.06,Matches,Jonathan Tah,D C,26,142,153,"Germany,Ivory Coast",Bayer 04 Leverkusen,5,10,9,6,13,5,11,5,12,15,12,8,15,12,12,13,12,14,12,10,13,12,7,11,6,13,15,13,13,11,16,17,14,13,13,18,14,6,13,9,8,1,2,4,1,1,4,1,3,1,3,3,8,13,8,13,13,14,15,15,1,1,20,12,1,8,1,1,1,1,1,1,1,1,195,94,12,20,18869764,7100,7100,6250,Mixed_Race,139,13,1996/2/11,16,0,67122.0,,91119700
212,Edmond Tapsoba,Leverkusen,1999,460.0,bf BFA,DF,23.0,31.9,51.0,30.0,35.0,12.0,4.0,30.0,42.0,71.4,12.0,40.0,17.0,23.0,36.0,87.0,109.0,1.0,Matches,460.0,bf BFA,DF,23.0,31.9,31.0,0.97,28.0,1.0,1.0,0.0,1.0,0.0,5.0,0.16,4.0,0.0,0.0,0.0,1.0,0.0,Matches,,,,,,,,,,,,,,,,,,,,,,,,,,,,,,,,,,,,,,,,,,,,,,,,,,,,,,,,460.0,bf BFA,DF,23.0,31.9,5.0,0.0,0.0,28.0,17.0,2.0,3.0,36.0,30.0,1.0,2.0,1.0,270.0,55.0,43.0,56.1,Matches,460.0,bf BFA,DF,23.0,31.9,2211.0,2095.0,112.0,74.0,9.0,6.0,3.0,14.0,0.0,0.0,0.0,0.0,1891.0,4.0,20.0,Matches,460.0,bf BFA,DF,23.0,31.9,1891.0,2211.0,85.5,35396.0,13773.0,714.0,783.0,91.2,953.0,1044.0,91.3,199.0,322.0,61.8,0.0,1.0,1.5,-1.0,5.0,154.0,9.0,0.0,169.0,Matches,536,bf BFA,DF,23,33,2871.0,87.0,93.8,31.9,32,89.0,30,1,29.0,0,1.42,52.0,47.0,5.0,0.16,-1.27,49.5,39.7,9.7,0.3,0.84,Matches,460.0,bf BFA,DF,23.0,31.9,2522.0,254.0,1143.0,1286.0,109.0,20.0,2520.0,25.0,16.0,64.0,2.0,8.0,1516.0,9044.0,5323.0,40.0,14.0,0.0,15.0,12.0,1668.0,10.0,Matches,460.0,bf BFA,DF,23.0,31.9,1.0,13.0,1.0,7.7,0.41,0.03,0.0,0.0,14.9,0.0,1.0,2.0,2.8,1.2,0.09,-1.8,-1.2,Matches,460.0,bf BFA,DF,23.0,33.0,32.0,2871.0,31.9,1.0,0.0,1.0,0.0,1.0,2.0,5.0,0.0,2.8,1.2,1.0,2.2,40.0,169.0,10.0,0.03,0.0,0.03,0.0,0.0,0.09,0.03,0.12,0.04,0.07,Matches,Edmond Tapsoba,D C,23,148,160,Burkina Faso,Bayer 04 Leverkusen,6,9,12,7,13,7,14,8,8,15,14,16,15,12,12,15,13,16,14,13,15,13,10,9,8,14,13,12,14,14,13,16,13,14,15,13,14,6,12,4,8,1,2,1,2,1,3,3,2,2,1,3,14,13,6,8,15,12,14,15,1,1,20,1,1,1,1,1,1,1,1,1,1,1,194,84,8,20,50409257,7389,6614,5516,African_Caribbean,149,16,1999/2/2,29,0,57533.0,,13196616
213,Simon Terodde,Schalke 04,1988,464.0,de GER,FW,34.0,20.3,15.0,8.0,4.0,7.0,4.0,3.0,14.0,21.4,11.0,6.0,2.0,4.0,6.0,21.0,9.0,0.0,Matches,464.0,de GER,FW,34.0,20.3,57.0,2.81,41.0,1.0,1.0,8.0,6.0,0.0,5.0,0.25,2.0,0.0,0.0,1.0,2.0,0.0,Matches,,,,,,,,,,,,,,,,,,,,,,,,,,,,,,,,,,,,,,,,,,,,,,,,,,,,,,,,464.0,de GER,FW,34.0,20.3,5.0,0.0,0.0,37.0,36.0,26.0,2.0,6.0,8.0,2.0,0.0,0.0,40.0,71.0,119.0,37.4,Matches,464.0,de GER,FW,34.0,20.3,316.0,286.0,30.0,0.0,1.0,2.0,2.0,3.0,0.0,0.0,0.0,0.0,212.0,0.0,7.0,Matches,464.0,de GER,FW,34.0,20.3,212.0,316.0,67.1,2888.0,473.0,121.0,161.0,75.2,65.0,97.0,67.0,9.0,13.0,69.2,0.0,2.3,1.4,-2.3,22.0,16.0,7.0,0.0,19.0,Matches,541,de GER,FW,34,32,1823.0,57.0,59.6,20.3,21,78.0,8,11,17.0,1,0.97,21.0,40.0,-19.0,-0.94,0.3,23.0,28.1,-5.1,-0.25,0.65,Matches,464.0,de GER,FW,34.0,20.3,505.0,10.0,39.0,244.0,224.0,87.0,504.0,13.0,2.0,15.4,8.0,61.5,218.0,671.0,191.0,5.0,2.0,3.0,43.0,16.0,362.0,68.0,Matches,464.0,de GER,FW,34.0,20.3,5.0,43.0,19.0,44.2,2.12,0.94,0.12,0.26,12.4,0.0,0.0,1.0,6.3,5.5,0.13,-1.3,-0.5,Matches,464.0,de GER,FW,34.0,32.0,21.0,1823.0,20.3,5.0,0.0,5.0,5.0,0.0,1.0,5.0,0.0,6.3,5.5,2.3,7.9,5.0,19.0,68.0,0.25,0.0,0.25,0.25,0.25,0.31,0.12,0.43,0.27,0.39,Matches,Simon Terodde,S,34,130,132,Germany,FC Schalke 04,3,6,9,16,11,4,17,8,3,5,11,14,6,11,12,16,15,14,12,12,12,16,9,12,16,6,11,11,10,10,13,16,18,12,13,16,13,7,16,6,6,1,4,3,3,3,3,3,3,2,3,4,14,15,8,8,12,16,15,11,1,1,1,1,1,1,1,1,1,1,1,1,1,20,192,83,13,20,229769,6500,6500,5000,Northern_European,127,4,1988/3/2,0,0,28766.0,,91014806
214,Marcus Thuram,Gladbach,1997,468.0,fr FRA,FW,24.0,27.9,14.0,7.0,3.0,6.0,5.0,6.0,13.0,46.2,7.0,20.0,3.0,17.0,6.0,20.0,22.0,0.0,Matches,468.0,fr FRA,FW,24.0,27.9,66.0,2.36,39.0,0.0,11.0,7.0,6.0,3.0,12.0,0.43,7.0,0.0,2.0,2.0,1.0,0.0,Matches,,,,,,,,,,,,,,,,,,,,,,,,,,,,,,,,,,,,,,,,,,,,,,,,,,,,,,,,468.0,fr FRA,FW,24.0,27.9,3.0,0.0,0.0,34.0,44.0,18.0,11.0,6.0,7.0,0.0,0.0,0.0,73.0,41.0,58.0,41.4,Matches,468.0,fr FRA,FW,24.0,27.9,561.0,516.0,43.0,0.0,1.0,0.0,11.0,0.0,0.0,0.0,0.0,0.0,415.0,2.0,21.0,Matches,468.0,fr FRA,FW,24.0,27.9,415.0,561.0,74.0,5280.0,867.0,260.0,324.0,80.2,116.0,150.0,77.3,6.0,14.0,42.9,6.0,5.2,3.1,0.8,29.0,16.0,20.0,0.0,46.0,Matches,545,fr FRA,FW,24,30,2513.0,84.0,82.1,27.9,28,88.0,21,2,21.0,1,1.33,42.0,41.0,1.0,0.04,0.69,42.0,40.8,1.1,0.04,0.45,Matches,468.0,fr FRA,FW,24.0,27.9,945.0,35.0,86.0,421.0,454.0,175.0,945.0,92.0,41.0,44.6,32.0,34.8,603.0,3764.0,1865.0,75.0,41.0,47.0,112.0,50.0,717.0,170.0,Matches,468.0,fr FRA,FW,24.0,27.9,13.0,92.0,44.0,47.8,3.29,1.58,0.14,0.3,12.7,0.0,0.0,0.0,16.5,16.5,0.18,-3.5,-3.5,Matches,468.0,fr FRA,FW,24.0,30.0,28.0,2513.0,27.9,13.0,6.0,19.0,13.0,0.0,0.0,3.0,0.0,16.5,16.5,5.2,21.8,75.0,46.0,170.0,0.47,0.21,0.68,0.47,0.68,0.59,0.19,0.78,0.59,0.78,Matches,Marcus Thuram,AM/S L,24,142,152,"France,Guadeloupe",Borussia Mönchengladbach,3,9,16,12,14,6,14,9,4,6,12,13,7,16,13,12,13,12,10,13,12,11,15,4,14,7,10,9,15,14,16,15,13,17,12,16,13,12,14,11,11,3,3,1,1,1,3,1,2,3,2,3,13,15,14,10,11,11,9,8,1,1,1,1,1,1,1,10,1,10,19,10,12,20,192,90,13,20,11734285,7100,6900,6100,African_Caribbean,140,16,1997/8/6,4,0,95889.0,,48037335
215,Tiago Tomás,Stuttgart,2002,471.0,pt POR,FWMF,20.0,14.3,10.0,4.0,2.0,4.0,4.0,8.0,13.0,61.5,5.0,9.0,2.0,7.0,1.0,11.0,5.0,0.0,Matches,471.0,pt POR,FWMF,20.0,14.3,37.0,2.58,23.0,4.0,1.0,2.0,7.0,0.0,6.0,0.42,4.0,0.0,1.0,0.0,1.0,0.0,Matches,,,,,,,,,,,,,,,,,,,,,,,,,,,,,,,,,,,,,,,,,,,,,,,,,,,,,,,,471.0,pt POR,FWMF,20.0,14.3,2.0,0.0,0.0,13.0,49.0,3.0,34.0,1.0,4.0,1.0,0.0,0.0,48.0,6.0,20.0,23.1,Matches,471.0,pt POR,FWMF,20.0,14.3,326.0,297.0,28.0,4.0,4.0,3.0,34.0,4.0,11.0,4.0,5.0,0.0,197.0,1.0,22.0,Matches,471.0,pt POR,FWMF,20.0,14.3,197.0,326.0,60.4,2984.0,912.0,121.0,159.0,76.1,49.0,82.0,59.8,19.0,43.0,44.2,3.0,3.6,2.3,-0.6,20.0,10.0,16.0,5.0,25.0,Matches,549,pt POR,FWMF,20,27,1291.0,48.0,42.2,14.3,16,65.0,2,11,23.0,1,0.96,21.0,27.0,-6.0,-0.42,-0.11,20.2,20.4,-0.1,-0.01,-0.14,Matches,471.0,pt POR,FWMF,20.0,14.3,510.0,8.0,57.0,199.0,259.0,55.0,510.0,58.0,19.0,32.8,29.0,50.0,322.0,1677.0,812.0,31.0,17.0,16.0,43.0,25.0,382.0,95.0,Matches,471.0,pt POR,FWMF,20.0,14.3,3.0,34.0,13.0,38.2,2.37,0.91,0.09,0.23,19.1,0.0,0.0,0.0,2.9,2.9,0.09,0.1,0.1,Matches,471.0,pt POR,FWMF,20.0,27.0,16.0,1291.0,14.3,3.0,3.0,6.0,3.0,0.0,0.0,2.0,0.0,2.9,2.9,3.6,6.5,31.0,25.0,95.0,0.21,0.21,0.42,0.21,0.42,0.2,0.25,0.45,0.2,0.45,Matches,Tiago Tomás,S R,20,126,-8,"Portugal,Angola",Sporting Clube de Portugal,7,9,13,13,12,6,11,12,8,6,10,11,6,12,15,12,16,11,10,12,9,16,16,6,13,7,13,14,15,15,12,10,15,15,14,12,10,5,10,5,14,3,1,2,1,1,1,4,3,2,3,1,12,14,11,14,15,16,12,11,1,1,1,5,1,10,1,1,1,14,12,1,15,20,180,72,13,20,28687501,6296,6146,4596,African_Caribbean,123,11,2002/6/16,0,0,10102.0,VfB Stuttgart,83261927
216,Lucas Tousart,Hertha BSC,1997,473.0,fr FRA,MF,25.0,32.7,73.0,38.0,35.0,28.0,10.0,27.0,60.0,45.0,33.0,42.0,6.0,36.0,48.0,121.0,75.0,1.0,Matches,473.0,fr FRA,MF,25.0,32.7,53.0,1.62,40.0,0.0,2.0,7.0,3.0,1.0,8.0,0.24,6.0,0.0,0.0,0.0,2.0,0.0,Matches,,,,,,,,,,,,,,,,,,,,,,,,,,,,,,,,,,,,,,,,,,,,,,,,,,,,,,,,473.0,fr FRA,MF,25.0,32.7,1.0,0.0,0.0,36.0,42.0,2.0,28.0,48.0,38.0,1.0,0.0,0.0,168.0,91.0,94.0,49.2,Matches,473.0,fr FRA,MF,25.0,32.7,885.0,869.0,12.0,9.0,1.0,3.0,28.0,2.0,0.0,0.0,0.0,0.0,530.0,4.0,39.0,Matches,473.0,fr FRA,MF,25.0,32.7,530.0,885.0,59.9,8426.0,3235.0,268.0,402.0,66.7,197.0,282.0,69.9,36.0,94.0,38.3,2.0,2.0,2.1,0.0,18.0,72.0,9.0,3.0,93.0,Matches,551,fr FRA,MF,25,33,2944.0,89.0,96.2,32.7,33,89.0,29,0,,0,0.88,41.0,65.0,-24.0,-0.73,1.59,38.9,58.0,-19.1,-0.58,0.54,Matches,473.0,fr FRA,MF,25.0,32.7,1347.0,85.0,351.0,720.0,296.0,81.0,1347.0,53.0,23.0,43.4,24.0,45.3,543.0,3123.0,1341.0,37.0,16.0,7.0,48.0,26.0,631.0,79.0,Matches,473.0,fr FRA,MF,25.0,32.7,5.0,43.0,16.0,37.2,1.31,0.49,0.12,0.31,16.7,0.0,0.0,0.0,3.6,3.6,0.08,1.4,1.4,Matches,473.0,fr FRA,MF,25.0,33.0,33.0,2944.0,32.7,5.0,2.0,7.0,5.0,0.0,0.0,1.0,0.0,3.6,3.6,2.0,5.5,37.0,93.0,79.0,0.15,0.06,0.21,0.15,0.21,0.11,0.06,0.17,0.11,0.17,Matches,Lucas Tousart,DM/M C,25,138,139,France,Hertha Berlin,7,7,10,8,12,7,14,8,7,14,12,7,15,12,15,14,17,13,15,11,13,15,8,14,12,15,17,17,13,12,15,13,16,13,18,15,15,12,13,4,11,3,1,1,3,1,2,2,2,1,2,1,12,14,5,13,11,17,13,13,1,1,1,1,1,1,20,1,20,1,1,1,1,1,185,83,8,20,8374540,6597,6597,5497,Northern_European,137,5,1997/4/29,0,0,92307.0,,48034210
217,Kevin Trapp,Eint Frankfurt,1990,474.0,de GER,GK,32.0,33.0,1.0,1.0,1.0,0.0,0.0,0.0,2.0,0.0,2.0,2.0,0.0,2.0,0.0,1.0,10.0,0.0,Matches,474.0,de GER,GK,32.0,33.0,3.0,0.09,3.0,0.0,0.0,0.0,0.0,0.0,0.0,0.0,0.0,0.0,0.0,0.0,0.0,0.0,Matches,32.0,de GER,GK,32.0,33.0,51.0,2.0,1.0,7.0,1.0,42.3,0.32,-7.7,-0.23,80.0,326.0,24.5,664.0,128.0,39.2,34.8,219.0,30.1,34.1,401.0,17.0,4.2,24.0,0.73,14.4,Matches,32.0,de GER,GK,32.0,33.0,33.0,2970.0,33.0,51.0,1.55,130.0,80.0,62.3,13.0,10.0,10.0,6.0,18.2,2.0,2.0,0.0,0.0,0.0,Matches,474.0,de GER,GK,32.0,33.0,3.0,0.0,0.0,0.0,4.0,0.0,0.0,0.0,1.0,0.0,0.0,0.0,37.0,4.0,0.0,100.0,Matches,474.0,de GER,GK,32.0,33.0,888.0,607.0,276.0,57.0,0.0,5.0,0.0,0.0,0.0,0.0,0.0,0.0,616.0,5.0,0.0,Matches,474.0,de GER,GK,32.0,33.0,616.0,888.0,69.4,15447.0,10068.0,133.0,134.0,99.3,327.0,332.0,98.5,151.0,412.0,36.7,0.0,0.0,0.0,0.0,0.0,9.0,0.0,0.0,0.0,Matches,552,de GER,GK,32,33,2970.0,90.0,97.1,33.0,33,90.0,33,0,,0,1.48,57.0,51.0,6.0,0.18,0.18,51.9,41.5,10.4,0.31,2.08,Matches,474.0,de GER,GK,32.0,33.0,957.0,854.0,951.0,6.0,0.0,0.0,957.0,0.0,0.0,,0.0,,493.0,2258.0,1322.0,0.0,0.0,0.0,0.0,0.0,417.0,0.0,Matches,474.0,de GER,GK,32.0,33.0,0.0,0.0,0.0,,0.0,0.0,,,,0.0,0.0,0.0,0.0,0.0,,0.0,0.0,Matches,474.0,de GER,GK,32.0,33.0,33.0,2970.0,33.0,0.0,0.0,0.0,0.0,0.0,0.0,3.0,0.0,0.0,0.0,0.0,0.0,0.0,0.0,0.0,0.0,0.0,0.0,0.0,0.0,0.0,0.0,0.0,0.0,0.0,Matches,Kevin Trapp,GK,32,144,148,Germany,Eintracht Frankfurt,6,3,1,3,10,8,7,2,2,1,9,3,3,10,8,15,14,16,13,7,14,12,6,9,1,16,17,10,13,14,14,13,15,10,10,16,16,5,15,5,14,13,12,10,10,14,11,17,17,15,12,11,11,15,4,13,12,17,15,17,20,1,1,1,1,1,1,1,1,1,1,1,1,1,189,88,7,20,347975206,7200,7200,6250,Northern_European,143,5,1990/7/8,6,0,57692.0,,35018013
218,Christopher Trimmel,Union Berlin,1987,475.0,at AUT,DF,35.0,20.1,31.0,16.0,16.0,12.0,3.0,20.0,31.0,64.5,11.0,14.0,1.0,13.0,25.0,56.0,48.0,0.0,Matches,475.0,at AUT,DF,35.0,20.1,59.0,2.93,31.0,26.0,1.0,0.0,1.0,0.0,7.0,0.35,0.0,7.0,0.0,0.0,0.0,0.0,Matches,,,,,,,,,,,,,,,,,,,,,,,,,,,,,,,,,,,,,,,,,,,,,,,,,,,,,,,,475.0,at AUT,DF,35.0,20.1,1.0,0.0,0.0,17.0,7.0,1.0,180.0,25.0,16.0,0.0,1.0,0.0,107.0,23.0,19.0,54.8,Matches,475.0,at AUT,DF,35.0,20.1,1040.0,682.0,348.0,51.0,0.0,1.0,180.0,217.0,80.0,36.0,37.0,0.0,649.0,10.0,26.0,Matches,475.0,at AUT,DF,35.0,20.1,649.0,1040.0,62.4,11591.0,5038.0,293.0,350.0,83.7,264.0,362.0,72.9,75.0,262.0,28.6,6.0,3.2,3.2,2.8,35.0,53.0,26.0,18.0,65.0,Matches,553,at AUT,DF,35,25,1811.0,72.0,59.2,20.1,20,87.0,17,5,13.0,8,1.76,29.0,24.0,5.0,0.25,-0.33,23.2,23.6,-0.4,-0.02,0.29,Matches,475.0,at AUT,DF,35.0,20.1,1190.0,63.0,324.0,470.0,405.0,28.0,1190.0,16.0,8.0,50.0,5.0,31.3,453.0,2299.0,1144.0,34.0,12.0,8.0,12.0,8.0,521.0,80.0,Matches,475.0,at AUT,DF,35.0,20.1,0.0,14.0,3.0,21.4,0.7,0.15,0.0,0.0,17.8,1.0,0.0,0.0,0.7,0.7,0.05,-0.7,-0.7,Matches,475.0,at AUT,DF,35.0,25.0,20.0,1811.0,20.1,0.0,6.0,6.0,0.0,0.0,0.0,1.0,0.0,0.7,0.7,3.2,4.0,34.0,65.0,80.0,0.0,0.3,0.3,0.0,0.3,0.04,0.16,0.2,0.04,0.2,Matches,Christopher Trimmel,D/WB R,35,136,137,Austria,1. FC Union Berlin,18,16,11,10,12,13,13,11,14,13,13,10,13,12,13,15,15,15,16,12,14,16,9,15,10,12,16,16,11,10,15,14,17,10,12,13,17,10,11,6,14,3,1,1,1,1,1,3,3,1,2,1,10,14,6,16,13,17,15,12,1,1,10,20,1,20,1,1,1,14,1,1,14,1,189,78,12,20,406593,6600,5930,5317,Northern_European,136,5,1987/2/24,23,1,19177.0,,16008969
219,Tuta,Eint Frankfurt,1999,476.0,br BRA,DF,23.0,30.2,53.0,35.0,27.0,19.0,7.0,33.0,57.0,57.9,24.0,47.0,14.0,33.0,49.0,102.0,134.0,2.0,Matches,476.0,br BRA,DF,23.0,30.2,20.0,0.66,15.0,0.0,2.0,2.0,0.0,1.0,1.0,0.03,1.0,0.0,0.0,0.0,0.0,0.0,Matches,,,,,,,,,,,,,,,,,,,,,,,,,,,,,,,,,,,,,,,,,,,,,,,,,,,,,,,,476.0,br BRA,DF,23.0,30.2,8.0,0.0,0.0,33.0,18.0,1.0,7.0,49.0,35.0,0.0,0.0,0.0,240.0,51.0,61.0,45.5,Matches,476.0,br BRA,DF,23.0,30.2,1855.0,1797.0,57.0,43.0,2.0,7.0,7.0,14.0,0.0,0.0,0.0,0.0,1486.0,1.0,22.0,Matches,476.0,br BRA,DF,23.0,30.2,1486.0,1855.0,80.1,28536.0,10513.0,483.0,544.0,88.8,828.0,945.0,87.6,161.0,314.0,51.3,1.0,0.8,0.9,0.2,6.0,94.0,6.0,1.0,107.0,Matches,554,br BRA,DF,23,31,2718.0,88.0,88.8,30.2,30,90.0,29,1,27.0,0,1.48,53.0,45.0,8.0,0.26,0.79,44.9,36.0,8.8,0.29,0.35,Matches,476.0,br BRA,DF,23.0,30.2,2246.0,237.0,1047.0,1111.0,114.0,27.0,2246.0,20.0,11.0,55.0,9.0,45.0,1332.0,6758.0,3475.0,23.0,18.0,2.0,27.0,13.0,1380.0,17.0,Matches,476.0,br BRA,DF,23.0,30.2,2.0,17.0,3.0,17.6,0.56,0.1,0.12,0.67,17.0,0.0,0.0,0.0,2.3,2.3,0.13,-0.3,-0.3,Matches,476.0,br BRA,DF,23.0,31.0,30.0,2718.0,30.2,2.0,1.0,3.0,2.0,0.0,0.0,8.0,0.0,2.3,2.3,0.8,3.1,23.0,107.0,17.0,0.07,0.03,0.1,0.07,0.1,0.08,0.03,0.1,0.08,0.1,Matches,Tuta,D C,23,130,147,Brazil,Eintracht Frankfurt,5,9,9,6,12,5,13,6,13,13,11,9,14,12,13,13,14,14,12,10,11,14,8,11,8,14,13,14,14,14,14,14,16,15,14,13,13,9,13,5,11,1,2,3,2,1,3,4,3,3,2,1,9,14,9,10,13,10,12,11,1,1,20,14,1,10,12,1,1,1,1,1,1,1,185,75,10,20,5802967,6600,6000,4600,Mixed_Race,131,12,1999/7/4,0,0,8500.0,,19290884
220,Dayot Upamecano,Bayern Munich,1998,479.0,fr FRA,DF,23.0,26.1,65.0,37.0,43.0,22.0,0.0,28.0,45.0,62.2,17.0,26.0,6.0,20.0,27.0,92.0,71.0,4.0,Matches,479.0,fr FRA,DF,23.0,26.1,23.0,0.88,22.0,0.0,0.0,1.0,0.0,0.0,3.0,0.11,3.0,0.0,0.0,0.0,0.0,0.0,Matches,,,,,,,,,,,,,,,,,,,,,,,,,,,,,,,,,,,,,,,,,,,,,,,,,,,,,,,,479.0,fr FRA,DF,23.0,26.1,6.0,1.0,0.0,30.0,14.0,1.0,2.0,27.0,37.0,0.0,1.0,0.0,212.0,47.0,47.0,50.0,Matches,479.0,fr FRA,DF,23.0,26.1,2318.0,2255.0,60.0,47.0,0.0,10.0,2.0,7.0,0.0,0.0,0.0,0.0,2101.0,3.0,9.0,Matches,479.0,fr FRA,DF,23.0,26.1,2101.0,2318.0,90.6,42619.0,15514.0,596.0,641.0,93.0,1250.0,1315.0,95.1,246.0,333.0,73.9,1.0,0.3,1.0,0.7,6.0,205.0,6.0,0.0,169.0,Matches,557,fr FRA,DF,23,29,2348.0,81.0,76.7,26.1,27,87.0,25,2,6.0,0,1.93,71.0,29.0,42.0,1.61,0.09,56.2,27.4,28.8,1.1,-0.04,Matches,479.0,fr FRA,DF,23.0,26.1,2569.0,234.0,1177.0,1314.0,92.0,18.0,2569.0,15.0,10.0,66.7,5.0,33.3,1844.0,9367.0,5193.0,31.0,28.0,2.0,19.0,10.0,1895.0,7.0,Matches,479.0,fr FRA,DF,23.0,26.1,0.0,7.0,1.0,14.3,0.27,0.04,0.0,0.0,9.0,0.0,0.0,0.0,0.7,0.7,0.1,-0.7,-0.7,Matches,479.0,fr FRA,DF,23.0,29.0,27.0,2348.0,26.1,0.0,1.0,1.0,0.0,0.0,0.0,6.0,1.0,0.7,0.7,0.3,1.0,31.0,169.0,7.0,0.0,0.04,0.04,0.0,0.04,0.03,0.01,0.04,0.03,0.04,Matches,Dayot Upamecano,D C,23,154,170,"France,Guinea-Bissau",FC Bayern München,3,7,12,7,12,4,14,6,5,15,15,6,17,12,16,13,17,14,13,14,14,16,13,8,10,14,12,15,15,12,16,15,15,17,14,17,14,10,14,7,10,1,4,3,3,2,3,2,3,1,1,2,15,17,10,10,12,10,12,10,1,1,20,1,1,1,12,1,10,1,1,1,1,1,186,90,12,20,76007700,7700,7250,7200,African_Caribbean,153,17,1998/10/27,6,1,230137.0,,16182894
221,Filip Uremović,Hertha BSC,1997,480.0,hr CRO,DF,25.0,19.2,38.0,23.0,29.0,8.0,1.0,14.0,22.0,63.6,8.0,18.0,13.0,5.0,36.0,74.0,88.0,2.0,Matches,480.0,hr CRO,DF,25.0,19.2,9.0,0.47,7.0,0.0,1.0,0.0,1.0,0.0,0.0,0.0,0.0,0.0,0.0,0.0,0.0,0.0,Matches,,,,,,,,,,,,,,,,,,,,,,,,,,,,,,,,,,,,,,,,,,,,,,,,,,,,,,,,480.0,hr CRO,DF,25.0,19.2,8.0,1.0,1.0,27.0,10.0,0.0,1.0,36.0,23.0,0.0,3.0,0.0,83.0,55.0,38.0,59.1,Matches,480.0,hr CRO,DF,25.0,19.2,658.0,603.0,53.0,30.0,0.0,2.0,1.0,23.0,0.0,0.0,0.0,0.0,514.0,2.0,4.0,Matches,480.0,hr CRO,DF,25.0,19.2,514.0,658.0,78.1,9661.0,2828.0,165.0,203.0,81.3,317.0,363.0,87.3,27.0,74.0,36.5,0.0,0.4,0.3,-0.4,4.0,16.0,2.0,1.0,17.0,Matches,560,hr CRO,DF,25,22,1726.0,78.0,56.4,19.2,21,80.0,14,1,45.0,5,0.82,22.0,38.0,-16.0,-0.83,-0.09,22.0,28.8,-6.7,-0.35,0.58,Matches,480.0,hr CRO,DF,25.0,19.2,882.0,109.0,514.0,338.0,33.0,17.0,882.0,2.0,2.0,100.0,0.0,0.0,384.0,2033.0,749.0,3.0,3.0,0.0,10.0,4.0,393.0,1.0,Matches,480.0,hr CRO,DF,25.0,19.2,0.0,9.0,3.0,33.3,0.47,0.16,0.0,0.0,12.7,0.0,0.0,0.0,0.9,0.9,0.1,-0.9,-0.9,Matches,480.0,hr CRO,DF,25.0,22.0,21.0,1726.0,19.2,0.0,0.0,0.0,0.0,0.0,0.0,8.0,1.0,0.9,0.9,0.4,1.2,3.0,17.0,1.0,0.0,0.0,0.0,0.0,0.0,0.05,0.02,0.06,0.05,0.06,Matches,Filip Uremović,D RC,25,128,140,Croatia,Hertha Berlin,6,6,9,6,11,4,14,7,12,13,13,6,14,10,13,13,15,11,14,11,12,16,7,17,8,13,14,15,13,13,14,13,13,14,13,11,12,14,14,6,2,1,1,1,2,3,2,1,3,3,1,2,11,12,6,12,11,13,13,12,1,1,20,17,1,1,8,1,1,1,1,1,1,1,184,81,10,20,3985858,6290,6540,4001,Northern_European,127,4,1997/2/11,6,0,15600.0,,24049323
222,Josha Vagnoman,Stuttgart,2000,483.0,de GER,DF,21.0,16.4,26.0,15.0,12.0,11.0,3.0,15.0,27.0,55.6,12.0,20.0,2.0,18.0,8.0,34.0,29.0,1.0,Matches,483.0,de GER,DF,21.0,16.4,28.0,1.71,19.0,0.0,6.0,1.0,1.0,1.0,3.0,0.18,3.0,0.0,0.0,0.0,0.0,0.0,Matches,,,,,,,,,,,,,,,,,,,,,,,,,,,,,,,,,,,,,,,,,,,,,,,,,,,,,,,,483.0,de GER,DF,21.0,16.4,3.0,1.0,1.0,19.0,9.0,2.0,27.0,8.0,15.0,0.0,0.0,0.0,74.0,23.0,19.0,54.8,Matches,483.0,de GER,DF,21.0,16.4,584.0,497.0,86.0,2.0,1.0,3.0,27.0,84.0,0.0,0.0,0.0,0.0,453.0,1.0,20.0,Matches,483.0,de GER,DF,21.0,16.4,453.0,584.0,77.6,6868.0,2125.0,247.0,291.0,84.9,164.0,217.0,75.6,24.0,33.0,72.7,2.0,1.6,1.9,0.4,11.0,28.0,14.0,3.0,43.0,Matches,563,de GER,DF,21,23,1479.0,64.0,48.3,16.4,16,84.0,11,7,19.0,4,1.09,21.0,23.0,-2.0,-0.12,0.45,24.5,19.8,4.6,0.28,0.41,Matches,483.0,de GER,DF,21.0,16.4,765.0,38.0,200.0,293.0,281.0,48.0,765.0,35.0,22.0,62.9,12.0,34.3,387.0,2071.0,1007.0,27.0,24.0,7.0,34.0,18.0,465.0,93.0,Matches,483.0,de GER,DF,21.0,16.4,2.0,25.0,5.0,20.0,1.52,0.3,0.08,0.4,13.9,0.0,0.0,0.0,2.9,2.9,0.12,-0.9,-0.9,Matches,483.0,de GER,DF,21.0,23.0,16.0,1479.0,16.4,2.0,2.0,4.0,2.0,0.0,0.0,3.0,1.0,2.9,2.9,1.6,4.5,27.0,43.0,93.0,0.12,0.12,0.24,0.12,0.24,0.18,0.1,0.28,0.18,0.28,Matches,Josha Vagnoman,D/WB RL,21,125,147,"Germany,Ivory Coast",VfB Stuttgart,7,12,13,7,11,6,8,9,14,11,10,9,11,12,12,9,13,12,9,10,10,11,12,7,10,11,13,14,14,10,14,12,13,16,13,14,11,11,13,13,14,2,2,1,2,2,2,4,2,1,3,3,8,12,7,13,15,10,14,12,1,18,12,20,18,20,12,10,10,14,1,1,10,1,187,86,12,20,6839999,6245,6245,4495,Mixed_Race,110,12,2000/12/11,0,0,11999.0,,91184445
223,Miloš Veljković,Werder Bremen,1995,486.0,rs SRB,DF,26.0,25.2,30.0,19.0,17.0,13.0,0.0,18.0,29.0,62.1,11.0,32.0,16.0,16.0,33.0,63.0,103.0,0.0,Matches,486.0,rs SRB,DF,26.0,25.2,23.0,0.91,21.0,1.0,0.0,1.0,0.0,0.0,3.0,0.12,3.0,0.0,0.0,0.0,0.0,0.0,Matches,,,,,,,,,,,,,,,,,,,,,,,,,,,,,,,,,,,,,,,,,,,,,,,,,,,,,,,,486.0,rs SRB,DF,26.0,25.2,2.0,0.0,0.0,24.0,9.0,0.0,3.0,33.0,19.0,0.0,1.0,0.0,131.0,58.0,45.0,56.3,Matches,486.0,rs SRB,DF,26.0,25.2,1411.0,1355.0,50.0,48.0,2.0,18.0,3.0,2.0,0.0,0.0,0.0,0.0,1145.0,6.0,8.0,Matches,486.0,rs SRB,DF,26.0,25.2,1145.0,1411.0,81.1,25411.0,10806.0,265.0,308.0,86.0,665.0,739.0,90.0,202.0,326.0,62.0,2.0,0.7,0.8,1.3,7.0,76.0,2.0,0.0,81.0,Matches,566,rs SRB,DF,26,29,2266.0,78.0,74.1,25.2,25,88.0,23,4,18.0,0,1.21,42.0,50.0,-8.0,-0.32,0.25,31.4,39.1,-7.7,-0.3,0.17,Matches,486.0,rs SRB,DF,26.0,25.2,1645.0,194.0,935.0,679.0,39.0,15.0,1645.0,4.0,3.0,75.0,1.0,25.0,905.0,4396.0,2536.0,5.0,2.0,0.0,2.0,0.0,1027.0,3.0,Matches,486.0,rs SRB,DF,26.0,25.2,1.0,4.0,2.0,50.0,0.16,0.08,0.25,0.5,8.7,0.0,0.0,0.0,0.5,0.5,0.12,0.5,0.5,Matches,486.0,rs SRB,DF,26.0,29.0,25.0,2266.0,25.2,1.0,2.0,3.0,1.0,0.0,0.0,2.0,0.0,0.5,0.5,0.7,1.2,5.0,81.0,3.0,0.04,0.08,0.12,0.04,0.12,0.02,0.03,0.05,0.02,0.05,Matches,Miloš Veljković,D/DM C,26,130,137,"Serbia,Switzerland",SV Werder Bremen,5,7,8,6,12,6,11,7,8,14,12,7,13,11,7,15,12,15,16,9,14,12,6,11,6,16,17,10,10,10,13,14,11,12,13,14,16,6,15,9,14,3,2,1,3,2,2,3,2,1,1,2,16,16,10,8,14,13,15,18,1,1,20,1,1,1,16,1,14,1,1,1,1,1,188,85,10,20,4111059,6500,6500,5000,Northern_European,128,5,1995/9/26,20,0,21924.0,,28070894
224,Micky van de Ven,Wolfsburg,2001,487.0,nl NED,DF,21.0,33.0,45.0,30.0,26.0,18.0,1.0,28.0,39.0,71.8,11.0,42.0,24.0,18.0,26.0,71.0,108.0,2.0,Matches,487.0,nl NED,DF,21.0,33.0,24.0,0.73,16.0,2.0,3.0,1.0,2.0,0.0,1.0,0.03,0.0,0.0,0.0,0.0,1.0,0.0,Matches,,,,,,,,,,,,,,,,,,,,,,,,,,,,,,,,,,,,,,,,,,,,,,,,,,,,,,,,487.0,nl NED,DF,21.0,33.0,5.0,0.0,0.0,23.0,27.0,1.0,12.0,26.0,30.0,1.0,2.0,0.0,195.0,35.0,32.0,52.2,Matches,487.0,nl NED,DF,21.0,33.0,1758.0,1632.0,125.0,46.0,0.0,14.0,12.0,79.0,0.0,0.0,0.0,0.0,1541.0,1.0,11.0,Matches,487.0,nl NED,DF,21.0,33.0,1541.0,1758.0,87.7,30569.0,9937.0,459.0,502.0,91.4,927.0,982.0,94.4,145.0,236.0,61.4,1.0,1.4,1.4,-0.4,6.0,98.0,5.0,0.0,111.0,Matches,567,nl NED,DF,21,33,2970.0,90.0,97.1,33.0,33,90.0,33,0,,0,1.39,54.0,48.0,6.0,0.18,-2.82,49.4,49.6,-0.2,0.0,-0.18,Matches,487.0,nl NED,DF,21.0,33.0,2043.0,188.0,981.0,935.0,141.0,21.0,2043.0,32.0,19.0,59.4,8.0,25.0,1232.0,6625.0,3777.0,43.0,34.0,5.0,13.0,11.0,1330.0,23.0,Matches,487.0,nl NED,DF,21.0,33.0,1.0,16.0,1.0,6.3,0.48,0.03,0.06,1.0,17.5,0.0,0.0,0.0,1.3,1.3,0.08,-0.3,-0.3,Matches,487.0,nl NED,DF,21.0,33.0,33.0,2970.0,33.0,1.0,1.0,2.0,1.0,0.0,0.0,5.0,0.0,1.3,1.3,1.4,2.8,43.0,111.0,23.0,0.03,0.03,0.06,0.03,0.06,0.04,0.04,0.08,0.04,0.08,Matches,Micky van de Ven,D/WB LC,21,128,150,Holland,VfL Wolfsburg,3,11,13,7,12,4,13,7,7,13,13,6,13,12,14,12,13,13,12,12,12,16,13,13,11,13,12,14,14,11,15,14,13,17,13,14,14,7,14,7,12,1,1,2,1,3,4,3,1,2,2,2,8,14,13,7,12,14,12,12,1,18,20,1,16,1,10,1,1,1,1,1,1,1,193,81,20,8,8999999,6600,6000,5000,Northern_European,128,1,2001/4/19,0,0,23972.0,,37084591
225,Kevin Vogt,Hoffenheim,1991,489.0,de GER,DF,30.0,19.7,15.0,10.0,10.0,5.0,0.0,9.0,22.0,40.9,13.0,18.0,11.0,7.0,26.0,41.0,67.0,0.0,Matches,489.0,de GER,DF,30.0,19.7,16.0,0.81,16.0,0.0,0.0,0.0,0.0,0.0,1.0,0.05,1.0,0.0,0.0,0.0,0.0,0.0,Matches,,,,,,,,,,,,,,,,,,,,,,,,,,,,,,,,,,,,,,,,,,,,,,,,,,,,,,,,489.0,de GER,DF,30.0,19.7,8.0,0.0,0.0,22.0,11.0,0.0,3.0,26.0,10.0,0.0,0.0,0.0,134.0,11.0,14.0,44.0,Matches,489.0,de GER,DF,30.0,19.7,1201.0,1127.0,70.0,52.0,0.0,13.0,3.0,1.0,0.0,0.0,0.0,0.0,1033.0,4.0,2.0,Matches,489.0,de GER,DF,30.0,19.7,1033.0,1201.0,86.0,22146.0,9878.0,272.0,304.0,89.5,578.0,629.0,91.9,171.0,242.0,70.7,0.0,0.4,0.8,-0.4,4.0,88.0,13.0,2.0,104.0,Matches,570,de GER,DF,30,22,1775.0,81.0,58.0,19.7,22,81.0,16,0,,0,1.27,29.0,27.0,2.0,0.1,0.87,30.1,26.4,3.8,0.19,0.67,Matches,489.0,de GER,DF,30.0,19.7,1352.0,173.0,693.0,636.0,28.0,0.0,1352.0,2.0,2.0,100.0,0.0,0.0,849.0,5240.0,3273.0,16.0,5.0,0.0,10.0,3.0,859.0,3.0,Matches,489.0,de GER,DF,30.0,19.7,0.0,0.0,0.0,,0.0,0.0,,,,0.0,0.0,0.0,0.0,0.0,,0.0,0.0,Matches,489.0,de GER,DF,30.0,22.0,22.0,1775.0,19.7,0.0,0.0,0.0,0.0,0.0,0.0,8.0,0.0,0.0,0.0,0.4,0.4,16.0,104.0,3.0,0.0,0.0,0.0,0.0,0.0,0.0,0.02,0.02,0.0,0.02,Matches,Kevin Vogt,D/DM C,30,136,141,Germany,TSG Hoffenheim,6,9,8,5,10,7,12,7,15,12,14,5,13,11,13,12,14,14,13,10,15,15,7,15,9,13,16,12,12,8,13,16,13,16,14,16,15,11,13,9,15,2,1,2,3,2,2,3,3,1,3,1,9,15,12,12,11,13,10,8,1,1,20,12,1,1,17,1,15,1,1,8,1,1,194,85,12,20,6877657,6750,6750,5250,Northern_European,134,3,1991/9/23,0,0,44109.0,,91004433
226,Julian Weigl,Gladbach,1995,494.0,de GER,MF,26.0,21.0,43.0,16.0,21.0,21.0,1.0,23.0,41.0,56.1,18.0,23.0,2.0,21.0,18.0,61.0,32.0,0.0,Matches,494.0,de GER,MF,26.0,21.0,22.0,1.04,21.0,0.0,0.0,0.0,1.0,0.0,2.0,0.09,2.0,0.0,0.0,0.0,0.0,0.0,Matches,,,,,,,,,,,,,,,,,,,,,,,,,,,,,,,,,,,,,,,,,,,,,,,,,,,,,,,,494.0,de GER,MF,26.0,21.0,6.0,0.0,0.0,21.0,29.0,0.0,0.0,18.0,16.0,0.0,0.0,0.0,116.0,18.0,13.0,58.1,Matches,494.0,de GER,MF,26.0,21.0,1203.0,1140.0,60.0,55.0,3.0,6.0,0.0,5.0,0.0,0.0,0.0,0.0,1072.0,3.0,12.0,Matches,494.0,de GER,MF,26.0,21.0,1072.0,1203.0,89.1,19320.0,5266.0,444.0,476.0,93.3,513.0,552.0,92.9,98.0,137.0,71.5,0.0,0.6,0.8,-0.6,6.0,66.0,5.0,0.0,82.0,Matches,575,de GER,MF,26,23,1894.0,82.0,61.9,21.0,21,88.0,18,2,19.0,1,1.26,38.0,35.0,3.0,0.14,0.61,31.8,35.0,-3.2,-0.15,-0.29,Matches,494.0,de GER,MF,26.0,21.0,1348.0,53.0,374.0,894.0,87.0,12.0,1347.0,13.0,9.0,69.2,1.0,7.7,745.0,2991.0,1462.0,7.0,11.0,0.0,2.0,2.0,979.0,7.0,Matches,494.0,de GER,MF,26.0,21.0,1.0,7.0,0.0,0.0,0.33,0.0,0.0,,16.7,0.0,1.0,1.0,1.1,0.3,0.04,-0.1,-0.3,Matches,494.0,de GER,MF,26.0,23.0,21.0,1894.0,21.0,1.0,0.0,1.0,0.0,1.0,1.0,6.0,0.0,1.1,0.3,0.6,0.8,7.0,82.0,7.0,0.05,0.0,0.05,0.0,0.0,0.05,0.03,0.08,0.01,0.04,Matches,Julian Weigl,DM/M C,26,142,150,Germany,SL Benfica,5,7,11,8,16,6,12,10,5,12,17,7,14,16,14,16,12,18,16,15,15,13,11,8,10,16,17,13,11,12,16,12,16,12,16,11,16,12,12,6,10,2,1,4,2,3,3,2,1,1,2,2,8,12,10,12,13,16,14,15,1,1,14,1,1,1,20,1,19,1,1,10,1,1,186,80,8,20,15988499,7100,7100,6200,Northern_European,142,4,1995/9/8,6,0,76711.0,Borussia Mönchengladbach,91124144
227,Mitchell Weiser,Werder Bremen,1994,496.0,de GER,DFFW,28.0,28.0,71.0,43.0,38.0,24.0,9.0,38.0,75.0,50.7,37.0,50.0,7.0,43.0,28.0,99.0,38.0,1.0,Matches,496.0,de GER,DFFW,28.0,28.0,89.0,3.18,69.0,3.0,7.0,2.0,8.0,0.0,16.0,0.57,12.0,1.0,1.0,1.0,1.0,0.0,Matches,,,,,,,,,,,,,,,,,,,,,,,,,,,,,,,,,,,,,,,,,,,,,,,,,,,,,,,,496.0,de GER,DFFW,28.0,28.0,7.0,0.0,0.0,36.0,57.0,5.0,75.0,28.0,43.0,1.0,0.0,0.0,196.0,25.0,29.0,46.3,Matches,496.0,de GER,DFFW,28.0,28.0,1341.0,1057.0,281.0,8.0,7.0,14.0,75.0,273.0,0.0,0.0,0.0,0.0,960.0,3.0,47.0,Matches,496.0,de GER,DFFW,28.0,28.0,960.0,1341.0,71.6,15772.0,6811.0,494.0,592.0,83.4,357.0,483.0,73.9,83.0,168.0,49.4,9.0,5.6,6.9,3.4,40.0,91.0,48.0,17.0,120.0,Matches,577,de GER,DFFW,28,30,2516.0,84.0,82.2,28.0,29,86.0,23,1,23.0,0,1.0,42.0,56.0,-14.0,-0.5,-0.67,34.1,43.8,-9.7,-0.35,0.0,Matches,496.0,de GER,DFFW,28.0,28.0,1789.0,66.0,390.0,861.0,566.0,78.0,1789.0,121.0,43.0,35.5,58.0,47.9,907.0,4440.0,2055.0,62.0,46.0,18.0,81.0,41.0,997.0,169.0,Matches,496.0,de GER,DFFW,28.0,28.0,2.0,28.0,8.0,28.6,1.0,0.29,0.07,0.25,17.9,0.0,0.0,0.0,2.6,2.6,0.09,-0.6,-0.6,Matches,496.0,de GER,DFFW,28.0,30.0,29.0,2516.0,28.0,2.0,9.0,11.0,2.0,0.0,0.0,7.0,0.0,2.6,2.6,5.6,8.2,62.0,120.0,169.0,0.07,0.32,0.39,0.07,0.39,0.09,0.2,0.29,0.09,0.29,Matches,Mitchell Weiser,D/WB/M R,28,127,137,Germany,SV Werder Bremen,10,13,14,9,13,12,6,11,10,10,13,9,11,13,10,12,8,12,10,12,13,8,13,7,11,10,12,9,14,15,11,8,13,14,11,9,8,7,13,14,18,2,3,3,3,3,1,1,1,2,2,2,7,12,14,10,13,8,9,7,1,13,1,20,13,20,1,12,1,17,12,1,15,1,177,71,12,20,2647272,6250,6250,5250,Northern_European,111,2,1994/4/21,0,0,37499.0,,92016244
228,Timo Werner,RB Leipzig,1996,499.0,de GER,FWMF,26.0,21.5,10.0,5.0,4.0,3.0,3.0,4.0,12.0,33.3,8.0,12.0,0.0,12.0,7.0,17.0,5.0,0.0,Matches,499.0,de GER,FWMF,26.0,21.5,54.0,2.51,40.0,0.0,6.0,7.0,1.0,0.0,7.0,0.33,6.0,0.0,1.0,0.0,0.0,0.0,Matches,,,,,,,,,,,,,,,,,,,,,,,,,,,,,,,,,,,,,,,,,,,,,,,,,,,,,,,,499.0,de GER,FWMF,26.0,21.5,2.0,0.0,0.0,6.0,13.0,25.0,29.0,7.0,5.0,0.0,0.0,0.0,55.0,5.0,11.0,31.3,Matches,499.0,de GER,FWMF,26.0,21.5,685.0,644.0,34.0,5.0,4.0,6.0,29.0,17.0,1.0,0.0,0.0,0.0,505.0,7.0,26.0,Matches,499.0,de GER,FWMF,26.0,21.5,505.0,685.0,73.7,7147.0,1425.0,301.0,360.0,83.6,162.0,222.0,73.0,22.0,35.0,62.9,3.0,3.1,3.0,-0.1,20.0,38.0,19.0,2.0,51.0,Matches,580,de GER,FWMF,26,27,1937.0,72.0,63.3,21.5,23,80.0,8,4,26.0,0,1.81,35.0,23.0,12.0,0.56,-0.32,34.4,21.8,12.5,0.58,-0.45,Matches,499.0,de GER,FWMF,26.0,21.5,904.0,6.0,65.0,367.0,479.0,133.0,904.0,64.0,27.0,42.2,32.0,50.0,578.0,3302.0,1482.0,65.0,20.0,44.0,53.0,21.0,716.0,209.0,Matches,499.0,de GER,FWMF,26.0,21.5,9.0,61.0,24.0,39.3,2.83,1.12,0.15,0.38,15.0,0.0,0.0,0.0,9.1,9.1,0.15,-0.1,-0.1,Matches,499.0,de GER,FWMF,26.0,27.0,23.0,1937.0,21.5,9.0,3.0,12.0,9.0,0.0,0.0,2.0,0.0,9.1,9.1,3.1,12.2,65.0,51.0,209.0,0.42,0.14,0.56,0.42,0.56,0.42,0.15,0.57,0.42,0.57,Matches,Timo Werner,AM/S L,26,154,161,Germany,RB Leipzig,6,9,12,12,11,7,13,10,4,6,11,17,8,12,16,13,11,13,12,12,11,12,11,6,16,5,15,18,18,14,17,11,15,17,16,12,15,5,12,3,12,1,3,3,3,2,2,1,2,3,1,2,8,16,8,13,10,13,8,14,1,1,1,1,1,1,1,15,1,12,18,10,13,20,180,75,13,20,56430002,7600,7800,7000,Northern_European,140,2,1996/3/6,53,24,191781.0,,92051583
229,Silvan Widmer,Mainz 05,1993,500.0,ch SUI,DF,29.0,18.8,26.0,17.0,15.0,10.0,1.0,20.0,39.0,51.3,19.0,22.0,8.0,14.0,31.0,57.0,28.0,0.0,Matches,500.0,ch SUI,DF,29.0,18.8,41.0,2.19,23.0,12.0,0.0,4.0,2.0,0.0,3.0,0.16,1.0,1.0,0.0,0.0,1.0,0.0,Matches,,,,,,,,,,,,,,,,,,,,,,,,,,,,,,,,,,,,,,,,,,,,,,,,,,,,,,,,500.0,ch SUI,DF,29.0,18.8,0.0,0.0,0.0,11.0,16.0,3.0,32.0,31.0,17.0,1.0,0.0,0.0,98.0,17.0,25.0,40.5,Matches,500.0,ch SUI,DF,29.0,18.8,873.0,642.0,226.0,12.0,0.0,2.0,32.0,214.0,0.0,0.0,0.0,0.0,597.0,5.0,25.0,Matches,500.0,ch SUI,DF,29.0,18.8,597.0,873.0,68.4,9838.0,4441.0,314.0,374.0,84.0,222.0,323.0,68.7,47.0,122.0,38.5,2.0,2.0,1.6,0.0,15.0,43.0,17.0,5.0,54.0,Matches,581,ch SUI,DF,29,26,1688.0,65.0,55.2,18.8,19,81.0,10,7,21.0,0,1.38,28.0,29.0,-1.0,-0.05,-0.05,27.6,27.1,0.4,0.02,0.48,Matches,500.0,ch SUI,DF,29.0,18.8,1049.0,38.0,266.0,504.0,287.0,50.0,1049.0,14.0,8.0,57.1,6.0,42.9,464.0,1820.0,847.0,14.0,9.0,3.0,22.0,12.0,508.0,91.0,Matches,500.0,ch SUI,DF,29.0,18.8,2.0,19.0,6.0,31.6,1.01,0.32,0.11,0.33,10.8,0.0,0.0,0.0,2.5,2.5,0.13,-0.5,-0.5,Matches,500.0,ch SUI,DF,29.0,26.0,19.0,1688.0,18.8,2.0,2.0,4.0,2.0,0.0,0.0,0.0,0.0,2.5,2.5,2.0,4.5,14.0,54.0,91.0,0.11,0.11,0.21,0.11,0.21,0.13,0.11,0.24,0.13,0.24,Matches,Silvan Widmer,D/WB RC,29,136,140,Switzerland,1. FSV Mainz 05,4,12,11,9,12,3,12,9,17,12,12,7,13,12,13,13,14,12,12,11,12,16,11,15,14,12,15,17,14,12,13,11,18,15,16,12,16,12,15,9,13,3,3,2,2,3,2,3,1,2,3,1,16,13,7,15,16,18,12,12,1,10,16,20,10,18,1,8,1,10,1,1,1,1,183,79,11,20,8716940,6800,6900,5300,Northern_European,131,2,1993/3/5,31,2,30684.0,,98010781
230,Patrick Wimmer,Wolfsburg,2001,501.0,at AUT,FWMF,21.0,18.3,39.0,26.0,18.0,11.0,10.0,12.0,38.0,31.6,26.0,27.0,2.0,25.0,15.0,54.0,15.0,0.0,Matches,501.0,at AUT,FWMF,21.0,18.3,72.0,3.94,45.0,10.0,6.0,4.0,6.0,1.0,12.0,0.66,7.0,3.0,2.0,0.0,0.0,0.0,Matches,,,,,,,,,,,,,,,,,,,,,,,,,,,,,,,,,,,,,,,,,,,,,,,,,,,,,,,,501.0,at AUT,FWMF,21.0,18.3,7.0,0.0,0.0,42.0,32.0,7.0,66.0,15.0,26.0,2.0,0.0,0.0,91.0,22.0,31.0,41.5,Matches,501.0,at AUT,FWMF,21.0,18.3,549.0,473.0,72.0,17.0,4.0,4.0,66.0,21.0,31.0,20.0,7.0,0.0,334.0,4.0,38.0,Matches,501.0,at AUT,FWMF,21.0,18.3,334.0,549.0,60.8,5267.0,1842.0,168.0,234.0,71.8,122.0,161.0,75.8,26.0,76.0,34.2,8.0,5.0,5.6,3.0,37.0,23.0,30.0,8.0,64.0,Matches,582,at AUT,FWMF,21,26,1648.0,63.0,53.9,18.3,23,69.0,1,3,21.0,0,1.58,34.0,26.0,8.0,0.44,0.37,28.6,25.1,3.4,0.19,0.4,Matches,501.0,at AUT,FWMF,21.0,18.3,820.0,16.0,100.0,310.0,425.0,67.0,820.0,66.0,26.0,39.4,33.0,50.0,446.0,2681.0,1205.0,42.0,17.0,13.0,50.0,30.0,480.0,133.0,Matches,501.0,at AUT,FWMF,21.0,18.3,4.0,31.0,14.0,45.2,1.69,0.76,0.13,0.29,13.9,0.0,0.0,0.0,4.4,4.4,0.14,-0.4,-0.4,Matches,501.0,at AUT,FWMF,21.0,26.0,23.0,1648.0,18.3,4.0,8.0,12.0,4.0,0.0,0.0,7.0,0.0,4.4,4.4,5.0,9.3,42.0,64.0,133.0,0.22,0.44,0.66,0.22,0.66,0.24,0.27,0.51,0.24,0.51,Matches,Patrick Wimmer,AM RL,21,135,153,Austria,VfL Wolfsburg,12,10,15,11,12,12,8,11,5,9,12,7,12,13,15,12,16,12,12,13,12,16,15,5,13,10,16,16,15,13,11,11,14,15,13,11,13,9,12,7,19,2,3,2,1,2,2,2,2,1,3,3,14,16,6,8,12,14,11,9,1,10,1,12,10,12,8,15,12,15,18,12,20,10,182,77,12,20,12473999,6748,6001,5808,Northern_European,133,2,2001/5/30,1,0,38355.0,,16253898
231,Jonas Wind,Wolfsburg,1999,502.0,dk DEN,FW,23.0,14.3,14.0,6.0,2.0,7.0,5.0,5.0,10.0,50.0,5.0,14.0,4.0,10.0,1.0,15.0,10.0,0.0,Matches,502.0,dk DEN,FW,23.0,14.3,37.0,2.58,27.0,0.0,0.0,8.0,2.0,0.0,6.0,0.42,4.0,0.0,0.0,1.0,1.0,0.0,Matches,,,,,,,,,,,,,,,,,,,,,,,,,,,,,,,,,,,,,,,,,,,,,,,,,,,,,,,,502.0,dk DEN,FW,23.0,14.3,1.0,0.0,0.0,17.0,22.0,0.0,2.0,1.0,6.0,0.0,0.0,0.0,43.0,61.0,55.0,52.6,Matches,502.0,dk DEN,FW,23.0,14.3,371.0,362.0,6.0,2.0,2.0,1.0,2.0,0.0,0.0,0.0,0.0,0.0,247.0,3.0,13.0,Matches,502.0,dk DEN,FW,23.0,14.3,247.0,371.0,66.6,3189.0,901.0,166.0,215.0,77.2,63.0,98.0,64.3,5.0,10.0,50.0,0.0,1.3,2.0,-1.3,14.0,37.0,11.0,0.0,41.0,Matches,583,dk DEN,FW,23,24,1291.0,54.0,42.2,14.3,15,75.0,3,9,18.0,1,1.54,26.0,18.0,8.0,0.56,0.51,23.5,23.7,-0.2,-0.02,-0.03,Matches,502.0,dk DEN,FW,23.0,14.3,536.0,16.0,42.0,267.0,232.0,62.0,535.0,20.0,7.0,35.0,13.0,65.0,302.0,941.0,325.0,7.0,13.0,1.0,46.0,18.0,406.0,89.0,Matches,502.0,dk DEN,FW,23.0,14.3,6.0,29.0,10.0,34.5,2.02,0.7,0.21,0.6,13.4,0.0,0.0,1.0,5.2,4.4,0.15,0.8,1.6,Matches,502.0,dk DEN,FW,23.0,24.0,15.0,1291.0,14.3,6.0,0.0,6.0,6.0,0.0,1.0,1.0,0.0,5.2,4.4,1.3,5.8,7.0,41.0,89.0,0.42,0.0,0.42,0.42,0.42,0.36,0.09,0.46,0.31,0.4,Matches,Jonas Wind,AM/S C,23,136,150,Denmark,VfL Wolfsburg,2,7,12,13,15,13,14,11,3,7,14,17,7,16,11,13,13,15,13,15,13,16,15,6,14,7,12,12,11,12,15,16,13,11,14,16,12,7,15,10,11,3,3,4,1,1,1,4,1,1,3,1,15,15,8,18,16,15,14,15,1,1,1,1,1,1,1,1,12,1,12,18,12,20,190,82,12,20,17655135,6800,6750,5900,Northern_European,136,4,1999/2/7,15,5,38355.0,,27122565
232,Florian Wirtz,Leverkusen,2003,504.0,de GER,FWMF,19.0,12.1,18.0,10.0,9.0,7.0,2.0,8.0,16.0,50.0,8.0,15.0,1.0,14.0,1.0,19.0,6.0,0.0,Matches,504.0,de GER,FWMF,19.0,12.1,64.0,5.28,47.0,8.0,5.0,1.0,3.0,0.0,8.0,0.66,7.0,0.0,1.0,0.0,0.0,0.0,Matches,,,,,,,,,,,,,,,,,,,,,,,,,,,,,,,,,,,,,,,,,,,,,,,,,,,,,,,,504.0,de GER,FWMF,19.0,12.1,4.0,0.0,0.0,13.0,27.0,1.0,43.0,1.0,10.0,0.0,0.0,0.0,77.0,2.0,12.0,14.3,Matches,504.0,de GER,FWMF,19.0,12.1,634.0,558.0,74.0,21.0,15.0,9.0,43.0,11.0,30.0,17.0,8.0,0.0,473.0,2.0,11.0,Matches,504.0,de GER,FWMF,19.0,12.1,473.0,634.0,74.6,7333.0,2166.0,262.0,307.0,85.3,141.0,186.0,75.8,44.0,91.0,48.4,6.0,3.9,3.1,2.1,39.0,43.0,26.0,3.0,80.0,Matches,585,de GER,FWMF,19,17,1090.0,64.0,35.6,12.1,11,82.0,5,6,31.0,0,1.53,22.0,15.0,7.0,0.58,0.53,20.0,12.2,7.8,0.64,0.61,Matches,504.0,de GER,FWMF,19.0,12.1,787.0,6.0,73.0,411.0,315.0,35.0,787.0,85.0,48.0,56.5,34.0,40.0,487.0,2638.0,1331.0,36.0,26.0,9.0,40.0,28.0,580.0,86.0,Matches,504.0,de GER,FWMF,19.0,12.1,1.0,7.0,4.0,57.1,0.58,0.33,0.14,0.25,18.6,0.0,0.0,0.0,0.8,0.8,0.11,0.2,0.2,Matches,504.0,de GER,FWMF,19.0,17.0,11.0,1090.0,12.1,1.0,6.0,7.0,1.0,0.0,0.0,4.0,0.0,0.8,0.8,3.9,4.7,36.0,80.0,86.0,0.08,0.5,0.58,0.08,0.58,0.06,0.32,0.39,0.06,0.39,Matches,Florian Wirtz,M/AM C,19,143,-9,Germany,Bayer 04 Leverkusen,12,11,15,13,15,11,7,13,5,7,15,11,10,16,13,14,13,14,12,15,13,15,15,8,14,8,14,16,14,15,12,8,13,13,14,8,14,6,15,14,12,3,1,3,2,4,2,3,1,2,3,2,10,14,7,13,15,13,12,12,1,1,1,1,1,1,1,12,16,12,13,20,13,10,176,72,12,20,120096006,7250,7250,6250,Northern_European,143,3,2003/5/3,4,0,86300.0,,91193048
233,Marius Wolf,Dortmund,1995,506.0,de GER,DF,27.0,17.4,25.0,18.0,9.0,12.0,4.0,16.0,29.0,55.2,13.0,40.0,10.0,30.0,18.0,43.0,22.0,1.0,Matches,506.0,de GER,DF,27.0,17.4,48.0,2.75,36.0,0.0,8.0,1.0,2.0,1.0,6.0,0.34,5.0,0.0,1.0,0.0,0.0,0.0,Matches,,,,,,,,,,,,,,,,,,,,,,,,,,,,,,,,,,,,,,,,,,,,,,,,,,,,,,,,506.0,de GER,DF,27.0,17.4,2.0,0.0,0.0,12.0,22.0,3.0,61.0,18.0,18.0,0.0,0.0,0.0,92.0,6.0,6.0,50.0,Matches,506.0,de GER,DF,27.0,17.4,1061.0,889.0,172.0,21.0,4.0,8.0,61.0,149.0,2.0,2.0,0.0,0.0,834.0,0.0,38.0,Matches,506.0,de GER,DF,27.0,17.4,834.0,1061.0,78.6,13553.0,4900.0,428.0,484.0,88.4,302.0,366.0,82.5,75.0,129.0,58.1,1.0,2.9,3.2,-1.9,22.0,60.0,29.0,14.0,91.0,Matches,587,de GER,DF,27,25,1570.0,63.0,51.3,17.4,17,82.0,11,8,21.0,2,2.32,48.0,20.0,28.0,1.61,0.94,37.5,20.9,16.6,0.95,0.26,Matches,506.0,de GER,DF,27.0,17.4,1265.0,42.0,350.0,522.0,411.0,50.0,1265.0,62.0,34.0,54.8,22.0,35.5,711.0,3580.0,1960.0,60.0,45.0,13.0,27.0,12.0,826.0,151.0,Matches,506.0,de GER,DF,27.0,17.4,1.0,23.0,6.0,26.1,1.32,0.34,0.04,0.17,19.4,0.0,0.0,0.0,1.2,1.2,0.05,-0.2,-0.2,Matches,506.0,de GER,DF,27.0,25.0,17.0,1570.0,17.4,1.0,1.0,2.0,1.0,0.0,0.0,2.0,0.0,1.2,1.2,2.9,4.0,60.0,91.0,151.0,0.06,0.06,0.11,0.06,0.11,0.07,0.16,0.23,0.07,0.23,Matches,Marius Wolf,WB/M/AM RL,27,142,143,Germany,Borussia Dortmund,10,12,12,12,11,9,9,12,12,10,11,13,10,11,17,11,16,11,11,11,11,17,13,12,11,10,14,17,15,10,10,12,16,15,17,12,13,6,14,8,17,4,1,4,4,2,3,1,1,1,1,1,7,16,12,6,11,15,11,13,1,8,1,15,12,18,1,14,1,20,16,1,20,8,188,81,10,20,10872297,6850,6850,4500,Northern_European,124,1,1995/5/27,0,0,67077.0,,91124151
234,Maya Yoshida,Schalke 04,1988,509.0,jp JPN,DF,33.0,28.4,34.0,22.0,19.0,13.0,2.0,18.0,29.0,62.1,11.0,40.0,29.0,11.0,46.0,80.0,132.0,2.0,Matches,509.0,jp JPN,DF,33.0,28.4,28.0,0.99,22.0,1.0,0.0,1.0,3.0,1.0,0.0,0.0,0.0,0.0,0.0,0.0,0.0,0.0,Matches,,,,,,,,,,,,,,,,,,,,,,,,,,,,,,,,,,,,,,,,,,,,,,,,,,,,,,,,509.0,jp JPN,DF,33.0,28.4,4.0,0.0,0.0,20.0,18.0,1.0,8.0,46.0,22.0,0.0,1.0,0.0,168.0,83.0,42.0,66.4,Matches,509.0,jp JPN,DF,33.0,28.4,1407.0,1338.0,63.0,57.0,2.0,14.0,8.0,5.0,0.0,0.0,0.0,0.0,1071.0,6.0,9.0,Matches,509.0,jp JPN,DF,33.0,28.4,1071.0,1407.0,76.1,23423.0,8479.0,252.0,318.0,79.2,653.0,729.0,89.6,163.0,326.0,50.0,0.0,0.1,0.8,-0.1,4.0,70.0,10.0,1.0,85.0,Matches,591,jp JPN,DF,33,29,2553.0,88.0,83.4,28.4,28,90.0,27,1,45.0,2,0.83,23.0,54.0,-31.0,-1.09,-0.21,31.8,45.5,-13.7,-0.48,0.2,Matches,509.0,jp JPN,DF,33.0,28.4,1716.0,245.0,997.0,678.0,56.0,22.0,1716.0,8.0,6.0,75.0,2.0,25.0,837.0,3625.0,1620.0,7.0,8.0,1.0,12.0,2.0,920.0,4.0,Matches,509.0,jp JPN,DF,33.0,28.4,0.0,12.0,2.0,16.7,0.42,0.07,0.0,0.0,13.9,0.0,0.0,0.0,1.0,1.0,0.08,-1.0,-1.0,Matches,509.0,jp JPN,DF,33.0,29.0,28.0,2553.0,28.4,0.0,0.0,0.0,0.0,0.0,0.0,4.0,0.0,1.0,1.0,0.1,1.1,7.0,85.0,4.0,0.0,0.0,0.0,0.0,0.0,0.04,0.0,0.04,0.04,0.04,Matches,Maya Yoshida,D C,33,125,142,Japan,FC Schalke 04,4,6,6,7,11,6,13,6,6,15,11,8,12,12,12,13,15,12,12,10,12,16,8,16,8,16,16,12,10,10,13,14,18,12,12,13,12,7,16,4,12,2,2,2,1,3,2,1,3,4,1,3,16,16,3,12,15,18,15,13,1,12,20,12,1,1,12,1,1,1,1,1,1,1,189,90,11,20,241887,6248,5998,5748,Asian,123,9,1988/8/24,119,12,31644.0,,45005892
235,Dan-Axel Zagadou,Stuttgart,1999,510.0,fr FRA,DF,23.0,14.1,14.0,9.0,10.0,4.0,0.0,5.0,14.0,35.7,9.0,19.0,16.0,3.0,21.0,35.0,81.0,1.0,Matches,510.0,fr FRA,DF,23.0,14.1,14.0,0.99,12.0,0.0,0.0,2.0,0.0,0.0,1.0,0.07,0.0,0.0,0.0,1.0,0.0,0.0,Matches,,,,,,,,,,,,,,,,,,,,,,,,,,,,,,,,,,,,,,,,,,,,,,,,,,,,,,,,510.0,fr FRA,DF,23.0,14.1,3.0,0.0,0.0,12.0,2.0,0.0,0.0,21.0,9.0,0.0,3.0,0.0,83.0,53.0,20.0,72.6,Matches,510.0,fr FRA,DF,23.0,14.1,985.0,956.0,25.0,19.0,0.0,6.0,0.0,6.0,0.0,0.0,0.0,0.0,841.0,4.0,6.0,Matches,510.0,fr FRA,DF,23.0,14.1,841.0,985.0,85.4,17357.0,6453.0,237.0,273.0,86.8,478.0,523.0,91.4,124.0,171.0,72.5,0.0,0.6,0.2,-0.6,9.0,45.0,1.0,0.0,44.0,Matches,592,fr FRA,DF,23,17,1271.0,75.0,41.5,14.1,14,86.0,11,3,20.0,5,1.06,18.0,26.0,-8.0,-0.57,-0.37,19.8,21.7,-1.9,-0.13,-0.35,Matches,510.0,fr FRA,DF,23.0,14.1,1150.0,155.0,631.0,497.0,28.0,20.0,1150.0,1.0,1.0,100.0,0.0,0.0,673.0,2911.0,1308.0,3.0,1.0,0.0,5.0,3.0,787.0,0.0,Matches,510.0,fr FRA,DF,23.0,14.1,0.0,13.0,3.0,23.1,0.92,0.21,0.0,0.0,11.1,0.0,0.0,0.0,1.7,1.7,0.13,-1.7,-1.7,Matches,510.0,fr FRA,DF,23.0,17.0,14.0,1271.0,14.1,0.0,0.0,0.0,0.0,0.0,0.0,3.0,0.0,1.7,1.7,0.6,2.2,3.0,44.0,0.0,0.0,0.0,0.0,0.0,0.0,0.12,0.04,0.16,0.12,0.16,Matches,Dan-Axel Zagadou,D LC,23,136,153,"France,Ivory Coast",VfB Stuttgart,3,8,9,6,14,4,13,5,10,14,14,7,14,14,11,13,15,13,13,12,15,12,8,9,8,15,15,10,11,8,15,17,11,13,11,17,14,7,16,16,8,3,2,3,2,2,1,1,3,2,3,2,11,13,8,10,14,14,13,17,1,16,20,1,12,1,12,1,1,1,1,1,1,1,196,90,20,9,15923083,6500,6024,5019,African_Caribbean,134,15,1999/6/3,0,0,14999.0,,48043086
236,Rodrigo Zalazar,Schalke 04,1999,511.0,uy URU,MFFW,22.0,14.7,16.0,8.0,5.0,9.0,2.0,9.0,24.0,37.5,15.0,16.0,1.0,15.0,7.0,23.0,13.0,0.0,Matches,511.0,uy URU,MFFW,22.0,14.7,63.0,4.3,23.0,23.0,3.0,7.0,7.0,0.0,8.0,0.55,5.0,3.0,0.0,0.0,0.0,0.0,Matches,,,,,,,,,,,,,,,,,,,,,,,,,,,,,,,,,,,,,,,,,,,,,,,,,,,,,,,,511.0,uy URU,MFFW,22.0,14.7,4.0,0.0,0.0,22.0,36.0,4.0,115.0,7.0,8.0,0.0,0.0,0.0,97.0,24.0,39.0,38.1,Matches,511.0,uy URU,MFFW,22.0,14.7,429.0,319.0,106.0,44.0,6.0,2.0,115.0,4.0,56.0,28.0,24.0,3.0,253.0,4.0,20.0,Matches,511.0,uy URU,MFFW,22.0,14.7,253.0,429.0,59.0,5131.0,1977.0,108.0,144.0,75.0,78.0,112.0,69.6,59.0,134.0,44.0,6.0,4.5,4.6,1.5,35.0,20.0,18.0,7.0,34.0,Matches,593,uy URU,MFFW,22,22,1321.0,60.0,43.2,14.7,15,74.0,2,7,29.0,3,1.09,18.0,22.0,-4.0,-0.27,1.38,18.5,21.8,-3.3,-0.22,0.51,Matches,511.0,uy URU,MFFW,22.0,14.7,667.0,9.0,94.0,304.0,296.0,40.0,667.0,83.0,35.0,42.2,36.0,43.4,347.0,2292.0,785.0,26.0,20.0,4.0,52.0,31.0,351.0,47.0,Matches,511.0,uy URU,MFFW,22.0,14.7,1.0,38.0,13.0,34.2,2.59,0.89,0.03,0.08,21.6,10.0,0.0,0.0,3.1,3.1,0.08,-2.1,-2.1,Matches,511.0,uy URU,MFFW,22.0,22.0,15.0,1321.0,14.7,1.0,6.0,7.0,1.0,0.0,0.0,4.0,0.0,3.1,3.1,4.5,7.5,26.0,34.0,47.0,0.07,0.41,0.48,0.07,0.48,0.21,0.31,0.51,0.21,0.51,Matches,Rodrigo Zalazar,M/AM RLC,22,127,149,"Uruguay,Spain",FC Schalke 04,13,11,15,12,13,12,8,15,4,11,13,12,12,15,16,12,15,13,12,13,12,17,16,7,13,12,12,17,13,14,12,8,15,14,13,11,13,10,16,5,14,3,1,3,1,2,1,1,3,1,3,3,14,13,10,12,12,12,9,9,1,1,1,1,1,1,12,12,20,12,15,16,15,8,178,72,8,20,2700000,6399,5643,4966,Mediterranean_Hispanic,129,9,1999/8/12,0,0,25889.0,,67271371
237,Robin Zentner,Mainz 05,1994,513.0,de GER,GK,27.0,26.0,0.0,0.0,0.0,0.0,0.0,0.0,4.0,0.0,4.0,0.0,0.0,0.0,0.0,0.0,17.0,1.0,Matches,513.0,de GER,GK,27.0,26.0,9.0,0.35,3.0,6.0,0.0,0.0,0.0,0.0,2.0,0.08,1.0,1.0,0.0,0.0,0.0,0.0,Matches,34.0,de GER,GK,27.0,26.0,39.0,3.0,1.0,2.0,0.0,35.4,0.3,-3.6,-0.14,160.0,474.0,33.8,672.0,146.0,50.0,40.0,194.0,71.1,54.1,321.0,43.0,13.4,53.0,2.04,17.4,Matches,34.0,de GER,GK,27.0,26.0,26.0,2340.0,26.0,39.0,1.5,109.0,69.0,67.0,9.0,8.0,9.0,7.0,26.9,5.0,3.0,1.0,1.0,25.0,Matches,513.0,de GER,GK,27.0,26.0,1.0,0.0,0.0,0.0,3.0,0.0,0.0,0.0,0.0,0.0,0.0,0.0,43.0,16.0,0.0,100.0,Matches,513.0,de GER,GK,27.0,26.0,868.0,611.0,255.0,61.0,0.0,1.0,0.0,0.0,0.0,0.0,0.0,0.0,532.0,2.0,0.0,Matches,513.0,de GER,GK,27.0,26.0,532.0,868.0,61.3,17507.0,13349.0,63.0,63.0,100.0,237.0,244.0,97.1,232.0,559.0,41.5,0.0,0.1,0.2,-0.1,1.0,26.0,1.0,0.0,6.0,Matches,596,de GER,GK,27,26,2340.0,90.0,76.5,26.0,26,90.0,26,0,,1,1.35,37.0,39.0,-2.0,-0.08,-0.2,33.9,38.4,-4.5,-0.17,0.08,Matches,513.0,de GER,GK,27.0,26.0,941.0,729.0,917.0,19.0,5.0,4.0,941.0,0.0,0.0,,0.0,,520.0,2965.0,1677.0,0.0,0.0,0.0,1.0,0.0,334.0,1.0,Matches,513.0,de GER,GK,27.0,26.0,0.0,0.0,0.0,,0.0,0.0,,,,0.0,0.0,0.0,0.0,0.0,,0.0,0.0,Matches,513.0,de GER,GK,27.0,26.0,26.0,2340.0,26.0,0.0,0.0,0.0,0.0,0.0,0.0,1.0,0.0,0.0,0.0,0.1,0.1,0.0,6.0,1.0,0.0,0.0,0.0,0.0,0.0,0.0,0.0,0.0,0.0,0.0,Matches,Robin Zentner,GK,27,128,132,Germany,1. FSV Mainz 05,5,3,2,2,8,6,6,3,2,3,8,2,1,8,8,12,12,12,12,8,12,16,5,14,3,12,12,12,11,15,13,17,14,11,12,16,13,5,14,13,11,14,15,14,8,13,11,13,13,16,10,12,7,13,6,19,13,16,14,10,20,1,1,1,1,1,1,1,1,1,1,1,1,1,194,96,7,20,2943143,6400,6400,4900,Northern_European,128,2,1994/10/28,0,0,28766.0,,91105813
238,Simon Zoller,Bochum,1991,515.0,de GER,FW,31.0,16.2,11.0,4.0,2.0,8.0,1.0,4.0,12.0,33.3,8.0,14.0,1.0,13.0,6.0,17.0,21.0,0.0,Matches,515.0,de GER,FW,31.0,16.2,20.0,1.24,16.0,1.0,1.0,1.0,1.0,0.0,2.0,0.12,2.0,0.0,0.0,0.0,0.0,0.0,Matches,,,,,,,,,,,,,,,,,,,,,,,,,,,,,,,,,,,,,,,,,,,,,,,,,,,,,,,,515.0,de GER,FW,31.0,16.2,5.0,0.0,0.0,21.0,8.0,7.0,16.0,6.0,4.0,0.0,1.0,0.0,57.0,15.0,20.0,42.9,Matches,515.0,de GER,FW,31.0,16.2,332.0,308.0,23.0,0.0,2.0,2.0,16.0,7.0,0.0,0.0,0.0,0.0,208.0,1.0,16.0,Matches,515.0,de GER,FW,31.0,16.2,208.0,332.0,62.7,3203.0,725.0,118.0,171.0,69.0,72.0,115.0,62.6,13.0,19.0,68.4,2.0,1.1,0.5,0.9,9.0,16.0,4.0,0.0,21.0,Matches,599,de GER,FW,31,27,1457.0,54.0,47.6,16.2,19,72.0,4,8,12.0,2,0.96,17.0,39.0,-22.0,-1.36,-0.8,17.0,32.9,-15.9,-0.98,-0.43,Matches,515.0,de GER,FW,31.0,16.2,460.0,22.0,63.0,218.0,181.0,55.0,460.0,7.0,2.0,28.6,2.0,28.6,201.0,707.0,238.0,10.0,1.0,6.0,19.0,6.0,268.0,61.0,Matches,515.0,de GER,FW,31.0,16.2,3.0,30.0,9.0,30.0,1.85,0.56,0.1,0.33,12.6,0.0,0.0,0.0,4.1,4.1,0.14,-1.1,-1.1,Matches,515.0,de GER,FW,31.0,27.0,19.0,1457.0,16.2,3.0,2.0,5.0,3.0,0.0,0.0,5.0,0.0,4.1,4.1,1.1,5.2,10.0,21.0,61.0,0.19,0.12,0.31,0.19,0.31,0.26,0.07,0.32,0.26,0.32,Matches,Simon Zoller,S RL,31,121,128,Germany,VfL Bochum 1848,6,9,13,13,12,7,14,10,5,6,10,11,6,12,12,13,10,11,12,11,10,11,13,7,14,8,12,14,15,14,10,10,12,13,12,9,11,6,11,16,13,2,1,2,3,1,3,4,2,2,3,3,10,15,7,7,9,12,12,10,1,1,1,1,1,1,1,15,1,15,15,12,15,20,179,70,10,20,1309231,6050,6050,4400,Northern_European,114,4,1991/6/26,0,0,11506.0,,91007707
239,Brenden Aaronson,Leeds United,2000,1.0,us USA,MFFW,21.0,26.4,45.0,18.0,16.0,22.0,7.0,15.0,46.0,32.6,31.0,43.0,3.0,40.0,5.0,50.0,6.0,1.0,Matches,1.0,us USA,MFFW,21.0,26.4,95.0,3.6,57.0,17.0,7.0,5.0,8.0,1.0,7.0,0.27,3.0,1.0,0.0,1.0,1.0,1.0,Matches,,,,,,,,,,,,,,,,,,,,,,,,,,,,,,,,,,,,,,,,,,,,,,,,,,,,,,,,1.0,us USA,MFFW,21.0,26.4,2.0,0.0,0.0,16.0,55.0,6.0,72.0,5.0,18.0,0.0,0.0,0.0,128.0,8.0,39.0,17.0,Matches,1.0,us USA,MFFW,21.0,26.4,797.0,711.0,85.0,26.0,8.0,2.0,72.0,5.0,38.0,17.0,14.0,1.0,592.0,1.0,27.0,Matches,1.0,us USA,MFFW,21.0,26.4,592.0,797.0,74.3,7577.0,2182.0,346.0,423.0,81.8,150.0,195.0,76.9,25.0,65.0,38.5,3.0,4.2,2.6,-1.2,46.0,47.0,16.0,4.0,86.0,Matches,1,us USA,MFFW,21,36,2372.0,66.0,69.4,26.4,28,78.0,8,8,22.0,2,0.86,35.0,58.0,-23.0,-0.87,-0.27,33.3,49.8,-16.6,-0.63,-0.35,Matches,1.0,us USA,MFFW,21.0,26.4,1143.0,12.0,116.0,495.0,554.0,72.0,1143.0,100.0,34.0,34.0,48.0,48.0,686.0,3646.0,1532.0,43.0,34.0,13.0,71.0,82.0,767.0,151.0,Matches,1.0,us USA,MFFW,21.0,26.4,1.0,41.0,9.0,22.0,1.56,0.34,0.02,0.11,18.4,2.0,0.0,0.0,3.9,3.9,0.09,-2.9,-2.9,Matches,1.0,us USA,MFFW,21.0,36.0,28.0,2372.0,26.4,1.0,3.0,4.0,1.0,0.0,0.0,2.0,0.0,3.9,3.9,4.2,8.1,43.0,86.0,151.0,0.04,0.11,0.15,0.04,0.15,0.15,0.16,0.31,0.15,0.31,Matches,Brenden Aaronson,M/AM C,21,132,151,United States,Leeds United,11,12,14,11,13,8,8,11,6,8,14,10,9,13,12,12,13,12,11,13,12,11,11,7,11,8,13,15,16,15,13,9,13,15,14,10,12,5,7,5,11,3,2,1,2,2,3,3,2,2,3,1,17,12,2,10,10,12,10,12,1,1,1,1,1,1,1,12,18,14,12,20,14,1,176,66,10,20,32440569,6600,6600,5250,Northern_European,130,1,2000/10/22,22,6,46397.0,,20046423
240,Che Adams,Southampton,1996,3.0,sct SCO,FW,26.0,22.1,17.0,13.0,7.0,8.0,2.0,7.0,12.0,58.3,5.0,13.0,4.0,9.0,4.0,21.0,22.0,0.0,Matches,3.0,sct SCO,FW,26.0,22.1,57.0,2.57,44.0,1.0,2.0,5.0,5.0,0.0,7.0,0.32,5.0,0.0,0.0,0.0,2.0,0.0,Matches,,,,,,,,,,,,,,,,,,,,,,,,,,,,,,,,,,,,,,,,,,,,,,,,,,,,,,,,3.0,sct SCO,FW,26.0,22.1,1.0,0.0,0.0,38.0,27.0,14.0,12.0,4.0,13.0,0.0,0.0,0.0,53.0,61.0,103.0,37.2,Matches,3.0,sct SCO,FW,26.0,22.1,498.0,490.0,7.0,0.0,6.0,7.0,12.0,4.0,0.0,0.0,0.0,0.0,330.0,1.0,17.0,Matches,3.0,sct SCO,FW,26.0,22.1,330.0,498.0,66.3,4651.0,1042.0,205.0,278.0,73.7,78.0,118.0,66.1,26.0,37.0,70.3,3.0,2.8,2.2,0.2,24.0,21.0,11.0,2.0,34.0,Matches,4,sct SCO,FW,26,28,1992.0,71.0,58.2,22.1,23,82.0,13,5,22.0,1,0.71,18.0,41.0,-23.0,-1.04,-0.16,24.1,33.2,-9.2,-0.41,0.48,Matches,3.0,sct SCO,FW,26.0,22.1,717.0,29.0,66.0,286.0,377.0,103.0,717.0,34.0,17.0,50.0,13.0,38.2,406.0,1623.0,471.0,17.0,11.0,9.0,66.0,28.0,558.0,115.0,Matches,3.0,sct SCO,FW,26.0,22.1,5.0,47.0,14.0,29.8,2.12,0.63,0.11,0.36,13.8,0.0,0.0,0.0,6.6,6.6,0.14,-1.6,-1.6,Matches,3.0,sct SCO,FW,26.0,28.0,23.0,1992.0,22.1,5.0,3.0,8.0,5.0,0.0,0.0,1.0,0.0,6.6,6.6,2.8,9.4,17.0,34.0,115.0,0.23,0.14,0.36,0.23,0.36,0.3,0.13,0.42,0.3,0.42,Matches,Che Adams,S,26,140,145,"Scotland,England,Antigua and Barbuda",Southampton,6,10,14,15,13,6,11,13,4,7,15,9,8,14,11,13,13,14,10,15,12,14,11,4,13,9,14,14,15,14,13,11,16,15,14,16,13,5,7,5,12,4,1,2,2,3,3,3,2,1,2,1,10,11,12,14,13,15,15,12,1,1,1,1,1,1,1,10,1,10,14,14,14,20,175,70,11,20,40191136,7000,6750,5500,Mixed_Race,139,12,1996/7/13,19,5,57996.0,,90055302
241,Tyler Adams,Leeds United,1999,4.0,us USA,MF,23.0,24.0,89.0,46.0,44.0,35.0,10.0,50.0,77.0,64.9,27.0,48.0,8.0,40.0,35.0,124.0,29.0,0.0,Matches,4.0,us USA,MF,23.0,24.0,43.0,1.79,42.0,0.0,0.0,0.0,1.0,0.0,1.0,0.04,1.0,0.0,0.0,0.0,0.0,0.0,Matches,,,,,,,,,,,,,,,,,,,,,,,,,,,,,,,,,,,,,,,,,,,,,,,,,,,,,,,,4.0,us USA,MF,23.0,24.0,6.0,1.0,1.0,37.0,21.0,1.0,2.0,35.0,46.0,0.0,0.0,0.0,199.0,25.0,15.0,62.5,Matches,4.0,us USA,MF,23.0,24.0,1343.0,1271.0,72.0,58.0,1.0,2.0,2.0,14.0,0.0,0.0,0.0,0.0,1108.0,0.0,24.0,Matches,4.0,us USA,MF,23.0,24.0,1108.0,1343.0,82.5,16592.0,5061.0,607.0,686.0,88.5,390.0,460.0,84.8,63.0,107.0,58.9,0.0,1.4,1.0,-1.4,24.0,110.0,13.0,0.0,136.0,Matches,5,us USA,MF,23,24,2156.0,90.0,63.0,24.0,24,90.0,23,0,,0,0.96,28.0,36.0,-8.0,-0.33,1.23,30.2,33.1,-2.9,-0.12,1.08,Matches,4.0,us USA,MF,23.0,24.0,1628.0,44.0,376.0,1010.0,254.0,5.0,1628.0,22.0,7.0,31.8,12.0,54.5,818.0,3342.0,1555.0,19.0,21.0,0.0,28.0,18.0,919.0,20.0,Matches,4.0,us USA,MF,23.0,24.0,0.0,4.0,0.0,0.0,0.17,0.0,0.0,,27.5,0.0,0.0,0.0,0.1,0.1,0.03,-0.1,-0.1,Matches,4.0,us USA,MF,23.0,24.0,24.0,2156.0,24.0,0.0,0.0,0.0,0.0,0.0,0.0,6.0,1.0,0.1,0.1,1.4,1.5,19.0,136.0,20.0,0.0,0.0,0.0,0.0,0.0,0.0,0.06,0.06,0.0,0.06,Matches,Tyler Adams,DM/M RC,23,140,151,United States,Leeds United,6,10,12,6,13,6,8,8,11,13,14,6,14,12,16,14,15,12,13,13,12,15,9,13,12,14,15,17,14,14,13,10,17,14,16,13,13,12,15,7,16,2,2,3,1,4,1,3,3,2,4,2,15,16,4,11,13,15,16,12,1,12,1,15,12,15,18,1,20,10,1,1,10,1,175,72,12,20,34031975,7000,7000,6000,Mixed_Race,135,13,1999/2/14,30,1,69595.0,,72044918
242,Tosin Adarabioyo,Fulham,1997,5.0,eng ENG,DF,24.0,23.2,30.0,13.0,22.0,6.0,2.0,16.0,23.0,69.6,7.0,20.0,15.0,5.0,26.0,56.0,140.0,1.0,Matches,5.0,eng ENG,DF,24.0,23.2,18.0,0.78,15.0,0.0,0.0,3.0,0.0,0.0,0.0,0.0,0.0,0.0,0.0,0.0,0.0,0.0,Matches,,,,,,,,,,,,,,,,,,,,,,,,,,,,,,,,,,,,,,,,,,,,,,,,,,,,,,,,5.0,eng ENG,DF,24.0,23.2,4.0,0.0,0.0,17.0,5.0,3.0,2.0,26.0,13.0,0.0,0.0,0.0,110.0,59.0,26.0,69.4,Matches,5.0,eng ENG,DF,24.0,23.2,1300.0,1235.0,58.0,47.0,2.0,12.0,2.0,7.0,0.0,0.0,0.0,0.0,1066.0,7.0,10.0,Matches,5.0,eng ENG,DF,24.0,23.2,1066.0,1300.0,82.0,22623.0,8478.0,265.0,307.0,86.3,653.0,735.0,88.8,136.0,223.0,61.0,0.0,0.4,0.5,-0.4,6.0,96.0,7.0,0.0,95.0,Matches,6,eng ENG,DF,24,25,2085.0,83.0,61.0,23.2,23,90.0,23,2,8.0,13,1.44,36.0,39.0,-3.0,-0.13,-0.47,26.5,42.8,-16.3,-0.7,-0.63,Matches,5.0,eng ENG,DF,24.0,23.2,1545.0,231.0,776.0,735.0,47.0,19.0,1545.0,11.0,9.0,81.8,2.0,18.2,834.0,4470.0,2733.0,16.0,12.0,1.0,4.0,4.0,975.0,3.0,Matches,5.0,eng ENG,DF,24.0,23.2,1.0,16.0,4.0,25.0,0.69,0.17,0.06,0.25,21.2,1.0,0.0,0.0,0.7,0.7,0.04,0.3,0.3,Matches,5.0,eng ENG,DF,24.0,25.0,23.0,2085.0,23.2,1.0,0.0,1.0,1.0,0.0,0.0,4.0,0.0,0.7,0.7,0.4,1.1,16.0,95.0,3.0,0.04,0.0,0.04,0.04,0.04,0.03,0.02,0.05,0.03,0.05,Matches,Tosin Adarabioyo,D C,24,136,155,"England,Nigeria",Fulham,8,8,11,9,13,6,13,9,11,14,14,11,14,13,9,12,11,14,12,14,11,14,14,10,8,13,12,13,15,13,14,16,15,15,14,13,12,6,10,12,12,2,1,2,2,3,1,4,3,3,3,2,13,17,12,7,13,14,14,15,1,1,20,12,1,1,11,1,1,1,1,1,1,1,196,80,11,20,24463146,6800,6800,4750,African_Caribbean,135,16,1997/9/24,0,0,46397.0,,28100239
243,Nayef Aguerd,West Ham,1996,6.0,ma MAR,DF,26.0,17.7,27.0,18.0,18.0,8.0,1.0,13.0,20.0,65.0,7.0,26.0,24.0,2.0,18.0,45.0,79.0,2.0,Matches,6.0,ma MAR,DF,26.0,17.7,14.0,0.79,12.0,1.0,0.0,1.0,0.0,0.0,0.0,0.0,0.0,0.0,0.0,0.0,0.0,0.0,Matches,,,,,,,,,,,,,,,,,,,,,,,,,,,,,,,,,,,,,,,,,,,,,,,,,,,,,,,,6.0,ma MAR,DF,26.0,17.7,4.0,0.0,0.0,8.0,8.0,2.0,0.0,18.0,18.0,0.0,1.0,0.0,105.0,32.0,31.0,50.8,Matches,6.0,ma MAR,DF,26.0,17.7,763.0,723.0,36.0,29.0,0.0,21.0,0.0,0.0,0.0,0.0,0.0,0.0,599.0,4.0,5.0,Matches,6.0,ma MAR,DF,26.0,17.7,599.0,763.0,78.5,12203.0,5332.0,224.0,244.0,91.8,287.0,335.0,85.7,82.0,169.0,48.5,0.0,0.5,0.3,-0.5,6.0,37.0,4.0,0.0,25.0,Matches,10,ma MAR,DF,26,18,1595.0,89.0,46.6,17.7,17,89.0,16,1,76.0,3,1.06,23.0,28.0,-5.0,-0.28,0.11,24.2,28.6,-4.5,-0.25,-0.28,Matches,6.0,ma MAR,DF,26.0,17.7,949.0,161.0,563.0,358.0,35.0,23.0,949.0,6.0,4.0,66.7,0.0,0.0,523.0,2127.0,1137.0,2.0,1.0,0.0,8.0,7.0,564.0,4.0,Matches,6.0,ma MAR,DF,26.0,17.7,2.0,12.0,2.0,16.7,0.68,0.11,0.17,1.0,9.9,0.0,0.0,0.0,2.2,2.2,0.19,-0.2,-0.2,Matches,6.0,ma MAR,DF,26.0,18.0,17.0,1595.0,17.7,2.0,0.0,2.0,2.0,0.0,0.0,4.0,0.0,2.2,2.2,0.5,2.7,2.0,25.0,4.0,0.11,0.0,0.11,0.11,0.11,0.13,0.03,0.15,0.13,0.15,Matches,Nayef Aguerd,D C,26,128,133,Morocco,West Ham United,3,9,5,12,12,4,16,7,11,13,12,9,14,11,11,13,14,15,14,10,13,12,5,11,9,15,11,12,13,11,13,16,12,11,13,12,12,7,13,6,9,2,3,2,2,3,4,1,3,2,2,3,12,12,7,13,11,11,13,12,1,13,20,1,1,1,10,1,1,1,1,1,1,1,188,76,20,6,27629844,6400,6400,3800,North_African__Middle_Eastern,128,5,1996/3/30,25,1,75395.0,,13199286
244,Rayan Aït-Nouri,Wolves,2001,8.0,dz ALG,DF,21.0,12.0,33.0,20.0,25.0,7.0,1.0,9.0,16.0,56.3,7.0,3.0,0.0,3.0,9.0,42.0,28.0,0.0,Matches,8.0,dz ALG,DF,21.0,12.0,23.0,1.93,14.0,2.0,4.0,1.0,2.0,0.0,0.0,0.0,0.0,0.0,0.0,0.0,0.0,0.0,Matches,,,,,,,,,,,,,,,,,,,,,,,,,,,,,,,,,,,,,,,,,,,,,,,,,,,,,,,,8.0,dz ALG,DF,21.0,12.0,4.0,0.0,0.0,15.0,11.0,3.0,21.0,9.0,20.0,0.0,1.0,1.0,61.0,14.0,17.0,45.2,Matches,8.0,dz ALG,DF,21.0,12.0,578.0,487.0,89.0,5.0,0.0,2.0,21.0,81.0,3.0,1.0,2.0,0.0,470.0,2.0,18.0,Matches,8.0,dz ALG,DF,21.0,12.0,470.0,578.0,81.3,7079.0,2353.0,268.0,300.0,89.3,169.0,205.0,82.4,20.0,32.0,62.5,0.0,1.0,0.9,-1.0,7.0,29.0,14.0,5.0,43.0,Matches,12,dz ALG,DF,21,21,1076.0,51.0,31.5,12.0,9,81.0,4,12,29.0,7,1.0,8.0,18.0,-10.0,-0.84,-0.18,11.6,18.7,-7.1,-0.6,0.01,Matches,8.0,dz ALG,DF,21.0,12.0,740.0,40.0,240.0,279.0,233.0,28.0,740.0,50.0,28.0,56.0,18.0,36.0,395.0,2260.0,1244.0,30.0,13.0,10.0,28.0,12.0,454.0,76.0,Matches,8.0,dz ALG,DF,21.0,12.0,1.0,10.0,5.0,50.0,0.84,0.42,0.1,0.2,14.1,0.0,0.0,0.0,0.7,0.7,0.07,0.3,0.3,Matches,8.0,dz ALG,DF,21.0,21.0,9.0,1076.0,12.0,1.0,0.0,1.0,1.0,0.0,0.0,4.0,0.0,0.7,0.7,1.0,1.7,30.0,43.0,76.0,0.08,0.0,0.08,0.08,0.08,0.06,0.08,0.14,0.06,0.14,Matches,Rayan Aït-Nouri,D/WB L,21,132,-85,"France,Algeria",Wolverhampton Wanderers,11,14,15,9,14,7,11,9,8,12,13,8,14,15,11,13,13,12,12,13,12,15,15,7,14,14,12,13,14,13,12,10,12,14,13,11,14,8,11,10,10,3,3,2,1,3,3,4,2,2,3,3,11,15,8,14,12,15,13,11,1,20,1,1,20,1,1,1,1,1,10,1,1,1,180,70,20,10,69827025,6350,6250,4600,North_African__Middle_Eastern,128,7,2001/6/6,0,0,40597.0,,49047581
245,Manuel Akanji,Manchester City,1995,10.0,ch SUI,DF,27.0,25.4,36.0,25.0,15.0,18.0,3.0,23.0,36.0,63.9,13.0,27.0,9.0,18.0,16.0,52.0,33.0,1.0,Matches,10.0,ch SUI,DF,27.0,25.4,23.0,0.91,22.0,0.0,0.0,1.0,0.0,0.0,0.0,0.0,0.0,0.0,0.0,0.0,0.0,0.0,Matches,,,,,,,,,,,,,,,,,,,,,,,,,,,,,,,,,,,,,,,,,,,,,,,,,,,,,,,,10.0,ch SUI,DF,27.0,25.4,2.0,0.0,0.0,24.0,12.0,0.0,6.0,16.0,25.0,0.0,0.0,0.0,136.0,23.0,34.0,40.4,Matches,10.0,ch SUI,DF,27.0,25.4,2056.0,1999.0,55.0,28.0,0.0,8.0,6.0,27.0,0.0,0.0,0.0,0.0,1912.0,2.0,8.0,Matches,10.0,ch SUI,DF,27.0,25.4,1912.0,2056.0,93.0,32634.0,10258.0,867.0,902.0,96.1,903.0,945.0,95.6,117.0,166.0,70.5,1.0,0.4,1.0,0.6,7.0,140.0,3.0,1.0,116.0,Matches,14,ch SUI,DF,27,29,2287.0,79.0,66.9,25.4,24,88.0,22,5,36.0,1,2.52,63.0,23.0,40.0,1.57,-0.09,51.6,21.1,30.6,1.2,-0.06,Matches,10.0,ch SUI,DF,27.0,25.4,2231.0,121.0,815.0,1248.0,176.0,34.0,2231.0,12.0,6.0,50.0,3.0,25.0,1544.0,8443.0,5039.0,24.0,40.0,1.0,12.0,3.0,1734.0,17.0,Matches,10.0,ch SUI,DF,27.0,25.4,0.0,15.0,2.0,13.3,0.59,0.08,0.0,0.0,15.9,0.0,0.0,0.0,1.3,1.3,0.09,-1.3,-1.3,Matches,10.0,ch SUI,DF,27.0,29.0,24.0,2287.0,25.4,0.0,1.0,1.0,0.0,0.0,0.0,2.0,0.0,1.3,1.3,0.4,1.7,24.0,116.0,17.0,0.0,0.04,0.04,0.0,0.04,0.05,0.02,0.07,0.05,0.07,Matches,Manuel Akanji,D C,27,156,156,"Switzerland,Nigeria",Manchester City,4,8,11,6,13,9,13,11,12,15,13,8,16,12,13,15,16,16,16,13,13,14,9,10,9,13,14,13,14,13,13,15,13,16,14,17,11,8,14,12,7,1,3,1,3,2,1,3,3,2,3,3,12,16,6,11,13,17,14,12,1,1,20,12,1,8,1,1,1,1,1,1,1,1,187,91,15,20,48855719,7800,7500,6250,Mixed_Race,156,12,1995/7/19,41,0,104393.0,,98031331
246,Nathan Aké,Manchester City,1995,11.0,nl NED,DF,27.0,20.8,26.0,12.0,15.0,9.0,2.0,11.0,15.0,73.3,4.0,20.0,10.0,10.0,20.0,46.0,48.0,0.0,Matches,11.0,nl NED,DF,27.0,20.8,24.0,1.15,20.0,1.0,0.0,2.0,0.0,1.0,2.0,0.1,2.0,0.0,0.0,0.0,0.0,0.0,Matches,,,,,,,,,,,,,,,,,,,,,,,,,,,,,,,,,,,,,,,,,,,,,,,,,,,,,,,,11.0,nl NED,DF,27.0,20.8,2.0,0.0,0.0,12.0,14.0,1.0,15.0,20.0,12.0,0.0,0.0,0.0,96.0,36.0,23.0,61.0,Matches,11.0,nl NED,DF,27.0,20.8,1813.0,1685.0,126.0,35.0,1.0,6.0,15.0,91.0,0.0,0.0,0.0,0.0,1639.0,2.0,26.0,Matches,11.0,nl NED,DF,27.0,20.8,1639.0,1813.0,90.4,26199.0,8953.0,803.0,846.0,94.9,745.0,809.0,92.1,63.0,98.0,64.3,0.0,0.7,1.3,-0.7,9.0,165.0,9.0,1.0,140.0,Matches,15,nl NED,DF,27,26,1873.0,72.0,54.8,20.8,22,82.0,16,4,16.0,4,2.23,53.0,15.0,38.0,1.83,0.49,44.8,16.2,28.5,1.37,0.32,Matches,11.0,nl NED,DF,27.0,20.8,1959.0,86.0,615.0,1097.0,256.0,32.0,1959.0,5.0,3.0,60.0,1.0,20.0,1223.0,5455.0,3314.0,25.0,19.0,4.0,16.0,0.0,1492.0,30.0,Matches,11.0,nl NED,DF,27.0,20.8,1.0,9.0,2.0,22.2,0.43,0.1,0.11,0.5,10.5,0.0,0.0,0.0,1.6,1.6,0.17,-0.6,-0.6,Matches,11.0,nl NED,DF,27.0,26.0,22.0,1873.0,20.8,1.0,0.0,1.0,1.0,0.0,0.0,2.0,0.0,1.6,1.6,0.7,2.3,25.0,140.0,30.0,0.05,0.0,0.05,0.05,0.05,0.07,0.04,0.11,0.07,0.11,Matches,Nathan Aké,D/DM LC,27,153,164,"Holland,Ivory Coast",Manchester City,2,10,13,8,14,6,15,10,10,15,14,3,15,14,12,15,14,15,15,13,13,15,6,14,5,15,14,16,16,14,13,12,14,15,15,15,13,10,13,8,15,4,1,1,1,1,3,3,1,4,3,3,16,14,10,12,12,15,11,8,1,17,20,1,10,1,17,1,10,1,1,1,1,1,180,75,20,10,43218521,7650,6815,6526,African_Caribbean,153,13,1995/2/18,27,3,127591.0,,37025551
247,Carlos Alcaraz,Southampton,2002,14.0,ar ARG,MFFW,19.0,11.4,10.0,5.0,2.0,7.0,1.0,6.0,22.0,27.3,16.0,14.0,5.0,9.0,1.0,11.0,11.0,0.0,Matches,14.0,ar ARG,MFFW,19.0,11.4,22.0,1.92,14.0,0.0,2.0,3.0,2.0,1.0,4.0,0.35,3.0,0.0,0.0,1.0,0.0,0.0,Matches,,,,,,,,,,,,,,,,,,,,,,,,,,,,,,,,,,,,,,,,,,,,,,,,,,,,,,,,14.0,ar ARG,MFFW,19.0,11.4,3.0,0.0,0.0,16.0,17.0,2.0,4.0,1.0,5.0,0.0,0.0,0.0,53.0,7.0,27.0,20.6,Matches,14.0,ar ARG,MFFW,19.0,11.4,290.0,279.0,9.0,1.0,2.0,4.0,4.0,1.0,0.0,0.0,0.0,0.0,222.0,2.0,10.0,Matches,14.0,ar ARG,MFFW,19.0,11.4,222.0,290.0,76.6,3147.0,669.0,114.0,137.0,83.2,80.0,95.0,84.2,8.0,19.0,42.1,2.0,0.7,0.7,1.3,5.0,20.0,6.0,0.0,28.0,Matches,18,ar ARG,MFFW,19,18,1029.0,57.0,30.1,11.4,13,70.0,2,5,24.0,2,0.72,15.0,25.0,-10.0,-0.87,0.14,12.2,22.7,-10.5,-0.92,-0.44,Matches,14.0,ar ARG,MFFW,19.0,11.4,430.0,14.0,73.0,234.0,130.0,23.0,430.0,28.0,13.0,46.4,11.0,39.3,258.0,1292.0,675.0,20.0,17.0,2.0,30.0,24.0,296.0,32.0,Matches,14.0,ar ARG,MFFW,19.0,11.4,4.0,24.0,10.0,41.7,2.1,0.87,0.17,0.4,20.0,0.0,0.0,0.0,1.9,1.9,0.08,2.1,2.1,Matches,14.0,ar ARG,MFFW,19.0,18.0,13.0,1029.0,11.4,4.0,2.0,6.0,4.0,0.0,0.0,3.0,0.0,1.9,1.9,0.7,2.6,20.0,28.0,32.0,0.35,0.17,0.52,0.35,0.52,0.17,0.06,0.23,0.17,0.23,Matches,Carlos Alcaraz,M/AM C,19,120,-8,Argentina,Racing Club de Avellaneda,12,11,13,13,14,12,7,12,9,10,14,7,9,14,6,10,9,9,13,11,16,15,11,1,14,13,13,12,13,13,13,12,12,12,11,11,13,11,20,4,11,4,2,3,2,2,2,2,2,2,2,4,11,14,2,11,11,11,10,15,1,1,1,1,1,1,1,10,20,14,13,16,14,12,181,74,10,20,8316120,6000,6000,3269,Mediterranean_Hispanic,120,3,2002/11/30,0,0,1399.0,,14238164
248,Trent Alexander-Arnold,Liverpool,1998,15.0,eng ENG,DF,23.0,32.5,57.0,40.0,32.0,16.0,9.0,42.0,80.0,52.5,38.0,25.0,7.0,18.0,43.0,100.0,41.0,2.0,Matches,15.0,eng ENG,DF,23.0,32.5,124.0,3.82,81.0,34.0,3.0,5.0,1.0,0.0,17.0,0.52,14.0,2.0,1.0,0.0,0.0,0.0,Matches,,,,,,,,,,,,,,,,,,,,,,,,,,,,,,,,,,,,,,,,,,,,,,,,,,,,,,,,15.0,eng ENG,DF,23.0,32.5,5.0,0.0,0.0,22.0,6.0,5.0,252.0,43.0,40.0,0.0,0.0,0.0,239.0,20.0,13.0,60.6,Matches,15.0,eng ENG,DF,23.0,32.5,2912.0,2393.0,509.0,70.0,26.0,59.0,252.0,341.0,98.0,16.0,74.0,1.0,2188.0,10.0,37.0,Matches,15.0,eng ENG,DF,23.0,32.5,2188.0,2912.0,75.1,41590.0,16323.0,1000.0,1123.0,89.0,822.0,1045.0,78.7,331.0,642.0,51.6,9.0,11.5,9.1,-2.5,71.0,239.0,82.0,28.0,235.0,Matches,20,eng ENG,DF,23,37,2923.0,79.0,85.5,32.5,34,85.0,23,3,16.0,1,1.78,70.0,44.0,26.0,0.8,0.44,64.2,42.6,21.6,0.66,0.65,Matches,15.0,eng ENG,DF,23.0,32.5,3180.0,89.0,737.0,1631.0,837.0,44.0,3180.0,45.0,30.0,66.7,13.0,28.9,1778.0,6848.0,3312.0,43.0,39.0,8.0,35.0,21.0,2042.0,139.0,Matches,15.0,eng ENG,DF,23.0,32.5,2.0,40.0,8.0,20.0,1.23,0.25,0.05,0.25,23.8,5.0,0.0,0.0,2.4,2.4,0.06,-0.4,-0.4,Matches,15.0,eng ENG,DF,23.0,37.0,34.0,2923.0,32.5,2.0,9.0,11.0,2.0,0.0,0.0,5.0,0.0,2.4,2.4,11.5,13.8,43.0,235.0,139.0,0.06,0.28,0.34,0.06,0.34,0.07,0.35,0.43,0.07,0.43,Matches,Trent Alexander-Arnold,D/WB RC,23,160,174,England,Liverpool,15,18,12,10,17,14,11,12,14,11,16,12,13,17,12,13,11,15,12,16,15,15,14,12,15,11,16,14,14,14,14,11,15,14,14,13,13,10,14,7,14,2,2,3,1,1,1,2,1,3,2,2,15,16,7,19,14,17,12,14,1,10,1,19,12,20,13,1,15,14,1,1,1,1,180,70,12,20,210765335,8199,7749,6999,Northern_European,157,14,1998/10/7,17,1,185587.0,,28104124
249,Alisson,Liverpool,1992,16.0,br BRA,GK,29.0,37.0,0.0,0.0,0.0,0.0,0.0,0.0,3.0,0.0,3.0,3.0,0.0,3.0,0.0,0.0,20.0,0.0,Matches,16.0,br BRA,GK,29.0,37.0,3.0,0.08,3.0,0.0,0.0,0.0,0.0,0.0,2.0,0.05,2.0,0.0,0.0,0.0,0.0,0.0,Matches,1.0,br BRA,GK,29.0,37.0,43.0,2.0,0.0,0.0,2.0,51.1,0.33,10.1,0.27,116.0,283.0,41.0,1256.0,210.0,18.4,26.9,193.0,26.9,31.3,397.0,23.0,5.8,89.0,2.41,19.8,Matches,1.0,br BRA,GK,29.0,37.0,37.0,3330.0,37.0,43.0,1.16,147.0,105.0,72.1,19.0,9.0,9.0,14.0,37.8,4.0,2.0,1.0,1.0,33.3,Matches,16.0,br BRA,GK,29.0,37.0,1.0,0.0,0.0,1.0,5.0,0.0,0.0,0.0,0.0,0.0,0.0,0.0,71.0,11.0,1.0,91.7,Matches,16.0,br BRA,GK,29.0,37.0,1453.0,1199.0,250.0,57.0,0.0,2.0,0.0,0.0,0.0,0.0,0.0,0.0,1241.0,4.0,1.0,Matches,16.0,br BRA,GK,29.0,37.0,1241.0,1453.0,85.4,29043.0,18696.0,307.0,309.0,99.4,657.0,666.0,98.6,273.0,469.0,58.2,1.0,0.3,0.0,0.7,1.0,16.0,0.0,0.0,3.0,Matches,21,br BRA,GK,29,37,3330.0,90.0,97.4,37.0,37,90.0,37,0,,0,1.78,71.0,43.0,28.0,0.76,0.76,68.6,49.1,19.5,0.53,-1.64,Matches,16.0,br BRA,GK,29.0,37.0,1536.0,1124.0,1498.0,39.0,0.0,0.0,1536.0,2.0,2.0,100.0,0.0,0.0,985.0,4654.0,2962.0,0.0,0.0,0.0,1.0,0.0,901.0,0.0,Matches,16.0,br BRA,GK,29.0,37.0,0.0,0.0,0.0,,0.0,0.0,,,,0.0,0.0,0.0,0.0,0.0,,0.0,0.0,Matches,16.0,br BRA,GK,29.0,37.0,37.0,3330.0,37.0,0.0,1.0,1.0,0.0,0.0,0.0,1.0,0.0,0.0,0.0,0.3,0.3,0.0,3.0,0.0,0.0,0.03,0.03,0.0,0.03,0.0,0.01,0.01,0.0,0.01,Matches,Alisson,GK,29,177,180,Brazil,Liverpool,3,3,10,3,15,2,7,3,3,2,14,5,2,14,12,17,14,17,15,11,16,19,13,11,11,18,11,17,13,16,16,13,17,13,12,15,17,5,16,8,1,15,13,14,12,16,15,18,17,16,14,14,16,17,6,14,17,18,15,17,20,1,1,1,1,1,1,1,1,1,1,1,1,1,191,91,9,20,298419213,8850,8650,8250,Northern_European,176,3,1992/10/2,55,0,220384.0,,19058734
250,Miguel Almirón,Newcastle Utd,1994,18.0,py PAR,FW,28.0,27.7,46.0,30.0,16.0,19.0,11.0,18.0,42.0,42.9,24.0,25.0,2.0,23.0,10.0,56.0,17.0,0.0,Matches,18.0,py PAR,FW,28.0,27.7,87.0,3.14,63.0,2.0,10.0,9.0,3.0,0.0,13.0,0.47,5.0,1.0,5.0,2.0,0.0,0.0,Matches,,,,,,,,,,,,,,,,,,,,,,,,,,,,,,,,,,,,,,,,,,,,,,,,,,,,,,,,18.0,py PAR,FW,28.0,27.7,2.0,0.0,0.0,22.0,33.0,9.0,26.0,10.0,30.0,0.0,0.0,0.0,139.0,6.0,10.0,37.5,Matches,18.0,py PAR,FW,28.0,27.7,982.0,946.0,30.0,0.0,3.0,4.0,26.0,18.0,11.0,0.0,0.0,0.0,811.0,6.0,29.0,Matches,18.0,py PAR,FW,28.0,27.7,811.0,982.0,82.6,10752.0,2657.0,513.0,567.0,90.5,223.0,276.0,80.8,29.0,40.0,72.5,2.0,3.2,3.0,-1.2,26.0,45.0,36.0,4.0,124.0,Matches,24,py PAR,FW,28,34,2491.0,73.0,72.8,27.7,29,81.0,6,5,26.0,0,1.74,43.0,22.0,21.0,0.76,-0.6,45.7,27.6,18.2,0.66,-0.71,Matches,18.0,py PAR,FW,28.0,27.7,1300.0,25.0,147.0,417.0,760.0,138.0,1300.0,79.0,34.0,43.0,33.0,41.8,841.0,5389.0,2341.0,77.0,46.0,25.0,51.0,28.0,924.0,264.0,Matches,18.0,py PAR,FW,28.0,27.7,11.0,69.0,20.0,29.0,2.49,0.72,0.16,0.55,16.4,0.0,0.0,0.0,8.0,8.0,0.12,3.0,3.0,Matches,18.0,py PAR,FW,28.0,34.0,29.0,2491.0,27.7,11.0,2.0,13.0,11.0,0.0,0.0,2.0,0.0,8.0,8.0,3.2,11.1,77.0,124.0,264.0,0.4,0.07,0.47,0.4,0.47,0.29,0.11,0.4,0.29,0.4,Matches,Miguel Almirón,M/AM RLC,28,140,158,Paraguay,Newcastle United,10,11,13,11,12,10,6,9,4,8,12,11,10,12,7,12,11,9,12,13,11,12,13,6,15,11,15,19,16,15,12,6,10,17,15,10,13,9,11,11,14,2,1,3,2,2,2,1,1,1,2,2,14,10,8,12,8,14,13,12,1,1,1,1,1,1,1,17,12,16,17,19,20,13,174,70,20,6,48521667,6996,7246,5646,Mediterranean_Hispanic,131,8,1994/2/10,44,6,86994.0,,79024232
251,Julián Álvarez,Manchester City,2000,19.0,ar ARG,FWMF,22.0,16.3,26.0,16.0,3.0,13.0,10.0,9.0,30.0,30.0,21.0,13.0,0.0,13.0,2.0,28.0,6.0,0.0,Matches,19.0,ar ARG,FWMF,22.0,16.3,52.0,3.2,39.0,0.0,6.0,5.0,2.0,0.0,5.0,0.31,2.0,0.0,1.0,1.0,1.0,0.0,Matches,,,,,,,,,,,,,,,,,,,,,,,,,,,,,,,,,,,,,,,,,,,,,,,,,,,,,,,,19.0,ar ARG,FWMF,22.0,16.3,0.0,0.0,0.0,21.0,14.0,3.0,26.0,2.0,16.0,1.0,0.0,0.0,44.0,8.0,23.0,25.8,Matches,19.0,ar ARG,FWMF,22.0,16.3,503.0,478.0,21.0,2.0,7.0,3.0,26.0,4.0,4.0,3.0,0.0,0.0,395.0,4.0,17.0,Matches,19.0,ar ARG,FWMF,22.0,16.3,395.0,503.0,78.5,5472.0,885.0,232.0,270.0,85.9,103.0,135.0,76.3,28.0,43.0,65.1,0.0,1.8,1.6,-1.8,18.0,22.0,13.0,2.0,37.0,Matches,25,ar ARG,FWMF,22,31,1465.0,47.0,42.8,16.3,13,85.0,8,18,20.0,6,2.42,37.0,16.0,21.0,1.29,-0.55,32.3,17.3,15.0,0.92,-0.53,Matches,19.0,ar ARG,FWMF,22.0,16.3,654.0,8.0,46.0,255.0,360.0,89.0,653.0,38.0,21.0,55.3,14.0,36.8,406.0,2187.0,908.0,38.0,18.0,17.0,28.0,24.0,506.0,99.0,Matches,19.0,ar ARG,FWMF,22.0,16.3,9.0,46.0,20.0,43.5,2.83,1.23,0.17,0.4,16.0,0.0,1.0,1.0,7.0,6.2,0.13,2.0,1.8,Matches,19.0,ar ARG,FWMF,22.0,31.0,13.0,1465.0,16.3,9.0,0.0,9.0,8.0,1.0,1.0,0.0,0.0,7.0,6.2,1.8,8.0,38.0,37.0,99.0,0.55,0.0,0.55,0.49,0.49,0.43,0.11,0.54,0.38,0.49,Matches,Julián Álvarez,AM/S RLC,22,146,162,Argentina,Manchester City,14,11,13,14,16,13,10,15,6,5,13,13,8,15,11,13,8,14,12,12,14,14,17,7,15,8,14,14,15,14,12,7,15,13,15,11,13,8,14,6,13,2,3,1,3,4,3,1,1,1,2,1,14,14,5,12,14,14,17,8,1,1,1,1,1,1,1,1,1,1,15,16,17,20,170,70,13,20,41525041,7350,7350,4500,Mediterranean_Hispanic,138,7,2000/1/31,9,1,92793.0,,14183207
252,Daniel Amartey,Leicester City,1994,20.0,gh GHA,DF,27.0,17.9,19.0,8.0,13.0,5.0,1.0,12.0,14.0,85.7,2.0,24.0,17.0,7.0,8.0,27.0,71.0,0.0,Matches,20.0,gh GHA,DF,27.0,17.9,15.0,0.84,15.0,0.0,0.0,0.0,0.0,0.0,1.0,0.06,1.0,0.0,0.0,0.0,0.0,0.0,Matches,,,,,,,,,,,,,,,,,,,,,,,,,,,,,,,,,,,,,,,,,,,,,,,,,,,,,,,,20.0,gh GHA,DF,27.0,17.9,1.0,0.0,0.0,7.0,3.0,0.0,0.0,8.0,8.0,0.0,1.0,0.0,108.0,34.0,26.0,56.7,Matches,20.0,gh GHA,DF,27.0,17.9,1114.0,1092.0,20.0,15.0,2.0,2.0,0.0,5.0,0.0,0.0,0.0,0.0,1015.0,2.0,2.0,Matches,20.0,gh GHA,DF,27.0,17.9,1015.0,1114.0,91.1,17506.0,6591.0,442.0,473.0,93.4,498.0,526.0,94.7,62.0,91.0,68.1,0.0,0.5,0.4,-0.5,5.0,58.0,1.0,0.0,66.0,Matches,27,gh GHA,DF,27,20,1610.0,81.0,47.1,17.9,18,87.0,16,2,22.0,15,0.8,20.0,27.0,-7.0,-0.39,0.11,19.9,27.5,-7.6,-0.42,-0.17,Matches,20.0,gh GHA,DF,27.0,17.9,1279.0,185.0,658.0,578.0,46.0,9.0,1279.0,5.0,2.0,40.0,2.0,40.0,779.0,3720.0,2275.0,23.0,11.0,0.0,8.0,4.0,909.0,5.0,Matches,20.0,gh GHA,DF,27.0,17.9,0.0,6.0,2.0,33.3,0.34,0.11,0.0,0.0,17.4,0.0,0.0,0.0,1.1,1.1,0.18,-1.1,-1.1,Matches,20.0,gh GHA,DF,27.0,20.0,18.0,1610.0,17.9,0.0,0.0,0.0,0.0,0.0,0.0,1.0,0.0,1.1,1.1,0.5,1.6,23.0,66.0,5.0,0.0,0.0,0.0,0.0,0.0,0.06,0.03,0.09,0.06,0.09,Matches,Daniel Amartey,D/DM/M RC,27,138,145,Ghana,Leicester City,6,12,11,6,12,8,14,10,8,15,12,9,14,12,15,13,15,12,13,10,13,17,5,8,11,13,15,16,11,12,13,13,13,12,15,15,11,10,14,8,15,1,2,2,1,2,3,3,3,3,2,2,11,15,5,15,15,15,14,12,1,1,20,18,1,12,17,1,16,14,1,1,1,1,186,79,9,20,23399662,6899,6899,5499,African_Caribbean,132,18,1994/12/21,44,0,63795.0,,93034815
253,Joachim Andersen,Crystal Palace,1996,22.0,dk DEN,DF,26.0,30.9,42.0,22.0,30.0,12.0,0.0,16.0,32.0,50.0,16.0,28.0,13.0,15.0,24.0,66.0,188.0,1.0,Matches,22.0,dk DEN,DF,26.0,30.9,25.0,0.81,20.0,3.0,0.0,0.0,1.0,1.0,1.0,0.03,0.0,1.0,0.0,0.0,0.0,0.0,Matches,,,,,,,,,,,,,,,,,,,,,,,,,,,,,,,,,,,,,,,,,,,,,,,,,,,,,,,,22.0,dk DEN,DF,26.0,30.9,8.0,0.0,0.0,27.0,16.0,2.0,10.0,24.0,22.0,0.0,0.0,2.0,180.0,87.0,34.0,71.9,Matches,22.0,dk DEN,DF,26.0,30.9,1972.0,1840.0,123.0,107.0,4.0,44.0,10.0,13.0,1.0,0.0,0.0,0.0,1561.0,9.0,13.0,Matches,22.0,dk DEN,DF,26.0,30.9,1561.0,1972.0,79.2,36474.0,13911.0,346.0,391.0,88.5,927.0,1007.0,92.1,281.0,534.0,52.6,0.0,1.3,1.0,-1.3,12.0,153.0,8.0,1.0,105.0,Matches,31,dk DEN,DF,26,32,2782.0,87.0,81.3,30.9,32,87.0,30,0,,0,1.31,35.0,37.0,-2.0,-0.06,0.92,34.0,35.4,-1.3,-0.04,1.01,Matches,22.0,dk DEN,DF,26.0,30.9,2303.0,355.0,1232.0,996.0,89.0,39.0,2303.0,9.0,5.0,55.6,4.0,44.4,1318.0,6889.0,3787.0,16.0,8.0,2.0,8.0,3.0,1498.0,7.0,Matches,22.0,dk DEN,DF,26.0,30.9,1.0,22.0,9.0,40.9,0.71,0.29,0.05,0.11,13.9,1.0,0.0,0.0,1.8,1.8,0.08,-0.8,-0.8,Matches,22.0,dk DEN,DF,26.0,32.0,32.0,2782.0,30.9,1.0,0.0,1.0,1.0,0.0,0.0,8.0,0.0,1.8,1.8,1.3,3.1,16.0,105.0,7.0,0.03,0.0,0.03,0.03,0.03,0.06,0.04,0.1,0.06,0.1,Matches,Joachim Andersen,D C,26,142,151,Denmark,Crystal Palace,8,9,9,6,13,11,13,8,5,15,15,9,14,14,12,15,13,15,13,13,13,15,11,13,11,14,14,12,13,11,13,17,14,12,13,14,13,12,12,7,8,1,3,3,3,2,3,1,2,2,3,3,11,15,3,12,14,16,13,14,1,1,20,1,1,1,10,1,1,1,1,1,1,1,192,85,11,20,29396945,7100,7100,5900,Northern_European,141,2,1996/5/31,17,0,86994.0,,27069975
254,Jaidon Anthony,Bournemouth,1999,24.0,eng ENG,MFFW,22.0,14.0,30.0,17.0,15.0,9.0,6.0,8.0,24.0,33.3,16.0,30.0,3.0,27.0,10.0,40.0,19.0,0.0,Matches,24.0,eng ENG,MFFW,22.0,14.0,38.0,2.72,28.0,3.0,4.0,1.0,1.0,1.0,4.0,0.29,2.0,0.0,1.0,0.0,1.0,0.0,Matches,,,,,,,,,,,,,,,,,,,,,,,,,,,,,,,,,,,,,,,,,,,,,,,,,,,,,,,,24.0,eng ENG,MFFW,22.0,14.0,2.0,0.0,0.0,9.0,12.0,5.0,43.0,10.0,17.0,0.0,0.0,0.0,80.0,10.0,12.0,45.5,Matches,24.0,eng ENG,MFFW,22.0,14.0,526.0,480.0,45.0,9.0,2.0,5.0,43.0,21.0,14.0,9.0,1.0,1.0,387.0,1.0,18.0,Matches,24.0,eng ENG,MFFW,22.0,14.0,387.0,526.0,73.6,5818.0,1610.0,225.0,257.0,87.5,110.0,150.0,73.3,31.0,63.0,49.2,1.0,1.0,1.1,0.0,12.0,24.0,19.0,7.0,49.0,Matches,33,eng ENG,MFFW,22,30,1257.0,42.0,36.8,14.0,11,76.0,4,19,22.0,8,0.97,9.0,29.0,-20.0,-1.43,-0.85,13.6,26.0,-12.4,-0.89,-0.35,Matches,24.0,eng ENG,MFFW,22.0,14.0,717.0,23.0,150.0,271.0,304.0,33.0,717.0,47.0,15.0,31.9,30.0,63.8,423.0,2449.0,1032.0,31.0,25.0,13.0,25.0,27.0,464.0,72.0,Matches,24.0,eng ENG,MFFW,22.0,14.0,3.0,22.0,13.0,59.1,1.58,0.93,0.14,0.23,19.3,2.0,0.0,0.0,2.2,2.2,0.1,0.8,0.8,Matches,24.0,eng ENG,MFFW,22.0,30.0,11.0,1257.0,14.0,3.0,1.0,4.0,3.0,0.0,0.0,2.0,0.0,2.2,2.2,1.0,3.3,31.0,49.0,72.0,0.21,0.07,0.29,0.21,0.29,0.16,0.07,0.24,0.16,0.24,Matches,Jaidon Anthony,AM L,22,127,146,England,AFC Bournemouth,11,12,14,11,12,6,7,8,2,7,11,10,6,14,10,12,8,12,10,10,11,13,11,5,13,8,12,15,16,13,12,8,14,16,14,8,13,7,7,6,10,3,1,1,1,1,3,1,1,3,1,4,10,13,5,12,11,15,12,15,1,1,1,1,1,1,1,15,1,5,20,1,10,10,177,67,9,20,19182132,6350,6350,3260,African_Caribbean,122,15,1999/11/30,0,0,34798.0,,28112512
255,Michail Antonio,West Ham,1990,25.0,jm JAM,FW,32.0,20.3,14.0,7.0,1.0,8.0,5.0,3.0,12.0,25.0,9.0,13.0,5.0,8.0,5.0,19.0,9.0,0.0,Matches,25.0,jm JAM,FW,32.0,20.3,39.0,1.92,24.0,0.0,7.0,3.0,5.0,0.0,9.0,0.44,6.0,0.0,3.0,0.0,0.0,0.0,Matches,,,,,,,,,,,,,,,,,,,,,,,,,,,,,,,,,,,,,,,,,,,,,,,,,,,,,,,,25.0,jm JAM,FW,32.0,20.3,2.0,0.0,0.0,28.0,44.0,12.0,35.0,5.0,7.0,0.0,1.0,0.0,43.0,50.0,88.0,36.2,Matches,25.0,jm JAM,FW,32.0,20.3,348.0,335.0,12.0,1.0,1.0,1.0,35.0,8.0,0.0,0.0,0.0,0.0,186.0,1.0,18.0,Matches,25.0,jm JAM,FW,32.0,20.3,186.0,348.0,53.4,2663.0,501.0,114.0,168.0,67.9,55.0,108.0,50.9,12.0,31.0,38.7,3.0,1.3,0.8,1.7,15.0,12.0,8.0,2.0,27.0,Matches,34,jm JAM,FW,32,33,1829.0,55.0,53.5,20.3,21,75.0,2,12,22.0,1,1.09,23.0,29.0,-6.0,-0.3,0.1,25.9,29.3,-3.4,-0.17,-0.14,Matches,25.0,jm JAM,FW,32.0,20.3,596.0,15.0,39.0,262.0,308.0,80.0,596.0,66.0,27.0,40.9,29.0,43.9,375.0,2585.0,1237.0,49.0,26.0,18.0,76.0,45.0,476.0,120.0,Matches,25.0,jm JAM,FW,32.0,20.3,5.0,39.0,13.0,33.3,1.92,0.64,0.13,0.38,11.6,0.0,0.0,0.0,6.6,6.6,0.17,-1.6,-1.6,Matches,25.0,jm JAM,FW,32.0,33.0,21.0,1829.0,20.3,5.0,3.0,8.0,5.0,0.0,0.0,2.0,0.0,6.6,6.6,1.3,7.8,49.0,27.0,120.0,0.25,0.15,0.39,0.25,0.39,0.32,0.06,0.38,0.32,0.38,Matches,Michail Antonio,AM/S R,32,142,148,"Jamaica,England",West Ham United,8,11,14,12,13,6,15,9,15,9,11,10,8,13,13,15,13,13,11,11,12,14,14,9,14,9,15,14,15,14,15,12,13,15,13,16,14,5,13,11,14,3,2,2,3,3,1,4,1,2,2,3,14,14,6,12,13,15,16,16,1,1,1,9,1,14,1,11,1,15,13,1,17,20,180,82,10,20,26667291,7100,7100,5750,African_Caribbean,139,15,1990/3/28,6,3,81194.0,,28036815
256,Antony,Manchester Utd,2000,26.0,br BRA,FW,22.0,20.0,22.0,9.0,9.0,9.0,4.0,8.0,28.0,28.6,20.0,18.0,0.0,18.0,11.0,33.0,6.0,0.0,Matches,26.0,br BRA,FW,22.0,20.0,74.0,3.69,61.0,0.0,5.0,3.0,4.0,1.0,7.0,0.35,6.0,0.0,1.0,0.0,0.0,0.0,Matches,,,,,,,,,,,,,,,,,,,,,,,,,,,,,,,,,,,,,,,,,,,,,,,,,,,,,,,,26.0,br BRA,FW,22.0,20.0,5.0,0.0,0.0,15.0,25.0,2.0,32.0,11.0,9.0,0.0,0.0,0.0,99.0,5.0,19.0,20.8,Matches,26.0,br BRA,FW,22.0,20.0,819.0,804.0,15.0,1.0,3.0,2.0,32.0,13.0,1.0,0.0,0.0,0.0,651.0,0.0,29.0,Matches,26.0,br BRA,FW,22.0,20.0,651.0,819.0,79.5,8497.0,1915.0,439.0,495.0,88.7,146.0,197.0,74.1,31.0,51.0,60.8,2.0,2.9,2.4,-0.9,28.0,29.0,33.0,2.0,74.0,Matches,35,br BRA,FW,22,25,1802.0,72.0,52.7,20.0,23,76.0,6,2,30.0,0,1.88,29.0,21.0,8.0,0.4,0.01,32.5,25.2,7.3,0.36,-0.19,Matches,26.0,br BRA,FW,22.0,20.0,1066.0,12.0,134.0,348.0,609.0,85.0,1066.0,77.0,30.0,39.0,38.0,49.4,763.0,4783.0,2569.0,95.0,60.0,32.0,37.0,12.0,813.0,168.0,Matches,26.0,br BRA,FW,22.0,20.0,4.0,72.0,24.0,33.3,3.6,1.2,0.06,0.17,19.6,0.0,0.0,0.0,6.6,6.6,0.09,-2.6,-2.6,Matches,26.0,br BRA,FW,22.0,25.0,23.0,1802.0,20.0,4.0,2.0,6.0,4.0,0.0,0.0,5.0,0.0,6.6,6.6,2.9,9.4,95.0,74.0,168.0,0.2,0.1,0.3,0.2,0.3,0.33,0.14,0.47,0.33,0.47,Matches,Antony,M/AM RC,22,148,165,Brazil,Manchester UFC,11,14,16,12,16,12,12,13,10,6,14,11,5,16,12,13,15,14,12,13,12,14,16,9,14,6,12,12,15,16,13,7,15,14,13,11,11,15,10,7,11,3,3,1,1,3,2,1,1,1,1,3,15,15,8,12,13,12,5,9,1,1,1,1,1,1,1,10,10,18,14,15,20,15,173,63,20,10,132630741,7600,7250,5500,Mediterranean_Hispanic,143,9,2000/2/24,9,2,173988.0,,19338230
257,Joe Aribo,Southampton,1996,29.0,ng NGA,MFFW,26.0,13.6,31.0,20.0,15.0,12.0,4.0,11.0,20.0,55.0,9.0,14.0,1.0,13.0,10.0,41.0,11.0,0.0,Matches,29.0,ng NGA,MFFW,26.0,13.6,27.0,1.99,23.0,0.0,1.0,1.0,1.0,1.0,2.0,0.15,1.0,0.0,1.0,0.0,0.0,0.0,Matches,,,,,,,,,,,,,,,,,,,,,,,,,,,,,,,,,,,,,,,,,,,,,,,,,,,,,,,,29.0,ng NGA,MFFW,26.0,13.6,2.0,0.0,0.0,10.0,13.0,0.0,8.0,10.0,20.0,0.0,0.0,0.0,76.0,30.0,43.0,41.1,Matches,29.0,ng NGA,MFFW,26.0,13.6,385.0,376.0,9.0,0.0,0.0,0.0,8.0,2.0,0.0,0.0,0.0,0.0,280.0,0.0,16.0,Matches,29.0,ng NGA,MFFW,26.0,13.6,280.0,385.0,72.7,3591.0,907.0,187.0,240.0,77.9,66.0,87.0,75.9,9.0,12.0,75.0,0.0,0.8,0.5,-0.8,9.0,20.0,9.0,0.0,39.0,Matches,38,ng NGA,MFFW,26,21,1224.0,58.0,35.8,13.6,13,77.0,3,8,28.0,8,0.57,13.0,24.0,-11.0,-0.81,0.26,13.5,16.6,-3.1,-0.23,0.6,Matches,29.0,ng NGA,MFFW,26.0,13.6,566.0,14.0,87.0,269.0,222.0,46.0,566.0,39.0,17.0,43.6,21.0,53.8,294.0,1294.0,615.0,19.0,10.0,7.0,35.0,22.0,354.0,64.0,Matches,29.0,ng NGA,MFFW,26.0,13.6,2.0,14.0,8.0,57.1,1.03,0.59,0.14,0.25,10.9,0.0,0.0,0.0,1.5,1.5,0.11,0.5,0.5,Matches,29.0,ng NGA,MFFW,26.0,21.0,13.0,1224.0,13.6,2.0,0.0,2.0,2.0,0.0,0.0,2.0,0.0,1.5,1.5,0.8,2.3,19.0,39.0,64.0,0.15,0.0,0.15,0.15,0.15,0.11,0.06,0.17,0.11,0.17,Matches,Joe Aribo,AM RLC,26,133,144,"Nigeria,England",Southampton,10,11,16,14,19,8,8,12,6,6,13,9,10,16,7,16,6,15,10,14,12,11,15,5,14,9,11,15,11,14,15,13,14,13,14,15,8,4,10,4,12,1,1,1,3,1,2,2,3,1,3,1,14,11,3,8,8,13,10,10,1,1,1,1,1,1,14,1,15,1,17,20,19,1,188,74,20,7,29229866,6650,6750,5000,African_Caribbean,133,14,1996/7/21,20,2,69595.0,,89046527
258,Adam Armstrong,Southampton,1997,30.0,eng ENG,FWMF,25.0,14.8,14.0,9.0,6.0,5.0,3.0,3.0,10.0,30.0,7.0,15.0,3.0,12.0,5.0,19.0,6.0,0.0,Matches,30.0,eng ENG,FWMF,25.0,14.8,24.0,1.62,19.0,0.0,2.0,1.0,1.0,1.0,2.0,0.13,1.0,0.0,0.0,0.0,0.0,1.0,Matches,,,,,,,,,,,,,,,,,,,,,,,,,,,,,,,,,,,,,,,,,,,,,,,,,,,,,,,,30.0,eng ENG,FWMF,25.0,14.8,2.0,0.0,0.0,17.0,9.0,2.0,14.0,5.0,9.0,0.0,0.0,0.0,54.0,5.0,21.0,19.2,Matches,30.0,eng ENG,FWMF,25.0,14.8,302.0,267.0,35.0,0.0,0.0,4.0,14.0,3.0,0.0,0.0,0.0,0.0,220.0,0.0,21.0,Matches,30.0,eng ENG,FWMF,25.0,14.8,220.0,302.0,72.8,3235.0,585.0,120.0,146.0,82.2,71.0,89.0,79.8,13.0,23.0,56.5,1.0,1.3,0.8,-0.3,11.0,13.0,10.0,2.0,16.0,Matches,39,eng ENG,FWMF,25,30,1335.0,45.0,39.0,14.8,14,73.0,0,16,20.0,4,0.8,17.0,24.0,-7.0,-0.47,0.82,13.8,24.0,-10.2,-0.69,-0.13,Matches,30.0,eng ENG,FWMF,25.0,14.8,458.0,11.0,71.0,176.0,222.0,46.0,458.0,43.0,13.0,30.2,25.0,58.1,255.0,2338.0,996.0,39.0,29.0,11.0,24.0,22.0,273.0,70.0,Matches,30.0,eng ENG,FWMF,25.0,14.8,2.0,25.0,12.0,48.0,1.69,0.81,0.08,0.17,15.9,0.0,0.0,0.0,2.1,2.1,0.08,-0.1,-0.1,Matches,30.0,eng ENG,FWMF,25.0,30.0,14.0,1335.0,14.8,2.0,1.0,3.0,2.0,0.0,0.0,2.0,0.0,2.1,2.1,1.3,3.3,39.0,16.0,70.0,0.13,0.07,0.2,0.13,0.2,0.14,0.09,0.23,0.14,0.23,Matches,Adam Armstrong,AM/S L,25,133,138,England,Southampton,7,8,13,13,13,12,8,14,4,5,10,13,5,11,7,13,11,10,11,10,10,13,11,6,11,6,13,12,17,14,10,8,14,17,15,9,12,6,12,2,12,4,2,1,3,1,1,2,2,2,2,1,15,15,4,13,13,15,13,15,1,1,1,1,1,1,1,1,1,1,20,14,11,18,172,69,13,20,18221214,6650,6650,4750,Northern_European,127,1,1997/2/10,0,0,57996.0,,28091349
259,Stuart Armstrong,Southampton,1992,31.0,sct SCO,MFFW,30.0,15.6,32.0,21.0,15.0,13.0,4.0,14.0,39.0,35.9,25.0,18.0,0.0,18.0,10.0,42.0,9.0,2.0,Matches,31.0,sct SCO,MFFW,30.0,15.6,50.0,3.2,39.0,1.0,0.0,6.0,4.0,0.0,2.0,0.13,1.0,0.0,0.0,0.0,1.0,0.0,Matches,,,,,,,,,,,,,,,,,,,,,,,,,,,,,,,,,,,,,,,,,,,,,,,,,,,,,,,,31.0,sct SCO,MFFW,30.0,15.6,6.0,0.0,0.0,17.0,20.0,1.0,37.0,10.0,21.0,0.0,0.0,0.0,83.0,6.0,8.0,42.9,Matches,31.0,sct SCO,MFFW,30.0,15.6,676.0,634.0,40.0,4.0,3.0,3.0,37.0,14.0,2.0,0.0,2.0,0.0,531.0,2.0,24.0,Matches,31.0,sct SCO,MFFW,30.0,15.6,531.0,676.0,78.6,8041.0,2224.0,296.0,341.0,86.8,189.0,226.0,83.6,29.0,55.0,52.7,1.0,2.2,2.8,-1.2,18.0,47.0,32.0,7.0,75.0,Matches,40,sct SCO,MFFW,30,32,1408.0,44.0,41.2,15.6,14,70.0,0,18,24.0,3,0.56,12.0,34.0,-22.0,-1.41,-0.74,16.3,28.9,-12.6,-0.81,-0.33,Matches,31.0,sct SCO,MFFW,30.0,15.6,864.0,21.0,133.0,403.0,341.0,37.0,864.0,52.0,22.0,42.3,21.0,40.4,539.0,3859.0,1910.0,61.0,45.0,10.0,28.0,28.0,596.0,88.0,Matches,31.0,sct SCO,MFFW,30.0,15.6,2.0,23.0,6.0,26.1,1.47,0.38,0.09,0.33,17.9,0.0,0.0,0.0,2.4,2.4,0.1,-0.4,-0.4,Matches,31.0,sct SCO,MFFW,30.0,32.0,14.0,1408.0,15.6,2.0,1.0,3.0,2.0,0.0,0.0,6.0,0.0,2.4,2.4,2.2,4.7,61.0,75.0,88.0,0.13,0.06,0.19,0.13,0.19,0.15,0.14,0.3,0.15,0.3,Matches,Stuart Armstrong,M/AM RC,30,138,150,Scotland,Southampton,13,12,15,14,14,12,10,15,5,6,15,12,11,14,11,14,12,12,10,14,14,14,12,14,14,10,16,14,12,12,9,10,16,12,14,12,15,9,10,9,14,3,1,2,1,3,2,3,1,2,3,2,20,15,4,5,9,15,8,7,1,1,1,1,1,1,1,10,14,18,13,17,20,1,183,68,14,20,32446303,6897,6897,5497,Mediterranean_Hispanic,136,0,1992/3/30,36,4,69595.0,,61028448
260,Kepa Arrizabalaga,Chelsea,1994,32.0,es ESP,GK,27.0,28.5,2.0,2.0,2.0,0.0,0.0,2.0,3.0,66.7,1.0,0.0,0.0,0.0,1.0,3.0,16.0,2.0,Matches,32.0,es ESP,GK,27.0,28.5,1.0,0.04,1.0,0.0,0.0,0.0,0.0,0.0,0.0,0.0,0.0,0.0,0.0,0.0,0.0,0.0,Matches,3.0,es ESP,GK,27.0,28.5,33.0,1.0,1.0,4.0,3.0,35.0,0.29,5.0,0.18,68.0,213.0,31.9,864.0,151.0,17.1,26.3,182.0,35.7,31.5,332.0,15.0,4.5,52.0,1.82,16.9,Matches,3.0,es ESP,GK,27.0,29.0,29.0,2565.0,28.5,33.0,1.16,120.0,90.0,73.3,8.0,9.0,12.0,9.0,31.0,1.0,1.0,0.0,0.0,0.0,Matches,32.0,es ESP,GK,27.0,28.5,1.0,0.0,0.0,0.0,8.0,0.0,0.0,1.0,2.0,0.0,0.0,0.0,42.0,11.0,1.0,91.7,Matches,32.0,es ESP,GK,27.0,28.5,1046.0,805.0,241.0,59.0,0.0,3.0,0.0,0.0,0.0,0.0,0.0,0.0,871.0,0.0,1.0,Matches,32.0,es ESP,GK,27.0,28.5,871.0,1046.0,83.3,19299.0,11448.0,287.0,289.0,99.3,390.0,395.0,98.7,190.0,357.0,53.2,0.0,0.0,0.0,0.0,0.0,6.0,0.0,0.0,0.0,Matches,41,es ESP,GK,27,29,2565.0,88.0,75.0,28.5,29,88.0,28,0,,7,1.14,27.0,33.0,-6.0,-0.21,0.11,39.2,39.0,0.2,0.01,0.34,Matches,32.0,es ESP,GK,27.0,28.5,1119.0,892.0,1103.0,16.0,0.0,0.0,1119.0,1.0,1.0,100.0,0.0,0.0,654.0,2894.0,1683.0,0.0,0.0,0.0,1.0,0.0,604.0,0.0,Matches,32.0,es ESP,GK,27.0,28.5,0.0,0.0,0.0,,0.0,0.0,,,,0.0,0.0,0.0,0.0,0.0,,0.0,0.0,Matches,32.0,es ESP,GK,27.0,29.0,29.0,2565.0,28.5,0.0,0.0,0.0,0.0,0.0,0.0,1.0,0.0,0.0,0.0,0.0,0.0,0.0,0.0,0.0,0.0,0.0,0.0,0.0,0.0,0.0,0.0,0.0,0.0,0.0,Matches,Kepa Arrizabalaga,GK,27,144,160,"Spain,Pays Basque",Chelsea,4,1,2,3,11,7,1,3,3,3,11,6,1,11,8,14,12,14,15,11,12,13,2,10,5,12,13,12,9,15,12,14,12,12,12,11,13,8,12,8,15,14,13,14,5,16,15,15,16,15,13,13,13,15,7,17,13,15,14,16,20,1,1,1,1,1,1,1,1,1,1,1,1,1,186,90,10,20,14353977,7000,7250,6500,Mediterranean_Hispanic,141,6,1994/10/3,11,0,170000.0,,67157624
261,Serge Aurier,Nott'ham Forest,1992,35.0,ci CIV,DF,29.0,21.6,64.0,41.0,41.0,18.0,5.0,23.0,33.0,69.7,10.0,34.0,11.0,23.0,29.0,93.0,75.0,0.0,Matches,35.0,ci CIV,DF,29.0,21.6,26.0,1.2,21.0,2.0,0.0,0.0,2.0,1.0,1.0,0.05,0.0,1.0,0.0,0.0,0.0,0.0,Matches,,,,,,,,,,,,,,,,,,,,,,,,,,,,,,,,,,,,,,,,,,,,,,,,,,,,,,,,35.0,ci CIV,DF,29.0,21.6,2.0,0.0,0.0,18.0,19.0,0.0,40.0,29.0,41.0,0.0,0.0,0.0,126.0,46.0,32.0,59.0,Matches,35.0,ci CIV,DF,29.0,21.6,943.0,758.0,183.0,16.0,1.0,0.0,40.0,167.0,0.0,0.0,0.0,0.0,667.0,2.0,28.0,Matches,35.0,ci CIV,DF,29.0,21.6,667.0,943.0,70.7,10182.0,4393.0,373.0,454.0,82.2,236.0,333.0,70.9,41.0,94.0,43.6,0.0,1.0,0.9,-1.0,10.0,44.0,13.0,6.0,71.0,Matches,46,ci CIV,DF,29,24,1943.0,81.0,56.8,21.6,22,84.0,16,2,45.0,0,1.38,24.0,31.0,-7.0,-0.32,1.08,22.7,32.7,-10.0,-0.46,0.45,Matches,35.0,ci CIV,DF,29.0,21.6,1238.0,107.0,484.0,505.0,263.0,13.0,1238.0,32.0,16.0,50.0,11.0,34.4,520.0,2394.0,1398.0,37.0,26.0,2.0,31.0,18.0,574.0,50.0,Matches,35.0,ci CIV,DF,29.0,21.6,1.0,9.0,3.0,33.3,0.42,0.14,0.11,0.33,16.2,0.0,0.0,0.0,0.8,0.8,0.09,0.2,0.2,Matches,35.0,ci CIV,DF,29.0,24.0,22.0,1943.0,21.6,1.0,0.0,1.0,1.0,0.0,0.0,2.0,0.0,0.8,0.8,1.0,1.8,37.0,71.0,50.0,0.05,0.0,0.05,0.05,0.05,0.04,0.05,0.08,0.04,0.08,Matches,Serge Aurier,D/WB R,29,136,144,Ivory Coast,Nottingham Forest,7,12,13,10,15,7,14,9,9,13,13,6,15,12,15,13,15,14,12,10,12,15,11,10,16,13,15,16,14,13,14,9,15,13,16,14,12,13,14,7,12,3,3,3,1,1,1,3,3,2,1,3,14,15,14,12,11,13,11,12,1,14,12,20,8,17,7,1,1,10,1,1,1,1,174,74,8,20,14082490,6800,7000,6000,African_Caribbean,136,17,1992/12/24,79,4,66471.0,,85057643
262,Taiwo Awoniyi,Nott'ham Forest,1997,36.0,ng NGA,FW,24.0,15.6,17.0,10.0,2.0,10.0,5.0,6.0,12.0,50.0,6.0,18.0,4.0,14.0,4.0,21.0,20.0,0.0,Matches,36.0,ng NGA,FW,24.0,15.6,25.0,1.6,18.0,0.0,2.0,2.0,2.0,1.0,4.0,0.26,2.0,0.0,1.0,1.0,0.0,0.0,Matches,,,,,,,,,,,,,,,,,,,,,,,,,,,,,,,,,,,,,,,,,,,,,,,,,,,,,,,,36.0,ng NGA,FW,24.0,15.6,2.0,0.0,0.0,24.0,19.0,15.0,3.0,4.0,10.0,0.0,0.0,0.0,56.0,20.0,61.0,24.7,Matches,36.0,ng NGA,FW,24.0,15.6,223.0,220.0,3.0,0.0,2.0,1.0,3.0,1.0,0.0,0.0,0.0,0.0,143.0,0.0,9.0,Matches,36.0,ng NGA,FW,24.0,15.6,143.0,223.0,64.1,1675.0,300.0,96.0,133.0,72.2,34.0,52.0,65.4,2.0,8.0,25.0,1.0,1.1,0.3,-0.1,10.0,6.0,2.0,0.0,12.0,Matches,48,ng NGA,FW,24,27,1404.0,52.0,41.1,15.6,17,71.0,0,10,19.0,2,0.93,19.0,29.0,-10.0,-0.64,0.25,17.9,25.9,-8.1,-0.52,0.24,Matches,36.0,ng NGA,FW,24.0,15.6,434.0,22.0,62.0,177.0,203.0,55.0,434.0,23.0,9.0,39.1,11.0,47.8,246.0,1269.0,530.0,18.0,13.0,9.0,68.0,29.0,284.0,55.0,Matches,36.0,ng NGA,FW,24.0,15.6,10.0,35.0,15.0,42.9,2.24,0.96,0.29,0.67,11.8,0.0,0.0,0.0,6.6,6.6,0.19,3.4,3.4,Matches,36.0,ng NGA,FW,24.0,27.0,17.0,1404.0,15.6,10.0,1.0,11.0,10.0,0.0,0.0,2.0,0.0,6.6,6.6,1.1,7.7,18.0,12.0,55.0,0.64,0.06,0.71,0.64,0.71,0.42,0.07,0.49,0.42,0.49,Matches,Taiwo Awoniyi,S,24,138,145,Nigeria,Nottingham Forest,7,9,15,16,14,8,14,11,5,4,11,12,4,14,14,14,13,9,11,11,10,13,13,5,15,5,11,13,16,15,16,11,13,16,13,16,11,5,13,5,5,1,2,2,1,2,2,3,1,2,2,2,12,14,10,9,10,11,10,12,1,1,1,1,1,1,1,1,1,1,13,1,13,20,183,74,9,20,39929041,6750,6600,5250,African_Caribbean,137,15,1997/8/12,4,1,52196.0,,13136629
263,Jordan Ayew,Crystal Palace,1991,39.0,gh GHA,FWMF,30.0,30.2,66.0,41.0,23.0,20.0,23.0,21.0,53.0,39.6,32.0,35.0,4.0,31.0,15.0,81.0,31.0,0.0,Matches,39.0,gh GHA,FWMF,30.0,30.2,78.0,2.59,53.0,0.0,9.0,6.0,7.0,3.0,8.0,0.27,5.0,0.0,1.0,1.0,1.0,0.0,Matches,,,,,,,,,,,,,,,,,,,,,,,,,,,,,,,,,,,,,,,,,,,,,,,,,,,,,,,,39.0,gh GHA,FWMF,30.0,30.2,5.0,0.0,0.0,48.0,90.0,4.0,43.0,15.0,41.0,0.0,0.0,0.0,166.0,50.0,92.0,35.2,Matches,39.0,gh GHA,FWMF,30.0,30.2,875.0,860.0,13.0,3.0,5.0,1.0,43.0,9.0,0.0,0.0,0.0,0.0,676.0,2.0,34.0,Matches,39.0,gh GHA,FWMF,30.0,30.2,676.0,875.0,77.3,8710.0,1706.0,434.0,495.0,87.7,192.0,246.0,78.0,15.0,40.0,37.5,3.0,3.2,2.6,-0.2,31.0,34.0,19.0,6.0,63.0,Matches,51,gh GHA,FWMF,30,38,2714.0,71.0,79.4,30.2,31,82.0,17,7,24.0,0,1.18,32.0,41.0,-9.0,-0.3,-0.3,29.7,40.2,-10.5,-0.35,-0.57,Matches,39.0,gh GHA,FWMF,30.0,30.2,1327.0,46.0,192.0,611.0,560.0,98.0,1327.0,149.0,65.0,43.6,59.0,39.6,801.0,5195.0,2372.0,83.0,50.0,31.0,107.0,83.0,932.0,174.0,Matches,39.0,gh GHA,FWMF,30.0,30.2,4.0,32.0,10.0,31.3,1.06,0.33,0.13,0.4,16.1,0.0,0.0,0.0,3.2,3.2,0.1,0.8,0.8,Matches,39.0,gh GHA,FWMF,30.0,38.0,31.0,2714.0,30.2,4.0,3.0,7.0,4.0,0.0,0.0,5.0,0.0,3.2,3.2,3.2,6.4,83.0,63.0,174.0,0.13,0.1,0.23,0.13,0.23,0.1,0.11,0.21,0.1,0.21,Matches,Jordan Ayew,AM RL,30,130,140,"Ghana,France",Crystal Palace,5,10,14,10,14,9,11,10,5,11,11,12,14,12,14,13,14,10,12,11,11,17,11,6,14,11,14,18,14,13,13,11,15,13,17,13,12,8,13,7,14,2,3,1,1,1,2,2,3,3,3,1,15,14,8,10,11,14,7,14,1,1,1,1,1,1,1,8,1,15,16,12,20,13,182,78,8,20,6658690,6500,6500,5750,African_Caribbean,129,14,1991/9/11,81,19,46397.0,,34010721
264,Luke Ayling,Leeds United,1991,40.0,eng ENG,DF,30.0,22.8,66.0,37.0,42.0,15.0,9.0,42.0,85.0,49.4,43.0,34.0,11.0,23.0,26.0,92.0,52.0,2.0,Matches,40.0,eng ENG,DF,30.0,22.8,40.0,1.75,33.0,0.0,0.0,3.0,2.0,2.0,1.0,0.04,1.0,0.0,0.0,0.0,0.0,0.0,Matches,,,,,,,,,,,,,,,,,,,,,,,,,,,,,,,,,,,,,,,,,,,,,,,,,,,,,,,,40.0,eng ENG,DF,30.0,22.8,3.0,0.0,0.0,15.0,35.0,1.0,62.0,26.0,37.0,0.0,1.0,0.0,152.0,47.0,57.0,45.2,Matches,40.0,eng ENG,DF,30.0,22.8,1132.0,912.0,212.0,22.0,0.0,11.0,62.0,190.0,0.0,0.0,0.0,0.0,786.0,8.0,46.0,Matches,40.0,eng ENG,DF,30.0,22.8,786.0,1132.0,69.4,12523.0,6236.0,439.0,508.0,86.4,267.0,374.0,71.4,62.0,155.0,40.0,1.0,2.0,2.2,-1.0,12.0,61.0,18.0,10.0,77.0,Matches,52,eng ENG,DF,30,29,2054.0,71.0,60.1,22.8,22,89.0,21,7,14.0,4,0.79,27.0,48.0,-21.0,-0.92,-0.33,27.6,43.3,-15.7,-0.69,-0.42,Matches,40.0,eng ENG,DF,30.0,22.8,1413.0,79.0,466.0,578.0,390.0,56.0,1413.0,33.0,13.0,39.4,17.0,51.5,648.0,2963.0,1480.0,28.0,20.0,4.0,23.0,12.0,700.0,100.0,Matches,40.0,eng ENG,DF,30.0,22.8,2.0,24.0,5.0,20.8,1.05,0.22,0.08,0.4,15.1,0.0,0.0,0.0,3.2,3.2,0.13,-1.2,-1.2,Matches,40.0,eng ENG,DF,30.0,29.0,22.0,2054.0,22.8,2.0,1.0,3.0,2.0,0.0,0.0,3.0,0.0,3.2,3.2,2.0,5.2,28.0,77.0,100.0,0.09,0.04,0.13,0.09,0.13,0.14,0.09,0.23,0.14,0.23,Matches,Luke Ayling,D RC,30,133,139,England,Leeds United,6,12,10,8,11,5,13,10,9,13,11,2,14,11,14,12,16,12,13,11,12,15,7,15,13,13,15,18,12,11,13,12,13,13,19,13,14,13,13,11,12,2,3,2,2,2,1,3,1,1,3,2,6,13,6,13,14,15,12,9,1,1,15,20,1,15,8,1,4,1,1,1,1,1,185,68,10,20,11857384,6650,6650,5600,Northern_European,130,6,1991/8/25,0,0,40597.0,,28011526
265,César Azpilicueta,Chelsea,1989,41.0,es ESP,DF,32.0,17.0,43.0,25.0,23.0,15.0,5.0,22.0,37.0,59.5,15.0,26.0,5.0,21.0,19.0,62.0,54.0,1.0,Matches,41.0,es ESP,DF,32.0,17.0,25.0,1.47,25.0,0.0,0.0,0.0,0.0,0.0,1.0,0.06,1.0,0.0,0.0,0.0,0.0,0.0,Matches,,,,,,,,,,,,,,,,,,,,,,,,,,,,,,,,,,,,,,,,,,,,,,,,,,,,,,,,41.0,es ESP,DF,32.0,17.0,3.0,0.0,0.0,27.0,7.0,2.0,26.0,19.0,25.0,0.0,0.0,1.0,59.0,29.0,19.0,60.4,Matches,41.0,es ESP,DF,32.0,17.0,1065.0,893.0,169.0,30.0,0.0,0.0,26.0,139.0,0.0,0.0,0.0,0.0,872.0,3.0,14.0,Matches,41.0,es ESP,DF,32.0,17.0,872.0,1065.0,81.9,12891.0,4354.0,501.0,538.0,93.1,337.0,414.0,81.4,21.0,74.0,28.4,0.0,1.1,1.3,-1.1,12.0,40.0,19.0,5.0,71.0,Matches,53,es ESP,DF,32,25,1527.0,61.0,44.6,17.0,16,82.0,12,9,23.0,6,1.12,17.0,21.0,-4.0,-0.24,0.0,22.5,27.0,-4.5,-0.27,-0.34,Matches,41.0,es ESP,DF,32.0,17.0,1245.0,84.0,424.0,510.0,319.0,25.0,1245.0,13.0,7.0,53.8,5.0,38.5,612.0,2691.0,1573.0,23.0,19.0,0.0,12.0,5.0,753.0,81.0,Matches,41.0,es ESP,DF,32.0,17.0,0.0,9.0,1.0,11.1,0.53,0.06,0.0,0.0,18.2,0.0,0.0,0.0,0.4,0.4,0.05,-0.4,-0.4,Matches,41.0,es ESP,DF,32.0,25.0,16.0,1527.0,17.0,0.0,0.0,0.0,0.0,0.0,0.0,3.0,0.0,0.4,0.4,1.1,1.5,23.0,71.0,81.0,0.0,0.0,0.0,0.0,0.0,0.02,0.07,0.09,0.02,0.09,Matches,César Azpilicueta,D/WB RLC,32,148,165,"Spain,Pays Basque",Chelsea,8,15,12,6,11,7,10,9,11,14,13,8,16,15,15,15,16,14,16,10,15,18,8,18,12,15,18,18,10,12,12,10,17,11,14,12,18,12,15,5,16,3,3,3,3,2,4,3,1,2,2,1,12,14,6,18,16,20,15,12,1,19,18,20,16,15,1,1,1,1,1,1,1,1,178,76,15,20,21003166,7400,7750,6500,Mediterranean_Hispanic,142,2,1989/8/28,40,1,173988.0,,67033300
266,Benoît Badiashile,Chelsea,2001,42.0,fr FRA,DF,21.0,10.1,14.0,8.0,10.0,4.0,0.0,9.0,14.0,64.3,5.0,5.0,2.0,3.0,16.0,30.0,34.0,1.0,Matches,42.0,fr FRA,DF,21.0,10.1,12.0,1.19,11.0,0.0,0.0,0.0,0.0,1.0,0.0,0.0,0.0,0.0,0.0,0.0,0.0,0.0,Matches,,,,,,,,,,,,,,,,,,,,,,,,,,,,,,,,,,,,,,,,,,,,,,,,,,,,,,,,42.0,fr FRA,DF,21.0,10.1,2.0,0.0,0.0,9.0,6.0,0.0,2.0,16.0,8.0,0.0,0.0,0.0,76.0,35.0,14.0,71.4,Matches,42.0,fr FRA,DF,21.0,10.1,860.0,840.0,19.0,17.0,1.0,6.0,2.0,2.0,0.0,0.0,0.0,0.0,769.0,1.0,4.0,Matches,42.0,fr FRA,DF,21.0,10.1,769.0,860.0,89.4,14061.0,5150.0,284.0,315.0,90.2,419.0,448.0,93.5,58.0,83.0,69.9,0.0,0.5,0.2,-0.5,3.0,47.0,5.0,0.0,56.0,Matches,55,fr FRA,DF,21,11,905.0,82.0,26.5,10.1,10,90.0,10,1,5.0,7,1.55,11.0,9.0,2.0,0.2,0.59,14.0,12.3,1.7,0.17,0.34,Matches,42.0,fr FRA,DF,21.0,10.1,945.0,95.0,469.0,458.0,25.0,11.0,945.0,3.0,1.0,33.3,2.0,66.7,630.0,3020.0,1774.0,11.0,2.0,0.0,2.0,3.0,689.0,2.0,Matches,42.0,fr FRA,DF,21.0,10.1,1.0,6.0,2.0,33.3,0.6,0.2,0.17,0.5,7.2,0.0,0.0,0.0,1.2,1.2,0.2,-0.2,-0.2,Matches,42.0,fr FRA,DF,21.0,11.0,10.0,905.0,10.1,1.0,0.0,1.0,1.0,0.0,0.0,2.0,0.0,1.2,1.2,0.5,1.6,11.0,56.0,2.0,0.1,0.0,0.1,0.1,0.1,0.12,0.05,0.16,0.12,0.16,Matches,Benoît Badiashile,D C,21,133,158,France,AS Monaco,3,5,9,6,12,4,15,7,8,14,13,7,14,12,10,14,14,13,11,11,12,15,9,11,6,14,14,12,13,11,14,17,15,14,14,16,13,6,13,5,5,3,2,2,1,1,4,1,1,2,3,4,12,15,6,16,14,15,14,14,1,1,20,1,1,1,10,1,1,1,1,1,1,1,194,75,20,7,31039996,6638,6638,4988,African_Caribbean,132,17,2001/3/26,0,0,12657.0,,49038942
267,Leon Bailey,Aston Villa,1997,43.0,jm JAM,FWMF,24.0,21.9,14.0,6.0,6.0,7.0,1.0,5.0,20.0,25.0,15.0,13.0,0.0,13.0,6.0,20.0,12.0,0.0,Matches,43.0,jm JAM,FWMF,24.0,21.9,62.0,2.84,40.0,2.0,10.0,7.0,3.0,0.0,8.0,0.37,5.0,0.0,0.0,3.0,0.0,0.0,Matches,,,,,,,,,,,,,,,,,,,,,,,,,,,,,,,,,,,,,,,,,,,,,,,,,,,,,,,,43.0,jm JAM,FWMF,24.0,21.9,4.0,0.0,0.0,29.0,22.0,9.0,96.0,6.0,6.0,0.0,1.0,0.0,72.0,24.0,46.0,34.3,Matches,43.0,jm JAM,FWMF,24.0,21.9,547.0,507.0,40.0,4.0,4.0,5.0,96.0,10.0,18.0,13.0,0.0,0.0,337.0,0.0,31.0,Matches,43.0,jm JAM,FWMF,24.0,21.9,337.0,547.0,61.6,5379.0,1285.0,190.0,248.0,76.6,97.0,154.0,63.0,35.0,75.0,46.7,4.0,4.8,4.8,-0.8,30.0,19.0,21.0,15.0,28.0,Matches,56,jm JAM,FWMF,24,33,1967.0,60.0,57.5,21.9,26,70.0,4,7,21.0,0,1.61,27.0,32.0,-5.0,-0.23,-0.85,30.7,35.5,-4.8,-0.22,-0.38,Matches,43.0,jm JAM,FWMF,24.0,21.9,813.0,16.0,91.0,283.0,456.0,89.0,813.0,112.0,41.0,36.6,55.0,49.1,521.0,4027.0,1706.0,85.0,33.0,38.0,48.0,53.0,561.0,182.0,Matches,43.0,jm JAM,FWMF,24.0,21.9,4.0,51.0,14.0,27.5,2.33,0.64,0.08,0.29,18.1,3.0,0.0,0.0,5.3,5.3,0.1,-1.3,-1.3,Matches,43.0,jm JAM,FWMF,24.0,33.0,26.0,1967.0,21.9,4.0,4.0,8.0,4.0,0.0,0.0,4.0,0.0,5.3,5.3,4.8,10.1,85.0,28.0,182.0,0.18,0.18,0.37,0.18,0.37,0.24,0.22,0.46,0.24,0.46,Matches,Leon Bailey,M/AM RL,24,142,160,Jamaica,Aston Villa,14,14,15,13,12,12,7,14,11,4,11,12,7,15,13,11,12,11,10,12,8,15,17,8,13,6,9,13,17,16,10,12,14,17,13,9,11,8,13,13,12,3,4,1,1,1,1,2,3,3,1,2,16,18,16,5,12,10,10,10,1,1,1,1,1,1,1,18,1,18,19,14,20,12,178,75,20,9,37117355,7100,7550,6000,African_Caribbean,135,12,1997/8/9,17,3,98593.0,,18083491
268,Patrick Bamford,Leeds United,1993,46.0,eng ENG,FW,28.0,16.8,9.0,6.0,0.0,6.0,3.0,4.0,20.0,20.0,16.0,12.0,5.0,7.0,5.0,14.0,13.0,0.0,Matches,46.0,eng ENG,FW,28.0,16.8,27.0,1.6,17.0,0.0,1.0,5.0,3.0,1.0,6.0,0.36,4.0,0.0,1.0,1.0,0.0,0.0,Matches,,,,,,,,,,,,,,,,,,,,,,,,,,,,,,,,,,,,,,,,,,,,,,,,,,,,,,,,46.0,eng ENG,FW,28.0,16.8,3.0,0.0,0.0,25.0,27.0,18.0,5.0,5.0,6.0,0.0,0.0,0.0,50.0,36.0,42.0,46.2,Matches,46.0,eng ENG,FW,28.0,16.8,333.0,294.0,38.0,0.0,1.0,0.0,5.0,1.0,0.0,0.0,0.0,0.0,229.0,1.0,10.0,Matches,46.0,eng ENG,FW,28.0,16.8,229.0,333.0,68.8,2421.0,537.0,166.0,211.0,78.7,35.0,64.0,54.7,2.0,8.0,25.0,2.0,1.0,0.9,1.0,12.0,18.0,9.0,0.0,23.0,Matches,60,eng ENG,FW,28,28,1515.0,54.0,44.3,16.8,18,70.0,2,10,26.0,0,0.82,23.0,31.0,-8.0,-0.48,0.56,21.9,28.0,-6.1,-0.36,0.28,Matches,46.0,eng ENG,FW,28.0,16.8,550.0,19.0,34.0,257.0,266.0,83.0,548.0,34.0,11.0,32.4,19.0,55.9,290.0,1186.0,447.0,17.0,17.0,13.0,56.0,21.0,386.0,96.0,Matches,46.0,eng ENG,FW,28.0,16.8,4.0,48.0,16.0,33.3,2.85,0.95,0.08,0.25,14.7,1.0,0.0,2.0,8.5,6.9,0.15,-4.5,-2.9,Matches,46.0,eng ENG,FW,28.0,28.0,18.0,1515.0,16.8,4.0,2.0,6.0,4.0,0.0,2.0,3.0,0.0,8.5,6.9,1.0,7.9,17.0,23.0,96.0,0.24,0.12,0.36,0.24,0.36,0.51,0.06,0.56,0.41,0.47,Matches,Patrick Bamford,S C,28,139,140,"England,Republic of Ireland",Leeds United,2,10,12,16,14,8,11,12,2,9,12,12,10,13,11,15,15,11,15,12,13,15,12,11,16,13,16,18,13,13,13,13,11,14,18,11,13,3,10,11,12,2,3,2,3,2,1,3,3,3,2,3,8,11,3,14,18,16,15,18,1,1,1,1,1,1,1,6,1,6,13,15,14,20,185,81,20,8,29090727,6950,6950,5750,Northern_European,137,4,1993/9/5,1,0,86994.0,,28059632
269,Harvey Barnes,Leicester City,1997,48.0,eng ENG,FWMF,24.0,30.1,26.0,14.0,8.0,14.0,4.0,14.0,42.0,33.3,28.0,32.0,1.0,31.0,8.0,34.0,12.0,0.0,Matches,48.0,eng ENG,FWMF,24.0,30.1,63.0,2.09,43.0,0.0,3.0,9.0,7.0,1.0,14.0,0.46,8.0,0.0,1.0,2.0,2.0,1.0,Matches,,,,,,,,,,,,,,,,,,,,,,,,,,,,,,,,,,,,,,,,,,,,,,,,,,,,,,,,48.0,eng ENG,FWMF,24.0,30.1,3.0,0.0,0.0,38.0,37.0,9.0,44.0,8.0,14.0,0.0,0.0,0.0,101.0,29.0,57.0,33.7,Matches,48.0,eng ENG,FWMF,24.0,30.1,786.0,769.0,10.0,0.0,5.0,1.0,44.0,8.0,0.0,0.0,0.0,0.0,549.0,7.0,31.0,Matches,48.0,eng ENG,FWMF,24.0,30.1,549.0,786.0,69.8,7152.0,2004.0,363.0,462.0,78.6,142.0,210.0,67.6,17.0,37.0,45.9,1.0,3.1,2.2,-2.1,19.0,39.0,31.0,5.0,79.0,Matches,63,eng ENG,FWMF,24,34,2711.0,80.0,79.3,30.1,32,83.0,21,2,27.0,0,0.88,41.0,51.0,-10.0,-0.33,0.56,39.4,50.8,-11.4,-0.38,-0.21,Matches,48.0,eng ENG,FWMF,24.0,30.1,1143.0,17.0,128.0,435.0,600.0,133.0,1143.0,91.0,27.0,29.7,53.0,58.2,734.0,5174.0,2749.0,100.0,72.0,48.0,75.0,42.0,900.0,257.0,Matches,48.0,eng ENG,FWMF,24.0,30.1,13.0,72.0,34.0,47.2,2.39,1.13,0.18,0.38,15.9,0.0,0.0,0.0,8.9,8.9,0.12,4.1,4.1,Matches,48.0,eng ENG,FWMF,24.0,34.0,32.0,2711.0,30.1,13.0,1.0,14.0,13.0,0.0,0.0,3.0,0.0,8.9,8.9,3.1,12.0,100.0,79.0,257.0,0.43,0.03,0.46,0.43,0.46,0.3,0.1,0.4,0.3,0.4,Matches,Harvey Barnes,M/AM RLC,24,144,165,"England,Scotland",Leicester City,9,13,16,12,14,11,8,14,12,6,12,8,7,15,9,12,9,12,9,13,12,12,15,7,12,6,12,12,15,15,13,10,13,16,14,12,8,2,12,5,12,1,3,2,1,4,1,1,1,3,1,3,15,11,1,13,12,14,12,12,1,1,1,1,7,1,1,18,10,13,20,15,15,12,178,66,13,20,45103386,7200,7200,5500,Northern_European,141,1,1997/12/9,1,0,115992.0,,28100207
270,Gavin Bazunu,Southampton,2002,49.0,ie IRL,GK,20.0,32.0,1.0,0.0,1.0,0.0,0.0,1.0,1.0,100.0,0.0,0.0,0.0,0.0,1.0,2.0,24.0,2.0,Matches,49.0,ie IRL,GK,20.0,32.0,7.0,0.22,5.0,2.0,0.0,0.0,0.0,0.0,0.0,0.0,0.0,0.0,0.0,0.0,0.0,0.0,Matches,4.0,ie IRL,GK,20.0,32.0,56.0,1.0,1.0,7.0,4.0,35.4,0.28,-16.6,-0.52,212.0,629.0,33.7,935.0,144.0,50.2,38.1,237.0,67.5,50.0,456.0,36.0,7.9,48.0,1.5,15.1,Matches,4.0,ie IRL,GK,20.0,32.0,32.0,2880.0,32.0,56.0,1.75,120.0,67.0,54.2,6.0,6.0,20.0,4.0,12.5,2.0,1.0,1.0,0.0,50.0,Matches,49.0,ie IRL,GK,20.0,32.0,0.0,0.0,0.0,1.0,2.0,0.0,0.0,1.0,0.0,0.0,1.0,0.0,39.0,13.0,0.0,100.0,Matches,49.0,ie IRL,GK,20.0,32.0,1178.0,847.0,325.0,88.0,0.0,1.0,0.0,0.0,0.0,0.0,0.0,0.0,718.0,6.0,0.0,Matches,49.0,ie IRL,GK,20.0,32.0,718.0,1178.0,61.0,21528.0,16289.0,183.0,185.0,98.9,256.0,263.0,97.3,278.0,722.0,38.5,0.0,0.1,0.1,-0.1,1.0,42.0,1.0,0.0,1.0,Matches,64,ie IRL,GK,20,32,2880.0,90.0,84.2,32.0,32,90.0,32,0,,6,0.75,27.0,56.0,-29.0,-0.91,0.43,30.5,46.1,-15.6,-0.49,0.8,Matches,49.0,ie IRL,GK,20.0,32.0,1253.0,910.0,1234.0,19.0,0.0,0.0,1253.0,0.0,0.0,,0.0,,746.0,3699.0,2072.0,0.0,0.0,0.0,0.0,0.0,599.0,0.0,Matches,49.0,ie IRL,GK,20.0,32.0,0.0,0.0,0.0,,0.0,0.0,,,,0.0,0.0,0.0,0.0,0.0,,0.0,0.0,Matches,49.0,ie IRL,GK,20.0,32.0,32.0,2880.0,32.0,0.0,0.0,0.0,0.0,0.0,0.0,0.0,0.0,0.0,0.0,0.1,0.1,0.0,1.0,0.0,0.0,0.0,0.0,0.0,0.0,0.0,0.0,0.0,0.0,0.0,Matches,Gavin Bazunu,GK,20,126,-85,"Republic of Ireland,Nigeria",Southampton,3,1,3,1,11,4,8,2,2,1,13,3,3,11,8,11,11,12,8,12,10,15,8,7,12,12,12,11,12,13,13,13,13,11,13,10,12,5,8,4,10,14,14,13,4,16,14,14,16,11,9,12,12,15,3,12,14,15,12,15,20,1,1,1,1,1,1,1,1,1,1,1,1,1,189,79,8,20,81310207,6300,6300,5400,Mixed_Race,125,12,2002/2/20,10,0,46397.0,,52094936
271,Jan Bednarek,Southampton,1996,51.0,pl POL,DF,26.0,18.6,27.0,21.0,20.0,7.0,0.0,12.0,16.0,75.0,4.0,38.0,27.0,11.0,49.0,76.0,87.0,0.0,Matches,51.0,pl POL,DF,26.0,18.6,7.0,0.38,5.0,1.0,0.0,1.0,0.0,0.0,0.0,0.0,0.0,0.0,0.0,0.0,0.0,0.0,Matches,,,,,,,,,,,,,,,,,,,,,,,,,,,,,,,,,,,,,,,,,,,,,,,,,,,,,,,,51.0,pl POL,DF,26.0,18.6,5.0,0.0,0.0,15.0,7.0,0.0,1.0,49.0,21.0,0.0,0.0,1.0,98.0,40.0,16.0,71.4,Matches,51.0,pl POL,DF,26.0,18.6,902.0,849.0,52.0,35.0,0.0,3.0,1.0,12.0,0.0,0.0,0.0,0.0,753.0,1.0,8.0,Matches,51.0,pl POL,DF,26.0,18.6,753.0,902.0,83.5,13941.0,5608.0,293.0,337.0,86.9,380.0,417.0,91.1,72.0,124.0,58.1,0.0,0.1,0.2,-0.1,3.0,33.0,1.0,0.0,45.0,Matches,66,pl POL,DF,26,20,1672.0,84.0,48.9,18.6,20,84.0,17,0,,3,0.55,16.0,39.0,-23.0,-1.24,-0.52,16.9,35.0,-18.2,-0.98,-0.71,Matches,51.0,pl POL,DF,26.0,18.6,1127.0,205.0,635.0,460.0,37.0,14.0,1127.0,2.0,1.0,50.0,1.0,50.0,579.0,2671.0,1580.0,8.0,1.0,0.0,2.0,1.0,605.0,2.0,Matches,51.0,pl POL,DF,26.0,18.6,0.0,8.0,0.0,0.0,0.43,0.0,0.0,,14.2,0.0,0.0,0.0,0.4,0.4,0.05,-0.4,-0.4,Matches,51.0,pl POL,DF,26.0,20.0,20.0,1672.0,18.6,0.0,0.0,0.0,0.0,0.0,0.0,5.0,0.0,0.4,0.4,0.1,0.5,8.0,45.0,2.0,0.0,0.0,0.0,0.0,0.0,0.02,0.01,0.03,0.02,0.03,Matches,Jan Bednarek,D C,26,140,145,Poland,Southampton,2,7,9,7,11,3,14,5,5,15,12,5,14,13,12,14,17,13,14,9,14,13,8,13,5,14,14,15,13,12,13,14,17,13,17,15,13,5,13,9,9,2,3,2,3,2,2,1,3,4,3,3,12,13,4,14,13,12,12,10,1,1,20,13,1,1,13,1,1,1,1,1,1,1,189,77,11,20,35991161,6995,6264,5654,Northern_European,140,4,1996/4/12,42,1,69595.0,Aston Villa,96047750
272,Saïd Benrahma,West Ham,1995,56.0,dz ALG,FWMF,26.0,23.0,25.0,15.0,11.0,7.0,7.0,11.0,27.0,40.7,16.0,23.0,1.0,22.0,9.0,34.0,13.0,0.0,Matches,56.0,dz ALG,FWMF,26.0,23.0,92.0,4.0,68.0,2.0,11.0,8.0,3.0,0.0,5.0,0.22,4.0,0.0,1.0,0.0,0.0,0.0,Matches,,,,,,,,,,,,,,,,,,,,,,,,,,,,,,,,,,,,,,,,,,,,,,,,,,,,,,,,56.0,dz ALG,FWMF,26.0,23.0,0.0,0.0,0.0,16.0,15.0,7.0,83.0,9.0,15.0,0.0,0.0,0.0,113.0,5.0,11.0,31.3,Matches,56.0,dz ALG,FWMF,26.0,23.0,796.0,771.0,20.0,1.0,5.0,2.0,83.0,8.0,4.0,4.0,0.0,0.0,597.0,5.0,29.0,Matches,56.0,dz ALG,FWMF,26.0,23.0,597.0,796.0,75.0,8154.0,2088.0,374.0,425.0,88.0,176.0,241.0,73.0,25.0,61.0,41.0,3.0,4.5,3.3,-1.5,48.0,32.0,23.0,12.0,82.0,Matches,72,dz ALG,FWMF,26,35,2069.0,59.0,60.5,23.0,22,77.0,8,13,28.0,3,0.89,25.0,32.0,-7.0,-0.3,0.1,32.3,32.7,-0.5,-0.02,0.2,Matches,56.0,dz ALG,FWMF,26.0,23.0,1091.0,16.0,131.0,399.0,583.0,94.0,1087.0,123.0,51.0,41.5,56.0,45.5,699.0,5281.0,2705.0,109.0,54.0,44.0,53.0,42.0,800.0,237.0,Matches,56.0,dz ALG,FWMF,26.0,23.0,6.0,69.0,23.0,33.3,3.0,1.0,0.03,0.09,21.9,5.0,4.0,4.0,7.0,3.9,0.06,-1.0,-1.9,Matches,56.0,dz ALG,FWMF,26.0,35.0,22.0,2069.0,23.0,6.0,3.0,9.0,2.0,4.0,4.0,0.0,0.0,7.0,3.9,4.5,8.4,109.0,82.0,237.0,0.26,0.13,0.39,0.09,0.22,0.31,0.2,0.5,0.17,0.36,Matches,Saïd Benrahma,AM RLC,26,140,148,"Algeria,France",West Ham United,10,13,17,13,17,13,8,11,6,5,13,12,6,17,10,11,11,13,11,13,12,14,18,6,14,6,10,13,14,15,13,7,14,14,14,9,11,4,11,5,12,3,2,2,4,3,2,3,3,1,2,1,13,13,6,12,14,14,13,12,1,1,1,1,1,1,1,1,1,1,20,18,18,13,172,67,12,20,31129862,6994,6994,5494,North_African__Middle_Eastern,138,11,1995/8/10,17,1,69595.0,,48036788
273,Rodrigo Bentancur,Tottenham,1997,57.0,uy URU,MF,25.0,16.7,45.0,28.0,15.0,21.0,9.0,16.0,28.0,57.1,12.0,28.0,15.0,13.0,20.0,65.0,22.0,0.0,Matches,57.0,uy URU,MF,25.0,16.7,34.0,2.04,27.0,0.0,1.0,2.0,1.0,3.0,5.0,0.3,2.0,0.0,0.0,1.0,0.0,2.0,Matches,,,,,,,,,,,,,,,,,,,,,,,,,,,,,,,,,,,,,,,,,,,,,,,,,,,,,,,,57.0,uy URU,MF,25.0,16.7,8.0,0.0,0.0,24.0,8.0,0.0,16.0,20.0,28.0,0.0,0.0,0.0,128.0,15.0,16.0,48.4,Matches,57.0,uy URU,MF,25.0,16.7,880.0,852.0,25.0,11.0,3.0,3.0,16.0,4.0,1.0,0.0,0.0,0.0,738.0,3.0,19.0,Matches,57.0,uy URU,MF,25.0,16.7,738.0,880.0,83.9,11482.0,3178.0,368.0,413.0,89.1,301.0,336.0,89.6,39.0,70.0,55.7,2.0,0.8,0.7,1.2,11.0,54.0,9.0,4.0,76.0,Matches,73,uy URU,MF,25,18,1500.0,83.0,43.9,16.7,17,86.0,10,1,33.0,0,1.89,33.0,24.0,9.0,0.54,0.63,26.4,19.6,6.8,0.41,0.38,Matches,57.0,uy URU,MF,25.0,16.7,1071.0,52.0,295.0,612.0,175.0,19.0,1071.0,34.0,21.0,61.8,11.0,32.4,581.0,3001.0,1444.0,26.0,14.0,1.0,22.0,17.0,732.0,19.0,Matches,57.0,uy URU,MF,25.0,16.7,5.0,15.0,9.0,60.0,0.9,0.54,0.33,0.56,15.8,0.0,0.0,0.0,2.2,2.2,0.15,2.8,2.8,Matches,57.0,uy URU,MF,25.0,18.0,17.0,1500.0,16.7,5.0,2.0,7.0,5.0,0.0,0.0,8.0,0.0,2.2,2.2,0.8,3.1,26.0,76.0,19.0,0.3,0.12,0.42,0.3,0.42,0.13,0.05,0.18,0.13,0.18,Matches,Rodrigo Bentancur,DM/M C,25,149,164,Uruguay,Tottenham Hotspur,12,12,14,10,15,12,12,11,7,14,14,8,16,14,16,15,13,13,11,11,13,12,11,10,10,16,15,16,12,14,15,13,14,13,15,14,12,15,11,7,16,1,2,2,3,3,2,1,1,3,1,1,16,12,5,15,17,18,15,11,1,1,1,1,1,1,18,7,20,7,1,8,1,1,187,77,12,20,57897159,7446,7846,6496,Mediterranean_Hispanic,144,4,1997/6/25,49,1,86994.0,,14094572
274,Philip Billing,Bournemouth,1996,62.0,dk DEN,MFFW,26.0,30.7,63.0,36.0,21.0,33.0,9.0,11.0,42.0,26.2,31.0,48.0,8.0,40.0,31.0,94.0,58.0,1.0,Matches,62.0,dk DEN,MFFW,26.0,30.7,54.0,1.76,41.0,2.0,5.0,5.0,1.0,0.0,6.0,0.2,4.0,0.0,0.0,2.0,0.0,0.0,Matches,,,,,,,,,,,,,,,,,,,,,,,,,,,,,,,,,,,,,,,,,,,,,,,,,,,,,,,,62.0,dk DEN,MFFW,26.0,30.7,5.0,0.0,0.0,30.0,35.0,3.0,38.0,31.0,36.0,0.0,0.0,0.0,146.0,52.0,35.0,59.8,Matches,62.0,dk DEN,MFFW,26.0,30.7,1055.0,1009.0,43.0,20.0,5.0,10.0,38.0,6.0,10.0,5.0,1.0,0.0,813.0,3.0,32.0,Matches,62.0,dk DEN,MFFW,26.0,30.7,813.0,1055.0,77.1,11823.0,3165.0,460.0,542.0,84.9,257.0,317.0,81.1,45.0,94.0,47.9,1.0,3.2,2.6,-2.2,26.0,49.0,9.0,3.0,80.0,Matches,79,dk DEN,MFFW,26,36,2764.0,77.0,80.8,30.7,34,79.0,11,2,36.0,0,1.06,32.0,54.0,-22.0,-0.72,0.93,31.4,48.8,-17.4,-0.57,0.52,Matches,62.0,dk DEN,MFFW,26.0,30.7,1410.0,76.0,334.0,666.0,428.0,71.0,1410.0,49.0,28.0,57.1,15.0,30.6,728.0,3709.0,1694.0,37.0,31.0,6.0,42.0,35.0,900.0,101.0,Matches,62.0,dk DEN,MFFW,26.0,30.7,7.0,38.0,18.0,47.4,1.24,0.59,0.18,0.39,18.3,5.0,0.0,0.0,4.9,4.9,0.13,2.1,2.1,Matches,62.0,dk DEN,MFFW,26.0,36.0,34.0,2764.0,30.7,7.0,1.0,8.0,7.0,0.0,0.0,5.0,0.0,4.9,4.9,3.2,8.0,37.0,80.0,101.0,0.23,0.03,0.26,0.23,0.26,0.16,0.1,0.26,0.16,0.26,Matches,Philip Billing,DM/M/AM C,26,130,136,"Denmark,Nigeria",AFC Bournemouth,6,10,12,12,13,7,8,12,17,10,14,12,11,13,13,12,13,13,11,11,13,13,10,8,12,11,12,14,12,14,13,15,16,13,15,15,12,6,12,8,13,1,3,1,2,3,3,1,3,3,2,1,11,13,12,8,11,10,9,12,1,1,12,1,1,1,17,10,20,10,1,19,1,1,196,88,20,10,13037498,6495,6495,5595,Mixed_Race,127,12,1996/6/11,3,0,52196.0,,29121437
275,Yves Bissouma,Tottenham,1996,63.0,ml MLI,MF,25.0,11.2,16.0,13.0,6.0,6.0,4.0,2.0,7.0,28.6,5.0,15.0,6.0,9.0,12.0,28.0,10.0,0.0,Matches,63.0,ml MLI,MF,25.0,11.2,29.0,2.58,24.0,0.0,1.0,1.0,1.0,2.0,1.0,0.09,1.0,0.0,0.0,0.0,0.0,0.0,Matches,,,,,,,,,,,,,,,,,,,,,,,,,,,,,,,,,,,,,,,,,,,,,,,,,,,,,,,,63.0,ml MLI,MF,25.0,11.2,6.0,0.0,0.0,17.0,10.0,1.0,2.0,12.0,13.0,0.0,0.0,0.0,68.0,6.0,12.0,33.3,Matches,63.0,ml MLI,MF,25.0,11.2,733.0,714.0,16.0,11.0,1.0,5.0,2.0,1.0,0.0,0.0,0.0,0.0,666.0,3.0,12.0,Matches,63.0,ml MLI,MF,25.0,11.2,666.0,733.0,90.9,10412.0,2333.0,340.0,357.0,95.2,271.0,289.0,93.8,38.0,48.0,79.2,0.0,0.5,0.4,-0.5,8.0,55.0,5.0,1.0,62.0,Matches,81,ml MLI,MF,25,23,1010.0,44.0,29.5,11.2,10,81.0,4,13,15.0,2,1.57,20.0,20.0,0.0,0.0,-0.26,15.5,13.8,1.7,0.15,-0.06,Matches,63.0,ml MLI,MF,25.0,11.2,826.0,23.0,164.0,536.0,127.0,2.0,826.0,9.0,7.0,77.8,2.0,22.2,504.0,2761.0,1143.0,14.0,13.0,1.0,16.0,8.0,613.0,10.0,Matches,63.0,ml MLI,MF,25.0,11.2,0.0,6.0,0.0,0.0,0.53,0.0,0.0,,26.7,0.0,0.0,0.0,0.2,0.2,0.03,-0.2,-0.2,Matches,63.0,ml MLI,MF,25.0,23.0,10.0,1010.0,11.2,0.0,0.0,0.0,0.0,0.0,0.0,6.0,0.0,0.2,0.2,0.5,0.7,14.0,62.0,10.0,0.0,0.0,0.0,0.0,0.0,0.02,0.05,0.06,0.02,0.06,Matches,Yves Bissouma,DM/M C,25,158,165,"Mali,Ivory Coast",Tottenham Hotspur,8,11,14,9,16,13,12,13,7,14,16,13,17,16,13,15,14,15,15,10,14,14,14,11,12,16,15,16,16,14,13,12,14,14,16,15,13,9,13,7,15,2,2,1,1,2,3,2,2,4,2,3,15,14,4,12,13,14,13,14,1,1,1,1,1,12,17,1,20,1,1,1,1,1,182,78,8,20,206180525,7900,7900,6250,African_Caribbean,156,15,1996/8/30,26,3,104393.0,,13174979
276,Sven Botman,Newcastle Utd,2000,65.0,nl NED,DF,22.0,34.7,38.0,24.0,31.0,7.0,0.0,22.0,28.0,78.6,6.0,44.0,24.0,20.0,34.0,72.0,126.0,2.0,Matches,65.0,nl NED,DF,22.0,34.7,24.0,0.69,18.0,1.0,0.0,5.0,0.0,0.0,1.0,0.03,0.0,0.0,0.0,1.0,0.0,0.0,Matches,,,,,,,,,,,,,,,,,,,,,,,,,,,,,,,,,,,,,,,,,,,,,,,,,,,,,,,,65.0,nl NED,DF,22.0,34.7,2.0,0.0,0.0,15.0,12.0,2.0,1.0,34.0,24.0,0.0,1.0,0.0,182.0,75.0,40.0,65.2,Matches,65.0,nl NED,DF,22.0,34.7,1765.0,1717.0,42.0,32.0,0.0,30.0,1.0,4.0,0.0,0.0,0.0,0.0,1527.0,6.0,7.0,Matches,65.0,nl NED,DF,22.0,34.7,1527.0,1765.0,86.5,30660.0,11233.0,480.0,543.0,88.4,855.0,929.0,92.0,178.0,258.0,69.0,0.0,1.0,1.1,-1.0,9.0,59.0,4.0,1.0,87.0,Matches,85,nl NED,DF,22,36,3127.0,87.0,91.4,34.7,35,89.0,33,1,1.0,2,1.94,64.0,30.0,34.0,0.98,0.67,66.7,37.0,29.6,0.85,0.02,Matches,65.0,nl NED,DF,22.0,34.7,2074.0,338.0,1188.0,801.0,95.0,53.0,2074.0,1.0,1.0,100.0,0.0,0.0,1171.0,5259.0,2810.0,8.0,5.0,2.0,10.0,2.0,1347.0,5.0,Matches,65.0,nl NED,DF,22.0,34.7,0.0,22.0,7.0,31.8,0.63,0.2,0.0,0.0,10.2,0.0,0.0,0.0,2.5,2.5,0.11,-2.5,-2.5,Matches,65.0,nl NED,DF,22.0,36.0,35.0,3127.0,34.7,0.0,0.0,0.0,0.0,0.0,0.0,2.0,0.0,2.5,2.5,1.0,3.5,8.0,87.0,5.0,0.0,0.0,0.0,0.0,0.0,0.07,0.03,0.1,0.07,0.1,Matches,Sven Botman,D LC,22,135,149,Holland,Newcastle United,7,9,9,6,12,3,15,6,11,15,14,8,16,13,10,14,13,13,14,10,12,13,8,12,9,13,12,14,10,9,14,16,12,12,15,15,13,5,11,7,12,1,2,3,2,4,1,3,3,3,3,3,13,13,8,12,11,15,13,7,1,16,20,1,13,1,13,1,1,1,1,1,1,10,193,0,20,8,49760455,6750,6750,5500,Northern_European,131,2,2000/1/12,0,0,104393.0,,37063649
277,Jarrod Bowen,West Ham,1996,66.0,eng ENG,FWMF,25.0,35.9,39.0,16.0,14.0,11.0,14.0,16.0,58.0,27.6,42.0,47.0,9.0,38.0,36.0,75.0,25.0,0.0,Matches,66.0,eng ENG,FWMF,25.0,35.9,108.0,3.01,58.0,15.0,10.0,13.0,10.0,2.0,14.0,0.39,6.0,3.0,0.0,2.0,3.0,0.0,Matches,,,,,,,,,,,,,,,,,,,,,,,,,,,,,,,,,,,,,,,,,,,,,,,,,,,,,,,,66.0,eng ENG,FWMF,25.0,35.9,2.0,0.0,0.0,26.0,69.0,10.0,159.0,36.0,16.0,3.0,1.0,0.0,152.0,34.0,68.0,33.3,Matches,66.0,eng ENG,FWMF,25.0,35.9,881.0,768.0,109.0,11.0,6.0,4.0,159.0,3.0,90.0,85.0,0.0,0.0,552.0,4.0,58.0,Matches,66.0,eng ENG,FWMF,25.0,35.9,552.0,881.0,62.7,8725.0,2552.0,312.0,385.0,81.0,170.0,225.0,75.6,52.0,164.0,31.7,5.0,7.4,6.0,-2.4,48.0,39.0,24.0,9.0,72.0,Matches,86,eng ENG,FWMF,25,38,3233.0,85.0,94.5,35.9,36,89.0,30,2,19.0,0,1.05,40.0,50.0,-10.0,-0.28,1.17,46.7,47.9,-1.2,-0.03,1.24,Matches,66.0,eng ENG,FWMF,25.0,35.9,1318.0,32.0,186.0,451.0,693.0,157.0,1316.0,118.0,36.0,30.5,55.0,46.6,731.0,5565.0,2201.0,101.0,44.0,56.0,70.0,55.0,793.0,213.0,Matches,66.0,eng ENG,FWMF,25.0,35.9,6.0,73.0,21.0,28.8,2.03,0.58,0.07,0.24,16.2,1.0,1.0,2.0,8.9,7.8,0.11,-2.9,-2.8,Matches,66.0,eng ENG,FWMF,25.0,38.0,36.0,3233.0,35.9,6.0,5.0,11.0,5.0,1.0,2.0,2.0,0.0,8.9,7.8,7.4,15.2,101.0,72.0,213.0,0.17,0.14,0.31,0.14,0.28,0.25,0.2,0.45,0.22,0.42,Matches,Jarrod Bowen,AM RLC,25,150,160,England,West Ham United,13,14,16,15,13,12,10,14,4,5,14,14,8,14,8,14,8,14,10,13,14,17,14,5,16,8,15,17,15,15,11,8,14,15,15,8,15,5,15,4,12,1,3,1,3,1,1,3,2,2,2,3,15,16,3,13,15,17,12,18,1,1,1,1,1,1,1,15,1,15,19,18,20,14,174,70,20,11,53588177,7500,7500,5500,Northern_European,147,4,1996/12/20,4,0,92793.0,,29125842
278,Hugo Bueno,Wolves,2002,72.0,es ESP,DF,19.0,14.6,33.0,16.0,23.0,6.0,4.0,17.0,33.0,51.5,16.0,14.0,1.0,13.0,10.0,43.0,36.0,0.0,Matches,72.0,es ESP,DF,19.0,14.6,30.0,2.06,22.0,7.0,0.0,1.0,0.0,0.0,1.0,0.07,1.0,0.0,0.0,0.0,0.0,0.0,Matches,,,,,,,,,,,,,,,,,,,,,,,,,,,,,,,,,,,,,,,,,,,,,,,,,,,,,,,,72.0,es ESP,DF,19.0,14.6,1.0,0.0,0.0,7.0,7.0,1.0,60.0,10.0,16.0,0.0,0.0,0.0,90.0,10.0,17.0,37.0,Matches,72.0,es ESP,DF,19.0,14.6,679.0,536.0,140.0,9.0,0.0,0.0,60.0,113.0,18.0,2.0,16.0,0.0,547.0,3.0,21.0,Matches,72.0,es ESP,DF,19.0,14.6,547.0,679.0,80.6,7697.0,2227.0,340.0,369.0,92.1,174.0,214.0,81.3,19.0,54.0,35.2,1.0,1.3,1.0,-0.3,16.0,24.0,10.0,6.0,39.0,Matches,93,es ESP,DF,19,21,1310.0,62.0,38.3,14.6,16,75.0,7,5,21.0,9,1.05,12.0,29.0,-17.0,-1.17,-0.74,13.3,23.0,-9.7,-0.67,-0.1,Matches,72.0,es ESP,DF,19.0,14.6,835.0,53.0,318.0,275.0,249.0,14.0,835.0,34.0,14.0,41.2,14.0,41.2,396.0,2714.0,1422.0,52.0,29.0,4.0,16.0,11.0,446.0,64.0,Matches,72.0,es ESP,DF,19.0,14.6,0.0,4.0,1.0,25.0,0.27,0.07,0.0,0.0,18.5,0.0,0.0,0.0,0.2,0.2,0.04,-0.2,-0.2,Matches,72.0,es ESP,DF,19.0,21.0,16.0,1310.0,14.6,0.0,1.0,1.0,0.0,0.0,0.0,1.0,0.0,0.2,0.2,1.3,1.5,52.0,39.0,64.0,0.0,0.07,0.07,0.0,0.07,0.01,0.09,0.1,0.01,0.1,Matches,Hugo Bueno,WB L,19,100,-75,Spain,Wolverhampton Wanderers,5,13,13,8,10,5,10,6,9,12,11,8,10,13,12,9,9,13,11,11,12,2,13,10,10,9,8,11,13,12,6,10,14,13,13,8,10,13,9,7,13,1,2,3,3,1,3,2,1,1,1,3,11,11,8,10,9,10,10,10,1,15,1,1,20,1,1,1,12,1,1,1,1,1,180,73,20,10,25054215,4994,4994,2754,Mediterranean_Hispanic,98,4,2002/9/18,0,0,1740.0,,28127371
279,Dan Burn,Newcastle Utd,1992,74.0,eng ENG,DF,30.0,34.6,60.0,38.0,29.0,23.0,8.0,34.0,67.0,50.7,33.0,42.0,16.0,26.0,32.0,92.0,120.0,2.0,Matches,74.0,eng ENG,DF,30.0,34.6,40.0,1.16,35.0,2.0,0.0,3.0,0.0,0.0,3.0,0.09,3.0,0.0,0.0,0.0,0.0,0.0,Matches,,,,,,,,,,,,,,,,,,,,,,,,,,,,,,,,,,,,,,,,,,,,,,,,,,,,,,,,74.0,eng ENG,DF,30.0,34.6,5.0,0.0,0.0,35.0,4.0,7.0,17.0,32.0,38.0,0.0,1.0,0.0,166.0,84.0,37.0,69.4,Matches,74.0,eng ENG,DF,30.0,34.6,1715.0,1437.0,275.0,17.0,0.0,7.0,17.0,257.0,0.0,0.0,0.0,0.0,1361.0,3.0,29.0,Matches,74.0,eng ENG,DF,30.0,34.6,1361.0,1715.0,79.4,22235.0,8853.0,673.0,765.0,88.0,566.0,682.0,83.0,94.0,183.0,51.4,0.0,1.3,1.3,-1.3,16.0,102.0,11.0,2.0,118.0,Matches,95,eng ENG,DF,30,38,3111.0,82.0,91.0,34.6,35,87.0,27,3,17.0,0,1.87,64.0,30.0,34.0,0.98,0.69,66.0,35.1,30.9,0.89,0.48,Matches,74.0,eng ENG,DF,30.0,34.6,2073.0,158.0,786.0,940.0,358.0,62.0,2073.0,25.0,11.0,44.0,12.0,48.0,926.0,4329.0,2196.0,29.0,22.0,5.0,34.0,9.0,1116.0,46.0,Matches,74.0,eng ENG,DF,30.0,34.6,1.0,21.0,4.0,19.0,0.61,0.12,0.05,0.25,12.2,0.0,0.0,0.0,2.1,2.1,0.1,-1.1,-1.1,Matches,74.0,eng ENG,DF,30.0,38.0,35.0,3111.0,34.6,1.0,0.0,1.0,1.0,0.0,0.0,5.0,0.0,2.1,2.1,1.3,3.4,29.0,118.0,46.0,0.03,0.0,0.03,0.03,0.03,0.06,0.04,0.1,0.06,0.1,Matches,Dan Burn,D LC,30,137,142,England,Newcastle United,7,9,9,9,12,4,16,4,13,14,13,5,15,12,13,15,17,13,13,12,13,16,8,13,9,13,17,17,9,8,8,19,12,14,15,16,14,5,12,5,5,3,1,4,3,2,3,1,1,3,3,3,8,14,4,14,12,18,15,10,1,17,20,1,14,1,1,1,1,1,1,1,1,1,201,87,20,8,36895465,6850,6850,5500,Northern_European,137,6,1992/5/9,0,0,57996.0,,29061164
280,Moisés Caicedo,Brighton,2001,76.0,ec ECU,MF,20.0,34.9,100.0,50.0,41.0,47.0,12.0,40.0,68.0,58.8,28.0,43.0,7.0,36.0,56.0,156.0,31.0,3.0,Matches,76.0,ec ECU,MF,20.0,34.9,88.0,2.52,81.0,0.0,2.0,3.0,1.0,1.0,5.0,0.14,5.0,0.0,0.0,0.0,0.0,0.0,Matches,,,,,,,,,,,,,,,,,,,,,,,,,,,,,,,,,,,,,,,,,,,,,,,,,,,,,,,,76.0,ec ECU,MF,20.0,34.9,10.0,0.0,0.0,65.0,54.0,0.0,17.0,56.0,50.0,0.0,0.0,0.0,248.0,37.0,20.0,64.9,Matches,76.0,ec ECU,MF,20.0,34.9,2251.0,2214.0,37.0,12.0,11.0,9.0,17.0,25.0,0.0,0.0,0.0,0.0,1993.0,0.0,38.0,Matches,76.0,ec ECU,MF,20.0,34.9,1993.0,2251.0,88.5,30177.0,8036.0,1112.0,1202.0,92.5,683.0,755.0,90.5,126.0,159.0,79.2,1.0,2.7,2.5,-1.7,43.0,181.0,35.0,7.0,219.0,Matches,101,ec ECU,MF,20,37,3139.0,85.0,91.8,34.9,34,89.0,30,3,35.0,0,1.68,62.0,47.0,15.0,0.43,-0.85,65.3,44.9,20.4,0.59,-0.28,Matches,76.0,ec ECU,MF,20.0,34.9,2603.0,91.0,555.0,1520.0,558.0,28.0,2603.0,54.0,28.0,51.9,21.0,38.9,1507.0,6220.0,2876.0,38.0,32.0,6.0,39.0,23.0,1891.0,61.0,Matches,76.0,ec ECU,MF,20.0,34.9,1.0,28.0,8.0,28.6,0.8,0.23,0.04,0.13,23.9,0.0,0.0,0.0,1.7,1.7,0.06,-0.7,-0.7,Matches,76.0,ec ECU,MF,20.0,37.0,34.0,3139.0,34.9,1.0,1.0,2.0,1.0,0.0,0.0,10.0,0.0,1.7,1.7,2.7,4.3,38.0,219.0,61.0,0.03,0.03,0.06,0.03,0.06,0.05,0.08,0.12,0.05,0.12,Matches,Moisés Caicedo,DM/M C,20,143,-9,Ecuador,Brighton & Hove Albion,5,8,14,10,13,8,9,12,4,12,15,8,17,14,13,13,13,14,13,14,14,15,14,9,13,14,14,15,16,16,12,9,18,14,16,9,13,8,11,6,10,3,3,3,1,1,1,1,2,3,2,2,4,14,8,13,10,12,13,10,1,1,1,1,1,1,19,1,20,1,1,1,1,1,178,73,8,20,94034500,7143,7143,4243,African_Caribbean,141,17,2001/11/2,25,2,28998.0,,86078360
281,Tom Cairney,Fulham,1991,77.0,sct SCO,MF,31.0,11.0,17.0,6.0,4.0,8.0,5.0,7.0,10.0,70.0,3.0,18.0,3.0,15.0,5.0,22.0,3.0,0.0,Matches,77.0,sct SCO,MF,31.0,11.0,45.0,4.1,35.0,4.0,1.0,2.0,2.0,1.0,3.0,0.27,3.0,0.0,0.0,0.0,0.0,0.0,Matches,,,,,,,,,,,,,,,,,,,,,,,,,,,,,,,,,,,,,,,,,,,,,,,,,,,,,,,,77.0,sct SCO,MF,31.0,11.0,2.0,0.0,0.0,8.0,22.0,0.0,37.0,5.0,6.0,1.0,0.0,0.0,76.0,8.0,10.0,44.4,Matches,77.0,sct SCO,MF,31.0,11.0,750.0,715.0,33.0,9.0,2.0,4.0,37.0,4.0,17.0,7.0,3.0,0.0,632.0,2.0,13.0,Matches,77.0,sct SCO,MF,31.0,11.0,632.0,750.0,84.3,10133.0,2428.0,326.0,352.0,92.6,230.0,264.0,87.1,51.0,84.0,60.7,0.0,1.4,1.5,-1.4,12.0,70.0,19.0,5.0,92.0,Matches,102,sct SCO,MF,31,33,988.0,30.0,28.9,11.0,6,78.0,0,27,19.0,0,1.36,18.0,13.0,5.0,0.46,0.57,16.0,20.1,-4.1,-0.38,0.12,Matches,77.0,sct SCO,MF,31.0,11.0,872.0,10.0,127.0,426.0,332.0,31.0,872.0,21.0,9.0,42.9,8.0,38.1,573.0,3124.0,1516.0,34.0,27.0,6.0,23.0,21.0,667.0,57.0,Matches,77.0,sct SCO,MF,31.0,11.0,2.0,21.0,2.0,9.5,1.91,0.18,0.1,1.0,18.6,0.0,0.0,0.0,1.5,1.5,0.07,0.5,0.5,Matches,77.0,sct SCO,MF,31.0,33.0,6.0,988.0,11.0,2.0,0.0,2.0,2.0,0.0,0.0,2.0,0.0,1.5,1.5,1.4,2.9,34.0,92.0,57.0,0.18,0.0,0.18,0.18,0.18,0.13,0.13,0.26,0.13,0.26,Matches,Tom Cairney,M/AM C,31,126,135,"Scotland,England",Fulham,12,14,13,13,15,14,7,15,6,7,15,13,10,15,13,14,9,14,12,14,15,11,15,15,14,12,14,11,10,13,14,10,15,10,13,9,13,5,14,7,13,1,4,3,3,1,2,2,2,1,2,1,12,14,7,11,14,11,7,18,1,1,1,1,1,1,1,1,20,13,1,20,13,1,185,72,20,7,3575474,6250,5634,5271,Northern_European,126,4,1991/1/20,2,0,34798.0,,28025033
282,Duje Ćaleta-Car,Southampton,1996,78.0,hr CRO,DF,25.0,10.5,14.0,10.0,9.0,4.0,1.0,6.0,9.0,66.7,3.0,15.0,11.0,4.0,15.0,29.0,65.0,1.0,Matches,78.0,hr CRO,DF,25.0,10.5,6.0,0.57,6.0,0.0,0.0,0.0,0.0,0.0,0.0,0.0,0.0,0.0,0.0,0.0,0.0,0.0,Matches,,,,,,,,,,,,,,,,,,,,,,,,,,,,,,,,,,,,,,,,,,,,,,,,,,,,,,,,78.0,hr CRO,DF,25.0,10.5,2.0,0.0,0.0,9.0,1.0,0.0,1.0,15.0,10.0,0.0,0.0,0.0,54.0,19.0,13.0,59.4,Matches,78.0,hr CRO,DF,25.0,10.5,568.0,542.0,22.0,17.0,0.0,3.0,1.0,1.0,0.0,0.0,0.0,0.0,480.0,4.0,1.0,Matches,78.0,hr CRO,DF,25.0,10.5,480.0,568.0,84.5,9398.0,3504.0,155.0,173.0,89.6,268.0,289.0,92.7,53.0,93.0,57.0,0.0,0.0,0.2,0.0,1.0,26.0,0.0,0.0,33.0,Matches,103,hr CRO,DF,25,13,946.0,73.0,27.7,10.5,9,86.0,7,4,44.0,13,0.69,8.0,15.0,-7.0,-0.67,0.43,9.2,14.7,-5.6,-0.53,0.11,Matches,78.0,hr CRO,DF,25.0,10.5,695.0,136.0,416.0,268.0,15.0,9.0,695.0,2.0,2.0,100.0,0.0,0.0,387.0,1829.0,993.0,5.0,1.0,0.0,1.0,2.0,429.0,0.0,Matches,78.0,hr CRO,DF,25.0,10.5,1.0,5.0,2.0,40.0,0.48,0.19,0.2,0.5,12.3,0.0,0.0,0.0,0.8,0.8,0.16,0.2,0.2,Matches,78.0,hr CRO,DF,25.0,13.0,9.0,946.0,10.5,1.0,0.0,1.0,1.0,0.0,0.0,2.0,0.0,0.8,0.8,0.0,0.8,5.0,33.0,0.0,0.1,0.0,0.1,0.1,0.1,0.08,0.0,0.08,0.08,0.08,Matches,Duje Ćaleta-Car,D C,25,135,144,Croatia,Southampton,5,5,8,7,13,8,15,10,8,14,14,8,14,9,14,15,13,12,13,12,12,15,10,11,8,14,14,14,11,11,15,15,14,12,14,16,14,11,13,12,6,1,3,3,2,4,3,2,3,1,3,1,14,13,8,10,12,14,14,13,1,1,20,1,1,1,1,1,1,1,1,1,1,1,192,89,11,20,24283271,6750,7050,5250,Northern_European,134,4,1996/9/17,23,1,57996.0,,24039427
283,Dominic Calvert-Lewin,Everton,1997,79.0,eng ENG,FW,25.0,12.9,4.0,2.0,1.0,0.0,3.0,1.0,5.0,20.0,4.0,5.0,1.0,4.0,3.0,7.0,18.0,0.0,Matches,79.0,eng ENG,FW,25.0,12.9,24.0,1.85,16.0,0.0,5.0,1.0,2.0,0.0,4.0,0.31,2.0,0.0,1.0,0.0,1.0,0.0,Matches,,,,,,,,,,,,,,,,,,,,,,,,,,,,,,,,,,,,,,,,,,,,,,,,,,,,,,,,79.0,eng ENG,FW,25.0,12.9,3.0,0.0,0.0,22.0,14.0,19.0,6.0,3.0,2.0,1.0,0.0,0.0,28.0,66.0,72.0,47.8,Matches,79.0,eng ENG,FW,25.0,12.9,221.0,220.0,1.0,0.0,0.0,1.0,6.0,0.0,0.0,0.0,0.0,0.0,131.0,0.0,9.0,Matches,79.0,eng ENG,FW,25.0,12.9,131.0,221.0,59.3,1575.0,318.0,83.0,125.0,66.4,29.0,54.0,53.7,5.0,8.0,62.5,1.0,0.8,0.8,0.2,9.0,13.0,4.0,0.0,15.0,Matches,104,eng ENG,FW,25,17,1165.0,69.0,34.1,12.9,15,75.0,4,2,20.0,0,0.82,12.0,22.0,-10.0,-0.77,-0.25,16.2,22.7,-6.4,-0.49,0.06,Matches,79.0,eng ENG,FW,25.0,12.9,376.0,20.0,39.0,143.0,200.0,59.0,375.0,28.0,15.0,53.6,10.0,35.7,186.0,972.0,405.0,18.0,11.0,10.0,40.0,12.0,286.0,56.0,Matches,79.0,eng ENG,FW,25.0,12.9,2.0,30.0,9.0,30.0,2.32,0.7,0.03,0.11,11.8,0.0,1.0,1.0,5.8,5.0,0.17,-3.8,-4.0,Matches,79.0,eng ENG,FW,25.0,17.0,15.0,1165.0,12.9,2.0,1.0,3.0,1.0,1.0,1.0,3.0,0.0,5.8,5.0,0.8,5.9,18.0,15.0,56.0,0.15,0.08,0.23,0.08,0.15,0.45,0.06,0.51,0.39,0.45,Matches,Dominic Calvert-Lewin,S,25,152,163,England,Everton,9,11,11,15,15,7,17,9,2,6,11,7,5,14,13,14,14,13,15,10,14,14,12,5,16,6,15,15,16,14,14,16,14,16,15,16,14,6,10,3,14,1,1,3,1,3,2,2,1,2,2,3,12,13,5,11,12,14,15,13,1,1,5,1,1,1,1,10,8,8,14,11,12,20,187,71,8,20,77192500,7600,7800,6250,Mixed_Race,150,12,1997/3/16,11,4,97433.0,,29123128
284,Casemiro,Manchester Utd,1992,86.0,br BRA,MF,30.0,23.6,88.0,46.0,43.0,35.0,10.0,47.0,92.0,51.1,45.0,49.0,11.0,38.0,34.0,122.0,64.0,0.0,Matches,86.0,br BRA,MF,30.0,23.6,68.0,2.88,61.0,0.0,0.0,5.0,2.0,0.0,8.0,0.34,8.0,0.0,0.0,0.0,0.0,0.0,Matches,,,,,,,,,,,,,,,,,,,,,,,,,,,,,,,,,,,,,,,,,,,,,,,,,,,,,,,,86.0,br BRA,MF,30.0,23.6,7.0,2.0,0.0,48.0,24.0,1.0,19.0,34.0,46.0,0.0,1.0,0.0,205.0,56.0,30.0,65.1,Matches,86.0,br BRA,MF,30.0,23.6,1439.0,1408.0,24.0,22.0,12.0,13.0,19.0,1.0,0.0,0.0,0.0,0.0,1114.0,7.0,29.0,Matches,86.0,br BRA,MF,30.0,23.6,1114.0,1439.0,77.4,19801.0,7351.0,515.0,614.0,83.9,446.0,545.0,81.8,126.0,204.0,61.8,3.0,3.1,3.9,-0.1,28.0,136.0,23.0,4.0,152.0,Matches,112,br BRA,MF,30,28,2124.0,76.0,62.1,23.6,24,85.0,18,4,22.0,0,2.11,37.0,21.0,16.0,0.68,0.75,45.6,26.0,19.7,0.83,1.0,Matches,86.0,br BRA,MF,30.0,23.6,1757.0,110.0,531.0,949.0,292.0,24.0,1757.0,20.0,9.0,45.0,8.0,40.0,850.0,2828.0,1404.0,14.0,17.0,1.0,18.0,14.0,1103.0,34.0,Matches,86.0,br BRA,MF,30.0,23.6,4.0,34.0,11.0,32.4,1.44,0.47,0.12,0.36,21.6,0.0,0.0,0.0,3.4,3.4,0.1,0.6,0.6,Matches,86.0,br BRA,MF,30.0,28.0,24.0,2124.0,23.6,4.0,3.0,7.0,4.0,0.0,0.0,7.0,2.0,3.4,3.4,3.1,6.5,14.0,152.0,34.0,0.17,0.13,0.3,0.17,0.3,0.14,0.13,0.28,0.14,0.28,Matches,Casemiro,DM/M C,30,161,170,"Brazil,Spain",Manchester UFC,10,11,12,11,14,10,13,14,10,14,14,11,15,14,18,14,16,15,14,12,15,17,12,15,12,18,17,18,11,12,15,13,15,12,17,17,14,17,15,5,12,2,1,1,2,1,2,1,1,2,2,1,13,15,14,10,15,16,10,11,1,1,9,1,1,1,20,1,19,1,1,1,1,1,185,84,13,20,209616868,8050,8500,7600,Mixed_Race,161,13,1992/2/23,63,5,347975.0,,19061518
285,Matty Cash,Aston Villa,1997,87.0,pl POL,DF,24.0,20.2,55.0,32.0,36.0,15.0,4.0,26.0,37.0,70.3,11.0,20.0,5.0,15.0,26.0,81.0,43.0,0.0,Matches,87.0,pl POL,DF,24.0,20.2,28.0,1.38,25.0,0.0,1.0,0.0,1.0,1.0,3.0,0.15,2.0,0.0,0.0,0.0,0.0,1.0,Matches,,,,,,,,,,,,,,,,,,,,,,,,,,,,,,,,,,,,,,,,,,,,,,,,,,,,,,,,87.0,pl POL,DF,24.0,20.2,4.0,0.0,0.0,21.0,15.0,2.0,46.0,26.0,32.0,0.0,1.0,0.0,108.0,12.0,13.0,48.0,Matches,87.0,pl POL,DF,24.0,20.2,1006.0,809.0,194.0,18.0,2.0,6.0,46.0,176.0,0.0,0.0,0.0,0.0,777.0,3.0,24.0,Matches,87.0,pl POL,DF,24.0,20.2,777.0,1006.0,77.2,13672.0,4595.0,345.0,384.0,89.8,361.0,441.0,81.9,61.0,139.0,43.9,1.0,0.7,0.9,0.3,8.0,57.0,15.0,9.0,75.0,Matches,114,pl POL,DF,24,26,1820.0,70.0,53.2,20.2,20,85.0,15,6,21.0,1,1.46,28.0,29.0,-1.0,-0.05,-0.39,28.7,27.4,1.3,0.06,0.26,Matches,87.0,pl POL,DF,24.0,20.2,1215.0,76.0,423.0,545.0,258.0,11.0,1215.0,33.0,16.0,48.5,9.0,27.3,610.0,3143.0,1677.0,42.0,33.0,4.0,24.0,7.0,652.0,57.0,Matches,87.0,pl POL,DF,24.0,20.2,0.0,7.0,1.0,14.3,0.35,0.05,0.0,0.0,26.9,0.0,0.0,0.0,0.2,0.2,0.03,-0.2,-0.2,Matches,87.0,pl POL,DF,24.0,26.0,20.0,1820.0,20.2,0.0,1.0,1.0,0.0,0.0,0.0,4.0,0.0,0.2,0.2,0.7,0.9,42.0,75.0,57.0,0.0,0.05,0.05,0.0,0.05,0.01,0.04,0.05,0.01,0.05,Matches,Matty Cash,D/WB R,24,138,148,"Poland,England",Aston Villa,10,11,13,11,14,10,12,12,17,9,13,8,13,12,15,15,13,11,11,11,11,15,11,9,13,11,16,16,14,14,13,11,15,14,15,12,13,13,10,6,12,2,2,2,3,3,3,3,3,1,3,3,13,13,2,13,12,13,12,13,1,1,1,20,1,17,1,1,12,15,1,1,14,1,185,0,14,20,29282114,6900,6800,5500,Northern_European,134,5,1997/8/7,7,1,75395.0,,29147447
286,Timothy Castagne,Leicester City,1995,88.0,be BEL,DF,26.0,36.2,87.0,44.0,53.0,27.0,7.0,41.0,84.0,48.8,43.0,50.0,13.0,37.0,43.0,130.0,110.0,0.0,Matches,88.0,be BEL,DF,26.0,36.2,51.0,1.41,44.0,2.0,1.0,2.0,1.0,1.0,5.0,0.14,4.0,0.0,0.0,1.0,0.0,0.0,Matches,,,,,,,,,,,,,,,,,,,,,,,,,,,,,,,,,,,,,,,,,,,,,,,,,,,,,,,,88.0,be BEL,DF,26.0,36.2,3.0,0.0,0.0,25.0,15.0,6.0,58.0,43.0,44.0,0.0,2.0,0.0,202.0,55.0,62.0,47.0,Matches,88.0,be BEL,DF,26.0,36.2,1836.0,1545.0,287.0,17.0,3.0,2.0,58.0,270.0,0.0,0.0,0.0,0.0,1470.0,4.0,43.0,Matches,88.0,be BEL,DF,26.0,36.2,1470.0,1836.0,80.1,21125.0,8419.0,895.0,998.0,89.7,470.0,586.0,80.2,60.0,132.0,45.5,3.0,2.6,2.2,0.4,22.0,89.0,20.0,10.0,106.0,Matches,115,be BEL,DF,26,37,3254.0,88.0,95.1,36.2,36,89.0,33,1,45.0,1,0.92,49.0,63.0,-14.0,-0.39,1.24,48.4,60.0,-11.6,-0.32,0.3,Matches,88.0,be BEL,DF,26.0,36.2,2237.0,158.0,820.0,920.0,508.0,52.0,2237.0,31.0,12.0,38.7,14.0,45.2,989.0,4010.0,1994.0,39.0,23.0,5.0,32.0,17.0,1246.0,149.0,Matches,88.0,be BEL,DF,26.0,36.2,2.0,19.0,5.0,26.3,0.53,0.14,0.11,0.4,11.0,0.0,0.0,0.0,2.2,2.2,0.12,-0.2,-0.2,Matches,88.0,be BEL,DF,26.0,37.0,36.0,3254.0,36.2,2.0,3.0,5.0,2.0,0.0,0.0,3.0,0.0,2.2,2.2,2.6,4.8,39.0,106.0,149.0,0.06,0.08,0.14,0.06,0.14,0.06,0.07,0.13,0.06,0.13,Matches,Timothy Castagne,D/WB/M RL,26,145,152,Belgium,Leicester City,8,14,13,10,12,6,9,8,8,11,13,5,12,14,12,12,11,12,12,11,12,15,11,9,13,12,15,16,15,14,14,12,13,15,15,11,15,13,14,10,16,1,3,3,1,1,2,2,4,1,2,2,14,13,10,14,13,15,13,15,1,18,12,20,18,20,1,16,1,16,1,1,10,1,185,80,10,20,41754125,7250,7250,5500,Northern_European,128,3,1995/12/5,24,2,81194.0,,18074558
287,Trevoh Chalobah,Chelsea,1999,91.0,eng ENG,DF,23.0,17.9,31.0,20.0,22.0,6.0,3.0,24.0,35.0,68.6,11.0,17.0,7.0,10.0,24.0,55.0,56.0,1.0,Matches,91.0,eng ENG,DF,23.0,17.9,16.0,0.9,11.0,0.0,1.0,2.0,2.0,0.0,3.0,0.17,3.0,0.0,0.0,0.0,0.0,0.0,Matches,,,,,,,,,,,,,,,,,,,,,,,,,,,,,,,,,,,,,,,,,,,,,,,,,,,,,,,,91.0,eng ENG,DF,23.0,17.9,4.0,0.0,0.0,11.0,8.0,0.0,13.0,24.0,20.0,0.0,0.0,1.0,86.0,31.0,32.0,49.2,Matches,91.0,eng ENG,DF,23.0,17.9,1200.0,1132.0,66.0,23.0,0.0,4.0,13.0,43.0,0.0,0.0,0.0,0.0,1051.0,2.0,11.0,Matches,91.0,eng ENG,DF,23.0,17.9,1051.0,1200.0,87.6,18603.0,5316.0,419.0,467.0,89.7,551.0,594.0,92.8,70.0,107.0,65.4,0.0,0.3,0.3,-0.3,4.0,64.0,3.0,1.0,71.0,Matches,118,eng ENG,DF,23,25,1608.0,64.0,47.0,17.9,18,86.0,15,7,8.0,10,1.2,20.0,24.0,-4.0,-0.22,0.02,23.1,31.6,-8.5,-0.48,-0.75,Matches,91.0,eng ENG,DF,23.0,17.9,1369.0,135.0,602.0,604.0,167.0,23.0,1369.0,10.0,8.0,80.0,1.0,10.0,784.0,2679.0,1393.0,17.0,13.0,1.0,6.0,5.0,973.0,27.0,Matches,91.0,eng ENG,DF,23.0,17.9,0.0,9.0,2.0,22.2,0.5,0.11,0.0,0.0,9.6,0.0,0.0,0.0,0.9,0.9,0.1,-0.9,-0.9,Matches,91.0,eng ENG,DF,23.0,25.0,18.0,1608.0,17.9,0.0,0.0,0.0,0.0,0.0,0.0,4.0,0.0,0.9,0.9,0.3,1.2,17.0,71.0,27.0,0.0,0.0,0.0,0.0,0.0,0.05,0.02,0.06,0.05,0.06,Matches,Trevoh Chalobah,D/DM/M C,23,144,155,"England,Sierra Leone",Chelsea,6,10,11,8,14,10,13,9,6,13,12,6,14,13,10,13,13,15,14,12,14,13,12,8,8,14,15,15,15,11,14,15,15,15,14,14,15,3,15,5,16,3,3,2,4,1,2,1,4,2,2,3,11,12,7,12,9,14,15,17,1,8,20,12,5,10,19,1,17,6,1,1,1,1,192,83,13,20,34124769,7200,7150,5850,African_Caribbean,142,15,1999/7/5,0,0,52196.0,,28103591
288,Ben Chilwell,Chelsea,1996,94.0,eng ENG,DFMF,25.0,15.6,21.0,17.0,12.0,8.0,1.0,13.0,25.0,52.0,12.0,21.0,2.0,19.0,18.0,39.0,26.0,0.0,Matches,94.0,eng ENG,DFMF,25.0,15.6,39.0,2.49,19.0,17.0,0.0,1.0,2.0,0.0,4.0,0.26,2.0,1.0,0.0,0.0,1.0,0.0,Matches,,,,,,,,,,,,,,,,,,,,,,,,,,,,,,,,,,,,,,,,,,,,,,,,,,,,,,,,94.0,eng ENG,DFMF,25.0,15.6,3.0,0.0,0.0,13.0,23.0,3.0,92.0,18.0,17.0,1.0,0.0,0.0,68.0,25.0,20.0,55.6,Matches,94.0,eng ENG,DFMF,25.0,15.6,977.0,774.0,198.0,25.0,2.0,5.0,92.0,121.0,52.0,25.0,20.0,0.0,762.0,5.0,18.0,Matches,94.0,eng ENG,DFMF,25.0,15.6,762.0,977.0,78.0,10963.0,3238.0,469.0,507.0,92.5,223.0,284.0,78.5,42.0,123.0,34.1,2.0,2.2,2.4,-0.2,21.0,42.0,10.0,7.0,41.0,Matches,123,eng ENG,DFMF,25,23,1408.0,61.0,41.2,15.6,15,85.0,10,8,17.0,2,1.26,16.0,19.0,-3.0,-0.19,0.08,20.2,18.4,1.7,0.11,0.32,Matches,94.0,eng ENG,DFMF,25.0,15.6,1133.0,23.0,284.0,426.0,426.0,36.0,1133.0,23.0,8.0,34.8,12.0,52.2,629.0,3401.0,1852.0,43.0,36.0,8.0,25.0,18.0,722.0,131.0,Matches,94.0,eng ENG,DFMF,25.0,15.6,2.0,16.0,4.0,25.0,1.02,0.26,0.13,0.5,16.1,0.0,0.0,0.0,1.4,1.4,0.09,0.6,0.6,Matches,94.0,eng ENG,DFMF,25.0,23.0,15.0,1408.0,15.6,2.0,2.0,4.0,2.0,0.0,0.0,3.0,0.0,1.4,1.4,2.2,3.7,43.0,41.0,131.0,0.13,0.13,0.26,0.13,0.26,0.09,0.14,0.23,0.09,0.23,Matches,Ben Chilwell,D/WB L,25,158,165,"England,New Zealand",Chelsea,13,15,15,7,15,11,14,7,11,14,13,11,13,13,12,14,13,14,13,12,14,14,11,12,11,15,14,16,15,14,15,13,14,16,17,13,13,5,10,4,10,4,2,2,3,1,1,1,2,2,2,2,13,17,7,13,12,15,12,15,1,20,10,1,17,1,1,10,1,1,10,1,1,1,178,77,20,12,176883481,7894,7844,6244,Northern_European,157,2,1996/12/21,17,1,220384.0,,29128536
289,Ryan Christie,Bournemouth,1995,95.0,sct SCO,MFFW,27.0,20.4,34.0,22.0,10.0,23.0,1.0,14.0,50.0,28.0,36.0,16.0,4.0,12.0,26.0,60.0,20.0,0.0,Matches,95.0,sct SCO,MFFW,27.0,20.4,66.0,3.24,48.0,5.0,5.0,5.0,3.0,0.0,4.0,0.2,3.0,0.0,0.0,1.0,0.0,0.0,Matches,,,,,,,,,,,,,,,,,,,,,,,,,,,,,,,,,,,,,,,,,,,,,,,,,,,,,,,,95.0,sct SCO,MFFW,27.0,20.4,2.0,0.0,0.0,36.0,45.0,1.0,32.0,26.0,22.0,0.0,0.0,0.0,132.0,16.0,23.0,41.0,Matches,95.0,sct SCO,MFFW,27.0,20.4,651.0,621.0,28.0,3.0,6.0,7.0,32.0,4.0,20.0,11.0,5.0,0.0,521.0,2.0,16.0,Matches,95.0,sct SCO,MFFW,27.0,20.4,521.0,651.0,80.0,8356.0,2028.0,279.0,327.0,85.3,175.0,196.0,89.3,47.0,81.0,58.0,1.0,2.4,2.0,-1.4,30.0,43.0,19.0,2.0,71.0,Matches,124,sct SCO,MFFW,27,32,1834.0,57.0,53.6,20.4,22,74.0,5,10,20.0,6,1.09,19.0,35.0,-16.0,-0.79,0.24,21.1,30.7,-9.6,-0.47,0.42,Matches,95.0,sct SCO,MFFW,27.0,20.4,940.0,39.0,187.0,421.0,350.0,61.0,940.0,86.0,37.0,43.0,42.0,48.8,559.0,3396.0,1462.0,39.0,34.0,13.0,49.0,33.0,592.0,71.0,Matches,95.0,sct SCO,MFFW,27.0,20.4,1.0,33.0,9.0,27.3,1.62,0.44,0.03,0.11,14.0,0.0,0.0,0.0,2.7,2.7,0.08,-1.7,-1.7,Matches,95.0,sct SCO,MFFW,27.0,32.0,22.0,1834.0,20.4,1.0,1.0,2.0,1.0,0.0,0.0,2.0,0.0,2.7,2.7,2.4,5.1,39.0,71.0,71.0,0.05,0.05,0.1,0.05,0.1,0.13,0.12,0.25,0.13,0.25,Matches,Ryan Christie,M/AM RLC,27,139,150,Scotland,AFC Bournemouth,11,12,14,13,14,12,5,14,1,5,13,11,7,15,10,15,7,13,11,16,13,12,16,8,16,9,12,15,14,14,13,9,15,14,14,11,15,6,14,6,10,2,4,3,2,2,1,1,3,3,4,1,10,14,8,14,10,14,14,13,1,1,1,1,1,1,1,15,16,15,16,20,20,9,178,74,20,10,38141386,6949,7099,5999,Northern_European,137,1,1995/2/22,31,4,40597.0,,61042900
290,Nathaniel Clyne,Crystal Palace,1991,98.0,eng ENG,DF,31.0,18.2,27.0,16.0,13.0,9.0,5.0,14.0,23.0,60.9,9.0,22.0,4.0,18.0,19.0,46.0,34.0,0.0,Matches,98.0,eng ENG,DF,31.0,18.2,18.0,0.99,16.0,1.0,0.0,0.0,1.0,0.0,0.0,0.0,0.0,0.0,0.0,0.0,0.0,0.0,Matches,,,,,,,,,,,,,,,,,,,,,,,,,,,,,,,,,,,,,,,,,,,,,,,,,,,,,,,,98.0,eng ENG,DF,31.0,18.2,3.0,0.0,0.0,10.0,8.0,0.0,21.0,19.0,16.0,0.0,0.0,0.0,81.0,6.0,18.0,25.0,Matches,98.0,eng ENG,DF,31.0,18.2,832.0,674.0,156.0,7.0,0.0,3.0,21.0,149.0,0.0,0.0,0.0,0.0,654.0,2.0,12.0,Matches,98.0,eng ENG,DF,31.0,18.2,654.0,832.0,78.6,10205.0,3887.0,341.0,386.0,88.3,283.0,346.0,81.8,24.0,73.0,32.9,0.0,0.7,0.6,-0.7,7.0,51.0,6.0,5.0,52.0,Matches,127,eng ENG,DF,31,22,1640.0,75.0,48.0,18.2,19,84.0,14,3,17.0,8,0.77,13.0,23.0,-10.0,-0.55,-0.6,15.7,25.7,-10.1,-0.55,-0.62,Matches,98.0,eng ENG,DF,31.0,18.2,971.0,44.0,313.0,475.0,186.0,3.0,971.0,12.0,5.0,41.7,5.0,41.7,423.0,1778.0,896.0,14.0,10.0,1.0,12.0,3.0,531.0,29.0,Matches,98.0,eng ENG,DF,31.0,18.2,0.0,0.0,0.0,,0.0,0.0,,,,0.0,0.0,0.0,0.0,0.0,,0.0,0.0,Matches,98.0,eng ENG,DF,31.0,22.0,19.0,1640.0,18.2,0.0,0.0,0.0,0.0,0.0,0.0,3.0,0.0,0.0,0.0,0.7,0.7,14.0,52.0,29.0,0.0,0.0,0.0,0.0,0.0,0.0,0.04,0.04,0.0,0.04,Matches,Nathaniel Clyne,D/WB RL,31,129,150,England,Crystal Palace,5,11,10,5,13,6,9,4,11,14,12,5,15,13,13,14,14,13,15,10,12,12,8,9,12,14,15,16,13,13,13,9,12,14,15,12,14,9,14,14,11,3,1,3,2,1,1,3,2,2,3,4,14,12,8,14,13,14,12,13,1,15,1,20,11,17,1,1,1,1,1,1,1,1,175,67,9,20,4316222,6449,6449,5199,African_Caribbean,128,16,1991/4/5,14,0,81194.0,,28019851
291,Conor Coady,Everton,1993,99.0,eng ENG,DF,29.0,23.3,14.0,9.0,8.0,6.0,0.0,7.0,15.0,46.7,8.0,21.0,17.0,4.0,14.0,28.0,88.0,3.0,Matches,99.0,eng ENG,DF,29.0,23.3,16.0,0.69,14.0,0.0,0.0,1.0,1.0,0.0,1.0,0.04,1.0,0.0,0.0,0.0,0.0,0.0,Matches,,,,,,,,,,,,,,,,,,,,,,,,,,,,,,,,,,,,,,,,,,,,,,,,,,,,,,,,99.0,eng ENG,DF,29.0,23.3,2.0,0.0,0.0,11.0,13.0,2.0,1.0,14.0,9.0,0.0,0.0,0.0,92.0,25.0,24.0,51.0,Matches,99.0,eng ENG,DF,29.0,23.3,1209.0,1169.0,35.0,31.0,1.0,10.0,1.0,3.0,0.0,0.0,0.0,0.0,1025.0,5.0,1.0,Matches,99.0,eng ENG,DF,29.0,23.3,1025.0,1209.0,84.8,21731.0,8337.0,284.0,302.0,94.0,578.0,622.0,92.9,155.0,267.0,58.1,1.0,0.3,0.5,0.7,4.0,73.0,3.0,1.0,43.0,Matches,129,eng ENG,DF,29,24,2096.0,87.0,61.3,23.3,23,90.0,22,1,36.0,11,1.0,16.0,28.0,-12.0,-0.52,0.23,24.2,36.0,-11.8,-0.51,0.08,Matches,99.0,eng ENG,DF,29.0,23.3,1363.0,238.0,795.0,547.0,29.0,10.0,1363.0,3.0,0.0,0.0,2.0,66.7,882.0,4154.0,2414.0,4.0,4.0,0.0,6.0,2.0,984.0,1.0,Matches,99.0,eng ENG,DF,29.0,23.3,1.0,4.0,2.0,50.0,0.17,0.09,0.25,0.5,8.5,0.0,0.0,0.0,0.8,0.8,0.21,0.2,0.2,Matches,99.0,eng ENG,DF,29.0,24.0,23.0,2096.0,23.3,1.0,1.0,2.0,1.0,0.0,0.0,2.0,0.0,0.8,0.8,0.3,1.2,4.0,43.0,1.0,0.04,0.04,0.09,0.04,0.09,0.04,0.01,0.05,0.04,0.05,Matches,Conor Coady,D C,29,137,144,England,Wolverhampton Wanderers,5,7,11,9,13,7,14,9,8,13,15,10,13,15,15,13,16,15,14,15,13,17,6,18,12,14,14,16,12,13,14,13,15,12,14,13,16,13,14,4,15,2,2,3,1,2,3,1,2,4,2,2,15,16,8,14,16,16,16,11,1,1,20,10,1,1,10,1,10,1,1,1,1,1,186,80,9,20,43061932,7000,7200,5750,Northern_European,137,5,1993/2/25,10,1,69595.0,Everton,28047452
292,Nathan Collins,Wolves,2001,102.0,ie IRL,DF,21.0,20.2,27.0,15.0,19.0,8.0,0.0,15.0,24.0,62.5,9.0,35.0,28.0,7.0,21.0,48.0,84.0,0.0,Matches,102.0,ie IRL,DF,21.0,20.2,10.0,0.5,7.0,0.0,1.0,0.0,2.0,0.0,0.0,0.0,0.0,0.0,0.0,0.0,0.0,0.0,Matches,,,,,,,,,,,,,,,,,,,,,,,,,,,,,,,,,,,,,,,,,,,,,,,,,,,,,,,,102.0,ie IRL,DF,21.0,20.2,2.0,1.0,0.0,17.0,9.0,1.0,0.0,21.0,15.0,0.0,0.0,0.0,96.0,37.0,31.0,54.4,Matches,102.0,ie IRL,DF,21.0,20.2,1138.0,1112.0,23.0,17.0,0.0,9.0,0.0,6.0,0.0,0.0,0.0,0.0,1001.0,3.0,5.0,Matches,102.0,ie IRL,DF,21.0,20.2,1001.0,1138.0,88.0,20045.0,6918.0,304.0,332.0,91.6,566.0,610.0,92.8,114.0,168.0,67.9,0.0,0.1,0.2,-0.1,2.0,68.0,2.0,0.0,64.0,Matches,132,ie IRL,DF,21,26,1814.0,70.0,53.0,20.2,19,87.0,18,7,23.0,9,1.04,16.0,36.0,-20.0,-0.99,-0.6,21.5,32.4,-10.9,-0.54,0.14,Matches,102.0,ie IRL,DF,21.0,20.2,1339.0,208.0,801.0,500.0,45.0,13.0,1339.0,8.0,7.0,87.5,0.0,0.0,724.0,3470.0,1799.0,11.0,9.0,2.0,9.0,8.0,922.0,5.0,Matches,102.0,ie IRL,DF,21.0,20.2,0.0,3.0,0.0,0.0,0.15,0.0,0.0,,9.0,0.0,0.0,0.0,0.2,0.2,0.08,-0.2,-0.2,Matches,102.0,ie IRL,DF,21.0,26.0,19.0,1814.0,20.2,0.0,0.0,0.0,0.0,0.0,0.0,2.0,1.0,0.2,0.2,0.1,0.3,11.0,64.0,5.0,0.0,0.0,0.0,0.0,0.0,0.01,0.0,0.02,0.01,0.02,Matches,Nathan Collins,D C,21,133,-8,Republic of Ireland,Wolverhampton Wanderers,4,6,9,3,11,5,15,4,6,14,11,5,15,11,13,14,17,15,14,10,13,14,4,13,3,14,15,15,13,11,12,15,15,14,14,14,15,7,14,4,16,3,1,1,3,1,2,2,2,2,3,3,11,16,4,10,11,16,14,7,1,1,20,14,1,10,1,1,1,1,1,1,1,1,196,0,8,20,93518337,6650,6650,5000,Northern_European,133,2,2001/4/30,6,1,34798.0,,28117372
293,Levi Colwill,Brighton,2003,103.0,eng ENG,DF,19.0,13.6,8.0,7.0,4.0,4.0,0.0,4.0,9.0,44.4,5.0,5.0,3.0,2.0,15.0,23.0,37.0,1.0,Matches,103.0,eng ENG,DF,19.0,13.6,18.0,1.33,16.0,1.0,0.0,1.0,0.0,0.0,2.0,0.15,2.0,0.0,0.0,0.0,0.0,0.0,Matches,,,,,,,,,,,,,,,,,,,,,,,,,,,,,,,,,,,,,,,,,,,,,,,,,,,,,,,,103.0,eng ENG,DF,19.0,13.6,1.0,0.0,0.0,8.0,10.0,0.0,1.0,15.0,7.0,0.0,0.0,0.0,74.0,45.0,18.0,71.4,Matches,103.0,eng ENG,DF,19.0,13.6,1165.0,1096.0,64.0,27.0,2.0,1.0,1.0,11.0,0.0,0.0,0.0,0.0,1027.0,5.0,6.0,Matches,103.0,eng ENG,DF,19.0,13.6,1027.0,1165.0,88.2,17912.0,7475.0,431.0,468.0,92.1,501.0,552.0,90.8,75.0,106.0,70.8,2.0,0.5,0.3,1.5,7.0,78.0,3.0,0.0,70.0,Matches,133,eng ENG,DF,19,17,1220.0,72.0,35.7,13.6,13,88.0,11,4,19.0,11,1.71,29.0,21.0,8.0,0.59,0.14,26.3,22.3,4.1,0.3,-0.48,Matches,103.0,eng ENG,DF,19.0,13.6,1263.0,144.0,569.0,646.0,51.0,11.0,1263.0,1.0,1.0,100.0,0.0,0.0,845.0,4646.0,2952.0,16.0,10.0,0.0,7.0,4.0,921.0,3.0,Matches,103.0,eng ENG,DF,19.0,13.6,0.0,8.0,0.0,0.0,0.59,0.0,0.0,,7.0,0.0,0.0,0.0,1.4,1.4,0.18,-1.4,-1.4,Matches,103.0,eng ENG,DF,19.0,17.0,13.0,1220.0,13.6,0.0,2.0,2.0,0.0,0.0,0.0,1.0,0.0,1.4,1.4,0.5,1.9,16.0,70.0,3.0,0.0,0.15,0.15,0.0,0.15,0.1,0.04,0.14,0.1,0.14,Matches,Levi Colwill,D LC,19,126,-8,England,Chelsea,6,7,11,5,10,2,12,2,8,13,12,6,13,10,10,11,8,13,11,8,13,1,5,13,11,13,10,11,15,12,15,15,14,15,13,12,11,6,11,7,15,4,4,1,2,1,2,1,4,3,1,3,19,12,5,10,13,11,14,20,1,16,20,1,14,1,1,1,1,1,1,1,1,1,187,88,20,10,67507190,6285,6285,3235,African_Caribbean,120,12,2003/2/26,0,0,17399.0,Brighton & Hove Albion,28124573
294,Lewis Cook,Bournemouth,1997,104.0,eng ENG,MF,25.0,19.1,37.0,22.0,10.0,22.0,5.0,18.0,44.0,40.9,26.0,29.0,10.0,19.0,23.0,60.0,31.0,0.0,Matches,104.0,eng ENG,MF,25.0,19.1,39.0,2.04,27.0,8.0,0.0,0.0,1.0,3.0,4.0,0.21,2.0,1.0,0.0,0.0,0.0,1.0,Matches,,,,,,,,,,,,,,,,,,,,,,,,,,,,,,,,,,,,,,,,,,,,,,,,,,,,,,,,104.0,eng ENG,MF,25.0,19.1,4.0,0.0,0.0,15.0,10.0,0.0,45.0,23.0,22.0,0.0,0.0,0.0,129.0,7.0,10.0,41.2,Matches,104.0,eng ENG,MF,25.0,19.1,751.0,692.0,56.0,32.0,1.0,3.0,45.0,0.0,15.0,15.0,0.0,0.0,593.0,3.0,20.0,Matches,104.0,eng ENG,MF,25.0,19.1,593.0,751.0,79.0,9922.0,3136.0,291.0,330.0,88.2,238.0,274.0,86.9,48.0,93.0,51.6,2.0,2.5,2.3,-0.5,24.0,55.0,14.0,9.0,63.0,Matches,134,eng ENG,MF,25,28,1720.0,61.0,50.3,19.1,18,84.0,14,10,21.0,5,0.89,18.0,39.0,-21.0,-1.1,-0.41,15.8,31.7,-15.9,-0.83,-0.34,Matches,104.0,eng ENG,MF,25.0,19.1,935.0,67.0,290.0,472.0,184.0,9.0,935.0,20.0,8.0,40.0,10.0,50.0,427.0,2210.0,819.0,9.0,18.0,1.0,15.0,16.0,517.0,10.0,Matches,104.0,eng ENG,MF,25.0,19.1,0.0,6.0,0.0,0.0,0.31,0.0,0.0,,28.7,2.0,0.0,0.0,0.2,0.2,0.04,-0.2,-0.2,Matches,104.0,eng ENG,MF,25.0,28.0,18.0,1720.0,19.1,0.0,2.0,2.0,0.0,0.0,0.0,4.0,0.0,0.2,0.2,2.5,2.7,9.0,63.0,10.0,0.0,0.1,0.1,0.0,0.1,0.01,0.13,0.14,0.01,0.14,Matches,Lewis Cook,DM/M C,25,130,169,England,AFC Bournemouth,9,10,12,10,14,5,6,9,3,7,15,7,14,14,14,13,14,14,12,15,12,15,13,14,12,12,15,14,13,14,14,8,16,13,14,13,14,8,13,2,13,3,2,1,1,2,1,1,2,4,1,3,13,13,2,13,12,16,12,13,1,1,1,1,1,1,20,1,20,1,1,12,1,1,176,71,10,20,13093423,6499,6499,5249,Northern_European,128,6,1997/2/3,1,0,40597.0,,29127852
295,Steve Cook,Nott'ham Forest,1991,105.0,eng ENG,DF,31.0,10.6,8.0,4.0,4.0,4.0,0.0,5.0,7.0,71.4,2.0,16.0,11.0,5.0,12.0,20.0,51.0,0.0,Matches,105.0,eng ENG,DF,31.0,10.6,6.0,0.56,6.0,0.0,0.0,0.0,0.0,0.0,0.0,0.0,0.0,0.0,0.0,0.0,0.0,0.0,Matches,,,,,,,,,,,,,,,,,,,,,,,,,,,,,,,,,,,,,,,,,,,,,,,,,,,,,,,,105.0,eng ENG,DF,31.0,10.6,4.0,0.0,0.0,5.0,2.0,0.0,1.0,12.0,4.0,0.0,1.0,0.0,35.0,27.0,10.0,73.0,Matches,105.0,eng ENG,DF,31.0,10.6,459.0,445.0,13.0,11.0,0.0,6.0,1.0,2.0,0.0,0.0,0.0,0.0,369.0,1.0,2.0,Matches,105.0,eng ENG,DF,31.0,10.6,369.0,459.0,80.4,7884.0,2511.0,80.0,99.0,80.8,234.0,261.0,89.7,51.0,91.0,56.0,0.0,0.6,0.6,-0.6,3.0,18.0,2.0,1.0,19.0,Matches,135,eng ENG,DF,31,12,957.0,80.0,28.0,10.6,11,86.0,8,1,12.0,7,0.83,7.0,21.0,-14.0,-1.32,-0.73,10.5,14.9,-4.5,-0.42,0.33,Matches,105.0,eng ENG,DF,31.0,10.6,559.0,100.0,321.0,220.0,19.0,10.0,559.0,1.0,1.0,100.0,0.0,0.0,284.0,1293.0,577.0,1.0,3.0,0.0,3.0,2.0,350.0,0.0,Matches,105.0,eng ENG,DF,31.0,10.6,0.0,3.0,0.0,0.0,0.28,0.0,0.0,,14.2,0.0,0.0,0.0,0.1,0.1,0.05,-0.1,-0.1,Matches,105.0,eng ENG,DF,31.0,12.0,11.0,957.0,10.6,0.0,0.0,0.0,0.0,0.0,0.0,4.0,0.0,0.1,0.1,0.6,0.7,1.0,19.0,0.0,0.0,0.0,0.0,0.0,0.0,0.01,0.05,0.07,0.01,0.07,Matches,Steve Cook,D C,31,127,142,England,Nottingham Forest,5,9,7,8,12,6,14,6,14,14,11,4,14,12,12,13,14,12,12,8,13,14,6,16,7,15,15,15,11,11,13,14,16,11,13,14,14,10,13,4,12,4,1,1,1,4,1,2,1,2,3,2,12,14,8,13,12,13,16,11,1,1,20,10,1,1,1,1,1,1,1,1,1,1,186,82,8,20,5393599,6345,6345,4745,Northern_European,127,6,1991/4/19,0,0,34798.0,,28014634
296,Liam Cooper,Leeds United,1991,106.0,sct SCO,DF,30.0,15.8,38.0,23.0,27.0,9.0,2.0,23.0,36.0,63.9,13.0,16.0,8.0,8.0,34.0,72.0,57.0,3.0,Matches,106.0,sct SCO,DF,30.0,15.8,16.0,1.01,13.0,1.0,0.0,2.0,0.0,0.0,3.0,0.19,3.0,0.0,0.0,0.0,0.0,0.0,Matches,,,,,,,,,,,,,,,,,,,,,,,,,,,,,,,,,,,,,,,,,,,,,,,,,,,,,,,,106.0,sct SCO,DF,30.0,15.8,5.0,0.0,0.0,12.0,10.0,0.0,1.0,34.0,23.0,0.0,0.0,0.0,107.0,56.0,32.0,63.6,Matches,106.0,sct SCO,DF,30.0,15.8,789.0,756.0,33.0,29.0,0.0,8.0,1.0,4.0,0.0,0.0,0.0,0.0,620.0,0.0,3.0,Matches,106.0,sct SCO,DF,30.0,15.8,620.0,789.0,78.6,11491.0,4568.0,241.0,274.0,88.0,318.0,376.0,84.6,52.0,117.0,44.4,0.0,0.7,0.3,-0.7,5.0,49.0,1.0,1.0,47.0,Matches,136,sct SCO,DF,30,18,1426.0,79.0,41.7,15.8,16,85.0,14,2,31.0,7,0.56,20.0,32.0,-12.0,-0.76,0.06,20.9,26.3,-5.4,-0.34,0.31,Matches,106.0,sct SCO,DF,30.0,15.8,970.0,103.0,499.0,440.0,37.0,21.0,970.0,4.0,1.0,25.0,1.0,25.0,477.0,2172.0,913.0,3.0,3.0,1.0,9.0,1.0,501.0,2.0,Matches,106.0,sct SCO,DF,30.0,15.8,1.0,10.0,2.0,20.0,0.63,0.13,0.1,0.5,9.5,0.0,0.0,0.0,1.0,1.0,0.11,0.0,0.0,Matches,106.0,sct SCO,DF,30.0,18.0,16.0,1426.0,15.8,1.0,0.0,1.0,1.0,0.0,0.0,5.0,0.0,1.0,1.0,0.7,1.7,3.0,47.0,2.0,0.06,0.0,0.06,0.06,0.06,0.06,0.05,0.11,0.06,0.11,Matches,Liam Cooper,D C,30,134,134,"Scotland,England",Leeds United,2,6,7,5,10,3,16,5,9,14,12,8,15,10,14,14,17,12,13,11,14,15,6,17,8,15,15,15,11,10,12,15,14,13,15,14,14,10,13,11,10,3,3,3,1,2,3,2,2,2,3,3,12,10,2,12,13,17,12,18,1,13,20,1,1,1,1,1,1,1,1,1,1,1,188,86,20,7,14363277,6700,6700,5350,Northern_European,134,5,1991/8/30,14,0,40597.0,,28020241
297,Diego Costa,Wolves,1988,108.0,es ESP,FW,33.0,13.8,3.0,1.0,3.0,0.0,0.0,2.0,9.0,22.2,7.0,6.0,1.0,5.0,2.0,5.0,17.0,0.0,Matches,108.0,es ESP,FW,33.0,13.8,23.0,1.67,15.0,0.0,3.0,3.0,2.0,0.0,1.0,0.07,1.0,0.0,0.0,0.0,0.0,0.0,Matches,,,,,,,,,,,,,,,,,,,,,,,,,,,,,,,,,,,,,,,,,,,,,,,,,,,,,,,,108.0,es ESP,FW,33.0,13.8,5.0,1.0,0.0,29.0,10.0,16.0,6.0,2.0,1.0,0.0,0.0,0.0,25.0,30.0,59.0,33.7,Matches,108.0,es ESP,FW,33.0,13.8,221.0,204.0,17.0,1.0,1.0,0.0,6.0,0.0,1.0,0.0,0.0,0.0,158.0,0.0,13.0,Matches,108.0,es ESP,FW,33.0,13.8,158.0,221.0,71.5,1870.0,312.0,93.0,118.0,78.8,45.0,56.0,80.4,2.0,5.0,40.0,0.0,0.7,0.7,-0.7,11.0,9.0,4.0,0.0,13.0,Matches,138,es ESP,FW,33,23,1241.0,54.0,36.3,13.8,16,68.0,1,7,22.0,2,1.26,15.0,17.0,-2.0,-0.15,0.89,11.8,21.1,-9.3,-0.67,-0.11,Matches,108.0,es ESP,FW,33.0,13.8,335.0,19.0,37.0,140.0,161.0,59.0,335.0,10.0,5.0,50.0,5.0,50.0,180.0,1019.0,342.0,19.0,9.0,11.0,23.0,26.0,245.0,60.0,Matches,108.0,es ESP,FW,33.0,13.8,1.0,28.0,14.0,50.0,2.03,1.02,0.04,0.07,12.0,0.0,0.0,0.0,3.2,3.2,0.11,-2.2,-2.2,Matches,108.0,es ESP,FW,33.0,23.0,16.0,1241.0,13.8,1.0,0.0,1.0,1.0,0.0,0.0,5.0,1.0,3.2,3.2,0.7,3.9,19.0,13.0,60.0,0.07,0.0,0.07,0.07,0.07,0.23,0.05,0.28,0.23,0.28,Matches,Diego Costa,S,33,142,168,"Spain,Brazil",Wolverhampton Wanderers,11,12,11,14,14,11,15,11,7,5,12,15,9,13,19,13,19,14,12,13,15,19,15,12,16,6,16,17,12,11,12,14,9,13,11,15,11,18,16,14,13,2,4,3,3,2,2,3,1,1,1,1,16,17,13,12,15,14,5,3,1,1,1,1,1,1,1,1,1,1,9,13,12,20,186,87,15,20,8874269,7100,7100,6250,Native_American,142,12,1988/10/7,24,10,69595.0,,55002038
298,Vladimír Coufal,West Ham,1992,109.0,cz CZE,DF,29.0,23.7,58.0,31.0,37.0,15.0,6.0,36.0,51.0,70.6,15.0,24.0,6.0,18.0,38.0,96.0,70.0,0.0,Matches,109.0,cz CZE,DF,29.0,23.7,52.0,2.19,36.0,13.0,0.0,1.0,2.0,0.0,3.0,0.13,2.0,1.0,0.0,0.0,0.0,0.0,Matches,,,,,,,,,,,,,,,,,,,,,,,,,,,,,,,,,,,,,,,,,,,,,,,,,,,,,,,,109.0,cz CZE,DF,29.0,23.7,5.0,0.0,0.0,30.0,21.0,1.0,113.0,38.0,31.0,0.0,0.0,0.0,150.0,40.0,22.0,64.5,Matches,109.0,cz CZE,DF,29.0,23.7,1174.0,907.0,260.0,16.0,0.0,0.0,113.0,244.0,0.0,0.0,0.0,0.0,730.0,7.0,47.0,Matches,109.0,cz CZE,DF,29.0,23.7,730.0,1174.0,62.2,12756.0,6471.0,347.0,421.0,82.4,279.0,438.0,63.7,83.0,226.0,36.7,1.0,2.5,1.7,-1.5,26.0,68.0,19.0,14.0,82.0,Matches,139,cz CZE,DF,29,27,2136.0,79.0,62.5,23.7,24,85.0,18,3,33.0,7,1.0,27.0,35.0,-8.0,-0.34,0.01,31.1,30.6,0.5,0.02,0.33,Matches,109.0,cz CZE,DF,29.0,23.7,1433.0,104.0,435.0,580.0,424.0,21.0,1433.0,17.0,3.0,17.6,6.0,35.3,578.0,3284.0,1710.0,53.0,33.0,2.0,25.0,21.0,665.0,109.0,Matches,109.0,cz CZE,DF,29.0,23.7,0.0,6.0,0.0,0.0,0.25,0.0,0.0,,25.7,0.0,0.0,0.0,0.3,0.3,0.04,-0.3,-0.3,Matches,109.0,cz CZE,DF,29.0,27.0,24.0,2136.0,23.7,0.0,1.0,1.0,0.0,0.0,0.0,5.0,0.0,0.3,0.3,2.5,2.7,53.0,82.0,109.0,0.0,0.04,0.04,0.0,0.04,0.01,0.1,0.11,0.01,0.11,Matches,Vladimír Coufal,D/WB R,29,140,140,Czech Republic,West Ham United,7,14,9,10,11,8,15,10,15,14,10,12,16,10,14,11,17,11,15,9,13,17,6,12,11,14,14,16,14,13,16,10,14,14,16,14,17,12,16,7,12,3,1,4,2,1,3,2,3,4,3,2,9,13,10,13,16,12,9,8,1,1,13,20,1,18,1,1,1,12,1,1,1,1,175,76,8,20,34162464,7000,6500,5500,Northern_European,140,1,1992/8/22,30,1,63795.0,,25038517
299,Aaron Cresswell,West Ham,1989,113.0,eng ENG,DF,32.0,24.8,21.0,11.0,12.0,7.0,2.0,12.0,31.0,38.7,19.0,21.0,11.0,10.0,27.0,48.0,56.0,0.0,Matches,113.0,eng ENG,DF,32.0,24.8,73.0,2.94,43.0,27.0,0.0,2.0,1.0,0.0,1.0,0.04,0.0,1.0,0.0,0.0,0.0,0.0,Matches,,,,,,,,,,,,,,,,,,,,,,,,,,,,,,,,,,,,,,,,,,,,,,,,,,,,,,,,113.0,eng ENG,DF,32.0,24.8,3.0,0.0,0.0,9.0,9.0,2.0,133.0,27.0,11.0,0.0,0.0,0.0,120.0,28.0,27.0,50.9,Matches,113.0,eng ENG,DF,32.0,24.8,1448.0,1157.0,288.0,40.0,1.0,5.0,133.0,192.0,56.0,5.0,44.0,1.0,1127.0,3.0,35.0,Matches,113.0,eng ENG,DF,32.0,24.8,1127.0,1448.0,77.8,18285.0,8587.0,626.0,670.0,93.4,387.0,497.0,77.9,100.0,206.0,48.5,1.0,3.7,2.9,-2.7,40.0,91.0,28.0,15.0,145.0,Matches,145,eng ENG,DF,32,28,2235.0,80.0,65.4,24.8,24,88.0,20,4,29.0,8,1.11,26.0,32.0,-6.0,-0.24,0.29,32.3,32.9,-0.6,-0.03,0.22,Matches,113.0,eng ENG,DF,32.0,24.8,1607.0,97.0,507.0,668.0,438.0,13.0,1607.0,7.0,2.0,28.6,4.0,57.1,766.0,3497.0,1751.0,35.0,26.0,1.0,6.0,6.0,960.0,82.0,Matches,113.0,eng ENG,DF,32.0,24.8,0.0,9.0,1.0,11.1,0.36,0.04,0.0,0.0,22.5,4.0,0.0,0.0,0.3,0.3,0.04,-0.3,-0.3,Matches,113.0,eng ENG,DF,32.0,28.0,24.0,2235.0,24.8,0.0,1.0,1.0,0.0,0.0,0.0,3.0,0.0,0.3,0.3,3.7,4.0,35.0,145.0,82.0,0.0,0.04,0.04,0.0,0.04,0.01,0.15,0.16,0.01,0.16,Matches,Aaron Cresswell,D/WB LC,32,142,145,England,West Ham United,16,16,13,8,13,16,11,14,11,13,12,13,13,13,8,14,13,15,14,12,15,13,12,12,13,14,16,16,14,13,13,8,15,14,15,10,18,9,14,11,13,1,2,1,1,1,4,1,4,3,2,3,12,16,4,14,11,14,14,16,1,20,18,1,16,1,1,8,1,1,4,1,1,1,170,66,20,7,13483494,7096,7096,5496,Northern_European,143,1,1989/12/15,3,0,57996.0,,28005949
300,Marc Cucurella,Chelsea,1998,114.0,es ESP,DF,24.0,18.6,66.0,33.0,40.0,15.0,11.0,30.0,60.0,50.0,30.0,28.0,8.0,20.0,16.0,82.0,48.0,1.0,Matches,114.0,es ESP,DF,24.0,18.6,27.0,1.46,21.0,6.0,0.0,0.0,0.0,0.0,3.0,0.16,2.0,1.0,0.0,0.0,0.0,0.0,Matches,,,,,,,,,,,,,,,,,,,,,,,,,,,,,,,,,,,,,,,,,,,,,,,,,,,,,,,,114.0,es ESP,DF,24.0,18.6,4.0,0.0,0.0,16.0,21.0,1.0,44.0,16.0,33.0,0.0,0.0,0.0,120.0,16.0,13.0,55.2,Matches,114.0,es ESP,DF,24.0,18.6,1293.0,1093.0,192.0,28.0,0.0,2.0,44.0,151.0,13.0,8.0,3.0,0.0,1090.0,8.0,26.0,Matches,114.0,es ESP,DF,24.0,18.6,1090.0,1293.0,84.3,16587.0,5116.0,600.0,647.0,92.7,396.0,453.0,87.4,59.0,110.0,53.6,2.0,0.6,0.9,1.4,11.0,77.0,12.0,6.0,73.0,Matches,146,es ESP,DF,24,24,1671.0,70.0,48.9,18.6,21,77.0,10,3,15.0,3,1.21,17.0,20.0,-3.0,-0.16,0.15,23.6,26.0,-2.4,-0.13,-0.1,Matches,114.0,es ESP,DF,24.0,18.6,1490.0,63.0,470.0,672.0,358.0,12.0,1490.0,14.0,5.0,35.7,6.0,42.9,787.0,3205.0,1797.0,30.0,20.0,2.0,14.0,6.0,906.0,65.0,Matches,114.0,es ESP,DF,24.0,18.6,0.0,7.0,0.0,0.0,0.38,0.0,0.0,,19.7,0.0,0.0,0.0,0.4,0.4,0.06,-0.4,-0.4,Matches,114.0,es ESP,DF,24.0,24.0,21.0,1671.0,18.6,0.0,2.0,2.0,0.0,0.0,0.0,4.0,0.0,0.4,0.4,0.6,1.0,30.0,73.0,65.0,0.0,0.11,0.11,0.0,0.11,0.02,0.03,0.06,0.02,0.06,Matches,Marc Cucurella,D/WB/M LC,24,153,164,Spain,Chelsea,10,13,11,9,14,7,6,8,12,12,14,7,14,14,15,16,14,15,14,14,15,18,10,13,15,15,14,14,16,15,14,8,13,13,15,12,14,9,14,8,15,3,2,3,3,3,1,3,1,3,1,3,11,14,5,13,14,15,13,15,1,19,15,1,19,1,1,20,1,1,14,1,1,1,172,68,20,8,83672958,7650,7650,6000,Mediterranean_Hispanic,144,6,1998/7/22,1,0,127591.0,,67215284
301,Matheus Cunha,Wolves,1999,115.0,br BRA,FW,23.0,10.7,7.0,4.0,0.0,5.0,2.0,2.0,10.0,20.0,8.0,15.0,3.0,12.0,9.0,16.0,11.0,0.0,Matches,115.0,br BRA,FW,23.0,10.7,21.0,1.96,16.0,1.0,1.0,1.0,2.0,0.0,0.0,0.0,0.0,0.0,0.0,0.0,0.0,0.0,Matches,,,,,,,,,,,,,,,,,,,,,,,,,,,,,,,,,,,,,,,,,,,,,,,,,,,,,,,,115.0,br BRA,FW,23.0,10.7,1.0,0.0,0.0,20.0,21.0,3.0,8.0,9.0,4.0,0.0,0.0,0.0,50.0,7.0,37.0,15.9,Matches,115.0,br BRA,FW,23.0,10.7,234.0,214.0,19.0,1.0,1.0,0.0,8.0,3.0,0.0,0.0,0.0,0.0,171.0,1.0,7.0,Matches,115.0,br BRA,FW,23.0,10.7,171.0,234.0,73.1,2140.0,353.0,105.0,132.0,79.5,38.0,53.0,71.7,9.0,17.0,52.9,0.0,0.6,0.2,-0.6,7.0,5.0,3.0,0.0,14.0,Matches,148,br BRA,FW,23,17,965.0,57.0,28.2,10.7,12,70.0,1,5,26.0,3,1.65,13.0,12.0,1.0,0.09,1.12,10.8,17.0,-6.2,-0.58,0.04,Matches,115.0,br BRA,FW,23.0,10.7,372.0,14.0,66.0,170.0,147.0,45.0,372.0,39.0,26.0,66.7,8.0,20.5,195.0,1119.0,459.0,16.0,6.0,7.0,31.0,13.0,224.0,43.0,Matches,115.0,br BRA,FW,23.0,10.7,2.0,26.0,7.0,26.9,2.42,0.65,0.08,0.29,19.4,0.0,0.0,0.0,2.0,2.0,0.08,0.0,0.0,Matches,115.0,br BRA,FW,23.0,17.0,12.0,965.0,10.7,2.0,0.0,2.0,2.0,0.0,0.0,1.0,0.0,2.0,2.0,0.6,2.6,16.0,14.0,43.0,0.19,0.0,0.19,0.19,0.19,0.19,0.05,0.24,0.19,0.24,Matches,Matheus Cunha,AM/S RLC,23,143,162,Brazil,A. Madrid,12,12,17,15,15,13,11,16,5,4,14,13,6,17,16,11,15,12,6,11,8,16,17,10,12,5,7,12,15,15,14,12,12,15,13,12,10,14,14,6,14,2,3,3,3,1,3,2,2,2,1,2,14,17,13,7,12,9,5,6,1,1,1,1,1,1,1,10,1,12,17,20,15,17,183,76,14,20,26534113,7100,1887,7865,Mixed_Race,134,12,1999/5/27,7,0,76711.0,,19334410
302,Patson Daka,Leicester City,1998,116.0,zm ZAM,FW,23.0,13.2,14.0,8.0,6.0,8.0,0.0,3.0,13.0,23.1,10.0,14.0,2.0,12.0,7.0,21.0,7.0,0.0,Matches,116.0,zm ZAM,FW,23.0,13.2,28.0,2.12,19.0,1.0,1.0,5.0,2.0,0.0,7.0,0.53,4.0,0.0,1.0,2.0,0.0,0.0,Matches,,,,,,,,,,,,,,,,,,,,,,,,,,,,,,,,,,,,,,,,,,,,,,,,,,,,,,,,116.0,zm ZAM,FW,23.0,13.2,2.0,0.0,0.0,23.0,15.0,7.0,8.0,7.0,8.0,1.0,0.0,0.0,36.0,26.0,45.0,36.6,Matches,116.0,zm ZAM,FW,23.0,13.2,295.0,264.0,29.0,0.0,5.0,0.0,8.0,10.0,0.0,0.0,0.0,0.0,195.0,2.0,11.0,Matches,116.0,zm ZAM,FW,23.0,13.2,195.0,295.0,66.1,2605.0,439.0,118.0,157.0,75.2,55.0,85.0,64.7,8.0,12.0,66.7,4.0,2.8,1.7,1.2,17.0,7.0,8.0,1.0,17.0,Matches,150,zm ZAM,FW,23,30,1187.0,40.0,34.7,13.2,13,65.0,2,17,20.0,7,0.83,20.0,24.0,-4.0,-0.3,0.22,18.7,20.4,-1.7,-0.13,0.32,Matches,116.0,zm ZAM,FW,23.0,13.2,444.0,13.0,42.0,175.0,230.0,58.0,444.0,18.0,7.0,38.9,8.0,44.4,207.0,1090.0,461.0,18.0,8.0,11.0,46.0,19.0,288.0,82.0,Matches,116.0,zm ZAM,FW,23.0,13.2,4.0,30.0,16.0,53.3,2.27,1.21,0.13,0.25,14.6,0.0,0.0,0.0,3.5,3.5,0.12,0.5,0.5,Matches,116.0,zm ZAM,FW,23.0,30.0,13.0,1187.0,13.2,4.0,4.0,8.0,4.0,0.0,0.0,2.0,0.0,3.5,3.5,2.8,6.3,18.0,17.0,82.0,0.3,0.3,0.61,0.3,0.61,0.27,0.21,0.48,0.27,0.48,Matches,Patson Daka,S,23,141,165,Zambia,Leicester City,6,8,10,16,14,7,9,11,6,8,12,9,8,13,5,13,13,14,13,12,13,16,11,9,13,11,14,15,16,15,13,12,13,17,13,13,11,5,11,6,6,3,3,2,1,3,1,2,1,1,1,3,13,14,6,12,11,13,12,15,1,1,1,1,1,1,1,1,1,1,12,1,12,20,183,72,11,20,48203845,7050,7500,5250,African_Caribbean,138,16,1998/10/9,31,9,92793.0,,13158264
303,Diogo Dalot,Manchester Utd,1999,117.0,pt POR,DF,23.0,23.9,54.0,41.0,40.0,13.0,1.0,33.0,45.0,73.3,12.0,25.0,7.0,18.0,37.0,91.0,55.0,2.0,Matches,117.0,pt POR,DF,23.0,23.9,52.0,2.17,48.0,0.0,1.0,2.0,0.0,1.0,2.0,0.08,2.0,0.0,0.0,0.0,0.0,0.0,Matches,,,,,,,,,,,,,,,,,,,,,,,,,,,,,,,,,,,,,,,,,,,,,,,,,,,,,,,,117.0,pt POR,DF,23.0,23.9,6.0,0.0,0.0,21.0,3.0,0.0,44.0,37.0,41.0,0.0,0.0,0.0,152.0,39.0,18.0,68.4,Matches,117.0,pt POR,DF,23.0,23.9,1441.0,1216.0,219.0,17.0,3.0,20.0,44.0,202.0,0.0,0.0,0.0,0.0,1141.0,6.0,35.0,Matches,117.0,pt POR,DF,23.0,23.9,1141.0,1441.0,79.2,20816.0,6349.0,468.0,527.0,88.8,543.0,639.0,85.0,113.0,205.0,55.1,2.0,1.9,1.5,0.1,29.0,82.0,28.0,13.0,92.0,Matches,151,pt POR,DF,23,26,2154.0,83.0,63.0,23.9,24,89.0,21,2,13.0,6,1.77,32.0,34.0,-2.0,-0.08,-1.29,37.6,34.6,2.9,0.12,-0.9,Matches,117.0,pt POR,DF,23.0,23.9,1673.0,125.0,580.0,714.0,390.0,38.0,1673.0,35.0,21.0,60.0,7.0,20.0,878.0,4258.0,2161.0,46.0,32.0,12.0,18.0,5.0,994.0,85.0,Matches,117.0,pt POR,DF,23.0,23.9,1.0,22.0,7.0,31.8,0.92,0.29,0.05,0.14,19.9,0.0,0.0,0.0,2.5,2.5,0.11,-1.5,-1.5,Matches,117.0,pt POR,DF,23.0,26.0,24.0,2154.0,23.9,1.0,2.0,3.0,1.0,0.0,0.0,6.0,0.0,2.5,2.5,1.9,4.4,46.0,92.0,85.0,0.04,0.08,0.13,0.04,0.13,0.1,0.08,0.18,0.1,0.18,Matches,Diogo Dalot,D/WB RL,23,139,158,Portugal,Manchester UFC,9,13,13,8,14,4,9,7,13,12,13,10,13,13,13,13,11,12,12,9,12,12,11,8,13,13,14,14,15,14,13,11,15,14,14,11,12,9,13,8,15,3,2,2,1,1,1,1,2,3,1,2,14,15,5,12,12,15,14,12,1,17,1,20,14,18,1,13,1,15,7,1,10,1,184,75,12,20,34660456,7250,7500,5650,Mediterranean_Hispanic,129,5,1999/3/18,5,0,34999.0,,83105845
304,Mikkel Damsgaard,Brentford,2000,118.0,dk DEN,MFFW,22.0,11.0,31.0,21.0,13.0,13.0,5.0,15.0,42.0,35.7,27.0,20.0,2.0,18.0,10.0,41.0,14.0,0.0,Matches,118.0,dk DEN,MFFW,22.0,11.0,25.0,2.28,20.0,3.0,0.0,1.0,1.0,0.0,2.0,0.18,2.0,0.0,0.0,0.0,0.0,0.0,Matches,,,,,,,,,,,,,,,,,,,,,,,,,,,,,,,,,,,,,,,,,,,,,,,,,,,,,,,,118.0,dk DEN,MFFW,22.0,11.0,4.0,0.0,0.0,13.0,11.0,0.0,29.0,10.0,21.0,0.0,0.0,0.0,70.0,10.0,9.0,52.6,Matches,118.0,dk DEN,MFFW,22.0,11.0,407.0,387.0,14.0,8.0,5.0,2.0,29.0,1.0,2.0,1.0,1.0,0.0,275.0,6.0,12.0,Matches,118.0,dk DEN,MFFW,22.0,11.0,275.0,407.0,67.6,4023.0,1438.0,156.0,193.0,80.8,92.0,132.0,69.7,16.0,44.0,36.4,0.0,1.4,1.3,-1.4,11.0,36.0,10.0,1.0,44.0,Matches,152,dk DEN,MFFW,22,26,988.0,38.0,28.9,11.0,9,66.0,0,17,23.0,9,1.5,19.0,14.0,5.0,0.46,0.2,18.9,14.6,4.4,0.4,0.31,Matches,118.0,dk DEN,MFFW,22.0,11.0,529.0,9.0,104.0,268.0,166.0,27.0,529.0,23.0,9.0,39.1,9.0,39.1,279.0,1075.0,574.0,9.0,9.0,1.0,15.0,6.0,307.0,45.0,Matches,118.0,dk DEN,MFFW,22.0,11.0,0.0,12.0,5.0,41.7,1.09,0.46,0.0,0.0,15.0,0.0,0.0,0.0,2.6,2.6,0.22,-2.6,-2.6,Matches,118.0,dk DEN,MFFW,22.0,26.0,9.0,988.0,11.0,0.0,0.0,0.0,0.0,0.0,0.0,4.0,0.0,2.6,2.6,1.4,4.0,9.0,44.0,45.0,0.0,0.0,0.0,0.0,0.0,0.24,0.13,0.36,0.24,0.36,Matches,Mikkel Damsgaard,M/AM RLC,22,140,161,Denmark,Brentford,12,13,15,12,13,10,6,12,4,4,15,12,6,16,10,13,11,11,12,16,11,14,16,6,15,6,11,11,15,15,12,6,12,15,12,6,11,4,10,4,16,3,2,3,3,2,2,3,2,2,3,1,12,13,4,12,10,13,13,14,1,1,1,1,1,1,1,16,13,16,20,19,17,12,180,71,15,20,59823893,7000,7250,5000,Northern_European,134,4,2000/7/3,16,4,57996.0,,27128917
305,Danilo,Nott'ham Forest,2001,119.0,br BRA,MF,21.0,10.8,18.0,7.0,7.0,9.0,2.0,6.0,25.0,24.0,19.0,26.0,6.0,20.0,9.0,27.0,19.0,0.0,Matches,119.0,br BRA,MF,21.0,10.8,23.0,2.12,17.0,1.0,3.0,1.0,1.0,0.0,6.0,0.55,5.0,0.0,1.0,0.0,0.0,0.0,Matches,,,,,,,,,,,,,,,,,,,,,,,,,,,,,,,,,,,,,,,,,,,,,,,,,,,,,,,,119.0,br BRA,MF,21.0,10.8,1.0,0.0,0.0,4.0,3.0,2.0,3.0,9.0,7.0,0.0,0.0,0.0,60.0,4.0,14.0,22.2,Matches,119.0,br BRA,MF,21.0,10.8,235.0,225.0,7.0,0.0,2.0,1.0,3.0,2.0,0.0,0.0,0.0,0.0,148.0,3.0,18.0,Matches,119.0,br BRA,MF,21.0,10.8,148.0,235.0,63.0,2539.0,979.0,77.0,97.0,79.4,53.0,73.0,72.6,16.0,34.0,47.1,2.0,0.7,0.6,1.3,9.0,24.0,7.0,0.0,34.0,Matches,153,br BRA,MF,21,13,976.0,75.0,28.5,10.8,12,78.0,5,1,46.0,3,1.23,17.0,17.0,0.0,0.0,1.1,11.8,20.1,-8.3,-0.77,-0.15,Matches,119.0,br BRA,MF,21.0,10.8,383.0,26.0,118.0,182.0,92.0,21.0,383.0,19.0,14.0,73.7,4.0,21.1,171.0,815.0,439.0,13.0,9.0,6.0,20.0,8.0,171.0,22.0,Matches,119.0,br BRA,MF,21.0,10.8,3.0,15.0,4.0,26.7,1.38,0.37,0.2,0.75,20.4,0.0,0.0,0.0,1.5,1.5,0.1,1.5,1.5,Matches,119.0,br BRA,MF,21.0,13.0,12.0,976.0,10.8,3.0,2.0,5.0,3.0,0.0,0.0,1.0,0.0,1.5,1.5,0.7,2.3,13.0,34.0,22.0,0.28,0.18,0.46,0.28,0.46,0.14,0.07,0.21,0.14,0.21,Matches,Danilo,D/WB RLC,31,150,156,Brazil,Juventus,7,14,12,10,14,9,11,12,7,12,15,11,14,14,11,15,15,13,14,15,13,16,12,12,13,15,16,14,13,12,13,12,13,14,14,13,15,14,12,12,18,2,1,2,1,3,1,2,3,3,3,2,14,12,6,13,13,18,13,16,1,17,17,20,14,16,12,1,10,9,1,1,1,1,184,78,14,20,347975206,7500,8100,7250,Mediterranean_Hispanic,145,12,1991/7/15,45,1,98653.0,,19099575
306,Josh Dasilva,Brentford,1998,121.0,eng ENG,MF,23.0,15.4,18.0,9.0,6.0,6.0,6.0,6.0,16.0,37.5,10.0,22.0,6.0,16.0,5.0,23.0,7.0,1.0,Matches,121.0,eng ENG,MF,23.0,15.4,42.0,2.72,36.0,1.0,3.0,1.0,1.0,0.0,7.0,0.45,5.0,0.0,1.0,0.0,1.0,0.0,Matches,,,,,,,,,,,,,,,,,,,,,,,,,,,,,,,,,,,,,,,,,,,,,,,,,,,,,,,,121.0,eng ENG,MF,23.0,15.4,1.0,0.0,0.0,14.0,23.0,0.0,33.0,5.0,9.0,0.0,0.0,0.0,66.0,6.0,8.0,42.9,Matches,121.0,eng ENG,MF,23.0,15.4,617.0,591.0,25.0,8.0,1.0,1.0,33.0,11.0,6.0,4.0,0.0,0.0,491.0,1.0,17.0,Matches,121.0,eng ENG,MF,23.0,15.4,491.0,617.0,79.6,8103.0,1954.0,255.0,291.0,87.6,187.0,217.0,86.2,40.0,70.0,57.1,2.0,1.5,1.6,0.5,12.0,35.0,24.0,5.0,62.0,Matches,156,eng ENG,MF,23,36,1389.0,39.0,40.6,15.4,14,68.0,0,22,20.0,2,1.47,28.0,17.0,11.0,0.71,0.67,24.4,17.9,6.5,0.42,0.41,Matches,121.0,eng ENG,MF,23.0,15.4,770.0,17.0,144.0,342.0,298.0,32.0,770.0,56.0,32.0,57.1,15.0,26.8,536.0,3392.0,1631.0,60.0,43.0,9.0,28.0,28.0,562.0,69.0,Matches,121.0,eng ENG,MF,23.0,15.4,4.0,18.0,6.0,33.3,1.17,0.39,0.22,0.67,19.8,0.0,0.0,0.0,1.5,1.5,0.09,2.5,2.5,Matches,121.0,eng ENG,MF,23.0,36.0,14.0,1389.0,15.4,4.0,2.0,6.0,4.0,0.0,0.0,1.0,0.0,1.5,1.5,1.5,3.0,60.0,62.0,69.0,0.26,0.13,0.39,0.26,0.39,0.1,0.09,0.19,0.1,0.19,Matches,Josh Dasilva,M C,23,129,146,"England,Angola",Brentford,8,12,13,13,13,9,10,14,8,11,14,10,12,13,12,14,11,14,13,13,13,15,14,9,13,11,14,13,13,12,12,11,14,13,13,13,14,8,11,9,15,2,1,1,1,1,1,4,2,4,2,2,14,13,5,13,13,15,13,14,1,10,8,1,1,1,12,1,20,1,11,14,11,1,184,71,20,10,14452211,6450,6450,5000,African_Caribbean,129,15,1998/10/23,0,0,40597.0,,28106685
307,Ben Davies,Tottenham,1993,123.0,wls WAL,DF,29.0,25.4,28.0,11.0,13.0,13.0,2.0,14.0,26.0,53.8,12.0,17.0,8.0,9.0,18.0,46.0,72.0,0.0,Matches,123.0,wls WAL,DF,29.0,25.4,37.0,1.46,33.0,1.0,0.0,3.0,0.0,0.0,7.0,0.28,5.0,0.0,0.0,2.0,0.0,0.0,Matches,,,,,,,,,,,,,,,,,,,,,,,,,,,,,,,,,,,,,,,,,,,,,,,,,,,,,,,,123.0,wls WAL,DF,29.0,25.4,4.0,0.0,0.0,30.0,17.0,1.0,35.0,18.0,11.0,0.0,0.0,0.0,84.0,70.0,53.0,56.9,Matches,123.0,wls WAL,DF,29.0,25.4,1281.0,1190.0,87.0,27.0,1.0,8.0,35.0,60.0,0.0,0.0,0.0,0.0,1040.0,4.0,22.0,Matches,123.0,wls WAL,DF,29.0,25.4,1040.0,1281.0,81.2,17332.0,5962.0,500.0,559.0,89.4,445.0,514.0,86.6,69.0,136.0,50.7,2.0,2.5,1.5,-0.5,20.0,79.0,9.0,6.0,107.0,Matches,158,wls WAL,DF,29,31,2288.0,74.0,66.9,25.4,26,87.0,20,5,7.0,2,1.61,44.0,33.0,11.0,0.43,0.75,35.4,26.3,9.1,0.36,0.49,Matches,123.0,wls WAL,DF,29.0,25.4,1482.0,95.0,514.0,749.0,223.0,29.0,1482.0,15.0,5.0,33.3,7.0,46.7,835.0,4386.0,2692.0,39.0,33.0,4.0,11.0,5.0,1012.0,69.0,Matches,123.0,wls WAL,DF,29.0,25.4,2.0,14.0,5.0,35.7,0.55,0.2,0.14,0.4,16.7,0.0,0.0,0.0,1.0,1.0,0.07,1.0,1.0,Matches,123.0,wls WAL,DF,29.0,31.0,26.0,2288.0,25.4,2.0,2.0,4.0,2.0,0.0,0.0,4.0,0.0,1.0,1.0,2.5,3.5,39.0,107.0,69.0,0.08,0.08,0.16,0.08,0.16,0.04,0.1,0.14,0.04,0.14,Matches,Ben Davies,D LC,29,144,145,Wales,Tottenham Hotspur,11,12,12,8,13,13,15,7,11,13,14,10,15,13,13,15,18,13,11,12,14,15,9,12,13,15,15,16,12,13,13,12,14,13,16,14,14,6,10,9,15,1,1,3,2,2,3,3,2,2,3,1,14,13,4,13,12,15,14,17,1,20,18,1,15,1,1,1,1,1,1,1,1,1,182,76,20,8,67881263,7200,7500,5900,Northern_European,143,4,1993/4/24,74,1,104393.0,,28049754
308,Craig Dawson,Wolves,1990,126.0,eng ENG,DF,32.0,15.7,9.0,6.0,6.0,3.0,0.0,4.0,7.0,57.1,3.0,31.0,23.0,8.0,12.0,21.0,74.0,2.0,Matches,126.0,eng ENG,DF,32.0,15.7,6.0,0.38,6.0,0.0,0.0,0.0,0.0,0.0,0.0,0.0,0.0,0.0,0.0,0.0,0.0,0.0,Matches,,,,,,,,,,,,,,,,,,,,,,,,,,,,,,,,,,,,,,,,,,,,,,,,,,,,,,,,126.0,eng ENG,DF,32.0,15.7,4.0,0.0,0.0,11.0,10.0,0.0,0.0,12.0,6.0,0.0,0.0,0.0,75.0,34.0,36.0,48.6,Matches,126.0,eng ENG,DF,32.0,15.7,926.0,897.0,27.0,22.0,0.0,4.0,0.0,5.0,0.0,0.0,0.0,0.0,780.0,2.0,3.0,Matches,126.0,eng ENG,DF,32.0,15.7,780.0,926.0,84.2,16202.0,5539.0,231.0,257.0,89.9,419.0,455.0,92.1,122.0,193.0,63.2,0.0,0.0,0.2,0.0,1.0,51.0,3.0,0.0,44.0,Matches,162,eng ENG,DF,32,17,1414.0,83.0,41.3,15.7,17,83.0,14,0,,1,1.41,16.0,18.0,-2.0,-0.13,0.99,14.8,25.2,-10.4,-0.66,-0.1,Matches,126.0,eng ENG,DF,32.0,15.7,1084.0,182.0,619.0,437.0,32.0,15.0,1084.0,4.0,3.0,75.0,0.0,0.0,628.0,2615.0,1323.0,5.0,3.0,0.0,5.0,2.0,748.0,1.0,Matches,126.0,eng ENG,DF,32.0,15.7,1.0,11.0,2.0,18.2,0.7,0.13,0.09,0.5,11.5,0.0,0.0,0.0,1.0,1.0,0.09,0.0,0.0,Matches,126.0,eng ENG,DF,32.0,17.0,17.0,1414.0,15.7,1.0,0.0,1.0,1.0,0.0,0.0,4.0,0.0,1.0,1.0,0.0,1.0,5.0,44.0,1.0,0.06,0.0,0.06,0.06,0.06,0.06,0.0,0.06,0.06,0.06,Matches,Craig Dawson,D C,32,138,140,England,West Ham United,2,12,9,10,12,2,18,6,4,15,11,10,15,11,15,13,17,11,13,7,13,17,7,13,6,15,15,12,11,10,11,16,18,11,15,15,14,4,14,2,8,3,3,3,1,3,1,2,2,1,1,3,6,18,3,4,10,7,9,8,1,1,20,12,1,1,1,1,1,1,1,1,1,1,188,83,10,20,17487441,6900,6900,4750,Northern_European,135,1,1990/5/6,0,0,57996.0,,90000708
309,Kevin De Bruyne,Manchester City,1991,127.0,be BEL,MF,31.0,26.9,28.0,12.0,3.0,12.0,13.0,14.0,39.0,35.9,25.0,27.0,2.0,25.0,9.0,37.0,10.0,0.0,Matches,127.0,be BEL,MF,31.0,26.9,176.0,6.55,120.0,33.0,8.0,7.0,5.0,3.0,31.0,1.15,24.0,3.0,1.0,1.0,2.0,0.0,Matches,,,,,,,,,,,,,,,,,,,,,,,,,,,,,,,,,,,,,,,,,,,,,,,,,,,,,,,,127.0,be BEL,MF,31.0,26.9,1.0,0.0,0.0,20.0,29.0,5.0,226.0,9.0,12.0,2.0,0.0,0.0,97.0,13.0,13.0,50.0,Matches,127.0,be BEL,MF,31.0,26.9,1626.0,1454.0,160.0,53.0,28.0,27.0,226.0,31.0,72.0,20.0,32.0,6.0,1192.0,12.0,41.0,Matches,127.0,be BEL,MF,31.0,26.9,1192.0,1626.0,73.3,22165.0,6516.0,538.0,633.0,85.0,477.0,629.0,75.8,160.0,275.0,58.2,16.0,13.7,14.1,2.3,96.0,124.0,96.0,21.0,246.0,Matches,163,be BEL,MF,31,32,2417.0,76.0,70.7,26.9,28,84.0,16,4,20.0,3,2.31,69.0,23.0,46.0,1.71,0.37,58.7,19.4,39.2,1.46,0.81,Matches,127.0,be BEL,MF,31.0,26.9,1860.0,13.0,100.0,743.0,1041.0,100.0,1860.0,61.0,32.0,52.5,19.0,31.1,1129.0,5721.0,3415.0,100.0,81.0,16.0,42.0,29.0,1445.0,245.0,Matches,127.0,be BEL,MF,31.0,26.9,7.0,65.0,21.0,32.3,2.42,0.78,0.11,0.33,23.0,7.0,0.0,0.0,5.6,5.6,0.09,1.4,1.4,Matches,127.0,be BEL,MF,31.0,32.0,28.0,2417.0,26.9,7.0,16.0,23.0,7.0,0.0,0.0,1.0,0.0,5.6,5.6,13.7,19.3,100.0,246.0,245.0,0.26,0.6,0.86,0.26,0.86,0.21,0.51,0.72,0.21,0.72,Matches,Kevin De Bruyne,M/AM RLC,31,189,189,Belgium,Manchester City,14,19,15,16,16,17,6,17,7,9,18,16,9,18,12,14,13,15,15,20,18,17,16,13,14,11,14,15,15,13,14,10,16,14,17,13,15,6,15,7,14,1,3,1,3,3,3,3,3,3,2,1,13,17,13,14,11,18,16,13,1,1,1,1,1,1,12,15,20,15,14,20,14,12,181,68,16,20,347975206,9450,9400,9400,Northern_European,181,4,1991/6/28,91,24,394372.0,,18004457
310,Kiernan Dewsbury-Hall,Leicester City,1998,133.0,eng ENG,MF,23.0,25.6,53.0,29.0,14.0,34.0,5.0,19.0,47.0,40.4,28.0,55.0,13.0,42.0,28.0,81.0,21.0,0.0,Matches,133.0,eng ENG,MF,23.0,25.6,78.0,3.04,61.0,0.0,8.0,2.0,5.0,2.0,9.0,0.35,6.0,0.0,1.0,0.0,1.0,1.0,Matches,,,,,,,,,,,,,,,,,,,,,,,,,,,,,,,,,,,,,,,,,,,,,,,,,,,,,,,,133.0,eng ENG,MF,23.0,25.6,5.0,1.0,1.0,37.0,35.0,1.0,46.0,28.0,29.0,0.0,0.0,0.0,149.0,15.0,13.0,53.6,Matches,133.0,eng ENG,MF,23.0,25.6,1154.0,1120.0,24.0,9.0,9.0,20.0,46.0,3.0,7.0,7.0,0.0,0.0,872.0,10.0,26.0,Matches,133.0,eng ENG,MF,23.0,25.6,872.0,1154.0,75.6,14495.0,3746.0,448.0,526.0,85.2,311.0,389.0,79.9,84.0,161.0,52.2,2.0,3.3,2.6,-1.3,39.0,111.0,23.0,4.0,132.0,Matches,173,eng ENG,MF,23,31,2306.0,74.0,67.4,25.6,28,80.0,16,3,26.0,2,1.0,38.0,40.0,-2.0,-0.08,1.13,30.5,39.2,-8.7,-0.34,-0.01,Matches,133.0,eng ENG,MF,23.0,25.6,1490.0,48.0,279.0,796.0,443.0,50.0,1490.0,76.0,42.0,55.3,26.0,34.2,903.0,5218.0,2559.0,68.0,36.0,16.0,73.0,32.0,1038.0,91.0,Matches,133.0,eng ENG,MF,23.0,25.6,2.0,26.0,6.0,23.1,1.01,0.23,0.08,0.33,21.3,0.0,0.0,0.0,2.4,2.4,0.09,-0.4,-0.4,Matches,133.0,eng ENG,MF,23.0,31.0,28.0,2306.0,25.6,2.0,2.0,4.0,2.0,0.0,0.0,5.0,1.0,2.4,2.4,3.3,5.6,68.0,132.0,91.0,0.08,0.08,0.16,0.08,0.16,0.09,0.13,0.22,0.09,0.22,Matches,Kiernan Dewsbury-Hall,DM/M/AM C,23,144,165,England,Leicester City,13,12,14,12,14,13,8,13,5,9,14,10,13,13,13,13,12,14,12,16,12,14,13,12,13,12,15,17,12,16,11,7,18,12,18,12,14,8,14,4,12,2,3,3,2,2,3,3,1,3,3,1,7,13,6,16,13,14,12,14,1,1,1,1,10,1,16,10,20,1,1,17,1,1,176,0,20,10,53785948,7000,7000,5500,Northern_European,141,6,1998/9/6,0,0,86994.0,,28106342
311,Rúben Dias,Manchester City,1997,135.0,pt POR,DF,25.0,22.2,21.0,13.0,10.0,10.0,1.0,11.0,18.0,61.1,7.0,21.0,13.0,8.0,18.0,39.0,56.0,1.0,Matches,135.0,pt POR,DF,25.0,22.2,15.0,0.68,11.0,1.0,0.0,3.0,0.0,0.0,1.0,0.05,1.0,0.0,0.0,0.0,0.0,0.0,Matches,,,,,,,,,,,,,,,,,,,,,,,,,,,,,,,,,,,,,,,,,,,,,,,,,,,,,,,,135.0,pt POR,DF,25.0,22.2,3.0,0.0,0.0,19.0,7.0,0.0,1.0,18.0,13.0,0.0,0.0,0.0,99.0,44.0,28.0,61.1,Matches,135.0,pt POR,DF,25.0,22.2,2080.0,2029.0,51.0,38.0,1.0,6.0,1.0,7.0,0.0,0.0,0.0,0.0,1928.0,0.0,7.0,Matches,135.0,pt POR,DF,25.0,22.2,1928.0,2080.0,92.7,35553.0,12572.0,696.0,726.0,95.9,1074.0,1122.0,95.7,143.0,203.0,70.4,0.0,0.6,0.3,-0.6,3.0,135.0,0.0,0.0,98.0,Matches,175,pt POR,DF,25,26,1998.0,77.0,58.4,22.2,22,87.0,19,4,23.0,6,2.65,65.0,16.0,49.0,2.21,1.45,47.0,17.0,30.0,1.35,0.31,Matches,135.0,pt POR,DF,25.0,22.2,2237.0,176.0,881.0,1280.0,83.0,22.0,2237.0,10.0,8.0,80.0,1.0,10.0,1497.0,8194.0,5025.0,14.0,22.0,1.0,1.0,4.0,1791.0,2.0,Matches,135.0,pt POR,DF,25.0,22.2,0.0,10.0,2.0,20.0,0.45,0.09,0.0,0.0,9.1,0.0,0.0,0.0,1.3,1.3,0.13,-1.3,-1.3,Matches,135.0,pt POR,DF,25.0,26.0,22.0,1998.0,22.2,0.0,0.0,0.0,0.0,0.0,0.0,3.0,0.0,1.3,1.3,0.6,1.9,14.0,98.0,2.0,0.0,0.0,0.0,0.0,0.0,0.06,0.03,0.09,0.06,0.09,Matches,Rúben Dias,D C,25,174,177,Portugal,Manchester City,4,11,12,6,13,5,15,4,5,17,14,8,18,13,16,17,18,15,16,13,15,18,8,17,8,17,16,17,13,13,12,16,18,13,18,16,18,13,15,4,8,1,3,2,3,1,1,3,1,3,2,2,18,18,8,16,16,18,14,16,1,1,20,1,1,1,1,1,1,1,1,1,1,1,186,83,12,20,347975206,8700,8500,8500,Mediterranean_Hispanic,172,4,1997/5/14,37,2,202986.0,,55070299
312,Luis Díaz,Liverpool,1997,136.0,co COL,FW,25.0,11.1,17.0,11.0,4.0,8.0,5.0,8.0,15.0,53.3,7.0,8.0,0.0,8.0,6.0,23.0,2.0,0.0,Matches,136.0,co COL,FW,25.0,11.1,41.0,3.7,29.0,0.0,7.0,3.0,2.0,0.0,6.0,0.54,3.0,0.0,2.0,1.0,0.0,0.0,Matches,,,,,,,,,,,,,,,,,,,,,,,,,,,,,,,,,,,,,,,,,,,,,,,,,,,,,,,,136.0,co COL,FW,25.0,11.1,2.0,0.0,0.0,20.0,24.0,3.0,8.0,6.0,11.0,0.0,0.0,0.0,50.0,8.0,23.0,25.8,Matches,136.0,co COL,FW,25.0,11.1,462.0,453.0,7.0,0.0,0.0,7.0,8.0,6.0,1.0,0.0,0.0,0.0,376.0,2.0,15.0,Matches,136.0,co COL,FW,25.0,11.1,376.0,462.0,81.4,5698.0,1124.0,215.0,256.0,84.0,127.0,150.0,84.7,25.0,27.0,92.6,2.0,1.5,1.3,0.5,13.0,25.0,13.0,1.0,49.0,Matches,176,co COL,FW,25,17,996.0,59.0,29.1,11.1,11,76.0,5,6,26.0,0,1.94,28.0,11.0,17.0,1.54,1.13,22.0,11.8,10.2,0.92,0.5,Matches,136.0,co COL,FW,25.0,11.1,618.0,4.0,47.0,247.0,336.0,77.0,618.0,65.0,32.0,49.2,25.0,38.5,440.0,2944.0,1303.0,39.0,31.0,22.0,30.0,37.0,500.0,116.0,Matches,136.0,co COL,FW,25.0,11.1,4.0,27.0,8.0,29.6,2.44,0.72,0.15,0.5,15.1,0.0,0.0,0.0,2.5,2.5,0.09,1.5,1.5,Matches,136.0,co COL,FW,25.0,17.0,11.0,996.0,11.1,4.0,2.0,6.0,4.0,0.0,0.0,2.0,0.0,2.5,2.5,1.5,4.0,39.0,49.0,116.0,0.36,0.18,0.54,0.36,0.54,0.22,0.14,0.36,0.22,0.36,Matches,Luis Díaz,AM L,25,166,172,Colombia,Liverpool,9,12,18,15,18,10,13,13,4,7,14,5,8,18,13,13,13,14,13,14,13,15,19,4,15,9,13,14,17,17,14,10,15,16,13,10,15,11,17,7,10,1,2,1,1,3,3,4,1,1,3,3,15,14,8,13,16,12,10,13,1,1,1,1,1,1,1,11,1,8,20,13,14,12,180,70,12,20,251912317,8250,8050,7250,Mixed_Race,160,12,1997/1/13,37,8,104393.0,,76049803
313,Eric Dier,Tottenham,1994,137.0,eng ENG,DF,28.0,31.3,30.0,19.0,16.0,12.0,2.0,9.0,19.0,47.4,10.0,41.0,24.0,17.0,35.0,65.0,112.0,2.0,Matches,137.0,eng ENG,DF,28.0,31.3,29.0,0.93,24.0,1.0,0.0,4.0,0.0,0.0,2.0,0.06,1.0,0.0,0.0,1.0,0.0,0.0,Matches,,,,,,,,,,,,,,,,,,,,,,,,,,,,,,,,,,,,,,,,,,,,,,,,,,,,,,,,137.0,eng ENG,DF,28.0,31.3,3.0,0.0,0.0,25.0,10.0,1.0,11.0,35.0,19.0,0.0,0.0,0.0,140.0,80.0,35.0,69.6,Matches,137.0,eng ENG,DF,28.0,31.3,2001.0,1929.0,68.0,58.0,2.0,17.0,11.0,8.0,0.0,0.0,0.0,0.0,1708.0,4.0,15.0,Matches,137.0,eng ENG,DF,28.0,31.3,1708.0,2001.0,85.4,32594.0,12717.0,636.0,688.0,92.4,866.0,934.0,92.7,179.0,317.0,56.5,1.0,1.2,0.6,-0.2,7.0,76.0,8.0,3.0,87.0,Matches,178,eng ENG,DF,28,33,2818.0,85.0,82.4,31.3,31,90.0,30,2,19.0,3,1.73,62.0,52.0,10.0,0.32,0.77,48.4,43.3,5.1,0.16,-0.18,Matches,137.0,eng ENG,DF,28.0,31.3,2274.0,370.0,1333.0,866.0,84.0,25.0,2274.0,6.0,3.0,50.0,2.0,33.3,1368.0,6183.0,2851.0,9.0,9.0,1.0,10.0,3.0,1600.0,14.0,Matches,137.0,eng ENG,DF,28.0,31.3,2.0,17.0,4.0,23.5,0.54,0.13,0.12,0.5,11.8,2.0,0.0,0.0,1.6,1.6,0.1,0.4,0.4,Matches,137.0,eng ENG,DF,28.0,33.0,31.0,2818.0,31.3,2.0,1.0,3.0,2.0,0.0,0.0,3.0,0.0,1.6,1.6,1.2,2.8,9.0,87.0,14.0,0.06,0.03,0.1,0.06,0.1,0.05,0.04,0.09,0.05,0.09,Matches,Eric Dier,D C,28,153,156,England,Tottenham Hotspur,7,12,11,9,13,11,16,11,5,14,14,8,16,13,16,15,16,13,14,12,14,16,5,13,11,16,15,15,11,10,11,13,14,14,13,16,13,5,12,6,17,1,3,3,1,2,3,3,1,2,1,1,17,14,5,14,13,16,14,11,1,5,20,8,1,1,13,1,10,1,1,1,1,1,188,90,17,20,159332595,7642,7642,6342,Northern_European,153,2,1994/1/15,45,3,104393.0,,55032265
314,Lucas Digne,Aston Villa,1993,138.0,fr FRA,DF,29.0,16.7,30.0,12.0,20.0,9.0,1.0,20.0,33.0,60.6,13.0,18.0,5.0,13.0,18.0,48.0,45.0,0.0,Matches,138.0,fr FRA,DF,29.0,16.7,29.0,1.74,24.0,4.0,0.0,0.0,1.0,0.0,0.0,0.0,0.0,0.0,0.0,0.0,0.0,0.0,Matches,,,,,,,,,,,,,,,,,,,,,,,,,,,,,,,,,,,,,,,,,,,,,,,,,,,,,,,,138.0,fr FRA,DF,29.0,16.7,5.0,0.0,0.0,19.0,23.0,2.0,77.0,18.0,12.0,0.0,1.0,1.0,86.0,26.0,17.0,60.5,Matches,138.0,fr FRA,DF,29.0,16.7,927.0,749.0,177.0,23.0,0.0,4.0,77.0,142.0,12.0,5.0,4.0,0.0,696.0,1.0,23.0,Matches,138.0,fr FRA,DF,29.0,16.7,696.0,927.0,75.1,11016.0,4245.0,387.0,432.0,89.6,247.0,337.0,73.3,49.0,105.0,46.7,0.0,1.9,1.9,-1.9,18.0,40.0,23.0,14.0,57.0,Matches,179,fr FRA,DF,29,28,1502.0,54.0,43.9,16.7,18,75.0,10,10,15.0,4,1.46,22.0,25.0,-3.0,-0.18,-0.56,19.9,25.7,-5.8,-0.35,-0.52,Matches,138.0,fr FRA,DF,29.0,16.7,1096.0,64.0,365.0,396.0,342.0,24.0,1096.0,18.0,3.0,16.7,11.0,61.1,552.0,2363.0,1262.0,29.0,14.0,2.0,16.0,12.0,625.0,89.0,Matches,138.0,fr FRA,DF,29.0,16.7,1.0,8.0,3.0,37.5,0.48,0.18,0.13,0.33,20.5,4.0,0.0,0.0,0.4,0.4,0.05,0.6,0.6,Matches,138.0,fr FRA,DF,29.0,28.0,18.0,1502.0,16.7,1.0,0.0,1.0,1.0,0.0,0.0,5.0,0.0,0.4,0.4,1.9,2.3,29.0,57.0,89.0,0.06,0.0,0.06,0.06,0.06,0.02,0.11,0.14,0.02,0.14,Matches,Lucas Digne,D/WB L,29,147,155,France,Aston Villa,13,16,13,8,14,16,13,13,15,10,14,6,14,15,13,14,15,16,14,13,13,16,10,8,15,13,14,15,15,15,14,8,15,14,16,12,14,13,15,11,10,2,2,2,1,2,3,1,3,2,2,2,15,16,5,13,14,16,15,14,1,20,13,1,18,1,1,13,1,1,7,1,1,1,178,74,20,5,43775281,7350,7250,6250,Northern_European,145,3,1993/7/20,46,0,139190.0,,85033423
315,Issa Diop,Fulham,1997,139.0,fr FRA,DF,25.0,22.4,28.0,19.0,18.0,9.0,1.0,17.0,32.0,53.1,15.0,24.0,17.0,7.0,35.0,63.0,86.0,0.0,Matches,139.0,fr FRA,DF,25.0,22.4,9.0,0.4,9.0,0.0,0.0,0.0,0.0,0.0,0.0,0.0,0.0,0.0,0.0,0.0,0.0,0.0,Matches,,,,,,,,,,,,,,,,,,,,,,,,,,,,,,,,,,,,,,,,,,,,,,,,,,,,,,,,139.0,fr FRA,DF,25.0,22.4,2.0,0.0,0.0,16.0,8.0,3.0,2.0,35.0,19.0,0.0,2.0,0.0,116.0,33.0,24.0,57.9,Matches,139.0,fr FRA,DF,25.0,22.4,1399.0,1352.0,46.0,41.0,0.0,8.0,2.0,1.0,0.0,0.0,0.0,0.0,1216.0,1.0,8.0,Matches,139.0,fr FRA,DF,25.0,22.4,1216.0,1399.0,86.9,23784.0,7827.0,386.0,427.0,90.4,710.0,761.0,93.3,112.0,189.0,59.3,0.0,0.4,0.5,-0.4,2.0,69.0,4.0,0.0,70.0,Matches,180,fr FRA,DF,25,25,2012.0,80.0,58.8,22.4,21,89.0,19,4,34.0,12,1.28,33.0,26.0,7.0,0.31,0.63,28.9,35.7,-6.8,-0.3,0.37,Matches,139.0,fr FRA,DF,25.0,22.4,1606.0,191.0,828.0,762.0,28.0,9.0,1606.0,7.0,5.0,71.4,1.0,14.3,1026.0,6704.0,4207.0,13.0,6.0,0.0,10.0,1.0,1115.0,4.0,Matches,139.0,fr FRA,DF,25.0,22.4,1.0,3.0,2.0,66.7,0.13,0.09,0.33,0.5,12.3,0.0,0.0,0.0,0.3,0.3,0.09,0.7,0.7,Matches,139.0,fr FRA,DF,25.0,25.0,21.0,2012.0,22.4,1.0,0.0,1.0,1.0,0.0,0.0,2.0,0.0,0.3,0.3,0.4,0.7,13.0,70.0,4.0,0.04,0.0,0.04,0.04,0.04,0.01,0.02,0.03,0.01,0.03,Matches,Issa Diop,D C,25,136,150,"France,Senegal,Morocco",Fulham,3,3,11,6,11,5,16,9,8,13,10,4,15,11,14,14,12,12,12,9,13,15,3,14,11,14,13,14,14,13,14,17,16,14,13,16,14,13,14,5,7,2,2,3,3,3,2,3,3,3,3,2,15,15,2,13,12,14,13,14,1,1,20,1,1,1,1,1,1,1,1,1,1,1,194,92,5,20,25902156,6800,6300,5750,African_Caribbean,135,14,1997/1/9,0,0,75395.0,,85140415
316,Abdoulaye Doucouré,Everton,1993,143.0,ml MLI,MF,29.0,17.0,31.0,20.0,9.0,15.0,7.0,12.0,37.0,32.4,25.0,26.0,3.0,23.0,13.0,44.0,11.0,0.0,Matches,143.0,ml MLI,MF,29.0,17.0,45.0,2.65,38.0,0.0,3.0,2.0,0.0,2.0,3.0,0.18,3.0,0.0,0.0,0.0,0.0,0.0,Matches,,,,,,,,,,,,,,,,,,,,,,,,,,,,,,,,,,,,,,,,,,,,,,,,,,,,,,,,143.0,ml MLI,MF,29.0,17.0,6.0,1.0,0.0,21.0,4.0,8.0,8.0,13.0,20.0,0.0,1.0,0.0,100.0,13.0,30.0,30.2,Matches,143.0,ml MLI,MF,29.0,17.0,548.0,530.0,16.0,0.0,1.0,0.0,8.0,0.0,0.0,0.0,0.0,0.0,430.0,2.0,14.0,Matches,143.0,ml MLI,MF,29.0,17.0,430.0,548.0,78.5,5637.0,1333.0,262.0,317.0,82.6,140.0,170.0,82.4,7.0,13.0,53.8,2.0,2.2,1.4,-0.2,22.0,29.0,10.0,0.0,38.0,Matches,184,ml MLI,MF,29,25,1533.0,61.0,44.8,17.0,17,84.0,14,8,13.0,4,1.2,18.0,26.0,-8.0,-0.47,0.25,24.0,29.5,-5.5,-0.32,0.39,Matches,143.0,ml MLI,MF,29.0,17.0,713.0,18.0,156.0,327.0,242.0,45.0,713.0,33.0,20.0,60.6,11.0,33.3,371.0,1689.0,896.0,23.0,16.0,7.0,27.0,13.0,440.0,66.0,Matches,143.0,ml MLI,MF,29.0,17.0,5.0,20.0,8.0,40.0,1.17,0.47,0.25,0.63,13.2,0.0,0.0,0.0,2.4,2.4,0.12,2.6,2.6,Matches,143.0,ml MLI,MF,29.0,25.0,17.0,1533.0,17.0,5.0,2.0,7.0,5.0,0.0,0.0,6.0,1.0,2.4,2.4,2.2,4.6,23.0,38.0,66.0,0.29,0.12,0.41,0.29,0.41,0.14,0.13,0.27,0.14,0.27,Matches,Abdoulaye Doucouré,DM/M/AM C,29,136,160,"Mali,France",Everton,5,11,12,13,14,7,12,13,5,12,13,8,12,14,13,12,14,13,12,13,13,14,12,10,13,12,16,17,14,13,14,12,16,13,16,15,11,11,14,9,10,1,3,2,3,3,2,1,2,2,2,2,14,15,5,13,14,15,15,12,1,1,10,1,1,1,17,1,20,1,1,16,1,7,183,70,8,20,27051843,6800,6850,6000,African_Caribbean,136,17,1993/1/1,2,0,139190.0,,85027988
317,Cheick Doucouré,Crystal Palace,2000,144.0,ml MLI,MF,22.0,30.8,77.0,46.0,40.0,33.0,4.0,29.0,52.0,55.8,23.0,47.0,13.0,34.0,56.0,133.0,48.0,0.0,Matches,144.0,ml MLI,MF,22.0,30.8,61.0,1.98,48.0,0.0,2.0,5.0,2.0,4.0,6.0,0.2,4.0,0.0,0.0,1.0,0.0,1.0,Matches,,,,,,,,,,,,,,,,,,,,,,,,,,,,,,,,,,,,,,,,,,,,,,,,,,,,,,,,144.0,ml MLI,MF,22.0,30.8,10.0,1.0,1.0,38.0,13.0,0.0,6.0,56.0,46.0,0.0,0.0,0.0,220.0,30.0,29.0,50.8,Matches,144.0,ml MLI,MF,22.0,30.8,1247.0,1229.0,16.0,16.0,3.0,2.0,6.0,0.0,0.0,0.0,0.0,0.0,1038.0,2.0,30.0,Matches,144.0,ml MLI,MF,22.0,30.8,1038.0,1247.0,83.2,17432.0,5352.0,478.0,535.0,89.3,460.0,530.0,86.8,75.0,104.0,72.1,3.0,1.9,1.2,1.1,26.0,110.0,11.0,1.0,140.0,Matches,185,ml MLI,MF,22,34,2769.0,81.0,81.0,30.8,34,81.0,16,0,,1,1.24,36.0,41.0,-5.0,-0.16,0.39,33.3,38.7,-5.4,-0.18,0.29,Matches,144.0,ml MLI,MF,22.0,30.8,1577.0,94.0,444.0,894.0,255.0,15.0,1577.0,21.0,15.0,71.4,6.0,28.6,761.0,3761.0,1761.0,18.0,25.0,1.0,28.0,20.0,884.0,17.0,Matches,144.0,ml MLI,MF,22.0,30.8,0.0,36.0,7.0,19.4,1.17,0.23,0.0,0.0,24.6,0.0,0.0,0.0,1.4,1.4,0.04,-1.4,-1.4,Matches,144.0,ml MLI,MF,22.0,34.0,34.0,2769.0,30.8,0.0,3.0,3.0,0.0,0.0,0.0,10.0,1.0,1.4,1.4,1.9,3.4,18.0,140.0,17.0,0.0,0.1,0.1,0.0,0.1,0.05,0.06,0.11,0.05,0.11,Matches,Cheick Doucouré,DM/M C,22,135,158,Mali,Crystal Palace,8,8,12,11,13,8,12,14,13,13,15,10,13,13,12,13,14,12,12,15,13,15,11,10,12,12,14,14,13,13,12,12,14,13,13,14,13,10,12,8,11,3,2,1,1,2,2,2,1,1,1,3,12,12,8,9,11,14,12,20,1,1,6,1,1,1,20,1,19,1,1,1,1,1,180,73,10,20,31958043,6745,6745,3745,African_Caribbean,134,15,2000/1/8,8,0,52196.0,,13194021
318,Lewis Dunk,Brighton,1991,150.0,eng ENG,DF,30.0,36.0,30.0,19.0,19.0,9.0,2.0,18.0,41.0,43.9,23.0,37.0,27.0,10.0,34.0,64.0,81.0,1.0,Matches,150.0,eng ENG,DF,30.0,36.0,32.0,0.89,31.0,0.0,0.0,1.0,0.0,0.0,2.0,0.06,2.0,0.0,0.0,0.0,0.0,0.0,Matches,,,,,,,,,,,,,,,,,,,,,,,,,,,,,,,,,,,,,,,,,,,,,,,,,,,,,,,,150.0,eng ENG,DF,30.0,36.0,4.0,0.0,0.0,18.0,27.0,1.0,2.0,34.0,19.0,0.0,4.0,1.0,253.0,68.0,47.0,59.1,Matches,150.0,eng ENG,DF,30.0,36.0,3223.0,3064.0,156.0,111.0,4.0,21.0,2.0,10.0,0.0,0.0,0.0,0.0,2911.0,3.0,13.0,Matches,150.0,eng ENG,DF,30.0,36.0,2911.0,3223.0,90.3,54839.0,19942.0,1066.0,1128.0,94.5,1525.0,1600.0,95.3,279.0,428.0,65.2,0.0,1.0,0.9,-1.0,9.0,178.0,9.0,1.0,158.0,Matches,194,eng ENG,DF,30,36,3239.0,90.0,94.7,36.0,36,90.0,35,0,,2,1.69,70.0,50.0,20.0,0.56,1.05,69.7,45.4,24.3,0.67,1.24,Matches,150.0,eng ENG,DF,30.0,36.0,3461.0,428.0,1665.0,1712.0,97.0,34.0,3461.0,5.0,4.0,80.0,0.0,0.0,2294.0,11410.0,6327.0,19.0,21.0,0.0,13.0,5.0,2586.0,5.0,Matches,150.0,eng ENG,DF,30.0,36.0,1.0,22.0,3.0,13.6,0.61,0.08,0.05,0.33,11.7,1.0,0.0,0.0,1.7,1.7,0.08,-0.7,-0.7,Matches,150.0,eng ENG,DF,30.0,36.0,36.0,3239.0,36.0,1.0,0.0,1.0,1.0,0.0,0.0,4.0,0.0,1.7,1.7,1.0,2.7,19.0,158.0,5.0,0.03,0.0,0.03,0.03,0.03,0.05,0.03,0.07,0.05,0.07,Matches,Lewis Dunk,D C,30,147,150,England,Brighton & Hove Albion,5,7,9,6,13,9,14,5,6,14,14,10,16,13,13,14,17,14,15,12,15,14,8,15,7,15,14,14,11,11,10,16,13,14,15,14,14,13,14,6,14,2,3,2,3,3,3,3,1,2,3,1,20,14,5,16,9,15,13,11,1,1,20,1,1,1,1,1,1,1,1,1,1,1,191,78,11,20,41000123,7350,7050,6250,Northern_European,146,6,1991/11/21,1,0,92793.0,,29036189
319,Ederson,Manchester City,1993,153.0,br BRA,GK,28.0,35.0,3.0,1.0,3.0,0.0,0.0,1.0,2.0,50.0,1.0,0.0,0.0,0.0,1.0,4.0,10.0,2.0,Matches,153.0,br BRA,GK,28.0,35.0,2.0,0.06,2.0,0.0,0.0,0.0,0.0,0.0,1.0,0.03,1.0,0.0,0.0,0.0,0.0,0.0,Matches,8.0,br BRA,GK,28.0,35.0,32.0,3.0,1.0,4.0,1.0,26.2,0.3,-4.8,-0.14,117.0,263.0,44.5,1104.0,147.0,19.6,28.0,152.0,30.9,32.3,286.0,19.0,6.6,33.0,0.94,15.7,Matches,8.0,br BRA,GK,28.0,35.0,35.0,3150.0,35.0,32.0,0.91,77.0,46.0,62.3,26.0,4.0,5.0,11.0,31.4,3.0,3.0,0.0,0.0,0.0,Matches,153.0,br BRA,GK,28.0,35.0,3.0,0.0,0.0,1.0,4.0,0.0,0.0,1.0,1.0,0.0,1.0,0.0,35.0,8.0,1.0,88.9,Matches,153.0,br BRA,GK,28.0,35.0,1257.0,1049.0,207.0,55.0,1.0,8.0,0.0,0.0,0.0,0.0,0.0,0.0,1079.0,1.0,1.0,Matches,153.0,br BRA,GK,28.0,35.0,1079.0,1257.0,85.8,26248.0,17275.0,237.0,239.0,99.2,563.0,572.0,98.4,278.0,442.0,62.9,1.0,0.2,0.2,0.8,1.0,13.0,0.0,0.0,0.0,Matches,197,br BRA,GK,28,35,3150.0,90.0,92.1,35.0,35,90.0,35,0,,3,2.34,89.0,32.0,57.0,1.63,0.3,73.3,28.3,45.1,1.29,0.81,Matches,153.0,br BRA,GK,28.0,35.0,1302.0,1049.0,1295.0,9.0,0.0,0.0,1302.0,0.0,0.0,,0.0,,869.0,4059.0,2429.0,0.0,0.0,0.0,0.0,0.0,833.0,0.0,Matches,153.0,br BRA,GK,28.0,35.0,0.0,0.0,0.0,,0.0,0.0,,,,0.0,0.0,0.0,0.0,0.0,,0.0,0.0,Matches,153.0,br BRA,GK,28.0,35.0,35.0,3150.0,35.0,0.0,1.0,1.0,0.0,0.0,0.0,3.0,0.0,0.0,0.0,0.2,0.2,0.0,0.0,0.0,0.0,0.03,0.03,0.0,0.03,0.0,0.01,0.01,0.0,0.01,Matches,Ederson,GK,28,175,180,"Brazil,Portugal",Manchester City,5,2,11,3,14,8,9,12,2,1,18,12,3,17,12,17,18,20,16,17,15,16,2,7,15,13,14,13,14,13,13,13,15,13,14,13,16,5,16,5,2,13,16,13,15,16,20,13,14,17,6,17,16,14,4,12,20,16,10,18,20,1,1,1,1,1,1,1,1,1,1,1,1,1,188,86,20,10,325655872,8750,8500,8500,Mediterranean_Hispanic,173,8,1993/8/17,18,0,208785.0,,55057659
320,Harvey Elliott,Liverpool,2003,157.0,eng ENG,MFFW,19.0,17.9,27.0,18.0,6.0,12.0,9.0,9.0,37.0,24.3,28.0,26.0,1.0,25.0,15.0,42.0,8.0,0.0,Matches,157.0,eng ENG,MFFW,19.0,17.9,75.0,4.19,62.0,1.0,5.0,5.0,1.0,1.0,10.0,0.56,10.0,0.0,0.0,0.0,0.0,0.0,Matches,,,,,,,,,,,,,,,,,,,,,,,,,,,,,,,,,,,,,,,,,,,,,,,,,,,,,,,,157.0,eng ENG,MFFW,19.0,17.9,2.0,0.0,0.0,14.0,25.0,2.0,34.0,15.0,18.0,0.0,0.0,0.0,122.0,4.0,16.0,20.0,Matches,157.0,eng ENG,MFFW,19.0,17.9,1009.0,962.0,39.0,0.0,8.0,4.0,34.0,10.0,2.0,1.0,0.0,0.0,809.0,8.0,24.0,Matches,157.0,eng ENG,MFFW,19.0,17.9,809.0,1009.0,80.2,12346.0,3197.0,442.0,494.0,89.5,296.0,363.0,81.5,45.0,85.0,52.9,2.0,3.6,4.3,-1.6,26.0,68.0,41.0,6.0,142.0,Matches,201,eng ENG,MFFW,19,32,1613.0,50.0,47.2,17.9,18,72.0,4,14,22.0,5,1.66,36.0,20.0,16.0,0.89,0.3,33.7,25.4,8.3,0.46,-0.2,Matches,157.0,eng ENG,MFFW,19.0,17.9,1194.0,14.0,147.0,566.0,491.0,50.0,1194.0,42.0,19.0,45.2,15.0,35.7,759.0,3981.0,1943.0,54.0,40.0,10.0,26.0,23.0,867.0,129.0,Matches,157.0,eng ENG,MFFW,19.0,17.9,1.0,36.0,12.0,33.3,2.01,0.67,0.03,0.08,19.3,0.0,0.0,0.0,2.1,2.1,0.06,-1.1,-1.1,Matches,157.0,eng ENG,MFFW,19.0,32.0,18.0,1613.0,17.9,1.0,2.0,3.0,1.0,0.0,0.0,2.0,0.0,2.1,2.1,3.6,5.7,54.0,142.0,129.0,0.06,0.11,0.17,0.06,0.17,0.12,0.2,0.32,0.12,0.32,Matches,Harvey Elliott,M/AM RLC,19,141,170,England,Liverpool,12,15,15,11,17,12,6,11,6,9,16,11,9,16,13,14,12,15,13,16,13,16,15,9,15,11,16,17,12,14,16,6,11,13,13,11,11,5,13,7,12,3,3,3,3,1,1,1,3,1,1,3,14,15,8,16,14,13,9,12,1,1,1,1,1,1,1,14,18,14,17,15,20,6,170,64,20,7,63795455,7050,7050,5750,Northern_European,141,3,2003/4/4,0,0,52196.0,,29233143
321,Emerson,Tottenham,1999,160.0,br BRA,DF,23.0,19.3,54.0,33.0,38.0,12.0,4.0,27.0,40.0,67.5,13.0,17.0,3.0,14.0,18.0,72.0,75.0,0.0,Matches,160.0,br BRA,DF,23.0,19.3,36.0,1.87,32.0,0.0,0.0,1.0,2.0,1.0,2.0,0.1,2.0,0.0,0.0,0.0,0.0,0.0,Matches,,,,,,,,,,,,,,,,,,,,,,,,,,,,,,,,,,,,,,,,,,,,,,,,,,,,,,,,160.0,br BRA,DF,23.0,19.3,2.0,1.0,0.0,21.0,33.0,0.0,46.0,18.0,33.0,0.0,0.0,0.0,102.0,28.0,27.0,50.9,Matches,160.0,br BRA,DF,23.0,19.3,1060.0,884.0,170.0,23.0,2.0,6.0,46.0,146.0,1.0,0.0,0.0,0.0,848.0,6.0,37.0,Matches,160.0,br BRA,DF,23.0,19.3,848.0,1060.0,80.0,13378.0,3797.0,437.0,482.0,90.7,330.0,392.0,84.2,53.0,93.0,57.0,1.0,0.6,1.0,0.4,9.0,58.0,17.0,3.0,80.0,Matches,204,br BRA,DF,23,26,1735.0,67.0,50.7,19.3,20,82.0,12,6,15.0,2,1.73,34.0,26.0,8.0,0.41,0.47,27.7,21.1,6.6,0.34,0.29,Matches,160.0,br BRA,DF,23.0,19.3,1323.0,101.0,481.0,505.0,346.0,46.0,1323.0,31.0,15.0,48.4,9.0,29.0,672.0,3662.0,2046.0,47.0,32.0,6.0,22.0,19.0,775.0,103.0,Matches,160.0,br BRA,DF,23.0,19.3,2.0,17.0,6.0,35.3,0.88,0.31,0.12,0.33,16.6,0.0,0.0,0.0,1.7,1.7,0.1,0.3,0.3,Matches,160.0,br BRA,DF,23.0,26.0,20.0,1735.0,19.3,2.0,1.0,3.0,2.0,0.0,0.0,2.0,1.0,1.7,1.7,0.6,2.3,47.0,80.0,103.0,0.1,0.05,0.16,0.1,0.16,0.09,0.03,0.12,0.09,0.12,Matches,Emerson,D RL,27,139,158,"Italy,Brazil",West Ham United,12,14,14,7,15,10,9,14,10,12,12,4,14,14,11,13,12,12,12,12,11,14,14,8,15,12,13,14,16,15,15,9,13,15,14,13,13,11,9,5,13,2,3,1,1,2,2,2,3,1,2,1,8,12,9,13,10,14,13,12,1,20,1,15,15,12,1,14,10,10,1,1,1,1,176,77,20,10,37578710,7150,7250,5750,Mixed_Race,136,10,1994/8/3,27,0,110192.0,,19158043
322,Christian Eriksen,Manchester Utd,1992,162.0,dk DEN,MF,30.0,22.8,22.0,18.0,10.0,7.0,5.0,10.0,33.0,30.3,23.0,23.0,9.0,14.0,11.0,33.0,20.0,1.0,Matches,162.0,dk DEN,MF,30.0,22.8,71.0,3.12,50.0,17.0,1.0,3.0,0.0,0.0,9.0,0.4,6.0,3.0,0.0,0.0,0.0,0.0,Matches,,,,,,,,,,,,,,,,,,,,,,,,,,,,,,,,,,,,,,,,,,,,,,,,,,,,,,,,162.0,dk DEN,MF,30.0,22.8,3.0,0.0,0.0,13.0,10.0,3.0,81.0,11.0,18.0,0.0,0.0,0.0,151.0,9.0,13.0,40.9,Matches,162.0,dk DEN,MF,30.0,22.8,1485.0,1373.0,106.0,32.0,9.0,20.0,81.0,7.0,62.0,27.0,16.0,2.0,1203.0,6.0,28.0,Matches,162.0,dk DEN,MF,30.0,22.8,1203.0,1485.0,81.0,19681.0,6193.0,629.0,700.0,89.9,429.0,502.0,85.5,105.0,198.0,53.0,8.0,4.2,3.4,3.8,36.0,149.0,27.0,5.0,164.0,Matches,206,dk DEN,MF,30,28,2048.0,73.0,59.9,22.8,25,80.0,7,3,14.0,1,2.14,33.0,25.0,8.0,0.35,-0.11,36.6,26.0,10.7,0.47,0.03,Matches,162.0,dk DEN,MF,30.0,22.8,1644.0,43.0,269.0,914.0,465.0,35.0,1644.0,17.0,8.0,47.1,9.0,52.9,967.0,3499.0,1756.0,23.0,24.0,3.0,24.0,19.0,1220.0,66.0,Matches,162.0,dk DEN,MF,30.0,22.8,1.0,39.0,11.0,28.2,1.71,0.48,0.03,0.09,19.3,4.0,0.0,0.0,5.0,5.0,0.13,-4.0,-4.0,Matches,162.0,dk DEN,MF,30.0,28.0,25.0,2048.0,22.8,1.0,8.0,9.0,1.0,0.0,0.0,3.0,0.0,5.0,5.0,4.2,9.2,23.0,164.0,66.0,0.04,0.35,0.4,0.04,0.4,0.22,0.19,0.4,0.22,0.4,Matches,Christian Eriksen,DM/M/AM C,30,161,170,Denmark,Manchester UFC,16,16,12,14,18,17,4,14,3,5,17,16,6,17,7,15,8,15,15,17,17,16,14,8,15,12,17,16,12,12,12,8,17,11,15,7,14,3,17,4,13,3,3,3,3,3,1,3,1,2,4,1,8,16,2,15,15,18,18,19,1,1,1,1,1,1,17,12,20,12,14,19,13,1,182,76,15,20,192148791,8050,8458,7400,Northern_European,153,1,1992/2/14,115,38,197186.0,,27010680
323,Pervis Estupiñán,Brighton,1998,163.0,ec ECU,DF,24.0,29.7,61.0,31.0,36.0,19.0,6.0,35.0,60.0,58.3,25.0,30.0,8.0,22.0,37.0,98.0,37.0,1.0,Matches,163.0,ec ECU,DF,24.0,29.7,87.0,2.93,78.0,4.0,3.0,0.0,2.0,0.0,8.0,0.27,7.0,0.0,0.0,0.0,1.0,0.0,Matches,,,,,,,,,,,,,,,,,,,,,,,,,,,,,,,,,,,,,,,,,,,,,,,,,,,,,,,,163.0,ec ECU,DF,24.0,29.7,4.0,0.0,0.0,42.0,26.0,11.0,101.0,37.0,31.0,1.0,1.0,0.0,191.0,36.0,28.0,56.3,Matches,163.0,ec ECU,DF,24.0,29.7,1926.0,1687.0,234.0,31.0,5.0,8.0,101.0,199.0,4.0,0.0,3.0,0.0,1576.0,5.0,57.0,Matches,163.0,ec ECU,DF,24.0,29.7,1576.0,1926.0,81.8,22843.0,7059.0,922.0,1017.0,90.7,545.0,661.0,82.5,60.0,110.0,54.5,5.0,5.4,4.1,-0.4,51.0,103.0,44.0,19.0,157.0,Matches,207,ec ECU,DF,24,35,2675.0,76.0,78.2,29.7,31,83.0,20,4,25.0,1,1.63,59.0,43.0,16.0,0.54,0.18,58.3,40.7,17.6,0.59,-0.08,Matches,163.0,ec ECU,DF,24.0,29.7,2211.0,82.0,506.0,1076.0,649.0,71.0,2211.0,42.0,19.0,45.2,18.0,42.9,1292.0,6134.0,3440.0,91.0,55.0,15.0,38.0,29.0,1434.0,183.0,Matches,163.0,ec ECU,DF,24.0,29.7,1.0,29.0,4.0,13.8,0.98,0.13,0.03,0.25,19.3,0.0,0.0,0.0,1.7,1.7,0.06,-0.7,-0.7,Matches,163.0,ec ECU,DF,24.0,35.0,31.0,2675.0,29.7,1.0,5.0,6.0,1.0,0.0,0.0,4.0,0.0,1.7,1.7,5.4,7.1,91.0,157.0,183.0,0.03,0.17,0.2,0.03,0.2,0.06,0.18,0.24,0.06,0.24,Matches,Pervis Estupiñán,D/WB/M L,24,140,156,"Ecuador,Spain",Brighton & Hove Albion,6,14,13,7,14,7,10,7,14,11,11,12,13,13,5,11,12,13,10,11,11,13,12,10,16,11,14,13,15,12,13,10,16,15,18,11,12,12,10,5,14,3,1,3,4,1,2,1,3,3,1,1,18,12,8,10,11,10,11,13,1,20,10,1,18,1,1,16,1,1,14,1,1,1,175,73,20,10,35789250,7000,7000,4750,African_Caribbean,126,16,1998/1/21,28,3,69595.0,,86045976
324,Jonny Evans,Leicester City,1988,164.0,nir NIR,DF,34.0,11.7,13.0,5.0,12.0,1.0,0.0,7.0,11.0,63.6,4.0,15.0,11.0,4.0,18.0,31.0,51.0,0.0,Matches,164.0,nir NIR,DF,34.0,11.7,4.0,0.34,4.0,0.0,0.0,0.0,0.0,0.0,0.0,0.0,0.0,0.0,0.0,0.0,0.0,0.0,Matches,,,,,,,,,,,,,,,,,,,,,,,,,,,,,,,,,,,,,,,,,,,,,,,,,,,,,,,,164.0,nir NIR,DF,34.0,11.7,1.0,0.0,0.0,9.0,7.0,1.0,0.0,18.0,5.0,0.0,0.0,0.0,60.0,26.0,13.0,66.7,Matches,164.0,nir NIR,DF,34.0,11.7,789.0,764.0,24.0,23.0,0.0,2.0,0.0,1.0,0.0,0.0,0.0,0.0,690.0,1.0,4.0,Matches,164.0,nir NIR,DF,34.0,11.7,690.0,789.0,87.5,13684.0,5215.0,211.0,227.0,93.0,400.0,430.0,93.0,73.0,114.0,64.0,0.0,0.0,0.2,0.0,1.0,43.0,2.0,0.0,35.0,Matches,208,nir NIR,DF,34,13,1051.0,81.0,30.7,11.7,12,88.0,10,1,1.0,3,0.62,17.0,28.0,-11.0,-0.94,-0.71,12.0,19.6,-7.6,-0.65,-0.46,Matches,164.0,nir NIR,DF,34.0,11.7,906.0,137.0,474.0,424.0,9.0,2.0,906.0,0.0,0.0,,0.0,,529.0,2218.0,1206.0,6.0,4.0,0.0,5.0,0.0,629.0,0.0,Matches,164.0,nir NIR,DF,34.0,11.7,0.0,1.0,1.0,100.0,0.09,0.09,0.0,0.0,3.8,0.0,0.0,0.0,0.2,0.2,0.17,-0.2,-0.2,Matches,164.0,nir NIR,DF,34.0,13.0,12.0,1051.0,11.7,0.0,0.0,0.0,0.0,0.0,0.0,1.0,0.0,0.2,0.2,0.0,0.2,6.0,35.0,0.0,0.0,0.0,0.0,0.0,0.0,0.01,0.0,0.01,0.01,0.01,Matches,Jonny Evans,D C,34,148,155,Northern Ireland,Leicester City,4,5,10,6,12,4,15,3,9,16,12,5,16,13,12,17,14,15,15,13,13,15,3,15,6,15,14,14,12,11,15,15,11,10,13,15,17,8,14,12,15,2,2,3,1,2,4,1,3,1,1,1,16,14,6,16,14,15,16,18,1,12,20,11,1,1,1,1,1,1,1,1,1,1,188,77,16,20,3656453,7400,7750,6000,Northern_European,148,4,1988/1/3,98,5,115992.0,,5005078
325,Łukasz Fabiański,West Ham,1985,166.0,pl POL,GK,37.0,34.6,2.0,0.0,2.0,0.0,0.0,1.0,2.0,50.0,1.0,1.0,0.0,1.0,0.0,2.0,10.0,1.0,Matches,166.0,pl POL,GK,37.0,34.6,2.0,0.06,0.0,2.0,0.0,0.0,0.0,0.0,0.0,0.0,0.0,0.0,0.0,0.0,0.0,0.0,Matches,9.0,pl POL,GK,37.0,34.6,48.0,2.0,0.0,3.0,1.0,45.9,0.28,-1.1,-0.03,198.0,516.0,38.4,677.0,153.0,54.2,39.3,249.0,59.8,44.8,513.0,29.0,5.7,25.0,0.72,13.0,Matches,9.0,pl POL,GK,37.0,36.0,36.0,3111.0,34.6,48.0,1.39,154.0,106.0,70.1,11.0,6.0,19.0,8.0,22.2,4.0,2.0,1.0,1.0,33.3,Matches,166.0,pl POL,GK,37.0,34.6,1.0,0.0,0.0,0.0,4.0,0.0,0.0,0.0,0.0,0.0,0.0,0.0,17.0,15.0,1.0,93.8,Matches,166.0,pl POL,GK,37.0,34.6,930.0,587.0,339.0,90.0,0.0,2.0,0.0,0.0,0.0,0.0,0.0,0.0,598.0,4.0,0.0,Matches,166.0,pl POL,GK,37.0,34.6,598.0,930.0,64.3,18882.0,15094.0,117.0,117.0,100.0,225.0,228.0,98.7,254.0,579.0,43.9,0.0,0.0,0.0,0.0,0.0,12.0,0.0,0.0,0.0,Matches,210,pl POL,GK,37,36,3111.0,86.0,91.0,34.6,36,86.0,33,0,,0,1.08,37.0,48.0,-11.0,-0.32,0.26,43.9,45.5,-1.7,-0.05,0.59,Matches,166.0,pl POL,GK,37.0,34.6,1005.0,871.0,1000.0,5.0,0.0,0.0,1005.0,0.0,0.0,,0.0,,506.0,3330.0,2146.0,0.0,0.0,0.0,3.0,0.0,350.0,0.0,Matches,166.0,pl POL,GK,37.0,34.6,0.0,0.0,0.0,,0.0,0.0,,,,0.0,0.0,0.0,0.0,0.0,,0.0,0.0,Matches,166.0,pl POL,GK,37.0,36.0,36.0,3111.0,34.6,0.0,0.0,0.0,0.0,0.0,0.0,1.0,0.0,0.0,0.0,0.0,0.0,0.0,0.0,0.0,0.0,0.0,0.0,0.0,0.0,0.0,0.0,0.0,0.0,0.0,Matches,Łukasz Fabiański,GK,37,140,154,Poland,West Ham United,2,3,2,1,8,7,11,3,3,7,11,4,13,7,10,13,12,16,18,10,12,15,5,8,4,15,14,13,9,15,12,15,13,8,10,13,17,3,15,10,11,13,13,14,7,15,12,15,16,14,12,14,16,14,6,13,10,18,18,19,20,1,1,1,1,1,1,1,1,1,1,1,1,1,190,83,5,20,2139468,7050,7700,6250,Northern_European,139,1,1985/4/18,57,0,69595.0,,718272
326,Wout Faes,Leicester City,1998,168.0,be BEL,DF,24.0,31.0,56.0,33.0,28.0,26.0,2.0,28.0,44.0,63.6,16.0,53.0,37.0,16.0,41.0,97.0,113.0,2.0,Matches,168.0,be BEL,DF,24.0,31.0,22.0,0.71,16.0,0.0,1.0,3.0,0.0,2.0,4.0,0.13,3.0,0.0,0.0,0.0,0.0,1.0,Matches,,,,,,,,,,,,,,,,,,,,,,,,,,,,,,,,,,,,,,,,,,,,,,,,,,,,,,,,168.0,be BEL,DF,24.0,31.0,6.0,1.0,1.0,23.0,17.0,0.0,0.0,41.0,33.0,0.0,0.0,2.0,184.0,58.0,41.0,58.6,Matches,168.0,be BEL,DF,24.0,31.0,1846.0,1789.0,54.0,48.0,2.0,9.0,0.0,1.0,0.0,0.0,0.0,0.0,1581.0,3.0,10.0,Matches,168.0,be BEL,DF,24.0,31.0,1581.0,1846.0,85.6,29211.0,10369.0,593.0,654.0,90.7,859.0,939.0,91.5,116.0,218.0,53.2,2.0,0.6,0.6,1.4,9.0,70.0,5.0,0.0,74.0,Matches,212,be BEL,DF,24,31,2786.0,90.0,81.5,31.0,31,90.0,30,0,,0,1.03,42.0,51.0,-9.0,-0.29,0.84,43.1,52.3,-9.2,-0.3,0.21,Matches,168.0,be BEL,DF,24.0,31.0,2177.0,357.0,1230.0,916.0,44.0,19.0,2177.0,12.0,9.0,75.0,3.0,25.0,1262.0,6476.0,3606.0,11.0,7.0,0.0,15.0,5.0,1436.0,2.0,Matches,168.0,be BEL,DF,24.0,31.0,1.0,13.0,3.0,23.1,0.42,0.1,0.08,0.33,11.8,0.0,0.0,0.0,1.2,1.2,0.09,-0.2,-0.2,Matches,168.0,be BEL,DF,24.0,31.0,31.0,2786.0,31.0,1.0,2.0,3.0,1.0,0.0,0.0,6.0,1.0,1.2,1.2,0.6,1.8,11.0,74.0,2.0,0.03,0.06,0.1,0.03,0.1,0.04,0.02,0.06,0.04,0.06,Matches,Wout Faes,D C,24,135,144,Belgium,Leicester City,8,10,11,6,12,8,14,8,5,15,13,5,15,12,13,17,14,14,13,14,12,14,8,15,8,14,14,15,12,12,13,14,12,12,14,13,14,15,12,6,10,1,2,1,2,2,3,3,1,4,1,2,11,15,4,13,12,11,12,17,1,1,20,1,1,1,14,1,10,1,1,1,1,1,187,84,7,20,18501541,6600,6600,4500,Northern_European,135,5,1998/4/3,1,0,69595.0,,18083577
327,Felipe,Nott'ham Forest,1989,169.0,br BRA,DF,33.0,15.8,42.0,23.0,29.0,13.0,0.0,24.0,41.0,58.5,17.0,34.0,13.0,21.0,36.0,78.0,90.0,0.0,Matches,169.0,br BRA,DF,33.0,15.8,15.0,0.95,10.0,0.0,0.0,4.0,1.0,0.0,1.0,0.06,1.0,0.0,0.0,0.0,0.0,0.0,Matches,,,,,,,,,,,,,,,,,,,,,,,,,,,,,,,,,,,,,,,,,,,,,,,,,,,,,,,,169.0,br BRA,DF,33.0,15.8,4.0,0.0,0.0,15.0,11.0,4.0,2.0,36.0,23.0,0.0,0.0,0.0,108.0,52.0,30.0,63.4,Matches,169.0,br BRA,DF,33.0,15.8,568.0,545.0,20.0,13.0,0.0,3.0,2.0,7.0,0.0,0.0,0.0,0.0,411.0,3.0,11.0,Matches,169.0,br BRA,DF,33.0,15.8,411.0,568.0,72.4,7998.0,3250.0,154.0,187.0,82.4,198.0,240.0,82.5,50.0,112.0,44.6,1.0,0.9,0.8,0.1,7.0,17.0,2.0,0.0,22.0,Matches,213,br BRA,DF,33,16,1418.0,89.0,41.5,15.8,15,89.0,13,1,84.0,1,0.81,20.0,32.0,-12.0,-0.76,0.05,15.2,31.2,-16.0,-1.02,-0.62,Matches,169.0,br BRA,DF,33.0,15.8,798.0,163.0,477.0,275.0,59.0,36.0,798.0,18.0,14.0,77.8,3.0,16.7,391.0,2137.0,1182.0,3.0,3.0,0.0,12.0,4.0,386.0,4.0,Matches,169.0,br BRA,DF,33.0,15.8,0.0,13.0,1.0,7.7,0.83,0.06,0.0,0.0,9.0,0.0,0.0,0.0,1.2,1.2,0.09,-1.2,-1.2,Matches,169.0,br BRA,DF,33.0,16.0,15.0,1418.0,15.8,0.0,1.0,1.0,0.0,0.0,0.0,4.0,0.0,1.2,1.2,0.9,2.1,3.0,22.0,4.0,0.0,0.06,0.06,0.0,0.06,0.07,0.06,0.13,0.07,0.13,Matches,Felipe,D C,33,148,152,Brazil,A. Madrid,6,6,10,8,11,7,16,7,7,16,12,11,15,12,18,15,16,12,14,9,13,16,7,17,10,14,14,15,12,13,15,16,17,13,13,16,14,16,14,10,12,2,2,3,1,3,2,1,3,1,3,2,13,14,13,12,14,16,6,8,1,1,20,13,1,1,12,1,1,1,1,1,1,1,191,87,8,20,9281976,7300,7600,6100,Northern_European,147,5,1989/5/16,2,0,86538.0,,19162578
328,João Félix,Chelsea,1999,170.0,pt POR,FWMF,22.0,10.5,14.0,7.0,5.0,6.0,3.0,4.0,12.0,33.3,8.0,3.0,0.0,3.0,1.0,15.0,1.0,1.0,Matches,170.0,pt POR,FWMF,22.0,10.5,31.0,2.96,13.0,2.0,6.0,4.0,6.0,0.0,1.0,0.1,1.0,0.0,0.0,0.0,0.0,0.0,Matches,,,,,,,,,,,,,,,,,,,,,,,,,,,,,,,,,,,,,,,,,,,,,,,,,,,,,,,,170.0,pt POR,FWMF,22.0,10.5,1.0,1.0,0.0,15.0,29.0,7.0,19.0,1.0,7.0,0.0,0.0,0.0,23.0,3.0,14.0,17.6,Matches,170.0,pt POR,FWMF,22.0,10.5,356.0,314.0,39.0,5.0,5.0,4.0,19.0,5.0,12.0,2.0,9.0,0.0,274.0,3.0,9.0,Matches,170.0,pt POR,FWMF,22.0,10.5,274.0,356.0,77.0,4034.0,1122.0,172.0,194.0,88.7,74.0,101.0,73.3,20.0,39.0,51.3,0.0,0.5,1.0,-0.5,7.0,29.0,17.0,1.0,47.0,Matches,214,pt POR,FWMF,22,16,941.0,59.0,27.5,10.5,11,75.0,3,5,22.0,1,0.88,11.0,15.0,-4.0,-0.38,-0.2,17.7,13.4,4.3,0.41,0.67,Matches,170.0,pt POR,FWMF,22.0,10.5,497.0,0.0,30.0,223.0,249.0,46.0,497.0,60.0,22.0,36.7,28.0,46.7,326.0,2092.0,1099.0,34.0,40.0,9.0,22.0,8.0,399.0,79.0,Matches,170.0,pt POR,FWMF,22.0,10.5,4.0,46.0,16.0,34.8,4.4,1.53,0.09,0.25,18.0,3.0,0.0,0.0,4.9,4.9,0.11,-0.9,-0.9,Matches,170.0,pt POR,FWMF,22.0,16.0,11.0,941.0,10.5,4.0,0.0,4.0,4.0,0.0,0.0,1.0,1.0,4.9,4.9,0.5,5.4,34.0,47.0,79.0,0.38,0.0,0.38,0.38,0.38,0.47,0.05,0.52,0.47,0.52,Matches,João Félix,AM/S RLC,22,159,177,Portugal,A. Madrid,11,12,17,15,16,12,12,13,4,4,17,14,7,18,14,15,11,15,13,16,16,16,19,7,18,6,12,11,13,15,13,9,14,12,12,9,12,14,15,9,8,2,1,2,1,1,3,1,2,1,4,2,15,18,13,8,17,15,10,10,1,1,1,1,1,1,1,12,10,12,18,20,15,19,178,74,15,20,95220000,7800,7800,7200,Mediterranean_Hispanic,152,8,1999/11/10,22,3,180287.0,,83169822
329,Evan Ferguson,Brighton,2004,171.0,ie IRL,FW,17.0,10.6,6.0,3.0,1.0,3.0,2.0,1.0,7.0,14.3,6.0,11.0,1.0,10.0,2.0,8.0,6.0,0.0,Matches,171.0,ie IRL,FW,17.0,10.6,22.0,2.08,15.0,0.0,1.0,6.0,0.0,0.0,2.0,0.19,2.0,0.0,0.0,0.0,0.0,0.0,Matches,,,,,,,,,,,,,,,,,,,,,,,,,,,,,,,,,,,,,,,,,,,,,,,,,,,,,,,,171.0,ie IRL,FW,17.0,10.6,1.0,0.0,0.0,9.0,11.0,5.0,2.0,2.0,3.0,0.0,0.0,0.0,25.0,9.0,14.0,39.1,Matches,171.0,ie IRL,FW,17.0,10.6,225.0,203.0,21.0,0.0,1.0,0.0,2.0,0.0,0.0,0.0,0.0,0.0,180.0,1.0,3.0,Matches,171.0,ie IRL,FW,17.0,10.6,180.0,225.0,80.0,2299.0,340.0,131.0,153.0,85.6,42.0,52.0,80.8,4.0,7.0,57.1,2.0,0.7,0.5,1.3,11.0,4.0,6.0,0.0,14.0,Matches,215,ie IRL,FW,17,19,950.0,50.0,27.8,10.6,10,70.0,1,9,28.0,2,1.63,21.0,12.0,9.0,0.85,0.49,23.3,13.1,10.2,0.97,0.5,Matches,171.0,ie IRL,FW,17.0,10.6,344.0,10.0,27.0,165.0,155.0,39.0,344.0,14.0,8.0,57.1,5.0,35.7,203.0,884.0,309.0,11.0,4.0,8.0,29.0,20.0,256.0,58.0,Matches,171.0,ie IRL,FW,17.0,10.6,6.0,36.0,17.0,47.2,3.41,1.61,0.17,0.35,15.2,0.0,0.0,0.0,5.3,5.3,0.15,0.7,0.7,Matches,171.0,ie IRL,FW,17.0,19.0,10.0,950.0,10.6,6.0,2.0,8.0,6.0,0.0,0.0,1.0,0.0,5.3,5.3,0.7,6.1,11.0,14.0,58.0,0.57,0.19,0.76,0.57,0.76,0.51,0.07,0.57,0.51,0.57,Matches,Evan Ferguson,S,17,106,-8,"Republic of Ireland,England",Brighton & Hove Albion,10,7,6,14,10,7,12,11,8,7,11,4,6,9,11,10,13,10,9,11,11,6,7,8,9,6,11,14,15,7,13,12,6,13,14,13,18,7,17,5,10,3,3,2,1,1,1,2,2,1,1,3,14,11,2,11,10,11,12,12,1,1,1,1,1,1,1,1,1,1,1,1,1,20,183,0,14,20,49180496,5296,5296,3000,Northern_European,102,1,2004/10/19,0,0,6960.0,,2000120742
330,Bruno Fernandes,Manchester Utd,1994,172.0,pt POR,MFFW,27.0,36.8,68.0,42.0,24.0,25.0,19.0,30.0,71.0,42.3,41.0,37.0,5.0,32.0,25.0,93.0,40.0,1.0,Matches,172.0,pt POR,MFFW,27.0,36.8,219.0,5.94,164.0,26.0,8.0,12.0,9.0,0.0,18.0,0.49,16.0,0.0,0.0,1.0,1.0,0.0,Matches,,,,,,,,,,,,,,,,,,,,,,,,,,,,,,,,,,,,,,,,,,,,,,,,,,,,,,,,172.0,pt POR,MFFW,27.0,36.8,6.0,0.0,0.0,42.0,39.0,15.0,141.0,25.0,42.0,1.0,0.0,0.0,222.0,18.0,43.0,29.5,Matches,172.0,pt POR,MFFW,27.0,36.8,2030.0,1838.0,182.0,32.0,35.0,36.0,141.0,24.0,83.0,20.0,23.0,2.0,1498.0,10.0,65.0,Matches,172.0,pt POR,MFFW,27.0,36.8,1498.0,2030.0,73.8,25425.0,8933.0,767.0,897.0,85.5,495.0,633.0,78.2,181.0,331.0,54.7,8.0,16.7,10.7,-8.7,119.0,148.0,89.0,10.0,263.0,Matches,216,pt POR,MFFW,27,37,3316.0,90.0,97.0,36.8,37,90.0,33,0,,0,2.03,57.0,39.0,18.0,0.49,3.08,65.9,49.2,16.7,0.45,-0.04,Matches,172.0,pt POR,MFFW,27.0,36.8,2408.0,68.0,386.0,966.0,1078.0,149.0,2406.0,66.0,32.0,48.5,28.0,42.4,1385.0,6213.0,3272.0,89.0,68.0,28.0,42.0,42.0,1689.0,231.0,Matches,172.0,pt POR,MFFW,27.0,36.8,8.0,90.0,32.0,35.6,2.44,0.87,0.07,0.19,20.8,6.0,2.0,2.0,9.3,7.7,0.09,-1.3,-1.7,Matches,172.0,pt POR,MFFW,27.0,37.0,37.0,3316.0,36.8,8.0,8.0,16.0,6.0,2.0,2.0,6.0,0.0,9.3,7.7,16.7,24.4,89.0,263.0,231.0,0.22,0.22,0.43,0.16,0.38,0.25,0.45,0.71,0.21,0.66,Matches,Bruno Fernandes,M/AM C,27,166,174,Portugal,Manchester UFC,16,16,11,15,17,16,10,16,4,3,17,19,8,17,18,16,17,15,14,18,10,17,17,17,17,6,15,15,13,15,13,9,18,14,19,10,12,13,13,3,15,1,1,2,3,3,3,1,1,3,1,1,18,15,5,13,14,17,6,7,1,1,1,1,1,1,1,10,16,10,12,20,14,10,179,69,13,20,265261481,8300,8500,7750,Mediterranean_Hispanic,165,6,1994/9/8,46,8,289979.0,,43124203
331,Enzo Fernández,Chelsea,2001,173.0,ar ARG,MF,21.0,17.2,45.0,27.0,25.0,17.0,3.0,21.0,56.0,37.5,35.0,32.0,2.0,30.0,16.0,61.0,12.0,1.0,Matches,173.0,ar ARG,MF,21.0,17.2,59.0,3.43,49.0,6.0,0.0,2.0,2.0,0.0,6.0,0.35,6.0,0.0,0.0,0.0,0.0,0.0,Matches,,,,,,,,,,,,,,,,,,,,,,,,,,,,,,,,,,,,,,,,,,,,,,,,,,,,,,,,173.0,ar ARG,MF,21.0,17.2,3.0,0.0,0.0,11.0,22.0,1.0,14.0,16.0,27.0,0.0,0.0,0.0,118.0,7.0,10.0,41.2,Matches,173.0,ar ARG,MF,21.0,17.2,1440.0,1381.0,56.0,51.0,11.0,17.0,14.0,2.0,3.0,1.0,1.0,0.0,1269.0,3.0,13.0,Matches,173.0,ar ARG,MF,21.0,17.2,1269.0,1440.0,88.1,24396.0,7284.0,504.0,549.0,91.8,546.0,604.0,90.4,193.0,240.0,80.4,2.0,2.4,2.7,-0.4,20.0,164.0,25.0,0.0,168.0,Matches,217,ar ARG,MF,21,18,1547.0,86.0,45.2,17.2,18,86.0,14,0,,0,0.83,16.0,25.0,-9.0,-0.52,-0.52,24.8,24.1,0.7,0.04,0.22,Matches,173.0,ar ARG,MF,21.0,17.2,1616.0,45.0,351.0,1000.0,280.0,9.0,1616.0,32.0,17.0,53.1,13.0,40.6,1097.0,4757.0,2023.0,22.0,28.0,1.0,25.0,13.0,1257.0,18.0,Matches,173.0,ar ARG,MF,21.0,17.2,0.0,20.0,3.0,15.0,1.16,0.17,0.0,0.0,25.7,2.0,0.0,0.0,0.8,0.8,0.04,-0.8,-0.8,Matches,173.0,ar ARG,MF,21.0,18.0,18.0,1547.0,17.2,0.0,2.0,2.0,0.0,0.0,0.0,3.0,0.0,0.8,0.8,2.4,3.2,22.0,168.0,18.0,0.0,0.12,0.12,0.0,0.12,0.05,0.14,0.19,0.05,0.19,Matches,Enzo Fernández,DM/M C,21,150,164,Argentina,SL Benfica,10,10,13,12,14,9,7,16,8,10,16,13,13,15,15,13,10,11,13,16,13,14,14,11,17,14,15,13,12,14,15,10,15,12,16,13,15,7,13,4,9,3,2,3,2,3,2,3,1,3,3,2,18,13,5,10,17,15,13,12,1,1,1,1,1,1,18,1,20,1,1,15,1,1,178,70,13,20,36600000,7500,6800,6500,Mediterranean_Hispanic,148,5,2001/1/17,2,0,27510.0,,14229525
332,Roberto Firmino,Liverpool,1991,174.0,br BRA,FWMF,30.0,13.5,17.0,12.0,2.0,12.0,3.0,4.0,22.0,18.2,18.0,16.0,1.0,15.0,7.0,24.0,2.0,0.0,Matches,174.0,br BRA,FWMF,30.0,13.5,46.0,3.41,36.0,0.0,4.0,6.0,0.0,0.0,7.0,0.52,4.0,0.0,1.0,2.0,0.0,0.0,Matches,,,,,,,,,,,,,,,,,,,,,,,,,,,,,,,,,,,,,,,,,,,,,,,,,,,,,,,,174.0,br BRA,FWMF,30.0,13.5,0.0,0.0,0.0,9.0,6.0,5.0,12.0,7.0,12.0,0.0,0.0,0.0,64.0,15.0,30.0,33.3,Matches,174.0,br BRA,FWMF,30.0,13.5,566.0,548.0,16.0,1.0,8.0,0.0,12.0,6.0,0.0,0.0,0.0,0.0,444.0,2.0,21.0,Matches,174.0,br BRA,FWMF,30.0,13.5,444.0,566.0,78.4,5932.0,1908.0,277.0,324.0,85.5,123.0,155.0,79.4,18.0,26.0,69.2,4.0,2.5,2.2,1.5,21.0,47.0,19.0,1.0,78.0,Matches,219,br BRA,FWMF,30,25,1213.0,49.0,35.5,13.5,13,73.0,3,12,22.0,0,1.64,28.0,17.0,11.0,0.82,0.12,24.0,19.6,4.3,0.32,-0.39,Matches,174.0,br BRA,FWMF,30.0,13.5,735.0,3.0,69.0,375.0,295.0,84.0,735.0,24.0,13.0,54.2,10.0,41.7,423.0,1757.0,742.0,16.0,14.0,7.0,38.0,23.0,565.0,96.0,Matches,174.0,br BRA,FWMF,30.0,13.5,11.0,39.0,25.0,64.1,2.89,1.85,0.28,0.44,12.3,0.0,0.0,0.0,5.5,5.5,0.14,5.5,5.5,Matches,174.0,br BRA,FWMF,30.0,25.0,13.0,1213.0,13.5,11.0,4.0,15.0,11.0,0.0,0.0,0.0,0.0,5.5,5.5,2.5,8.0,16.0,78.0,96.0,0.82,0.3,1.11,0.82,1.11,0.41,0.19,0.59,0.41,0.59,Matches,Roberto Firmino,AM/S RLC,30,155,175,Brazil,Liverpool,8,12,14,11,17,8,12,10,7,13,13,12,12,18,13,15,11,17,13,16,13,13,16,8,15,13,18,16,13,15,17,10,17,13,16,14,13,7,14,8,11,3,2,1,2,3,2,1,1,2,3,1,16,14,6,16,15,15,13,16,1,1,1,1,1,1,1,1,1,1,16,18,16,20,181,76,8,20,45779196,7850,8150,7500,Mixed_Race,147,10,1991/10/2,55,17,208785.0,,19068857
333,Phil Foden,Manchester City,2000,176.0,eng ENG,FW,22.0,20.5,16.0,10.0,9.0,5.0,2.0,8.0,19.0,42.1,11.0,25.0,2.0,23.0,5.0,21.0,12.0,0.0,Matches,176.0,eng ENG,FW,22.0,20.5,99.0,4.83,76.0,9.0,6.0,5.0,3.0,0.0,14.0,0.68,10.0,0.0,3.0,0.0,1.0,0.0,Matches,,,,,,,,,,,,,,,,,,,,,,,,,,,,,,,,,,,,,,,,,,,,,,,,,,,,,,,,176.0,eng ENG,FW,22.0,20.5,1.0,0.0,0.0,10.0,29.0,6.0,91.0,5.0,10.0,1.0,0.0,0.0,91.0,19.0,26.0,42.2,Matches,176.0,eng ENG,FW,22.0,20.5,1111.0,1046.0,61.0,9.0,4.0,4.0,91.0,13.0,39.0,4.0,26.0,2.0,904.0,4.0,32.0,Matches,176.0,eng ENG,FW,22.0,20.5,904.0,1111.0,81.4,13670.0,2403.0,527.0,577.0,91.3,287.0,343.0,83.7,55.0,103.0,53.4,6.0,4.7,4.8,1.3,43.0,38.0,37.0,9.0,88.0,Matches,221,eng ENG,FW,22,32,1842.0,58.0,53.9,20.5,22,77.0,11,10,15.0,1,2.31,49.0,16.0,33.0,1.61,0.02,39.6,17.7,21.9,1.07,-0.33,Matches,176.0,eng ENG,FW,22.0,20.5,1324.0,20.0,116.0,433.0,790.0,131.0,1324.0,81.0,40.0,49.4,31.0,38.3,891.0,4578.0,2141.0,68.0,43.0,25.0,34.0,29.0,1051.0,275.0,Matches,176.0,eng ENG,FW,22.0,20.5,11.0,46.0,22.0,47.8,2.25,1.07,0.24,0.5,15.3,1.0,0.0,0.0,5.9,5.9,0.13,5.1,5.1,Matches,176.0,eng ENG,FW,22.0,32.0,22.0,1842.0,20.5,11.0,6.0,17.0,11.0,0.0,0.0,1.0,0.0,5.9,5.9,4.7,10.6,68.0,88.0,275.0,0.54,0.29,0.83,0.54,0.83,0.29,0.23,0.52,0.29,0.52,Matches,Phil Foden,AM RLC,22,163,180,England,Manchester City,13,13,17,14,17,13,8,12,5,8,17,12,8,17,7,14,13,15,15,16,14,14,16,8,16,9,14,16,15,17,15,7,14,16,15,9,15,6,16,4,13,2,3,2,2,1,2,1,3,2,1,3,12,15,12,13,12,14,14,16,1,1,1,1,1,1,1,1,14,1,20,20,17,14,171,64,20,9,147976457,8150,8150,8000,Northern_European,161,3,2000/5/28,16,2,139190.0,,28108494
334,Wesley Fofana,Chelsea,2000,178.0,fr FRA,DF,21.0,13.1,30.0,18.0,19.0,7.0,4.0,13.0,26.0,50.0,13.0,17.0,10.0,7.0,20.0,50.0,33.0,2.0,Matches,178.0,fr FRA,DF,21.0,13.1,13.0,0.99,13.0,0.0,0.0,0.0,0.0,0.0,2.0,0.15,2.0,0.0,0.0,0.0,0.0,0.0,Matches,,,,,,,,,,,,,,,,,,,,,,,,,,,,,,,,,,,,,,,,,,,,,,,,,,,,,,,,178.0,fr FRA,DF,21.0,13.1,3.0,0.0,0.0,11.0,22.0,0.0,3.0,20.0,18.0,0.0,1.0,0.0,67.0,30.0,17.0,63.8,Matches,178.0,fr FRA,DF,21.0,13.1,872.0,842.0,29.0,23.0,0.0,3.0,3.0,6.0,0.0,0.0,0.0,0.0,779.0,1.0,4.0,Matches,178.0,fr FRA,DF,21.0,13.1,779.0,872.0,89.3,12895.0,3325.0,346.0,367.0,94.3,394.0,430.0,91.6,27.0,53.0,50.9,0.0,0.1,0.3,-0.1,2.0,50.0,2.0,0.0,43.0,Matches,223,fr FRA,DF,21,15,1183.0,79.0,34.6,13.1,12,85.0,7,3,54.0,1,1.0,13.0,18.0,-5.0,-0.38,-0.22,17.9,18.9,-0.9,-0.07,0.01,Matches,178.0,fr FRA,DF,21.0,13.1,1013.0,97.0,424.0,509.0,85.0,10.0,1013.0,13.0,8.0,61.5,1.0,7.7,686.0,4197.0,2489.0,29.0,20.0,1.0,9.0,6.0,735.0,12.0,Matches,178.0,fr FRA,DF,21.0,13.1,1.0,6.0,2.0,33.3,0.46,0.15,0.17,0.5,11.4,0.0,0.0,0.0,0.7,0.7,0.12,0.3,0.3,Matches,178.0,fr FRA,DF,21.0,15.0,12.0,1183.0,13.1,1.0,0.0,1.0,1.0,0.0,0.0,3.0,0.0,0.7,0.7,0.1,0.8,29.0,43.0,12.0,0.08,0.0,0.08,0.08,0.08,0.05,0.0,0.06,0.05,0.06,Matches,Wesley Fofana,D C,21,151,180,"France,Mali,Ivory Coast",Chelsea,11,6,12,7,12,10,16,5,12,15,12,5,15,14,12,14,13,14,13,12,12,16,10,10,12,15,13,13,15,13,10,16,16,16,15,15,15,10,15,8,8,3,1,1,4,3,4,2,3,1,2,3,14,16,13,8,12,11,12,12,1,1,20,12,1,1,1,1,1,1,1,1,1,1,190,76,10,20,145047192,7650,7250,5750,African_Caribbean,149,15,2000/12/17,0,0,266781.0,,49037900
335,Pablo Fornals,West Ham,1996,179.0,es ESP,FWMF,26.0,16.7,30.0,15.0,9.0,12.0,9.0,13.0,34.0,38.2,21.0,16.0,2.0,14.0,14.0,44.0,9.0,0.0,Matches,179.0,es ESP,FWMF,26.0,16.7,57.0,3.41,48.0,4.0,1.0,3.0,0.0,1.0,3.0,0.18,2.0,0.0,1.0,0.0,0.0,0.0,Matches,,,,,,,,,,,,,,,,,,,,,,,,,,,,,,,,,,,,,,,,,,,,,,,,,,,,,,,,179.0,es ESP,FWMF,26.0,16.7,0.0,0.0,0.0,14.0,7.0,1.0,59.0,14.0,15.0,0.0,0.0,0.0,130.0,11.0,25.0,30.6,Matches,179.0,es ESP,FWMF,26.0,16.7,771.0,719.0,48.0,6.0,7.0,10.0,59.0,7.0,21.0,18.0,2.0,0.0,557.0,4.0,22.0,Matches,179.0,es ESP,FWMF,26.0,16.7,557.0,771.0,72.2,9313.0,2676.0,261.0,300.0,87.0,208.0,277.0,75.1,61.0,124.0,49.2,1.0,1.7,2.0,-0.7,20.0,60.0,12.0,4.0,89.0,Matches,224,es ESP,FWMF,26,32,1503.0,47.0,43.9,16.7,17,75.0,3,15,16.0,6,1.09,18.0,28.0,-10.0,-0.6,-0.46,19.7,24.6,-5.0,-0.3,-0.35,Matches,179.0,es ESP,FWMF,26.0,16.7,917.0,16.0,144.0,424.0,360.0,36.0,917.0,23.0,12.0,52.2,10.0,43.5,500.0,2480.0,1255.0,33.0,24.0,12.0,21.0,15.0,616.0,101.0,Matches,179.0,es ESP,FWMF,26.0,16.7,3.0,27.0,7.0,25.9,1.62,0.42,0.11,0.43,22.6,0.0,0.0,0.0,2.2,2.2,0.08,0.8,0.8,Matches,179.0,es ESP,FWMF,26.0,32.0,17.0,1503.0,16.7,3.0,1.0,4.0,3.0,0.0,0.0,0.0,0.0,2.2,2.2,1.7,3.9,33.0,89.0,101.0,0.18,0.06,0.24,0.18,0.24,0.13,0.1,0.24,0.13,0.24,Matches,Pablo Fornals,M/AM LC,26,144,165,Spain,West Ham United,9,14,13,12,16,12,8,12,7,12,15,9,14,15,15,14,8,14,12,15,12,14,15,11,15,12,15,15,12,15,12,9,14,12,15,11,10,7,10,7,10,2,4,2,2,1,2,2,1,1,3,2,16,16,4,16,17,19,16,16,1,1,1,1,1,1,10,13,18,11,18,20,11,1,178,67,12,20,41384691,7199,7199,5599,Mediterranean_Hispanic,142,6,1996/2/22,6,1,92793.0,,67214613
336,Fraser Forster,Tottenham,1988,181.0,eng ENG,GK,34.0,13.5,1.0,0.0,1.0,0.0,0.0,0.0,0.0,,0.0,1.0,0.0,1.0,0.0,1.0,3.0,1.0,Matches,181.0,eng ENG,GK,34.0,13.5,0.0,0.0,0.0,0.0,0.0,0.0,0.0,0.0,0.0,0.0,0.0,0.0,0.0,0.0,0.0,0.0,Matches,10.0,eng ENG,GK,34.0,13.5,24.0,2.0,1.0,4.0,0.0,21.3,0.34,-2.7,-0.2,36.0,124.0,29.0,269.0,71.0,29.0,30.2,93.0,49.5,37.6,193.0,5.0,2.6,16.0,1.19,15.2,Matches,10.0,eng ENG,GK,34.0,14.0,13.0,1215.0,13.5,24.0,1.78,55.0,30.0,60.0,5.0,3.0,5.0,3.0,23.1,3.0,2.0,1.0,0.0,33.3,Matches,181.0,eng ENG,GK,34.0,13.5,1.0,0.0,0.0,0.0,2.0,0.0,0.0,0.0,0.0,0.0,0.0,0.0,15.0,2.0,0.0,100.0,Matches,181.0,eng ENG,GK,34.0,13.5,363.0,241.0,121.0,28.0,0.0,0.0,0.0,0.0,0.0,0.0,0.0,0.0,266.0,1.0,1.0,Matches,181.0,eng ENG,GK,34.0,13.5,266.0,363.0,73.3,6319.0,4013.0,79.0,79.0,100.0,125.0,127.0,98.4,61.0,154.0,39.6,0.0,0.0,0.0,0.0,0.0,2.0,0.0,0.0,0.0,Matches,226,eng ENG,GK,34,14,1215.0,87.0,35.5,13.5,13,90.0,13,1,45.0,24,1.29,26.0,24.0,2.0,0.15,-0.06,21.4,18.8,2.6,0.19,0.0,Matches,181.0,eng ENG,GK,34.0,13.5,395.0,352.0,392.0,3.0,0.0,0.0,395.0,0.0,0.0,,0.0,,203.0,1098.0,616.0,0.0,0.0,0.0,1.0,0.0,148.0,0.0,Matches,181.0,eng ENG,GK,34.0,13.5,0.0,0.0,0.0,,0.0,0.0,,,,0.0,0.0,0.0,0.0,0.0,,0.0,0.0,Matches,181.0,eng ENG,GK,34.0,14.0,13.0,1215.0,13.5,0.0,0.0,0.0,0.0,0.0,0.0,1.0,0.0,0.0,0.0,0.0,0.0,0.0,0.0,0.0,0.0,0.0,0.0,0.0,0.0,0.0,0.0,0.0,0.0,0.0,Matches,Fraser Forster,GK,34,136,150,England,Tottenham Hotspur,4,3,2,3,8,6,1,3,2,1,9,3,7,7,7,12,15,16,15,9,15,17,2,9,1,15,6,12,2,12,13,20,11,2,9,19,15,5,16,6,1,19,11,14,4,14,13,16,17,12,3,13,13,19,3,8,13,20,18,15,20,1,1,1,1,1,1,1,1,1,1,1,1,1,201,99,7,20,9003176,6791,6241,5341,Northern_European,135,5,1988/3/17,6,0,81194.0,,5128263
337,Fred,Manchester Utd,1993,184.0,br BRA,MF,29.0,13.9,47.0,30.0,24.0,20.0,3.0,15.0,38.0,39.5,23.0,38.0,2.0,36.0,19.0,66.0,19.0,0.0,Matches,184.0,br BRA,MF,29.0,13.9,59.0,4.25,49.0,0.0,1.0,4.0,3.0,2.0,4.0,0.29,3.0,0.0,0.0,1.0,0.0,0.0,Matches,,,,,,,,,,,,,,,,,,,,,,,,,,,,,,,,,,,,,,,,,,,,,,,,,,,,,,,,184.0,br BRA,MF,29.0,13.9,6.0,0.0,0.0,33.0,22.0,1.0,14.0,19.0,30.0,0.0,0.0,0.0,127.0,11.0,11.0,50.0,Matches,184.0,br BRA,MF,29.0,13.9,781.0,761.0,16.0,9.0,7.0,1.0,14.0,1.0,3.0,0.0,1.0,0.0,618.0,4.0,26.0,Matches,184.0,br BRA,MF,29.0,13.9,618.0,781.0,79.1,9392.0,2767.0,344.0,398.0,86.4,197.0,234.0,84.2,48.0,77.0,62.3,2.0,2.9,1.8,-0.9,30.0,65.0,11.0,2.0,76.0,Matches,230,br BRA,MF,29,35,1249.0,36.0,36.5,13.9,12,74.0,6,23,16.0,3,1.97,24.0,22.0,2.0,0.14,-0.39,27.7,22.2,5.6,0.4,-0.08,Matches,184.0,br BRA,MF,29.0,13.9,999.0,38.0,250.0,483.0,279.0,37.0,999.0,32.0,12.0,37.5,15.0,46.9,537.0,2158.0,1034.0,10.0,17.0,3.0,26.0,16.0,614.0,50.0,Matches,184.0,br BRA,MF,29.0,13.9,2.0,26.0,5.0,19.2,1.87,0.36,0.08,0.4,19.5,0.0,0.0,0.0,2.0,2.0,0.08,0.0,0.0,Matches,184.0,br BRA,MF,29.0,35.0,12.0,1249.0,13.9,2.0,2.0,4.0,2.0,0.0,0.0,6.0,0.0,2.0,2.0,2.9,4.9,10.0,76.0,50.0,0.14,0.14,0.29,0.14,0.29,0.14,0.21,0.35,0.14,0.35,Matches,Fred,DM/M C,29,144,149,Brazil,Manchester UFC,10,10,13,9,13,10,8,7,6,13,14,9,14,14,15,15,15,10,11,11,11,14,12,8,14,13,17,17,16,16,14,7,15,15,18,13,10,12,14,3,12,2,4,1,2,2,1,3,1,3,3,2,15,14,12,12,10,15,12,13,1,1,1,1,1,1,16,10,20,1,10,12,1,1,169,64,20,12,25476425,7200,6900,6000,African_Caribbean,142,17,1993/3/5,19,0,150789.0,,19159362
338,Remo Freuler,Nott'ham Forest,1992,186.0,ch SUI,MF,30.0,24.0,43.0,23.0,23.0,15.0,5.0,19.0,43.0,44.2,24.0,36.0,9.0,27.0,29.0,72.0,45.0,0.0,Matches,186.0,ch SUI,MF,30.0,24.0,29.0,1.21,27.0,1.0,0.0,1.0,0.0,0.0,0.0,0.0,0.0,0.0,0.0,0.0,0.0,0.0,Matches,,,,,,,,,,,,,,,,,,,,,,,,,,,,,,,,,,,,,,,,,,,,,,,,,,,,,,,,186.0,ch SUI,MF,30.0,24.0,4.0,0.0,0.0,24.0,12.0,0.0,5.0,29.0,23.0,0.0,0.0,0.0,137.0,26.0,20.0,56.5,Matches,186.0,ch SUI,MF,30.0,24.0,836.0,812.0,23.0,20.0,0.0,2.0,5.0,2.0,0.0,0.0,0.0,0.0,664.0,1.0,17.0,Matches,186.0,ch SUI,MF,30.0,24.0,664.0,836.0,79.4,9828.0,3216.0,371.0,429.0,86.5,238.0,285.0,83.5,30.0,66.0,45.5,0.0,0.8,0.7,-0.8,12.0,47.0,6.0,3.0,54.0,Matches,232,ch SUI,MF,30,28,2161.0,77.0,63.2,24.0,24,84.0,16,4,38.0,8,0.82,17.0,47.0,-30.0,-1.25,-1.25,22.9,41.5,-18.5,-0.77,-0.31,Matches,186.0,ch SUI,MF,30.0,24.0,1058.0,71.0,360.0,537.0,167.0,13.0,1058.0,12.0,6.0,50.0,4.0,33.3,491.0,2192.0,959.0,7.0,11.0,0.0,20.0,8.0,557.0,11.0,Matches,186.0,ch SUI,MF,30.0,24.0,0.0,8.0,1.0,12.5,0.33,0.04,0.0,0.0,20.0,0.0,0.0,0.0,0.4,0.4,0.05,-0.4,-0.4,Matches,186.0,ch SUI,MF,30.0,28.0,24.0,2161.0,24.0,0.0,0.0,0.0,0.0,0.0,0.0,4.0,0.0,0.4,0.4,0.8,1.2,7.0,54.0,11.0,0.0,0.0,0.0,0.0,0.0,0.02,0.03,0.05,0.02,0.05,Matches,Remo Freuler,DM/M C,30,144,152,Switzerland,Nottingham Forest,8,12,14,9,15,8,9,12,6,11,14,11,13,14,14,15,14,13,13,15,14,15,12,11,12,14,16,16,13,14,14,10,15,12,16,12,14,9,13,6,14,2,3,2,3,3,3,3,2,3,3,1,13,14,7,12,14,16,13,13,1,1,1,1,1,1,18,9,20,7,1,11,1,1,180,80,11,20,29672542,7200,7250,6350,Northern_European,144,1,1992/4/15,46,4,52196.0,,98006034
339,Cody Gakpo,Liverpool,1999,187.0,nl NED,FWMF,23.0,16.2,26.0,15.0,4.0,13.0,9.0,13.0,38.0,34.2,25.0,13.0,1.0,12.0,4.0,30.0,2.0,0.0,Matches,187.0,nl NED,FWMF,23.0,16.2,49.0,3.02,37.0,0.0,3.0,4.0,3.0,2.0,6.0,0.37,5.0,0.0,0.0,0.0,1.0,0.0,Matches,,,,,,,,,,,,,,,,,,,,,,,,,,,,,,,,,,,,,,,,,,,,,,,,,,,,,,,,187.0,nl NED,FWMF,23.0,16.2,0.0,0.0,0.0,26.0,33.0,8.0,17.0,4.0,15.0,1.0,0.0,0.0,57.0,26.0,24.0,52.0,Matches,187.0,nl NED,FWMF,23.0,16.2,392.0,381.0,9.0,0.0,3.0,0.0,17.0,2.0,4.0,3.0,0.0,0.0,293.0,2.0,11.0,Matches,187.0,nl NED,FWMF,23.0,16.2,293.0,392.0,74.7,3928.0,1110.0,168.0,208.0,80.8,91.0,119.0,76.5,11.0,20.0,55.0,2.0,2.7,1.9,-0.7,23.0,33.0,11.0,1.0,50.0,Matches,235,nl NED,FWMF,23,21,1458.0,69.0,42.6,16.2,17,81.0,6,4,22.0,0,1.86,32.0,19.0,13.0,0.8,0.11,32.9,19.2,13.7,0.84,0.48,Matches,187.0,nl NED,FWMF,23.0,16.2,591.0,6.0,42.0,266.0,298.0,76.0,591.0,48.0,23.0,47.9,13.0,27.1,374.0,2069.0,1134.0,36.0,32.0,12.0,43.0,36.0,448.0,109.0,Matches,187.0,nl NED,FWMF,23.0,16.2,7.0,39.0,12.0,30.8,2.41,0.74,0.18,0.58,14.8,0.0,0.0,0.0,6.2,6.2,0.16,0.8,0.8,Matches,187.0,nl NED,FWMF,23.0,21.0,17.0,1458.0,16.2,7.0,2.0,9.0,7.0,0.0,0.0,0.0,0.0,6.2,6.2,2.7,8.9,36.0,50.0,109.0,0.43,0.12,0.56,0.43,0.56,0.38,0.17,0.55,0.38,0.55,Matches,Cody Gakpo,M/AM/S RL,23,152,162,"Holland,Togo",PSV Eindhoven,17,14,16,13,15,12,12,15,5,5,12,11,4,14,8,13,12,13,13,13,12,14,14,14,13,6,13,12,15,16,13,14,10,14,13,12,10,3,14,10,7,2,3,1,1,1,2,2,1,3,4,1,10,10,3,13,16,15,14,18,1,1,1,1,1,1,1,16,12,13,20,14,17,19,189,76,11,20,55007104,7598,7598,6648,African_Caribbean,143,12,1999/5/7,7,2,19177.0,,37062185
340,Conor Gallagher,Chelsea,2000,188.0,eng ENG,MF,22.0,18.0,46.0,33.0,17.0,19.0,10.0,10.0,37.0,27.0,27.0,41.0,10.0,31.0,23.0,69.0,18.0,1.0,Matches,188.0,eng ENG,MF,22.0,18.0,47.0,2.61,34.0,4.0,4.0,2.0,2.0,1.0,3.0,0.17,2.0,0.0,1.0,0.0,0.0,0.0,Matches,,,,,,,,,,,,,,,,,,,,,,,,,,,,,,,,,,,,,,,,,,,,,,,,,,,,,,,,188.0,eng ENG,MF,22.0,18.0,11.0,1.0,1.0,35.0,35.0,2.0,49.0,23.0,33.0,0.0,0.0,0.0,93.0,19.0,28.0,40.4,Matches,188.0,eng ENG,MF,22.0,18.0,871.0,818.0,50.0,13.0,1.0,6.0,49.0,10.0,21.0,9.0,7.0,0.0,706.0,3.0,29.0,Matches,188.0,eng ENG,MF,22.0,18.0,706.0,871.0,81.1,10444.0,2483.0,399.0,447.0,89.3,243.0,290.0,83.8,32.0,58.0,55.2,1.0,2.3,1.7,-1.3,21.0,67.0,20.0,5.0,105.0,Matches,236,eng ENG,MF,22,35,1621.0,46.0,47.4,18.0,18,73.0,8,17,18.0,2,1.23,15.0,22.0,-7.0,-0.39,-0.29,21.2,26.1,-4.9,-0.27,-0.36,Matches,188.0,eng ENG,MF,22.0,18.0,1134.0,32.0,198.0,529.0,421.0,59.0,1134.0,55.0,24.0,43.6,23.0,41.8,700.0,3523.0,1394.0,40.0,40.0,12.0,36.0,36.0,778.0,104.0,Matches,188.0,eng ENG,MF,22.0,18.0,3.0,28.0,11.0,39.3,1.55,0.61,0.11,0.27,17.9,0.0,0.0,0.0,2.5,2.5,0.09,0.5,0.5,Matches,188.0,eng ENG,MF,22.0,35.0,18.0,1621.0,18.0,3.0,1.0,4.0,3.0,0.0,0.0,11.0,1.0,2.5,2.5,2.3,4.7,40.0,105.0,104.0,0.17,0.06,0.22,0.17,0.22,0.14,0.13,0.26,0.14,0.26,Matches,Conor Gallagher,M/AM C,22,144,164,"England,Scotland,Republic of Ireland",Chelsea,12,12,13,14,13,13,8,12,6,9,13,7,13,13,17,11,15,13,14,13,14,17,12,11,14,13,15,17,15,14,11,10,16,13,18,11,13,8,11,4,8,3,1,2,3,3,4,1,3,2,1,2,8,13,7,13,14,13,9,14,1,1,1,1,1,1,14,12,20,12,1,16,1,1,182,74,12,20,44656818,7200,7150,6250,Northern_European,142,7,2000/2/6,4,0,17399.0,,28108036
341,Morgan Gibbs-White,Nott'ham Forest,2000,196.0,eng ENG,MFFW,22.0,33.0,26.0,14.0,7.0,7.0,12.0,11.0,33.0,33.3,22.0,23.0,4.0,19.0,14.0,40.0,15.0,0.0,Matches,196.0,eng ENG,MFFW,22.0,33.0,119.0,3.6,72.0,27.0,9.0,6.0,2.0,3.0,12.0,0.36,6.0,3.0,1.0,2.0,0.0,0.0,Matches,,,,,,,,,,,,,,,,,,,,,,,,,,,,,,,,,,,,,,,,,,,,,,,,,,,,,,,,196.0,eng ENG,MFFW,22.0,33.0,5.0,0.0,0.0,32.0,28.0,6.0,161.0,14.0,14.0,0.0,0.0,0.0,147.0,56.0,109.0,33.9,Matches,196.0,eng ENG,MFFW,22.0,33.0,1078.0,891.0,171.0,62.0,16.0,8.0,161.0,5.0,94.0,43.0,44.0,1.0,659.0,16.0,30.0,Matches,196.0,eng ENG,MFFW,22.0,33.0,659.0,1078.0,61.1,10717.0,3931.0,351.0,466.0,75.3,195.0,279.0,69.9,84.0,229.0,36.7,8.0,8.2,6.2,-0.2,66.0,70.0,40.0,5.0,131.0,Matches,246,eng ENG,MFFW,22,35,2971.0,85.0,86.9,33.0,34,87.0,26,1,30.0,0,1.0,37.0,59.0,-22.0,-0.67,0.94,36.0,54.7,-18.7,-0.57,0.69,Matches,196.0,eng ENG,MFFW,22.0,33.0,1447.0,20.0,169.0,626.0,680.0,76.0,1445.0,97.0,48.0,49.5,43.0,44.3,764.0,4463.0,2187.0,69.0,62.0,19.0,91.0,44.0,902.0,157.0,Matches,196.0,eng ENG,MFFW,22.0,33.0,5.0,57.0,19.0,33.3,1.73,0.58,0.05,0.16,20.0,3.0,2.0,2.0,6.0,4.4,0.08,-1.0,-1.4,Matches,196.0,eng ENG,MFFW,22.0,35.0,34.0,2971.0,33.0,5.0,8.0,13.0,3.0,2.0,2.0,5.0,0.0,6.0,4.4,8.2,12.7,69.0,131.0,157.0,0.15,0.24,0.39,0.09,0.33,0.18,0.25,0.43,0.13,0.38,Matches,Morgan Gibbs-White,M/AM RC,22,129,155,England,Nottingham Forest,13,12,14,11,14,8,9,11,5,6,15,10,9,15,12,13,9,13,12,16,12,13,16,8,14,8,13,14,13,15,14,10,11,14,12,12,11,11,12,10,12,1,2,3,3,1,2,3,2,3,2,1,11,13,13,13,12,11,12,14,1,1,1,1,1,1,1,1,20,1,12,20,15,10,178,72,8,20,33331385,6450,6450,4750,Mixed_Race,126,12,2000/1/27,0,0,57996.0,,29175220
342,Wilfried Gnonto,Leeds United,2003,199.0,it ITA,FWMF,18.0,15.0,27.0,17.0,7.0,15.0,5.0,10.0,30.0,33.3,20.0,24.0,1.0,23.0,5.0,32.0,7.0,0.0,Matches,199.0,it ITA,FWMF,18.0,15.0,50.0,3.32,30.0,3.0,4.0,4.0,8.0,1.0,7.0,0.47,6.0,1.0,0.0,0.0,0.0,0.0,Matches,,,,,,,,,,,,,,,,,,,,,,,,,,,,,,,,,,,,,,,,,,,,,,,,,,,,,,,,199.0,it ITA,FWMF,18.0,15.0,7.0,0.0,0.0,28.0,39.0,3.0,42.0,5.0,17.0,0.0,0.0,0.0,82.0,8.0,18.0,30.8,Matches,199.0,it ITA,FWMF,18.0,15.0,512.0,482.0,26.0,1.0,4.0,0.0,42.0,13.0,10.0,2.0,1.0,0.0,370.0,4.0,35.0,Matches,199.0,it ITA,FWMF,18.0,15.0,370.0,512.0,72.3,4823.0,1234.0,230.0,270.0,85.2,104.0,137.0,75.9,12.0,24.0,50.0,4.0,2.2,2.2,1.8,22.0,12.0,19.0,5.0,35.0,Matches,252,it ITA,FWMF,18,24,1354.0,56.0,39.6,15.0,14,79.0,7,10,26.0,5,0.75,17.0,28.0,-11.0,-0.73,0.1,16.2,25.0,-8.8,-0.59,-0.11,Matches,199.0,it ITA,FWMF,18.0,15.0,719.0,12.0,95.0,248.0,393.0,43.0,719.0,77.0,21.0,27.3,43.0,55.8,484.0,3356.0,1715.0,66.0,37.0,17.0,30.0,19.0,508.0,136.0,Matches,199.0,it ITA,FWMF,18.0,15.0,2.0,22.0,8.0,36.4,1.46,0.53,0.09,0.25,17.4,0.0,0.0,0.0,1.8,1.8,0.08,0.2,0.2,Matches,199.0,it ITA,FWMF,18.0,24.0,14.0,1354.0,15.0,2.0,4.0,6.0,2.0,0.0,0.0,7.0,0.0,1.8,1.8,2.2,4.0,66.0,35.0,136.0,0.13,0.27,0.4,0.13,0.4,0.12,0.15,0.27,0.12,0.27,Matches,Wilfried Gnonto,AM/S RLC,18,116,-85,"Italy,Ivory Coast",Leeds United,5,9,14,13,12,8,8,9,3,4,12,10,6,15,8,11,9,13,7,11,8,16,14,6,13,5,9,13,16,14,12,5,17,15,12,8,9,12,12,6,12,2,3,1,2,4,3,1,1,2,2,1,9,15,9,12,12,12,9,9,1,1,1,1,1,1,1,1,1,1,15,18,15,20,170,71,10,20,42327704,5800,7118,5338,North_African__Middle_Eastern,104,16,2003/11/5,4,1,23198.0,,43500350
343,Joe Gomez,Liverpool,1997,203.0,eng ENG,DF,25.0,16.3,28.0,21.0,15.0,11.0,2.0,11.0,19.0,57.9,8.0,17.0,11.0,6.0,24.0,52.0,51.0,2.0,Matches,203.0,eng ENG,DF,25.0,16.3,18.0,1.11,15.0,1.0,0.0,1.0,0.0,1.0,1.0,0.06,1.0,0.0,0.0,0.0,0.0,0.0,Matches,,,,,,,,,,,,,,,,,,,,,,,,,,,,,,,,,,,,,,,,,,,,,,,,,,,,,,,,203.0,eng ENG,DF,25.0,16.3,3.0,0.0,0.0,13.0,4.0,1.0,4.0,24.0,21.0,0.0,1.0,0.0,126.0,46.0,38.0,54.8,Matches,203.0,eng ENG,DF,25.0,16.3,1361.0,1316.0,39.0,6.0,2.0,11.0,4.0,30.0,0.0,0.0,0.0,0.0,1166.0,6.0,5.0,Matches,203.0,eng ENG,DF,25.0,16.3,1166.0,1361.0,85.7,23380.0,7637.0,336.0,379.0,88.7,686.0,745.0,92.1,127.0,197.0,64.5,0.0,0.2,0.7,-0.2,1.0,121.0,4.0,0.0,108.0,Matches,259,eng ENG,DF,25,21,1466.0,70.0,42.9,16.3,15,90.0,15,6,19.0,12,1.67,28.0,16.0,12.0,0.74,0.0,30.4,24.6,5.8,0.36,-0.38,Matches,203.0,eng ENG,DF,25.0,16.3,1521.0,114.0,602.0,851.0,76.0,6.0,1521.0,5.0,4.0,80.0,1.0,20.0,1005.0,4826.0,2616.0,15.0,12.0,0.0,13.0,5.0,1040.0,5.0,Matches,203.0,eng ENG,DF,25.0,16.3,0.0,6.0,2.0,33.3,0.37,0.12,0.0,0.0,24.5,0.0,0.0,0.0,0.2,0.2,0.03,-0.2,-0.2,Matches,203.0,eng ENG,DF,25.0,21.0,15.0,1466.0,16.3,0.0,0.0,0.0,0.0,0.0,0.0,3.0,0.0,0.2,0.2,0.2,0.3,15.0,108.0,5.0,0.0,0.0,0.0,0.0,0.0,0.01,0.01,0.02,0.01,0.02,Matches,Joe Gomez,D RLC,25,151,164,"England,The Gambia",Liverpool,4,8,11,3,15,5,15,2,16,15,14,4,15,14,14,15,14,15,13,7,14,13,6,9,9,15,14,14,16,15,14,14,15,16,15,15,12,9,14,12,13,4,2,1,2,1,3,2,3,4,1,1,14,14,6,14,13,15,11,14,1,15,20,17,1,13,12,1,1,1,1,1,1,1,188,87,8,20,39460388,7550,7200,6000,Mixed_Race,152,13,1997/5/23,11,0,110192.0,,29115800
344,Anthony Gordon,Everton,2001,206.0,eng ENG,FW,21.0,12.2,34.0,22.0,17.0,10.0,7.0,8.0,24.0,33.3,16.0,19.0,0.0,19.0,4.0,38.0,11.0,0.0,Matches,206.0,eng ENG,FW,21.0,12.2,23.0,1.89,13.0,0.0,1.0,6.0,1.0,2.0,0.0,0.0,0.0,0.0,0.0,0.0,0.0,0.0,Matches,,,,,,,,,,,,,,,,,,,,,,,,,,,,,,,,,,,,,,,,,,,,,,,,,,,,,,,,206.0,eng ENG,FW,21.0,12.2,6.0,0.0,0.0,20.0,15.0,3.0,25.0,4.0,22.0,0.0,0.0,0.0,56.0,9.0,29.0,23.7,Matches,206.0,eng ENG,FW,21.0,12.2,280.0,272.0,7.0,0.0,1.0,1.0,25.0,1.0,2.0,2.0,0.0,0.0,193.0,1.0,10.0,Matches,206.0,eng ENG,FW,21.0,12.2,193.0,280.0,68.9,2905.0,625.0,110.0,135.0,81.5,66.0,89.0,74.2,11.0,27.0,40.7,0.0,0.6,0.5,-0.6,8.0,8.0,11.0,2.0,19.0,Matches,264,eng ENG,FW,21,16,1095.0,68.0,32.0,12.2,12,85.0,7,4,19.0,1,0.88,10.0,13.0,-3.0,-0.25,0.53,13.2,17.5,-4.3,-0.36,0.26,Matches,206.0,eng ENG,FW,21.0,12.2,464.0,13.0,87.0,165.0,218.0,47.0,464.0,45.0,11.0,24.4,29.0,64.4,252.0,1875.0,704.0,28.0,23.0,13.0,32.0,23.0,290.0,67.0,Matches,206.0,eng ENG,FW,21.0,12.2,3.0,26.0,16.0,61.5,2.14,1.32,0.12,0.19,16.6,1.0,0.0,0.0,3.3,3.3,0.13,-0.3,-0.3,Matches,206.0,eng ENG,FW,21.0,16.0,12.0,1095.0,12.2,3.0,0.0,3.0,3.0,0.0,0.0,6.0,0.0,3.3,3.3,0.6,3.9,28.0,19.0,67.0,0.25,0.0,0.25,0.25,0.25,0.27,0.05,0.32,0.27,0.32,Matches,Anthony Gordon,AM RLC,21,131,154,"England,Republic of Ireland,Scotland",Everton,11,13,14,11,13,12,7,13,5,8,12,12,11,13,11,10,10,12,10,11,12,17,15,9,10,6,11,15,15,14,7,11,10,14,14,9,10,7,8,11,5,1,1,3,1,1,1,1,2,1,1,3,9,16,8,12,12,14,12,13,1,1,1,1,1,1,1,1,1,1,18,17,20,15,183,0,10,20,59569003,6996,6996,5496,Northern_European,125,1,2001/2/24,0,0,11599.0,,28116386
345,Demarai Gray,Everton,1996,207.0,jm JAM,FWMF,26.0,27.9,33.0,24.0,9.0,14.0,10.0,17.0,31.0,54.8,14.0,23.0,3.0,20.0,13.0,46.0,18.0,0.0,Matches,207.0,jm JAM,FWMF,26.0,27.9,96.0,3.44,41.0,25.0,6.0,11.0,10.0,3.0,5.0,0.18,3.0,2.0,0.0,0.0,0.0,0.0,Matches,,,,,,,,,,,,,,,,,,,,,,,,,,,,,,,,,,,,,,,,,,,,,,,,,,,,,,,,207.0,jm JAM,FWMF,26.0,27.9,3.0,0.0,0.0,24.0,51.0,13.0,173.0,13.0,24.0,0.0,0.0,0.0,98.0,13.0,45.0,22.4,Matches,207.0,jm JAM,FWMF,26.0,27.9,838.0,666.0,172.0,57.0,2.0,8.0,173.0,7.0,74.0,53.0,20.0,0.0,579.0,0.0,38.0,Matches,207.0,jm JAM,FWMF,26.0,27.9,579.0,838.0,69.1,9843.0,2215.0,289.0,328.0,88.1,191.0,252.0,75.8,72.0,179.0,40.2,1.0,3.8,3.8,-2.8,37.0,30.0,18.0,7.0,46.0,Matches,267,jm JAM,FWMF,26,33,2507.0,76.0,73.3,27.9,27,86.0,16,6,30.0,5,0.79,20.0,39.0,-19.0,-0.68,-0.29,28.7,44.7,-16.0,-0.57,-0.15,Matches,207.0,jm JAM,FWMF,26.0,27.9,1181.0,22.0,110.0,441.0,652.0,104.0,1179.0,95.0,36.0,37.9,42.0,44.2,720.0,5100.0,2465.0,94.0,62.0,48.0,86.0,66.0,781.0,199.0,Matches,207.0,jm JAM,FWMF,26.0,27.9,4.0,57.0,22.0,38.6,2.05,0.79,0.04,0.09,19.5,8.0,2.0,2.0,6.2,4.7,0.08,-2.2,-2.7,Matches,207.0,jm JAM,FWMF,26.0,33.0,27.0,2507.0,27.9,4.0,1.0,5.0,2.0,2.0,2.0,3.0,0.0,6.2,4.7,3.8,8.5,94.0,46.0,199.0,0.14,0.04,0.18,0.07,0.11,0.22,0.14,0.36,0.17,0.3,Matches,Demarai Gray,M/AM RLC,26,132,145,"Jamaica,England",Everton,12,11,14,12,12,11,6,9,6,7,12,11,5,13,9,12,7,10,10,11,10,13,15,7,12,8,12,11,16,14,12,9,15,16,13,10,8,5,11,5,6,1,2,1,1,2,3,3,2,1,2,1,10,14,5,11,11,15,9,11,1,1,1,1,1,1,1,17,1,16,20,18,17,14,184,74,12,20,12676982,6592,6592,5342,African_Caribbean,123,14,1996/6/28,0,0,46397.0,,29114887
346,Jack Grealish,Manchester City,1995,208.0,eng ENG,FW,26.0,22.8,25.0,16.0,10.0,12.0,3.0,13.0,23.0,56.5,10.0,17.0,3.0,14.0,7.0,32.0,9.0,0.0,Matches,208.0,eng ENG,FW,26.0,22.8,104.0,4.55,71.0,7.0,6.0,6.0,13.0,1.0,20.0,0.88,14.0,1.0,0.0,1.0,3.0,1.0,Matches,,,,,,,,,,,,,,,,,,,,,,,,,,,,,,,,,,,,,,,,,,,,,,,,,,,,,,,,208.0,eng ENG,FW,26.0,22.8,4.0,0.0,0.0,27.0,78.0,3.0,53.0,7.0,16.0,1.0,0.0,0.0,110.0,14.0,17.0,45.2,Matches,208.0,eng ENG,FW,26.0,22.8,1072.0,1011.0,56.0,7.0,6.0,8.0,53.0,25.0,24.0,12.0,0.0,1.0,902.0,5.0,35.0,Matches,208.0,eng ENG,FW,26.0,22.8,902.0,1072.0,84.1,13270.0,2584.0,539.0,588.0,91.7,295.0,337.0,87.5,41.0,66.0,62.1,7.0,7.1,6.7,-0.1,50.0,28.0,48.0,2.0,100.0,Matches,268,eng ENG,FW,26,28,2055.0,73.0,60.1,22.8,23,83.0,11,5,31.0,5,2.64,63.0,16.0,47.0,2.06,1.14,50.6,14.0,36.6,1.6,0.95,Matches,208.0,eng ENG,FW,26.0,22.8,1308.0,20.0,141.0,421.0,772.0,136.0,1308.0,110.0,45.0,40.9,28.0,25.5,957.0,8506.0,3982.0,143.0,83.0,63.0,36.0,29.0,1065.0,310.0,Matches,208.0,eng ENG,FW,26.0,22.8,5.0,41.0,15.0,36.6,1.8,0.66,0.12,0.33,15.4,0.0,0.0,0.0,4.6,4.6,0.11,0.4,0.4,Matches,208.0,eng ENG,FW,26.0,28.0,23.0,2055.0,22.8,5.0,7.0,12.0,5.0,0.0,0.0,4.0,0.0,4.6,4.6,7.1,11.7,143.0,100.0,310.0,0.22,0.31,0.53,0.22,0.53,0.2,0.31,0.51,0.2,0.51,Matches,Jack Grealish,M/AM RLC,26,166,175,"England,Republic of Ireland",Manchester City,13,16,17,14,15,11,11,13,3,6,14,12,9,16,11,13,14,14,11,16,13,14,16,12,13,11,14,15,15,15,14,7,15,15,14,14,14,13,14,12,9,3,1,1,1,3,2,2,4,3,1,1,12,16,12,15,16,13,6,10,1,1,1,1,1,1,1,18,14,16,20,20,16,12,175,82,15,20,288514966,8350,7900,7500,Northern_European,158,4,1995/9/10,23,1,313178.0,,28067800
347,Pascal Groß,Brighton,1991,210.0,de GER,MFDF,31.0,36.0,59.0,38.0,23.0,27.0,9.0,25.0,55.0,45.5,30.0,32.0,10.0,22.0,13.0,72.0,21.0,1.0,Matches,210.0,de GER,MFDF,31.0,36.0,138.0,3.83,90.0,40.0,1.0,5.0,1.0,1.0,12.0,0.33,10.0,2.0,0.0,0.0,0.0,0.0,Matches,,,,,,,,,,,,,,,,,,,,,,,,,,,,,,,,,,,,,,,,,,,,,,,,,,,,,,,,210.0,de GER,MFDF,31.0,36.0,6.0,0.0,0.0,35.0,18.0,10.0,224.0,13.0,38.0,0.0,1.0,1.0,140.0,10.0,36.0,21.7,Matches,210.0,de GER,MFDF,31.0,36.0,2347.0,2004.0,333.0,87.0,9.0,20.0,224.0,86.0,140.0,60.0,60.0,2.0,1879.0,10.0,50.0,Matches,210.0,de GER,MFDF,31.0,36.0,1879.0,2347.0,80.1,30182.0,8776.0,988.0,1079.0,91.6,681.0,809.0,84.2,147.0,316.0,46.5,8.0,10.9,8.8,-2.9,80.0,157.0,69.0,13.0,255.0,Matches,272,de GER,MFDF,31,37,3239.0,88.0,94.7,36.0,37,88.0,30,0,,0,1.59,70.0,51.0,19.0,0.53,0.53,69.7,47.3,22.4,0.62,0.26,Matches,210.0,de GER,MFDF,31.0,36.0,2602.0,77.0,466.0,1225.0,924.0,98.0,2602.0,33.0,17.0,51.5,13.0,39.4,1453.0,6723.0,3125.0,62.0,52.0,8.0,39.0,18.0,1832.0,209.0,Matches,210.0,de GER,MFDF,31.0,36.0,9.0,39.0,19.0,48.7,1.08,0.53,0.23,0.47,17.4,1.0,0.0,0.0,5.4,5.4,0.14,3.6,3.6,Matches,210.0,de GER,MFDF,31.0,37.0,37.0,3239.0,36.0,9.0,8.0,17.0,9.0,0.0,0.0,6.0,0.0,5.4,5.4,10.9,16.3,62.0,255.0,209.0,0.25,0.22,0.47,0.25,0.47,0.15,0.3,0.45,0.15,0.45,Matches,Pascal Groß,M/AM RLC,31,136,150,Germany,Brighton & Hove Albion,17,17,11,13,14,14,11,14,6,10,15,14,10,15,13,13,12,15,14,15,14,15,13,12,16,13,14,16,8,12,11,10,15,9,15,11,16,6,15,5,13,2,3,2,2,1,2,2,1,1,2,3,17,13,5,13,12,17,15,14,1,1,1,1,1,12,14,14,18,14,15,20,15,1,181,78,11,20,23823150,6800,6800,5500,Northern_European,132,4,1991/6/15,0,0,76555.0,,92017376
348,Vicente Guaita,Crystal Palace,1987,211.0,es ESP,GK,35.0,27.0,0.0,0.0,0.0,0.0,0.0,0.0,0.0,,0.0,0.0,0.0,0.0,0.0,0.0,9.0,1.0,Matches,211.0,es ESP,GK,35.0,27.0,1.0,0.04,1.0,0.0,0.0,0.0,0.0,0.0,0.0,0.0,0.0,0.0,0.0,0.0,0.0,0.0,Matches,12.0,es ESP,GK,35.0,27.0,34.0,2.0,0.0,4.0,2.0,32.4,0.26,0.4,0.01,115.0,320.0,35.9,635.0,140.0,34.5,32.3,206.0,49.0,37.4,410.0,26.0,6.3,26.0,0.96,13.1,Matches,12.0,es ESP,GK,35.0,27.0,27.0,2430.0,27.0,34.0,1.26,116.0,84.0,72.4,7.0,9.0,11.0,6.0,22.2,2.0,2.0,0.0,0.0,0.0,Matches,211.0,es ESP,GK,35.0,27.0,1.0,0.0,0.0,1.0,3.0,0.0,0.0,0.0,0.0,0.0,0.0,0.0,26.0,10.0,1.0,90.9,Matches,211.0,es ESP,GK,35.0,27.0,845.0,590.0,251.0,45.0,0.0,4.0,0.0,0.0,0.0,0.0,0.0,0.0,610.0,4.0,0.0,Matches,211.0,es ESP,GK,35.0,27.0,610.0,845.0,72.2,15748.0,10443.0,159.0,161.0,98.8,258.0,263.0,98.1,182.0,405.0,44.9,0.0,0.0,0.0,0.0,0.0,3.0,0.0,0.0,1.0,Matches,273,es ESP,GK,35,27,2430.0,90.0,71.1,27.0,27,90.0,27,0,,5,1.11,23.0,34.0,-11.0,-0.41,-0.59,25.2,37.4,-12.2,-0.45,-0.76,Matches,211.0,es ESP,GK,35.0,27.0,895.0,785.0,893.0,2.0,0.0,0.0,895.0,0.0,0.0,,0.0,,507.0,2657.0,1704.0,0.0,0.0,0.0,1.0,0.0,383.0,0.0,Matches,211.0,es ESP,GK,35.0,27.0,0.0,0.0,0.0,,0.0,0.0,,,,0.0,0.0,0.0,0.0,0.0,,0.0,0.0,Matches,211.0,es ESP,GK,35.0,27.0,27.0,2430.0,27.0,0.0,0.0,0.0,0.0,0.0,0.0,1.0,0.0,0.0,0.0,0.0,0.0,0.0,1.0,0.0,0.0,0.0,0.0,0.0,0.0,0.0,0.0,0.0,0.0,0.0,Matches,Vicente Guaita,GK,35,138,150,Spain,Crystal Palace,2,2,2,1,10,1,8,1,3,1,12,5,1,10,9,13,13,13,14,11,12,15,3,11,2,16,11,11,10,12,14,16,13,11,14,13,13,4,12,6,1,14,14,11,8,16,12,13,15,12,17,14,17,14,5,16,13,16,10,12,20,1,1,1,1,1,1,1,1,1,1,1,1,1,190,81,9,20,4757875,6900,6900,5750,Mediterranean_Hispanic,137,4,1987/1/10,0,0,81194.0,,1510602
349,Marc Guéhi,Crystal Palace,2000,213.0,eng ENG,DF,22.0,37.0,52.0,27.0,39.0,11.0,2.0,26.0,42.0,61.9,16.0,45.0,24.0,21.0,45.0,97.0,134.0,3.0,Matches,213.0,eng ENG,DF,22.0,37.0,29.0,0.78,23.0,1.0,0.0,3.0,1.0,1.0,1.0,0.03,1.0,0.0,0.0,0.0,0.0,0.0,Matches,,,,,,,,,,,,,,,,,,,,,,,,,,,,,,,,,,,,,,,,,,,,,,,,,,,,,,,,213.0,eng ENG,DF,22.0,37.0,8.0,0.0,0.0,24.0,40.0,0.0,0.0,45.0,27.0,0.0,0.0,1.0,241.0,54.0,43.0,55.7,Matches,213.0,eng ENG,DF,22.0,37.0,2208.0,2124.0,79.0,75.0,3.0,29.0,0.0,2.0,0.0,0.0,0.0,0.0,1883.0,5.0,12.0,Matches,213.0,eng ENG,DF,22.0,37.0,1883.0,2208.0,85.3,38404.0,14329.0,584.0,642.0,91.0,1074.0,1152.0,93.2,216.0,384.0,56.3,0.0,0.5,0.8,-0.5,10.0,148.0,5.0,0.0,106.0,Matches,275,eng ENG,DF,22,37,3329.0,90.0,97.3,37.0,37,90.0,36,0,,0,1.22,40.0,46.0,-6.0,-0.16,2.8,38.8,45.5,-6.7,-0.18,1.9,Matches,213.0,eng ENG,DF,22.0,37.0,2557.0,369.0,1415.0,1078.0,74.0,28.0,2557.0,21.0,14.0,66.7,3.0,14.3,1511.0,7181.0,4034.0,17.0,14.0,0.0,17.0,7.0,1690.0,3.0,Matches,213.0,eng ENG,DF,22.0,37.0,1.0,14.0,6.0,42.9,0.38,0.16,0.07,0.17,8.3,0.0,0.0,0.0,1.5,1.5,0.1,-0.5,-0.5,Matches,213.0,eng ENG,DF,22.0,37.0,37.0,3329.0,37.0,1.0,0.0,1.0,1.0,0.0,0.0,8.0,0.0,1.5,1.5,0.5,1.9,17.0,106.0,3.0,0.03,0.0,0.03,0.03,0.03,0.04,0.01,0.05,0.04,0.05,Matches,Marc Guéhi,D C,22,143,168,"England,Ivory Coast",Crystal Palace,5,6,11,9,12,7,11,8,9,14,12,6,15,12,10,14,14,14,14,10,13,14,11,14,9,14,13,14,14,13,14,14,15,14,14,15,14,10,12,9,12,2,1,3,2,3,1,2,1,2,1,1,13,12,5,13,10,15,13,16,1,12,20,10,1,1,8,1,1,1,1,1,1,1,182,80,14,20,58162896,7130,7130,5930,African_Caribbean,142,15,2000/7/13,3,0,52196.0,,28108033
350,Bruno Guimarães,Newcastle Utd,1997,214.0,br BRA,MF,24.0,30.3,78.0,40.0,27.0,46.0,5.0,38.0,65.0,58.5,27.0,28.0,4.0,24.0,36.0,114.0,22.0,1.0,Matches,214.0,br BRA,MF,24.0,30.3,110.0,3.63,92.0,1.0,3.0,1.0,11.0,2.0,12.0,0.4,11.0,0.0,0.0,0.0,0.0,1.0,Matches,,,,,,,,,,,,,,,,,,,,,,,,,,,,,,,,,,,,,,,,,,,,,,,,,,,,,,,,214.0,br BRA,MF,24.0,30.3,7.0,0.0,0.0,45.0,83.0,1.0,22.0,36.0,40.0,0.0,0.0,0.0,233.0,19.0,13.0,59.4,Matches,214.0,br BRA,MF,24.0,30.3,1668.0,1617.0,42.0,34.0,25.0,20.0,22.0,5.0,3.0,0.0,0.0,0.0,1387.0,9.0,29.0,Matches,214.0,br BRA,MF,24.0,30.3,1387.0,1668.0,83.2,24038.0,6632.0,659.0,741.0,88.9,539.0,614.0,87.8,149.0,216.0,69.0,5.0,4.0,3.9,1.0,42.0,147.0,54.0,2.0,222.0,Matches,276,br BRA,MF,24,32,2726.0,85.0,79.7,30.3,32,85.0,23,0,,0,2.09,61.0,25.0,36.0,1.19,1.32,59.2,29.8,29.4,0.97,0.59,Matches,214.0,br BRA,MF,24.0,30.3,2014.0,59.0,392.0,1076.0,575.0,50.0,2014.0,92.0,45.0,48.9,26.0,28.3,1321.0,7248.0,2911.0,41.0,47.0,5.0,46.0,60.0,1503.0,42.0,Matches,214.0,br BRA,MF,24.0,30.3,4.0,28.0,8.0,28.6,0.92,0.26,0.14,0.5,19.7,0.0,0.0,0.0,2.8,2.8,0.1,1.2,1.2,Matches,214.0,br BRA,MF,24.0,32.0,32.0,2726.0,30.3,4.0,5.0,9.0,4.0,0.0,0.0,7.0,0.0,2.8,2.8,4.0,6.8,41.0,222.0,42.0,0.13,0.17,0.3,0.13,0.3,0.09,0.13,0.22,0.09,0.22,Matches,Bruno Guimarães,DM/M C,24,150,166,"Brazil,Spain",Newcastle United,11,11,15,13,15,12,11,11,5,13,16,11,14,15,12,15,14,17,15,17,15,14,14,12,14,15,15,15,12,13,11,12,14,13,14,12,15,14,13,7,17,4,2,1,1,3,1,3,1,3,3,4,19,13,6,12,14,14,9,11,1,1,10,1,1,1,19,12,20,1,1,1,1,1,182,74,8,20,84814753,7499,7999,6249,Mediterranean_Hispanic,151,9,1997/11/16,8,1,185587.0,,19297055
351,Erling Haaland,Manchester City,2000,217.0,no NOR,FW,22.0,30.8,3.0,2.0,0.0,2.0,1.0,1.0,5.0,20.0,4.0,12.0,4.0,8.0,3.0,6.0,14.0,0.0,Matches,217.0,no NOR,FW,22.0,30.8,72.0,2.34,48.0,0.0,5.0,10.0,8.0,1.0,17.0,0.55,14.0,0.0,0.0,1.0,2.0,0.0,Matches,,,,,,,,,,,,,,,,,,,,,,,,,,,,,,,,,,,,,,,,,,,,,,,,,,,,,,,,217.0,no NOR,FW,22.0,30.8,5.0,0.0,0.0,31.0,24.0,8.0,12.0,3.0,2.0,1.0,0.0,0.0,37.0,50.0,50.0,50.0,Matches,217.0,no NOR,FW,22.0,30.8,500.0,449.0,45.0,0.0,4.0,0.0,12.0,2.0,1.0,0.0,0.0,0.0,360.0,6.0,21.0,Matches,217.0,no NOR,FW,22.0,30.8,360.0,500.0,72.0,4403.0,947.0,218.0,276.0,79.0,100.0,132.0,75.8,7.0,9.0,77.8,8.0,5.3,3.1,2.7,29.0,14.0,23.0,0.0,58.0,Matches,279,no NOR,FW,22,35,2769.0,79.0,81.0,30.8,33,83.0,21,2,22.0,1,2.37,84.0,26.0,58.0,1.89,1.47,66.9,24.3,42.6,1.38,0.84,Matches,217.0,no NOR,FW,22.0,30.8,763.0,18.0,39.0,290.0,435.0,217.0,756.0,32.0,11.0,34.4,18.0,56.3,405.0,2020.0,761.0,35.0,10.0,25.0,51.0,26.0,583.0,151.0,Matches,217.0,no NOR,FW,22.0,30.8,36.0,116.0,53.0,45.7,3.77,1.72,0.25,0.55,12.6,0.0,7.0,7.0,28.4,23.0,0.2,7.6,6.0,Matches,217.0,no NOR,FW,22.0,35.0,33.0,2769.0,30.8,36.0,8.0,44.0,29.0,7.0,7.0,5.0,0.0,28.4,23.0,5.3,28.3,35.0,58.0,151.0,1.17,0.26,1.43,0.94,1.2,0.92,0.17,1.09,0.75,0.92,Matches,Erling Haaland,S,22,185,195,"Norway,England",Manchester City,7,10,14,18,16,13,15,13,5,6,13,17,7,15,13,18,15,18,15,14,13,20,16,13,18,7,13,13,17,16,17,18,19,19,14,17,17,9,17,12,10,2,4,1,3,2,2,2,2,3,3,2,16,20,12,15,18,17,10,12,1,1,1,1,1,1,1,1,1,1,1,1,1,20,195,88,20,11,347975206,9250,9250,8750,Northern_European,185,2,2000/7/21,21,20,394372.0,,29179241
352,Jack Harrison,Leeds United,1996,220.0,eng ENG,FWMF,25.0,30.1,41.0,17.0,5.0,15.0,21.0,12.0,52.0,23.1,40.0,47.0,2.0,45.0,22.0,63.0,25.0,0.0,Matches,220.0,eng ENG,FWMF,25.0,30.1,114.0,3.79,68.0,27.0,7.0,5.0,5.0,2.0,9.0,0.3,6.0,1.0,1.0,1.0,0.0,0.0,Matches,,,,,,,,,,,,,,,,,,,,,,,,,,,,,,,,,,,,,,,,,,,,,,,,,,,,,,,,220.0,eng ENG,FWMF,25.0,30.1,2.0,0.0,0.0,38.0,37.0,3.0,186.0,22.0,17.0,0.0,0.0,0.0,174.0,5.0,42.0,10.6,Matches,220.0,eng ENG,FWMF,25.0,30.1,1150.0,1012.0,131.0,38.0,4.0,11.0,186.0,24.0,68.0,34.0,21.0,3.0,732.0,7.0,55.0,Matches,220.0,eng ENG,FWMF,25.0,30.1,732.0,1150.0,63.7,10776.0,4115.0,443.0,544.0,81.4,189.0,316.0,59.8,60.0,165.0,36.4,7.0,5.1,5.1,1.9,53.0,57.0,51.0,21.0,103.0,Matches,283,eng ENG,FWMF,25,36,2708.0,75.0,79.2,30.1,34,78.0,11,2,27.0,1,0.86,35.0,55.0,-20.0,-0.66,0.6,37.5,50.4,-12.9,-0.43,0.43,Matches,220.0,eng ENG,FWMF,25.0,30.1,1556.0,31.0,192.0,549.0,836.0,81.0,1556.0,118.0,48.0,40.7,59.0,50.0,959.0,5271.0,2584.0,103.0,56.0,24.0,92.0,61.0,1037.0,255.0,Matches,220.0,eng ENG,FWMF,25.0,30.1,5.0,39.0,14.0,35.9,1.3,0.47,0.13,0.36,17.8,3.0,0.0,0.0,4.7,4.7,0.12,0.3,0.3,Matches,220.0,eng ENG,FWMF,25.0,36.0,34.0,2708.0,30.1,5.0,7.0,12.0,5.0,0.0,0.0,2.0,0.0,4.7,4.7,5.1,9.8,103.0,103.0,255.0,0.17,0.23,0.4,0.17,0.4,0.16,0.17,0.33,0.16,0.33,Matches,Jack Harrison,M/AM RL,25,139,148,"England,United States",Leeds United,13,12,13,12,17,8,5,11,5,4,11,10,6,13,11,11,13,11,10,12,9,17,14,7,13,10,14,15,14,13,14,7,16,15,17,8,9,9,9,8,12,3,3,4,1,3,1,2,2,4,1,1,19,16,6,11,16,18,12,13,1,1,1,1,1,1,1,17,4,15,20,12,19,4,175,70,20,17,28815131,6941,6941,5991,Northern_European,135,4,1996/11/20,0,0,69595.0,,72045910
353,Kai Havertz,Chelsea,1999,221.0,de GER,FWMF,23.0,28.5,34.0,16.0,4.0,20.0,10.0,10.0,30.0,33.3,20.0,28.0,0.0,28.0,7.0,41.0,41.0,0.0,Matches,221.0,de GER,FWMF,23.0,28.5,63.0,2.21,54.0,2.0,1.0,5.0,1.0,0.0,4.0,0.14,3.0,0.0,0.0,1.0,0.0,0.0,Matches,,,,,,,,,,,,,,,,,,,,,,,,,,,,,,,,,,,,,,,,,,,,,,,,,,,,,,,,221.0,de GER,FWMF,23.0,28.5,5.0,0.0,0.0,60.0,25.0,28.0,14.0,7.0,16.0,0.0,0.0,0.0,81.0,79.0,59.0,57.2,Matches,221.0,de GER,FWMF,23.0,28.5,894.0,850.0,41.0,5.0,2.0,4.0,14.0,9.0,1.0,0.0,0.0,0.0,727.0,3.0,24.0,Matches,221.0,de GER,FWMF,23.0,28.5,727.0,894.0,81.3,9347.0,1882.0,458.0,540.0,84.8,195.0,221.0,88.2,23.0,32.0,71.9,1.0,3.8,2.8,-2.8,38.0,49.0,26.0,2.0,89.0,Matches,284,de GER,FWMF,23,35,2569.0,73.0,75.1,28.5,30,81.0,15,5,25.0,1,1.23,29.0,31.0,-2.0,-0.07,0.67,40.3,38.1,2.2,0.08,0.63,Matches,221.0,de GER,FWMF,23.0,28.5,1258.0,46.0,108.0,519.0,640.0,165.0,1257.0,61.0,18.0,29.5,38.0,62.3,728.0,3741.0,1483.0,59.0,33.0,30.0,79.0,36.0,946.0,218.0,Matches,221.0,de GER,FWMF,23.0,28.5,7.0,70.0,31.0,44.3,2.45,1.09,0.09,0.19,12.7,1.0,1.0,1.0,11.6,10.8,0.15,-4.6,-4.8,Matches,221.0,de GER,FWMF,23.0,35.0,30.0,2569.0,28.5,7.0,1.0,8.0,6.0,1.0,1.0,5.0,0.0,11.6,10.8,3.8,14.6,59.0,89.0,218.0,0.25,0.04,0.28,0.21,0.25,0.41,0.13,0.54,0.38,0.51,Matches,Kai Havertz,AM/S C,23,167,180,Germany,Chelsea,11,12,14,16,18,11,13,11,8,7,14,12,10,17,11,15,11,17,10,17,16,10,15,7,17,10,15,13,13,13,13,14,16,17,15,13,13,6,16,4,16,2,2,3,1,3,3,3,2,3,2,3,12,14,5,12,16,15,15,19,1,1,1,1,1,1,10,12,14,14,12,20,14,19,186,77,20,10,305612129,8350,7650,7250,Northern_European,160,3,1999/6/11,28,8,173988.0,,91151081
354,Dean Henderson,Nott'ham Forest,1997,224.0,eng ENG,GK,25.0,18.0,0.0,0.0,0.0,0.0,0.0,0.0,0.0,,0.0,0.0,0.0,0.0,0.0,0.0,12.0,1.0,Matches,224.0,eng ENG,GK,25.0,18.0,3.0,0.17,3.0,0.0,0.0,0.0,0.0,0.0,0.0,0.0,0.0,0.0,0.0,0.0,0.0,0.0,Matches,13.0,eng ENG,GK,25.0,18.0,31.0,2.0,1.0,5.0,0.0,26.9,0.28,-4.1,-0.23,108.0,334.0,32.3,513.0,107.0,47.2,38.5,156.0,59.0,45.3,291.0,20.0,6.9,27.0,1.5,15.6,Matches,13.0,eng ENG,GK,25.0,18.0,18.0,1620.0,18.0,31.0,1.72,85.0,52.0,65.9,5.0,5.0,8.0,6.0,33.3,5.0,2.0,2.0,1.0,50.0,Matches,224.0,eng ENG,GK,25.0,18.0,2.0,0.0,0.0,1.0,1.0,0.0,0.0,0.0,0.0,0.0,1.0,0.0,11.0,1.0,0.0,100.0,Matches,224.0,eng ENG,GK,25.0,18.0,671.0,455.0,214.0,58.0,0.0,0.0,0.0,0.0,0.0,0.0,0.0,0.0,425.0,2.0,0.0,Matches,224.0,eng ENG,GK,25.0,18.0,425.0,671.0,63.3,12543.0,8838.0,80.0,80.0,100.0,186.0,188.0,98.9,159.0,400.0,39.8,0.0,0.0,0.0,0.0,0.0,11.0,1.0,0.0,0.0,Matches,289,eng ENG,GK,25,18,1620.0,90.0,47.4,18.0,18,90.0,18,0,,0,1.11,15.0,31.0,-16.0,-0.89,-0.19,20.5,26.6,-6.1,-0.34,0.6,Matches,224.0,eng ENG,GK,25.0,18.0,715.0,600.0,711.0,5.0,0.0,0.0,715.0,0.0,0.0,,0.0,,397.0,2242.0,1245.0,0.0,0.0,0.0,1.0,0.0,319.0,0.0,Matches,224.0,eng ENG,GK,25.0,18.0,0.0,0.0,0.0,,0.0,0.0,,,,0.0,0.0,0.0,0.0,0.0,,0.0,0.0,Matches,224.0,eng ENG,GK,25.0,18.0,18.0,1620.0,18.0,0.0,0.0,0.0,0.0,0.0,0.0,2.0,0.0,0.0,0.0,0.0,0.0,0.0,0.0,0.0,0.0,0.0,0.0,0.0,0.0,0.0,0.0,0.0,0.0,0.0,Matches,Dean Henderson,GK,25,140,160,England,Manchester UFC,3,3,3,1,11,6,5,3,2,1,12,1,3,10,15,14,14,11,12,8,13,14,13,12,13,12,13,8,13,15,12,14,15,11,12,12,14,7,13,5,12,13,14,15,13,13,14,15,15,10,14,13,12,17,12,15,12,14,14,11,20,1,1,1,1,1,1,1,1,1,1,1,1,1,188,85,8,20,24881967,7089,7089,5989,Northern_European,139,1,1997/3/12,1,0,139190.0,Nottingham Forest,29125334
355,Jordan Henderson,Liverpool,1990,225.0,eng ENG,MF,32.0,23.0,32.0,23.0,10.0,18.0,4.0,15.0,36.0,41.7,21.0,21.0,3.0,18.0,21.0,53.0,16.0,1.0,Matches,225.0,eng ENG,MF,32.0,23.0,72.0,3.13,65.0,1.0,0.0,3.0,1.0,2.0,7.0,0.3,5.0,0.0,0.0,1.0,1.0,0.0,Matches,,,,,,,,,,,,,,,,,,,,,,,,,,,,,,,,,,,,,,,,,,,,,,,,,,,,,,,,225.0,eng ENG,MF,32.0,23.0,2.0,0.0,0.0,18.0,9.0,3.0,45.0,21.0,23.0,0.0,0.0,0.0,163.0,11.0,10.0,52.4,Matches,225.0,eng ENG,MF,32.0,23.0,1615.0,1554.0,53.0,12.0,9.0,11.0,45.0,17.0,0.0,0.0,0.0,0.0,1341.0,8.0,32.0,Matches,225.0,eng ENG,MF,32.0,23.0,1341.0,1615.0,83.0,22431.0,5954.0,666.0,734.0,90.7,513.0,594.0,86.4,122.0,193.0,63.2,2.0,3.2,3.6,-1.2,31.0,158.0,47.0,12.0,189.0,Matches,290,eng ENG,MF,32,35,2074.0,59.0,60.6,23.0,23,78.0,10,12,23.0,0,1.8,48.0,30.0,18.0,0.78,0.11,44.0,31.6,12.4,0.54,-0.08,Matches,225.0,eng ENG,MF,32.0,23.0,1782.0,34.0,277.0,1013.0,505.0,45.0,1782.0,23.0,12.0,52.2,8.0,34.8,1060.0,4836.0,2046.0,37.0,49.0,1.0,18.0,9.0,1319.0,90.0,Matches,225.0,eng ENG,MF,32.0,23.0,0.0,23.0,5.0,21.7,1.0,0.22,0.0,0.0,22.8,0.0,0.0,0.0,1.4,1.4,0.06,-1.4,-1.4,Matches,225.0,eng ENG,MF,32.0,35.0,23.0,2074.0,23.0,0.0,2.0,2.0,0.0,0.0,0.0,2.0,0.0,1.4,1.4,3.2,4.5,37.0,189.0,90.0,0.0,0.09,0.09,0.0,0.09,0.06,0.14,0.2,0.06,0.2,Matches,Jordan Henderson,DM/M C,32,154,159,England,Liverpool,11,13,11,8,15,10,10,9,9,15,13,10,14,14,14,15,16,15,15,14,14,19,11,19,14,16,18,18,13,13,14,13,15,14,18,15,15,8,17,9,13,1,1,1,1,2,2,4,2,2,1,3,15,18,4,18,19,20,15,19,1,1,14,13,1,12,20,1,19,14,1,8,1,1,183,80,8,20,347975206,7700,7700,7250,Northern_European,155,4,1990/6/17,69,2,220384.0,,28005568
356,Rico Henry,Brentford,1997,227.0,eng ENG,DF,25.0,36.0,57.0,31.0,20.0,28.0,9.0,22.0,41.0,53.7,19.0,29.0,8.0,21.0,30.0,87.0,84.0,1.0,Matches,227.0,eng ENG,DF,25.0,36.0,51.0,1.42,43.0,1.0,1.0,2.0,2.0,2.0,5.0,0.14,4.0,0.0,0.0,0.0,1.0,0.0,Matches,,,,,,,,,,,,,,,,,,,,,,,,,,,,,,,,,,,,,,,,,,,,,,,,,,,,,,,,227.0,eng ENG,DF,25.0,36.0,4.0,0.0,0.0,32.0,38.0,2.0,87.0,30.0,31.0,1.0,0.0,0.0,197.0,40.0,55.0,42.1,Matches,227.0,eng ENG,DF,25.0,36.0,1203.0,1059.0,138.0,1.0,4.0,2.0,87.0,137.0,0.0,0.0,0.0,0.0,876.0,6.0,21.0,Matches,227.0,eng ENG,DF,25.0,36.0,876.0,1203.0,72.8,14087.0,4856.0,469.0,544.0,86.2,314.0,418.0,75.1,72.0,169.0,42.6,2.0,2.6,2.9,-0.6,23.0,73.0,41.0,18.0,107.0,Matches,292,eng ENG,DF,25,37,3238.0,88.0,94.7,36.0,37,88.0,29,0,,0,1.51,53.0,46.0,7.0,0.19,-2.28,53.8,48.2,5.6,0.16,-0.39,Matches,227.0,eng ENG,DF,25.0,36.0,1582.0,115.0,478.0,647.0,482.0,30.0,1582.0,50.0,26.0,52.0,17.0,34.0,782.0,3790.0,1832.0,55.0,41.0,9.0,50.0,44.0,813.0,111.0,Matches,227.0,eng ENG,DF,25.0,36.0,0.0,22.0,4.0,18.2,0.61,0.11,0.0,0.0,20.0,0.0,0.0,0.0,1.6,1.6,0.07,-1.6,-1.6,Matches,227.0,eng ENG,DF,25.0,37.0,37.0,3238.0,36.0,0.0,2.0,2.0,0.0,0.0,0.0,4.0,0.0,1.6,1.6,2.6,4.2,55.0,107.0,111.0,0.0,0.06,0.06,0.0,0.06,0.04,0.07,0.12,0.04,0.12,Matches,Rico Henry,D/WB L,25,137,145,England,Brentford,7,13,14,9,14,7,12,8,8,12,13,7,13,13,12,13,13,14,13,13,14,15,13,9,12,13,13,14,16,13,13,8,14,16,13,12,15,4,13,11,11,1,3,2,2,4,4,2,3,2,4,1,13,14,7,12,14,14,15,14,1,20,1,1,19,1,1,14,1,1,12,1,1,1,170,66,20,7,29038095,6850,6850,6000,Mixed_Race,133,12,1997/7/8,0,0,46397.0,,29129073
357,Aaron Hickey,Brentford,2002,229.0,sct SCO,DF,20.0,21.3,38.0,26.0,27.0,11.0,0.0,18.0,32.0,56.3,14.0,18.0,7.0,11.0,17.0,55.0,32.0,1.0,Matches,229.0,sct SCO,DF,20.0,21.3,20.0,0.94,14.0,1.0,1.0,2.0,2.0,0.0,2.0,0.09,1.0,0.0,0.0,1.0,0.0,0.0,Matches,,,,,,,,,,,,,,,,,,,,,,,,,,,,,,,,,,,,,,,,,,,,,,,,,,,,,,,,229.0,sct SCO,DF,20.0,21.3,7.0,0.0,0.0,20.0,35.0,1.0,27.0,17.0,26.0,0.0,1.0,0.0,111.0,14.0,22.0,38.9,Matches,229.0,sct SCO,DF,20.0,21.3,838.0,743.0,93.0,11.0,2.0,1.0,27.0,82.0,0.0,0.0,0.0,0.0,695.0,2.0,17.0,Matches,229.0,sct SCO,DF,20.0,21.3,695.0,838.0,82.9,10998.0,3275.0,373.0,411.0,90.8,265.0,310.0,85.5,46.0,80.0,57.5,1.0,0.4,0.6,0.6,6.0,62.0,13.0,4.0,81.0,Matches,294,sct SCO,DF,20,26,1916.0,74.0,56.0,21.3,23,81.0,8,3,16.0,2,1.46,33.0,30.0,3.0,0.14,-0.4,32.3,27.3,4.9,0.23,0.13,Matches,229.0,sct SCO,DF,20.0,21.3,1028.0,47.0,328.0,499.0,211.0,21.0,1028.0,45.0,17.0,37.8,18.0,40.0,616.0,3295.0,1802.0,41.0,17.0,3.0,16.0,13.0,624.0,47.0,Matches,229.0,sct SCO,DF,20.0,21.3,0.0,11.0,2.0,18.2,0.52,0.09,0.0,0.0,21.5,0.0,0.0,0.0,0.4,0.4,0.04,-0.4,-0.4,Matches,229.0,sct SCO,DF,20.0,26.0,23.0,1916.0,21.3,0.0,1.0,1.0,0.0,0.0,0.0,7.0,0.0,0.4,0.4,0.4,0.8,41.0,81.0,47.0,0.0,0.05,0.05,0.0,0.05,0.02,0.02,0.04,0.02,0.04,Matches,Aaron Hickey,D/WB RL,20,132,-85,Scotland,Brentford,7,12,14,9,12,7,7,13,11,9,12,7,11,13,11,12,15,12,11,12,12,14,12,8,12,12,15,14,14,13,11,9,13,14,13,11,13,12,12,8,14,1,2,3,3,1,2,4,4,2,2,2,15,13,3,12,13,14,15,11,1,20,1,18,18,17,5,14,5,5,5,1,1,1,176,72,20,16,88444858,6600,6600,5500,Northern_European,122,0,2002/6/10,4,0,40597.0,,61089387
358,Kelechi Iheanacho,Leicester City,1996,237.0,ng NGA,FWMF,25.0,12.5,7.0,2.0,0.0,3.0,4.0,3.0,10.0,30.0,7.0,9.0,1.0,8.0,0.0,7.0,8.0,0.0,Matches,237.0,ng NGA,FWMF,25.0,12.5,45.0,3.59,33.0,1.0,4.0,5.0,2.0,0.0,6.0,0.48,6.0,0.0,0.0,0.0,0.0,0.0,Matches,,,,,,,,,,,,,,,,,,,,,,,,,,,,,,,,,,,,,,,,,,,,,,,,,,,,,,,,237.0,ng NGA,FWMF,25.0,12.5,0.0,0.0,0.0,18.0,5.0,12.0,6.0,0.0,2.0,0.0,0.0,0.0,30.0,15.0,31.0,32.6,Matches,237.0,ng NGA,FWMF,25.0,12.5,316.0,304.0,9.0,0.0,4.0,3.0,6.0,2.0,2.0,0.0,0.0,0.0,236.0,3.0,12.0,Matches,237.0,ng NGA,FWMF,25.0,12.5,236.0,316.0,74.7,3049.0,602.0,156.0,189.0,82.5,54.0,67.0,80.6,11.0,22.0,50.0,5.0,4.0,1.8,1.0,22.0,21.0,8.0,0.0,27.0,Matches,305,ng NGA,FWMF,25,28,1127.0,40.0,33.0,12.5,11,73.0,1,17,19.0,7,0.68,17.0,23.0,-6.0,-0.48,-0.05,22.6,22.5,0.1,0.01,0.51,Matches,237.0,ng NGA,FWMF,25.0,12.5,464.0,10.0,28.0,197.0,244.0,58.0,463.0,39.0,20.0,51.3,17.0,43.6,293.0,1661.0,724.0,33.0,13.0,18.0,41.0,36.0,380.0,99.0,Matches,237.0,ng NGA,FWMF,25.0,12.5,5.0,38.0,13.0,34.2,3.03,1.04,0.11,0.31,17.1,0.0,1.0,1.0,7.1,6.3,0.17,-2.1,-2.3,Matches,237.0,ng NGA,FWMF,25.0,28.0,11.0,1127.0,12.5,5.0,5.0,10.0,4.0,1.0,1.0,0.0,0.0,7.1,6.3,4.0,10.4,33.0,27.0,99.0,0.4,0.4,0.8,0.32,0.72,0.57,0.32,0.89,0.51,0.83,Matches,Kelechi Iheanacho,AM/S C,25,143,155,Nigeria,Leicester City,6,7,13,17,15,4,13,14,5,5,14,14,7,15,11,13,11,16,12,12,13,14,12,6,16,6,14,15,15,15,13,13,14,14,15,14,12,10,4,5,7,3,2,1,2,1,4,1,3,1,2,1,18,14,5,13,13,14,8,11,1,1,1,1,1,1,1,1,1,1,12,16,12,20,185,82,20,6,52631250,7150,7500,5500,African_Caribbean,143,15,1996/10/3,43,12,104393.0,,13136621
359,Alexander Isak,Newcastle Utd,1999,240.0,se SWE,FW,22.0,16.9,18.0,8.0,4.0,7.0,7.0,10.0,28.0,35.7,18.0,21.0,2.0,19.0,4.0,22.0,8.0,0.0,Matches,240.0,se SWE,FW,22.0,16.9,49.0,2.9,29.0,0.0,5.0,11.0,3.0,1.0,5.0,0.3,1.0,0.0,2.0,1.0,1.0,0.0,Matches,,,,,,,,,,,,,,,,,,,,,,,,,,,,,,,,,,,,,,,,,,,,,,,,,,,,,,,,240.0,se SWE,FW,22.0,16.9,3.0,0.0,0.0,19.0,15.0,5.0,7.0,4.0,8.0,1.0,1.0,0.0,38.0,22.0,28.0,44.0,Matches,240.0,se SWE,FW,22.0,16.9,368.0,338.0,25.0,1.0,8.0,2.0,7.0,4.0,1.0,0.0,0.0,0.0,279.0,5.0,12.0,Matches,240.0,se SWE,FW,22.0,16.9,279.0,368.0,75.8,4292.0,977.0,151.0,192.0,78.6,87.0,106.0,82.1,25.0,28.0,89.3,1.0,2.2,1.4,-1.2,16.0,29.0,15.0,0.0,48.0,Matches,310,se SWE,FW,22,22,1522.0,69.0,44.5,16.9,17,83.0,7,5,23.0,0,1.68,29.0,20.0,9.0,0.53,-0.7,37.5,17.9,19.6,1.16,0.56,Matches,240.0,se SWE,FW,22.0,16.9,583.0,11.0,34.0,202.0,358.0,98.0,581.0,72.0,32.0,44.4,30.0,41.7,371.0,2548.0,1300.0,41.0,36.0,22.0,39.0,25.0,431.0,122.0,Matches,240.0,se SWE,FW,22.0,16.9,10.0,49.0,23.0,46.9,2.9,1.36,0.16,0.35,15.0,0.0,2.0,2.0,8.2,6.7,0.14,1.8,1.3,Matches,240.0,se SWE,FW,22.0,22.0,17.0,1522.0,16.9,10.0,1.0,11.0,8.0,2.0,2.0,3.0,0.0,8.2,6.7,2.2,8.9,41.0,48.0,122.0,0.59,0.06,0.65,0.47,0.53,0.49,0.13,0.61,0.4,0.52,Matches,Alexander Isak,S,22,151,166,"Sweden,Eritrea",Newcastle United,7,9,15,14,15,8,12,9,6,5,13,14,6,16,11,15,13,13,11,15,14,14,16,7,16,6,12,12,17,15,15,16,14,16,14,12,12,7,15,5,8,2,3,3,3,1,1,3,2,3,3,2,13,15,5,10,13,12,14,14,1,1,1,1,1,1,1,12,1,12,12,10,12,20,190,74,10,20,140433523,7450,6759,5507,African_Caribbean,150,14,1999/9/21,37,9,139190.0,,93070286
360,Daniel Iversen,Leicester City,1997,241.0,dk DEN,GK,25.0,12.0,0.0,0.0,0.0,0.0,0.0,0.0,0.0,,0.0,0.0,0.0,0.0,0.0,0.0,6.0,1.0,Matches,241.0,dk DEN,GK,25.0,12.0,1.0,0.08,1.0,0.0,0.0,0.0,0.0,0.0,0.0,0.0,0.0,0.0,0.0,0.0,0.0,0.0,Matches,15.0,dk DEN,GK,25.0,12.0,22.0,2.0,2.0,2.0,1.0,18.9,0.29,-2.1,-0.18,38.0,194.0,19.6,261.0,49.0,47.1,37.2,114.0,62.3,46.2,203.0,16.0,7.9,6.0,0.5,10.3,Matches,15.0,dk DEN,GK,25.0,12.0,12.0,1080.0,12.0,22.0,1.83,59.0,38.0,66.1,2.0,4.0,6.0,1.0,8.3,2.0,2.0,0.0,0.0,0.0,Matches,241.0,dk DEN,GK,25.0,12.0,0.0,0.0,0.0,0.0,0.0,0.0,0.0,0.0,0.0,0.0,0.0,1.0,6.0,3.0,0.0,100.0,Matches,241.0,dk DEN,GK,25.0,12.0,377.0,214.0,161.0,47.0,0.0,1.0,0.0,0.0,0.0,0.0,0.0,0.0,212.0,2.0,1.0,Matches,241.0,dk DEN,GK,25.0,12.0,212.0,377.0,56.2,5408.0,3761.0,65.0,65.0,100.0,93.0,95.0,97.9,53.0,213.0,24.9,0.0,0.0,0.0,0.0,0.0,6.0,0.0,0.0,0.0,Matches,311,dk DEN,GK,25,12,1080.0,90.0,31.6,12.0,12,90.0,12,0,,26,0.83,14.0,22.0,-8.0,-0.67,-0.32,17.6,20.2,-2.6,-0.22,0.17,Matches,241.0,dk DEN,GK,25.0,12.0,411.0,344.0,406.0,5.0,0.0,0.0,411.0,0.0,0.0,,0.0,,177.0,1011.0,571.0,0.0,0.0,0.0,0.0,0.0,136.0,0.0,Matches,241.0,dk DEN,GK,25.0,12.0,0.0,0.0,0.0,,0.0,0.0,,,,0.0,0.0,0.0,0.0,0.0,,0.0,0.0,Matches,241.0,dk DEN,GK,25.0,12.0,12.0,1080.0,12.0,0.0,0.0,0.0,0.0,0.0,0.0,0.0,0.0,0.0,0.0,0.0,0.0,0.0,0.0,0.0,0.0,0.0,0.0,0.0,0.0,0.0,0.0,0.0,0.0,0.0,Matches,Daniel Iversen,GK,25,124,150,Denmark,Leicester City,6,3,3,1,10,8,2,2,3,3,10,3,2,9,9,11,12,10,11,9,12,14,1,12,3,13,12,11,9,14,10,15,12,9,12,13,14,6,10,3,14,14,14,13,4,13,11,15,15,9,14,11,15,14,2,12,6,20,14,15,20,1,1,1,1,1,1,1,1,1,1,1,1,1,193,80,8,20,3685842,6200,6000,3753,Northern_European,121,1,1997/7/19,0,0,23198.0,,27102367
361,Alex Iwobi,Everton,1996,242.0,ng NGA,MFFW,26.0,37.5,69.0,37.0,37.0,28.0,4.0,33.0,65.0,50.8,32.0,41.0,2.0,39.0,25.0,94.0,29.0,0.0,Matches,242.0,ng NGA,MFFW,26.0,37.5,120.0,3.2,91.0,9.0,8.0,7.0,3.0,2.0,9.0,0.24,8.0,0.0,0.0,0.0,1.0,0.0,Matches,,,,,,,,,,,,,,,,,,,,,,,,,,,,,,,,,,,,,,,,,,,,,,,,,,,,,,,,242.0,ng NGA,MFFW,26.0,37.5,2.0,0.0,0.0,19.0,15.0,4.0,104.0,25.0,37.0,1.0,0.0,0.0,259.0,10.0,28.0,26.3,Matches,242.0,ng NGA,MFFW,26.0,37.5,1536.0,1469.0,58.0,3.0,14.0,13.0,104.0,31.0,17.0,14.0,1.0,0.0,1154.0,9.0,46.0,Matches,242.0,ng NGA,MFFW,26.0,37.5,1154.0,1536.0,75.1,20102.0,6570.0,547.0,648.0,84.4,435.0,555.0,78.4,132.0,220.0,60.0,7.0,6.1,4.3,0.9,64.0,134.0,63.0,17.0,194.0,Matches,312,ng NGA,MFFW,26,38,3378.0,89.0,98.8,37.5,38,89.0,34,0,,0,0.95,34.0,56.0,-22.0,-0.59,1.56,44.8,64.5,-19.7,-0.52,0.93,Matches,242.0,ng NGA,MFFW,26.0,37.5,1912.0,52.0,359.0,892.0,709.0,59.0,1912.0,110.0,55.0,50.0,50.0,45.5,1169.0,6913.0,3434.0,90.0,79.0,15.0,68.0,42.0,1285.0,145.0,Matches,242.0,ng NGA,MFFW,26.0,37.5,2.0,42.0,15.0,35.7,1.12,0.4,0.05,0.13,21.0,0.0,0.0,0.0,2.5,2.5,0.06,-0.5,-0.5,Matches,242.0,ng NGA,MFFW,26.0,38.0,38.0,3378.0,37.5,2.0,7.0,9.0,2.0,0.0,0.0,2.0,0.0,2.5,2.5,6.1,8.5,90.0,194.0,145.0,0.05,0.19,0.24,0.05,0.24,0.07,0.16,0.23,0.07,0.23,Matches,Alex Iwobi,M C,26,136,155,"Nigeria,England",Everton,9,14,16,11,13,9,9,13,4,8,12,11,11,14,9,13,10,13,13,12,14,15,15,8,14,14,15,15,14,13,15,12,13,14,16,13,13,8,13,7,15,1,3,2,2,3,2,4,1,3,2,1,14,13,7,12,13,15,14,15,1,1,1,1,1,12,15,13,20,13,13,15,13,8,180,82,8,20,32508319,6799,6949,5849,African_Caribbean,133,14,1996/5/3,58,10,115992.0,,28084930
362,Reece James,Chelsea,1999,245.0,eng ENG,DFMF,22.0,13.8,31.0,20.0,10.0,18.0,3.0,15.0,19.0,78.9,4.0,17.0,2.0,15.0,12.0,43.0,23.0,0.0,Matches,245.0,eng ENG,DFMF,22.0,13.8,47.0,3.4,36.0,5.0,3.0,2.0,1.0,0.0,3.0,0.22,2.0,0.0,0.0,0.0,1.0,0.0,Matches,,,,,,,,,,,,,,,,,,,,,,,,,,,,,,,,,,,,,,,,,,,,,,,,,,,,,,,,245.0,eng ENG,DFMF,22.0,13.8,4.0,0.0,0.0,9.0,18.0,4.0,91.0,12.0,20.0,1.0,0.0,0.0,89.0,23.0,16.0,59.0,Matches,245.0,eng ENG,DFMF,22.0,13.8,1051.0,896.0,151.0,26.0,0.0,5.0,91.0,104.0,21.0,12.0,6.0,0.0,891.0,4.0,16.0,Matches,245.0,eng ENG,DFMF,22.0,13.8,891.0,1051.0,84.8,14345.0,4119.0,468.0,499.0,93.8,337.0,395.0,85.3,67.0,109.0,61.5,1.0,3.0,2.9,-2.0,21.0,60.0,24.0,6.0,90.0,Matches,317,eng ENG,DFMF,22,16,1244.0,78.0,36.4,13.8,14,85.0,12,2,27.0,0,1.44,15.0,17.0,-2.0,-0.14,0.14,19.3,14.5,4.8,0.35,0.67,Matches,245.0,eng ENG,DFMF,22.0,13.8,1187.0,39.0,256.0,543.0,395.0,25.0,1187.0,40.0,22.0,55.0,10.0,25.0,710.0,3722.0,2018.0,52.0,26.0,9.0,13.0,14.0,813.0,115.0,Matches,245.0,eng ENG,DFMF,22.0,13.8,1.0,16.0,4.0,25.0,1.16,0.29,0.06,0.25,22.4,2.0,0.0,0.0,1.0,1.0,0.06,0.0,0.0,Matches,245.0,eng ENG,DFMF,22.0,16.0,14.0,1244.0,13.8,1.0,1.0,2.0,1.0,0.0,0.0,4.0,0.0,1.0,1.0,3.0,4.0,52.0,90.0,115.0,0.07,0.07,0.14,0.07,0.14,0.07,0.22,0.29,0.07,0.29,Matches,Reece James,D/WB RC,22,164,170,England,Chelsea,13,16,11,12,14,14,14,11,9,13,13,7,14,15,16,14,18,16,14,11,16,17,12,13,12,13,15,16,15,12,19,10,15,14,15,18,16,10,15,5,13,1,3,1,1,2,2,2,1,3,4,2,8,17,4,12,16,19,15,12,1,10,16,20,10,19,15,1,13,12,1,1,1,1,175,90,10,20,287615409,8400,8200,7000,African_Caribbean,160,11,1999/12/8,13,0,289979.0,,28108035
363,Vitaly Janelt,Brentford,1998,246.0,de GER,MFDF,24.0,24.5,54.0,27.0,20.0,24.0,10.0,21.0,49.0,42.9,28.0,29.0,9.0,20.0,29.0,83.0,26.0,0.0,Matches,246.0,de GER,MFDF,24.0,24.5,47.0,1.91,39.0,1.0,2.0,3.0,0.0,2.0,4.0,0.16,4.0,0.0,0.0,0.0,0.0,0.0,Matches,,,,,,,,,,,,,,,,,,,,,,,,,,,,,,,,,,,,,,,,,,,,,,,,,,,,,,,,246.0,de GER,MFDF,24.0,24.5,3.0,0.0,0.0,22.0,21.0,2.0,22.0,29.0,27.0,0.0,0.0,0.0,159.0,32.0,23.0,58.2,Matches,246.0,de GER,MFDF,24.0,24.5,1020.0,986.0,29.0,12.0,3.0,17.0,22.0,16.0,1.0,1.0,0.0,0.0,812.0,5.0,21.0,Matches,246.0,de GER,MFDF,24.0,24.5,812.0,1020.0,79.6,14151.0,3894.0,411.0,466.0,88.2,298.0,360.0,82.8,90.0,139.0,64.7,1.0,1.4,1.5,-0.4,16.0,75.0,19.0,8.0,82.0,Matches,318,de GER,MFDF,24,35,2208.0,63.0,64.6,24.5,24,80.0,13,11,26.0,0,1.63,34.0,28.0,6.0,0.24,-0.2,37.9,30.3,7.6,0.31,0.38,Matches,246.0,de GER,MFDF,24.0,24.5,1244.0,66.0,335.0,675.0,242.0,36.0,1244.0,24.0,9.0,37.5,14.0,58.3,663.0,2798.0,1246.0,14.0,18.0,2.0,18.0,11.0,737.0,28.0,Matches,246.0,de GER,MFDF,24.0,24.5,3.0,14.0,5.0,35.7,0.57,0.2,0.21,0.6,15.8,0.0,0.0,0.0,2.4,2.4,0.17,0.6,0.6,Matches,246.0,de GER,MFDF,24.0,35.0,24.0,2208.0,24.5,3.0,1.0,4.0,3.0,0.0,0.0,3.0,0.0,2.4,2.4,1.4,3.8,14.0,82.0,28.0,0.12,0.04,0.16,0.12,0.16,0.1,0.06,0.15,0.1,0.15,Matches,Vitaly Janelt,DM/M C,24,135,148,Germany,Brentford,10,12,13,12,13,9,12,13,12,12,14,8,14,13,16,14,16,13,14,13,12,15,8,12,11,12,15,15,12,12,14,12,16,12,15,14,14,12,14,5,13,1,1,1,2,1,1,2,3,3,1,2,14,13,11,10,14,13,12,16,1,12,10,12,1,1,20,1,20,1,1,1,1,1,184,79,20,10,25632341,6750,6750,5250,Northern_European,136,3,1998/5/10,0,0,46397.0,,91143519
364,Mathias Jensen,Brentford,1996,248.0,dk DEN,MF,26.0,31.1,70.0,35.0,28.0,30.0,12.0,34.0,97.0,35.1,63.0,54.0,5.0,49.0,32.0,102.0,24.0,1.0,Matches,248.0,dk DEN,MF,26.0,31.1,103.0,3.31,48.0,47.0,1.0,3.0,3.0,1.0,13.0,0.42,7.0,4.0,0.0,1.0,0.0,1.0,Matches,,,,,,,,,,,,,,,,,,,,,,,,,,,,,,,,,,,,,,,,,,,,,,,,,,,,,,,,248.0,dk DEN,MF,26.0,31.1,5.0,0.0,0.0,32.0,25.0,1.0,158.0,32.0,35.0,0.0,0.0,0.0,175.0,11.0,17.0,39.3,Matches,248.0,dk DEN,MF,26.0,31.1,1566.0,1158.0,401.0,84.0,5.0,28.0,158.0,184.0,76.0,37.0,18.0,7.0,1088.0,7.0,25.0,Matches,248.0,dk DEN,MF,26.0,31.1,1088.0,1566.0,69.5,21665.0,8457.0,471.0,559.0,84.3,398.0,555.0,71.7,191.0,372.0,51.3,6.0,5.0,4.7,1.0,48.0,117.0,38.0,16.0,141.0,Matches,320,dk DEN,MF,26,37,2803.0,76.0,82.0,31.1,37,76.0,10,0,,0,1.51,45.0,40.0,5.0,0.16,-0.86,43.5,39.7,3.8,0.12,-0.3,Matches,248.0,dk DEN,MF,26.0,31.1,1890.0,43.0,368.0,869.0,669.0,29.0,1890.0,62.0,25.0,40.3,28.0,45.2,901.0,3514.0,1386.0,21.0,25.0,1.0,54.0,32.0,1011.0,77.0,Matches,248.0,dk DEN,MF,26.0,31.1,5.0,23.0,7.0,30.4,0.74,0.22,0.22,0.71,22.0,4.0,0.0,0.0,2.1,2.1,0.09,2.9,2.9,Matches,248.0,dk DEN,MF,26.0,37.0,37.0,2803.0,31.1,5.0,6.0,11.0,5.0,0.0,0.0,5.0,0.0,2.1,2.1,5.0,7.1,21.0,141.0,77.0,0.16,0.19,0.35,0.16,0.35,0.07,0.16,0.23,0.07,0.23,Matches,Mathias Jensen,M C,26,133,145,Denmark,Brentford,13,13,13,10,14,12,9,11,5,9,14,10,12,14,9,13,11,13,13,16,14,12,14,12,13,11,13,14,11,12,12,10,13,11,13,11,12,8,12,12,13,3,4,2,2,2,3,2,3,2,3,1,15,15,4,14,13,13,13,14,1,1,1,1,1,1,13,10,20,12,1,14,1,1,180,71,15,20,15258581,6650,6650,5500,Northern_European,132,4,1996/1/1,19,1,40597.0,,27088231
365,Gabriel Jesus,Arsenal,1997,249.0,br BRA,FW,25.0,22.9,33.0,25.0,16.0,8.0,9.0,15.0,31.0,48.4,16.0,27.0,3.0,24.0,11.0,44.0,15.0,1.0,Matches,249.0,br BRA,FW,25.0,22.9,83.0,3.62,43.0,1.0,12.0,11.0,13.0,3.0,12.0,0.52,8.0,0.0,1.0,1.0,2.0,0.0,Matches,,,,,,,,,,,,,,,,,,,,,,,,,,,,,,,,,,,,,,,,,,,,,,,,,,,,,,,,249.0,br BRA,FW,25.0,22.9,6.0,0.0,0.0,43.0,56.0,16.0,11.0,11.0,25.0,2.0,0.0,0.0,79.0,44.0,78.0,36.1,Matches,249.0,br BRA,FW,25.0,22.9,699.0,635.0,62.0,4.0,4.0,5.0,11.0,12.0,0.0,0.0,0.0,0.0,561.0,2.0,19.0,Matches,249.0,br BRA,FW,25.0,22.9,561.0,699.0,80.3,8525.0,1644.0,297.0,349.0,85.1,206.0,234.0,88.0,28.0,45.0,62.2,6.0,3.9,2.9,2.1,31.0,31.0,22.0,2.0,64.0,Matches,321,br BRA,FW,25,26,2064.0,79.0,60.4,22.9,24,84.0,11,2,20.0,0,2.23,53.0,23.0,30.0,1.31,0.31,43.2,23.2,20.0,0.87,0.22,Matches,249.0,br BRA,FW,25.0,22.9,1080.0,26.0,110.0,406.0,573.0,191.0,1079.0,111.0,44.0,39.6,49.0,44.1,642.0,3467.0,1517.0,44.0,31.0,28.0,88.0,65.0,799.0,194.0,Matches,249.0,br BRA,FW,25.0,22.9,11.0,76.0,31.0,40.8,3.31,1.35,0.13,0.32,10.6,0.0,1.0,1.0,14.0,13.2,0.18,-3.0,-3.2,Matches,249.0,br BRA,FW,25.0,26.0,24.0,2064.0,22.9,11.0,6.0,17.0,10.0,1.0,1.0,6.0,0.0,14.0,13.2,3.9,17.1,44.0,64.0,194.0,0.48,0.26,0.74,0.44,0.7,0.61,0.17,0.78,0.58,0.75,Matches,Gabriel Jesus,AM/S RL,25,162,175,Brazil,Arsenal,7,12,16,16,15,11,15,12,4,6,14,13,8,16,12,15,13,15,14,14,15,13,16,8,16,7,15,16,15,16,15,10,15,15,14,13,13,12,14,8,12,1,1,1,2,2,3,2,1,4,1,4,15,13,8,12,14,14,11,11,1,1,1,1,1,1,1,1,1,1,15,11,17,20,175,73,13,20,282622772,8098,7998,7848,African_Caribbean,161,15,1997/4/3,56,19,139190.0,,19220266
366,Joelinton,Newcastle Utd,1996,251.0,br BRA,MFFW,25.0,29.6,70.0,49.0,36.0,26.0,8.0,26.0,62.0,41.9,36.0,52.0,7.0,45.0,48.0,118.0,39.0,0.0,Matches,251.0,br BRA,MFFW,25.0,29.6,80.0,2.71,54.0,1.0,9.0,8.0,7.0,1.0,10.0,0.34,4.0,1.0,2.0,2.0,1.0,0.0,Matches,,,,,,,,,,,,,,,,,,,,,,,,,,,,,,,,,,,,,,,,,,,,,,,,,,,,,,,,251.0,br BRA,MFFW,25.0,29.6,12.0,0.0,0.0,65.0,34.0,1.0,16.0,48.0,49.0,1.0,1.0,0.0,198.0,66.0,58.0,53.2,Matches,251.0,br BRA,MFFW,25.0,29.6,1268.0,1227.0,38.0,14.0,3.0,4.0,16.0,19.0,4.0,0.0,0.0,0.0,1035.0,3.0,40.0,Matches,251.0,br BRA,MFFW,25.0,29.6,1035.0,1268.0,81.6,15180.0,4014.0,581.0,668.0,87.0,338.0,390.0,86.7,59.0,75.0,78.7,1.0,2.4,1.9,-1.4,26.0,78.0,21.0,3.0,130.0,Matches,323,br BRA,MFFW,25,32,2661.0,83.0,77.8,29.6,30,87.0,25,2,24.0,1,1.78,51.0,26.0,25.0,0.85,-0.34,55.1,31.6,23.5,0.8,-0.25,Matches,251.0,br BRA,MFFW,25.0,29.6,1703.0,71.0,312.0,852.0,562.0,96.0,1703.0,111.0,53.0,47.7,42.0,37.8,897.0,4853.0,2286.0,64.0,45.0,13.0,72.0,51.0,1115.0,150.0,Matches,251.0,br BRA,MFFW,25.0,29.6,6.0,51.0,19.0,37.3,1.72,0.64,0.12,0.32,14.6,0.0,0.0,0.0,7.1,7.1,0.14,-1.1,-1.1,Matches,251.0,br BRA,MFFW,25.0,32.0,30.0,2661.0,29.6,6.0,1.0,7.0,6.0,0.0,0.0,12.0,0.0,7.1,7.1,2.4,9.4,64.0,130.0,150.0,0.2,0.03,0.24,0.2,0.24,0.24,0.08,0.32,0.24,0.32,Matches,Joelinton,M/AM/S LC,25,143,145,Brazil,Newcastle United,7,11,15,11,14,8,15,10,6,7,13,11,16,14,17,13,19,14,12,13,14,15,14,9,13,13,17,18,11,11,15,14,12,14,16,17,15,10,10,9,10,1,3,1,2,2,3,3,2,1,1,2,11,16,12,10,13,11,7,10,1,1,1,1,1,1,1,1,20,10,16,16,10,16,186,81,10,20,55999655,7150,6500,5750,Mixed_Race,141,13,1996/8/14,0,0,92793.0,,19184436
367,Brennan Johnson,Nott'ham Forest,2001,253.0,wls WAL,FWMF,21.0,32.6,34.0,20.0,18.0,8.0,8.0,8.0,29.0,27.6,21.0,30.0,1.0,29.0,5.0,39.0,7.0,1.0,Matches,253.0,wls WAL,FWMF,21.0,32.6,55.0,1.69,36.0,0.0,6.0,7.0,5.0,1.0,11.0,0.34,5.0,0.0,1.0,3.0,2.0,0.0,Matches,,,,,,,,,,,,,,,,,,,,,,,,,,,,,,,,,,,,,,,,,,,,,,,,,,,,,,,,253.0,wls WAL,FWMF,21.0,32.6,6.0,0.0,0.0,37.0,21.0,18.0,58.0,5.0,20.0,1.0,0.0,0.0,89.0,18.0,48.0,27.3,Matches,253.0,wls WAL,FWMF,21.0,32.6,505.0,480.0,23.0,0.0,0.0,2.0,58.0,4.0,1.0,1.0,0.0,0.0,291.0,2.0,27.0,Matches,253.0,wls WAL,FWMF,21.0,32.6,291.0,505.0,57.6,4220.0,809.0,155.0,223.0,69.5,103.0,177.0,58.2,15.0,34.0,44.1,3.0,3.2,1.9,-0.2,28.0,12.0,18.0,6.0,30.0,Matches,325,wls WAL,FWMF,21,38,2934.0,77.0,85.8,32.6,33,86.0,21,5,20.0,0,1.0,30.0,54.0,-24.0,-0.74,0.37,31.8,52.8,-20.9,-0.64,0.1,Matches,253.0,wls WAL,FWMF,21.0,32.6,806.0,9.0,90.0,309.0,434.0,116.0,803.0,88.0,33.0,37.5,41.0,46.6,450.0,3848.0,2111.0,88.0,46.0,42.0,76.0,25.0,507.0,155.0,Matches,253.0,wls WAL,FWMF,21.0,32.6,8.0,52.0,24.0,46.2,1.6,0.74,0.13,0.29,16.6,0.0,1.0,3.0,8.6,6.2,0.12,-0.6,0.8,Matches,253.0,wls WAL,FWMF,21.0,38.0,33.0,2934.0,32.6,8.0,3.0,11.0,7.0,1.0,3.0,6.0,0.0,8.6,6.2,3.2,9.4,88.0,30.0,155.0,0.25,0.09,0.34,0.21,0.31,0.26,0.1,0.36,0.19,0.29,Matches,Brennan Johnson,AM/S RC,21,136,162,"Wales,England",Nottingham Forest,8,13,14,13,12,11,8,10,5,7,14,14,6,13,6,11,12,13,10,12,13,12,13,10,13,8,12,13,16,13,12,8,14,15,13,9,13,5,13,3,9,3,3,3,3,2,1,3,3,1,2,1,11,12,3,13,14,12,10,12,1,1,1,1,1,1,1,10,9,12,14,17,20,18,180,0,10,20,47361745,6800,6800,5000,African_Caribbean,129,13,2001/5/23,13,2,46397.0,,29189400
368,Curtis Jones,Liverpool,2001,255.0,eng ENG,MF,21.0,11.5,34.0,17.0,8.0,12.0,14.0,18.0,31.0,58.1,13.0,12.0,2.0,10.0,3.0,37.0,9.0,0.0,Matches,255.0,eng ENG,MF,21.0,11.5,38.0,3.3,31.0,0.0,4.0,1.0,1.0,1.0,4.0,0.35,3.0,0.0,1.0,0.0,0.0,0.0,Matches,,,,,,,,,,,,,,,,,,,,,,,,,,,,,,,,,,,,,,,,,,,,,,,,,,,,,,,,255.0,eng ENG,MF,21.0,11.5,2.0,0.0,0.0,13.0,16.0,2.0,9.0,3.0,17.0,0.0,0.0,0.0,56.0,3.0,6.0,33.3,Matches,255.0,eng ENG,MF,21.0,11.5,677.0,664.0,12.0,2.0,5.0,3.0,9.0,9.0,0.0,0.0,0.0,0.0,611.0,1.0,7.0,Matches,255.0,eng ENG,MF,21.0,11.5,611.0,677.0,90.3,9160.0,1895.0,334.0,355.0,94.1,233.0,250.0,93.2,25.0,32.0,78.1,1.0,1.1,1.4,-0.1,14.0,53.0,14.0,1.0,69.0,Matches,327,eng ENG,MF,21,18,1035.0,58.0,30.3,11.5,12,78.0,2,6,18.0,5,1.94,23.0,15.0,8.0,0.7,-0.06,23.2,15.8,7.4,0.64,0.11,Matches,255.0,eng ENG,MF,21.0,11.5,821.0,14.0,105.0,417.0,304.0,40.0,821.0,30.0,11.0,36.7,13.0,43.3,550.0,2645.0,1011.0,31.0,15.0,11.0,22.0,29.0,627.0,75.0,Matches,255.0,eng ENG,MF,21.0,11.5,3.0,15.0,5.0,33.3,1.3,0.43,0.2,0.6,17.9,0.0,0.0,0.0,1.2,1.2,0.08,1.8,1.8,Matches,255.0,eng ENG,MF,21.0,18.0,12.0,1035.0,11.5,3.0,1.0,4.0,3.0,0.0,0.0,2.0,0.0,1.2,1.2,1.1,2.3,31.0,69.0,75.0,0.26,0.09,0.35,0.26,0.35,0.1,0.1,0.2,0.1,0.2,Matches,Curtis Jones,M/AM LC,21,143,160,England,Liverpool,12,13,16,12,16,11,9,13,7,11,14,13,9,15,11,14,11,15,14,14,13,15,15,11,14,10,15,14,14,15,14,9,12,13,13,11,12,8,13,8,11,3,4,1,3,2,3,3,3,3,3,3,14,16,8,16,15,15,12,15,1,1,1,1,1,1,12,1,20,1,19,16,14,12,185,75,9,20,66985227,7150,7150,6000,Northern_European,140,7,2001/1/30,0,0,52196.0,,28115788
369,Jorginho,Chelsea,1991,257.0,it ITA,MF,30.0,14.2,42.0,23.0,22.0,14.0,6.0,22.0,46.0,47.8,24.0,18.0,3.0,15.0,21.0,63.0,7.0,0.0,Matches,257.0,it ITA,MF,30.0,14.2,29.0,2.04,29.0,0.0,0.0,0.0,0.0,0.0,2.0,0.14,2.0,0.0,0.0,0.0,0.0,0.0,Matches,,,,,,,,,,,,,,,,,,,,,,,,,,,,,,,,,,,,,,,,,,,,,,,,,,,,,,,,257.0,it ITA,MF,30.0,14.2,4.0,0.0,0.0,12.0,23.0,0.0,2.0,21.0,23.0,0.0,0.0,0.0,119.0,8.0,11.0,42.1,Matches,257.0,it ITA,MF,30.0,14.2,884.0,853.0,28.0,27.0,2.0,3.0,2.0,1.0,0.0,0.0,0.0,0.0,749.0,3.0,11.0,Matches,257.0,it ITA,MF,30.0,14.2,749.0,884.0,84.7,11991.0,3508.0,379.0,421.0,90.0,301.0,348.0,86.5,51.0,74.0,68.9,0.0,0.4,0.4,-0.4,7.0,87.0,9.0,0.0,80.0,Matches,329,it ITA,MF,30,18,1279.0,71.0,37.4,14.2,15,81.0,8,3,23.0,2,1.61,16.0,12.0,4.0,0.28,0.83,17.0,16.4,0.5,0.04,0.19,Matches,257.0,it ITA,MF,30.0,14.2,1026.0,36.0,273.0,577.0,178.0,8.0,1024.0,12.0,5.0,41.7,4.0,33.3,546.0,2331.0,1090.0,13.0,27.0,1.0,14.0,9.0,706.0,10.0,Matches,257.0,it ITA,MF,30.0,14.2,2.0,3.0,1.0,33.3,0.21,0.07,0.0,0.0,34.1,0.0,2.0,2.0,1.7,0.1,0.04,0.3,-0.1,Matches,257.0,it ITA,MF,30.0,18.0,15.0,1279.0,14.2,2.0,0.0,2.0,0.0,2.0,2.0,4.0,0.0,1.7,0.1,0.4,0.5,13.0,80.0,10.0,0.14,0.0,0.14,0.0,0.0,0.12,0.03,0.14,0.01,0.03,Matches,Jorginho,DM/M C,30,164,165,"Italy,Brazil",Chelsea,11,12,12,8,18,9,7,9,2,10,18,18,14,16,10,16,14,19,15,18,18,15,13,15,15,14,17,17,11,14,14,9,14,12,17,9,15,10,15,8,6,1,3,2,1,1,2,2,3,1,2,2,11,15,7,12,13,17,13,12,1,1,1,1,1,1,20,1,20,1,1,10,1,1,180,65,9,20,193594995,8199,7749,7249,Mediterranean_Hispanic,158,4,1991/12/20,44,5,127591.0,,43036641
370,Diogo Jota,Liverpool,1996,259.0,pt POR,FW,25.0,12.6,23.0,15.0,8.0,8.0,7.0,12.0,37.0,32.4,25.0,5.0,0.0,5.0,3.0,26.0,11.0,0.0,Matches,259.0,pt POR,FW,25.0,12.6,33.0,2.63,23.0,0.0,3.0,5.0,2.0,0.0,5.0,0.4,4.0,0.0,1.0,0.0,0.0,0.0,Matches,,,,,,,,,,,,,,,,,,,,,,,,,,,,,,,,,,,,,,,,,,,,,,,,,,,,,,,,259.0,pt POR,FW,25.0,12.6,2.0,0.0,0.0,19.0,15.0,3.0,8.0,3.0,15.0,1.0,0.0,0.0,60.0,18.0,26.0,40.9,Matches,259.0,pt POR,FW,25.0,12.6,381.0,379.0,2.0,0.0,3.0,1.0,8.0,0.0,0.0,0.0,0.0,0.0,286.0,0.0,14.0,Matches,259.0,pt POR,FW,25.0,12.6,286.0,381.0,75.1,3868.0,886.0,172.0,216.0,79.6,87.0,109.0,79.8,10.0,20.0,50.0,4.0,2.1,1.7,1.9,17.0,28.0,8.0,2.0,30.0,Matches,331,pt POR,FW,25,22,1131.0,51.0,33.1,12.6,12,76.0,2,10,22.0,0,1.95,24.0,19.0,5.0,0.4,-0.51,25.4,17.6,7.8,0.62,0.07,Matches,259.0,pt POR,FW,25.0,12.6,550.0,21.0,71.0,235.0,252.0,73.0,550.0,39.0,14.0,35.9,21.0,53.8,339.0,1938.0,1067.0,34.0,26.0,14.0,34.0,19.0,403.0,104.0,Matches,259.0,pt POR,FW,25.0,12.6,7.0,35.0,11.0,31.4,2.79,0.88,0.2,0.64,11.7,0.0,0.0,0.0,6.5,6.5,0.19,0.5,0.5,Matches,259.0,pt POR,FW,25.0,22.0,12.0,1131.0,12.6,7.0,4.0,11.0,7.0,0.0,0.0,2.0,0.0,6.5,6.5,2.1,8.6,34.0,30.0,104.0,0.56,0.32,0.88,0.56,0.88,0.52,0.17,0.69,0.52,0.69,Matches,Diogo Jota,AM/S RL,25,158,166,Portugal,Liverpool,7,12,16,15,14,10,15,12,4,8,13,11,8,15,14,14,12,14,13,13,14,17,16,5,15,9,14,14,16,16,13,11,14,15,13,11,14,12,14,8,12,2,2,3,3,1,3,3,3,1,3,1,14,16,11,12,15,15,11,12,1,1,1,1,1,1,1,1,1,1,20,14,18,19,178,73,14,20,87689752,7900,8250,6750,Mediterranean_Hispanic,152,5,1996/12/4,27,9,162388.0,,55083779
371,James Justin,Leicester City,1998,261.0,eng ENG,DF,24.0,13.9,20.0,18.0,7.0,12.0,1.0,9.0,18.0,50.0,9.0,24.0,6.0,18.0,15.0,35.0,47.0,0.0,Matches,261.0,eng ENG,DF,24.0,13.9,21.0,1.51,17.0,0.0,2.0,0.0,2.0,0.0,2.0,0.14,0.0,0.0,1.0,0.0,1.0,0.0,Matches,,,,,,,,,,,,,,,,,,,,,,,,,,,,,,,,,,,,,,,,,,,,,,,,,,,,,,,,261.0,eng ENG,DF,24.0,13.9,0.0,0.0,0.0,8.0,29.0,2.0,21.0,15.0,18.0,1.0,0.0,0.0,64.0,23.0,32.0,41.8,Matches,261.0,eng ENG,DF,24.0,13.9,819.0,687.0,130.0,16.0,0.0,4.0,21.0,114.0,0.0,0.0,0.0,0.0,667.0,2.0,19.0,Matches,261.0,eng ENG,DF,24.0,13.9,667.0,819.0,81.4,10404.0,3063.0,371.0,408.0,90.9,239.0,282.0,84.8,39.0,81.0,48.1,0.0,0.3,0.5,-0.3,7.0,48.0,12.0,7.0,47.0,Matches,334,eng ENG,DF,24,14,1252.0,89.0,36.6,13.9,14,89.0,12,0,,0,1.0,23.0,25.0,-2.0,-0.14,0.48,15.9,20.8,-5.0,-0.36,-0.03,Matches,261.0,eng ENG,DF,24.0,13.9,980.0,48.0,296.0,475.0,216.0,8.0,980.0,19.0,4.0,21.1,11.0,57.9,417.0,1831.0,834.0,20.0,19.0,4.0,15.0,6.0,574.0,50.0,Matches,261.0,eng ENG,DF,24.0,13.9,0.0,5.0,0.0,0.0,0.36,0.0,0.0,,23.4,0.0,0.0,0.0,0.3,0.3,0.06,-0.3,-0.3,Matches,261.0,eng ENG,DF,24.0,14.0,14.0,1252.0,13.9,0.0,0.0,0.0,0.0,0.0,0.0,0.0,0.0,0.3,0.3,0.3,0.6,20.0,47.0,50.0,0.0,0.0,0.0,0.0,0.0,0.02,0.02,0.05,0.02,0.05,Matches,James Justin,D/WB RLC,24,143,161,England,Leicester City,9,11,13,5,11,9,12,8,11,13,12,6,12,12,12,12,11,12,12,11,12,16,7,8,10,13,14,15,15,13,11,12,14,15,16,12,16,8,9,8,15,1,2,2,3,4,1,1,1,1,1,2,8,12,8,12,14,12,14,12,1,19,16,20,18,18,10,1,10,1,1,1,1,1,183,80,13,20,39368175,7150,7150,5500,African_Caribbean,130,14,1998/2/23,1,0,115992.0,,29140167
372,Mathias Jørgensen,Brentford,1990,262.0,dk DEN,DF,32.0,12.3,17.0,8.0,9.0,8.0,0.0,9.0,21.0,42.9,12.0,19.0,12.0,7.0,16.0,33.0,39.0,1.0,Matches,262.0,dk DEN,DF,32.0,12.3,9.0,0.73,5.0,4.0,0.0,0.0,0.0,0.0,1.0,0.08,0.0,1.0,0.0,0.0,0.0,0.0,Matches,,,,,,,,,,,,,,,,,,,,,,,,,,,,,,,,,,,,,,,,,,,,,,,,,,,,,,,,262.0,dk DEN,DF,32.0,12.3,2.0,0.0,0.0,9.0,4.0,2.0,3.0,16.0,8.0,0.0,0.0,1.0,53.0,17.0,15.0,53.1,Matches,262.0,dk DEN,DF,32.0,12.3,503.0,437.0,65.0,6.0,0.0,0.0,3.0,55.0,0.0,0.0,0.0,0.0,404.0,1.0,2.0,Matches,262.0,dk DEN,DF,32.0,12.3,404.0,503.0,80.3,6929.0,3051.0,181.0,203.0,89.2,197.0,240.0,82.1,20.0,49.0,40.8,0.0,0.2,0.2,-0.2,3.0,30.0,0.0,0.0,35.0,Matches,335,dk DEN,DF,32,18,1103.0,61.0,32.3,12.3,11,85.0,9,7,24.0,15,1.83,17.0,15.0,2.0,0.16,-0.23,18.4,20.4,-2.0,-0.16,-0.5,Matches,262.0,dk DEN,DF,32.0,12.3,612.0,87.0,291.0,281.0,42.0,12.0,612.0,1.0,0.0,0.0,1.0,100.0,295.0,1062.0,616.0,1.0,2.0,0.0,3.0,1.0,321.0,1.0,Matches,262.0,dk DEN,DF,32.0,12.3,0.0,5.0,1.0,20.0,0.41,0.08,0.0,0.0,7.8,0.0,0.0,0.0,0.9,0.9,0.18,-0.9,-0.9,Matches,262.0,dk DEN,DF,32.0,18.0,11.0,1103.0,12.3,0.0,0.0,0.0,0.0,0.0,0.0,2.0,0.0,0.9,0.9,0.2,1.1,1.0,35.0,1.0,0.0,0.0,0.0,0.0,0.0,0.07,0.01,0.09,0.07,0.09,Matches,Mathias Jørgensen,D C,32,123,155,"Denmark,The Gambia",Brentford,5,5,11,7,13,8,13,6,11,13,14,7,13,13,12,13,13,15,9,12,11,13,10,14,8,13,13,12,12,11,15,15,13,12,13,14,11,16,17,9,7,2,1,3,1,1,1,1,3,2,2,1,16,14,16,10,16,12,8,8,1,1,20,10,1,1,5,1,1,1,1,1,1,1,191,79,12,20,628985,6150,6150,5200,Mixed_Race,123,15,1990/4/23,35,2,25000.0,,27000592
373,Boubacar Kamara,Aston Villa,1999,264.0,fr FRA,MF,22.0,19.7,58.0,25.0,25.0,23.0,10.0,27.0,56.0,48.2,29.0,38.0,12.0,26.0,19.0,77.0,24.0,3.0,Matches,264.0,fr FRA,MF,22.0,19.7,23.0,1.17,19.0,0.0,1.0,0.0,3.0,0.0,4.0,0.2,2.0,0.0,1.0,0.0,1.0,0.0,Matches,,,,,,,,,,,,,,,,,,,,,,,,,,,,,,,,,,,,,,,,,,,,,,,,,,,,,,,,264.0,fr FRA,MF,22.0,19.7,4.0,0.0,0.0,34.0,31.0,0.0,1.0,19.0,25.0,0.0,0.0,0.0,126.0,22.0,17.0,56.4,Matches,264.0,fr FRA,MF,22.0,19.7,941.0,907.0,34.0,32.0,2.0,10.0,1.0,0.0,0.0,0.0,0.0,0.0,798.0,0.0,20.0,Matches,264.0,fr FRA,MF,22.0,19.7,798.0,941.0,84.8,13161.0,3895.0,395.0,441.0,89.6,303.0,334.0,90.7,67.0,95.0,70.5,1.0,0.8,0.7,0.2,7.0,61.0,6.0,0.0,84.0,Matches,337,fr FRA,MF,22,24,1777.0,74.0,52.0,19.7,21,83.0,14,3,14.0,0,1.63,28.0,30.0,-2.0,-0.1,-0.48,24.2,33.1,-8.9,-0.45,-0.81,Matches,264.0,fr FRA,MF,22.0,19.7,1145.0,65.0,362.0,662.0,132.0,10.0,1145.0,35.0,16.0,45.7,12.0,34.3,622.0,2571.0,1173.0,16.0,11.0,1.0,20.0,14.0,713.0,8.0,Matches,264.0,fr FRA,MF,22.0,19.7,0.0,4.0,1.0,25.0,0.2,0.05,0.0,0.0,29.7,0.0,0.0,0.0,0.2,0.2,0.05,-0.2,-0.2,Matches,264.0,fr FRA,MF,22.0,24.0,21.0,1777.0,19.7,0.0,1.0,1.0,0.0,0.0,0.0,4.0,0.0,0.2,0.2,0.8,1.0,16.0,84.0,8.0,0.0,0.05,0.05,0.0,0.05,0.01,0.04,0.05,0.01,0.05,Matches,Boubacar Kamara,D/DM C,22,139,164,France,Aston Villa,6,8,13,6,12,6,13,8,5,14,15,7,15,13,12,14,14,14,13,13,13,13,9,9,11,14,15,15,14,13,15,14,14,15,14,12,14,11,12,8,12,3,2,1,1,3,1,3,1,4,3,3,18,14,8,13,12,14,12,14,1,6,20,8,1,1,20,1,13,1,1,1,1,1,184,68,10,20,61429223,6950,6950,5500,African_Caribbean,139,13,1999/11/23,3,0,115992.0,,48043084
374,Harry Kane,Tottenham,1993,265.0,eng ENG,FW,29.0,37.8,15.0,12.0,1.0,6.0,8.0,7.0,21.0,33.3,14.0,27.0,7.0,20.0,2.0,17.0,18.0,0.0,Matches,265.0,eng ENG,FW,29.0,37.8,131.0,3.46,89.0,2.0,13.0,12.0,12.0,3.0,18.0,0.48,10.0,0.0,2.0,3.0,3.0,0.0,Matches,,,,,,,,,,,,,,,,,,,,,,,,,,,,,,,,,,,,,,,,,,,,,,,,,,,,,,,,265.0,eng ENG,FW,29.0,37.8,6.0,0.0,0.0,31.0,56.0,16.0,37.0,2.0,12.0,2.0,0.0,0.0,96.0,66.0,81.0,44.9,Matches,265.0,eng ENG,FW,29.0,37.8,921.0,853.0,60.0,14.0,20.0,18.0,37.0,25.0,0.0,0.0,0.0,0.0,642.0,8.0,39.0,Matches,265.0,eng ENG,FW,29.0,37.8,642.0,921.0,69.7,12295.0,4345.0,286.0,368.0,77.7,236.0,302.0,78.1,103.0,164.0,62.8,3.0,7.0,4.0,-4.0,57.0,100.0,47.0,6.0,180.0,Matches,338,eng ENG,FW,29,38,3405.0,90.0,99.6,37.8,38,90.0,35,0,,0,1.58,70.0,62.0,8.0,0.21,6.21,56.8,49.4,7.5,0.2,0.5,Matches,265.0,eng ENG,FW,29.0,37.8,1328.0,28.0,106.0,646.0,599.0,167.0,1322.0,108.0,40.0,37.0,53.0,49.1,834.0,4546.0,1842.0,60.0,50.0,21.0,74.0,58.0,1031.0,193.0,Matches,265.0,eng ENG,FW,29.0,37.8,30.0,124.0,54.0,43.5,3.28,1.43,0.2,0.46,16.0,4.0,5.0,6.0,21.4,16.7,0.13,8.6,8.3,Matches,265.0,eng ENG,FW,29.0,38.0,38.0,3405.0,37.8,30.0,3.0,33.0,25.0,5.0,6.0,6.0,0.0,21.4,16.7,7.0,23.7,60.0,180.0,193.0,0.79,0.08,0.87,0.66,0.74,0.57,0.18,0.75,0.44,0.63,Matches,Harry Kane,S C,28,183,185,"England,Republic of Ireland",Tottenham Hotspur,9,15,14,19,15,10,15,15,6,10,18,20,11,16,11,15,14,18,15,18,18,19,12,15,16,12,18,16,12,12,14,13,16,14,16,15,17,8,14,12,9,1,1,3,1,3,2,1,2,2,3,1,10,18,12,18,18,20,11,16,1,1,1,1,1,1,1,1,11,1,13,15,1,20,188,86,19,20,347975206,9200,9200,8750,Northern_European,183,4,1993/7/28,73,50,231983.0,,28049320
375,Michael Keane,Everton,1993,267.0,eng ENG,DF,29.0,10.9,7.0,4.0,5.0,2.0,0.0,5.0,8.0,62.5,3.0,12.0,7.0,5.0,14.0,21.0,55.0,1.0,Matches,267.0,eng ENG,DF,29.0,10.9,10.0,0.91,8.0,0.0,0.0,1.0,1.0,0.0,2.0,0.18,2.0,0.0,0.0,0.0,0.0,0.0,Matches,,,,,,,,,,,,,,,,,,,,,,,,,,,,,,,,,,,,,,,,,,,,,,,,,,,,,,,,267.0,eng ENG,DF,29.0,10.9,0.0,0.0,0.0,7.0,4.0,0.0,4.0,14.0,4.0,0.0,2.0,0.0,62.0,67.0,33.0,67.0,Matches,267.0,eng ENG,DF,29.0,10.9,441.0,429.0,9.0,3.0,0.0,0.0,4.0,6.0,0.0,0.0,0.0,0.0,305.0,3.0,8.0,Matches,267.0,eng ENG,DF,29.0,10.9,305.0,441.0,69.2,5849.0,2983.0,115.0,146.0,78.8,147.0,179.0,82.1,39.0,93.0,41.9,2.0,0.7,0.8,1.3,3.0,33.0,2.0,0.0,31.0,Matches,341,eng ENG,DF,29,12,985.0,82.0,28.8,10.9,10,90.0,10,2,43.0,20,0.83,11.0,22.0,-11.0,-1.01,-0.56,14.0,23.0,-9.0,-0.82,-0.4,Matches,267.0,eng ENG,DF,29.0,10.9,565.0,83.0,275.0,239.0,55.0,24.0,565.0,7.0,4.0,57.1,2.0,28.6,257.0,1282.0,719.0,2.0,2.0,0.0,6.0,2.0,275.0,4.0,Matches,267.0,eng ENG,DF,29.0,10.9,1.0,14.0,4.0,28.6,1.28,0.37,0.07,0.25,12.9,0.0,0.0,0.0,1.3,1.3,0.1,-0.3,-0.3,Matches,267.0,eng ENG,DF,29.0,12.0,10.0,985.0,10.9,1.0,2.0,3.0,1.0,0.0,0.0,0.0,0.0,1.3,1.3,0.7,2.1,2.0,31.0,4.0,0.09,0.18,0.27,0.09,0.27,0.12,0.07,0.19,0.12,0.19,Matches,Michael Keane,D C,29,127,146,"England,Republic of Ireland",Everton,5,8,8,9,12,5,16,5,12,14,12,5,16,12,11,15,13,11,13,9,11,17,5,11,10,14,15,13,10,9,13,14,14,12,13,15,12,8,12,11,10,1,3,4,1,1,3,1,3,1,1,2,10,15,5,14,14,16,16,14,1,1,20,13,1,1,1,1,7,10,1,1,1,1,186,83,11,20,10643607,6500,6500,5650,Northern_European,127,1,1993/1/11,12,1,81194.0,,28047558
376,Thilo Kehrer,West Ham,1996,269.0,de GER,DF,25.0,24.8,43.0,24.0,25.0,14.0,4.0,21.0,45.0,46.7,24.0,16.0,6.0,10.0,34.0,77.0,76.0,1.0,Matches,269.0,de GER,DF,25.0,24.8,24.0,0.97,17.0,4.0,0.0,3.0,0.0,0.0,4.0,0.16,2.0,1.0,0.0,1.0,0.0,0.0,Matches,,,,,,,,,,,,,,,,,,,,,,,,,,,,,,,,,,,,,,,,,,,,,,,,,,,,,,,,269.0,de GER,DF,25.0,24.8,4.0,0.0,0.0,31.0,12.0,0.0,23.0,34.0,24.0,0.0,1.0,1.0,117.0,36.0,33.0,52.2,Matches,269.0,de GER,DF,25.0,24.8,1112.0,992.0,116.0,24.0,1.0,6.0,23.0,91.0,0.0,0.0,0.0,0.0,927.0,4.0,14.0,Matches,269.0,de GER,DF,25.0,24.8,927.0,1112.0,83.4,16374.0,6006.0,393.0,447.0,87.9,456.0,510.0,89.4,68.0,119.0,57.1,2.0,0.6,0.8,1.4,8.0,59.0,4.0,1.0,60.0,Matches,343,de GER,DF,25,27,2230.0,83.0,65.2,24.8,25,87.0,23,2,27.0,8,1.15,26.0,34.0,-8.0,-0.32,0.06,31.9,31.6,0.4,0.02,0.34,Matches,269.0,de GER,DF,25.0,24.8,1335.0,135.0,600.0,595.0,147.0,17.0,1335.0,11.0,8.0,72.7,3.0,27.3,677.0,2885.0,1533.0,15.0,12.0,1.0,17.0,6.0,760.0,29.0,Matches,269.0,de GER,DF,25.0,24.8,0.0,8.0,1.0,12.5,0.32,0.04,0.0,0.0,18.4,0.0,0.0,0.0,0.5,0.5,0.06,-0.5,-0.5,Matches,269.0,de GER,DF,25.0,27.0,25.0,2230.0,24.8,0.0,2.0,2.0,0.0,0.0,0.0,4.0,0.0,0.5,0.5,0.6,1.1,15.0,60.0,29.0,0.0,0.08,0.08,0.0,0.08,0.02,0.03,0.04,0.02,0.04,Matches,Thilo Kehrer,D RC,25,135,146,"Germany,Burundi",West Ham United,6,10,9,6,13,5,14,8,10,14,13,7,15,13,14,13,14,14,12,12,12,10,9,12,7,11,13,13,13,13,12,14,16,15,14,13,12,13,14,5,17,3,2,2,2,1,2,2,1,3,3,3,10,17,15,6,12,9,14,12,1,12,20,17,8,10,15,1,15,1,1,1,1,1,186,76,14,20,22075703,6750,6750,5500,Mixed_Race,133,11,1996/9/21,20,0,110192.0,,91126230
377,Lloyd Kelly,Bournemouth,1998,272.0,eng ENG,DF,23.0,22.7,33.0,18.0,23.0,9.0,1.0,13.0,19.0,68.4,6.0,26.0,15.0,11.0,26.0,59.0,101.0,1.0,Matches,272.0,eng ENG,DF,23.0,22.7,16.0,0.71,13.0,1.0,0.0,1.0,1.0,0.0,2.0,0.09,2.0,0.0,0.0,0.0,0.0,0.0,Matches,,,,,,,,,,,,,,,,,,,,,,,,,,,,,,,,,,,,,,,,,,,,,,,,,,,,,,,,272.0,eng ENG,DF,23.0,22.7,3.0,0.0,0.0,17.0,5.0,0.0,14.0,26.0,18.0,0.0,1.0,0.0,131.0,36.0,20.0,64.3,Matches,272.0,eng ENG,DF,23.0,22.7,1164.0,1020.0,140.0,29.0,2.0,11.0,14.0,109.0,0.0,0.0,0.0,0.0,934.0,4.0,12.0,Matches,272.0,eng ENG,DF,23.0,22.7,934.0,1164.0,80.2,17585.0,7174.0,352.0,387.0,91.0,461.0,510.0,90.4,104.0,227.0,45.8,2.0,0.5,0.8,1.5,7.0,73.0,9.0,3.0,47.0,Matches,346,eng ENG,DF,23,23,2040.0,89.0,59.6,22.7,23,89.0,22,0,,0,1.13,19.0,38.0,-19.0,-0.84,0.14,22.0,36.1,-14.1,-0.62,0.11,Matches,272.0,eng ENG,DF,23.0,22.7,1394.0,185.0,752.0,526.0,124.0,9.0,1394.0,7.0,1.0,14.3,5.0,71.4,705.0,3316.0,1879.0,14.0,4.0,0.0,16.0,4.0,806.0,10.0,Matches,272.0,eng ENG,DF,23.0,22.7,0.0,3.0,0.0,0.0,0.13,0.0,0.0,,8.9,0.0,0.0,0.0,0.2,0.2,0.06,-0.2,-0.2,Matches,272.0,eng ENG,DF,23.0,23.0,23.0,2040.0,22.7,0.0,2.0,2.0,0.0,0.0,0.0,3.0,0.0,0.2,0.2,0.5,0.7,14.0,47.0,10.0,0.0,0.09,0.09,0.0,0.09,0.01,0.02,0.03,0.01,0.03,Matches,Lloyd Kelly,D LC,23,132,153,England,AFC Bournemouth,7,12,10,6,11,5,13,6,12,14,13,7,14,12,10,13,12,14,11,9,14,13,6,13,9,13,13,13,13,13,14,14,11,14,14,13,12,10,12,7,11,2,2,1,1,3,3,2,3,2,3,1,10,9,4,14,12,12,15,13,1,19,20,1,10,1,1,1,1,1,1,1,1,1,191,0,20,9,22428781,6593,6593,4993,African_Caribbean,132,17,1998/10/1,0,0,40597.0,,29158244
378,Max Kilman,Wolves,1997,273.0,eng ENG,DF,25.0,36.7,36.0,20.0,26.0,9.0,1.0,16.0,30.0,53.3,14.0,70.0,42.0,28.0,19.0,55.0,164.0,1.0,Matches,273.0,eng ENG,DF,25.0,36.7,23.0,0.63,20.0,0.0,0.0,2.0,1.0,0.0,2.0,0.05,1.0,0.0,0.0,1.0,0.0,0.0,Matches,,,,,,,,,,,,,,,,,,,,,,,,,,,,,,,,,,,,,,,,,,,,,,,,,,,,,,,,273.0,eng ENG,DF,25.0,36.7,3.0,0.0,0.0,18.0,12.0,0.0,5.0,19.0,20.0,0.0,0.0,0.0,219.0,86.0,42.0,67.2,Matches,273.0,eng ENG,DF,25.0,36.7,2107.0,2069.0,29.0,28.0,0.0,31.0,5.0,1.0,0.0,0.0,0.0,0.0,1748.0,9.0,20.0,Matches,273.0,eng ENG,DF,25.0,36.7,1748.0,2107.0,83.0,34713.0,12450.0,574.0,621.0,92.4,964.0,1046.0,92.2,189.0,384.0,49.2,0.0,0.2,0.6,-0.2,4.0,133.0,7.0,2.0,127.0,Matches,347,eng ENG,DF,25,37,3307.0,89.0,96.7,36.7,37,89.0,36,0,,1,1.08,30.0,56.0,-26.0,-0.71,0.09,35.1,57.1,-22.0,-0.6,0.26,Matches,273.0,eng ENG,DF,25.0,36.7,2470.0,432.0,1460.0,952.0,75.0,26.0,2470.0,25.0,19.0,76.0,6.0,24.0,1443.0,7679.0,4615.0,30.0,15.0,2.0,15.0,9.0,1699.0,5.0,Matches,273.0,eng ENG,DF,25.0,36.7,0.0,14.0,0.0,0.0,0.38,0.0,0.0,,10.1,0.0,0.0,0.0,1.3,1.3,0.1,-1.3,-1.3,Matches,273.0,eng ENG,DF,25.0,37.0,37.0,3307.0,36.7,0.0,0.0,0.0,0.0,0.0,0.0,3.0,0.0,1.3,1.3,0.2,1.6,30.0,127.0,5.0,0.0,0.0,0.0,0.0,0.0,0.04,0.01,0.04,0.04,0.04,Matches,Max Kilman,D C,25,136,155,"England,Russia,Ukraine",Wolverhampton Wanderers,4,11,13,6,13,10,16,7,7,14,14,2,14,15,7,15,12,14,11,13,12,15,11,6,11,12,12,12,14,13,13,15,11,14,13,14,14,10,13,10,13,1,3,1,3,1,1,2,4,3,2,3,8,13,3,13,15,14,15,15,1,10,20,1,10,1,1,1,1,1,1,1,1,1,194,89,20,13,20183497,6800,6800,5500,Northern_European,136,3,1997/5/23,0,0,34798.0,,29142052
379,Robin Koch,Leeds United,1996,276.0,de GER,DF,26.0,35.3,53.0,30.0,32.0,16.0,5.0,24.0,56.0,42.9,32.0,44.0,21.0,23.0,43.0,96.0,152.0,1.0,Matches,276.0,de GER,DF,26.0,35.3,15.0,0.43,11.0,2.0,0.0,2.0,0.0,0.0,2.0,0.06,2.0,0.0,0.0,0.0,0.0,0.0,Matches,,,,,,,,,,,,,,,,,,,,,,,,,,,,,,,,,,,,,,,,,,,,,,,,,,,,,,,,276.0,de GER,DF,26.0,35.3,7.0,0.0,0.0,35.0,17.0,1.0,1.0,43.0,30.0,0.0,0.0,1.0,193.0,111.0,69.0,61.7,Matches,276.0,de GER,DF,26.0,35.3,1594.0,1544.0,46.0,46.0,2.0,5.0,1.0,0.0,0.0,0.0,0.0,0.0,1229.0,4.0,25.0,Matches,276.0,de GER,DF,26.0,35.3,1229.0,1594.0,77.1,23945.0,10673.0,409.0,485.0,84.3,665.0,772.0,86.1,141.0,285.0,49.5,0.0,0.4,0.5,-0.4,6.0,121.0,7.0,0.0,114.0,Matches,352,de GER,DF,26,36,3175.0,88.0,92.8,35.3,36,88.0,33,0,,1,0.86,46.0,74.0,-28.0,-0.79,-0.06,44.9,63.6,-18.7,-0.53,-0.13,Matches,276.0,de GER,DF,26.0,35.3,1963.0,263.0,1051.0,820.0,106.0,32.0,1963.0,3.0,1.0,33.3,2.0,66.7,1013.0,4700.0,2583.0,11.0,8.0,0.0,15.0,1.0,1102.0,11.0,Matches,276.0,de GER,DF,26.0,35.3,0.0,17.0,4.0,23.5,0.48,0.11,0.0,0.0,11.1,0.0,0.0,0.0,1.5,1.5,0.09,-1.5,-1.5,Matches,276.0,de GER,DF,26.0,36.0,36.0,3175.0,35.3,0.0,0.0,0.0,0.0,0.0,0.0,7.0,0.0,1.5,1.5,0.4,1.9,11.0,114.0,11.0,0.0,0.0,0.0,0.0,0.0,0.04,0.01,0.06,0.04,0.06,Matches,Robin Koch,D/DM C,26,134,146,Germany,Leeds United,2,5,8,5,12,3,15,8,10,14,13,6,14,11,7,13,12,13,13,11,12,13,5,8,9,14,15,13,13,11,12,16,13,15,13,14,13,7,12,13,17,3,1,2,1,2,3,3,3,3,2,3,7,14,5,12,12,15,15,17,1,13,20,14,10,10,17,1,15,1,1,1,1,1,190,82,10,20,17268104,6700,6700,5600,Northern_European,130,4,1996/7/17,8,0,46397.0,,91147345
380,Ibrahima Konaté,Liverpool,1999,277.0,fr FRA,DF,23.0,17.2,38.0,26.0,25.0,13.0,0.0,16.0,27.0,59.3,11.0,12.0,5.0,7.0,26.0,64.0,61.0,4.0,Matches,277.0,fr FRA,DF,23.0,17.2,17.0,0.99,12.0,0.0,1.0,2.0,1.0,1.0,1.0,0.06,1.0,0.0,0.0,0.0,0.0,0.0,Matches,,,,,,,,,,,,,,,,,,,,,,,,,,,,,,,,,,,,,,,,,,,,,,,,,,,,,,,,277.0,fr FRA,DF,23.0,17.2,5.0,0.0,0.0,29.0,15.0,1.0,1.0,26.0,26.0,0.0,1.0,1.0,107.0,46.0,14.0,76.7,Matches,277.0,fr FRA,DF,23.0,17.2,1135.0,1115.0,19.0,16.0,2.0,6.0,1.0,3.0,0.0,0.0,0.0,0.0,988.0,1.0,5.0,Matches,277.0,fr FRA,DF,23.0,17.2,988.0,1135.0,87.0,17712.0,6925.0,374.0,413.0,90.6,539.0,588.0,91.7,59.0,109.0,54.1,0.0,0.1,0.8,-0.1,1.0,56.0,2.0,0.0,56.0,Matches,353,fr FRA,DF,23,18,1552.0,86.0,45.4,17.2,17,90.0,17,1,22.0,3,1.72,34.0,22.0,12.0,0.7,-0.08,31.9,23.3,8.6,0.5,-0.13,Matches,277.0,fr FRA,DF,23.0,17.2,1317.0,107.0,589.0,691.0,43.0,22.0,1317.0,14.0,10.0,71.4,2.0,14.3,829.0,3627.0,1871.0,7.0,7.0,0.0,12.0,4.0,918.0,5.0,Matches,277.0,fr FRA,DF,23.0,17.2,0.0,11.0,3.0,27.3,0.64,0.17,0.0,0.0,9.7,0.0,0.0,0.0,1.2,1.2,0.11,-1.2,-1.2,Matches,277.0,fr FRA,DF,23.0,18.0,17.0,1552.0,17.2,0.0,0.0,0.0,0.0,0.0,0.0,5.0,0.0,1.2,1.2,0.1,1.4,7.0,56.0,5.0,0.0,0.0,0.0,0.0,0.0,0.07,0.01,0.08,0.07,0.08,Matches,Ibrahima Konaté,D C,23,152,165,France,Liverpool,3,5,13,7,14,6,16,5,12,14,13,7,15,13,15,14,16,14,14,9,14,14,6,10,7,14,14,14,14,12,16,17,14,16,12,17,15,9,15,9,7,3,3,1,2,2,3,2,1,3,1,4,13,16,10,10,15,13,11,15,1,1,20,1,1,1,12,1,10,1,1,1,1,1,194,95,10,20,58367041,7600,6328,6123,African_Caribbean,151,17,1999/5/25,2,0,81194.0,,48037822
381,Ezri Konsa,Aston Villa,1997,278.0,eng ENG,DF,24.0,36.9,42.0,20.0,25.0,15.0,2.0,18.0,26.0,69.2,8.0,41.0,23.0,18.0,26.0,68.0,120.0,3.0,Matches,278.0,eng ENG,DF,24.0,36.9,15.0,0.41,13.0,0.0,0.0,1.0,1.0,0.0,2.0,0.05,2.0,0.0,0.0,0.0,0.0,0.0,Matches,,,,,,,,,,,,,,,,,,,,,,,,,,,,,,,,,,,,,,,,,,,,,,,,,,,,,,,,278.0,eng ENG,DF,24.0,36.9,6.0,0.0,0.0,12.0,64.0,0.0,4.0,26.0,20.0,0.0,0.0,0.0,164.0,55.0,37.0,59.8,Matches,278.0,eng ENG,DF,24.0,36.9,1898.0,1806.0,88.0,60.0,1.0,6.0,4.0,18.0,0.0,0.0,0.0,0.0,1681.0,4.0,14.0,Matches,278.0,eng ENG,DF,24.0,36.9,1681.0,1898.0,88.6,30731.0,10578.0,608.0,663.0,91.7,938.0,997.0,94.1,120.0,202.0,59.4,0.0,1.3,0.7,-1.3,8.0,70.0,4.0,2.0,56.0,Matches,354,eng ENG,DF,24,38,3322.0,87.0,97.1,36.9,37,90.0,36,1,1.0,0,1.61,49.0,45.0,4.0,0.11,-0.81,47.8,51.1,-3.4,-0.09,-1.15,Matches,278.0,eng ENG,DF,24.0,36.9,2192.0,349.0,1280.0,850.0,70.0,22.0,2192.0,15.0,5.0,33.3,3.0,20.0,1375.0,6226.0,3596.0,7.0,9.0,0.0,15.0,5.0,1533.0,11.0,Matches,278.0,eng ENG,DF,24.0,36.9,0.0,8.0,0.0,0.0,0.22,0.0,0.0,,8.0,0.0,0.0,0.0,1.1,1.1,0.13,-1.1,-1.1,Matches,278.0,eng ENG,DF,24.0,38.0,37.0,3322.0,36.9,0.0,0.0,0.0,0.0,0.0,0.0,6.0,0.0,1.1,1.1,1.3,2.3,7.0,56.0,11.0,0.0,0.0,0.0,0.0,0.0,0.03,0.03,0.06,0.03,0.06,Matches,Ezri Konsa,D C,24,138,150,"England,Democratic Republic of Congo,Angola",Aston Villa,4,7,12,5,13,3,15,3,7,13,14,4,15,14,13,14,14,15,12,14,13,13,10,10,9,14,15,16,14,14,13,14,14,14,15,14,11,11,13,9,13,1,2,1,3,3,2,3,3,3,2,2,13,13,3,15,13,12,13,13,1,1,20,14,1,1,1,1,1,1,1,1,1,1,183,77,9,20,31004591,6900,6900,5750,African_Caribbean,138,14,1997/10/23,0,0,81194.0,,29141827
382,Kalidou Koulibaly,Chelsea,1991,279.0,sn SEN,DF,31.0,20.0,45.0,31.0,34.0,8.0,3.0,26.0,40.0,65.0,14.0,30.0,13.0,17.0,29.0,74.0,77.0,0.0,Matches,279.0,sn SEN,DF,31.0,20.0,21.0,1.05,17.0,0.0,0.0,2.0,0.0,2.0,3.0,0.15,3.0,0.0,0.0,0.0,0.0,0.0,Matches,,,,,,,,,,,,,,,,,,,,,,,,,,,,,,,,,,,,,,,,,,,,,,,,,,,,,,,,279.0,sn SEN,DF,31.0,20.0,7.0,1.0,1.0,22.0,9.0,0.0,4.0,29.0,31.0,0.0,0.0,0.0,126.0,33.0,28.0,54.1,Matches,279.0,sn SEN,DF,31.0,20.0,1471.0,1421.0,45.0,33.0,0.0,15.0,4.0,12.0,0.0,0.0,0.0,0.0,1275.0,5.0,12.0,Matches,279.0,sn SEN,DF,31.0,20.0,1275.0,1471.0,86.7,22422.0,9023.0,564.0,598.0,94.3,595.0,653.0,91.1,96.0,175.0,54.9,1.0,0.4,0.4,0.6,7.0,83.0,9.0,1.0,81.0,Matches,355,sn SEN,DF,31,23,1800.0,78.0,52.6,20.0,20,87.0,17,3,23.0,6,1.26,20.0,22.0,-2.0,-0.1,0.29,26.7,22.6,4.2,0.21,0.61,Matches,279.0,sn SEN,DF,31.0,20.0,1687.0,174.0,793.0,838.0,63.0,19.0,1687.0,6.0,4.0,66.7,2.0,33.3,1083.0,4728.0,2459.0,10.0,8.0,0.0,10.0,2.0,1209.0,4.0,Matches,279.0,sn SEN,DF,31.0,20.0,2.0,11.0,4.0,36.4,0.55,0.2,0.18,0.5,12.0,0.0,0.0,0.0,0.9,0.9,0.09,1.1,1.1,Matches,279.0,sn SEN,DF,31.0,23.0,20.0,1800.0,20.0,2.0,1.0,3.0,2.0,0.0,0.0,7.0,1.0,0.9,0.9,0.4,1.4,10.0,81.0,4.0,0.1,0.05,0.15,0.1,0.15,0.05,0.02,0.07,0.05,0.07,Matches,Kalidou Koulibaly,D C,31,160,168,"Senegal,France",Chelsea,4,6,10,10,12,4,16,6,6,18,13,6,17,11,15,14,18,10,8,10,13,11,8,13,10,16,16,16,12,14,15,15,13,17,15,19,14,13,7,9,8,3,1,1,2,4,4,1,3,2,3,1,12,15,7,13,8,14,14,14,1,1,20,10,1,1,1,1,1,1,1,1,1,1,187,89,9,20,347975206,8000,7750,7000,African_Caribbean,157,18,1991/6/20,61,0,347975.0,,85051083
383,Mateo Kovačić,Chelsea,1994,281.0,hr CRO,MF,28.0,19.0,36.0,24.0,16.0,14.0,6.0,14.0,36.0,38.9,22.0,10.0,1.0,9.0,19.0,55.0,16.0,0.0,Matches,281.0,hr CRO,MF,28.0,19.0,62.0,3.27,53.0,1.0,2.0,4.0,0.0,2.0,3.0,0.16,3.0,0.0,0.0,0.0,0.0,0.0,Matches,,,,,,,,,,,,,,,,,,,,,,,,,,,,,,,,,,,,,,,,,,,,,,,,,,,,,,,,281.0,hr CRO,MF,28.0,19.0,8.0,0.0,0.0,18.0,12.0,0.0,6.0,19.0,24.0,0.0,0.0,0.0,121.0,10.0,10.0,50.0,Matches,281.0,hr CRO,MF,28.0,19.0,1319.0,1289.0,29.0,26.0,10.0,10.0,6.0,3.0,0.0,0.0,0.0,0.0,1130.0,1.0,25.0,Matches,281.0,hr CRO,MF,28.0,19.0,1130.0,1319.0,85.7,18537.0,5579.0,555.0,614.0,90.4,470.0,522.0,90.0,76.0,120.0,63.3,2.0,2.1,2.1,-0.1,23.0,158.0,23.0,1.0,153.0,Matches,357,hr CRO,MF,28,27,1707.0,63.0,49.9,19.0,17,82.0,10,10,32.0,2,1.15,14.0,25.0,-11.0,-0.58,-0.69,24.7,24.1,0.6,0.03,0.22,Matches,281.0,hr CRO,MF,28.0,19.0,1492.0,31.0,279.0,938.0,289.0,12.0,1492.0,34.0,19.0,55.9,10.0,29.4,1010.0,5517.0,2591.0,37.0,39.0,2.0,26.0,26.0,1144.0,30.0,Matches,281.0,hr CRO,MF,28.0,19.0,1.0,23.0,1.0,4.3,1.21,0.05,0.04,1.0,22.1,0.0,0.0,0.0,1.8,1.8,0.08,-0.8,-0.8,Matches,281.0,hr CRO,MF,28.0,27.0,17.0,1707.0,19.0,1.0,2.0,3.0,1.0,0.0,0.0,8.0,0.0,1.8,1.8,2.1,3.9,37.0,153.0,30.0,0.05,0.11,0.16,0.05,0.16,0.09,0.11,0.2,0.09,0.2,Matches,Mateo Kovačić,DM/M C,28,164,172,"Croatia,Austria",Chelsea,10,10,17,8,17,12,10,10,7,12,15,12,15,17,14,16,14,18,11,15,16,17,16,11,13,12,15,17,15,15,16,9,12,14,15,15,13,12,13,8,15,3,2,2,1,2,1,2,4,3,2,2,14,14,9,12,14,16,14,17,1,1,1,1,1,1,18,10,20,10,7,15,5,1,178,78,11,20,233998516,8300,8050,7250,Northern_European,164,5,1994/5/6,81,3,173988.0,,24016925
384,Rasmus Kristensen,Leeds United,1997,283.0,dk DEN,DF,25.0,21.8,62.0,35.0,35.0,21.0,6.0,42.0,76.0,55.3,34.0,32.0,14.0,18.0,35.0,97.0,61.0,0.0,Matches,283.0,dk DEN,DF,25.0,21.8,35.0,1.61,30.0,1.0,2.0,1.0,0.0,1.0,3.0,0.14,2.0,0.0,1.0,0.0,0.0,0.0,Matches,,,,,,,,,,,,,,,,,,,,,,,,,,,,,,,,,,,,,,,,,,,,,,,,,,,,,,,,283.0,dk DEN,DF,25.0,21.8,4.0,0.0,0.0,19.0,6.0,1.0,35.0,35.0,35.0,0.0,0.0,0.0,119.0,34.0,27.0,55.7,Matches,283.0,dk DEN,DF,25.0,21.8,1044.0,861.0,181.0,7.0,0.0,3.0,35.0,174.0,0.0,0.0,0.0,0.0,740.0,2.0,38.0,Matches,283.0,dk DEN,DF,25.0,21.8,740.0,1044.0,70.9,12326.0,5355.0,364.0,435.0,83.7,310.0,410.0,75.6,52.0,134.0,38.8,1.0,1.0,0.9,0.0,9.0,63.0,16.0,2.0,89.0,Matches,360,dk DEN,DF,25,26,1960.0,75.0,57.3,21.8,21,87.0,17,5,26.0,11,0.88,29.0,53.0,-24.0,-1.1,-0.73,26.8,40.8,-14.0,-0.64,-0.28,Matches,283.0,dk DEN,DF,25.0,21.8,1276.0,90.0,470.0,529.0,282.0,23.0,1276.0,15.0,7.0,46.7,7.0,46.7,548.0,1725.0,833.0,15.0,10.0,4.0,6.0,5.0,633.0,70.0,Matches,283.0,dk DEN,DF,25.0,21.8,3.0,13.0,5.0,38.5,0.6,0.23,0.23,0.6,15.2,0.0,0.0,0.0,0.8,0.8,0.06,2.2,2.2,Matches,283.0,dk DEN,DF,25.0,26.0,21.0,1960.0,21.8,3.0,1.0,4.0,3.0,0.0,0.0,4.0,0.0,0.8,0.8,1.0,1.9,15.0,89.0,70.0,0.14,0.05,0.18,0.14,0.18,0.04,0.05,0.09,0.04,0.09,Matches,Rasmus Kristensen,D/WB/DM R,25,133,144,Denmark,Leeds United,9,15,11,10,12,8,13,9,13,12,13,9,13,11,18,12,15,11,11,11,11,15,11,13,12,11,14,16,12,12,14,14,14,14,15,14,15,11,12,5,15,2,1,1,3,3,3,1,3,4,2,2,9,17,6,14,13,14,12,11,1,14,12,20,12,17,16,1,10,15,1,1,8,1,187,86,11,20,15120555,6649,6699,5499,Northern_European,127,2,1997/7/11,8,0,52196.0,,27100968
385,Dejan Kulusevski,Tottenham,2000,284.0,se SWE,MFFW,22.0,23.0,38.0,15.0,23.0,7.0,8.0,16.0,44.0,36.4,28.0,19.0,0.0,19.0,13.0,51.0,7.0,0.0,Matches,284.0,se SWE,MFFW,22.0,23.0,97.0,4.22,71.0,5.0,15.0,5.0,0.0,1.0,11.0,0.48,9.0,1.0,1.0,0.0,0.0,0.0,Matches,,,,,,,,,,,,,,,,,,,,,,,,,,,,,,,,,,,,,,,,,,,,,,,,,,,,,,,,284.0,se SWE,MFFW,22.0,23.0,2.0,0.0,0.0,36.0,25.0,3.0,62.0,13.0,15.0,0.0,1.0,0.0,145.0,3.0,7.0,30.0,Matches,284.0,se SWE,MFFW,22.0,23.0,746.0,684.0,61.0,1.0,5.0,3.0,62.0,7.0,23.0,6.0,3.0,0.0,582.0,1.0,26.0,Matches,284.0,se SWE,MFFW,22.0,23.0,582.0,746.0,78.0,8120.0,2005.0,355.0,410.0,86.6,179.0,226.0,79.2,25.0,51.0,49.0,7.0,4.6,4.8,2.4,47.0,14.0,38.0,11.0,67.0,Matches,361,se SWE,MFFW,22,30,2067.0,69.0,60.4,23.0,23,81.0,5,7,28.0,0,1.6,42.0,40.0,2.0,0.09,-0.25,32.8,30.5,2.3,0.1,-0.25,Matches,284.0,se SWE,MFFW,22.0,23.0,1048.0,26.0,156.0,394.0,528.0,107.0,1048.0,112.0,52.0,46.4,52.0,46.4,677.0,4905.0,2513.0,87.0,46.0,48.0,78.0,52.0,711.0,195.0,Matches,284.0,se SWE,MFFW,22.0,23.0,2.0,43.0,10.0,23.3,1.87,0.44,0.05,0.2,17.6,0.0,0.0,0.0,2.5,2.5,0.06,-0.5,-0.5,Matches,284.0,se SWE,MFFW,22.0,30.0,23.0,2067.0,23.0,2.0,7.0,9.0,2.0,0.0,0.0,2.0,0.0,2.5,2.5,4.6,7.2,87.0,67.0,195.0,0.09,0.3,0.39,0.09,0.39,0.11,0.2,0.31,0.11,0.31,Matches,Dejan Kulusevski,M/AM RC,22,153,171,"Sweden,North Macedonia",Juventus,11,14,16,13,15,9,7,11,4,4,17,11,7,16,7,15,8,13,12,16,16,15,15,6,14,6,14,14,13,14,17,12,14,14,16,15,14,11,14,6,15,3,1,3,2,3,2,2,3,1,3,1,16,14,8,12,15,14,13,10,1,1,1,1,1,9,1,12,14,18,14,20,20,14,186,79,20,14,35000000,7650,7250,6850,Northern_European,153,2,2000/4/25,25,2,88941.0,Tottenham Hotspur,43295814
386,Aymeric Laporte,Manchester City,1994,289.0,es ESP,DF,28.0,11.0,11.0,8.0,6.0,4.0,1.0,7.0,11.0,63.6,4.0,10.0,4.0,6.0,3.0,14.0,30.0,1.0,Matches,289.0,es ESP,DF,28.0,11.0,17.0,1.54,16.0,0.0,0.0,1.0,0.0,0.0,0.0,0.0,0.0,0.0,0.0,0.0,0.0,0.0,Matches,,,,,,,,,,,,,,,,,,,,,,,,,,,,,,,,,,,,,,,,,,,,,,,,,,,,,,,,289.0,es ESP,DF,28.0,11.0,0.0,0.0,0.0,5.0,7.0,1.0,6.0,3.0,8.0,0.0,0.0,0.0,55.0,24.0,19.0,55.8,Matches,289.0,es ESP,DF,28.0,11.0,964.0,926.0,37.0,21.0,1.0,6.0,6.0,10.0,0.0,0.0,0.0,0.0,892.0,1.0,5.0,Matches,289.0,es ESP,DF,28.0,11.0,892.0,964.0,92.5,14630.0,4347.0,441.0,463.0,95.2,387.0,405.0,95.6,52.0,74.0,70.3,0.0,0.2,0.4,-0.2,5.0,87.0,7.0,0.0,85.0,Matches,366,es ESP,DF,28,12,993.0,83.0,29.0,11.0,11,89.0,10,1,16.0,15,2.33,21.0,10.0,11.0,1.0,-0.86,20.5,12.4,8.1,0.73,-0.69,Matches,289.0,es ESP,DF,28.0,11.0,1036.0,85.0,335.0,538.0,166.0,13.0,1036.0,4.0,2.0,50.0,1.0,25.0,702.0,4015.0,2882.0,30.0,44.0,0.0,3.0,0.0,806.0,11.0,Matches,289.0,es ESP,DF,28.0,11.0,0.0,10.0,1.0,10.0,0.91,0.09,0.0,0.0,14.9,0.0,0.0,0.0,0.5,0.5,0.05,-0.5,-0.5,Matches,289.0,es ESP,DF,28.0,12.0,11.0,993.0,11.0,0.0,0.0,0.0,0.0,0.0,0.0,0.0,0.0,0.5,0.5,0.2,0.7,30.0,85.0,11.0,0.0,0.0,0.0,0.0,0.0,0.04,0.02,0.06,0.04,0.06,Matches,Aymeric Laporte,D C,28,168,173,"Spain,France,Pays Basque",Manchester City,8,11,13,8,15,10,16,11,8,16,16,11,15,15,13,16,15,16,15,16,16,14,12,13,14,16,13,14,14,13,12,16,15,14,15,14,15,8,15,7,8,2,2,2,3,2,1,3,2,1,1,3,13,16,6,15,12,16,13,14,1,13,20,1,1,1,1,1,1,1,1,1,1,1,191,85,20,10,347975206,8400,8000,8250,Mediterranean_Hispanic,168,6,1994/5/27,15,1,150789.0,,85085378
387,Roméo Lavia,Southampton,2004,292.0,be BEL,MF,18.0,24.7,60.0,35.0,27.0,29.0,4.0,21.0,53.0,39.6,32.0,47.0,11.0,36.0,33.0,93.0,23.0,1.0,Matches,292.0,be BEL,MF,18.0,24.7,41.0,1.66,31.0,2.0,3.0,1.0,3.0,1.0,3.0,0.12,1.0,0.0,0.0,0.0,1.0,1.0,Matches,,,,,,,,,,,,,,,,,,,,,,,,,,,,,,,,,,,,,,,,,,,,,,,,,,,,,,,,292.0,be BEL,MF,18.0,24.7,9.0,0.0,0.0,28.0,48.0,0.0,3.0,33.0,35.0,1.0,0.0,0.0,187.0,7.0,10.0,41.2,Matches,292.0,be BEL,MF,18.0,24.7,997.0,985.0,10.0,5.0,5.0,9.0,3.0,1.0,4.0,0.0,0.0,2.0,859.0,2.0,22.0,Matches,292.0,be BEL,MF,18.0,24.7,859.0,997.0,86.2,14815.0,3986.0,386.0,425.0,90.8,389.0,426.0,91.3,68.0,93.0,73.1,0.0,0.6,0.6,-0.6,16.0,101.0,9.0,0.0,102.0,Matches,369,be BEL,MF,18,29,2221.0,77.0,64.9,24.7,26,82.0,14,3,30.0,0,0.69,28.0,50.0,-22.0,-0.89,0.23,25.8,41.0,-15.2,-0.62,-0.01,Matches,292.0,be BEL,MF,18.0,24.7,1288.0,58.0,298.0,828.0,177.0,1.0,1288.0,50.0,28.0,56.0,13.0,26.0,804.0,4275.0,1903.0,22.0,21.0,0.0,24.0,31.0,794.0,14.0,Matches,292.0,be BEL,MF,18.0,24.7,1.0,12.0,3.0,25.0,0.49,0.12,0.08,0.33,27.0,0.0,0.0,0.0,0.4,0.4,0.03,0.6,0.6,Matches,292.0,be BEL,MF,18.0,29.0,26.0,2221.0,24.7,1.0,0.0,1.0,1.0,0.0,0.0,9.0,0.0,0.4,0.4,0.6,1.0,22.0,102.0,14.0,0.04,0.0,0.04,0.04,0.04,0.02,0.03,0.04,0.02,0.04,Matches,Roméo Lavia,DM/M C,18,124,-9,Belgium,Southampton,5,7,12,8,14,11,7,11,5,10,14,5,13,14,15,15,12,9,11,12,13,16,14,12,13,13,14,14,15,14,12,9,14,14,13,13,12,6,11,7,8,2,2,3,1,1,3,1,1,1,2,1,10,18,6,8,10,10,12,15,1,1,1,1,1,1,20,1,18,14,1,12,12,1,176,0,7,20,79523934,6194,6194,3744,African_Caribbean,125,17,2004/1/6,0,0,46397.0,,18115012
388,Mario Lemina,Wolves,1993,294.0,ga GAB,MF,28.0,14.4,38.0,24.0,22.0,13.0,3.0,20.0,38.0,52.6,18.0,26.0,8.0,18.0,14.0,52.0,24.0,1.0,Matches,294.0,ga GAB,MF,28.0,14.4,8.0,0.55,6.0,0.0,0.0,0.0,0.0,2.0,2.0,0.14,1.0,0.0,0.0,0.0,0.0,1.0,Matches,,,,,,,,,,,,,,,,,,,,,,,,,,,,,,,,,,,,,,,,,,,,,,,,,,,,,,,,294.0,ga GAB,MF,28.0,14.4,4.0,1.0,1.0,18.0,9.0,1.0,3.0,14.0,24.0,0.0,0.0,0.0,91.0,17.0,5.0,77.3,Matches,294.0,ga GAB,MF,28.0,14.4,651.0,645.0,5.0,5.0,1.0,4.0,3.0,0.0,0.0,0.0,0.0,0.0,566.0,1.0,9.0,Matches,294.0,ga GAB,MF,28.0,14.4,566.0,651.0,86.9,10051.0,2917.0,241.0,269.0,89.6,267.0,289.0,92.4,51.0,72.0,70.8,1.0,0.3,0.5,0.7,3.0,31.0,5.0,1.0,42.0,Matches,371,ga GAB,MF,28,19,1299.0,68.0,38.0,14.4,17,74.0,8,2,18.0,0,1.42,14.0,28.0,-14.0,-0.97,-0.42,13.2,27.0,-13.8,-0.95,-0.56,Matches,294.0,ga GAB,MF,28.0,14.4,794.0,67.0,292.0,430.0,81.0,4.0,794.0,18.0,11.0,61.1,3.0,16.7,414.0,1924.0,949.0,6.0,6.0,0.0,13.0,8.0,521.0,9.0,Matches,294.0,ga GAB,MF,28.0,14.4,0.0,9.0,2.0,22.2,0.62,0.14,0.0,0.0,27.4,0.0,0.0,0.0,0.3,0.3,0.03,-0.3,-0.3,Matches,294.0,ga GAB,MF,28.0,19.0,17.0,1299.0,14.4,0.0,1.0,1.0,0.0,0.0,0.0,4.0,1.0,0.3,0.3,0.3,0.6,6.0,42.0,9.0,0.0,0.07,0.07,0.0,0.07,0.02,0.02,0.04,0.02,0.04,Matches,Mario Lemina,DM/M C,28,130,147,"Gabon,France",OGC Nice,9,9,13,11,13,8,12,12,10,12,14,9,14,13,14,13,15,12,11,13,10,15,14,12,12,10,13,15,13,13,15,13,14,13,15,16,14,12,14,12,13,2,2,1,3,3,2,2,3,2,2,3,14,15,8,10,13,14,12,9,1,1,1,10,1,10,18,1,20,10,1,7,7,1,184,85,10,20,6501730,6649,6649,5499,African_Caribbean,131,13,1993/9/1,25,3,37499.0,,85104273
389,Clément Lenglet,Tottenham,1995,295.0,fr FRA,DF,27.0,22.4,38.0,23.0,18.0,15.0,5.0,16.0,34.0,47.1,18.0,26.0,11.0,15.0,18.0,56.0,68.0,2.0,Matches,295.0,fr FRA,DF,27.0,22.4,23.0,1.03,20.0,1.0,0.0,0.0,1.0,1.0,5.0,0.22,5.0,0.0,0.0,0.0,0.0,0.0,Matches,,,,,,,,,,,,,,,,,,,,,,,,,,,,,,,,,,,,,,,,,,,,,,,,,,,,,,,,295.0,fr FRA,DF,27.0,22.4,4.0,0.0,0.0,23.0,17.0,0.0,16.0,18.0,23.0,0.0,0.0,0.0,119.0,43.0,28.0,60.6,Matches,295.0,fr FRA,DF,27.0,22.4,1465.0,1431.0,29.0,22.0,5.0,20.0,16.0,6.0,0.0,0.0,0.0,0.0,1270.0,5.0,11.0,Matches,295.0,fr FRA,DF,27.0,22.4,1270.0,1465.0,86.7,23668.0,8588.0,484.0,501.0,96.6,637.0,701.0,90.9,129.0,219.0,58.9,2.0,0.6,0.8,1.4,6.0,80.0,11.0,5.0,85.0,Matches,372,fr FRA,DF,27,26,2019.0,78.0,59.0,22.4,24,83.0,14,2,9.0,11,1.54,45.0,35.0,10.0,0.45,0.64,36.7,28.6,8.1,0.36,0.41,Matches,295.0,fr FRA,DF,27.0,22.4,1666.0,178.0,805.0,761.0,107.0,17.0,1666.0,12.0,7.0,58.3,4.0,33.3,1142.0,5666.0,3561.0,33.0,27.0,1.0,12.0,8.0,1256.0,7.0,Matches,295.0,fr FRA,DF,27.0,22.4,0.0,13.0,2.0,15.4,0.58,0.09,0.0,0.0,15.5,0.0,0.0,0.0,1.0,1.0,0.07,-1.0,-1.0,Matches,295.0,fr FRA,DF,27.0,26.0,24.0,2019.0,22.4,0.0,2.0,2.0,0.0,0.0,0.0,4.0,0.0,1.0,1.0,0.6,1.6,33.0,85.0,7.0,0.0,0.09,0.09,0.0,0.09,0.04,0.03,0.07,0.04,0.07,Matches,Clément Lenglet,D C,27,144,154,France,Barcelona,9,10,11,8,13,9,15,8,10,15,14,8,15,13,12,15,12,13,13,12,13,14,10,12,10,15,15,14,12,13,13,15,13,14,15,14,14,9,13,10,9,2,3,3,2,2,1,1,3,3,2,1,13,14,8,12,12,15,15,9,1,12,20,1,1,1,1,1,1,1,1,1,1,1,186,81,20,8,15657934,7242,7492,6492,Northern_European,145,5,1995/6/17,15,1,110583.0,Tottenham Hotspur,85078880
390,Bernd Leno,Fulham,1992,296.0,de GER,GK,30.0,36.0,0.0,0.0,0.0,0.0,0.0,0.0,3.0,0.0,3.0,0.0,0.0,0.0,0.0,0.0,18.0,1.0,Matches,296.0,de GER,GK,30.0,36.0,2.0,0.06,2.0,0.0,0.0,0.0,0.0,0.0,0.0,0.0,0.0,0.0,0.0,0.0,0.0,0.0,Matches,18.0,de GER,GK,30.0,36.0,51.0,7.0,1.0,8.0,2.0,58.0,0.27,9.0,0.25,124.0,391.0,31.7,1153.0,190.0,26.0,30.0,242.0,37.6,36.0,464.0,35.0,7.5,46.0,1.28,14.9,Matches,18.0,de GER,GK,30.0,36.0,36.0,3240.0,36.0,51.0,1.42,192.0,142.0,77.1,15.0,5.0,16.0,8.0,22.2,8.0,7.0,1.0,0.0,12.5,Matches,296.0,de GER,GK,30.0,36.0,3.0,0.0,0.0,1.0,3.0,0.0,0.0,0.0,0.0,0.0,1.0,0.0,50.0,11.0,0.0,100.0,Matches,296.0,de GER,GK,30.0,36.0,1397.0,1041.0,354.0,112.0,0.0,2.0,0.0,0.0,0.0,0.0,0.0,0.0,1110.0,2.0,0.0,Matches,296.0,de GER,GK,30.0,36.0,1110.0,1397.0,79.5,26975.0,16383.0,234.0,235.0,99.6,651.0,655.0,99.4,223.0,503.0,44.3,0.0,0.0,0.0,0.0,1.0,11.0,0.0,0.0,0.0,Matches,373,de GER,GK,30,36,3240.0,90.0,94.7,36.0,36,90.0,36,0,,2,1.39,53.0,51.0,2.0,0.06,0.06,43.5,61.5,-18.0,-0.5,-0.8,Matches,296.0,de GER,GK,30.0,36.0,1499.0,1188.0,1492.0,7.0,0.0,0.0,1499.0,0.0,0.0,,0.0,,857.0,4060.0,2355.0,0.0,0.0,0.0,1.0,0.0,752.0,0.0,Matches,296.0,de GER,GK,30.0,36.0,0.0,0.0,0.0,,0.0,0.0,,,,0.0,0.0,0.0,0.0,0.0,,0.0,0.0,Matches,296.0,de GER,GK,30.0,36.0,36.0,3240.0,36.0,0.0,0.0,0.0,0.0,0.0,0.0,3.0,0.0,0.0,0.0,0.0,0.0,0.0,0.0,0.0,0.0,0.0,0.0,0.0,0.0,0.0,0.0,0.0,0.0,0.0,Matches,Bernd Leno,GK,30,138,163,Germany,Fulham,3,3,2,1,10,5,6,1,1,3,10,2,1,9,8,14,14,11,12,7,10,12,4,9,6,13,16,10,13,16,14,14,14,10,12,12,13,4,14,8,2,13,14,12,13,15,15,16,16,16,13,12,12,12,8,14,12,15,14,15,20,1,1,1,1,1,1,1,1,1,1,1,1,1,190,83,8,20,27129015,6900,6900,6500,Northern_European,138,4,1992/3/4,9,0,98593.0,,92012109
391,Jefferson Lerma,Bournemouth,1994,297.0,co COL,MF,27.0,36.1,50.0,30.0,23.0,23.0,4.0,20.0,45.0,44.4,25.0,32.0,15.0,17.0,47.0,97.0,91.0,2.0,Matches,297.0,co COL,MF,27.0,36.1,46.0,1.27,41.0,2.0,0.0,2.0,1.0,0.0,1.0,0.03,1.0,0.0,0.0,0.0,0.0,0.0,Matches,,,,,,,,,,,,,,,,,,,,,,,,,,,,,,,,,,,,,,,,,,,,,,,,,,,,,,,,297.0,co COL,MF,27.0,36.1,7.0,0.0,0.0,37.0,33.0,2.0,11.0,47.0,30.0,0.0,2.0,1.0,260.0,62.0,40.0,60.8,Matches,297.0,co COL,MF,27.0,36.1,1611.0,1551.0,59.0,46.0,7.0,7.0,11.0,11.0,0.0,0.0,0.0,0.0,1317.0,1.0,24.0,Matches,297.0,co COL,MF,27.0,36.1,1317.0,1611.0,81.8,20458.0,7229.0,695.0,793.0,87.6,502.0,581.0,86.4,77.0,146.0,52.7,0.0,2.3,3.1,-2.3,18.0,126.0,23.0,2.0,142.0,Matches,374,co COL,MF,27,37,3252.0,88.0,95.1,36.1,37,88.0,33,0,,0,1.05,34.0,67.0,-33.0,-0.91,-0.38,35.6,60.4,-24.8,-0.69,-0.43,Matches,297.0,co COL,MF,27.0,36.1,1934.0,165.0,587.0,1030.0,338.0,44.0,1934.0,24.0,14.0,58.3,9.0,37.5,947.0,3764.0,1861.0,22.0,32.0,1.0,24.0,17.0,1162.0,30.0,Matches,297.0,co COL,MF,27.0,36.1,5.0,35.0,10.0,28.6,0.97,0.28,0.14,0.5,17.6,0.0,0.0,0.0,2.6,2.6,0.07,2.4,2.4,Matches,297.0,co COL,MF,27.0,37.0,37.0,3252.0,36.1,5.0,0.0,5.0,5.0,0.0,0.0,7.0,0.0,2.6,2.6,2.3,4.9,22.0,142.0,30.0,0.14,0.0,0.14,0.14,0.14,0.07,0.06,0.14,0.07,0.14,Matches,Jefferson Lerma,DM/M C,27,134,148,Colombia,AFC Bournemouth,9,10,11,8,12,9,10,13,8,13,13,9,16,12,14,15,16,12,14,11,13,15,9,9,12,13,13,15,13,13,15,14,17,12,15,14,11,13,14,6,14,1,1,2,1,3,2,1,1,1,1,3,14,14,10,13,12,15,7,7,1,1,1,10,1,12,20,1,20,12,1,9,1,1,179,70,8,20,17920615,6694,6594,5594,African_Caribbean,134,17,1994/10/25,32,1,52196.0,,76038475
392,Rico Lewis,Manchester City,2004,299.0,eng ENG,DFMF,17.0,10.0,16.0,9.0,9.0,5.0,2.0,6.0,11.0,54.5,5.0,8.0,4.0,4.0,6.0,22.0,13.0,1.0,Matches,299.0,eng ENG,DFMF,17.0,10.0,27.0,2.69,24.0,1.0,0.0,1.0,1.0,0.0,0.0,0.0,0.0,0.0,0.0,0.0,0.0,0.0,Matches,,,,,,,,,,,,,,,,,,,,,,,,,,,,,,,,,,,,,,,,,,,,,,,,,,,,,,,,299.0,eng ENG,DFMF,17.0,10.0,1.0,0.0,0.0,10.0,18.0,0.0,5.0,6.0,9.0,0.0,0.0,0.0,43.0,0.0,6.0,0.0,Matches,299.0,eng ENG,DFMF,17.0,10.0,675.0,633.0,41.0,7.0,1.0,0.0,5.0,31.0,0.0,0.0,0.0,0.0,617.0,1.0,9.0,Matches,299.0,eng ENG,DFMF,17.0,10.0,617.0,675.0,91.4,8779.0,1476.0,378.0,400.0,94.5,203.0,219.0,92.7,19.0,23.0,82.6,0.0,1.5,1.6,-1.5,12.0,38.0,10.0,3.0,48.0,Matches,376,eng ENG,DFMF,17,14,903.0,65.0,26.4,10.0,10,82.0,6,4,21.0,23,2.29,18.0,8.0,10.0,1.0,-0.83,20.8,8.9,11.9,1.19,-0.05,Matches,299.0,eng ENG,DFMF,17.0,10.0,742.0,26.0,133.0,416.0,199.0,12.0,742.0,14.0,8.0,57.1,3.0,21.4,511.0,2555.0,1390.0,22.0,24.0,3.0,7.0,13.0,593.0,26.0,Matches,299.0,eng ENG,DFMF,17.0,10.0,0.0,5.0,2.0,40.0,0.5,0.2,0.0,0.0,21.1,0.0,0.0,0.0,0.2,0.2,0.04,-0.2,-0.2,Matches,299.0,eng ENG,DFMF,17.0,14.0,10.0,903.0,10.0,0.0,0.0,0.0,0.0,0.0,0.0,1.0,0.0,0.2,0.2,1.5,1.7,22.0,48.0,26.0,0.0,0.0,0.0,0.0,0.0,0.02,0.15,0.17,0.02,0.17,Matches,Rico Lewis,D RL,17,110,-8,England,Manchester City,4,8,12,7,11,5,11,4,9,9,12,11,11,12,15,11,13,11,12,11,11,15,12,12,11,14,12,14,14,16,11,3,13,13,14,12,11,10,17,13,16,4,3,2,2,3,3,2,1,3,1,1,10,8,6,14,9,16,12,15,1,16,1,20,1,15,15,1,14,1,1,1,1,1,169,0,8,20,39437190,5494,5494,4007,African_Caribbean,111,16,2004/11/21,0,0,3480.0,,2000098727
393,Victor Lindelöf,Manchester Utd,1994,301.0,se SWE,DF,28.0,15.2,22.0,17.0,10.0,9.0,3.0,9.0,17.0,52.9,8.0,18.0,9.0,9.0,21.0,43.0,63.0,1.0,Matches,301.0,se SWE,DF,28.0,15.2,6.0,0.4,6.0,0.0,0.0,0.0,0.0,0.0,0.0,0.0,0.0,0.0,0.0,0.0,0.0,0.0,Matches,,,,,,,,,,,,,,,,,,,,,,,,,,,,,,,,,,,,,,,,,,,,,,,,,,,,,,,,301.0,se SWE,DF,28.0,15.2,1.0,0.0,0.0,10.0,4.0,0.0,1.0,21.0,17.0,0.0,0.0,0.0,84.0,33.0,20.0,62.3,Matches,301.0,se SWE,DF,28.0,15.2,930.0,905.0,25.0,13.0,2.0,1.0,1.0,1.0,0.0,0.0,0.0,0.0,866.0,0.0,1.0,Matches,301.0,se SWE,DF,28.0,15.2,866.0,930.0,93.1,15313.0,4622.0,318.0,336.0,94.6,479.0,495.0,96.8,54.0,76.0,71.1,0.0,0.1,0.4,-0.1,3.0,35.0,2.0,0.0,36.0,Matches,378,se SWE,DF,28,20,1365.0,68.0,39.9,15.2,14,90.0,13,6,18.0,10,1.95,29.0,16.0,13.0,0.86,0.77,35.3,20.4,14.9,0.98,0.88,Matches,301.0,se SWE,DF,28.0,15.2,1074.0,145.0,550.0,491.0,35.0,5.0,1074.0,3.0,2.0,66.7,1.0,33.3,652.0,3094.0,1529.0,3.0,4.0,0.0,1.0,2.0,739.0,1.0,Matches,301.0,se SWE,DF,28.0,15.2,0.0,3.0,0.0,0.0,0.2,0.0,0.0,,7.9,0.0,0.0,0.0,0.3,0.3,0.09,-0.3,-0.3,Matches,301.0,se SWE,DF,28.0,20.0,14.0,1365.0,15.2,0.0,0.0,0.0,0.0,0.0,0.0,1.0,0.0,0.3,0.3,0.1,0.4,3.0,36.0,1.0,0.0,0.0,0.0,0.0,0.0,0.02,0.01,0.03,0.02,0.03,Matches,Victor Lindelöf,D C,28,143,150,Sweden,Manchester UFC,3,10,12,7,14,4,13,5,11,15,14,12,15,14,10,14,10,13,14,12,14,12,7,10,8,15,14,13,13,12,14,14,16,13,16,13,11,8,15,5,15,3,1,1,1,1,3,3,2,2,4,1,14,16,6,18,13,17,15,16,1,5,20,14,1,13,10,1,3,1,1,1,1,1,187,80,13,20,36018563,7143,6993,6493,Northern_European,143,0,1994/7/17,52,3,197186.0,,93023425
394,Jesse Lingard,Nott'ham Forest,1992,302.0,eng ENG,FWMF,29.0,10.3,4.0,4.0,2.0,2.0,0.0,1.0,7.0,14.3,6.0,11.0,0.0,11.0,5.0,9.0,4.0,0.0,Matches,302.0,eng ENG,FWMF,29.0,10.3,25.0,2.44,18.0,1.0,2.0,3.0,1.0,0.0,2.0,0.2,1.0,0.0,0.0,1.0,0.0,0.0,Matches,,,,,,,,,,,,,,,,,,,,,,,,,,,,,,,,,,,,,,,,,,,,,,,,,,,,,,,,302.0,eng ENG,FWMF,29.0,10.3,1.0,0.0,0.0,8.0,9.0,2.0,5.0,5.0,4.0,0.0,0.0,0.0,39.0,1.0,3.0,25.0,Matches,302.0,eng ENG,FWMF,29.0,10.3,297.0,271.0,24.0,7.0,1.0,4.0,5.0,8.0,0.0,0.0,0.0,0.0,236.0,2.0,5.0,Matches,302.0,eng ENG,FWMF,29.0,10.3,236.0,297.0,79.5,3558.0,897.0,121.0,137.0,88.3,88.0,104.0,84.6,14.0,28.0,50.0,0.0,0.7,0.5,-0.7,11.0,27.0,7.0,1.0,33.0,Matches,379,eng ENG,FWMF,29,17,923.0,54.0,27.0,10.3,12,70.0,2,5,16.0,12,0.71,8.0,17.0,-9.0,-0.88,-0.12,10.4,15.2,-4.9,-0.47,0.25,Matches,302.0,eng ENG,FWMF,29.0,10.3,371.0,7.0,44.0,202.0,132.0,16.0,371.0,10.0,6.0,60.0,4.0,40.0,214.0,1003.0,527.0,11.0,12.0,0.0,16.0,10.0,263.0,38.0,Matches,302.0,eng ENG,FWMF,29.0,10.3,0.0,10.0,2.0,20.0,0.98,0.2,0.0,0.0,19.3,0.0,0.0,0.0,1.0,1.0,0.1,-1.0,-1.0,Matches,302.0,eng ENG,FWMF,29.0,17.0,12.0,923.0,10.3,0.0,0.0,0.0,0.0,0.0,0.0,1.0,0.0,1.0,1.0,0.7,1.7,11.0,33.0,38.0,0.0,0.0,0.0,0.0,0.0,0.1,0.07,0.17,0.1,0.17,Matches,Jesse Lingard,M/AM RLC,29,140,148,England,Nottingham Forest,8,10,14,14,13,5,4,11,4,4,13,10,6,14,15,13,13,12,12,11,13,14,14,5,17,10,16,13,15,15,14,6,17,15,17,8,12,4,18,3,9,3,3,2,2,4,2,3,3,2,3,3,13,15,7,17,10,17,12,16,1,1,1,1,1,1,1,16,12,15,18,20,17,8,175,62,11,20,23136489,7000,7100,5750,Mixed_Race,133,12,1992/12/15,32,6,115992.0,,28047560
395,Hugo Lloris,Tottenham,1986,305.0,fr FRA,GK,35.0,24.5,1.0,1.0,1.0,0.0,0.0,1.0,3.0,33.3,2.0,0.0,0.0,0.0,1.0,2.0,13.0,5.0,Matches,305.0,fr FRA,GK,35.0,24.5,5.0,0.2,5.0,0.0,0.0,0.0,0.0,0.0,0.0,0.0,0.0,0.0,0.0,0.0,0.0,0.0,Matches,19.0,fr FRA,GK,35.0,24.5,39.0,1.0,0.0,3.0,1.0,33.9,0.29,-4.1,-0.17,77.0,218.0,35.3,539.0,109.0,31.7,31.4,186.0,25.3,25.8,322.0,20.0,6.2,29.0,1.18,13.7,Matches,19.0,fr FRA,GK,35.0,25.0,25.0,2205.0,24.5,39.0,1.59,117.0,79.0,67.5,13.0,3.0,9.0,7.0,28.0,1.0,1.0,0.0,0.0,0.0,Matches,305.0,fr FRA,GK,35.0,24.5,0.0,0.0,0.0,0.0,2.0,0.0,0.0,1.0,1.0,0.0,0.0,1.0,30.0,9.0,3.0,75.0,Matches,305.0,fr FRA,GK,35.0,24.5,728.0,513.0,212.0,26.0,0.0,0.0,0.0,0.0,0.0,0.0,0.0,0.0,561.0,3.0,1.0,Matches,305.0,fr FRA,GK,35.0,24.5,561.0,728.0,77.1,13442.0,8398.0,174.0,177.0,98.3,241.0,242.0,99.6,146.0,305.0,47.9,0.0,0.0,0.0,0.0,0.0,13.0,0.0,0.0,0.0,Matches,382,fr FRA,GK,35,25,2205.0,88.0,64.5,24.5,25,88.0,24,0,,1,1.68,44.0,39.0,5.0,0.2,0.06,35.7,30.8,4.8,0.2,0.0,Matches,305.0,fr FRA,GK,35.0,24.5,794.0,723.0,792.0,2.0,0.0,0.0,794.0,0.0,0.0,,0.0,,430.0,2401.0,1498.0,0.0,0.0,0.0,2.0,0.0,353.0,0.0,Matches,305.0,fr FRA,GK,35.0,24.5,0.0,0.0,0.0,,0.0,0.0,,,,0.0,0.0,0.0,0.0,0.0,,0.0,0.0,Matches,305.0,fr FRA,GK,35.0,25.0,25.0,2205.0,24.5,0.0,0.0,0.0,0.0,0.0,0.0,0.0,0.0,0.0,0.0,0.0,0.0,0.0,0.0,0.0,0.0,0.0,0.0,0.0,0.0,0.0,0.0,0.0,0.0,0.0,Matches,Hugo Lloris,GK,35,147,170,France,Tottenham Hotspur,2,3,5,3,8,7,9,1,1,4,8,1,10,10,15,17,17,7,15,9,14,15,6,15,6,16,15,14,11,15,11,13,15,10,14,13,15,2,14,14,1,11,12,13,12,16,11,15,17,13,13,11,13,14,4,18,14,17,18,19,20,1,1,1,1,1,1,1,1,1,1,1,1,1,188,82,20,5,347975206,7750,7900,6972,Northern_European,145,6,1986/12/26,139,0,127591.0,,8428653
396,Renan Lodi,Nott'ham Forest,1998,306.0,br BRA,DF,24.0,24.6,52.0,39.0,38.0,8.0,6.0,33.0,66.0,50.0,33.0,25.0,6.0,19.0,33.0,85.0,74.0,0.0,Matches,306.0,br BRA,DF,24.0,24.6,30.0,1.22,22.0,6.0,0.0,1.0,1.0,0.0,4.0,0.16,3.0,0.0,0.0,1.0,0.0,0.0,Matches,,,,,,,,,,,,,,,,,,,,,,,,,,,,,,,,,,,,,,,,,,,,,,,,,,,,,,,,306.0,br BRA,DF,24.0,24.6,7.0,0.0,0.0,29.0,42.0,2.0,75.0,33.0,39.0,0.0,0.0,0.0,153.0,18.0,19.0,48.6,Matches,306.0,br BRA,DF,24.0,24.6,877.0,684.0,189.0,44.0,0.0,3.0,75.0,130.0,15.0,12.0,2.0,0.0,583.0,4.0,29.0,Matches,306.0,br BRA,DF,24.0,24.6,583.0,877.0,66.5,10215.0,3529.0,272.0,323.0,84.2,242.0,339.0,71.4,57.0,162.0,35.2,1.0,1.2,1.3,-0.2,13.0,25.0,14.0,8.0,31.0,Matches,383,br BRA,DF,24,28,2214.0,79.0,64.7,24.6,26,83.0,16,2,25.0,2,1.11,29.0,48.0,-19.0,-0.77,0.05,27.0,41.1,-14.1,-0.57,0.23,Matches,306.0,br BRA,DF,24.0,24.6,1143.0,96.0,478.0,418.0,263.0,21.0,1143.0,39.0,16.0,41.0,14.0,35.9,546.0,2834.0,1379.0,24.0,15.0,2.0,18.0,13.0,535.0,70.0,Matches,306.0,br BRA,DF,24.0,24.6,0.0,15.0,0.0,0.0,0.61,0.0,0.0,,19.9,2.0,0.0,0.0,1.0,1.0,0.06,-1.0,-1.0,Matches,306.0,br BRA,DF,24.0,28.0,26.0,2214.0,24.6,0.0,1.0,1.0,0.0,0.0,0.0,7.0,0.0,1.0,1.0,1.2,2.1,24.0,31.0,70.0,0.0,0.04,0.04,0.0,0.04,0.04,0.05,0.09,0.04,0.09,Matches,Renan Lodi,D/WB/M L,24,142,157,Brazil,A. Madrid,12,14,15,12,15,12,11,13,8,14,15,11,12,15,15,14,10,13,12,12,13,12,11,11,14,12,12,12,16,15,11,8,15,14,14,11,11,15,12,11,11,3,1,2,3,3,2,4,2,3,1,1,17,14,6,12,12,13,7,12,1,20,1,1,17,1,1,17,1,1,13,1,1,1,178,74,20,8,11938062,7099,7699,6184,Mediterranean_Hispanic,136,10,1998/4/8,15,0,76922.0,Nottingham Forest,19259027
397,Ruben Loftus-Cheek,Chelsea,1996,307.0,eng ENG,MFDF,26.0,17.1,25.0,14.0,8.0,14.0,3.0,12.0,22.0,54.5,10.0,15.0,2.0,13.0,12.0,37.0,23.0,0.0,Matches,307.0,eng ENG,MFDF,26.0,17.1,36.0,2.11,31.0,0.0,3.0,1.0,1.0,0.0,4.0,0.23,4.0,0.0,0.0,0.0,0.0,0.0,Matches,,,,,,,,,,,,,,,,,,,,,,,,,,,,,,,,,,,,,,,,,,,,,,,,,,,,,,,,307.0,eng ENG,MFDF,26.0,17.1,1.0,0.0,0.0,10.0,34.0,1.0,19.0,12.0,14.0,0.0,0.0,1.0,101.0,22.0,26.0,45.8,Matches,307.0,eng ENG,MFDF,26.0,17.1,907.0,858.0,44.0,11.0,1.0,6.0,19.0,32.0,0.0,0.0,0.0,0.0,782.0,5.0,20.0,Matches,307.0,eng ENG,MFDF,26.0,17.1,782.0,907.0,86.2,11417.0,2878.0,475.0,530.0,89.6,263.0,291.0,90.4,29.0,37.0,78.4,1.0,1.5,1.8,-0.5,16.0,78.0,18.0,1.0,90.0,Matches,384,eng ENG,MFDF,26,25,1536.0,61.0,44.9,17.1,19,73.0,6,6,26.0,6,1.36,22.0,23.0,-1.0,-0.06,0.32,21.7,27.2,-5.5,-0.32,-0.44,Matches,307.0,eng ENG,MFDF,26.0,17.1,1068.0,40.0,185.0,576.0,322.0,42.0,1068.0,60.0,30.0,50.0,22.0,36.7,651.0,3753.0,2210.0,56.0,29.0,10.0,22.0,23.0,774.0,86.0,Matches,307.0,eng ENG,MFDF,26.0,17.1,0.0,9.0,2.0,22.2,0.53,0.12,0.0,0.0,18.6,0.0,0.0,0.0,0.8,0.8,0.09,-0.8,-0.8,Matches,307.0,eng ENG,MFDF,26.0,25.0,19.0,1536.0,17.1,0.0,1.0,1.0,0.0,0.0,0.0,1.0,0.0,0.8,0.8,1.5,2.4,56.0,90.0,86.0,0.0,0.06,0.06,0.0,0.06,0.05,0.09,0.14,0.05,0.14,Matches,Ruben Loftus-Cheek,M/AM C,26,148,162,England,Chelsea,7,10,14,13,15,5,12,10,5,9,15,10,10,15,14,14,12,17,11,14,15,13,11,12,15,14,15,14,15,11,16,14,13,14,11,16,11,10,13,14,11,3,3,4,1,1,3,1,3,4,3,3,15,15,3,13,14,15,15,16,1,1,1,1,1,10,15,10,20,10,10,19,12,11,191,86,13,20,37685715,7400,6700,6500,African_Caribbean,145,12,1996/1/23,10,0,173988.0,,28068727
398,Sean Longstaff,Newcastle Utd,1997,308.0,eng ENG,MF,24.0,28.0,42.0,21.0,16.0,20.0,6.0,20.0,52.0,38.5,32.0,35.0,8.0,27.0,16.0,58.0,23.0,0.0,Matches,308.0,eng ENG,MF,24.0,28.0,62.0,2.22,46.0,1.0,2.0,7.0,6.0,0.0,6.0,0.21,4.0,0.0,0.0,1.0,1.0,0.0,Matches,,,,,,,,,,,,,,,,,,,,,,,,,,,,,,,,,,,,,,,,,,,,,,,,,,,,,,,,308.0,eng ENG,MF,24.0,28.0,2.0,0.0,0.0,29.0,39.0,5.0,30.0,16.0,21.0,0.0,0.0,0.0,141.0,23.0,28.0,45.1,Matches,308.0,eng ENG,MF,24.0,28.0,1163.0,1118.0,41.0,7.0,7.0,6.0,30.0,4.0,3.0,0.0,0.0,0.0,943.0,4.0,31.0,Matches,308.0,eng ENG,MF,24.0,28.0,943.0,1163.0,81.1,15457.0,4299.0,470.0,538.0,87.4,362.0,415.0,87.2,78.0,129.0,60.5,4.0,3.3,2.6,0.7,23.0,80.0,21.0,5.0,116.0,Matches,386,eng ENG,MF,24,33,2518.0,76.0,73.6,28.0,28,87.0,24,5,18.0,0,1.91,48.0,18.0,30.0,1.07,0.57,50.6,26.6,24.0,0.86,0.03,Matches,308.0,eng ENG,MF,24.0,28.0,1433.0,45.0,278.0,742.0,420.0,76.0,1433.0,27.0,8.0,29.6,18.0,66.7,752.0,2989.0,1191.0,21.0,16.0,8.0,37.0,29.0,951.0,115.0,Matches,308.0,eng ENG,MF,24.0,28.0,1.0,33.0,7.0,21.2,1.18,0.25,0.03,0.14,16.0,0.0,0.0,0.0,3.6,3.6,0.11,-2.6,-2.6,Matches,308.0,eng ENG,MF,24.0,33.0,28.0,2518.0,28.0,1.0,4.0,5.0,1.0,0.0,0.0,2.0,0.0,3.6,3.6,3.3,6.9,21.0,116.0,115.0,0.04,0.14,0.18,0.04,0.18,0.13,0.12,0.25,0.13,0.25,Matches,Sean Longstaff,DM/M C,24,128,157,England,Newcastle United,11,11,13,13,14,11,10,13,7,11,13,5,14,13,11,13,15,14,12,13,12,6,11,10,14,13,16,16,11,11,13,11,11,12,15,12,13,7,13,10,8,1,3,1,3,3,4,1,3,3,3,1,17,10,4,10,13,10,10,14,1,1,1,1,1,1,18,1,20,10,1,14,10,1,180,65,8,20,8982296,6400,6400,5000,Northern_European,127,1,1997/10/30,0,0,34798.0,,28100360
399,Douglas Luiz,Aston Villa,1998,310.0,br BRA,MF,24.0,32.5,72.0,42.0,31.0,32.0,9.0,29.0,63.0,46.0,34.0,36.0,7.0,29.0,40.0,112.0,27.0,2.0,Matches,310.0,br BRA,MF,24.0,32.5,96.0,2.95,61.0,26.0,4.0,1.0,1.0,3.0,12.0,0.37,9.0,1.0,0.0,0.0,0.0,2.0,Matches,,,,,,,,,,,,,,,,,,,,,,,,,,,,,,,,,,,,,,,,,,,,,,,,,,,,,,,,310.0,br BRA,MF,24.0,32.5,6.0,1.0,0.0,48.0,42.0,2.0,106.0,40.0,42.0,0.0,0.0,0.0,197.0,25.0,22.0,53.2,Matches,310.0,br BRA,MF,24.0,32.5,1812.0,1593.0,216.0,120.0,6.0,10.0,106.0,6.0,89.0,53.0,13.0,1.0,1494.0,3.0,16.0,Matches,310.0,br BRA,MF,24.0,32.5,1494.0,1812.0,82.5,26492.0,6527.0,614.0,681.0,90.2,664.0,767.0,86.6,158.0,277.0,57.0,6.0,4.4,2.9,1.6,45.0,123.0,19.0,4.0,148.0,Matches,388,br BRA,MF,24,37,2927.0,79.0,85.6,32.5,33,86.0,23,4,23.0,1,1.57,46.0,33.0,13.0,0.4,1.86,43.3,41.5,1.7,0.05,0.78,Matches,310.0,br BRA,MF,24.0,32.5,2117.0,75.0,534.0,1161.0,442.0,19.0,2116.0,44.0,24.0,54.5,14.0,31.8,1142.0,6289.0,2913.0,48.0,39.0,4.0,36.0,33.0,1326.0,35.0,Matches,310.0,br BRA,MF,24.0,32.5,6.0,34.0,12.0,35.3,1.05,0.37,0.18,0.5,25.0,7.0,0.0,0.0,2.8,2.8,0.08,3.2,3.2,Matches,310.0,br BRA,MF,24.0,37.0,33.0,2927.0,32.5,6.0,6.0,12.0,6.0,0.0,0.0,6.0,1.0,2.8,2.8,4.4,7.2,48.0,148.0,35.0,0.18,0.18,0.37,0.18,0.37,0.09,0.14,0.22,0.09,0.22,Matches,Douglas Luiz,DM/M C,24,140,155,Brazil,Aston Villa,7,8,12,12,14,10,12,13,9,14,14,11,14,15,13,14,12,14,12,13,12,13,14,12,13,11,13,14,14,14,13,11,14,13,15,13,11,14,12,9,11,1,3,3,2,3,2,2,2,3,2,4,12,12,6,12,14,12,13,12,1,1,1,1,1,1,20,1,19,1,1,1,1,1,178,65,11,20,42447176,7000,6900,6000,Mediterranean_Hispanic,138,13,1998/5/9,9,0,75395.0,,19302456
400,Lyanco,Southampton,1997,312.0,br BRA,DF,25.0,13.1,24.0,16.0,15.0,9.0,0.0,12.0,18.0,66.7,6.0,30.0,25.0,5.0,20.0,44.0,65.0,2.0,Matches,312.0,br BRA,DF,25.0,13.1,9.0,0.69,6.0,1.0,1.0,1.0,0.0,0.0,0.0,0.0,0.0,0.0,0.0,0.0,0.0,0.0,Matches,,,,,,,,,,,,,,,,,,,,,,,,,,,,,,,,,,,,,,,,,,,,,,,,,,,,,,,,312.0,br BRA,DF,25.0,13.1,4.0,0.0,0.0,16.0,10.0,1.0,7.0,20.0,16.0,0.0,0.0,0.0,83.0,25.0,19.0,56.8,Matches,312.0,br BRA,DF,25.0,13.1,558.0,494.0,63.0,15.0,3.0,6.0,7.0,48.0,0.0,0.0,0.0,0.0,400.0,1.0,7.0,Matches,312.0,br BRA,DF,25.0,13.1,400.0,558.0,71.7,7719.0,2787.0,137.0,163.0,84.0,208.0,263.0,79.1,44.0,110.0,40.0,1.0,0.5,0.1,0.5,4.0,31.0,3.0,1.0,35.0,Matches,390,br BRA,DF,25,21,1180.0,56.0,34.5,13.1,11,88.0,9,10,22.0,8,0.86,14.0,26.0,-12.0,-0.92,0.09,14.8,23.1,-8.3,-0.63,-0.03,Matches,312.0,br BRA,DF,25.0,13.1,720.0,123.0,368.0,297.0,64.0,12.0,720.0,11.0,8.0,72.7,2.0,18.2,368.0,1892.0,1034.0,13.0,8.0,1.0,11.0,4.0,353.0,4.0,Matches,312.0,br BRA,DF,25.0,13.1,1.0,12.0,4.0,33.3,0.92,0.31,0.08,0.25,19.1,0.0,0.0,0.0,0.6,0.6,0.05,0.4,0.4,Matches,312.0,br BRA,DF,25.0,21.0,11.0,1180.0,13.1,1.0,1.0,2.0,1.0,0.0,0.0,4.0,0.0,0.6,0.6,0.5,1.0,13.0,35.0,4.0,0.08,0.08,0.15,0.08,0.15,0.04,0.04,0.08,0.04,0.08,Matches,Lyanco,D C,25,132,145,"Brazil,Serbia",Southampton,4,4,11,7,12,6,14,5,3,14,12,10,14,11,14,14,14,14,12,10,12,18,11,10,6,13,14,15,14,13,14,14,16,15,13,14,12,13,12,8,6,1,3,3,2,2,2,3,2,1,1,3,17,14,8,10,12,16,11,9,1,1,20,1,1,1,1,1,1,1,1,1,1,1,187,83,10,20,19426617,6600,6600,5200,Northern_European,132,3,1997/2/1,0,0,57996.0,,19236273
401,Alexis Mac Allister,Brighton,1998,313.0,ar ARG,MF,23.0,32.1,70.0,39.0,22.0,40.0,8.0,34.0,71.0,47.9,37.0,26.0,2.0,24.0,22.0,92.0,10.0,1.0,Matches,313.0,ar ARG,MF,23.0,32.1,106.0,3.31,76.0,7.0,9.0,8.0,4.0,2.0,8.0,0.25,7.0,0.0,1.0,0.0,0.0,0.0,Matches,,,,,,,,,,,,,,,,,,,,,,,,,,,,,,,,,,,,,,,,,,,,,,,,,,,,,,,,313.0,ar ARG,MF,23.0,32.1,8.0,0.0,0.0,35.0,57.0,0.0,29.0,22.0,39.0,0.0,0.0,1.0,213.0,25.0,16.0,61.0,Matches,313.0,ar ARG,MF,23.0,32.1,1844.0,1785.0,52.0,35.0,15.0,11.0,29.0,5.0,12.0,7.0,4.0,0.0,1586.0,7.0,43.0,Matches,313.0,ar ARG,MF,23.0,32.1,1586.0,1844.0,86.0,24936.0,6259.0,847.0,930.0,91.1,591.0,653.0,90.5,101.0,148.0,68.2,2.0,4.3,4.4,-2.3,47.0,151.0,33.0,1.0,174.0,Matches,391,ar ARG,MF,23,35,2886.0,82.0,84.4,32.1,31,89.0,27,4,32.0,0,1.6,54.0,45.0,9.0,0.28,-1.4,62.0,39.5,22.5,0.7,0.6,Matches,313.0,ar ARG,MF,23.0,32.1,2182.0,48.0,367.0,1194.0,644.0,63.0,2176.0,72.0,42.0,58.3,21.0,29.2,1319.0,6135.0,3072.0,69.0,74.0,8.0,47.0,36.0,1644.0,77.0,Matches,313.0,ar ARG,MF,23.0,32.1,10.0,80.0,28.0,35.0,2.49,0.87,0.05,0.14,22.5,8.0,6.0,6.0,12.1,7.3,0.09,-2.1,-3.3,Matches,313.0,ar ARG,MF,23.0,35.0,31.0,2886.0,32.1,10.0,2.0,12.0,4.0,6.0,6.0,8.0,0.0,12.1,7.3,4.3,11.6,69.0,174.0,77.0,0.31,0.06,0.37,0.12,0.19,0.38,0.13,0.51,0.23,0.36,Matches,Alexis Mac Allister,DM/M/AM C,23,144,159,Argentina,Brighton & Hove Albion,14,14,13,14,14,15,10,15,9,7,16,16,14,16,15,13,12,14,13,16,13,14,14,10,14,13,13,14,13,11,11,9,14,13,14,12,13,8,13,6,14,2,2,4,2,4,3,2,3,2,2,2,9,12,3,12,14,16,15,10,1,1,1,1,1,1,18,13,18,1,14,20,14,12,174,71,8,20,52732047,7199,6649,5499,Mediterranean_Hispanic,141,7,1998/12/24,5,0,69595.0,,14157184
402,James Maddison,Leicester City,1996,314.0,eng ENG,MFFW,25.0,27.6,51.0,26.0,25.0,19.0,7.0,19.0,50.0,38.0,31.0,19.0,1.0,18.0,13.0,64.0,6.0,1.0,Matches,314.0,eng ENG,MFFW,25.0,27.6,138.0,5.01,76.0,29.0,12.0,7.0,12.0,2.0,13.0,0.47,10.0,1.0,1.0,0.0,1.0,0.0,Matches,,,,,,,,,,,,,,,,,,,,,,,,,,,,,,,,,,,,,,,,,,,,,,,,,,,,,,,,314.0,eng ENG,MFFW,25.0,27.6,10.0,0.0,0.0,31.0,79.0,6.0,123.0,13.0,26.0,1.0,0.0,0.0,101.0,4.0,10.0,28.6,Matches,314.0,eng ENG,MFFW,25.0,27.6,1150.0,998.0,142.0,60.0,13.0,8.0,123.0,4.0,69.0,37.0,20.0,3.0,844.0,10.0,29.0,Matches,314.0,eng ENG,MFFW,25.0,27.6,844.0,1150.0,73.4,14244.0,4356.0,417.0,481.0,86.7,300.0,395.0,75.9,93.0,186.0,50.0,9.0,9.3,5.7,-0.3,69.0,117.0,27.0,4.0,151.0,Matches,392,eng ENG,MFFW,25,30,2480.0,83.0,72.5,27.6,28,86.0,21,2,34.0,0,0.93,41.0,54.0,-13.0,-0.47,-0.09,38.0,45.8,-7.9,-0.29,0.18,Matches,314.0,eng ENG,MFFW,25.0,27.6,1447.0,17.0,160.0,647.0,655.0,103.0,1445.0,107.0,46.0,43.0,39.0,36.4,964.0,5653.0,2671.0,77.0,44.0,31.0,45.0,31.0,1075.0,155.0,Matches,314.0,eng ENG,MFFW,25.0,27.6,10.0,83.0,27.0,32.5,3.01,0.98,0.11,0.33,21.1,13.0,1.0,2.0,8.7,6.6,0.08,1.3,2.4,Matches,314.0,eng ENG,MFFW,25.0,30.0,28.0,2480.0,27.6,10.0,9.0,19.0,9.0,1.0,2.0,10.0,0.0,8.7,6.6,9.3,15.9,77.0,151.0,155.0,0.36,0.33,0.69,0.33,0.65,0.31,0.34,0.65,0.24,0.58,Matches,James Maddison,M/AM RLC,25,153,163,"England,Republic of Ireland",Leicester City,12,13,16,14,15,16,5,14,4,7,16,15,11,16,8,12,12,15,12,16,15,14,16,13,14,10,12,14,13,16,17,8,15,12,13,8,13,9,13,7,8,1,1,3,3,1,2,2,1,2,1,2,12,16,12,13,14,15,9,13,1,1,1,1,1,1,1,16,18,12,16,20,18,8,175,73,13,20,70175000,7750,7400,6000,Northern_European,150,5,1996/11/23,1,0,127591.0,,28093567
403,Riyad Mahrez,Manchester City,1991,318.0,dz ALG,FWMF,31.0,21.3,30.0,14.0,8.0,13.0,9.0,13.0,39.0,33.3,26.0,27.0,1.0,26.0,9.0,39.0,5.0,0.0,Matches,318.0,dz ALG,FWMF,31.0,21.3,116.0,5.44,74.0,17.0,7.0,10.0,6.0,2.0,21.0,0.98,13.0,2.0,2.0,3.0,0.0,1.0,Matches,,,,,,,,,,,,,,,,,,,,,,,,,,,,,,,,,,,,,,,,,,,,,,,,,,,,,,,,318.0,dz ALG,FWMF,31.0,21.3,2.0,0.0,0.0,16.0,42.0,7.0,96.0,9.0,14.0,0.0,0.0,0.0,82.0,9.0,14.0,39.1,Matches,318.0,dz ALG,FWMF,31.0,21.3,1166.0,1028.0,138.0,36.0,10.0,7.0,96.0,37.0,65.0,26.0,20.0,1.0,958.0,0.0,18.0,Matches,318.0,dz ALG,FWMF,31.0,21.3,958.0,1166.0,82.2,15746.0,2752.0,506.0,567.0,89.2,355.0,416.0,85.3,82.0,141.0,58.2,10.0,7.0,5.3,3.0,52.0,36.0,37.0,7.0,76.0,Matches,396,dz ALG,FWMF,31,30,1920.0,64.0,56.1,21.3,22,80.0,11,8,20.0,8,2.5,51.0,23.0,28.0,1.31,-0.67,44.1,18.9,25.2,1.18,-0.1,Matches,318.0,dz ALG,FWMF,31.0,21.3,1392.0,14.0,105.0,494.0,802.0,110.0,1391.0,73.0,25.0,34.2,27.0,37.0,934.0,5159.0,2361.0,78.0,47.0,45.0,35.0,27.0,1042.0,242.0,Matches,318.0,dz ALG,FWMF,31.0,21.3,5.0,42.0,12.0,28.6,1.97,0.56,0.1,0.33,17.2,7.0,1.0,1.0,5.6,4.8,0.11,-0.6,-0.8,Matches,318.0,dz ALG,FWMF,31.0,30.0,22.0,1920.0,21.3,5.0,10.0,15.0,4.0,1.0,1.0,2.0,0.0,5.6,4.8,7.0,11.8,78.0,76.0,242.0,0.23,0.47,0.7,0.19,0.66,0.26,0.33,0.59,0.22,0.55,Matches,Riyad Mahrez,M/AM RL,31,160,163,"Algeria,France,Morocco",Manchester City,14,16,17,16,20,14,8,13,4,5,16,13,8,17,6,13,7,16,13,17,13,13,17,5,15,5,13,13,15,17,15,9,14,14,14,8,14,7,15,6,10,1,1,1,1,2,1,3,3,3,3,3,8,15,8,12,9,12,9,14,1,1,1,1,1,1,1,14,1,19,15,14,20,10,179,67,20,10,79602112,7997,7997,7747,African_Caribbean,159,12,1991/2/21,75,26,231983.0,,85078058
404,Ainsley Maitland-Niles,Southampton,1997,320.0,eng ENG,DFMF,24.0,15.6,45.0,24.0,23.0,18.0,4.0,28.0,44.0,63.6,16.0,28.0,7.0,21.0,22.0,67.0,45.0,1.0,Matches,320.0,eng ENG,DFMF,24.0,15.6,24.0,1.54,22.0,0.0,1.0,0.0,1.0,0.0,2.0,0.13,1.0,0.0,0.0,0.0,1.0,0.0,Matches,,,,,,,,,,,,,,,,,,,,,,,,,,,,,,,,,,,,,,,,,,,,,,,,,,,,,,,,320.0,eng ENG,DFMF,24.0,15.6,3.0,0.0,0.0,13.0,8.0,0.0,20.0,22.0,24.0,1.0,1.0,0.0,90.0,15.0,11.0,57.7,Matches,320.0,eng ENG,DFMF,24.0,15.6,713.0,633.0,77.0,11.0,2.0,3.0,20.0,66.0,0.0,0.0,0.0,0.0,565.0,3.0,12.0,Matches,320.0,eng ENG,DFMF,24.0,15.6,565.0,713.0,79.2,9322.0,3245.0,288.0,331.0,87.0,214.0,258.0,82.9,50.0,84.0,59.5,0.0,0.7,0.7,-0.7,10.0,52.0,12.0,5.0,57.0,Matches,398,eng ENG,DFMF,24,22,1407.0,64.0,41.1,15.6,13,86.0,7,9,32.0,5,0.64,16.0,31.0,-15.0,-0.96,0.02,17.7,22.2,-4.5,-0.29,0.55,Matches,320.0,eng ENG,DFMF,24.0,15.6,912.0,73.0,328.0,440.0,155.0,7.0,912.0,22.0,17.0,77.3,5.0,22.7,407.0,2036.0,885.0,15.0,13.0,2.0,26.0,13.0,509.0,35.0,Matches,320.0,eng ENG,DFMF,24.0,15.6,0.0,1.0,1.0,100.0,0.06,0.06,0.0,0.0,31.4,0.0,0.0,0.0,0.0,0.0,0.02,0.0,0.0,Matches,320.0,eng ENG,DFMF,24.0,22.0,13.0,1407.0,15.6,0.0,0.0,0.0,0.0,0.0,0.0,3.0,0.0,0.0,0.0,0.7,0.7,15.0,57.0,35.0,0.0,0.0,0.0,0.0,0.0,0.0,0.05,0.05,0.0,0.05,Matches,Ainsley Maitland-Niles,D/WB RLC,24,136,148,England,Arsenal,10,11,14,8,13,8,6,10,8,10,13,17,11,14,10,11,10,12,10,12,12,10,14,7,14,10,13,10,16,15,14,8,13,14,13,10,12,9,12,9,20,1,3,2,1,3,3,1,3,3,2,3,19,14,12,13,13,10,12,13,1,18,8,18,19,20,14,12,15,12,10,8,13,1,177,73,9,20,19062192,6800,7050,5750,African_Caribbean,123,15,1997/8/29,5,0,75395.0,Southampton,28095584
405,Tyrell Malacia,Manchester Utd,1999,321.0,nl NED,DF,22.0,15.5,46.0,33.0,33.0,12.0,1.0,14.0,25.0,56.0,11.0,13.0,3.0,10.0,25.0,71.0,49.0,0.0,Matches,321.0,nl NED,DF,22.0,15.5,19.0,1.22,19.0,0.0,0.0,0.0,0.0,0.0,0.0,0.0,0.0,0.0,0.0,0.0,0.0,0.0,Matches,,,,,,,,,,,,,,,,,,,,,,,,,,,,,,,,,,,,,,,,,,,,,,,,,,,,,,,,321.0,nl NED,DF,22.0,15.5,6.0,0.0,0.0,39.0,13.0,3.0,15.0,25.0,33.0,0.0,0.0,0.0,90.0,8.0,4.0,66.7,Matches,321.0,nl NED,DF,22.0,15.5,802.0,670.0,130.0,11.0,0.0,5.0,15.0,117.0,2.0,2.0,0.0,0.0,694.0,2.0,16.0,Matches,321.0,nl NED,DF,22.0,15.5,694.0,802.0,86.5,10156.0,2981.0,429.0,463.0,92.7,205.0,232.0,88.4,35.0,60.0,58.3,0.0,0.7,0.7,-0.7,9.0,36.0,8.0,0.0,44.0,Matches,399,nl NED,DF,22,22,1396.0,63.0,40.8,15.5,14,84.0,10,8,27.0,15,2.0,22.0,14.0,8.0,0.52,0.2,29.5,19.2,10.4,0.67,0.36,Matches,321.0,nl NED,DF,22.0,15.5,989.0,54.0,378.0,392.0,225.0,16.0,989.0,19.0,6.0,31.6,13.0,68.4,472.0,2127.0,1023.0,19.0,17.0,3.0,17.0,8.0,557.0,33.0,Matches,321.0,nl NED,DF,22.0,15.5,0.0,5.0,2.0,40.0,0.32,0.13,0.0,0.0,22.1,0.0,0.0,0.0,0.2,0.2,0.05,-0.2,-0.2,Matches,321.0,nl NED,DF,22.0,22.0,14.0,1396.0,15.5,0.0,0.0,0.0,0.0,0.0,0.0,6.0,0.0,0.2,0.2,0.7,0.9,19.0,44.0,33.0,0.0,0.0,0.0,0.0,0.0,0.02,0.04,0.06,0.02,0.06,Matches,Tyrell Malacia,D/WB L,22,139,150,"Holland,Curaçao",Manchester UFC,7,13,12,7,13,9,9,8,12,14,12,7,13,13,15,13,16,14,14,11,14,16,10,9,13,13,15,17,15,17,13,8,16,14,15,7,14,5,14,6,8,2,1,1,1,4,2,3,1,1,2,2,12,15,7,14,15,14,16,16,1,20,1,1,19,1,1,14,1,1,10,1,1,1,169,67,20,10,37268142,7300,6650,5500,African_Caribbean,138,13,1999/8/17,5,0,57996.0,,37058363
406,Orel Mangala,Nott'ham Forest,1998,322.0,be BEL,MF,24.0,17.2,28.0,20.0,16.0,10.0,2.0,12.0,29.0,41.4,17.0,21.0,7.0,14.0,23.0,51.0,15.0,0.0,Matches,322.0,be BEL,MF,24.0,17.2,13.0,0.76,11.0,0.0,0.0,0.0,2.0,0.0,1.0,0.06,1.0,0.0,0.0,0.0,0.0,0.0,Matches,,,,,,,,,,,,,,,,,,,,,,,,,,,,,,,,,,,,,,,,,,,,,,,,,,,,,,,,322.0,be BEL,MF,24.0,17.2,3.0,0.0,0.0,22.0,23.0,0.0,6.0,23.0,20.0,0.0,0.0,0.0,88.0,11.0,9.0,55.0,Matches,322.0,be BEL,MF,24.0,17.2,514.0,508.0,4.0,3.0,1.0,1.0,6.0,0.0,0.0,0.0,0.0,0.0,411.0,2.0,11.0,Matches,322.0,be BEL,MF,24.0,17.2,411.0,514.0,80.0,6178.0,1807.0,223.0,256.0,87.1,153.0,183.0,83.6,22.0,42.0,52.4,1.0,0.4,0.5,0.6,3.0,35.0,3.0,0.0,43.0,Matches,400,be BEL,MF,24,27,1550.0,57.0,45.3,17.2,20,70.0,5,7,20.0,5,1.19,22.0,24.0,-2.0,-0.12,1.23,19.6,28.9,-9.3,-0.54,0.21,Matches,322.0,be BEL,MF,24.0,17.2,655.0,31.0,183.0,380.0,99.0,8.0,655.0,34.0,16.0,47.1,12.0,35.3,334.0,1742.0,808.0,14.0,6.0,2.0,11.0,9.0,383.0,8.0,Matches,322.0,be BEL,MF,24.0,17.2,1.0,9.0,3.0,33.3,0.52,0.17,0.11,0.33,20.7,0.0,0.0,0.0,0.6,0.6,0.06,0.4,0.4,Matches,322.0,be BEL,MF,24.0,27.0,20.0,1550.0,17.2,1.0,1.0,2.0,1.0,0.0,0.0,3.0,0.0,0.6,0.6,0.4,0.9,14.0,43.0,8.0,0.06,0.06,0.12,0.06,0.12,0.03,0.02,0.06,0.03,0.06,Matches,Orel Mangala,DM/M C,24,126,134,"Belgium,Democratic Republic of Congo",Nottingham Forest,8,10,15,9,13,8,10,10,8,11,13,10,13,14,11,12,15,14,13,13,12,13,12,9,12,13,11,10,13,14,16,10,17,13,12,15,10,10,15,8,12,1,1,3,2,1,2,1,3,3,1,2,13,13,13,8,12,12,12,8,1,1,1,1,1,1,18,10,20,1,10,12,1,1,178,82,10,20,11950706,6300,6300,5450,African_Caribbean,126,16,1998/3/18,2,0,52196.0,,18087973
407,Solly March,Brighton,1994,325.0,eng ENG,FWDF,28.0,30.2,53.0,31.0,16.0,17.0,20.0,8.0,28.0,28.6,20.0,34.0,3.0,31.0,24.0,77.0,32.0,0.0,Matches,325.0,eng ENG,FWDF,28.0,30.2,140.0,4.64,91.0,15.0,19.0,9.0,4.0,2.0,14.0,0.46,10.0,1.0,1.0,2.0,0.0,0.0,Matches,,,,,,,,,,,,,,,,,,,,,,,,,,,,,,,,,,,,,,,,,,,,,,,,,,,,,,,,325.0,eng ENG,FWDF,28.0,30.2,2.0,0.0,0.0,46.0,39.0,12.0,155.0,24.0,31.0,0.0,0.0,0.0,125.0,29.0,38.0,43.3,Matches,325.0,eng ENG,FWDF,28.0,30.2,1312.0,1168.0,142.0,14.0,3.0,29.0,155.0,54.0,71.0,33.0,21.0,0.0,951.0,2.0,36.0,Matches,325.0,eng ENG,FWDF,28.0,30.2,951.0,1312.0,72.5,17051.0,4026.0,443.0,526.0,84.2,367.0,481.0,76.3,113.0,208.0,54.3,7.0,8.4,6.3,-1.4,67.0,63.0,52.0,15.0,135.0,Matches,404,eng ENG,FWDF,28,33,2715.0,82.0,79.4,30.2,31,86.0,19,2,30.0,0,1.67,58.0,40.0,18.0,0.6,0.47,59.0,36.2,22.8,0.75,0.71,Matches,325.0,eng ENG,FWDF,28.0,30.2,1659.0,46.0,191.0,521.0,962.0,138.0,1659.0,114.0,58.0,50.9,35.0,30.7,1024.0,6810.0,3074.0,110.0,48.0,47.0,55.0,32.0,1124.0,357.0,Matches,325.0,eng ENG,FWDF,28.0,30.2,7.0,74.0,31.0,41.9,2.45,1.03,0.09,0.23,16.2,1.0,0.0,0.0,8.1,8.1,0.11,-1.1,-1.1,Matches,325.0,eng ENG,FWDF,28.0,33.0,31.0,2715.0,30.2,7.0,7.0,14.0,7.0,0.0,0.0,2.0,0.0,8.1,8.1,8.4,16.5,110.0,135.0,357.0,0.23,0.23,0.46,0.23,0.46,0.27,0.28,0.55,0.27,0.55,Matches,Solly March,WB/M/AM RL,28,138,141,England,Brighton & Hove Albion,13,13,14,9,13,13,8,13,4,8,13,10,10,14,9,12,10,13,14,12,14,14,13,8,12,13,15,14,14,13,13,10,12,14,14,9,15,6,15,12,17,2,4,2,1,1,2,3,2,3,3,4,9,13,5,12,14,18,8,13,1,11,1,11,17,17,1,17,11,17,15,14,20,1,181,73,20,8,47210232,6897,6897,5247,Northern_European,131,5,1994/7/20,0,0,52196.0,,29090530
408,Anthony Martial,Manchester Utd,1995,328.0,fr FRA,FW,26.0,10.9,5.0,3.0,0.0,2.0,3.0,1.0,4.0,25.0,3.0,11.0,2.0,9.0,1.0,6.0,4.0,0.0,Matches,328.0,fr FRA,FW,26.0,10.9,28.0,2.58,22.0,0.0,1.0,3.0,1.0,1.0,5.0,0.46,2.0,0.0,1.0,1.0,1.0,0.0,Matches,,,,,,,,,,,,,,,,,,,,,,,,,,,,,,,,,,,,,,,,,,,,,,,,,,,,,,,,328.0,fr FRA,FW,26.0,10.9,0.0,0.0,0.0,8.0,14.0,7.0,4.0,1.0,3.0,1.0,0.0,0.0,20.0,10.0,17.0,37.0,Matches,328.0,fr FRA,FW,26.0,10.9,328.0,314.0,12.0,3.0,3.0,0.0,4.0,2.0,0.0,0.0,0.0,0.0,263.0,2.0,14.0,Matches,328.0,fr FRA,FW,26.0,10.9,263.0,328.0,80.2,3259.0,910.0,173.0,198.0,87.4,61.0,73.0,83.6,9.0,14.0,64.3,2.0,1.4,1.4,0.6,12.0,14.0,13.0,0.0,35.0,Matches,408,fr FRA,FW,26,21,978.0,47.0,28.6,10.9,11,64.0,0,10,28.0,0,2.19,16.0,8.0,8.0,0.74,0.48,21.5,13.7,7.8,0.72,0.37,Matches,328.0,fr FRA,FW,26.0,10.9,443.0,10.0,31.0,166.0,249.0,49.0,442.0,26.0,14.0,53.8,9.0,34.6,297.0,1296.0,570.0,18.0,13.0,8.0,33.0,20.0,371.0,87.0,Matches,328.0,fr FRA,FW,26.0,10.9,6.0,26.0,12.0,46.2,2.39,1.1,0.19,0.42,13.2,0.0,1.0,1.0,6.2,5.5,0.21,-0.2,-0.5,Matches,328.0,fr FRA,FW,26.0,21.0,11.0,978.0,10.9,6.0,2.0,8.0,5.0,1.0,1.0,0.0,0.0,6.2,5.5,1.4,6.9,18.0,35.0,87.0,0.55,0.18,0.74,0.46,0.64,0.58,0.13,0.7,0.5,0.63,Matches,Anthony Martial,AM/S L,26,145,170,"France,Martinique,Guadeloupe",Manchester UFC,5,8,16,15,16,8,11,12,2,5,14,15,4,16,5,13,10,15,11,9,13,8,17,6,13,5,14,10,15,16,15,9,15,16,16,13,8,8,13,13,10,3,3,3,2,3,3,3,3,3,1,3,16,14,12,12,10,8,11,12,1,1,1,1,1,1,1,12,1,10,16,1,14,20,181,76,12,20,41757025,7500,7200,6750,African_Caribbean,143,13,1995/12/5,30,2,289979.0,,85086702
409,Gabriel Martinelli,Arsenal,2001,329.0,br BRA,FW,21.0,31.0,31.0,18.0,13.0,12.0,6.0,9.0,22.0,40.9,13.0,24.0,1.0,23.0,9.0,40.0,14.0,0.0,Matches,329.0,br BRA,FW,21.0,31.0,127.0,4.1,89.0,8.0,12.0,12.0,4.0,2.0,17.0,0.55,10.0,0.0,2.0,5.0,0.0,0.0,Matches,,,,,,,,,,,,,,,,,,,,,,,,,,,,,,,,,,,,,,,,,,,,,,,,,,,,,,,,329.0,br BRA,FW,21.0,31.0,3.0,0.0,0.0,39.0,37.0,8.0,113.0,9.0,18.0,0.0,0.0,0.0,103.0,14.0,63.0,18.2,Matches,329.0,br BRA,FW,21.0,31.0,1107.0,1013.0,88.0,12.0,8.0,2.0,113.0,11.0,63.0,40.0,0.0,0.0,833.0,6.0,44.0,Matches,329.0,br BRA,FW,21.0,31.0,833.0,1107.0,75.2,12960.0,2610.0,447.0,527.0,84.8,295.0,356.0,82.9,61.0,123.0,49.6,5.0,9.1,7.0,-4.1,59.0,33.0,43.0,10.0,94.0,Matches,409,br BRA,FW,21,36,2789.0,77.0,81.5,31.0,34,80.0,16,2,28.0,0,2.25,72.0,33.0,39.0,1.26,0.4,59.7,35.7,24.1,0.78,-0.03,Matches,329.0,br BRA,FW,21.0,31.0,1490.0,19.0,129.0,419.0,965.0,223.0,1490.0,132.0,59.0,44.7,55.0,41.7,1019.0,7180.0,3297.0,124.0,65.0,70.0,83.0,56.0,1115.0,350.0,Matches,329.0,br BRA,FW,21.0,31.0,15.0,79.0,30.0,38.0,2.55,0.97,0.19,0.5,15.4,2.0,0.0,0.0,9.1,9.1,0.12,5.9,5.9,Matches,329.0,br BRA,FW,21.0,36.0,34.0,2789.0,31.0,15.0,5.0,20.0,15.0,0.0,0.0,3.0,0.0,9.1,9.1,9.1,18.2,124.0,94.0,350.0,0.48,0.16,0.65,0.48,0.65,0.29,0.29,0.59,0.29,0.59,Matches,Gabriel Martinelli,AM/S RL,21,148,174,"Brazil,Italy",Arsenal,14,10,14,14,14,10,13,8,3,5,12,11,5,14,12,13,13,13,12,13,12,16,15,6,15,6,16,16,17,16,14,11,13,16,13,10,13,6,14,10,12,2,2,4,4,3,2,2,2,3,2,1,16,14,5,12,14,15,13,13,1,1,1,1,1,1,1,12,1,10,20,13,16,19,180,72,10,20,100274855,7400,7250,6000,Mediterranean_Hispanic,141,8,2001/6/18,3,0,63795.0,,19351309
410,Emiliano Martínez,Aston Villa,1992,330.0,ar ARG,GK,29.0,34.9,0.0,0.0,0.0,0.0,0.0,0.0,2.0,0.0,2.0,0.0,0.0,0.0,1.0,1.0,23.0,1.0,Matches,330.0,ar ARG,GK,29.0,34.9,5.0,0.14,3.0,2.0,0.0,0.0,0.0,0.0,0.0,0.0,0.0,0.0,0.0,0.0,0.0,0.0,Matches,20.0,ar ARG,GK,29.0,34.9,38.0,4.0,1.0,6.0,4.0,36.6,0.24,2.6,0.07,199.0,523.0,38.0,1171.0,135.0,35.5,33.0,212.0,50.5,40.7,483.0,60.0,12.4,73.0,2.09,16.6,Matches,20.0,ar ARG,GK,29.0,36.0,36.0,3139.0,34.9,38.0,1.09,132.0,97.0,74.2,17.0,7.0,12.0,11.0,30.6,5.0,4.0,1.0,0.0,20.0,Matches,330.0,ar ARG,GK,29.0,34.9,7.0,0.0,0.0,1.0,6.0,0.0,0.0,1.0,0.0,0.0,1.0,1.0,41.0,13.0,0.0,100.0,Matches,330.0,ar ARG,GK,29.0,34.9,1388.0,1043.0,340.0,128.0,1.0,5.0,0.0,0.0,0.0,0.0,0.0,0.0,1026.0,5.0,1.0,Matches,330.0,ar ARG,GK,29.0,34.9,1026.0,1388.0,73.9,27095.0,17857.0,218.0,219.0,99.5,520.0,527.0,98.7,286.0,633.0,45.2,0.0,0.3,0.3,-0.3,2.0,21.0,0.0,0.0,0.0,Matches,410,ar ARG,GK,29,36,3139.0,87.0,91.8,34.9,36,87.0,34,0,,1,1.61,47.0,38.0,9.0,0.26,1.54,46.5,43.9,2.7,0.08,1.64,Matches,330.0,ar ARG,GK,29.0,34.9,1479.0,1218.0,1463.0,17.0,0.0,0.0,1479.0,0.0,0.0,,0.0,,851.0,4474.0,2627.0,0.0,0.0,0.0,2.0,0.0,707.0,0.0,Matches,330.0,ar ARG,GK,29.0,34.9,0.0,0.0,0.0,,0.0,0.0,,,,0.0,0.0,0.0,0.0,0.0,,0.0,0.0,Matches,330.0,ar ARG,GK,29.0,36.0,36.0,3139.0,34.9,0.0,0.0,0.0,0.0,0.0,0.0,7.0,0.0,0.0,0.0,0.3,0.3,0.0,0.0,0.0,0.0,0.0,0.0,0.0,0.0,0.0,0.01,0.01,0.0,0.01,Matches,Emiliano Martínez,GK,29,149,155,Argentina,Aston Villa,1,1,3,3,11,1,5,1,1,2,12,4,2,11,7,13,12,12,14,7,13,14,8,13,11,13,12,13,10,16,13,15,13,10,12,12,14,7,14,6,2,15,14,12,10,16,14,14,18,14,10,11,14,13,5,15,15,15,9,14,20,1,1,1,1,1,1,1,1,1,1,1,1,1,193,85,10,20,39770086,7539,7739,6489,Mediterranean_Hispanic,146,8,1992/9/2,17,0,115992.0,,14020367
411,Lisandro Martínez,Manchester Utd,1998,331.0,ar ARG,DF,24.0,23.5,54.0,28.0,33.0,18.0,3.0,30.0,43.0,69.8,13.0,51.0,27.0,24.0,33.0,87.0,103.0,0.0,Matches,331.0,ar ARG,DF,24.0,23.5,18.0,0.77,16.0,0.0,0.0,1.0,0.0,1.0,1.0,0.04,1.0,0.0,0.0,0.0,0.0,0.0,Matches,,,,,,,,,,,,,,,,,,,,,,,,,,,,,,,,,,,,,,,,,,,,,,,,,,,,,,,,331.0,ar ARG,DF,24.0,23.5,6.0,0.0,0.0,21.0,10.0,0.0,0.0,33.0,28.0,0.0,0.0,0.0,164.0,32.0,31.0,50.8,Matches,331.0,ar ARG,DF,24.0,23.5,1528.0,1401.0,122.0,34.0,7.0,16.0,0.0,5.0,0.0,0.0,0.0,0.0,1330.0,5.0,7.0,Matches,331.0,ar ARG,DF,24.0,23.5,1330.0,1528.0,87.0,23895.0,8188.0,532.0,568.0,93.7,683.0,728.0,93.8,96.0,193.0,49.7,0.0,0.3,1.0,-0.3,6.0,92.0,5.0,0.0,83.0,Matches,411,ar ARG,DF,24,27,2114.0,78.0,61.8,23.5,24,87.0,19,3,11.0,0,1.85,35.0,33.0,2.0,0.09,-0.81,36.3,32.3,4.0,0.17,-0.75,Matches,331.0,ar ARG,DF,24.0,23.5,1809.0,281.0,934.0,829.0,60.0,11.0,1809.0,16.0,14.0,87.5,0.0,0.0,1061.0,5256.0,2986.0,12.0,16.0,0.0,11.0,9.0,1138.0,2.0,Matches,331.0,ar ARG,DF,24.0,23.5,1.0,10.0,1.0,10.0,0.43,0.04,0.1,1.0,14.8,0.0,0.0,0.0,0.5,0.5,0.05,0.5,0.5,Matches,331.0,ar ARG,DF,24.0,27.0,24.0,2114.0,23.5,1.0,0.0,1.0,1.0,0.0,0.0,6.0,0.0,0.5,0.5,0.3,0.8,12.0,83.0,2.0,0.04,0.0,0.04,0.04,0.04,0.02,0.01,0.03,0.02,0.03,Matches,Lisandro Martínez,D LC,24,143,155,Argentina,Manchester UFC,6,9,12,7,13,9,14,7,12,15,15,9,13,15,16,14,14,14,14,14,14,12,12,13,12,14,13,15,13,12,14,13,15,13,15,13,15,14,11,7,13,3,3,1,3,3,3,2,1,2,2,1,14,13,6,12,14,14,12,11,1,15,20,1,1,1,15,1,12,1,1,1,1,1,178,77,20,10,108516059,7500,7000,6000,Mediterranean_Hispanic,142,11,1998/1/18,7,0,139190.0,,14167329
412,Joël Matip,Liverpool,1991,334.0,cm CMR,DF,30.0,12.1,14.0,8.0,12.0,2.0,0.0,11.0,23.0,47.8,12.0,8.0,3.0,5.0,21.0,35.0,45.0,3.0,Matches,334.0,cm CMR,DF,30.0,12.1,16.0,1.32,14.0,0.0,0.0,2.0,0.0,0.0,0.0,0.0,0.0,0.0,0.0,0.0,0.0,0.0,Matches,,,,,,,,,,,,,,,,,,,,,,,,,,,,,,,,,,,,,,,,,,,,,,,,,,,,,,,,334.0,cm CMR,DF,30.0,12.1,3.0,0.0,0.0,10.0,5.0,1.0,1.0,21.0,8.0,0.0,0.0,1.0,78.0,25.0,23.0,52.1,Matches,334.0,cm CMR,DF,30.0,12.1,885.0,873.0,11.0,7.0,0.0,5.0,1.0,4.0,0.0,0.0,0.0,0.0,766.0,1.0,5.0,Matches,334.0,cm CMR,DF,30.0,12.1,766.0,885.0,86.6,13750.0,4547.0,305.0,349.0,87.4,395.0,428.0,92.3,57.0,85.0,67.1,0.0,0.3,0.4,-0.3,4.0,53.0,7.0,0.0,59.0,Matches,414,cm CMR,DF,30,14,1092.0,78.0,31.9,12.1,12,86.0,10,2,28.0,15,1.29,21.0,20.0,1.0,0.08,-0.96,22.5,16.6,5.8,0.48,-0.13,Matches,334.0,cm CMR,DF,30.0,12.1,1004.0,111.0,482.0,468.0,62.0,17.0,1004.0,7.0,4.0,57.1,3.0,42.9,657.0,4140.0,2907.0,28.0,22.0,1.0,14.0,1.0,720.0,2.0,Matches,334.0,cm CMR,DF,30.0,12.1,1.0,5.0,3.0,60.0,0.41,0.25,0.2,0.33,8.3,0.0,0.0,0.0,0.7,0.7,0.17,0.3,0.3,Matches,334.0,cm CMR,DF,30.0,14.0,12.0,1092.0,12.1,1.0,0.0,1.0,1.0,0.0,0.0,3.0,0.0,0.7,0.7,0.3,1.0,28.0,59.0,2.0,0.08,0.0,0.08,0.08,0.08,0.06,0.02,0.08,0.06,0.08,Matches,Joël Matip,D C,30,157,158,"Cameroon,Germany",Liverpool,4,7,15,5,15,5,16,3,8,15,15,5,15,14,15,15,14,15,16,12,15,14,11,8,11,17,15,15,14,14,12,16,13,14,15,14,16,8,14,11,5,1,2,3,1,1,3,2,2,2,2,2,16,13,5,17,14,15,10,15,1,1,20,1,1,1,12,1,8,1,1,1,1,1,195,90,8,20,113213483,7900,7850,6750,Mixed_Race,157,13,1991/8/8,27,1,162388.0,,91018389
413,Neal Maupay,Everton,1996,335.0,fr FRA,FW,25.0,12.4,11.0,5.0,3.0,4.0,4.0,2.0,4.0,50.0,2.0,8.0,0.0,8.0,5.0,16.0,0.0,0.0,Matches,335.0,fr FRA,FW,25.0,12.4,18.0,1.45,12.0,0.0,1.0,2.0,3.0,0.0,1.0,0.08,1.0,0.0,0.0,0.0,0.0,0.0,Matches,,,,,,,,,,,,,,,,,,,,,,,,,,,,,,,,,,,,,,,,,,,,,,,,,,,,,,,,335.0,fr FRA,FW,25.0,12.4,4.0,0.0,0.0,14.0,21.0,1.0,3.0,5.0,5.0,0.0,0.0,0.0,26.0,15.0,48.0,23.8,Matches,335.0,fr FRA,FW,25.0,12.4,253.0,222.0,30.0,1.0,0.0,1.0,3.0,2.0,0.0,0.0,0.0,0.0,190.0,1.0,10.0,Matches,335.0,fr FRA,FW,25.0,12.4,190.0,253.0,75.1,2500.0,217.0,125.0,151.0,82.8,49.0,63.0,77.8,7.0,9.0,77.8,0.0,0.6,0.3,-0.6,7.0,8.0,2.0,0.0,11.0,Matches,416,fr FRA,FW,25,27,1118.0,41.0,32.7,12.4,11,78.0,1,16,16.0,6,1.0,12.0,19.0,-7.0,-0.56,0.06,14.2,21.2,-7.0,-0.56,-0.04,Matches,335.0,fr FRA,FW,25.0,12.4,387.0,1.0,27.0,172.0,194.0,49.0,387.0,19.0,7.0,36.8,12.0,63.2,219.0,864.0,306.0,8.0,7.0,3.0,38.0,16.0,280.0,61.0,Matches,335.0,fr FRA,FW,25.0,12.4,1.0,32.0,13.0,40.6,2.58,1.05,0.03,0.08,14.3,0.0,0.0,0.0,4.8,4.8,0.15,-3.8,-3.8,Matches,335.0,fr FRA,FW,25.0,27.0,11.0,1118.0,12.4,1.0,0.0,1.0,1.0,0.0,0.0,4.0,0.0,4.8,4.8,0.6,5.4,8.0,11.0,61.0,0.08,0.0,0.08,0.08,0.08,0.39,0.05,0.43,0.39,0.43,Matches,Neal Maupay,S,25,133,145,"France,Argentina",Everton,6,10,11,14,14,7,13,13,5,7,13,13,9,14,17,14,17,12,14,14,12,15,13,11,15,9,14,16,14,14,15,8,15,13,15,14,14,14,11,7,8,2,1,1,3,3,2,3,2,1,3,2,14,13,5,14,13,12,5,8,1,1,1,1,1,1,1,1,1,1,1,1,1,20,171,69,10,20,34262112,6800,6700,5400,Mediterranean_Hispanic,135,6,1996/8/14,0,0,57996.0,,85120748
414,Bryan Mbeumo,Brentford,1999,337.0,cm CMR,FW,22.0,32.3,26.0,18.0,5.0,13.0,8.0,8.0,42.0,19.0,34.0,24.0,1.0,23.0,13.0,39.0,21.0,0.0,Matches,337.0,cm CMR,FW,22.0,32.3,97.0,3.0,62.0,27.0,7.0,0.0,1.0,0.0,15.0,0.46,12.0,2.0,1.0,0.0,0.0,0.0,Matches,,,,,,,,,,,,,,,,,,,,,,,,,,,,,,,,,,,,,,,,,,,,,,,,,,,,,,,,337.0,cm CMR,FW,22.0,32.3,5.0,0.0,0.0,27.0,23.0,6.0,156.0,13.0,18.0,0.0,0.0,0.0,135.0,35.0,63.0,35.7,Matches,337.0,cm CMR,FW,22.0,32.3,991.0,845.0,139.0,48.0,7.0,7.0,156.0,19.0,71.0,37.0,12.0,5.0,655.0,7.0,42.0,Matches,337.0,cm CMR,FW,22.0,32.3,655.0,991.0,66.1,10466.0,3238.0,376.0,456.0,82.5,185.0,287.0,64.5,71.0,151.0,47.0,8.0,7.6,5.6,0.4,51.0,37.0,45.0,13.0,88.0,Matches,420,cm CMR,FW,22,38,2906.0,76.0,85.0,32.3,36,79.0,10,2,24.0,0,1.55,50.0,39.0,11.0,0.34,0.17,45.4,41.3,4.1,0.13,-0.33,Matches,337.0,cm CMR,FW,22.0,32.3,1335.0,24.0,177.0,425.0,755.0,125.0,1334.0,88.0,45.0,51.1,37.0,42.0,776.0,4292.0,1862.0,66.0,33.0,26.0,72.0,54.0,862.0,235.0,Matches,337.0,cm CMR,FW,22.0,32.3,9.0,70.0,32.0,45.7,2.17,0.99,0.11,0.25,16.3,1.0,1.0,1.0,9.7,8.9,0.13,-0.7,-0.9,Matches,337.0,cm CMR,FW,22.0,38.0,36.0,2906.0,32.3,9.0,8.0,17.0,8.0,1.0,1.0,5.0,0.0,9.7,8.9,7.6,16.5,66.0,88.0,235.0,0.28,0.25,0.53,0.25,0.5,0.3,0.23,0.53,0.28,0.51,Matches,Bryan Mbeumo,M/AM/S RL,22,136,152,"Cameroon,France",Brentford,11,13,14,13,11,9,10,13,6,6,13,13,6,13,12,12,14,12,12,13,12,14,14,7,13,8,14,16,15,13,12,8,14,15,13,12,13,8,12,6,13,1,1,3,1,1,1,1,1,1,3,2,12,13,8,12,12,13,11,12,1,1,1,1,1,1,1,17,1,1,19,1,20,18,171,70,20,8,74438852,7000,6800,5750,African_Caribbean,129,12,1999/8/7,0,0,52196.0,,48042658
415,John McGinn,Aston Villa,1994,340.0,sct SCO,MFFW,27.0,29.9,66.0,36.0,27.0,29.0,10.0,34.0,71.0,47.9,37.0,43.0,4.0,39.0,24.0,90.0,19.0,0.0,Matches,340.0,sct SCO,MFFW,27.0,29.9,80.0,2.67,56.0,10.0,5.0,3.0,5.0,1.0,10.0,0.33,7.0,1.0,0.0,0.0,2.0,0.0,Matches,,,,,,,,,,,,,,,,,,,,,,,,,,,,,,,,,,,,,,,,,,,,,,,,,,,,,,,,340.0,sct SCO,MFFW,27.0,29.9,7.0,0.0,0.0,41.0,66.0,0.0,50.0,24.0,36.0,2.0,0.0,0.0,176.0,22.0,21.0,51.2,Matches,340.0,sct SCO,MFFW,27.0,29.9,1028.0,965.0,56.0,25.0,11.0,10.0,50.0,1.0,25.0,18.0,0.0,0.0,805.0,7.0,20.0,Matches,340.0,sct SCO,MFFW,27.0,29.9,805.0,1028.0,78.3,14385.0,4830.0,374.0,430.0,87.0,309.0,373.0,82.8,101.0,165.0,61.2,3.0,2.6,3.3,0.4,18.0,114.0,20.0,5.0,140.0,Matches,426,sct SCO,MFFW,27,34,2693.0,79.0,78.7,29.9,30,86.0,22,4,26.0,1,1.59,36.0,31.0,5.0,0.17,0.17,39.4,38.0,1.4,0.05,0.5,Matches,340.0,sct SCO,MFFW,27.0,29.9,1348.0,37.0,218.0,756.0,388.0,45.0,1348.0,70.0,45.0,64.3,14.0,20.0,804.0,4072.0,1799.0,34.0,35.0,8.0,58.0,35.0,888.0,66.0,Matches,340.0,sct SCO,MFFW,27.0,29.9,1.0,42.0,11.0,26.2,1.4,0.37,0.02,0.09,23.6,0.0,0.0,0.0,2.4,2.4,0.06,-1.4,-1.4,Matches,340.0,sct SCO,MFFW,27.0,34.0,30.0,2693.0,29.9,1.0,3.0,4.0,1.0,0.0,0.0,7.0,0.0,2.4,2.4,2.6,5.0,34.0,140.0,66.0,0.03,0.1,0.13,0.03,0.13,0.08,0.09,0.17,0.08,0.17,Matches,John McGinn,DM/M/AM C,27,143,150,Scotland,Aston Villa,11,13,14,13,13,10,9,15,9,10,14,10,14,15,15,13,14,13,11,14,10,16,13,10,13,13,16,17,13,13,14,9,15,14,17,15,13,14,13,5,10,3,1,3,1,4,4,3,2,2,1,1,12,13,4,8,13,16,15,15,1,1,1,1,1,1,18,1,20,1,1,17,1,1,181,77,20,10,39999750,7150,7150,6000,Northern_European,142,0,1994/10/18,48,13,81194.0,,61043070
416,Scott McKenna,Nott'ham Forest,1996,341.0,sct SCO,DF,25.0,17.5,12.0,7.0,7.0,3.0,2.0,6.0,10.0,60.0,4.0,20.0,14.0,6.0,12.0,24.0,85.0,1.0,Matches,341.0,sct SCO,DF,25.0,17.5,10.0,0.57,10.0,0.0,0.0,0.0,0.0,0.0,1.0,0.06,1.0,0.0,0.0,0.0,0.0,0.0,Matches,,,,,,,,,,,,,,,,,,,,,,,,,,,,,,,,,,,,,,,,,,,,,,,,,,,,,,,,341.0,sct SCO,DF,25.0,17.5,4.0,0.0,0.0,8.0,4.0,0.0,2.0,12.0,7.0,0.0,1.0,0.0,68.0,36.0,23.0,61.0,Matches,341.0,sct SCO,DF,25.0,17.5,727.0,691.0,32.0,11.0,0.0,3.0,2.0,21.0,0.0,0.0,0.0,0.0,569.0,4.0,2.0,Matches,341.0,sct SCO,DF,25.0,17.5,569.0,727.0,78.3,11331.0,4319.0,163.0,195.0,83.6,334.0,394.0,84.8,66.0,122.0,54.1,0.0,1.0,0.4,-1.0,8.0,35.0,3.0,1.0,35.0,Matches,427,sct SCO,DF,25,20,1571.0,79.0,45.9,17.5,19,82.0,16,1,16.0,5,0.85,14.0,32.0,-18.0,-1.03,-0.45,18.8,28.5,-9.7,-0.56,0.18,Matches,341.0,sct SCO,DF,25.0,17.5,877.0,151.0,501.0,333.0,45.0,21.0,877.0,7.0,5.0,71.4,1.0,14.3,430.0,1885.0,929.0,5.0,1.0,0.0,2.0,2.0,508.0,2.0,Matches,341.0,sct SCO,DF,25.0,17.5,0.0,2.0,0.0,0.0,0.11,0.0,0.0,,8.2,0.0,0.0,0.0,0.1,0.1,0.04,-0.1,-0.1,Matches,341.0,sct SCO,DF,25.0,20.0,19.0,1571.0,17.5,0.0,0.0,0.0,0.0,0.0,0.0,4.0,0.0,0.1,0.1,1.0,1.1,5.0,35.0,2.0,0.0,0.0,0.0,0.0,0.0,0.0,0.06,0.06,0.0,0.06,Matches,Scott McKenna,D C,25,126,148,Scotland,Nottingham Forest,4,5,7,6,10,7,15,10,10,13,11,10,14,10,15,13,14,12,12,8,12,15,7,16,7,13,12,13,12,11,11,15,12,14,13,15,14,13,14,8,11,2,3,1,3,2,2,2,4,2,1,1,12,15,7,12,12,14,10,13,1,1,20,1,1,1,1,1,1,1,1,1,1,1,188,73,20,9,12110099,6600,6300,4750,Northern_European,125,1,1996/11/12,26,1,28998.0,,61064267
417,Weston McKennie,Leeds United,1998,342.0,us USA,MF,23.0,16.0,30.0,13.0,5.0,18.0,7.0,10.0,29.0,34.5,19.0,22.0,3.0,19.0,22.0,52.0,26.0,0.0,Matches,342.0,us USA,MF,23.0,16.0,29.0,1.82,25.0,3.0,0.0,1.0,0.0,0.0,3.0,0.19,2.0,1.0,0.0,0.0,0.0,0.0,Matches,,,,,,,,,,,,,,,,,,,,,,,,,,,,,,,,,,,,,,,,,,,,,,,,,,,,,,,,342.0,us USA,MF,23.0,16.0,7.0,0.0,0.0,21.0,5.0,1.0,9.0,22.0,13.0,0.0,0.0,0.0,95.0,25.0,23.0,52.1,Matches,342.0,us USA,MF,23.0,16.0,628.0,589.0,36.0,8.0,4.0,6.0,9.0,26.0,0.0,0.0,0.0,0.0,472.0,3.0,16.0,Matches,342.0,us USA,MF,23.0,16.0,472.0,628.0,75.2,7648.0,2686.0,246.0,302.0,81.5,154.0,197.0,78.2,47.0,79.0,59.5,1.0,0.7,0.5,0.3,13.0,50.0,15.0,3.0,82.0,Matches,428,us USA,MF,23,19,1437.0,76.0,42.0,16.0,16,85.0,9,3,28.0,0,0.68,20.0,35.0,-15.0,-0.94,-0.26,17.6,28.2,-10.6,-0.66,-0.25,Matches,342.0,us USA,MF,23.0,16.0,807.0,41.0,188.0,401.0,228.0,17.0,807.0,16.0,11.0,68.8,4.0,25.0,400.0,1738.0,791.0,14.0,16.0,0.0,28.0,25.0,445.0,33.0,Matches,342.0,us USA,MF,23.0,16.0,0.0,13.0,2.0,15.4,0.81,0.13,0.0,0.0,15.9,0.0,0.0,0.0,0.8,0.8,0.06,-0.8,-0.8,Matches,342.0,us USA,MF,23.0,19.0,16.0,1437.0,16.0,0.0,1.0,1.0,0.0,0.0,0.0,7.0,0.0,0.8,0.8,0.7,1.4,14.0,82.0,33.0,0.0,0.06,0.06,0.0,0.06,0.05,0.04,0.09,0.05,0.09,Matches,Weston McKennie,M RC,23,146,156,United States,Juventus,7,11,12,15,12,7,15,10,17,10,13,8,15,13,17,15,17,14,10,11,12,17,12,13,17,11,15,15,14,15,16,12,18,14,17,16,12,12,16,11,16,1,1,3,1,1,1,3,2,3,2,3,17,14,13,10,13,10,15,12,1,1,8,8,1,8,14,14,20,15,12,15,14,1,185,84,12,20,17209941,7300,7450,5950,Mixed_Race,145,12,1998/8/28,35,9,61731.0,,72048035
418,Dwight McNeil,Everton,1999,343.0,eng ENG,FWMF,22.0,27.8,64.0,41.0,35.0,14.0,15.0,27.0,65.0,41.5,38.0,46.0,7.0,39.0,31.0,95.0,41.0,0.0,Matches,343.0,eng ENG,FWMF,22.0,27.8,108.0,3.89,53.0,36.0,9.0,6.0,2.0,2.0,12.0,0.43,4.0,3.0,3.0,0.0,1.0,1.0,Matches,,,,,,,,,,,,,,,,,,,,,,,,,,,,,,,,,,,,,,,,,,,,,,,,,,,,,,,,343.0,eng ENG,FWMF,22.0,27.8,5.0,0.0,0.0,22.0,21.0,1.0,194.0,31.0,41.0,1.0,0.0,0.0,175.0,14.0,18.0,43.8,Matches,343.0,eng ENG,FWMF,22.0,27.8,987.0,838.0,142.0,50.0,3.0,6.0,194.0,31.0,61.0,53.0,4.0,0.0,656.0,7.0,49.0,Matches,343.0,eng ENG,FWMF,22.0,27.8,656.0,987.0,66.5,11288.0,3797.0,335.0,391.0,85.7,208.0,278.0,74.8,87.0,212.0,41.0,3.0,6.1,5.4,-3.1,49.0,45.0,27.0,14.0,69.0,Matches,429,eng ENG,FWMF,22,36,2498.0,69.0,73.0,27.8,28,83.0,19,8,22.0,2,0.97,26.0,46.0,-20.0,-0.72,-0.43,35.1,50.0,-14.9,-0.54,0.0,Matches,343.0,eng ENG,FWMF,22.0,27.8,1358.0,52.0,266.0,505.0,614.0,61.0,1357.0,108.0,54.0,50.0,51.0,47.2,738.0,5432.0,2144.0,76.0,44.0,16.0,53.0,45.0,762.0,128.0,Matches,343.0,eng ENG,FWMF,22.0,27.8,7.0,46.0,15.0,32.6,1.66,0.54,0.15,0.47,20.5,1.0,0.0,0.0,3.5,3.5,0.08,3.5,3.5,Matches,343.0,eng ENG,FWMF,22.0,36.0,28.0,2498.0,27.8,7.0,3.0,10.0,7.0,0.0,0.0,5.0,0.0,3.5,3.5,6.1,9.6,76.0,69.0,128.0,0.25,0.11,0.36,0.25,0.36,0.13,0.22,0.35,0.13,0.35,Matches,Dwight McNeil,M/AM RL,22,133,165,England,Everton,13,14,13,12,13,9,7,8,6,10,14,9,12,13,8,13,14,13,12,13,11,16,14,6,13,11,14,13,14,14,10,11,16,14,12,10,13,7,13,5,16,2,2,3,3,4,3,3,1,4,3,1,12,15,2,13,12,14,13,13,1,1,1,1,1,1,1,19,13,16,20,14,17,15,183,68,20,8,85087185,6650,6750,5600,Mixed_Race,125,12,1999/11/22,0,0,86994.0,,28110488
419,Scott McTominay,Manchester Utd,1996,344.0,sct SCO,MF,25.0,12.9,32.0,19.0,16.0,10.0,6.0,13.0,22.0,59.1,9.0,15.0,6.0,9.0,14.0,46.0,45.0,1.0,Matches,344.0,sct SCO,MF,25.0,12.9,23.0,1.78,18.0,0.0,1.0,2.0,2.0,0.0,0.0,0.0,0.0,0.0,0.0,0.0,0.0,0.0,Matches,,,,,,,,,,,,,,,,,,,,,,,,,,,,,,,,,,,,,,,,,,,,,,,,,,,,,,,,344.0,sct SCO,MF,25.0,12.9,8.0,0.0,0.0,28.0,16.0,0.0,4.0,14.0,19.0,0.0,1.0,0.0,78.0,34.0,23.0,59.6,Matches,344.0,sct SCO,MF,25.0,12.9,432.0,426.0,5.0,3.0,3.0,3.0,4.0,1.0,0.0,0.0,0.0,0.0,355.0,1.0,6.0,Matches,344.0,sct SCO,MF,25.0,12.9,355.0,432.0,82.2,5433.0,1549.0,194.0,224.0,86.6,122.0,141.0,86.5,25.0,36.0,69.4,0.0,0.6,1.0,-0.6,8.0,32.0,5.0,1.0,33.0,Matches,430,sct SCO,MF,25,24,1160.0,48.0,33.9,12.9,10,85.0,7,14,22.0,2,2.0,17.0,20.0,-3.0,-0.23,-0.95,19.1,22.5,-3.4,-0.27,-1.09,Matches,344.0,sct SCO,MF,25.0,12.9,618.0,69.0,205.0,287.0,132.0,25.0,618.0,26.0,13.0,50.0,9.0,34.6,315.0,1610.0,782.0,20.0,16.0,3.0,24.0,19.0,359.0,19.0,Matches,344.0,sct SCO,MF,25.0,12.9,1.0,13.0,6.0,46.2,1.01,0.47,0.08,0.17,14.9,0.0,0.0,0.0,1.9,1.9,0.15,-0.9,-0.9,Matches,344.0,sct SCO,MF,25.0,24.0,10.0,1160.0,12.9,1.0,0.0,1.0,1.0,0.0,0.0,8.0,0.0,1.9,1.9,0.6,2.5,20.0,33.0,19.0,0.08,0.0,0.08,0.08,0.08,0.15,0.04,0.19,0.15,0.19,Matches,Scott McTominay,DM/M C,25,139,148,"Scotland,England",Manchester UFC,5,12,12,12,13,4,14,13,10,11,13,7,15,13,17,11,16,11,13,9,11,18,6,14,11,11,18,15,13,14,15,17,17,14,19,15,13,17,14,4,16,3,1,1,3,1,2,1,1,3,3,3,12,15,2,16,15,18,14,16,1,1,15,1,1,1,18,1,20,1,1,10,1,7,193,88,12,20,34710527,7250,7300,6000,Northern_European,136,0,1996/12/8,34,1,92793.0,,29125343
420,Ben Mee,Brentford,1989,345.0,eng ENG,DF,32.0,36.3,45.0,24.0,28.0,13.0,4.0,20.0,37.0,54.1,17.0,54.0,42.0,12.0,48.0,93.0,122.0,2.0,Matches,345.0,eng ENG,DF,32.0,36.3,33.0,0.91,23.0,0.0,1.0,7.0,1.0,1.0,1.0,0.03,1.0,0.0,0.0,0.0,0.0,0.0,Matches,,,,,,,,,,,,,,,,,,,,,,,,,,,,,,,,,,,,,,,,,,,,,,,,,,,,,,,,345.0,eng ENG,DF,32.0,36.3,2.0,0.0,0.0,14.0,15.0,1.0,7.0,48.0,24.0,0.0,0.0,0.0,199.0,131.0,98.0,57.2,Matches,345.0,eng ENG,DF,32.0,36.3,1761.0,1625.0,130.0,38.0,0.0,10.0,7.0,90.0,0.0,0.0,0.0,0.0,1348.0,6.0,20.0,Matches,345.0,eng ENG,DF,32.0,36.3,1348.0,1761.0,76.5,25834.0,10693.0,520.0,609.0,85.4,648.0,784.0,82.7,169.0,316.0,53.5,1.0,1.3,0.8,-0.3,8.0,86.0,7.0,1.0,84.0,Matches,431,eng ENG,DF,32,37,3269.0,88.0,95.6,36.3,37,88.0,34,0,,1,1.59,56.0,40.0,16.0,0.44,2.82,54.5,46.0,8.5,0.23,1.28,Matches,345.0,eng ENG,DF,32.0,36.3,2122.0,272.0,1089.0,887.0,156.0,71.0,2122.0,13.0,12.0,92.3,1.0,7.7,1146.0,4790.0,2581.0,8.0,11.0,3.0,18.0,2.0,1179.0,14.0,Matches,345.0,eng ENG,DF,32.0,36.3,3.0,28.0,7.0,25.0,0.77,0.19,0.11,0.43,10.3,0.0,0.0,0.0,3.2,3.2,0.12,-0.2,-0.2,Matches,345.0,eng ENG,DF,32.0,37.0,37.0,3269.0,36.3,3.0,1.0,4.0,3.0,0.0,0.0,2.0,0.0,3.2,3.2,1.3,4.5,8.0,84.0,14.0,0.08,0.03,0.11,0.08,0.11,0.09,0.04,0.12,0.09,0.12,Matches,Ben Mee,D LC,32,136,143,England,Brentford,6,8,8,6,10,4,16,4,15,15,10,5,16,9,17,14,16,11,14,8,13,14,7,15,8,14,18,14,13,12,10,14,12,12,15,15,15,9,11,8,10,4,1,2,2,2,1,3,2,1,3,2,12,12,3,15,11,16,16,15,1,18,20,1,1,1,1,1,1,1,1,1,1,1,183,74,20,7,347975206,6800,6800,5500,Northern_European,136,5,1989/9/21,0,0,57996.0,,4002177
421,Chris Mepham,Bournemouth,1997,348.0,wls WAL,DF,24.0,24.4,45.0,22.0,37.0,8.0,0.0,19.0,30.0,63.3,11.0,40.0,27.0,13.0,30.0,75.0,152.0,0.0,Matches,348.0,wls WAL,DF,24.0,24.4,8.0,0.33,6.0,0.0,0.0,2.0,0.0,0.0,0.0,0.0,0.0,0.0,0.0,0.0,0.0,0.0,Matches,,,,,,,,,,,,,,,,,,,,,,,,,,,,,,,,,,,,,,,,,,,,,,,,,,,,,,,,348.0,wls WAL,DF,24.0,24.4,7.0,0.0,0.0,16.0,7.0,0.0,0.0,30.0,22.0,0.0,0.0,2.0,85.0,53.0,31.0,63.1,Matches,348.0,wls WAL,DF,24.0,24.4,1041.0,1001.0,37.0,21.0,0.0,4.0,0.0,16.0,0.0,0.0,0.0,0.0,870.0,3.0,7.0,Matches,348.0,wls WAL,DF,24.0,24.4,870.0,1041.0,83.6,16273.0,5694.0,309.0,346.0,89.3,478.0,525.0,91.0,75.0,142.0,52.8,0.0,0.2,0.6,-0.2,4.0,42.0,2.0,0.0,42.0,Matches,435,wls WAL,DF,24,26,2199.0,85.0,64.3,24.4,24,90.0,23,2,24.0,7,1.0,23.0,52.0,-29.0,-1.19,-0.82,20.3,41.4,-21.1,-0.86,-0.55,Matches,348.0,wls WAL,DF,24.0,24.4,1336.0,285.0,852.0,455.0,36.0,14.0,1336.0,7.0,3.0,42.9,3.0,42.9,650.0,3099.0,1628.0,2.0,6.0,2.0,4.0,3.0,788.0,1.0,Matches,348.0,wls WAL,DF,24.0,24.4,0.0,8.0,4.0,50.0,0.33,0.16,0.0,0.0,9.8,0.0,0.0,0.0,0.7,0.7,0.09,-0.7,-0.7,Matches,348.0,wls WAL,DF,24.0,26.0,24.0,2199.0,24.4,0.0,0.0,0.0,0.0,0.0,0.0,7.0,0.0,0.7,0.7,0.2,0.9,2.0,42.0,1.0,0.0,0.0,0.0,0.0,0.0,0.03,0.01,0.04,0.03,0.04,Matches,Chris Mepham,D C,24,126,145,"Wales,England",AFC Bournemouth,4,5,11,7,12,5,14,4,4,14,13,4,14,13,12,14,14,13,14,11,12,16,6,12,6,14,14,14,12,8,15,15,14,12,13,15,13,5,14,3,6,3,2,1,4,3,3,2,2,1,3,1,12,14,4,14,14,15,15,16,1,1,20,1,1,1,1,1,1,1,1,1,1,1,191,75,10,20,11437316,6600,6250,5500,Northern_European,126,2,1997/11/5,32,0,28998.0,,29134274
422,Illan Meslier,Leeds United,2000,349.0,fr FRA,GK,22.0,34.0,2.0,1.0,2.0,0.0,0.0,2.0,4.0,50.0,2.0,0.0,0.0,0.0,1.0,3.0,30.0,3.0,Matches,349.0,fr FRA,GK,22.0,34.0,4.0,0.12,2.0,2.0,0.0,0.0,0.0,0.0,0.0,0.0,0.0,0.0,0.0,0.0,0.0,0.0,Matches,23.0,fr FRA,GK,22.0,34.0,67.0,3.0,1.0,7.0,1.0,53.6,0.32,-12.4,-0.36,106.0,449.0,23.6,794.0,194.0,39.4,33.7,242.0,56.2,43.5,432.0,34.0,7.9,66.0,1.94,15.8,Matches,23.0,fr FRA,GK,22.0,34.0,34.0,3060.0,34.0,67.0,1.97,158.0,92.0,59.5,7.0,9.0,18.0,5.0,14.7,3.0,3.0,0.0,0.0,0.0,Matches,349.0,fr FRA,GK,22.0,34.0,3.0,0.0,0.0,1.0,5.0,0.0,0.0,1.0,1.0,0.0,0.0,0.0,34.0,10.0,3.0,76.9,Matches,349.0,fr FRA,GK,22.0,34.0,1039.0,705.0,331.0,89.0,0.0,1.0,0.0,0.0,0.0,0.0,0.0,0.0,664.0,3.0,2.0,Matches,349.0,fr FRA,GK,22.0,34.0,664.0,1039.0,63.9,16770.0,10937.0,144.0,148.0,97.3,354.0,359.0,98.6,162.0,523.0,31.0,0.0,0.0,0.0,0.0,0.0,13.0,1.0,0.0,0.0,Matches,436,fr FRA,GK,22,34,3060.0,90.0,89.5,34.0,34,90.0,34,0,,4,0.88,43.0,67.0,-24.0,-0.71,0.79,42.7,57.9,-15.2,-0.45,0.7,Matches,349.0,fr FRA,GK,22.0,34.0,1122.0,903.0,1116.0,5.0,2.0,1.0,1122.0,0.0,0.0,,0.0,,596.0,3396.0,1969.0,0.0,0.0,0.0,1.0,1.0,424.0,0.0,Matches,349.0,fr FRA,GK,22.0,34.0,0.0,1.0,1.0,100.0,0.03,0.03,0.0,0.0,9.0,0.0,0.0,0.0,0.1,0.1,0.12,-0.1,-0.1,Matches,349.0,fr FRA,GK,22.0,34.0,34.0,3060.0,34.0,0.0,0.0,0.0,0.0,0.0,0.0,3.0,0.0,0.1,0.1,0.0,0.1,0.0,0.0,0.0,0.0,0.0,0.0,0.0,0.0,0.0,0.0,0.0,0.0,0.0,Matches,Illan Meslier,GK,22,138,161,France,Leeds United,3,3,3,2,11,5,9,1,2,2,11,1,1,12,12,16,14,13,14,10,12,12,4,8,4,13,12,12,9,16,12,17,15,9,13,8,14,5,12,6,6,17,13,12,10,13,12,16,16,13,9,13,15,13,6,13,14,13,10,15,20,1,1,1,1,1,1,1,1,1,1,1,1,1,196,74,20,7,43798479,6900,6900,5700,Northern_European,136,4,2000/3/2,0,0,46397.0,,49040115
423,James Milner,Liverpool,1986,353.0,eng ENG,MFDF,36.0,10.1,26.0,16.0,11.0,11.0,4.0,15.0,34.0,44.1,19.0,14.0,2.0,12.0,12.0,38.0,15.0,0.0,Matches,353.0,eng ENG,MFDF,36.0,10.1,36.0,3.56,27.0,4.0,3.0,2.0,0.0,0.0,3.0,0.3,2.0,1.0,0.0,0.0,0.0,0.0,Matches,,,,,,,,,,,,,,,,,,,,,,,,,,,,,,,,,,,,,,,,,,,,,,,,,,,,,,,,353.0,eng ENG,MFDF,36.0,10.1,2.0,0.0,0.0,16.0,15.0,0.0,52.0,12.0,16.0,0.0,0.0,0.0,64.0,13.0,14.0,48.1,Matches,353.0,eng ENG,MFDF,36.0,10.1,727.0,625.0,99.0,20.0,2.0,4.0,52.0,65.0,12.0,2.0,9.0,0.0,563.0,3.0,24.0,Matches,353.0,eng ENG,MFDF,36.0,10.1,563.0,727.0,77.4,9891.0,3403.0,261.0,291.0,89.7,238.0,279.0,85.3,52.0,112.0,46.4,1.0,0.9,1.6,0.1,13.0,61.0,15.0,5.0,70.0,Matches,441,eng ENG,MFDF,36,31,913.0,29.0,26.7,10.1,7,77.0,3,24,16.0,3,1.84,17.0,12.0,5.0,0.49,-0.33,21.4,13.6,7.9,0.78,0.28,Matches,353.0,eng ENG,MFDF,36.0,10.1,848.0,24.0,196.0,390.0,264.0,24.0,848.0,21.0,11.0,52.4,8.0,38.1,447.0,1868.0,886.0,21.0,17.0,5.0,19.0,14.0,551.0,78.0,Matches,353.0,eng ENG,MFDF,36.0,10.1,0.0,7.0,1.0,14.3,0.69,0.1,0.0,0.0,17.9,0.0,0.0,0.0,0.4,0.4,0.06,-0.4,-0.4,Matches,353.0,eng ENG,MFDF,36.0,31.0,7.0,913.0,10.1,0.0,1.0,1.0,0.0,0.0,0.0,2.0,0.0,0.4,0.4,0.9,1.3,21.0,70.0,78.0,0.0,0.1,0.1,0.0,0.1,0.04,0.09,0.13,0.04,0.13,Matches,James Milner,WB/DM/M RLC,36,143,157,England,Liverpool,13,12,10,11,15,9,9,7,13,13,14,16,13,14,15,13,17,14,14,12,13,19,9,17,12,13,18,18,11,10,13,8,19,10,17,15,14,11,15,12,18,3,3,2,3,2,2,2,2,1,4,3,18,17,7,16,17,20,15,18,1,15,1,15,16,16,18,14,20,14,8,6,8,6,176,70,8,20,2471213,7149,7149,6249,Northern_European,133,4,1986/1/4,61,1,139190.0,,5106363
424,Tyrone Mings,Aston Villa,1993,355.0,eng ENG,DF,29.0,35.0,15.0,7.0,10.0,5.0,0.0,9.0,20.0,45.0,11.0,40.0,21.0,19.0,54.0,69.0,163.0,2.0,Matches,355.0,eng ENG,DF,29.0,35.0,23.0,0.66,17.0,0.0,0.0,2.0,4.0,0.0,4.0,0.11,2.0,0.0,0.0,1.0,1.0,0.0,Matches,,,,,,,,,,,,,,,,,,,,,,,,,,,,,,,,,,,,,,,,,,,,,,,,,,,,,,,,355.0,eng ENG,DF,29.0,35.0,7.0,0.0,0.0,18.0,22.0,3.0,3.0,54.0,7.0,1.0,0.0,1.0,174.0,61.0,24.0,71.8,Matches,355.0,eng ENG,DF,29.0,35.0,1899.0,1811.0,85.0,64.0,1.0,15.0,3.0,6.0,0.0,0.0,0.0,0.0,1617.0,3.0,10.0,Matches,355.0,eng ENG,DF,29.0,35.0,1617.0,1899.0,85.2,30932.0,11677.0,532.0,586.0,90.8,913.0,984.0,92.8,153.0,286.0,53.5,2.0,1.4,0.9,0.6,5.0,106.0,6.0,0.0,111.0,Matches,443,eng ENG,DF,29,35,3150.0,90.0,92.1,35.0,35,90.0,35,0,,1,1.74,50.0,40.0,10.0,0.29,1.95,48.8,48.0,0.9,0.02,1.05,Matches,355.0,eng ENG,DF,29.0,35.0,2228.0,384.0,1276.0,877.0,81.0,21.0,2228.0,12.0,6.0,50.0,3.0,25.0,1379.0,7995.0,4556.0,20.0,21.0,3.0,8.0,7.0,1486.0,7.0,Matches,355.0,eng ENG,DF,29.0,35.0,1.0,7.0,2.0,28.6,0.2,0.06,0.14,0.5,12.1,0.0,0.0,0.0,1.2,1.2,0.17,-0.2,-0.2,Matches,355.0,eng ENG,DF,29.0,35.0,35.0,3150.0,35.0,1.0,2.0,3.0,1.0,0.0,0.0,7.0,0.0,1.2,1.2,1.4,2.6,20.0,111.0,7.0,0.03,0.06,0.09,0.03,0.09,0.03,0.04,0.07,0.03,0.07,Matches,Tyrone Mings,D LC,29,140,142,"England,Barbados",Aston Villa,9,10,13,6,11,5,16,9,12,12,14,2,15,13,15,13,16,14,12,12,12,16,12,17,13,13,15,14,14,14,13,15,14,14,14,15,12,14,13,10,10,1,2,3,3,2,2,3,2,4,4,2,11,15,6,13,14,16,12,14,1,15,20,1,1,1,1,1,1,1,1,1,1,1,196,78,20,7,34449545,7000,7500,5750,Mixed_Race,139,13,1993/3/13,17,2,81194.0,,29074544
425,Tyrick Mitchell,Crystal Palace,1999,356.0,eng ENG,DF,22.0,32.1,71.0,49.0,43.0,23.0,5.0,30.0,53.0,56.6,23.0,48.0,11.0,37.0,42.0,113.0,78.0,0.0,Matches,356.0,eng ENG,DF,22.0,32.1,33.0,1.03,28.0,1.0,2.0,0.0,0.0,2.0,3.0,0.09,3.0,0.0,0.0,0.0,0.0,0.0,Matches,,,,,,,,,,,,,,,,,,,,,,,,,,,,,,,,,,,,,,,,,,,,,,,,,,,,,,,,356.0,eng ENG,DF,22.0,32.1,5.0,1.0,0.0,33.0,10.0,2.0,70.0,42.0,49.0,0.0,1.0,0.0,186.0,25.0,26.0,49.0,Matches,356.0,eng ENG,DF,22.0,32.1,1607.0,1234.0,370.0,34.0,0.0,2.0,70.0,336.0,0.0,0.0,0.0,0.0,1152.0,3.0,66.0,Matches,356.0,eng ENG,DF,22.0,32.1,1152.0,1607.0,71.7,18235.0,8262.0,600.0,710.0,84.5,483.0,635.0,76.1,53.0,169.0,31.4,2.0,1.2,1.2,0.8,15.0,90.0,21.0,9.0,106.0,Matches,444,eng ENG,DF,22,36,2891.0,80.0,84.5,32.1,34,84.0,27,2,19.0,0,1.17,36.0,38.0,-2.0,-0.06,1.13,33.5,38.4,-4.8,-0.15,0.52,Matches,356.0,eng ENG,DF,22.0,32.1,1899.0,115.0,654.0,834.0,431.0,35.0,1899.0,30.0,17.0,56.7,9.0,30.0,827.0,3148.0,1433.0,23.0,19.0,4.0,35.0,17.0,957.0,90.0,Matches,356.0,eng ENG,DF,22.0,32.1,0.0,6.0,1.0,16.7,0.19,0.03,0.0,0.0,11.6,0.0,0.0,0.0,0.6,0.6,0.1,-0.6,-0.6,Matches,356.0,eng ENG,DF,22.0,36.0,34.0,2891.0,32.1,0.0,2.0,2.0,0.0,0.0,0.0,5.0,1.0,0.6,0.6,1.2,1.8,23.0,106.0,90.0,0.0,0.06,0.06,0.0,0.06,0.02,0.04,0.05,0.02,0.05,Matches,Tyrick Mitchell,D/WB L,22,141,155,"England,Jamaica",Crystal Palace,9,13,13,6,12,8,11,8,10,12,14,7,17,12,15,13,13,14,13,13,13,13,10,8,13,14,15,15,15,15,13,9,16,16,14,12,14,5,13,5,10,2,3,2,3,1,1,2,3,1,1,2,7,14,1,10,15,14,14,3,1,20,1,1,16,1,1,1,1,1,1,1,1,1,175,66,20,9,40235213,7050,7050,6000,African_Caribbean,140,17,1999/9/1,2,0,46397.0,,28111507
426,Kaoru Mitoma,Brighton,1997,357.0,jp JPN,FWMF,25.0,25.8,44.0,27.0,15.0,16.0,13.0,20.0,41.0,48.8,21.0,25.0,0.0,25.0,17.0,61.0,10.0,0.0,Matches,357.0,jp JPN,FWMF,25.0,25.8,109.0,4.23,78.0,1.0,19.0,5.0,4.0,2.0,16.0,0.62,10.0,0.0,3.0,2.0,1.0,0.0,Matches,,,,,,,,,,,,,,,,,,,,,,,,,,,,,,,,,,,,,,,,,,,,,,,,,,,,,,,,357.0,jp JPN,FWMF,25.0,25.8,0.0,0.0,0.0,29.0,27.0,6.0,41.0,17.0,27.0,1.0,0.0,0.0,120.0,18.0,19.0,48.6,Matches,357.0,jp JPN,FWMF,25.0,25.8,977.0,952.0,19.0,0.0,4.0,3.0,41.0,16.0,3.0,0.0,0.0,0.0,780.0,6.0,33.0,Matches,357.0,jp JPN,FWMF,25.0,25.8,780.0,977.0,79.8,10673.0,2356.0,507.0,570.0,88.9,214.0,268.0,79.9,30.0,53.0,56.6,5.0,6.4,4.9,-1.4,41.0,45.0,28.0,1.0,90.0,Matches,445,jp JPN,FWMF,25,33,2318.0,70.0,67.8,25.8,24,88.0,16,9,24.0,2,1.67,49.0,35.0,14.0,0.54,0.14,53.7,34.8,19.0,0.74,0.4,Matches,357.0,jp JPN,FWMF,25.0,25.8,1312.0,18.0,146.0,466.0,716.0,177.0,1312.0,130.0,59.0,45.4,55.0,42.3,891.0,6882.0,3828.0,143.0,82.0,85.0,60.0,33.0,986.0,260.0,Matches,357.0,jp JPN,FWMF,25.0,25.8,7.0,52.0,21.0,40.4,2.02,0.82,0.13,0.33,13.2,0.0,0.0,0.0,8.1,8.1,0.16,-1.1,-1.1,Matches,357.0,jp JPN,FWMF,25.0,33.0,24.0,2318.0,25.8,7.0,5.0,12.0,7.0,0.0,0.0,0.0,0.0,8.1,8.1,6.4,14.5,143.0,90.0,260.0,0.27,0.19,0.47,0.27,0.47,0.31,0.25,0.56,0.31,0.56,Matches,Kaoru Mitoma,M/AM L,25,126,135,Japan,Brighton & Hove Albion,10,10,14,11,14,9,8,9,7,8,11,8,8,14,14,9,13,12,11,12,11,8,15,6,14,7,12,12,17,14,12,9,14,15,12,7,11,1,13,6,16,3,3,2,1,1,1,4,1,1,3,2,13,11,7,12,11,12,10,10,1,1,1,1,14,1,1,17,1,1,20,1,13,1,178,72,8,20,5639097,6294,6594,4494,10,121,8,1997/5/20,7,4,23198.0,,45111891
427,Aleksandar Mitrović,Fulham,1994,358.0,rs SRB,FW,27.0,22.3,14.0,7.0,8.0,4.0,2.0,5.0,12.0,41.7,7.0,22.0,5.0,17.0,3.0,17.0,20.0,1.0,Matches,358.0,rs SRB,FW,27.0,22.3,55.0,2.47,26.0,0.0,9.0,13.0,6.0,1.0,10.0,0.45,3.0,0.0,1.0,4.0,2.0,0.0,Matches,,,,,,,,,,,,,,,,,,,,,,,,,,,,,,,,,,,,,,,,,,,,,,,,,,,,,,,,358.0,rs SRB,FW,27.0,22.3,7.0,0.0,0.0,34.0,40.0,14.0,4.0,3.0,7.0,2.0,0.0,0.0,55.0,100.0,105.0,48.8,Matches,358.0,rs SRB,FW,27.0,22.3,496.0,486.0,10.0,1.0,4.0,9.0,4.0,3.0,0.0,0.0,0.0,0.0,299.0,0.0,24.0,Matches,358.0,rs SRB,FW,27.0,22.3,299.0,496.0,60.3,4671.0,970.0,172.0,257.0,66.9,85.0,132.0,64.4,31.0,52.0,59.6,1.0,2.3,1.3,-1.3,16.0,26.0,10.0,1.0,44.0,Matches,446,rs SRB,FW,27,24,2008.0,84.0,58.7,22.3,23,86.0,14,1,26.0,0,1.5,33.0,30.0,3.0,0.13,0.2,31.2,34.8,-3.6,-0.16,0.72,Matches,358.0,rs SRB,FW,27.0,22.3,814.0,27.0,79.0,392.0,349.0,144.0,806.0,47.0,23.0,48.9,22.0,46.8,451.0,1873.0,715.0,24.0,15.0,10.0,65.0,58.0,646.0,97.0,Matches,358.0,rs SRB,FW,27.0,22.3,14.0,85.0,27.0,31.8,3.81,1.21,0.12,0.37,15.1,0.0,4.0,8.0,14.9,8.6,0.1,-0.9,1.4,Matches,358.0,rs SRB,FW,27.0,24.0,23.0,2008.0,22.3,14.0,1.0,15.0,10.0,4.0,8.0,7.0,0.0,14.9,8.6,2.3,10.9,24.0,44.0,97.0,0.63,0.04,0.67,0.45,0.49,0.67,0.1,0.77,0.39,0.49,Matches,Aleksandar Mitrović,S,27,146,155,Serbia,Fulham,3,5,12,17,14,6,17,7,3,9,13,15,10,14,15,14,16,14,13,11,14,14,12,14,14,6,15,16,12,10,16,17,13,12,15,19,14,16,14,6,8,3,2,1,4,2,2,1,2,1,1,3,13,14,14,15,13,14,7,5,1,1,1,1,1,1,1,1,1,1,1,1,1,20,189,82,9,20,38181577,6950,7250,6000,Mediterranean_Hispanic,143,6,1994/9/16,74,46,75395.0,,62096282
428,Kieffer Moore,Bournemouth,1992,359.0,wls WAL,FW,29.0,14.2,14.0,11.0,2.0,9.0,3.0,5.0,16.0,31.3,11.0,12.0,5.0,7.0,1.0,15.0,26.0,0.0,Matches,359.0,wls WAL,FW,29.0,14.2,18.0,1.26,14.0,0.0,1.0,0.0,3.0,0.0,2.0,0.14,2.0,0.0,0.0,0.0,0.0,0.0,Matches,,,,,,,,,,,,,,,,,,,,,,,,,,,,,,,,,,,,,,,,,,,,,,,,,,,,,,,,359.0,wls WAL,FW,29.0,14.2,1.0,0.0,0.0,26.0,30.0,1.0,7.0,1.0,11.0,0.0,0.0,0.0,26.0,68.0,60.0,53.1,Matches,359.0,wls WAL,FW,29.0,14.2,360.0,337.0,23.0,1.0,0.0,1.0,7.0,0.0,0.0,0.0,0.0,0.0,212.0,0.0,12.0,Matches,359.0,wls WAL,FW,29.0,14.2,212.0,360.0,58.9,2944.0,495.0,119.0,193.0,61.7,62.0,95.0,65.3,11.0,20.0,55.0,0.0,0.3,0.5,-0.3,5.0,16.0,6.0,0.0,23.0,Matches,448,wls WAL,FW,29,27,1279.0,47.0,37.4,14.2,12,86.0,8,15,17.0,8,0.85,11.0,34.0,-23.0,-1.62,-1.16,11.0,25.6,-14.6,-1.02,-0.57,Matches,359.0,wls WAL,FW,29.0,14.2,522.0,36.0,59.0,286.0,178.0,49.0,522.0,13.0,2.0,15.4,7.0,53.8,252.0,940.0,302.0,10.0,8.0,2.0,42.0,31.0,396.0,56.0,Matches,359.0,wls WAL,FW,29.0,14.2,4.0,23.0,8.0,34.8,1.62,0.56,0.17,0.5,11.2,0.0,0.0,0.0,4.4,4.4,0.19,-0.4,-0.4,Matches,359.0,wls WAL,FW,29.0,27.0,12.0,1279.0,14.2,4.0,0.0,4.0,4.0,0.0,0.0,1.0,0.0,4.4,4.4,0.3,4.7,10.0,23.0,56.0,0.28,0.0,0.28,0.28,0.28,0.31,0.02,0.33,0.31,0.33,Matches,Kieffer Moore,S,29,125,132,"Wales,England",AFC Bournemouth,7,10,11,13,13,8,15,12,9,10,11,14,8,12,14,13,14,13,12,11,12,16,11,11,14,11,14,14,11,8,14,17,16,12,13,15,13,13,14,8,13,2,3,2,3,2,2,3,3,1,2,2,14,15,4,12,15,13,13,13,1,1,1,1,1,1,1,1,1,1,1,1,1,20,196,83,10,20,8634724,6247,6955,5147,Northern_European,125,2,1992/8/8,26,8,28998.0,,89038587
429,Álex Moreno,Aston Villa,1993,361.0,es ESP,DF,29.0,14.8,23.0,14.0,15.0,5.0,3.0,13.0,36.0,36.1,23.0,18.0,3.0,15.0,7.0,30.0,37.0,2.0,Matches,361.0,es ESP,DF,29.0,14.8,34.0,2.3,31.0,0.0,2.0,1.0,0.0,0.0,3.0,0.2,3.0,0.0,0.0,0.0,0.0,0.0,Matches,,,,,,,,,,,,,,,,,,,,,,,,,,,,,,,,,,,,,,,,,,,,,,,,,,,,,,,,361.0,es ESP,DF,29.0,14.8,3.0,0.0,0.0,17.0,11.0,0.0,48.0,7.0,14.0,0.0,0.0,0.0,69.0,9.0,12.0,42.9,Matches,361.0,es ESP,DF,29.0,14.8,745.0,609.0,134.0,18.0,1.0,0.0,48.0,116.0,0.0,0.0,0.0,0.0,581.0,2.0,32.0,Matches,361.0,es ESP,DF,29.0,14.8,581.0,745.0,78.0,8524.0,2588.0,320.0,374.0,85.6,216.0,266.0,81.2,24.0,42.0,57.1,3.0,3.0,2.6,0.0,22.0,15.0,30.0,14.0,37.0,Matches,450,es ESP,DF,29,19,1329.0,70.0,38.9,14.8,14,81.0,5,5,40.0,0,1.89,23.0,10.0,13.0,0.88,1.22,19.7,18.6,1.1,0.07,0.21,Matches,361.0,es ESP,DF,29.0,14.8,949.0,60.0,327.0,337.0,293.0,43.0,949.0,57.0,23.0,40.4,27.0,47.4,510.0,3260.0,1642.0,65.0,29.0,16.0,38.0,15.0,570.0,122.0,Matches,361.0,es ESP,DF,29.0,14.8,0.0,13.0,3.0,23.1,0.88,0.2,0.0,0.0,18.4,0.0,0.0,0.0,0.6,0.6,0.05,-0.6,-0.6,Matches,361.0,es ESP,DF,29.0,19.0,14.0,1329.0,14.8,0.0,3.0,3.0,0.0,0.0,0.0,3.0,0.0,0.6,0.6,3.0,3.7,65.0,37.0,122.0,0.0,0.2,0.2,0.0,0.2,0.04,0.21,0.25,0.04,0.25,Matches,Álex Moreno,D/WB/M/AM L,29,141,145,Spain,Real Hispalis,10,13,15,10,13,8,7,10,12,12,12,10,14,14,9,12,13,11,10,11,10,12,14,9,14,13,13,15,15,15,12,9,14,16,14,12,13,9,12,9,12,1,2,1,3,4,3,1,3,1,2,3,12,13,10,11,10,13,10,13,1,20,1,1,20,1,1,18,1,1,17,1,1,1,176,68,20,8,7042625,6650,6650,4650,Mediterranean_Hispanic,127,1,1993/6/8,0,0,14057.0,,67153373
430,Mason Mount,Chelsea,1999,362.0,eng ENG,MFFW,23.0,18.3,33.0,19.0,6.0,16.0,11.0,14.0,27.0,51.9,13.0,24.0,6.0,18.0,8.0,41.0,9.0,0.0,Matches,362.0,eng ENG,MFFW,23.0,18.3,57.0,3.11,42.0,9.0,2.0,2.0,2.0,0.0,7.0,0.38,5.0,0.0,0.0,1.0,1.0,0.0,Matches,,,,,,,,,,,,,,,,,,,,,,,,,,,,,,,,,,,,,,,,,,,,,,,,,,,,,,,,362.0,eng ENG,MFFW,23.0,18.3,4.0,0.0,0.0,28.0,27.0,1.0,64.0,8.0,19.0,0.0,0.0,0.0,85.0,9.0,14.0,39.1,Matches,362.0,eng ENG,MFFW,23.0,18.3,778.0,706.0,68.0,17.0,6.0,8.0,64.0,5.0,34.0,11.0,19.0,1.0,585.0,4.0,23.0,Matches,362.0,eng ENG,MFFW,23.0,18.3,585.0,778.0,75.2,8688.0,2236.0,350.0,409.0,85.6,165.0,216.0,76.4,44.0,84.0,52.4,2.0,3.0,2.8,-1.0,30.0,55.0,27.0,5.0,98.0,Matches,453,eng ENG,MFFW,23,24,1648.0,69.0,48.2,18.3,20,77.0,7,4,25.0,2,1.29,18.0,21.0,-3.0,-0.16,0.14,22.3,23.4,-1.1,-0.06,0.04,Matches,362.0,eng ENG,MFFW,23.0,18.3,969.0,17.0,110.0,415.0,455.0,56.0,969.0,31.0,15.0,48.4,13.0,41.9,530.0,2745.0,1429.0,48.0,34.0,11.0,36.0,29.0,678.0,114.0,Matches,362.0,eng ENG,MFFW,23.0,18.3,3.0,33.0,9.0,27.3,1.8,0.49,0.09,0.33,19.7,2.0,0.0,0.0,2.0,2.0,0.06,1.0,1.0,Matches,362.0,eng ENG,MFFW,23.0,24.0,20.0,1648.0,18.3,3.0,2.0,5.0,3.0,0.0,0.0,4.0,0.0,2.0,2.0,3.0,5.0,48.0,98.0,114.0,0.16,0.11,0.27,0.16,0.27,0.11,0.16,0.27,0.11,0.27,Matches,Mason Mount,AM RLC,23,165,170,England,Chelsea,14,12,11,14,15,14,9,12,5,7,15,15,11,15,14,14,15,15,12,12,16,18,13,12,17,14,18,20,15,13,10,9,15,15,20,11,12,6,14,8,12,1,3,2,2,1,3,4,3,2,3,3,16,18,6,13,14,16,16,17,1,1,1,1,1,1,14,1,15,1,16,20,15,1,178,70,12,20,126331239,8244,8244,6894,Northern_European,162,3,1999/1/10,31,4,89314.0,,28103590
431,João Moutinho,Wolves,1986,364.0,pt POR,MF,35.0,19.8,51.0,30.0,24.0,21.0,6.0,19.0,46.0,41.3,27.0,22.0,6.0,16.0,18.0,69.0,20.0,0.0,Matches,364.0,pt POR,MF,35.0,19.8,66.0,3.34,49.0,14.0,0.0,2.0,1.0,0.0,3.0,0.15,3.0,0.0,0.0,0.0,0.0,0.0,Matches,,,,,,,,,,,,,,,,,,,,,,,,,,,,,,,,,,,,,,,,,,,,,,,,,,,,,,,,364.0,pt POR,MF,35.0,19.8,3.0,0.0,0.0,31.0,15.0,1.0,59.0,18.0,30.0,0.0,0.0,0.0,106.0,8.0,23.0,25.8,Matches,364.0,pt POR,MF,35.0,19.8,1057.0,936.0,116.0,55.0,7.0,6.0,59.0,3.0,34.0,10.0,15.0,0.0,850.0,5.0,20.0,Matches,364.0,pt POR,MF,35.0,19.8,850.0,1057.0,80.4,15648.0,4124.0,323.0,362.0,89.2,412.0,480.0,85.8,91.0,147.0,61.9,2.0,2.6,1.9,-0.6,36.0,105.0,23.0,4.0,132.0,Matches,455,pt POR,MF,35,31,1780.0,57.0,52.0,19.8,20,74.0,6,11,27.0,2,1.16,12.0,28.0,-16.0,-0.81,-0.21,20.2,27.3,-7.0,-0.36,0.52,Matches,364.0,pt POR,MF,35.0,19.8,1218.0,42.0,243.0,658.0,325.0,15.0,1218.0,15.0,8.0,53.3,7.0,46.7,615.0,2554.0,1350.0,23.0,23.0,0.0,14.0,7.0,769.0,32.0,Matches,364.0,pt POR,MF,35.0,19.8,0.0,16.0,3.0,18.8,0.81,0.15,0.0,0.0,18.4,3.0,0.0,0.0,1.3,1.3,0.08,-1.3,-1.3,Matches,364.0,pt POR,MF,35.0,31.0,20.0,1780.0,19.8,0.0,2.0,2.0,0.0,0.0,0.0,3.0,0.0,1.3,1.3,2.6,3.9,23.0,132.0,32.0,0.0,0.1,0.1,0.0,0.1,0.07,0.13,0.2,0.07,0.2,Matches,João Moutinho,DM/M C,35,149,154,Portugal,Wolverhampton Wanderers,13,14,15,10,16,14,7,13,4,11,17,14,13,17,14,16,14,14,15,17,15,16,15,14,12,14,17,16,10,13,13,8,15,10,14,10,16,13,16,8,14,3,3,2,3,2,1,1,2,2,1,3,13,17,7,15,16,17,14,16,1,1,1,1,1,1,20,9,20,9,1,15,1,1,170,61,10,20,4464618,7450,7250,6500,Mediterranean_Hispanic,147,6,1986/9/8,146,7,115992.0,,744539
432,Jacob Murphy,Newcastle Utd,1995,367.0,eng ENG,FW,27.0,13.9,15.0,7.0,3.0,8.0,4.0,8.0,20.0,40.0,12.0,17.0,0.0,17.0,7.0,22.0,3.0,0.0,Matches,367.0,eng ENG,FW,27.0,13.9,49.0,3.52,37.0,0.0,4.0,2.0,5.0,1.0,6.0,0.43,5.0,0.0,0.0,0.0,0.0,1.0,Matches,,,,,,,,,,,,,,,,,,,,,,,,,,,,,,,,,,,,,,,,,,,,,,,,,,,,,,,,367.0,eng ENG,FW,27.0,13.9,0.0,0.0,0.0,8.0,14.0,2.0,53.0,7.0,7.0,0.0,0.0,0.0,69.0,3.0,11.0,21.4,Matches,367.0,eng ENG,FW,27.0,13.9,448.0,428.0,18.0,0.0,6.0,2.0,53.0,10.0,7.0,1.0,0.0,0.0,296.0,2.0,31.0,Matches,367.0,eng ENG,FW,27.0,13.9,296.0,448.0,66.1,4516.0,1252.0,177.0,219.0,80.8,89.0,131.0,67.9,18.0,40.0,45.0,2.0,2.8,3.1,-0.8,19.0,20.0,26.0,4.0,57.0,Matches,460,eng ENG,FW,27,36,1251.0,35.0,36.6,13.9,14,67.0,1,22,14.0,1,1.86,29.0,12.0,17.0,1.22,0.48,28.4,16.1,12.2,0.88,0.04,Matches,367.0,eng ENG,FW,27.0,13.9,590.0,11.0,58.0,214.0,329.0,75.0,590.0,44.0,15.0,34.1,21.0,47.7,365.0,2498.0,1516.0,67.0,32.0,30.0,17.0,23.0,421.0,141.0,Matches,367.0,eng ENG,FW,27.0,13.9,4.0,29.0,10.0,34.5,2.09,0.72,0.14,0.4,18.6,0.0,0.0,0.0,3.3,3.3,0.11,0.7,0.7,Matches,367.0,eng ENG,FW,27.0,36.0,14.0,1251.0,13.9,4.0,2.0,6.0,4.0,0.0,0.0,0.0,0.0,3.3,3.3,2.8,6.1,67.0,57.0,141.0,0.29,0.14,0.43,0.29,0.43,0.24,0.2,0.44,0.24,0.44,Matches,Jacob Murphy,WB/AM RL,27,126,132,England,Newcastle United,5,13,14,11,13,13,4,11,5,7,11,5,11,13,9,13,11,11,11,12,6,12,13,6,12,13,11,15,15,14,13,7,13,15,11,10,11,3,7,5,10,4,3,2,2,3,1,3,3,1,1,2,8,11,1,12,11,12,11,15,1,1,1,14,1,20,1,10,1,15,16,1,19,1,179,74,11,20,4832549,6300,6300,4850,African_Caribbean,111,15,1995/2/24,0,0,40597.0,,29079830
433,Vitaliy Mykolenko,Everton,1999,369.0,ua UKR,DF,23.0,29.5,58.0,34.0,36.0,19.0,3.0,28.0,51.0,54.9,23.0,50.0,16.0,34.0,46.0,104.0,99.0,0.0,Matches,369.0,ua UKR,DF,23.0,29.5,45.0,1.52,40.0,1.0,0.0,2.0,2.0,0.0,3.0,0.1,2.0,0.0,0.0,1.0,0.0,0.0,Matches,,,,,,,,,,,,,,,,,,,,,,,,,,,,,,,,,,,,,,,,,,,,,,,,,,,,,,,,369.0,ua UKR,DF,23.0,29.5,4.0,0.0,0.0,29.0,21.0,0.0,57.0,46.0,34.0,0.0,0.0,0.0,150.0,25.0,34.0,42.4,Matches,369.0,ua UKR,DF,23.0,29.5,1292.0,1045.0,239.0,10.0,1.0,3.0,57.0,227.0,2.0,1.0,1.0,0.0,966.0,8.0,30.0,Matches,369.0,ua UKR,DF,23.0,29.5,966.0,1292.0,74.8,15199.0,5874.0,509.0,585.0,87.0,365.0,477.0,76.5,63.0,147.0,42.9,0.0,1.2,0.9,-1.2,19.0,84.0,21.0,11.0,100.0,Matches,462,ua UKR,DF,23,34,2655.0,78.0,77.6,29.5,30,86.0,27,4,17.0,0,0.91,28.0,46.0,-18.0,-0.61,-0.02,34.6,52.0,-17.4,-0.59,-0.24,Matches,369.0,ua UKR,DF,23.0,29.5,1625.0,124.0,576.0,693.0,370.0,26.0,1625.0,25.0,11.0,44.0,14.0,56.0,701.0,3103.0,1491.0,31.0,33.0,7.0,32.0,8.0,798.0,72.0,Matches,369.0,ua UKR,DF,23.0,29.5,0.0,10.0,3.0,30.0,0.34,0.1,0.0,0.0,20.3,0.0,0.0,0.0,0.5,0.5,0.05,-0.5,-0.5,Matches,369.0,ua UKR,DF,23.0,34.0,30.0,2655.0,29.5,0.0,0.0,0.0,0.0,0.0,0.0,4.0,0.0,0.5,0.5,1.2,1.8,31.0,100.0,72.0,0.0,0.0,0.0,0.0,0.0,0.02,0.04,0.06,0.02,0.06,Matches,Vitaliy Mykolenko,D/WB L,23,135,150,Ukraine,Everton,8,13,12,7,12,5,13,12,10,12,13,4,14,12,12,12,15,12,14,11,13,16,7,8,13,13,13,16,15,14,11,13,14,15,15,11,13,12,15,3,6,2,3,3,3,2,1,2,1,2,3,2,12,15,5,13,16,14,11,12,1,20,11,4,19,3,2,1,1,1,1,1,1,1,180,71,20,9,44521841,6750,6750,5250,Northern_European,134,2,1999/5/29,27,0,57996.0,,71104595
434,Keylor Navas,Nott'ham Forest,1986,370.0,cr CRC,GK,35.0,17.0,0.0,0.0,0.0,0.0,0.0,0.0,0.0,,0.0,0.0,0.0,0.0,1.0,1.0,11.0,2.0,Matches,370.0,cr CRC,GK,35.0,17.0,3.0,0.18,2.0,1.0,0.0,0.0,0.0,0.0,0.0,0.0,0.0,0.0,0.0,0.0,0.0,0.0,Matches,24.0,cr CRC,GK,35.0,17.0,32.0,4.0,1.0,3.0,0.0,29.3,0.32,-2.7,-0.16,106.0,320.0,33.1,378.0,65.0,56.3,41.3,151.0,70.9,48.1,295.0,14.0,4.7,9.0,0.53,9.0,Matches,24.0,cr CRC,GK,35.0,17.0,17.0,1529.0,17.0,32.0,1.88,83.0,51.0,66.3,4.0,4.0,9.0,1.0,5.9,4.0,4.0,0.0,0.0,0.0,Matches,370.0,cr CRC,GK,35.0,17.0,2.0,0.0,0.0,0.0,0.0,0.0,0.0,1.0,0.0,0.0,0.0,0.0,10.0,6.0,0.0,100.0,Matches,370.0,cr CRC,GK,35.0,17.0,534.0,312.0,217.0,66.0,0.0,0.0,0.0,0.0,0.0,0.0,0.0,0.0,306.0,5.0,0.0,Matches,370.0,cr CRC,GK,35.0,17.0,306.0,534.0,57.3,10310.0,8282.0,29.0,29.0,100.0,136.0,137.0,99.3,141.0,363.0,38.8,0.0,0.0,0.0,0.0,0.0,7.0,0.0,0.0,1.0,Matches,464,cr CRC,GK,35,17,1529.0,90.0,44.7,17.0,17,90.0,16,0,,0,0.94,21.0,32.0,-11.0,-0.65,0.26,15.8,32.4,-16.6,-0.98,-0.58,Matches,370.0,cr CRC,GK,35.0,17.0,578.0,515.0,576.0,2.0,0.0,0.0,578.0,1.0,1.0,100.0,0.0,0.0,267.0,1718.0,1174.0,0.0,0.0,0.0,1.0,0.0,175.0,0.0,Matches,370.0,cr CRC,GK,35.0,17.0,0.0,0.0,0.0,,0.0,0.0,,,,0.0,0.0,0.0,0.0,0.0,,0.0,0.0,Matches,370.0,cr CRC,GK,35.0,17.0,17.0,1529.0,17.0,0.0,0.0,0.0,0.0,0.0,0.0,2.0,0.0,0.0,0.0,0.0,0.0,0.0,1.0,0.0,0.0,0.0,0.0,0.0,0.0,0.0,0.0,0.0,0.0,0.0,Matches,Keylor Navas,GK,35,158,167,"Costa Rica,Spain",Paris Saint-Germain,3,3,3,1,10,1,9,1,1,2,10,2,3,8,11,15,15,13,17,8,15,16,8,12,1,14,15,15,12,17,14,12,17,13,14,13,15,4,17,9,1,10,15,14,4,12,14,16,17,12,16,15,14,15,3,16,15,18,16,19,20,1,1,1,1,1,1,1,1,1,1,1,1,1,185,80,8,20,11935211,7891,7891,7491,Mediterranean_Hispanic,157,10,1986/12/15,107,0,230137.0,,8826969
435,Wilfred Ndidi,Leicester City,1996,371.0,ng NGA,MF,25.0,18.7,61.0,42.0,34.0,24.0,3.0,17.0,43.0,39.5,26.0,32.0,14.0,18.0,38.0,99.0,48.0,3.0,Matches,371.0,ng NGA,MF,25.0,18.7,12.0,0.64,12.0,0.0,0.0,0.0,0.0,0.0,2.0,0.11,2.0,0.0,0.0,0.0,0.0,0.0,Matches,,,,,,,,,,,,,,,,,,,,,,,,,,,,,,,,,,,,,,,,,,,,,,,,,,,,,,,,371.0,ng NGA,MF,25.0,18.7,4.0,0.0,0.0,29.0,14.0,0.0,2.0,38.0,42.0,0.0,2.0,0.0,146.0,25.0,22.0,53.2,Matches,371.0,ng NGA,MF,25.0,18.7,899.0,868.0,31.0,25.0,1.0,5.0,2.0,3.0,0.0,0.0,0.0,0.0,754.0,0.0,19.0,Matches,371.0,ng NGA,MF,25.0,18.7,754.0,899.0,83.9,11486.0,2879.0,392.0,429.0,91.4,304.0,348.0,87.4,31.0,67.0,46.3,0.0,0.1,0.2,-0.1,3.0,49.0,0.0,0.0,51.0,Matches,465,ng NGA,MF,25,27,1679.0,62.0,49.1,18.7,19,79.0,8,8,22.0,4,0.7,25.0,39.0,-14.0,-0.75,-0.6,22.0,31.5,-9.5,-0.51,-0.34,Matches,371.0,ng NGA,MF,25.0,18.7,1129.0,83.0,406.0,652.0,92.0,5.0,1129.0,15.0,10.0,66.7,4.0,26.7,564.0,2464.0,1075.0,11.0,14.0,0.0,14.0,10.0,659.0,7.0,Matches,371.0,ng NGA,MF,25.0,18.7,0.0,7.0,2.0,28.6,0.38,0.11,0.0,0.0,25.1,0.0,0.0,0.0,0.2,0.2,0.03,-0.2,-0.2,Matches,371.0,ng NGA,MF,25.0,27.0,19.0,1679.0,18.7,0.0,0.0,0.0,0.0,0.0,0.0,4.0,0.0,0.2,0.2,0.1,0.3,11.0,51.0,7.0,0.0,0.0,0.0,0.0,0.0,0.01,0.0,0.01,0.01,0.01,Matches,Wilfred Ndidi,DM/M C,25,149,163,Nigeria,Leicester City,10,10,12,7,13,10,14,12,10,13,13,6,19,13,14,18,13,12,13,13,12,14,11,10,11,15,15,17,13,12,11,15,17,12,16,14,14,10,13,10,12,1,1,2,3,1,3,1,3,2,1,1,14,16,5,14,14,14,12,14,1,6,14,8,6,6,20,1,19,1,1,10,1,1,183,74,8,20,51973011,7449,7749,5999,African_Caribbean,144,16,1996/12/16,48,0,92793.0,,18091791
436,Neto,Bournemouth,1989,373.0,br BRA,GK,33.0,26.5,3.0,1.0,3.0,0.0,0.0,3.0,3.0,100.0,0.0,0.0,0.0,0.0,0.0,3.0,10.0,3.0,Matches,373.0,br BRA,GK,33.0,26.5,2.0,0.08,2.0,0.0,0.0,0.0,0.0,0.0,1.0,0.04,1.0,0.0,0.0,0.0,0.0,0.0,Matches,25.0,br BRA,GK,33.0,26.5,39.0,4.0,0.0,8.0,1.0,39.7,0.26,1.7,0.06,160.0,437.0,36.6,601.0,136.0,47.4,37.8,231.0,65.8,44.6,510.0,35.0,6.9,25.0,0.94,12.1,Matches,25.0,br BRA,GK,33.0,27.0,27.0,2385.0,26.5,39.0,1.47,138.0,100.0,74.6,9.0,6.0,12.0,6.0,22.2,5.0,4.0,0.0,1.0,0.0,Matches,373.0,br BRA,GK,33.0,26.5,4.0,0.0,0.0,0.0,4.0,0.0,0.0,0.0,1.0,0.0,0.0,0.0,21.0,4.0,3.0,57.1,Matches,373.0,br BRA,GK,33.0,26.5,833.0,513.0,319.0,88.0,0.0,1.0,0.0,0.0,0.0,0.0,0.0,0.0,521.0,1.0,0.0,Matches,373.0,br BRA,GK,33.0,26.5,521.0,833.0,62.5,15893.0,12592.0,109.0,111.0,98.2,194.0,201.0,96.5,211.0,513.0,41.1,0.0,0.0,0.0,0.0,0.0,14.0,2.0,0.0,0.0,Matches,467,br BRA,GK,33,27,2385.0,88.0,69.7,26.5,27,88.0,26,0,,3,1.22,27.0,39.0,-12.0,-0.45,1.46,30.5,43.9,-13.4,-0.51,0.53,Matches,373.0,br BRA,GK,33.0,26.5,895.0,768.0,890.0,6.0,0.0,0.0,895.0,1.0,1.0,100.0,0.0,0.0,446.0,2814.0,2029.0,0.0,0.0,0.0,1.0,0.0,271.0,0.0,Matches,373.0,br BRA,GK,33.0,26.5,0.0,0.0,0.0,,0.0,0.0,,,,0.0,0.0,0.0,0.0,0.0,,0.0,0.0,Matches,373.0,br BRA,GK,33.0,27.0,27.0,2385.0,26.5,0.0,0.0,0.0,0.0,0.0,0.0,4.0,0.0,0.0,0.0,0.0,0.0,0.0,0.0,0.0,0.0,0.0,0.0,0.0,0.0,0.0,0.0,0.0,0.0,0.0,Matches,Neto,GK,33,150,156,"Brazil,Italy",AFC Bournemouth,5,3,3,3,10,8,6,1,2,2,11,5,1,9,7,16,12,16,15,11,13,15,6,12,3,16,12,13,12,16,15,15,14,13,14,15,12,7,14,6,13,13,14,14,8,13,10,15,17,14,13,12,14,14,8,11,16,14,13,13,20,1,1,1,1,1,1,1,1,1,1,1,1,1,190,84,7,20,26792223,7500,7250,6750,Northern_European,149,4,1989/7/19,1,0,115992.0,,19030933
437,Pedro Neto,Wolves,2000,374.0,pt POR,FWMF,22.0,10.7,11.0,6.0,4.0,2.0,5.0,7.0,17.0,41.2,10.0,5.0,1.0,4.0,4.0,15.0,4.0,0.0,Matches,374.0,pt POR,FWMF,22.0,10.7,41.0,3.82,23.0,6.0,2.0,4.0,5.0,1.0,6.0,0.56,4.0,0.0,0.0,1.0,1.0,0.0,Matches,,,,,,,,,,,,,,,,,,,,,,,,,,,,,,,,,,,,,,,,,,,,,,,,,,,,,,,,374.0,pt POR,FWMF,22.0,10.7,1.0,0.0,0.0,8.0,15.0,2.0,66.0,4.0,6.0,1.0,0.0,0.0,51.0,0.0,7.0,0.0,Matches,374.0,pt POR,FWMF,22.0,10.7,384.0,342.0,42.0,11.0,2.0,3.0,66.0,6.0,25.0,11.0,9.0,0.0,284.0,0.0,14.0,Matches,374.0,pt POR,FWMF,22.0,10.7,284.0,384.0,74.0,4517.0,1035.0,165.0,186.0,88.7,83.0,118.0,70.3,27.0,54.0,50.0,0.0,2.1,1.6,-2.1,20.0,13.0,9.0,4.0,24.0,Matches,468,pt POR,FWMF,22,18,964.0,54.0,28.2,10.7,13,69.0,2,5,13.0,3,1.06,7.0,15.0,-8.0,-0.75,-0.05,10.9,14.2,-3.2,-0.3,0.42,Matches,374.0,pt POR,FWMF,22.0,10.7,517.0,6.0,61.0,166.0,298.0,46.0,517.0,54.0,18.0,33.3,30.0,55.6,325.0,2373.0,1181.0,37.0,24.0,18.0,29.0,13.0,363.0,111.0,Matches,374.0,pt POR,FWMF,22.0,10.7,0.0,17.0,3.0,17.6,1.59,0.28,0.0,0.0,20.7,1.0,0.0,0.0,1.1,1.1,0.06,-1.1,-1.1,Matches,374.0,pt POR,FWMF,22.0,18.0,13.0,964.0,10.7,0.0,0.0,0.0,0.0,0.0,0.0,1.0,0.0,1.1,1.1,2.1,3.2,37.0,24.0,111.0,0.0,0.0,0.0,0.0,0.0,0.1,0.2,0.3,0.1,0.3,Matches,Pedro Neto,AM/S RLC,22,138,167,Portugal,Wolverhampton Wanderers,13,13,17,13,13,11,7,12,3,5,13,8,3,14,9,9,9,11,10,11,11,15,16,7,13,6,11,10,17,13,11,7,14,16,12,7,14,11,12,5,17,1,2,1,2,3,1,2,1,2,1,1,13,15,8,13,14,15,16,15,1,1,1,1,1,1,1,14,1,14,20,15,20,16,172,62,20,10,48667812,6900,6400,6000,Mediterranean_Hispanic,124,4,2000/3/9,3,1,46397.0,,29179717
438,Rúben Neves,Wolves,1997,375.0,pt POR,MF,25.0,33.5,79.0,43.0,31.0,33.0,15.0,32.0,76.0,42.1,44.0,59.0,22.0,37.0,50.0,129.0,85.0,1.0,Matches,375.0,pt POR,MF,25.0,33.5,80.0,2.38,55.0,11.0,3.0,4.0,3.0,4.0,3.0,0.09,2.0,1.0,0.0,0.0,0.0,0.0,Matches,,,,,,,,,,,,,,,,,,,,,,,,,,,,,,,,,,,,,,,,,,,,,,,,,,,,,,,,375.0,pt POR,MF,25.0,33.5,12.0,0.0,0.0,38.0,18.0,1.0,53.0,50.0,43.0,0.0,1.0,0.0,237.0,25.0,25.0,50.0,Matches,375.0,pt POR,MF,25.0,33.5,2106.0,1945.0,153.0,115.0,7.0,24.0,53.0,11.0,21.0,3.0,16.0,0.0,1730.0,8.0,30.0,Matches,375.0,pt POR,MF,25.0,33.5,1730.0,2106.0,82.1,36646.0,10039.0,578.0,635.0,91.0,824.0,926.0,89.0,312.0,474.0,65.8,1.0,1.6,1.5,-0.6,32.0,202.0,15.0,1.0,218.0,Matches,469,pt POR,MF,25,35,3019.0,86.0,88.3,33.5,33,89.0,30,2,45.0,0,1.0,26.0,48.0,-22.0,-0.66,0.47,32.5,51.7,-19.2,-0.57,0.29,Matches,375.0,pt POR,MF,25.0,33.5,2486.0,177.0,811.0,1307.0,394.0,25.0,2483.0,32.0,20.0,62.5,9.0,28.1,1318.0,6007.0,2980.0,28.0,29.0,1.0,22.0,13.0,1621.0,18.0,Matches,375.0,pt POR,MF,25.0,33.5,6.0,63.0,13.0,20.6,1.88,0.39,0.05,0.23,26.7,11.0,3.0,3.0,5.2,2.8,0.04,0.8,0.2,Matches,375.0,pt POR,MF,25.0,35.0,33.0,3019.0,33.5,6.0,1.0,7.0,3.0,3.0,3.0,12.0,0.0,5.2,2.8,1.6,4.4,28.0,218.0,18.0,0.18,0.03,0.21,0.09,0.12,0.15,0.05,0.2,0.08,0.13,Matches,Rúben Neves,DM/M C,25,153,169,Portugal,Wolverhampton Wanderers,14,13,13,11,14,16,9,15,7,11,17,16,13,16,13,15,11,15,15,17,15,16,11,13,11,14,15,14,12,13,14,11,14,11,13,11,14,13,13,8,11,2,2,3,3,2,1,1,2,2,3,1,12,14,6,16,16,19,14,12,1,1,10,1,1,1,20,1,20,1,1,1,1,1,180,80,13,20,66666250,7600,7600,6250,Mediterranean_Hispanic,151,5,1997/3/13,30,0,69595.0,,55070307
439,Eddie Nketiah,Arsenal,1999,377.0,eng ENG,FW,23.0,12.1,13.0,9.0,6.0,2.0,5.0,2.0,10.0,20.0,8.0,7.0,1.0,6.0,1.0,14.0,7.0,0.0,Matches,377.0,eng ENG,FW,23.0,12.1,29.0,2.4,14.0,0.0,6.0,6.0,3.0,0.0,3.0,0.25,2.0,0.0,0.0,0.0,1.0,0.0,Matches,,,,,,,,,,,,,,,,,,,,,,,,,,,,,,,,,,,,,,,,,,,,,,,,,,,,,,,,377.0,eng ENG,FW,23.0,12.1,3.0,0.0,0.0,30.0,25.0,8.0,5.0,1.0,9.0,1.0,0.0,0.0,30.0,10.0,31.0,24.4,Matches,377.0,eng ENG,FW,23.0,12.1,255.0,231.0,24.0,0.0,0.0,1.0,5.0,0.0,0.0,0.0,0.0,0.0,205.0,0.0,11.0,Matches,377.0,eng ENG,FW,23.0,12.1,205.0,255.0,80.4,2894.0,350.0,131.0,151.0,86.8,58.0,69.0,84.1,9.0,12.0,75.0,1.0,1.1,1.3,-0.1,9.0,9.0,6.0,0.0,15.0,Matches,471,eng ENG,FW,23,30,1089.0,36.0,31.8,12.1,9,90.0,8,21,13.0,3,2.07,26.0,16.0,10.0,0.83,-0.52,24.7,14.2,10.5,0.87,0.13,Matches,377.0,eng ENG,FW,23.0,12.1,407.0,10.0,35.0,157.0,221.0,87.0,407.0,34.0,15.0,44.1,13.0,38.2,259.0,1682.0,603.0,32.0,16.0,22.0,30.0,20.0,305.0,82.0,Matches,377.0,eng ENG,FW,23.0,12.1,4.0,41.0,14.0,34.1,3.39,1.16,0.1,0.29,11.3,0.0,0.0,0.0,8.2,8.2,0.2,-4.2,-4.2,Matches,377.0,eng ENG,FW,23.0,30.0,9.0,1089.0,12.1,4.0,1.0,5.0,4.0,0.0,0.0,3.0,0.0,8.2,8.2,1.1,9.3,32.0,15.0,82.0,0.33,0.08,0.41,0.33,0.41,0.68,0.09,0.76,0.68,0.76,Matches,Eddie Nketiah,S RL,23,138,155,"England,Ghana",Arsenal,2,7,14,14,13,5,12,9,1,3,11,8,4,14,11,13,10,14,11,11,12,14,13,4,15,4,15,14,17,16,13,9,14,17,14,10,14,6,12,8,10,1,3,2,3,2,1,2,2,2,1,3,8,14,4,13,14,13,13,14,1,1,1,1,1,1,1,8,1,12,15,12,15,20,175,0,12,20,30273843,6900,6900,5500,African_Caribbean,132,16,1999/5/30,0,0,86994.0,,28106687
440,Matheus Nunes,Wolves,1998,378.0,pt POR,MF,23.0,27.4,67.0,43.0,36.0,22.0,9.0,28.0,61.0,45.9,33.0,35.0,4.0,31.0,16.0,83.0,35.0,2.0,Matches,378.0,pt POR,MF,23.0,27.4,59.0,2.15,49.0,2.0,4.0,2.0,2.0,0.0,5.0,0.18,3.0,0.0,2.0,0.0,0.0,0.0,Matches,,,,,,,,,,,,,,,,,,,,,,,,,,,,,,,,,,,,,,,,,,,,,,,,,,,,,,,,378.0,pt POR,MF,23.0,27.4,2.0,1.0,0.0,37.0,49.0,2.0,43.0,16.0,43.0,0.0,1.0,0.0,154.0,22.0,30.0,42.3,Matches,378.0,pt POR,MF,23.0,27.4,1028.0,994.0,31.0,14.0,6.0,33.0,43.0,8.0,9.0,3.0,4.0,0.0,818.0,3.0,23.0,Matches,378.0,pt POR,MF,23.0,27.4,818.0,1028.0,79.6,15035.0,2954.0,387.0,451.0,85.8,290.0,339.0,85.5,119.0,173.0,68.8,1.0,2.2,1.3,-1.2,27.0,70.0,19.0,7.0,84.0,Matches,472,pt POR,MF,23,34,2467.0,73.0,72.1,27.4,30,79.0,14,4,22.0,0,1.14,21.0,41.0,-20.0,-0.73,-0.07,23.7,41.7,-18.0,-0.66,-0.19,Matches,378.0,pt POR,MF,23.0,27.4,1354.0,64.0,325.0,656.0,397.0,52.0,1354.0,85.0,44.0,51.8,28.0,32.9,851.0,5513.0,2640.0,59.0,54.0,10.0,41.0,39.0,943.0,129.0,Matches,378.0,pt POR,MF,23.0,27.4,1.0,28.0,9.0,32.1,1.02,0.33,0.04,0.11,17.6,1.0,0.0,0.0,2.4,2.4,0.09,-1.4,-1.4,Matches,378.0,pt POR,MF,23.0,34.0,30.0,2467.0,27.4,1.0,1.0,2.0,1.0,0.0,0.0,2.0,1.0,2.4,2.4,2.2,4.7,59.0,84.0,129.0,0.04,0.04,0.07,0.04,0.07,0.09,0.08,0.17,0.09,0.17,Matches,Matheus Nunes,M/AM C,23,150,162,"Portugal,Brazil",Wolverhampton Wanderers,13,13,15,12,14,11,10,14,8,9,14,11,11,15,15,13,16,13,17,14,13,15,15,8,14,14,16,16,14,13,13,12,17,14,16,14,15,13,17,3,14,1,1,3,1,2,2,2,3,1,2,1,14,16,5,13,17,18,13,15,1,1,1,1,1,1,14,5,20,13,10,16,13,1,184,78,12,20,85427913,7500,7500,6500,Mediterranean_Hispanic,149,8,1998/8/27,8,1,115992.0,,83188780
441,Darwin Núñez,Liverpool,1999,379.0,uy URU,FW,23.0,18.8,11.0,5.0,2.0,4.0,5.0,4.0,17.0,23.5,13.0,10.0,0.0,10.0,3.0,14.0,13.0,0.0,Matches,379.0,uy URU,FW,23.0,18.8,54.0,2.87,35.0,1.0,4.0,7.0,7.0,0.0,3.0,0.16,2.0,0.0,0.0,0.0,1.0,0.0,Matches,,,,,,,,,,,,,,,,,,,,,,,,,,,,,,,,,,,,,,,,,,,,,,,,,,,,,,,,379.0,uy URU,FW,23.0,18.8,1.0,1.0,0.0,25.0,17.0,17.0,18.0,3.0,5.0,1.0,0.0,0.0,44.0,36.0,51.0,41.4,Matches,379.0,uy URU,FW,23.0,18.8,401.0,386.0,11.0,0.0,2.0,8.0,18.0,8.0,1.0,0.0,0.0,0.0,258.0,4.0,22.0,Matches,379.0,uy URU,FW,23.0,18.8,258.0,401.0,64.3,3922.0,852.0,130.0,184.0,70.7,80.0,117.0,68.4,21.0,30.0,70.0,3.0,5.4,2.8,-2.4,28.0,11.0,12.0,1.0,29.0,Matches,473,uy URU,FW,23,29,1695.0,58.0,49.6,18.8,19,78.0,5,10,21.0,0,1.9,35.0,22.0,13.0,0.69,-0.09,37.3,27.2,10.1,0.53,-0.07,Matches,379.0,uy URU,FW,23.0,18.8,633.0,12.0,51.0,179.0,412.0,154.0,633.0,44.0,18.0,40.9,19.0,43.2,387.0,2795.0,1408.0,61.0,33.0,31.0,41.0,27.0,491.0,181.0,Matches,379.0,uy URU,FW,23.0,18.8,9.0,84.0,35.0,41.7,4.46,1.86,0.11,0.26,15.1,0.0,0.0,0.0,12.1,12.1,0.14,-3.1,-3.1,Matches,379.0,uy URU,FW,23.0,29.0,19.0,1695.0,18.8,9.0,3.0,12.0,9.0,0.0,0.0,1.0,1.0,12.1,12.1,5.4,17.5,61.0,29.0,181.0,0.48,0.16,0.64,0.48,0.64,0.64,0.28,0.93,0.64,0.93,Matches,Darwin Núñez,S,23,150,164,Uruguay,Liverpool,7,12,12,15,10,11,13,13,5,6,11,15,9,12,16,13,17,12,13,14,11,17,14,6,15,6,16,18,17,13,12,15,15,17,16,15,12,7,11,9,10,4,3,3,1,3,2,1,1,1,1,1,12,16,3,10,12,14,12,11,1,1,1,1,1,1,1,1,1,1,14,1,12,20,187,82,13,20,74455712,7300,6950,6000,Mediterranean_Hispanic,149,7,1999/6/24,11,2,162388.0,,78090138
442,Christian Nørgaard,Brentford,1994,381.0,dk DEN,MF,28.0,19.6,52.0,30.0,21.0,29.0,2.0,18.0,48.0,37.5,30.0,32.0,9.0,23.0,34.0,86.0,41.0,2.0,Matches,381.0,dk DEN,MF,28.0,19.6,32.0,1.63,24.0,1.0,1.0,4.0,2.0,0.0,7.0,0.36,3.0,0.0,0.0,3.0,1.0,0.0,Matches,,,,,,,,,,,,,,,,,,,,,,,,,,,,,,,,,,,,,,,,,,,,,,,,,,,,,,,,381.0,dk DEN,MF,28.0,19.6,6.0,0.0,0.0,35.0,20.0,0.0,11.0,34.0,30.0,1.0,0.0,0.0,165.0,18.0,20.0,47.4,Matches,381.0,dk DEN,MF,28.0,19.6,812.0,787.0,19.0,10.0,2.0,6.0,11.0,2.0,0.0,0.0,0.0,0.0,608.0,6.0,11.0,Matches,381.0,dk DEN,MF,28.0,19.6,608.0,812.0,74.9,9879.0,3427.0,304.0,369.0,82.4,252.0,326.0,77.3,40.0,74.0,54.1,3.0,3.1,1.8,-0.1,12.0,68.0,8.0,2.0,73.0,Matches,475,dk DEN,MF,28,22,1763.0,80.0,51.5,19.6,21,83.0,12,1,29.0,0,1.5,31.0,23.0,8.0,0.41,0.19,29.2,24.7,4.5,0.23,0.11,Matches,381.0,dk DEN,MF,28.0,19.6,1050.0,78.0,338.0,554.0,165.0,42.0,1050.0,19.0,8.0,42.1,10.0,52.6,454.0,1518.0,671.0,4.0,11.0,2.0,14.0,10.0,526.0,8.0,Matches,381.0,dk DEN,MF,28.0,19.6,1.0,19.0,8.0,42.1,0.97,0.41,0.05,0.13,11.4,0.0,0.0,0.0,1.6,1.6,0.08,-0.6,-0.6,Matches,381.0,dk DEN,MF,28.0,22.0,21.0,1763.0,19.6,1.0,3.0,4.0,1.0,0.0,0.0,6.0,0.0,1.6,1.6,3.1,4.7,4.0,73.0,8.0,0.05,0.15,0.2,0.05,0.2,0.08,0.16,0.24,0.08,0.24,Matches,Christian Nørgaard,DM/M C,28,136,139,Denmark,Brentford,9,10,12,8,13,9,12,9,8,13,14,8,14,14,14,13,14,14,15,15,13,13,12,14,12,15,15,16,11,11,12,14,15,12,16,12,15,3,14,11,16,3,1,2,2,4,1,3,1,1,1,3,14,14,4,14,13,13,16,14,1,1,13,1,1,1,20,1,18,1,1,10,1,1,187,76,12,20,27341164,6800,7000,5750,Northern_European,136,5,1994/3/10,17,1,46397.0,,27039017
443,Angelo Ogbonna,West Ham,1988,384.0,it ITA,DF,34.0,13.7,11.0,4.0,7.0,4.0,0.0,5.0,10.0,50.0,5.0,11.0,7.0,4.0,17.0,28.0,74.0,1.0,Matches,384.0,it ITA,DF,34.0,13.7,6.0,0.44,5.0,0.0,0.0,0.0,0.0,1.0,0.0,0.0,0.0,0.0,0.0,0.0,0.0,0.0,Matches,,,,,,,,,,,,,,,,,,,,,,,,,,,,,,,,,,,,,,,,,,,,,,,,,,,,,,,,384.0,it ITA,DF,34.0,13.7,0.0,0.0,0.0,2.0,4.0,0.0,0.0,17.0,4.0,0.0,0.0,0.0,61.0,35.0,20.0,63.6,Matches,384.0,it ITA,DF,34.0,13.7,415.0,406.0,9.0,7.0,0.0,0.0,0.0,0.0,0.0,0.0,0.0,0.0,332.0,0.0,2.0,Matches,384.0,it ITA,DF,34.0,13.7,332.0,415.0,80.0,6299.0,2059.0,100.0,120.0,83.3,190.0,217.0,87.6,32.0,62.0,51.6,0.0,0.2,0.1,-0.2,3.0,8.0,1.0,0.0,11.0,Matches,479,it ITA,DF,34,16,1237.0,77.0,36.2,13.7,13,88.0,11,3,33.0,19,1.13,15.0,19.0,-4.0,-0.29,0.08,17.6,20.1,-2.5,-0.18,-0.12,Matches,384.0,it ITA,DF,34.0,13.7,545.0,111.0,331.0,197.0,17.0,7.0,545.0,0.0,0.0,,0.0,,255.0,1288.0,436.0,0.0,0.0,0.0,1.0,3.0,281.0,2.0,Matches,384.0,it ITA,DF,34.0,13.7,0.0,3.0,0.0,0.0,0.22,0.0,0.0,,12.6,0.0,0.0,0.0,0.3,0.3,0.09,-0.3,-0.3,Matches,384.0,it ITA,DF,34.0,16.0,13.0,1237.0,13.7,0.0,0.0,0.0,0.0,0.0,0.0,0.0,0.0,0.3,0.3,0.2,0.5,0.0,11.0,2.0,0.0,0.0,0.0,0.0,0.0,0.02,0.02,0.03,0.02,0.03,Matches,Angelo Ogbonna,D C,34,141,152,"Italy,Nigeria",West Ham United,2,5,10,4,12,2,15,5,9,14,11,7,13,12,16,15,15,14,15,10,14,14,10,13,9,16,13,13,12,12,15,15,12,14,15,15,15,10,12,9,10,2,2,2,3,2,4,1,3,3,1,1,14,16,6,8,10,14,16,16,1,13,20,10,1,1,1,1,1,1,1,1,1,1,191,86,20,8,5029213,7050,6750,5500,African_Caribbean,140,15,1988/5/23,13,0,75395.0,,43006340
444,Michael Olise,Crystal Palace,2001,385.0,fr FRA,FWMF,20.0,30.5,58.0,34.0,28.0,26.0,4.0,25.0,60.0,41.7,35.0,46.0,1.0,45.0,26.0,84.0,17.0,0.0,Matches,385.0,fr FRA,FWMF,20.0,30.5,143.0,4.68,75.0,37.0,15.0,4.0,9.0,3.0,13.0,0.43,9.0,4.0,0.0,0.0,0.0,0.0,Matches,,,,,,,,,,,,,,,,,,,,,,,,,,,,,,,,,,,,,,,,,,,,,,,,,,,,,,,,385.0,fr FRA,FWMF,20.0,30.5,2.0,0.0,0.0,28.0,69.0,7.0,242.0,26.0,34.0,0.0,1.0,0.0,165.0,17.0,38.0,30.9,Matches,385.0,fr FRA,FWMF,20.0,30.5,1420.0,1189.0,229.0,63.0,4.0,21.0,242.0,18.0,127.0,58.0,46.0,4.0,985.0,2.0,49.0,Matches,385.0,fr FRA,FWMF,20.0,30.5,985.0,1420.0,69.4,16792.0,5022.0,518.0,601.0,86.2,328.0,444.0,73.9,115.0,273.0,42.1,11.0,8.7,6.4,2.3,72.0,72.0,53.0,16.0,133.0,Matches,482,fr FRA,FWMF,20,37,2749.0,74.0,80.4,30.5,31,85.0,17,6,20.0,0,1.22,35.0,38.0,-3.0,-0.1,0.71,32.1,36.6,-4.5,-0.15,0.43,Matches,385.0,fr FRA,FWMF,20.0,30.5,1840.0,25.0,243.0,709.0,911.0,86.0,1840.0,141.0,54.0,38.3,59.0,41.8,1048.0,6663.0,3366.0,111.0,74.0,38.0,85.0,47.0,1215.0,243.0,Matches,385.0,fr FRA,FWMF,20.0,30.5,2.0,51.0,14.0,27.5,1.67,0.46,0.04,0.14,21.1,7.0,0.0,0.0,2.9,2.9,0.06,-0.9,-0.9,Matches,385.0,fr FRA,FWMF,20.0,37.0,31.0,2749.0,30.5,2.0,11.0,13.0,2.0,0.0,0.0,2.0,0.0,2.9,2.9,8.7,11.6,111.0,133.0,243.0,0.07,0.36,0.43,0.07,0.43,0.09,0.29,0.38,0.09,0.38,Matches,Michael Olise,AM RC,20,138,-9,"France,England,Algeria",Crystal Palace,12,14,16,11,15,14,7,13,4,9,15,12,8,15,6,11,9,13,11,14,14,12,16,9,13,10,11,12,15,15,14,11,13,14,12,10,13,5,12,9,8,2,2,2,1,3,1,4,3,2,1,3,8,16,5,8,15,13,11,8,1,1,1,1,1,1,1,12,11,13,14,16,20,1,184,71,20,9,57995868,6900,6900,5650,African_Caribbean,138,15,2001/12/12,0,0,52196.0,,29221846
445,Amadou Onana,Everton,2001,387.0,be BEL,MF,20.0,27.6,72.0,43.0,24.0,42.0,6.0,30.0,42.0,71.4,12.0,25.0,6.0,19.0,37.0,109.0,39.0,0.0,Matches,387.0,be BEL,MF,20.0,27.6,45.0,1.63,35.0,0.0,1.0,2.0,5.0,2.0,2.0,0.07,2.0,0.0,0.0,0.0,0.0,0.0,Matches,,,,,,,,,,,,,,,,,,,,,,,,,,,,,,,,,,,,,,,,,,,,,,,,,,,,,,,,387.0,be BEL,MF,20.0,27.6,9.0,0.0,0.0,44.0,49.0,2.0,5.0,37.0,43.0,0.0,0.0,0.0,150.0,60.0,55.0,52.2,Matches,387.0,be BEL,MF,20.0,27.6,980.0,970.0,6.0,4.0,5.0,7.0,5.0,1.0,0.0,0.0,0.0,0.0,816.0,4.0,6.0,Matches,387.0,be BEL,MF,20.0,27.6,816.0,980.0,83.3,13145.0,3007.0,420.0,481.0,87.3,310.0,354.0,87.6,60.0,86.0,69.8,2.0,2.6,1.7,-0.6,22.0,77.0,11.0,0.0,79.0,Matches,484,be BEL,MF,20,33,2488.0,75.0,72.7,27.6,29,83.0,16,4,21.0,1,1.03,22.0,37.0,-15.0,-0.54,0.23,32.0,46.4,-14.4,-0.52,0.05,Matches,387.0,be BEL,MF,20.0,27.6,1310.0,58.0,287.0,745.0,295.0,52.0,1310.0,52.0,18.0,34.6,23.0,44.2,684.0,3563.0,1436.0,27.0,30.0,4.0,49.0,17.0,871.0,49.0,Matches,387.0,be BEL,MF,20.0,27.6,1.0,34.0,6.0,17.6,1.23,0.22,0.03,0.17,16.8,0.0,0.0,0.0,3.0,3.0,0.09,-2.0,-2.0,Matches,387.0,be BEL,MF,20.0,33.0,29.0,2488.0,27.6,1.0,2.0,3.0,1.0,0.0,0.0,9.0,0.0,3.0,3.0,2.6,5.6,27.0,79.0,49.0,0.04,0.07,0.11,0.04,0.11,0.11,0.09,0.2,0.11,0.2,Matches,Amadou Onana,D/DM/M C,20,133,-85,"Belgium,Senegal",Everton,7,9,14,8,13,9,12,9,8,12,13,9,14,14,13,11,12,14,12,14,12,14,14,9,11,11,10,14,12,13,15,15,13,17,14,13,10,10,15,10,11,2,3,3,2,3,1,3,4,1,1,1,13,17,15,6,13,9,12,10,1,1,16,1,1,1,19,1,20,1,1,12,1,1,192,76,12,20,123699386,6800,5773,5270,African_Caribbean,130,19,2001/8/16,1,0,40597.0,,91207274
446,Dango Ouattara,Bournemouth,2002,393.0,bf BFA,MFFW,20.0,13.8,28.0,15.0,20.0,6.0,2.0,13.0,32.0,40.6,19.0,20.0,3.0,17.0,13.0,41.0,29.0,1.0,Matches,393.0,bf BFA,MFFW,20.0,13.8,44.0,3.19,26.0,1.0,8.0,4.0,4.0,1.0,5.0,0.36,1.0,0.0,2.0,1.0,1.0,0.0,Matches,,,,,,,,,,,,,,,,,,,,,,,,,,,,,,,,,,,,,,,,,,,,,,,,,,,,,,,,393.0,bf BFA,MFFW,20.0,13.8,1.0,0.0,0.0,6.0,15.0,8.0,30.0,13.0,15.0,0.0,0.0,0.0,64.0,30.0,37.0,44.8,Matches,393.0,bf BFA,MFFW,20.0,13.8,334.0,322.0,10.0,0.0,5.0,5.0,30.0,7.0,1.0,0.0,0.0,0.0,210.0,2.0,12.0,Matches,393.0,bf BFA,MFFW,20.0,13.8,210.0,334.0,62.9,3297.0,1069.0,118.0,157.0,75.2,68.0,105.0,64.8,16.0,37.0,43.2,3.0,2.5,1.6,0.5,18.0,20.0,17.0,8.0,23.0,Matches,490,bf BFA,MFFW,20,19,1241.0,65.0,36.3,13.8,15,78.0,7,4,17.0,0,1.21,13.0,23.0,-10.0,-0.73,0.27,17.5,25.4,-7.9,-0.58,0.14,Matches,393.0,bf BFA,MFFW,20.0,13.8,566.0,42.0,136.0,210.0,234.0,64.0,566.0,74.0,31.0,41.9,37.0,50.0,301.0,2219.0,1083.0,39.0,23.0,17.0,39.0,14.0,336.0,87.0,Matches,393.0,bf BFA,MFFW,20.0,13.8,1.0,26.0,5.0,19.2,1.89,0.36,0.04,0.2,14.3,0.0,0.0,0.0,3.6,3.6,0.14,-2.6,-2.6,Matches,393.0,bf BFA,MFFW,20.0,19.0,15.0,1241.0,13.8,1.0,3.0,4.0,1.0,0.0,0.0,1.0,0.0,3.6,3.6,2.5,6.1,39.0,23.0,87.0,0.07,0.22,0.29,0.07,0.29,0.26,0.18,0.44,0.26,0.44,Matches,Dango Ouattara,AM/S R,20,123,-75,Burkina Faso,FC Lorient,11,12,13,11,16,12,8,9,5,10,12,11,10,13,6,11,8,11,10,12,12,10,12,7,12,11,14,14,14,13,12,9,15,14,13,9,13,7,13,7,11,3,1,2,1,3,2,2,3,2,3,2,12,11,6,12,9,15,13,13,1,1,1,1,1,1,1,12,1,14,14,1,20,17,177,68,20,8,43189421,6197,6147,3749,African_Caribbean,121,17,2002/2/11,8,4,9618.0,,12091814
447,João Palhinha,Fulham,1995,396.0,pt POR,MF,27.0,34.5,148.0,83.0,59.0,65.0,24.0,71.0,135.0,52.6,64.0,48.0,5.0,43.0,46.0,194.0,61.0,2.0,Matches,396.0,pt POR,MF,27.0,34.5,30.0,0.87,21.0,0.0,0.0,4.0,1.0,4.0,0.0,0.0,0.0,0.0,0.0,0.0,0.0,0.0,Matches,,,,,,,,,,,,,,,,,,,,,,,,,,,,,,,,,,,,,,,,,,,,,,,,,,,,,,,,396.0,pt POR,MF,27.0,34.5,14.0,0.0,0.0,48.0,50.0,1.0,3.0,46.0,83.0,0.0,1.0,1.0,212.0,71.0,39.0,64.5,Matches,396.0,pt POR,MF,27.0,34.5,1274.0,1222.0,48.0,32.0,0.0,38.0,3.0,0.0,0.0,0.0,0.0,0.0,1051.0,4.0,15.0,Matches,396.0,pt POR,MF,27.0,34.5,1051.0,1274.0,82.5,18222.0,4336.0,527.0,600.0,87.8,396.0,462.0,85.7,107.0,157.0,68.2,0.0,0.4,0.4,-0.4,7.0,118.0,3.0,0.0,101.0,Matches,494,pt POR,MF,27,35,3108.0,89.0,90.9,34.5,35,89.0,30,0,,0,1.49,51.0,43.0,8.0,0.23,1.96,42.1,55.7,-13.7,-0.4,0.7,Matches,396.0,pt POR,MF,27.0,34.5,1713.0,81.0,433.0,1055.0,247.0,33.0,1713.0,39.0,14.0,35.9,15.0,38.5,763.0,2775.0,935.0,8.0,10.0,3.0,37.0,28.0,919.0,18.0,Matches,396.0,pt POR,MF,27.0,34.5,3.0,39.0,9.0,23.1,1.13,0.26,0.08,0.33,17.2,0.0,0.0,0.0,2.9,2.9,0.07,0.1,0.1,Matches,396.0,pt POR,MF,27.0,35.0,35.0,3108.0,34.5,3.0,0.0,3.0,3.0,0.0,0.0,14.0,0.0,2.9,2.9,0.4,3.3,8.0,101.0,18.0,0.09,0.0,0.09,0.09,0.09,0.08,0.01,0.1,0.08,0.1,Matches,João Palhinha,DM/M C,27,152,160,Portugal,Fulham,5,12,11,10,13,4,15,14,10,15,14,10,17,13,17,16,17,14,17,13,14,15,6,13,11,17,16,14,11,10,15,16,17,12,14,16,18,16,11,5,13,3,1,2,2,1,2,3,1,3,1,2,16,12,5,16,14,19,15,12,1,1,14,1,1,1,20,1,17,1,1,1,1,1,190,84,12,20,55536838,7500,7500,6000,Northern_European,152,5,1995/7/9,14,2,69595.0,,55070285
448,Lucas Paquetá,West Ham,1997,399.0,br BRA,MF,24.0,23.9,71.0,53.0,23.0,36.0,12.0,27.0,68.0,39.7,41.0,41.0,4.0,37.0,16.0,87.0,31.0,0.0,Matches,399.0,br BRA,MF,24.0,23.9,79.0,3.3,57.0,1.0,4.0,8.0,6.0,3.0,12.0,0.5,6.0,0.0,1.0,3.0,2.0,0.0,Matches,,,,,,,,,,,,,,,,,,,,,,,,,,,,,,,,,,,,,,,,,,,,,,,,,,,,,,,,399.0,br BRA,MF,24.0,23.9,5.0,0.0,0.0,50.0,30.0,1.0,22.0,16.0,53.0,2.0,0.0,0.0,144.0,36.0,32.0,52.9,Matches,399.0,br BRA,MF,24.0,23.9,1157.0,1075.0,73.0,21.0,13.0,11.0,22.0,1.0,1.0,0.0,0.0,0.0,907.0,9.0,28.0,Matches,399.0,br BRA,MF,24.0,23.9,907.0,1157.0,78.4,14158.0,4393.0,476.0,559.0,85.2,324.0,394.0,82.2,68.0,104.0,65.4,3.0,2.5,2.6,0.5,32.0,98.0,30.0,3.0,147.0,Matches,497,br BRA,MF,24,28,2151.0,77.0,62.9,23.9,27,79.0,7,1,24.0,1,1.11,32.0,39.0,-7.0,-0.29,0.13,32.2,33.7,-1.5,-0.06,0.1,Matches,399.0,br BRA,MF,24.0,23.9,1476.0,46.0,239.0,840.0,419.0,49.0,1475.0,65.0,35.0,53.8,22.0,33.8,773.0,3450.0,1486.0,25.0,34.0,6.0,48.0,44.0,964.0,63.0,Matches,399.0,br BRA,MF,24.0,23.9,4.0,52.0,14.0,26.9,2.18,0.59,0.06,0.21,19.2,1.0,1.0,1.0,4.4,3.6,0.07,-0.4,-0.6,Matches,399.0,br BRA,MF,24.0,28.0,27.0,2151.0,23.9,4.0,3.0,7.0,3.0,1.0,1.0,5.0,0.0,4.4,3.6,2.5,6.1,25.0,147.0,63.0,0.17,0.13,0.29,0.13,0.25,0.18,0.1,0.29,0.15,0.25,Matches,Lucas Paquetá,M/AM RC,24,147,161,"Brazil,Portugal",West Ham United,12,12,15,12,16,12,12,13,6,10,16,13,10,17,13,13,16,14,12,16,13,13,17,11,14,10,13,14,13,16,14,11,13,13,13,14,11,11,14,8,14,1,3,3,3,1,3,2,1,2,2,2,11,14,9,9,9,14,8,10,1,1,1,1,1,1,1,13,19,14,13,20,15,12,180,72,20,9,57424604,7350,8097,5897,Mixed_Race,147,10,1997/8/27,21,5,150789.0,,19226741
449,Thomas Partey,Arsenal,1993,400.0,gh GHA,MF,29.0,27.6,70.0,40.0,20.0,35.0,15.0,25.0,52.0,48.1,27.0,26.0,5.0,21.0,28.0,98.0,41.0,1.0,Matches,400.0,gh GHA,MF,29.0,27.6,71.0,2.57,62.0,2.0,1.0,2.0,1.0,3.0,6.0,0.22,6.0,0.0,0.0,0.0,0.0,0.0,Matches,,,,,,,,,,,,,,,,,,,,,,,,,,,,,,,,,,,,,,,,,,,,,,,,,,,,,,,,400.0,gh GHA,MF,29.0,27.6,5.0,0.0,0.0,37.0,23.0,0.0,9.0,28.0,40.0,0.0,0.0,0.0,225.0,37.0,25.0,59.7,Matches,400.0,gh GHA,MF,29.0,27.6,1985.0,1923.0,59.0,32.0,11.0,12.0,9.0,27.0,0.0,0.0,0.0,0.0,1731.0,3.0,20.0,Matches,400.0,gh GHA,MF,29.0,27.6,1731.0,1985.0,87.2,30132.0,9207.0,804.0,876.0,91.8,712.0,801.0,88.9,178.0,240.0,74.2,0.0,1.5,2.4,-1.5,26.0,231.0,24.0,2.0,231.0,Matches,499,gh GHA,MF,29,33,2483.0,75.0,72.6,27.6,28,85.0,21,5,20.0,0,2.27,69.0,28.0,41.0,1.49,1.1,54.5,31.9,22.6,0.82,0.13,Matches,400.0,gh GHA,MF,29.0,27.6,2267.0,78.0,418.0,1406.0,466.0,29.0,2267.0,45.0,35.0,77.8,8.0,17.8,1398.0,6866.0,3847.0,34.0,38.0,3.0,33.0,19.0,1654.0,35.0,Matches,400.0,gh GHA,MF,29.0,27.6,3.0,28.0,4.0,14.3,1.01,0.14,0.11,0.75,20.4,0.0,0.0,0.0,2.2,2.2,0.08,0.8,0.8,Matches,400.0,gh GHA,MF,29.0,33.0,28.0,2483.0,27.6,3.0,0.0,3.0,3.0,0.0,0.0,5.0,0.0,2.2,2.2,1.5,3.8,34.0,231.0,35.0,0.11,0.0,0.11,0.11,0.11,0.08,0.06,0.14,0.08,0.14,Matches,Thomas Partey,DM/M C,29,150,162,Ghana,Arsenal,8,10,12,10,14,9,13,13,10,12,15,8,14,13,13,15,14,15,13,14,15,13,11,12,13,14,16,15,13,13,12,14,11,14,16,15,12,10,13,13,16,2,2,2,1,3,2,3,3,3,1,2,14,14,9,13,11,14,12,12,1,1,8,8,1,8,19,1,20,8,1,10,8,1,185,80,11,20,110302341,7500,7750,6900,African_Caribbean,150,16,1993/6/13,40,13,185587.0,,67175052
450,Nathan Patterson,Everton,2001,401.0,sct SCO,DFMF,20.0,14.2,49.0,24.0,32.0,13.0,4.0,29.0,54.0,53.7,25.0,24.0,4.0,20.0,15.0,64.0,45.0,0.0,Matches,401.0,sct SCO,DFMF,20.0,14.2,20.0,1.41,16.0,1.0,0.0,0.0,2.0,1.0,0.0,0.0,0.0,0.0,0.0,0.0,0.0,0.0,Matches,,,,,,,,,,,,,,,,,,,,,,,,,,,,,,,,,,,,,,,,,,,,,,,,,,,,,,,,401.0,sct SCO,DFMF,20.0,14.2,3.0,0.0,0.0,14.0,13.0,1.0,39.0,15.0,24.0,0.0,0.0,0.0,80.0,10.0,12.0,45.5,Matches,401.0,sct SCO,DFMF,20.0,14.2,649.0,503.0,145.0,7.0,1.0,0.0,39.0,137.0,1.0,0.0,0.0,0.0,488.0,1.0,14.0,Matches,401.0,sct SCO,DFMF,20.0,14.2,488.0,649.0,75.2,7279.0,2596.0,284.0,315.0,90.2,172.0,230.0,74.8,22.0,67.0,32.8,0.0,0.4,0.7,-0.4,6.0,21.0,10.0,4.0,24.0,Matches,500,sct SCO,DFMF,20,19,1279.0,67.0,37.4,14.2,14,82.0,11,5,26.0,2,0.74,13.0,22.0,-9.0,-0.63,-0.04,16.4,24.8,-8.4,-0.59,-0.08,Matches,401.0,sct SCO,DFMF,20.0,14.2,836.0,71.0,310.0,295.0,238.0,19.0,836.0,24.0,11.0,45.8,12.0,50.0,349.0,1940.0,851.0,16.0,12.0,3.0,22.0,9.0,431.0,51.0,Matches,401.0,sct SCO,DFMF,20.0,14.2,0.0,8.0,1.0,12.5,0.56,0.07,0.0,0.0,18.2,0.0,0.0,0.0,0.5,0.5,0.06,-0.5,-0.5,Matches,401.0,sct SCO,DFMF,20.0,19.0,14.0,1279.0,14.2,0.0,0.0,0.0,0.0,0.0,0.0,3.0,0.0,0.5,0.5,0.4,0.9,16.0,24.0,51.0,0.0,0.0,0.0,0.0,0.0,0.03,0.03,0.07,0.03,0.07,Matches,Nathan Patterson,D/WB R,20,129,162,Scotland,Everton,12,13,11,11,12,6,8,11,10,10,12,5,13,9,9,12,10,13,14,14,7,15,7,4,13,12,13,13,15,11,12,11,14,15,17,12,11,13,14,6,11,3,3,1,3,3,3,1,1,1,2,3,12,12,6,17,14,15,16,16,1,14,14,20,14,19,1,1,1,12,1,1,1,1,183,0,10,20,53211209,6450,6450,5000,Northern_European,117,3,2001/10/16,10,0,46397.0,,61083649
451,Andreas Pereira,Fulham,1996,404.0,br BRA,MF,26.0,29.9,18.0,9.0,3.0,6.0,9.0,8.0,34.0,23.5,26.0,21.0,3.0,18.0,6.0,24.0,8.0,0.0,Matches,404.0,br BRA,MF,26.0,29.9,118.0,3.94,57.0,44.0,2.0,9.0,6.0,0.0,12.0,0.4,5.0,5.0,0.0,2.0,0.0,0.0,Matches,,,,,,,,,,,,,,,,,,,,,,,,,,,,,,,,,,,,,,,,,,,,,,,,,,,,,,,,404.0,br BRA,MF,26.0,29.9,8.0,0.0,0.0,41.0,31.0,2.0,196.0,6.0,9.0,0.0,1.0,0.0,117.0,9.0,28.0,24.3,Matches,404.0,br BRA,MF,26.0,29.9,1068.0,826.0,231.0,81.0,1.0,21.0,196.0,6.0,116.0,51.0,50.0,0.0,701.0,11.0,39.0,Matches,404.0,br BRA,MF,26.0,29.9,701.0,1068.0,65.6,13078.0,4235.0,336.0,419.0,80.2,229.0,315.0,72.7,116.0,251.0,46.2,6.0,5.2,4.1,0.8,60.0,86.0,22.0,9.0,121.0,Matches,506,br BRA,MF,26,33,2692.0,82.0,78.7,29.9,33,82.0,7,0,,0,1.36,43.0,40.0,3.0,0.1,0.22,35.8,46.2,-10.4,-0.35,0.53,Matches,404.0,br BRA,MF,26.0,29.9,1312.0,14.0,106.0,608.0,613.0,65.0,1311.0,51.0,17.0,33.3,26.0,51.0,722.0,3951.0,1662.0,53.0,44.0,9.0,51.0,51.0,853.0,133.0,Matches,404.0,br BRA,MF,26.0,29.9,4.0,61.0,22.0,36.1,2.04,0.74,0.05,0.14,21.3,12.0,1.0,1.0,7.3,6.5,0.11,-3.3,-3.5,Matches,404.0,br BRA,MF,26.0,33.0,33.0,2692.0,29.9,4.0,6.0,10.0,3.0,1.0,1.0,8.0,0.0,7.3,6.5,5.2,11.7,53.0,121.0,133.0,0.13,0.2,0.33,0.1,0.3,0.24,0.17,0.42,0.22,0.39,Matches,Andreas Pereira,M/AM RLC,26,138,145,"Brazil,Belgium",Fulham,15,13,14,12,15,14,6,15,2,8,15,14,13,15,13,11,11,11,10,15,10,18,15,10,13,12,14,16,14,14,10,7,16,14,13,7,11,6,14,3,12,3,3,2,3,4,2,4,4,1,3,2,11,17,10,13,9,15,10,14,1,1,1,1,1,1,1,14,20,13,16,18,15,1,178,71,14,20,14418146,6500,6500,6000,Mediterranean_Hispanic,134,6,1996/1/1,1,0,57996.0,,28085588
452,Ivan Perišić,Tottenham,1989,407.0,hr CRO,DFMF,33.0,23.4,42.0,24.0,25.0,10.0,7.0,27.0,47.0,57.4,20.0,29.0,7.0,22.0,22.0,64.0,49.0,1.0,Matches,407.0,hr CRO,DFMF,33.0,23.4,75.0,3.2,55.0,16.0,1.0,2.0,1.0,0.0,11.0,0.47,7.0,3.0,1.0,0.0,0.0,0.0,Matches,,,,,,,,,,,,,,,,,,,,,,,,,,,,,,,,,,,,,,,,,,,,,,,,,,,,,,,,407.0,hr CRO,DFMF,33.0,23.4,6.0,0.0,0.0,30.0,8.0,6.0,196.0,22.0,24.0,0.0,0.0,0.0,117.0,33.0,32.0,50.8,Matches,407.0,hr CRO,DFMF,33.0,23.4,1121.0,895.0,221.0,16.0,0.0,13.0,196.0,138.0,67.0,57.0,6.0,0.0,713.0,5.0,43.0,Matches,407.0,hr CRO,DFMF,33.0,23.4,713.0,1121.0,63.6,12565.0,3575.0,357.0,443.0,80.6,249.0,389.0,64.0,91.0,210.0,43.3,8.0,6.1,5.2,1.9,48.0,29.0,36.0,24.0,61.0,Matches,509,hr CRO,DFMF,33,34,2108.0,62.0,61.6,23.4,23,83.0,10,11,18.0,3,1.41,40.0,44.0,-4.0,-0.17,-0.93,34.6,34.0,0.6,0.03,-0.44,Matches,407.0,hr CRO,DFMF,33.0,23.4,1370.0,73.0,357.0,443.0,583.0,94.0,1370.0,40.0,18.0,45.0,19.0,47.5,611.0,3704.0,2075.0,87.0,29.0,35.0,33.0,14.0,733.0,181.0,Matches,407.0,hr CRO,DFMF,33.0,23.4,1.0,29.0,8.0,27.6,1.24,0.34,0.03,0.13,15.3,2.0,0.0,0.0,2.6,2.6,0.09,-1.6,-1.6,Matches,407.0,hr CRO,DFMF,33.0,34.0,23.0,2108.0,23.4,1.0,8.0,9.0,1.0,0.0,0.0,6.0,0.0,2.6,2.6,6.1,8.8,87.0,61.0,181.0,0.04,0.34,0.38,0.04,0.38,0.11,0.26,0.37,0.11,0.37,Matches,Ivan Perišić,WB/AM L,33,156,159,Croatia,Tottenham Hotspur,11,13,12,15,15,12,16,12,9,12,13,14,12,14,14,15,11,13,13,13,13,14,12,11,17,13,10,14,15,14,13,14,17,15,15,12,14,8,19,6,18,2,3,1,3,2,1,1,1,1,3,3,15,17,13,9,18,12,8,10,1,12,1,1,20,1,1,15,1,10,17,10,13,12,186,80,16,20,347975206,7800,8200,7000,Northern_European,153,2,1989/2/2,113,32,208785.0,,34012563
453,Romain Perraud,Southampton,1997,408.0,fr FRA,DF,24.0,20.4,54.0,33.0,23.0,23.0,8.0,28.0,52.0,53.8,24.0,24.0,6.0,18.0,20.0,74.0,42.0,0.0,Matches,408.0,fr FRA,DF,24.0,20.4,38.0,1.86,23.0,1.0,4.0,8.0,1.0,1.0,5.0,0.25,3.0,0.0,1.0,0.0,1.0,0.0,Matches,,,,,,,,,,,,,,,,,,,,,,,,,,,,,,,,,,,,,,,,,,,,,,,,,,,,,,,,408.0,fr FRA,DF,24.0,20.4,4.0,0.0,0.0,31.0,15.0,3.0,77.0,20.0,33.0,0.0,0.0,1.0,97.0,14.0,23.0,37.8,Matches,408.0,fr FRA,DF,24.0,20.4,885.0,729.0,151.0,7.0,1.0,0.0,77.0,143.0,1.0,0.0,0.0,0.0,623.0,5.0,41.0,Matches,408.0,fr FRA,DF,24.0,20.4,623.0,885.0,70.4,8776.0,3419.0,377.0,443.0,85.1,200.0,270.0,74.1,26.0,91.0,28.6,2.0,1.9,1.9,0.1,15.0,47.0,15.0,8.0,62.0,Matches,511,fr FRA,DF,24,29,1835.0,63.0,53.7,20.4,22,78.0,12,7,16.0,2,0.59,15.0,35.0,-20.0,-0.98,-0.02,19.3,30.2,-10.9,-0.53,0.17,Matches,408.0,fr FRA,DF,24.0,20.4,1153.0,54.0,360.0,406.0,395.0,39.0,1153.0,38.0,10.0,26.3,25.0,65.8,609.0,2999.0,1388.0,33.0,35.0,5.0,27.0,14.0,626.0,122.0,Matches,408.0,fr FRA,DF,24.0,20.4,2.0,30.0,6.0,20.0,1.47,0.29,0.07,0.33,22.3,0.0,0.0,0.0,1.3,1.3,0.04,0.7,0.7,Matches,408.0,fr FRA,DF,24.0,29.0,22.0,1835.0,20.4,2.0,2.0,4.0,2.0,0.0,0.0,4.0,0.0,1.3,1.3,1.9,3.2,33.0,62.0,122.0,0.1,0.1,0.2,0.1,0.2,0.06,0.09,0.16,0.06,0.16,Matches,Romain Perraud,D/WB L,24,130,145,France,Southampton,10,14,12,8,12,13,8,16,8,10,12,10,12,14,14,13,14,13,13,13,13,15,12,8,15,13,14,15,13,14,15,7,15,13,15,10,14,8,13,6,13,2,3,3,1,1,4,1,1,3,3,2,12,14,7,14,13,14,11,13,1,20,1,1,17,1,1,13,1,1,13,1,1,1,173,68,20,8,12762841,6490,6490,4990,Northern_European,127,4,1997/9/22,0,0,46397.0,,48036809
454,Jordan Pickford,Everton,1994,413.0,eng ENG,GK,28.0,37.0,0.0,0.0,0.0,0.0,0.0,0.0,1.0,0.0,1.0,0.0,0.0,0.0,4.0,4.0,15.0,3.0,Matches,413.0,eng ENG,GK,28.0,37.0,10.0,0.27,4.0,6.0,0.0,0.0,0.0,0.0,1.0,0.03,1.0,0.0,0.0,0.0,0.0,0.0,Matches,28.0,eng ENG,GK,28.0,37.0,57.0,5.0,2.0,4.0,0.0,60.0,0.31,3.0,0.08,270.0,801.0,33.7,992.0,151.0,58.1,43.0,315.0,71.4,52.7,566.0,22.0,3.9,52.0,1.41,16.2,Matches,28.0,eng ENG,GK,28.0,37.0,37.0,3330.0,37.0,57.0,1.54,181.0,123.0,71.3,7.0,12.0,18.0,8.0,21.6,6.0,5.0,1.0,0.0,16.7,Matches,413.0,eng ENG,GK,28.0,37.0,6.0,0.0,0.0,1.0,5.0,0.0,0.0,4.0,0.0,0.0,1.0,0.0,36.0,8.0,3.0,72.7,Matches,413.0,eng ENG,GK,28.0,37.0,1312.0,823.0,484.0,169.0,1.0,7.0,0.0,0.0,0.0,0.0,0.0,0.0,749.0,5.0,1.0,Matches,413.0,eng ENG,GK,28.0,37.0,749.0,1312.0,57.1,25114.0,19603.0,158.0,159.0,99.4,242.0,247.0,98.0,342.0,892.0,38.3,1.0,0.1,0.4,0.9,2.0,57.0,1.0,0.0,2.0,Matches,517,eng ENG,GK,28,37,3330.0,90.0,97.4,37.0,37,90.0,37,0,,0,0.89,33.0,57.0,-24.0,-0.65,-1.65,44.8,64.5,-19.7,-0.53,0.14,Matches,413.0,eng ENG,GK,28.0,37.0,1413.0,1030.0,1359.0,57.0,0.0,0.0,1413.0,0.0,0.0,,0.0,,732.0,4810.0,3221.0,0.0,0.0,0.0,1.0,1.0,548.0,0.0,Matches,413.0,eng ENG,GK,28.0,37.0,0.0,0.0,0.0,,0.0,0.0,,,,0.0,0.0,0.0,0.0,0.0,,0.0,0.0,Matches,413.0,eng ENG,GK,28.0,37.0,37.0,3330.0,37.0,0.0,1.0,1.0,0.0,0.0,0.0,6.0,0.0,0.0,0.0,0.1,0.1,0.0,2.0,0.0,0.0,0.03,0.03,0.0,0.03,0.0,0.0,0.0,0.0,0.0,Matches,Jordan Pickford,GK,28,146,152,England,Everton,7,2,1,1,11,8,8,2,2,3,12,2,2,14,16,14,15,10,14,15,12,14,1,14,1,14,10,11,8,16,12,14,15,8,13,13,14,12,13,5,13,14,15,14,12,14,16,16,16,14,11,12,11,12,6,13,12,14,10,7,20,1,1,1,1,1,1,1,1,1,1,1,1,1,187,77,20,9,47368125,7300,7800,6250,Northern_European,146,1,1994/3/7,45,0,127591.0,,28054565
455,Ethan Pinnock,Brentford,1993,414.0,jm JAM,DF,29.0,30.0,52.0,28.0,33.0,12.0,7.0,18.0,24.0,75.0,6.0,41.0,31.0,10.0,35.0,87.0,215.0,2.0,Matches,414.0,jm JAM,DF,29.0,30.0,25.0,0.83,18.0,3.0,0.0,3.0,1.0,0.0,5.0,0.17,5.0,0.0,0.0,0.0,0.0,0.0,Matches,,,,,,,,,,,,,,,,,,,,,,,,,,,,,,,,,,,,,,,,,,,,,,,,,,,,,,,,414.0,jm JAM,DF,29.0,30.0,0.0,0.0,0.0,6.0,10.0,0.0,10.0,35.0,28.0,0.0,0.0,1.0,123.0,105.0,52.0,66.9,Matches,414.0,jm JAM,DF,29.0,30.0,1149.0,1088.0,57.0,14.0,0.0,3.0,10.0,43.0,0.0,0.0,0.0,0.0,914.0,4.0,5.0,Matches,414.0,jm JAM,DF,29.0,30.0,914.0,1149.0,79.5,16931.0,5712.0,333.0,391.0,85.2,480.0,559.0,85.9,84.0,160.0,52.5,0.0,1.0,1.1,-1.0,8.0,43.0,3.0,3.0,52.0,Matches,518,jm JAM,DF,29,30,2700.0,90.0,78.9,30.0,30,90.0,30,0,,0,1.63,43.0,34.0,9.0,0.3,-0.07,45.2,40.2,4.9,0.16,-0.06,Matches,414.0,jm JAM,DF,29.0,30.0,1554.0,327.0,927.0,497.0,134.0,55.0,1554.0,6.0,2.0,33.3,1.0,16.7,650.0,2705.0,1499.0,2.0,2.0,0.0,6.0,7.0,745.0,16.0,Matches,414.0,jm JAM,DF,29.0,30.0,3.0,15.0,8.0,53.3,0.5,0.27,0.2,0.38,10.0,0.0,0.0,0.0,3.0,3.0,0.21,0.0,0.0,Matches,414.0,jm JAM,DF,29.0,30.0,30.0,2700.0,30.0,3.0,0.0,3.0,3.0,0.0,0.0,0.0,0.0,3.0,3.0,1.0,4.0,2.0,52.0,16.0,0.1,0.0,0.1,0.1,0.1,0.1,0.03,0.13,0.1,0.13,Matches,Ethan Pinnock,D C,29,134,137,"Jamaica,England",Brentford,5,7,10,7,11,6,15,5,13,13,12,5,14,11,12,14,15,14,14,11,13,16,6,13,8,14,13,14,12,11,14,17,14,12,14,15,14,6,14,8,10,4,1,3,3,3,3,1,2,2,1,1,14,14,4,14,14,18,14,18,1,10,20,1,1,1,10,1,1,1,1,1,1,1,194,77,20,7,22664384,6700,6700,5350,African_Caribbean,134,12,1993/5/29,5,0,34798.0,,89040516
456,Daniel Podence,Wolves,1995,415.0,pt POR,FWMF,26.0,19.7,27.0,17.0,13.0,9.0,5.0,6.0,32.0,18.8,26.0,19.0,0.0,19.0,7.0,34.0,6.0,0.0,Matches,415.0,pt POR,FWMF,26.0,19.7,69.0,3.51,46.0,9.0,3.0,8.0,2.0,1.0,3.0,0.15,2.0,0.0,1.0,0.0,0.0,0.0,Matches,,,,,,,,,,,,,,,,,,,,,,,,,,,,,,,,,,,,,,,,,,,,,,,,,,,,,,,,415.0,pt POR,FWMF,26.0,19.7,5.0,0.0,0.0,26.0,23.0,4.0,56.0,7.0,17.0,0.0,0.0,0.0,87.0,6.0,12.0,33.3,Matches,415.0,pt POR,FWMF,26.0,19.7,663.0,609.0,51.0,8.0,9.0,7.0,56.0,11.0,26.0,9.0,8.0,0.0,445.0,3.0,19.0,Matches,415.0,pt POR,FWMF,26.0,19.7,445.0,663.0,67.1,7362.0,2311.0,227.0,301.0,75.4,140.0,209.0,67.0,51.0,90.0,56.7,0.0,2.5,2.2,-2.5,36.0,35.0,39.0,7.0,95.0,Matches,521,pt POR,FWMF,26,32,1771.0,55.0,51.8,19.7,20,74.0,8,12,24.0,3,0.81,13.0,31.0,-18.0,-0.91,-0.42,20.7,28.3,-7.6,-0.39,0.46,Matches,415.0,pt POR,FWMF,26.0,19.7,889.0,11.0,120.0,328.0,456.0,70.0,889.0,61.0,24.0,39.3,34.0,55.7,528.0,2670.0,1229.0,43.0,28.0,20.0,49.0,30.0,622.0,148.0,Matches,415.0,pt POR,FWMF,26.0,19.7,6.0,43.0,17.0,39.5,2.19,0.86,0.14,0.35,16.5,0.0,0.0,0.0,3.9,3.9,0.09,2.1,2.1,Matches,415.0,pt POR,FWMF,26.0,32.0,20.0,1771.0,19.7,6.0,0.0,6.0,6.0,0.0,0.0,5.0,0.0,3.9,3.9,2.5,6.4,43.0,95.0,148.0,0.3,0.0,0.3,0.3,0.3,0.2,0.13,0.33,0.2,0.33,Matches,Daniel Podence,AM RLC,26,135,142,Portugal,Wolverhampton Wanderers,12,13,17,9,16,10,4,8,4,6,13,10,5,16,15,11,13,9,9,14,9,15,18,6,14,6,8,14,16,17,16,3,14,16,14,5,12,13,12,11,6,1,2,3,1,3,1,1,2,3,3,1,12,13,9,8,12,11,8,10,1,1,1,1,1,1,1,14,1,14,20,15,20,10,165,58,8,20,21024479,6750,6700,5500,Mediterranean_Hispanic,130,5,1995/10/21,1,0,57996.0,,55063406
457,Nick Pope,Newcastle Utd,1992,416.0,eng ENG,GK,30.0,36.2,1.0,0.0,1.0,0.0,0.0,1.0,3.0,33.3,2.0,0.0,0.0,0.0,0.0,1.0,27.0,2.0,Matches,416.0,eng ENG,GK,30.0,36.2,5.0,0.14,4.0,1.0,0.0,0.0,0.0,0.0,0.0,0.0,0.0,0.0,0.0,0.0,0.0,0.0,Matches,29.0,eng ENG,GK,30.0,36.2,32.0,2.0,0.0,8.0,1.0,31.3,0.24,0.3,0.01,120.0,368.0,32.6,683.0,232.0,33.1,33.0,207.0,68.6,50.7,411.0,34.0,8.3,74.0,2.04,18.2,Matches,29.0,eng ENG,GK,30.0,37.0,37.0,3261.0,36.2,32.0,0.88,118.0,85.0,74.6,19.0,13.0,5.0,14.0,37.8,5.0,2.0,2.0,1.0,50.0,Matches,416.0,eng ENG,GK,30.0,36.2,3.0,1.0,0.0,1.0,2.0,0.0,0.0,0.0,0.0,0.0,0.0,0.0,30.0,4.0,1.0,80.0,Matches,416.0,eng ENG,GK,30.0,36.2,890.0,612.0,278.0,71.0,0.0,3.0,0.0,0.0,0.0,0.0,0.0,0.0,614.0,0.0,1.0,Matches,416.0,eng ENG,GK,30.0,36.2,614.0,890.0,69.0,17068.0,11723.0,121.0,122.0,99.2,275.0,283.0,97.2,212.0,478.0,44.4,0.0,0.1,0.0,-0.1,2.0,13.0,0.0,0.0,1.0,Matches,523,eng ENG,GK,30,37,3261.0,88.0,95.4,36.2,37,88.0,36,0,,0,1.89,67.0,32.0,35.0,0.97,0.97,68.4,36.3,32.0,0.88,0.71,Matches,416.0,eng ENG,GK,30.0,36.2,974.0,821.0,967.0,7.0,0.0,0.0,974.0,0.0,0.0,,0.0,,502.0,2949.0,1724.0,0.0,0.0,0.0,2.0,0.0,344.0,0.0,Matches,416.0,eng ENG,GK,30.0,36.2,0.0,0.0,0.0,,0.0,0.0,,,,0.0,0.0,0.0,0.0,0.0,,0.0,0.0,Matches,416.0,eng ENG,GK,30.0,37.0,37.0,3261.0,36.2,0.0,0.0,0.0,0.0,0.0,0.0,3.0,1.0,0.0,0.0,0.1,0.1,0.0,1.0,0.0,0.0,0.0,0.0,0.0,0.0,0.0,0.0,0.0,0.0,0.0,Matches,Nick Pope,GK,30,140,155,England,Newcastle United,1,2,3,3,7,2,3,1,1,2,10,3,3,7,8,15,13,9,14,6,12,14,4,8,2,15,15,15,8,13,12,18,10,9,10,13,16,8,10,1,2,17,16,15,2,16,8,16,15,13,12,11,10,13,2,8,13,14,10,12,20,1,1,1,1,1,1,1,1,1,1,1,1,1,196,78,13,20,45389195,7194,7144,5994,Northern_European,138,4,1992/4/19,8,0,115992.0,,29083750
458,Pedro Porro,Tottenham,1999,417.0,es ESP,DFMF,22.0,12.6,25.0,16.0,8.0,15.0,2.0,14.0,39.0,35.9,25.0,25.0,2.0,23.0,15.0,40.0,24.0,1.0,Matches,417.0,es ESP,DFMF,22.0,12.6,41.0,3.26,29.0,7.0,1.0,2.0,1.0,1.0,6.0,0.48,6.0,0.0,0.0,0.0,0.0,0.0,Matches,,,,,,,,,,,,,,,,,,,,,,,,,,,,,,,,,,,,,,,,,,,,,,,,,,,,,,,,417.0,es ESP,DFMF,22.0,12.6,0.0,0.0,0.0,12.0,16.0,1.0,77.0,15.0,16.0,0.0,0.0,0.0,85.0,1.0,11.0,8.3,Matches,417.0,es ESP,DFMF,22.0,12.6,648.0,525.0,121.0,6.0,7.0,4.0,77.0,91.0,24.0,12.0,12.0,0.0,465.0,2.0,29.0,Matches,417.0,es ESP,DFMF,22.0,12.6,465.0,648.0,71.8,7553.0,2604.0,241.0,272.0,88.6,168.0,221.0,76.0,43.0,98.0,43.9,3.0,3.0,2.3,0.0,25.0,28.0,23.0,14.0,39.0,Matches,524,es ESP,DFMF,22,15,1131.0,75.0,33.1,12.6,13,86.0,6,2,9.0,2,1.2,20.0,26.0,-6.0,-0.48,-0.99,19.4,19.9,-0.5,-0.04,-0.35,Matches,417.0,es ESP,DFMF,22.0,12.6,817.0,45.0,246.0,293.0,285.0,25.0,817.0,41.0,14.0,34.1,23.0,56.1,423.0,2283.0,1359.0,34.0,17.0,4.0,15.0,7.0,480.0,95.0,Matches,417.0,es ESP,DFMF,22.0,12.6,3.0,26.0,7.0,26.9,2.07,0.56,0.12,0.43,20.4,1.0,0.0,0.0,1.8,1.8,0.07,1.2,1.2,Matches,417.0,es ESP,DFMF,22.0,15.0,13.0,1131.0,12.6,3.0,3.0,6.0,3.0,0.0,0.0,0.0,0.0,1.8,1.8,3.0,4.8,34.0,39.0,95.0,0.24,0.24,0.48,0.24,0.48,0.15,0.24,0.38,0.15,0.38,Matches,Pedro Porro,D/WB/M R,22,150,164,Spain,Sporting Clube de Portugal,13,17,15,11,15,13,8,14,11,8,15,12,14,15,15,12,17,11,12,15,12,16,17,8,16,9,10,13,16,16,13,8,17,15,15,12,14,16,14,6,15,1,1,1,2,3,1,1,1,1,3,3,16,15,13,11,14,13,7,11,1,9,1,19,9,20,1,1,1,17,1,1,14,1,176,71,8,20,44668000,7500,6570,6318,Mediterranean_Hispanic,146,9,1999/9/13,1,0,31500.0,,67268221
459,Aaron Ramsdale,Arsenal,1998,421.0,eng ENG,GK,24.0,38.0,1.0,1.0,1.0,0.0,0.0,1.0,1.0,100.0,0.0,0.0,0.0,0.0,0.0,1.0,20.0,6.0,Matches,421.0,eng ENG,GK,24.0,38.0,3.0,0.08,3.0,0.0,0.0,0.0,0.0,0.0,0.0,0.0,0.0,0.0,0.0,0.0,0.0,0.0,Matches,30.0,eng ENG,GK,24.0,38.0,43.0,3.0,0.0,6.0,1.0,40.0,0.28,-2.0,-0.05,109.0,429.0,25.4,956.0,174.0,35.4,33.3,153.0,59.5,49.2,381.0,22.0,5.8,43.0,1.13,16.1,Matches,30.0,eng ENG,GK,24.0,38.0,38.0,3420.0,38.0,43.0,1.13,136.0,94.0,70.6,26.0,6.0,6.0,14.0,36.8,5.0,3.0,0.0,2.0,0.0,Matches,421.0,eng ENG,GK,24.0,38.0,1.0,0.0,0.0,0.0,4.0,0.0,0.0,0.0,1.0,0.0,0.0,0.0,33.0,6.0,0.0,100.0,Matches,421.0,eng ENG,GK,24.0,38.0,1111.0,872.0,237.0,83.0,0.0,6.0,0.0,1.0,0.0,0.0,0.0,0.0,761.0,2.0,3.0,Matches,421.0,eng ENG,GK,24.0,38.0,761.0,1111.0,68.5,18974.0,13109.0,190.0,196.0,96.9,383.0,390.0,98.2,186.0,519.0,35.8,0.0,0.0,0.0,0.0,0.0,30.0,2.0,0.0,8.0,Matches,529,eng ENG,GK,24,38,3420.0,90.0,100.0,38.0,38,90.0,38,0,,0,2.21,88.0,43.0,45.0,1.18,,71.7,42.0,29.7,0.78,,Matches,421.0,eng ENG,GK,24.0,38.0,1196.0,872.0,1170.0,28.0,0.0,0.0,1196.0,1.0,1.0,100.0,0.0,0.0,722.0,3934.0,2459.0,0.0,1.0,0.0,0.0,0.0,629.0,0.0,Matches,421.0,eng ENG,GK,24.0,38.0,0.0,0.0,0.0,,0.0,0.0,,,,0.0,0.0,0.0,0.0,0.0,,0.0,0.0,Matches,421.0,eng ENG,GK,24.0,38.0,38.0,3420.0,38.0,0.0,0.0,0.0,0.0,0.0,0.0,1.0,0.0,0.0,0.0,0.0,0.0,0.0,8.0,0.0,0.0,0.0,0.0,0.0,0.0,0.0,0.0,0.0,0.0,0.0,Matches,Aaron Ramsdale,GK,24,150,162,England,Arsenal,2,3,3,3,12,6,6,3,2,2,13,1,1,12,12,13,15,14,13,15,14,16,10,13,9,13,15,10,8,16,10,14,11,7,12,14,15,7,15,4,15,14,15,14,10,15,16,16,16,11,10,16,17,16,5,13,17,16,12,14,20,1,1,1,1,1,1,1,1,1,1,1,1,1,191,85,8,20,136841241,7500,7500,6400,Northern_European,152,1,1998/5/14,3,0,92793.0,,29137172
460,Jacob Ramsey,Aston Villa,2001,422.0,eng ENG,MFFW,21.0,29.3,69.0,39.0,23.0,35.0,11.0,32.0,69.0,46.4,37.0,48.0,8.0,40.0,23.0,92.0,34.0,0.0,Matches,422.0,eng ENG,MFFW,21.0,29.3,81.0,2.76,69.0,0.0,4.0,2.0,5.0,1.0,11.0,0.38,8.0,0.0,1.0,1.0,1.0,0.0,Matches,,,,,,,,,,,,,,,,,,,,,,,,,,,,,,,,,,,,,,,,,,,,,,,,,,,,,,,,422.0,eng ENG,MFFW,21.0,29.3,5.0,0.0,0.0,35.0,45.0,2.0,18.0,23.0,39.0,0.0,1.0,1.0,141.0,16.0,33.0,32.7,Matches,422.0,eng ENG,MFFW,21.0,29.3,889.0,880.0,3.0,2.0,3.0,3.0,18.0,1.0,0.0,0.0,0.0,0.0,728.0,6.0,26.0,Matches,422.0,eng ENG,MFFW,21.0,29.3,728.0,889.0,81.9,10240.0,2665.0,444.0,500.0,88.8,217.0,266.0,81.6,34.0,46.0,73.9,7.0,5.1,2.9,1.9,42.0,67.0,28.0,4.0,98.0,Matches,530,eng ENG,MFFW,21,35,2636.0,75.0,77.1,29.3,31,82.0,16,4,26.0,0,1.63,40.0,33.0,7.0,0.24,0.47,38.9,40.7,-1.9,-0.06,-0.02,Matches,422.0,eng ENG,MFFW,21.0,29.3,1245.0,57.0,238.0,609.0,422.0,85.0,1245.0,77.0,31.0,40.3,31.0,40.3,752.0,5322.0,2656.0,94.0,62.0,21.0,62.0,37.0,819.0,119.0,Matches,422.0,eng ENG,MFFW,21.0,29.3,6.0,33.0,13.0,39.4,1.13,0.44,0.18,0.46,15.9,0.0,0.0,0.0,5.0,5.0,0.15,1.0,1.0,Matches,422.0,eng ENG,MFFW,21.0,35.0,31.0,2636.0,29.3,6.0,7.0,13.0,6.0,0.0,0.0,5.0,0.0,5.0,5.0,5.1,10.1,94.0,98.0,119.0,0.2,0.24,0.44,0.2,0.44,0.17,0.17,0.34,0.17,0.34,Matches,Jacob Ramsey,M/AM C,21,134,-8,England,Aston Villa,8,10,15,13,13,7,9,12,7,10,13,9,10,14,9,12,14,14,11,13,12,13,13,8,12,10,14,14,14,14,12,11,13,14,14,13,13,9,12,7,11,2,4,1,1,1,1,3,3,2,3,1,10,13,5,14,10,13,11,13,1,1,1,1,1,1,1,1,20,1,10,20,1,1,180,61,12,20,76090578,6695,6695,5595,Mixed_Race,130,12,2001/5/28,0,0,81194.0,,29193659
461,Marcus Rashford,Manchester Utd,1997,423.0,eng ENG,FW,24.0,32.0,20.0,10.0,7.0,8.0,5.0,9.0,24.0,37.5,15.0,31.0,4.0,27.0,7.0,27.0,14.0,0.0,Matches,423.0,eng ENG,FW,24.0,32.0,98.0,3.06,61.0,1.0,17.0,14.0,4.0,1.0,14.0,0.44,8.0,0.0,3.0,2.0,1.0,0.0,Matches,,,,,,,,,,,,,,,,,,,,,,,,,,,,,,,,,,,,,,,,,,,,,,,,,,,,,,,,423.0,eng ENG,FW,24.0,32.0,2.0,0.0,0.0,15.0,23.0,15.0,24.0,7.0,10.0,0.0,0.0,0.0,100.0,20.0,40.0,33.3,Matches,423.0,eng ENG,FW,24.0,32.0,817.0,790.0,22.0,2.0,2.0,6.0,24.0,9.0,0.0,0.0,0.0,0.0,627.0,5.0,31.0,Matches,423.0,eng ENG,FW,24.0,32.0,627.0,817.0,76.7,8886.0,2180.0,409.0,480.0,85.2,146.0,187.0,78.1,41.0,64.0,64.1,5.0,3.4,2.8,1.6,30.0,38.0,53.0,2.0,88.0,Matches,533,eng ENG,FW,24,35,2879.0,82.0,84.2,32.0,32,86.0,19,3,42.0,0,1.89,48.0,39.0,9.0,0.28,-0.72,53.7,43.8,9.9,0.31,-0.91,Matches,423.0,eng ENG,FW,24.0,32.0,1212.0,22.0,102.0,429.0,704.0,183.0,1212.0,138.0,54.0,39.1,73.0,52.9,765.0,4830.0,2344.0,85.0,51.0,55.0,80.0,44.0,928.0,245.0,Matches,423.0,eng ENG,FW,24.0,32.0,17.0,108.0,49.0,45.4,3.38,1.53,0.16,0.35,16.4,7.0,0.0,0.0,15.4,15.4,0.15,1.6,1.6,Matches,423.0,eng ENG,FW,24.0,35.0,32.0,2879.0,32.0,17.0,5.0,22.0,17.0,0.0,0.0,2.0,0.0,15.4,15.4,3.4,18.8,85.0,88.0,245.0,0.53,0.16,0.69,0.53,0.69,0.48,0.11,0.59,0.48,0.59,Matches,Marcus Rashford,AM/S L,24,151,173,England,Manchester UFC,6,13,15,14,14,13,6,12,3,2,14,16,3,15,14,12,12,12,12,13,11,16,18,10,15,4,13,10,18,16,15,8,17,17,14,13,11,6,18,6,10,2,2,2,2,3,2,1,1,2,3,1,16,16,4,16,15,17,12,18,1,1,1,1,1,1,1,14,1,11,20,14,14,17,185,70,8,20,78771918,7750,7850,7000,African_Caribbean,144,13,1997/10/31,46,12,260981.0,,28100266
462,David Raya,Brentford,1995,424.0,es ESP,GK,26.0,38.0,0.0,0.0,0.0,0.0,0.0,0.0,2.0,0.0,2.0,1.0,0.0,1.0,1.0,1.0,10.0,3.0,Matches,424.0,es ESP,GK,26.0,38.0,12.0,0.32,9.0,3.0,0.0,0.0,0.0,0.0,2.0,0.05,1.0,1.0,0.0,0.0,0.0,0.0,Matches,31.0,es ESP,GK,26.0,38.0,46.0,2.0,1.0,9.0,3.0,48.1,0.24,5.1,0.13,347.0,882.0,39.3,1367.0,160.0,50.7,39.5,269.0,70.3,51.8,598.0,52.0,8.7,54.0,1.42,15.7,Matches,31.0,es ESP,GK,26.0,38.0,38.0,3420.0,38.0,46.0,1.21,197.0,154.0,77.7,15.0,14.0,9.0,12.0,31.6,2.0,2.0,0.0,0.0,0.0,Matches,424.0,es ESP,GK,26.0,38.0,1.0,0.0,0.0,0.0,6.0,0.0,0.0,1.0,0.0,0.0,0.0,1.0,47.0,12.0,2.0,85.7,Matches,424.0,es ESP,GK,26.0,38.0,1640.0,1181.0,455.0,185.0,0.0,19.0,0.0,1.0,0.0,0.0,0.0,0.0,1054.0,4.0,1.0,Matches,424.0,es ESP,GK,26.0,38.0,1054.0,1640.0,64.3,34961.0,26954.0,131.0,135.0,97.0,463.0,473.0,97.9,459.0,1026.0,44.7,0.0,0.1,0.2,-0.1,2.0,75.0,3.0,0.0,13.0,Matches,534,es ESP,GK,26,38,3420.0,90.0,100.0,38.0,38,90.0,38,0,,0,1.55,58.0,46.0,12.0,0.32,,56.6,49.8,6.7,0.18,,Matches,424.0,es ESP,GK,26.0,38.0,1722.0,1257.0,1616.0,108.0,1.0,1.0,1722.0,1.0,1.0,100.0,0.0,0.0,1030.0,5891.0,3795.0,0.0,0.0,0.0,0.0,0.0,808.0,0.0,Matches,424.0,es ESP,GK,26.0,38.0,0.0,1.0,0.0,0.0,0.03,0.0,0.0,,9.1,0.0,0.0,0.0,0.1,0.1,0.11,-0.1,-0.1,Matches,424.0,es ESP,GK,26.0,38.0,38.0,3420.0,38.0,0.0,0.0,0.0,0.0,0.0,0.0,1.0,0.0,0.1,0.1,0.1,0.3,0.0,13.0,0.0,0.0,0.0,0.0,0.0,0.0,0.0,0.0,0.01,0.0,0.01,Matches,David Raya,GK,26,140,149,Spain,Brentford,1,2,3,1,10,1,8,2,2,2,13,4,2,11,12,13,13,13,13,14,12,14,13,10,6,13,12,13,12,16,10,12,16,11,12,10,13,5,13,5,1,13,13,13,15,14,13,14,16,17,13,13,14,15,6,14,12,13,7,12,20,1,1,1,1,1,1,1,1,1,1,1,1,1,183,70,10,20,35167242,7250,7000,6000,Mediterranean_Hispanic,138,6,1995/9/15,1,0,46397.0,,29111433
463,Tim Ream,Fulham,1987,425.0,us USA,DF,34.0,32.2,30.0,16.0,15.0,12.0,3.0,13.0,26.0,50.0,13.0,45.0,24.0,21.0,41.0,71.0,116.0,3.0,Matches,425.0,us USA,DF,34.0,32.2,24.0,0.75,23.0,0.0,0.0,0.0,0.0,1.0,0.0,0.0,0.0,0.0,0.0,0.0,0.0,0.0,Matches,,,,,,,,,,,,,,,,,,,,,,,,,,,,,,,,,,,,,,,,,,,,,,,,,,,,,,,,425.0,us USA,DF,34.0,32.2,2.0,0.0,0.0,18.0,7.0,1.0,4.0,41.0,16.0,0.0,1.0,0.0,199.0,48.0,31.0,60.8,Matches,425.0,us USA,DF,34.0,32.2,1922.0,1858.0,59.0,34.0,0.0,25.0,4.0,11.0,0.0,0.0,0.0,0.0,1662.0,5.0,8.0,Matches,425.0,us USA,DF,34.0,32.2,1662.0,1922.0,86.5,35620.0,12543.0,420.0,472.0,89.0,961.0,1035.0,92.9,267.0,379.0,70.4,0.0,0.1,0.3,-0.1,3.0,148.0,0.0,0.0,142.0,Matches,535,us USA,DF,34,33,2897.0,88.0,84.7,32.2,33,88.0,31,0,,0,1.36,45.0,44.0,1.0,0.03,-0.14,38.7,52.6,-14.0,-0.43,0.16,Matches,425.0,us USA,DF,34.0,32.2,2193.0,312.0,1124.0,1021.0,61.0,14.0,2193.0,17.0,12.0,70.6,3.0,17.6,1364.0,7720.0,5069.0,28.0,13.0,0.0,15.0,5.0,1451.0,2.0,Matches,425.0,us USA,DF,34.0,32.2,1.0,3.0,2.0,66.7,0.09,0.06,0.33,0.5,9.8,0.0,0.0,0.0,0.3,0.3,0.09,0.7,0.7,Matches,425.0,us USA,DF,34.0,33.0,33.0,2897.0,32.2,1.0,0.0,1.0,1.0,0.0,0.0,2.0,0.0,0.3,0.3,0.1,0.4,28.0,142.0,2.0,0.03,0.0,0.03,0.03,0.03,0.01,0.0,0.01,0.01,0.01,Matches,Tim Ream,D LC,34,127,130,United States,Fulham,3,9,11,6,13,6,12,7,7,13,14,3,15,13,12,13,14,12,13,14,12,15,10,17,12,15,16,15,11,12,13,13,16,11,15,14,10,7,12,9,15,2,2,1,2,3,1,1,2,2,2,3,14,12,5,14,15,17,15,14,1,17,20,1,1,1,13,1,1,1,1,1,1,1,185,73,20,7,1416322,6743,6343,4993,Northern_European,127,4,1987/10/5,46,1,34798.0,,72021508
464,Harrison Reed,Fulham,1995,427.0,eng ENG,MF,27.0,31.8,44.0,27.0,17.0,21.0,6.0,16.0,51.0,31.4,35.0,54.0,12.0,42.0,19.0,63.0,36.0,0.0,Matches,427.0,eng ENG,MF,27.0,31.8,74.0,2.32,64.0,2.0,2.0,3.0,3.0,0.0,7.0,0.22,6.0,0.0,1.0,0.0,0.0,0.0,Matches,,,,,,,,,,,,,,,,,,,,,,,,,,,,,,,,,,,,,,,,,,,,,,,,,,,,,,,,427.0,eng ENG,MF,27.0,31.8,5.0,0.0,0.0,38.0,21.0,4.0,54.0,19.0,27.0,0.0,0.0,1.0,160.0,29.0,36.0,44.6,Matches,427.0,eng ENG,MF,27.0,31.8,1281.0,1225.0,51.0,14.0,0.0,4.0,54.0,5.0,3.0,2.0,1.0,0.0,988.0,5.0,46.0,Matches,427.0,eng ENG,MF,27.0,31.8,988.0,1281.0,77.1,15467.0,3661.0,517.0,612.0,84.5,355.0,421.0,84.3,76.0,133.0,57.1,4.0,4.1,2.0,-0.1,35.0,82.0,29.0,11.0,102.0,Matches,537,eng ENG,MF,27,37,2866.0,77.0,83.8,31.8,35,81.0,17,2,23.0,0,1.41,48.0,44.0,4.0,0.13,0.45,38.6,52.1,-13.5,-0.42,0.22,Matches,427.0,eng ENG,MF,27.0,31.8,1585.0,57.0,292.0,842.0,463.0,50.0,1585.0,28.0,10.0,35.7,16.0,57.1,765.0,3430.0,1141.0,30.0,22.0,4.0,44.0,25.0,972.0,107.0,Matches,427.0,eng ENG,MF,27.0,31.8,3.0,20.0,7.0,35.0,0.63,0.22,0.15,0.43,20.1,0.0,0.0,0.0,1.9,1.9,0.09,1.1,1.1,Matches,427.0,eng ENG,MF,27.0,37.0,35.0,2866.0,31.8,3.0,4.0,7.0,3.0,0.0,0.0,5.0,0.0,1.9,1.9,4.1,6.0,30.0,102.0,107.0,0.09,0.13,0.22,0.09,0.22,0.06,0.13,0.19,0.06,0.19,Matches,Harrison Reed,DM/M RC,27,139,145,England,Fulham,12,12,11,8,12,12,12,10,8,14,14,8,15,11,14,12,15,13,14,12,13,15,9,12,13,13,17,17,15,14,14,8,15,15,15,11,14,8,12,10,18,3,3,1,1,2,3,3,3,1,3,3,13,13,4,12,13,16,11,13,1,1,1,12,1,13,18,1,20,15,1,10,14,1,181,74,10,20,36272499,6950,6950,5250,Northern_European,137,4,1995/1/27,0,0,46397.0,,29076104
465,Declan Rice,West Ham,1999,429.0,eng ENG,MF,23.0,36.4,79.0,38.0,44.0,31.0,4.0,31.0,50.0,62.0,19.0,45.0,15.0,30.0,63.0,142.0,58.0,0.0,Matches,429.0,eng ENG,MF,23.0,36.4,100.0,2.75,86.0,7.0,1.0,1.0,2.0,3.0,6.0,0.16,6.0,0.0,0.0,0.0,0.0,0.0,Matches,,,,,,,,,,,,,,,,,,,,,,,,,,,,,,,,,,,,,,,,,,,,,,,,,,,,,,,,429.0,eng ENG,MF,23.0,36.4,5.0,0.0,0.0,23.0,11.0,1.0,44.0,63.0,38.0,0.0,0.0,0.0,334.0,37.0,26.0,58.7,Matches,429.0,eng ENG,MF,23.0,36.4,2135.0,2060.0,70.0,48.0,4.0,60.0,44.0,3.0,19.0,15.0,1.0,0.0,1846.0,5.0,26.0,Matches,429.0,eng ENG,MF,23.0,36.4,1846.0,2135.0,86.5,33652.0,9456.0,850.0,944.0,90.0,735.0,789.0,93.2,223.0,324.0,68.8,1.0,3.2,1.9,-2.2,37.0,233.0,13.0,3.0,240.0,Matches,540,eng ENG,MF,23,37,3273.0,88.0,95.7,36.4,36,90.0,36,1,33.0,0,1.08,42.0,50.0,-8.0,-0.22,2.84,48.7,48.6,0.1,0.0,2.41,Matches,429.0,eng ENG,MF,23.0,36.4,2475.0,123.0,670.0,1420.0,433.0,24.0,2474.0,65.0,37.0,56.9,23.0,35.4,1455.0,9170.0,4918.0,89.0,76.0,6.0,28.0,26.0,1642.0,37.0,Matches,429.0,eng ENG,MF,23.0,36.4,4.0,35.0,8.0,22.9,0.96,0.22,0.11,0.5,23.6,1.0,0.0,1.0,2.4,1.6,0.05,1.6,2.4,Matches,429.0,eng ENG,MF,23.0,37.0,36.0,3273.0,36.4,4.0,1.0,5.0,4.0,0.0,1.0,5.0,0.0,2.4,1.6,3.2,4.8,89.0,240.0,37.0,0.11,0.03,0.14,0.11,0.14,0.07,0.09,0.15,0.04,0.13,Matches,Declan Rice,D/DM/M C,23,162,178,"England,Republic of Ireland",West Ham United,7,11,14,9,14,8,12,9,10,14,15,11,17,14,13,15,14,17,15,14,15,17,10,16,16,17,16,17,13,13,13,12,18,13,17,13,17,12,15,6,16,2,2,3,2,1,2,1,1,3,2,1,12,16,5,15,14,15,16,14,1,1,16,1,1,1,20,1,19,1,1,1,1,1,185,80,11,20,92610121,8100,8100,7500,Northern_European,160,4,1999/1/14,32,2,69595.0,,28106491
466,Richarlison,Tottenham,1997,431.0,br BRA,MFFW,25.0,11.2,21.0,16.0,13.0,5.0,3.0,12.0,27.0,44.4,15.0,14.0,1.0,13.0,5.0,26.0,10.0,0.0,Matches,431.0,br BRA,MFFW,25.0,11.2,35.0,3.12,22.0,0.0,1.0,4.0,8.0,0.0,5.0,0.45,3.0,0.0,0.0,0.0,2.0,0.0,Matches,,,,,,,,,,,,,,,,,,,,,,,,,,,,,,,,,,,,,,,,,,,,,,,,,,,,,,,,431.0,br BRA,MFFW,25.0,11.2,3.0,0.0,0.0,14.0,22.0,9.0,16.0,5.0,16.0,2.0,0.0,0.0,52.0,18.0,29.0,38.3,Matches,431.0,br BRA,MFFW,25.0,11.2,279.0,270.0,9.0,0.0,4.0,1.0,16.0,0.0,0.0,0.0,0.0,0.0,196.0,0.0,13.0,Matches,431.0,br BRA,MFFW,25.0,11.2,196.0,279.0,70.3,2927.0,700.0,109.0,145.0,75.2,60.0,82.0,73.2,13.0,18.0,72.2,3.0,2.2,1.5,0.8,16.0,16.0,10.0,3.0,28.0,Matches,542,br BRA,MFFW,25,27,1010.0,37.0,29.5,11.2,12,65.0,1,15,15.0,2,1.59,22.0,18.0,4.0,0.36,0.24,18.2,15.3,2.9,0.25,0.08,Matches,431.0,br BRA,MFFW,25.0,11.2,441.0,11.0,78.0,172.0,200.0,62.0,441.0,34.0,12.0,35.3,18.0,52.9,260.0,1598.0,783.0,33.0,19.0,13.0,40.0,18.0,306.0,75.0,Matches,431.0,br BRA,MFFW,25.0,11.2,1.0,27.0,14.0,51.9,2.41,1.25,0.04,0.07,12.6,0.0,0.0,0.0,3.3,3.3,0.12,-2.3,-2.3,Matches,431.0,br BRA,MFFW,25.0,27.0,12.0,1010.0,11.2,1.0,3.0,4.0,1.0,0.0,0.0,3.0,0.0,3.3,3.3,2.2,5.5,33.0,28.0,75.0,0.09,0.27,0.36,0.09,0.36,0.29,0.19,0.49,0.29,0.49,Matches,Richarlison,AM/S RL,25,148,166,Brazil,Tottenham Hotspur,10,11,15,14,13,9,14,11,8,6,12,12,12,15,15,12,13,12,12,10,10,14,14,9,14,10,12,16,15,14,12,11,15,15,17,13,13,6,11,8,12,3,2,1,2,1,2,4,1,2,4,2,15,13,8,14,13,12,5,11,1,1,1,1,1,1,1,1,1,1,20,1,16,19,181,71,12,20,62635537,7500,7950,6693,Mediterranean_Hispanic,143,14,1997/5/10,36,14,202986.0,,19265858
467,Andrew Robertson,Liverpool,1994,434.0,sct SCO,DF,28.0,28.7,38.0,21.0,12.0,16.0,10.0,21.0,41.0,51.2,20.0,32.0,5.0,27.0,18.0,56.0,50.0,3.0,Matches,434.0,sct SCO,DF,28.0,28.7,95.0,3.31,59.0,27.0,1.0,4.0,1.0,3.0,13.0,0.45,9.0,4.0,0.0,0.0,0.0,0.0,Matches,,,,,,,,,,,,,,,,,,,,,,,,,,,,,,,,,,,,,,,,,,,,,,,,,,,,,,,,434.0,sct SCO,DF,28.0,28.7,3.0,0.0,0.0,22.0,10.0,7.0,195.0,18.0,21.0,0.0,0.0,0.0,174.0,22.0,24.0,47.8,Matches,434.0,sct SCO,DF,28.0,28.7,2265.0,1883.0,375.0,65.0,2.0,12.0,195.0,229.0,81.0,23.0,49.0,0.0,1803.0,7.0,41.0,Matches,434.0,sct SCO,DF,28.0,28.7,1803.0,2265.0,79.6,30554.0,9527.0,855.0,943.0,90.7,786.0,938.0,83.8,137.0,286.0,47.9,8.0,6.1,6.5,1.9,52.0,121.0,33.0,14.0,166.0,Matches,546,sct SCO,DF,28,34,2583.0,76.0,75.5,28.7,29,84.0,19,5,27.0,1,1.82,58.0,34.0,24.0,0.84,0.41,54.9,36.4,18.5,0.65,0.31,Matches,434.0,sct SCO,DF,28.0,28.7,2483.0,79.0,691.0,1084.0,727.0,59.0,2483.0,42.0,17.0,40.5,23.0,54.8,1385.0,6702.0,3934.0,80.0,60.0,10.0,31.0,7.0,1637.0,194.0,Matches,434.0,sct SCO,DF,28.0,28.7,0.0,13.0,2.0,15.4,0.45,0.07,0.0,0.0,14.5,0.0,0.0,0.0,1.3,1.3,0.11,-1.3,-1.3,Matches,434.0,sct SCO,DF,28.0,34.0,29.0,2583.0,28.7,0.0,8.0,8.0,0.0,0.0,0.0,3.0,0.0,1.3,1.3,6.1,7.4,80.0,166.0,194.0,0.0,0.28,0.28,0.0,0.28,0.05,0.21,0.26,0.05,0.26,Matches,Andrew Robertson,D/WB L,28,159,165,Scotland,Liverpool,14,16,12,5,15,9,10,6,13,15,14,7,15,14,17,14,15,15,14,13,15,16,11,15,14,14,16,17,16,14,14,9,17,16,18,12,16,13,15,6,6,2,1,2,2,1,1,3,1,3,2,1,15,16,8,16,15,15,10,13,1,19,1,1,20,1,1,14,1,1,12,1,1,1,178,64,20,4,200948518,8050,8050,7000,Northern_European,158,1,1994/3/11,59,3,185587.0,,61043456
468,Antonee Robinson,Fulham,1997,435.0,us USA,DF,24.0,34.3,62.0,38.0,43.0,15.0,4.0,44.0,65.0,67.7,21.0,49.0,13.0,36.0,53.0,115.0,83.0,3.0,Matches,435.0,us USA,DF,24.0,34.3,58.0,1.69,52.0,2.0,2.0,0.0,1.0,1.0,6.0,0.17,4.0,0.0,1.0,0.0,1.0,0.0,Matches,,,,,,,,,,,,,,,,,,,,,,,,,,,,,,,,,,,,,,,,,,,,,,,,,,,,,,,,435.0,us USA,DF,24.0,34.3,8.0,0.0,0.0,33.0,23.0,3.0,134.0,53.0,38.0,0.0,1.0,0.0,235.0,40.0,30.0,57.1,Matches,435.0,us USA,DF,24.0,34.3,1910.0,1582.0,327.0,18.0,0.0,5.0,134.0,309.0,0.0,0.0,0.0,0.0,1404.0,1.0,51.0,Matches,435.0,us USA,DF,24.0,34.3,1404.0,1910.0,73.5,24327.0,9684.0,625.0,725.0,86.2,612.0,792.0,77.3,137.0,294.0,46.6,1.0,1.3,1.8,-0.3,21.0,104.0,42.0,25.0,129.0,Matches,547,us USA,DF,24,35,3088.0,88.0,90.3,34.3,35,88.0,34,0,,0,1.4,50.0,44.0,6.0,0.17,1.26,43.1,54.2,-11.1,-0.32,1.41,Matches,435.0,us USA,DF,24.0,34.3,2260.0,125.0,778.0,938.0,580.0,29.0,2260.0,75.0,40.0,53.3,26.0,34.7,1174.0,7863.0,4290.0,113.0,87.0,10.0,40.0,20.0,1263.0,153.0,Matches,435.0,us USA,DF,24.0,34.3,0.0,3.0,0.0,0.0,0.09,0.0,0.0,,25.7,0.0,0.0,0.0,0.1,0.1,0.03,-0.1,-0.1,Matches,435.0,us USA,DF,24.0,35.0,35.0,3088.0,34.3,0.0,1.0,1.0,0.0,0.0,0.0,8.0,0.0,0.1,0.1,1.3,1.3,113.0,129.0,153.0,0.0,0.03,0.03,0.0,0.03,0.0,0.04,0.04,0.0,0.04,Matches,Antonee Robinson,D/WB L,24,139,142,"United States,England,Jamaica",Fulham,3,11,13,7,12,7,10,7,4,12,12,8,13,13,13,11,14,11,11,13,11,12,11,9,13,12,14,16,17,13,13,12,14,17,16,13,11,2,13,11,11,3,3,2,2,1,2,3,2,3,3,1,14,12,4,12,12,12,15,15,1,20,1,1,19,1,1,1,1,1,1,1,1,1,183,70,20,8,32454341,6950,6950,5500,African_Caribbean,129,12,1997/8/8,28,2,34798.0,,29125265
469,Marc Roca,Leeds United,1996,437.0,es ESP,MF,25.0,25.7,66.0,40.0,27.0,34.0,5.0,20.0,65.0,30.8,45.0,34.0,10.0,24.0,23.0,89.0,24.0,2.0,Matches,437.0,es ESP,MF,25.0,25.7,52.0,2.02,34.0,10.0,2.0,3.0,2.0,1.0,4.0,0.16,1.0,1.0,0.0,1.0,1.0,0.0,Matches,,,,,,,,,,,,,,,,,,,,,,,,,,,,,,,,,,,,,,,,,,,,,,,,,,,,,,,,437.0,es ESP,MF,25.0,25.7,7.0,0.0,0.0,40.0,29.0,0.0,76.0,23.0,40.0,0.0,0.0,0.0,169.0,18.0,13.0,58.1,Matches,437.0,es ESP,MF,25.0,25.7,1295.0,1188.0,102.0,55.0,7.0,10.0,76.0,3.0,40.0,20.0,16.0,0.0,978.0,5.0,17.0,Matches,437.0,es ESP,MF,25.0,25.7,978.0,1295.0,75.5,16572.0,6565.0,495.0,575.0,86.1,359.0,450.0,79.8,94.0,201.0,46.8,2.0,2.9,2.6,-0.9,33.0,157.0,17.0,2.0,172.0,Matches,550,es ESP,MF,25,32,2315.0,72.0,67.7,25.7,29,78.0,12,3,19.0,3,0.91,33.0,60.0,-27.0,-1.05,-0.81,31.4,48.1,-16.7,-0.65,-0.4,Matches,437.0,es ESP,MF,25.0,25.7,1571.0,47.0,333.0,914.0,333.0,26.0,1571.0,30.0,17.0,56.7,10.0,33.3,822.0,3627.0,1914.0,25.0,18.0,6.0,26.0,26.0,948.0,28.0,Matches,437.0,es ESP,MF,25.0,25.7,1.0,35.0,13.0,37.1,1.36,0.51,0.03,0.08,22.3,4.0,0.0,0.0,2.1,2.1,0.06,-1.1,-1.1,Matches,437.0,es ESP,MF,25.0,32.0,29.0,2315.0,25.7,1.0,2.0,3.0,1.0,0.0,0.0,7.0,0.0,2.1,2.1,2.9,5.0,25.0,172.0,28.0,0.04,0.08,0.12,0.04,0.12,0.08,0.11,0.19,0.08,0.19,Matches,Marc Roca,DM/M C,25,141,145,Spain,Leeds United,12,11,11,8,15,12,11,9,5,12,16,10,13,15,13,15,13,15,14,15,15,13,11,12,12,13,15,14,11,12,15,11,13,10,15,13,13,9,13,6,12,2,3,1,3,1,1,3,2,1,1,1,7,13,8,14,11,18,13,12,1,8,14,1,8,1,20,14,18,14,1,14,1,1,184,77,20,12,30060418,7050,7000,6000,Mediterranean_Hispanic,140,4,1996/11/26,0,0,75395.0,,67211094
470,Rodri,Manchester City,1996,439.0,es ESP,MF,26.0,32.3,67.0,41.0,28.0,28.0,11.0,26.0,53.0,49.1,27.0,40.0,14.0,26.0,33.0,100.0,43.0,1.0,Matches,439.0,es ESP,MF,26.0,32.3,92.0,2.84,80.0,0.0,4.0,6.0,1.0,1.0,10.0,0.31,10.0,0.0,0.0,0.0,0.0,0.0,Matches,,,,,,,,,,,,,,,,,,,,,,,,,,,,,,,,,,,,,,,,,,,,,,,,,,,,,,,,439.0,es ESP,MF,26.0,32.3,5.0,0.0,0.0,47.0,20.0,3.0,6.0,33.0,41.0,0.0,0.0,0.0,301.0,72.0,32.0,69.2,Matches,439.0,es ESP,MF,26.0,32.3,2987.0,2943.0,43.0,37.0,2.0,26.0,6.0,3.0,0.0,0.0,0.0,0.0,2723.0,1.0,21.0,Matches,439.0,es ESP,MF,26.0,32.3,2723.0,2987.0,91.2,49949.0,11936.0,1103.0,1187.0,92.9,1278.0,1369.0,93.4,300.0,354.0,84.7,6.0,4.1,3.5,1.9,32.0,265.0,33.0,3.0,260.0,Matches,553,es ESP,MF,26,36,2911.0,81.0,85.1,32.3,34,85.0,23,2,7.0,1,2.39,83.0,26.0,57.0,1.76,1.06,67.4,24.4,43.0,1.33,0.71,Matches,439.0,es ESP,MF,26.0,32.3,3272.0,119.0,706.0,1993.0,592.0,62.0,3272.0,37.0,25.0,67.6,8.0,21.6,2004.0,10293.0,5622.0,76.0,72.0,3.0,21.0,19.0,2511.0,37.0,Matches,439.0,es ESP,MF,26.0,32.3,2.0,50.0,14.0,28.0,1.55,0.43,0.04,0.14,17.1,0.0,0.0,0.0,4.6,4.6,0.09,-2.6,-2.6,Matches,439.0,es ESP,MF,26.0,36.0,34.0,2911.0,32.3,2.0,6.0,8.0,2.0,0.0,0.0,5.0,0.0,4.6,4.6,4.1,8.7,76.0,260.0,37.0,0.06,0.19,0.25,0.06,0.25,0.14,0.13,0.27,0.14,0.27,Matches,Rodri,DM C,26,175,175,Spain,Manchester City,7,8,13,9,15,8,13,14,8,12,15,8,17,14,13,18,15,17,16,14,18,13,9,11,13,17,16,16,14,13,12,17,16,13,17,16,17,10,15,4,10,3,1,4,2,3,2,2,2,1,1,1,15,16,6,13,15,18,13,16,1,1,1,1,1,1,20,1,15,1,1,1,1,1,191,75,13,20,347975206,8750,8150,8250,Mediterranean_Hispanic,173,7,1996/6/22,33,1,185587.0,,67217524
471,Rodrigo,Leeds United,1991,440.0,es ESP,FWMF,31.0,21.5,24.0,10.0,2.0,15.0,7.0,8.0,19.0,42.1,11.0,16.0,4.0,12.0,6.0,30.0,21.0,1.0,Matches,440.0,es ESP,FWMF,31.0,21.5,45.0,2.09,30.0,0.0,4.0,8.0,2.0,1.0,4.0,0.19,2.0,0.0,0.0,2.0,0.0,0.0,Matches,,,,,,,,,,,,,,,,,,,,,,,,,,,,,,,,,,,,,,,,,,,,,,,,,,,,,,,,440.0,es ESP,FWMF,31.0,21.5,6.0,0.0,0.0,29.0,11.0,10.0,21.0,6.0,10.0,0.0,0.0,0.0,66.0,34.0,66.0,34.0,Matches,440.0,es ESP,FWMF,31.0,21.5,550.0,492.0,53.0,0.0,4.0,10.0,21.0,7.0,2.0,0.0,0.0,0.0,389.0,5.0,9.0,Matches,440.0,es ESP,FWMF,31.0,21.5,389.0,550.0,70.7,5651.0,1138.0,219.0,277.0,79.1,110.0,158.0,69.6,32.0,56.0,57.1,1.0,1.8,1.3,-0.8,16.0,23.0,17.0,5.0,44.0,Matches,554,es ESP,FWMF,31,31,1935.0,62.0,56.6,21.5,23,74.0,7,8,28.0,0,0.87,28.0,43.0,-15.0,-0.7,0.21,26.4,37.4,-11.1,-0.51,0.01,Matches,440.0,es ESP,FWMF,31.0,21.5,804.0,26.0,94.0,372.0,341.0,110.0,803.0,29.0,12.0,41.4,15.0,51.7,451.0,2217.0,825.0,40.0,17.0,24.0,57.0,24.0,547.0,143.0,Matches,440.0,es ESP,FWMF,31.0,21.5,13.0,66.0,25.0,37.9,3.07,1.16,0.18,0.48,15.8,2.0,1.0,1.0,8.0,7.2,0.11,5.0,4.8,Matches,440.0,es ESP,FWMF,31.0,31.0,23.0,1935.0,21.5,13.0,1.0,14.0,12.0,1.0,1.0,6.0,0.0,8.0,7.2,1.8,9.0,40.0,44.0,143.0,0.6,0.05,0.65,0.56,0.6,0.37,0.08,0.46,0.34,0.42,Matches,Rodrigo,AM/S RLC,31,139,165,"Spain,Brazil",Leeds United,11,12,14,11,15,12,8,12,3,5,13,13,7,15,13,13,14,13,8,13,12,13,14,11,15,4,13,12,16,16,14,12,14,15,14,11,8,10,14,7,13,2,3,3,3,1,2,1,2,1,2,1,12,14,6,11,8,15,13,8,1,1,1,1,1,1,1,1,14,1,15,17,15,20,182,77,20,8,347975206,6946,7046,6496,Mixed_Race,129,12,1991/3/6,27,8,115992.0,,67086280
472,Mads Roerslev,Brentford,1999,441.0,dk DEN,DF,23.0,12.3,22.0,12.0,19.0,3.0,0.0,16.0,33.0,48.5,17.0,14.0,5.0,9.0,9.0,31.0,38.0,0.0,Matches,441.0,dk DEN,DF,23.0,12.3,13.0,1.06,13.0,0.0,0.0,0.0,0.0,0.0,1.0,0.08,1.0,0.0,0.0,0.0,0.0,0.0,Matches,,,,,,,,,,,,,,,,,,,,,,,,,,,,,,,,,,,,,,,,,,,,,,,,,,,,,,,,441.0,dk DEN,DF,23.0,12.3,0.0,0.0,0.0,4.0,3.0,0.0,20.0,9.0,12.0,0.0,0.0,0.0,48.0,8.0,12.0,40.0,Matches,441.0,dk DEN,DF,23.0,12.3,303.0,282.0,21.0,1.0,2.0,0.0,20.0,20.0,0.0,0.0,0.0,0.0,194.0,0.0,21.0,Matches,441.0,dk DEN,DF,23.0,12.3,194.0,303.0,64.0,2980.0,1071.0,110.0,143.0,76.9,62.0,84.0,73.8,15.0,44.0,34.1,0.0,1.2,0.8,-1.2,8.0,15.0,7.0,5.0,19.0,Matches,555,dk DEN,DF,23,20,1108.0,55.0,32.4,12.3,12,85.0,10,8,11.0,15,2.1,20.0,12.0,8.0,0.65,0.49,16.8,18.0,-1.2,-0.1,-0.4,Matches,441.0,dk DEN,DF,23.0,12.3,426.0,50.0,178.0,140.0,109.0,13.0,426.0,7.0,3.0,42.9,3.0,42.9,186.0,817.0,278.0,8.0,7.0,2.0,14.0,9.0,210.0,36.0,Matches,441.0,dk DEN,DF,23.0,12.3,0.0,3.0,0.0,0.0,0.24,0.0,0.0,,14.8,0.0,0.0,0.0,0.3,0.3,0.11,-0.3,-0.3,Matches,441.0,dk DEN,DF,23.0,20.0,12.0,1108.0,12.3,0.0,0.0,0.0,0.0,0.0,0.0,0.0,0.0,0.3,0.3,1.2,1.5,8.0,19.0,36.0,0.0,0.0,0.0,0.0,0.0,0.03,0.1,0.12,0.03,0.12,Matches,Mads Roerslev,D/WB R,23,129,141,Denmark,Brentford,12,14,13,9,13,7,12,9,9,13,14,7,13,14,13,13,14,14,14,13,12,14,13,9,11,13,14,14,13,13,12,12,12,13,13,12,13,7,13,6,13,2,1,2,3,1,3,1,3,3,3,2,12,13,5,13,11,13,14,12,1,7,10,20,5,17,1,1,1,12,1,1,1,1,184,67,9,20,12019169,6450,6000,4750,Northern_European,129,4,1999/6/24,0,0,23198.0,,27122563
473,Cristian Romero,Tottenham,1998,442.0,ar ARG,DF,24.0,26.3,68.0,36.0,42.0,24.0,2.0,29.0,46.0,63.0,17.0,40.0,18.0,22.0,44.0,112.0,102.0,3.0,Matches,442.0,ar ARG,DF,24.0,26.3,24.0,0.91,22.0,0.0,0.0,0.0,1.0,1.0,4.0,0.15,3.0,0.0,0.0,0.0,1.0,0.0,Matches,,,,,,,,,,,,,,,,,,,,,,,,,,,,,,,,,,,,,,,,,,,,,,,,,,,,,,,,442.0,ar ARG,DF,24.0,26.3,11.0,1.0,1.0,42.0,12.0,0.0,0.0,44.0,36.0,1.0,1.0,0.0,173.0,57.0,26.0,68.7,Matches,442.0,ar ARG,DF,24.0,26.3,1606.0,1523.0,80.0,60.0,4.0,20.0,0.0,19.0,0.0,0.0,0.0,0.0,1407.0,3.0,24.0,Matches,442.0,ar ARG,DF,24.0,26.3,1407.0,1606.0,87.6,25378.0,9085.0,562.0,618.0,90.9,698.0,746.0,93.6,119.0,176.0,67.6,1.0,1.2,1.0,-0.2,8.0,87.0,8.0,0.0,92.0,Matches,556,ar ARG,DF,24,27,2364.0,88.0,69.1,26.3,26,90.0,24,1,32.0,0,1.59,46.0,41.0,5.0,0.19,0.02,38.1,34.5,3.6,0.14,-0.19,Matches,442.0,ar ARG,DF,24.0,26.3,1923.0,299.0,976.0,849.0,111.0,17.0,1923.0,22.0,13.0,59.1,8.0,36.4,1150.0,5216.0,2993.0,19.0,25.0,1.0,19.0,10.0,1226.0,9.0,Matches,442.0,ar ARG,DF,24.0,26.3,0.0,11.0,2.0,18.2,0.42,0.08,0.0,0.0,12.3,0.0,0.0,0.0,1.5,1.5,0.13,-1.5,-1.5,Matches,442.0,ar ARG,DF,24.0,27.0,26.0,2364.0,26.3,0.0,1.0,1.0,0.0,0.0,0.0,11.0,1.0,1.5,1.5,1.2,2.6,19.0,92.0,9.0,0.0,0.04,0.04,0.0,0.04,0.06,0.05,0.1,0.06,0.1,Matches,Cristian Romero,D C,24,153,164,Argentina,Tottenham Hotspur,5,6,9,8,13,4,16,5,4,17,12,8,17,12,18,17,15,14,14,11,14,16,8,12,6,14,14,17,13,14,14,14,15,13,14,15,15,15,15,8,8,4,2,1,4,2,3,3,3,2,3,2,16,15,4,12,14,14,9,13,1,1,20,7,1,1,1,1,1,1,1,1,1,1,185,79,9,20,160448769,7650,7550,6400,Mediterranean_Hispanic,151,9,1998/4/27,11,1,202986.0,,14130029
474,Joe Rothwell,Bournemouth,1995,447.0,eng ENG,MF,27.0,11.3,20.0,13.0,7.0,12.0,1.0,7.0,21.0,33.3,14.0,14.0,3.0,11.0,9.0,29.0,7.0,0.0,Matches,447.0,eng ENG,MF,27.0,11.3,24.0,2.12,16.0,6.0,1.0,1.0,0.0,0.0,2.0,0.18,1.0,1.0,0.0,0.0,0.0,0.0,Matches,,,,,,,,,,,,,,,,,,,,,,,,,,,,,,,,,,,,,,,,,,,,,,,,,,,,,,,,447.0,eng ENG,MF,27.0,11.3,1.0,0.0,0.0,17.0,3.0,0.0,26.0,9.0,13.0,0.0,0.0,0.0,56.0,1.0,3.0,25.0,Matches,447.0,eng ENG,MF,27.0,11.3,457.0,402.0,54.0,24.0,4.0,2.0,26.0,1.0,21.0,12.0,4.0,3.0,385.0,1.0,6.0,Matches,447.0,eng ENG,MF,27.0,11.3,385.0,457.0,84.2,6524.0,1662.0,179.0,196.0,91.3,154.0,165.0,93.3,36.0,68.0,52.9,1.0,1.0,1.5,0.0,8.0,34.0,11.0,1.0,33.0,Matches,561,eng ENG,MF,27,20,1016.0,51.0,29.7,11.3,12,71.0,3,8,20.0,7,1.1,16.0,15.0,1.0,0.09,1.4,15.1,17.1,-2.0,-0.18,0.7,Matches,447.0,eng ENG,MF,27.0,11.3,538.0,19.0,131.0,309.0,105.0,5.0,538.0,23.0,16.0,69.6,7.0,30.4,285.0,1640.0,790.0,12.0,12.0,2.0,8.0,4.0,319.0,12.0,Matches,447.0,eng ENG,MF,27.0,11.3,0.0,3.0,2.0,66.7,0.27,0.18,0.0,0.0,24.1,1.0,0.0,0.0,0.1,0.1,0.05,-0.1,-0.1,Matches,447.0,eng ENG,MF,27.0,20.0,12.0,1016.0,11.3,0.0,1.0,1.0,0.0,0.0,0.0,1.0,0.0,0.1,0.1,1.0,1.2,12.0,33.0,12.0,0.0,0.09,0.09,0.0,0.09,0.01,0.09,0.1,0.01,0.1,Matches,Joe Rothwell,M C,27,128,135,England,AFC Bournemouth,13,10,15,11,13,11,6,11,4,5,11,11,11,14,8,11,12,9,10,13,9,15,14,9,14,9,14,16,17,14,14,10,16,15,12,11,12,4,9,12,8,2,1,2,3,4,2,2,1,2,1,3,8,11,4,10,10,15,10,10,1,1,1,1,1,1,13,11,20,11,14,15,11,1,185,77,12,20,14636600,6400,6400,4500,Northern_European,120,1,1995/1/11,0,0,34798.0,,28066821
475,José Sá,Wolves,1993,449.0,pt POR,GK,29.0,36.0,1.0,0.0,1.0,0.0,0.0,1.0,1.0,100.0,0.0,0.0,0.0,0.0,0.0,1.0,10.0,6.0,Matches,449.0,pt POR,GK,29.0,36.0,1.0,0.03,0.0,1.0,0.0,0.0,0.0,0.0,0.0,0.0,0.0,0.0,0.0,0.0,0.0,0.0,Matches,34.0,pt POR,GK,29.0,36.0,55.0,2.0,0.0,6.0,1.0,48.4,0.28,-5.6,-0.16,120.0,435.0,27.6,935.0,182.0,29.3,30.9,260.0,61.9,46.2,540.0,43.0,8.0,28.0,0.78,12.6,Matches,34.0,pt POR,GK,29.0,36.0,36.0,3240.0,36.0,55.0,1.53,161.0,105.0,67.1,11.0,7.0,18.0,11.0,30.6,4.0,2.0,2.0,0.0,50.0,Matches,449.0,pt POR,GK,29.0,36.0,2.0,0.0,0.0,1.0,8.0,0.0,0.0,0.0,0.0,0.0,1.0,0.0,45.0,6.0,1.0,85.7,Matches,449.0,pt POR,GK,29.0,36.0,1200.0,854.0,341.0,81.0,0.0,3.0,0.0,0.0,0.0,0.0,0.0,0.0,837.0,5.0,1.0,Matches,449.0,pt POR,GK,29.0,36.0,837.0,1200.0,69.8,20499.0,13561.0,203.0,206.0,98.5,450.0,463.0,97.2,182.0,522.0,34.9,0.0,0.0,0.0,0.0,0.0,10.0,0.0,0.0,0.0,Matches,563,pt POR,GK,29,36,3240.0,90.0,94.7,36.0,36,90.0,36,0,,2,1.11,30.0,55.0,-25.0,-0.69,0.31,34.9,54.7,-19.8,-0.55,1.07,Matches,449.0,pt POR,GK,29.0,36.0,1277.0,1153.0,1271.0,7.0,0.0,0.0,1277.0,2.0,2.0,100.0,0.0,0.0,731.0,4563.0,2991.0,0.0,0.0,0.0,4.0,0.0,585.0,0.0,Matches,449.0,pt POR,GK,29.0,36.0,0.0,0.0,0.0,,0.0,0.0,,,,0.0,0.0,0.0,0.0,0.0,,0.0,0.0,Matches,449.0,pt POR,GK,29.0,36.0,36.0,3240.0,36.0,0.0,0.0,0.0,0.0,0.0,0.0,2.0,0.0,0.0,0.0,0.0,0.0,0.0,0.0,0.0,0.0,0.0,0.0,0.0,0.0,0.0,0.0,0.0,0.0,0.0,Matches,José Sá,GK,29,141,145,Portugal,Wolverhampton Wanderers,6,2,3,3,9,9,8,2,3,3,9,5,3,8,9,15,16,13,12,10,13,15,5,11,3,14,16,10,9,14,12,13,13,9,13,12,12,5,15,10,11,14,15,14,13,14,13,15,16,13,12,13,10,14,6,12,15,16,9,14,20,1,1,1,1,1,1,1,1,1,1,1,1,1,192,84,8,20,30991542,6950,6500,5500,Mediterranean_Hispanic,140,5,1993/1/17,0,0,46397.0,,55038655
476,Allan Saint-Maximin,Newcastle Utd,1997,451.0,fr FRA,FW,25.0,12.4,10.0,3.0,3.0,6.0,1.0,2.0,11.0,18.2,9.0,4.0,0.0,4.0,5.0,15.0,2.0,0.0,Matches,451.0,fr FRA,FW,25.0,12.4,65.0,5.22,49.0,0.0,10.0,3.0,3.0,0.0,10.0,0.8,7.0,0.0,2.0,0.0,1.0,0.0,Matches,,,,,,,,,,,,,,,,,,,,,,,,,,,,,,,,,,,,,,,,,,,,,,,,,,,,,,,,451.0,fr FRA,FW,25.0,12.4,1.0,0.0,0.0,6.0,16.0,2.0,32.0,5.0,3.0,0.0,0.0,0.0,69.0,2.0,2.0,50.0,Matches,451.0,fr FRA,FW,25.0,12.4,447.0,435.0,9.0,1.0,4.0,3.0,32.0,7.0,1.0,0.0,0.0,0.0,316.0,3.0,17.0,Matches,451.0,fr FRA,FW,25.0,12.4,316.0,447.0,70.7,5087.0,1599.0,169.0,209.0,80.9,106.0,154.0,68.8,29.0,41.0,70.7,5.0,4.6,2.8,0.4,31.0,23.0,35.0,4.0,69.0,Matches,566,fr FRA,FW,25,25,1120.0,45.0,32.7,12.4,12,75.0,2,13,17.0,1,1.76,19.0,14.0,5.0,0.4,-0.77,22.7,13.0,9.7,0.78,-0.1,Matches,451.0,fr FRA,FW,25.0,12.4,598.0,5.0,69.0,198.0,348.0,77.0,598.0,99.0,57.0,57.6,33.0,33.3,435.0,4137.0,2512.0,93.0,51.0,41.0,31.0,30.0,456.0,111.0,Matches,451.0,fr FRA,FW,25.0,12.4,1.0,28.0,11.0,39.3,2.25,0.88,0.04,0.09,17.6,0.0,0.0,0.0,1.6,1.6,0.06,-0.6,-0.6,Matches,451.0,fr FRA,FW,25.0,25.0,12.0,1120.0,12.4,1.0,5.0,6.0,1.0,0.0,0.0,1.0,0.0,1.6,1.6,4.6,6.2,93.0,69.0,111.0,0.08,0.4,0.48,0.08,0.48,0.13,0.37,0.5,0.13,0.5,Matches,Allan Saint-Maximin,AM RL,25,150,165,"France,Guadeloupe",Newcastle United,12,13,19,10,15,11,5,10,4,2,12,12,3,16,7,10,9,12,12,13,12,11,19,10,13,6,11,10,16,16,12,6,14,17,13,14,12,6,12,12,15,2,3,2,2,2,1,2,2,1,1,3,7,15,7,12,10,13,14,15,1,1,1,1,1,1,1,15,1,15,20,14,19,15,173,67,8,20,71200836,7493,6745,5993,African_Caribbean,138,14,1997/3/12,0,0,104393.0,,85132406
477,Bukayo Saka,Arsenal,2001,452.0,eng ENG,FW,20.0,35.3,63.0,34.0,22.0,15.0,26.0,20.0,44.0,45.5,24.0,38.0,0.0,38.0,14.0,77.0,19.0,0.0,Matches,452.0,eng ENG,FW,20.0,35.3,161.0,4.56,106.0,27.0,8.0,11.0,7.0,2.0,28.0,0.79,20.0,4.0,2.0,1.0,0.0,1.0,Matches,,,,,,,,,,,,,,,,,,,,,,,,,,,,,,,,,,,,,,,,,,,,,,,,,,,,,,,,452.0,eng ENG,FW,20.0,35.3,6.0,0.0,0.0,43.0,65.0,9.0,172.0,14.0,34.0,0.0,0.0,0.0,127.0,16.0,38.0,29.6,Matches,452.0,eng ENG,FW,20.0,35.3,1430.0,1297.0,131.0,11.0,2.0,3.0,172.0,21.0,99.0,76.0,0.0,2.0,1054.0,2.0,62.0,Matches,452.0,eng ENG,FW,20.0,35.3,1054.0,1430.0,73.7,15405.0,3694.0,653.0,753.0,86.7,292.0,378.0,77.2,70.0,164.0,42.7,11.0,8.5,5.8,2.5,75.0,50.0,66.0,12.0,109.0,Matches,567,eng ENG,FW,20,38,3181.0,84.0,93.0,35.3,37,85.0,23,1,31.0,0,2.21,79.0,42.0,37.0,1.05,-1.97,64.2,39.4,24.8,0.7,-1.14,Matches,452.0,eng ENG,FW,20.0,35.3,1882.0,21.0,160.0,474.0,1270.0,237.0,1879.0,161.0,61.0,37.9,69.0,42.9,1191.0,8403.0,4557.0,179.0,92.0,84.0,78.0,59.0,1361.0,520.0,Matches,452.0,eng ENG,FW,20.0,35.3,14.0,86.0,29.0,33.7,2.43,0.82,0.14,0.41,16.3,1.0,2.0,3.0,11.2,9.1,0.11,2.8,2.9,Matches,452.0,eng ENG,FW,20.0,38.0,37.0,3181.0,35.3,14.0,11.0,25.0,12.0,2.0,3.0,6.0,0.0,11.2,9.1,8.5,17.6,179.0,109.0,520.0,0.4,0.31,0.71,0.34,0.65,0.32,0.24,0.56,0.26,0.5,Matches,Bukayo Saka,AM RL,20,161,177,"England,Nigeria",Arsenal,12,14,15,11,14,8,7,12,7,9,13,12,10,15,11,16,11,14,14,15,16,16,16,6,16,9,15,15,17,16,16,9,15,15,15,11,14,8,14,9,18,1,1,1,3,1,3,3,3,1,2,3,7,14,7,14,16,15,13,14,1,13,1,1,14,10,1,12,8,12,19,1,20,1,178,0,20,11,303538754,8050,8050,7000,African_Caribbean,160,19,2001/9/5,18,4,57996.0,,28122642
478,Mohamed Salah,Liverpool,1992,453.0,eg EGY,FW,30.0,36.6,21.0,12.0,4.0,5.0,12.0,10.0,26.0,38.5,16.0,21.0,0.0,21.0,6.0,27.0,4.0,0.0,Matches,453.0,eg EGY,FW,30.0,36.6,140.0,3.83,106.0,2.0,12.0,12.0,6.0,2.0,24.0,0.66,17.0,1.0,0.0,2.0,3.0,1.0,Matches,,,,,,,,,,,,,,,,,,,,,,,,,,,,,,,,,,,,,,,,,,,,,,,,,,,,,,,,453.0,eg EGY,FW,30.0,36.6,2.0,0.0,0.0,20.0,33.0,22.0,38.0,6.0,12.0,0.0,0.0,0.0,100.0,8.0,30.0,21.1,Matches,453.0,eg EGY,FW,30.0,36.6,1185.0,1146.0,29.0,4.0,14.0,3.0,38.0,17.0,0.0,0.0,0.0,0.0,902.0,10.0,40.0,Matches,453.0,eg EGY,FW,30.0,36.6,902.0,1185.0,76.1,12538.0,3403.0,533.0,648.0,82.3,283.0,352.0,80.4,38.0,66.0,57.6,12.0,7.7,7.2,4.3,65.0,53.0,80.0,7.0,149.0,Matches,568,eg EGY,FW,30,38,3290.0,87.0,96.2,36.6,37,88.0,29,1,26.0,0,1.76,74.0,45.0,29.0,0.79,1.49,70.6,46.8,23.8,0.65,2.12,Matches,453.0,eg EGY,FW,30.0,36.6,1634.0,4.0,83.0,539.0,1028.0,301.0,1630.0,135.0,51.0,37.8,72.0,53.3,1108.0,6393.0,3036.0,120.0,66.0,87.0,110.0,79.0,1305.0,421.0,Matches,453.0,eg EGY,FW,30.0,36.6,19.0,121.0,45.0,37.2,3.31,1.23,0.14,0.38,15.1,2.0,2.0,4.0,21.7,18.5,0.15,-2.7,-1.5,Matches,453.0,eg EGY,FW,30.0,38.0,37.0,3290.0,36.6,19.0,12.0,31.0,17.0,2.0,4.0,2.0,0.0,21.7,18.5,7.7,26.2,120.0,149.0,421.0,0.52,0.33,0.85,0.47,0.79,0.59,0.21,0.8,0.51,0.72,Matches,Mohamed Salah,AM/S RL,30,185,187,Egypt,Liverpool,12,14,17,17,17,12,10,13,6,7,15,17,7,17,11,16,11,15,15,17,15,18,15,11,18,9,15,16,18,16,18,8,17,18,15,15,15,6,16,4,7,3,2,2,1,2,1,3,2,3,3,2,16,19,8,13,16,18,16,17,1,1,1,1,1,1,1,1,1,1,17,12,20,19,175,72,20,8,347975206,9400,9445,8750,North_African__Middle_Eastern,181,9,1992/6/15,85,47,405971.0,,98028755
479,William Saliba,Arsenal,2001,454.0,fr FRA,DF,21.0,26.8,34.0,20.0,23.0,9.0,2.0,15.0,18.0,83.3,3.0,13.0,10.0,3.0,19.0,53.0,85.0,4.0,Matches,454.0,fr FRA,DF,21.0,26.8,14.0,0.52,11.0,2.0,1.0,0.0,0.0,0.0,2.0,0.07,2.0,0.0,0.0,0.0,0.0,0.0,Matches,,,,,,,,,,,,,,,,,,,,,,,,,,,,,,,,,,,,,,,,,,,,,,,,,,,,,,,,454.0,fr FRA,DF,21.0,26.8,4.0,0.0,0.0,19.0,13.0,0.0,1.0,19.0,20.0,0.0,2.0,1.0,206.0,53.0,43.0,55.2,Matches,454.0,fr FRA,DF,21.0,26.8,1865.0,1822.0,43.0,34.0,0.0,2.0,1.0,0.0,0.0,0.0,0.0,0.0,1698.0,0.0,8.0,Matches,454.0,fr FRA,DF,21.0,26.8,1698.0,1865.0,91.0,29692.0,11617.0,715.0,767.0,93.2,844.0,905.0,93.3,108.0,144.0,75.0,1.0,1.2,0.3,-0.2,6.0,111.0,3.0,0.0,99.0,Matches,569,fr FRA,DF,21,27,2415.0,89.0,70.6,26.8,27,89.0,26,0,,0,2.44,61.0,25.0,36.0,1.34,0.54,51.7,26.2,25.5,0.95,0.57,Matches,454.0,fr FRA,DF,21.0,26.8,2056.0,174.0,905.0,1094.0,64.0,15.0,2056.0,11.0,8.0,72.7,1.0,9.1,1323.0,6658.0,3908.0,13.0,14.0,1.0,15.0,6.0,1423.0,2.0,Matches,454.0,fr FRA,DF,21.0,26.8,2.0,6.0,3.0,50.0,0.22,0.11,0.33,0.67,13.8,0.0,0.0,0.0,0.9,0.9,0.15,1.1,1.1,Matches,454.0,fr FRA,DF,21.0,27.0,27.0,2415.0,26.8,2.0,1.0,3.0,2.0,0.0,0.0,4.0,0.0,0.9,0.9,1.2,2.1,13.0,99.0,2.0,0.07,0.04,0.11,0.07,0.11,0.03,0.04,0.08,0.03,0.08,Matches,William Saliba,D C,21,145,175,"France,Cameroon",Arsenal,6,10,10,9,12,6,16,11,6,14,13,10,15,12,15,13,14,13,13,10,13,14,11,10,8,13,16,14,14,13,15,16,14,14,14,16,14,14,14,8,7,1,1,1,2,1,1,1,2,2,1,1,15,15,6,11,14,14,13,13,1,1,20,14,1,1,1,1,1,1,1,1,1,1,192,83,10,20,102536694,7394,7394,5994,African_Caribbean,144,11,2001/3/24,5,0,46397.0,,49039004
480,Mohammed Salisu,Southampton,1999,455.0,gh GHA,DF,23.0,21.9,51.0,29.0,33.0,16.0,2.0,24.0,34.0,70.6,10.0,56.0,25.0,31.0,31.0,82.0,122.0,1.0,Matches,455.0,gh GHA,DF,23.0,21.9,25.0,1.14,16.0,5.0,1.0,3.0,0.0,0.0,3.0,0.14,1.0,1.0,0.0,1.0,0.0,0.0,Matches,,,,,,,,,,,,,,,,,,,,,,,,,,,,,,,,,,,,,,,,,,,,,,,,,,,,,,,,455.0,gh GHA,DF,23.0,21.9,5.0,0.0,0.0,26.0,3.0,1.0,13.0,31.0,29.0,0.0,0.0,1.0,158.0,55.0,26.0,67.9,Matches,455.0,gh GHA,DF,23.0,21.9,1196.0,1075.0,115.0,25.0,1.0,10.0,13.0,87.0,0.0,0.0,0.0,0.0,879.0,6.0,12.0,Matches,455.0,gh GHA,DF,23.0,21.9,879.0,1196.0,73.5,16118.0,7370.0,360.0,412.0,87.4,426.0,538.0,79.2,86.0,209.0,41.1,1.0,0.6,0.5,0.4,7.0,80.0,7.0,4.0,82.0,Matches,570,gh GHA,DF,23,22,1973.0,90.0,57.7,21.9,21,90.0,20,1,84.0,4,0.73,20.0,41.0,-21.0,-0.96,0.04,21.6,28.2,-6.5,-0.3,0.74,Matches,455.0,gh GHA,DF,23.0,21.9,1504.0,220.0,755.0,635.0,124.0,25.0,1504.0,11.0,8.0,72.7,3.0,27.3,725.0,3391.0,1556.0,5.0,11.0,0.0,5.0,9.0,757.0,4.0,Matches,455.0,gh GHA,DF,23.0,21.9,0.0,19.0,4.0,21.1,0.87,0.18,0.0,0.0,12.2,0.0,0.0,0.0,1.5,1.5,0.08,-1.5,-1.5,Matches,455.0,gh GHA,DF,23.0,22.0,21.0,1973.0,21.9,0.0,1.0,1.0,0.0,0.0,0.0,5.0,0.0,1.5,1.5,0.6,2.1,5.0,82.0,4.0,0.0,0.05,0.05,0.0,0.05,0.07,0.03,0.1,0.07,0.1,Matches,Mohammed Salisu,D C,23,144,160,Ghana,Southampton,7,9,10,6,11,6,16,8,14,14,11,6,16,12,12,15,14,12,14,12,12,14,9,12,9,15,15,15,14,13,12,15,13,14,15,16,14,9,13,8,11,2,1,1,3,1,1,2,1,4,1,2,9,8,8,12,12,11,11,13,1,11,20,1,1,1,1,1,1,1,1,1,1,1,191,82,20,7,48071035,7200,7200,5750,African_Caribbean,144,18,1999/4/17,0,0,46397.0,,67270690
481,Robert Sánchez,Brighton,1997,459.0,es ESP,GK,24.0,23.0,1.0,0.0,1.0,0.0,0.0,0.0,0.0,,0.0,0.0,0.0,0.0,3.0,4.0,9.0,2.0,Matches,459.0,es ESP,GK,24.0,23.0,2.0,0.09,2.0,0.0,0.0,0.0,0.0,0.0,0.0,0.0,0.0,0.0,0.0,0.0,0.0,0.0,Matches,35.0,es ESP,GK,24.0,23.0,30.0,5.0,0.0,4.0,3.0,24.2,0.25,-2.8,-0.12,60.0,205.0,29.3,645.0,103.0,24.2,28.9,131.0,37.4,35.1,229.0,17.0,7.4,13.0,0.57,12.3,Matches,35.0,es ESP,GK,24.0,23.0,23.0,2070.0,23.0,30.0,1.3,74.0,46.0,66.2,11.0,5.0,7.0,6.0,26.1,6.0,5.0,1.0,0.0,16.7,Matches,459.0,es ESP,GK,24.0,23.0,2.0,0.0,0.0,1.0,0.0,0.0,0.0,3.0,0.0,0.0,1.0,0.0,25.0,7.0,0.0,100.0,Matches,459.0,es ESP,GK,24.0,23.0,781.0,608.0,168.0,37.0,0.0,4.0,0.0,0.0,0.0,0.0,0.0,0.0,604.0,5.0,3.0,Matches,459.0,es ESP,GK,24.0,23.0,604.0,781.0,77.3,13655.0,8845.0,203.0,204.0,99.5,283.0,292.0,96.9,111.0,270.0,41.1,0.0,0.0,0.0,0.0,0.0,11.0,0.0,0.0,0.0,Matches,576,es ESP,GK,24,23,2070.0,90.0,60.5,23.0,23,90.0,23,0,,10,1.65,41.0,30.0,11.0,0.48,-0.06,38.9,27.0,11.9,0.52,-0.24,Matches,459.0,es ESP,GK,24.0,23.0,826.0,692.0,822.0,4.0,0.0,0.0,826.0,0.0,0.0,,0.0,,523.0,2418.0,1458.0,0.0,0.0,0.0,0.0,0.0,480.0,0.0,Matches,459.0,es ESP,GK,24.0,23.0,0.0,0.0,0.0,,0.0,0.0,,,,0.0,0.0,0.0,0.0,0.0,,0.0,0.0,Matches,459.0,es ESP,GK,24.0,23.0,23.0,2070.0,23.0,0.0,0.0,0.0,0.0,0.0,0.0,2.0,0.0,0.0,0.0,0.0,0.0,0.0,0.0,0.0,0.0,0.0,0.0,0.0,0.0,0.0,0.0,0.0,0.0,0.0,Matches,Robert Sánchez,GK,24,139,160,Spain,Brighton & Hove Albion,6,3,1,3,11,8,1,1,3,2,13,1,2,13,8,11,14,13,11,9,10,10,9,7,3,11,12,9,12,13,12,18,14,10,12,14,10,3,9,13,15,17,17,11,11,15,15,13,15,14,10,14,20,11,3,11,11,10,8,14,20,1,1,1,1,1,1,1,1,1,1,1,1,1,197,91,12,20,26813230,6934,6934,5484,Mixed_Race,136,14,1997/11/18,1,0,28998.0,,29156212
482,Jadon Sancho,Manchester Utd,2000,460.0,eng ENG,FWMF,22.0,18.7,16.0,10.0,7.0,5.0,4.0,8.0,28.0,28.6,20.0,25.0,2.0,23.0,7.0,23.0,6.0,0.0,Matches,460.0,eng ENG,FWMF,22.0,18.7,87.0,4.64,80.0,1.0,4.0,2.0,0.0,0.0,9.0,0.48,7.0,0.0,2.0,0.0,0.0,0.0,Matches,,,,,,,,,,,,,,,,,,,,,,,,,,,,,,,,,,,,,,,,,,,,,,,,,,,,,,,,460.0,eng ENG,FWMF,22.0,18.7,0.0,0.0,0.0,9.0,10.0,8.0,17.0,7.0,10.0,0.0,0.0,0.0,109.0,2.0,12.0,14.3,Matches,460.0,eng ENG,FWMF,22.0,18.7,776.0,760.0,14.0,0.0,4.0,3.0,17.0,8.0,5.0,2.0,0.0,0.0,647.0,2.0,28.0,Matches,460.0,eng ENG,FWMF,22.0,18.7,647.0,776.0,83.4,7890.0,1794.0,450.0,504.0,89.3,140.0,164.0,85.4,15.0,26.0,57.7,3.0,5.0,4.1,-2.0,43.0,23.0,40.0,1.0,76.0,Matches,577,eng ENG,FWMF,22,26,1686.0,65.0,49.3,18.7,21,74.0,4,5,28.0,4,1.92,30.0,18.0,12.0,0.64,0.48,37.8,24.8,13.0,0.69,0.47,Matches,460.0,eng ENG,FWMF,22.0,18.7,977.0,16.0,118.0,339.0,536.0,106.0,977.0,78.0,33.0,42.3,40.0,51.3,640.0,3825.0,2193.0,88.0,39.0,45.0,50.0,20.0,715.0,173.0,Matches,460.0,eng ENG,FWMF,22.0,18.7,6.0,21.0,9.0,42.9,1.12,0.48,0.29,0.67,14.1,0.0,0.0,0.0,4.2,4.2,0.2,1.8,1.8,Matches,460.0,eng ENG,FWMF,22.0,26.0,21.0,1686.0,18.7,6.0,3.0,9.0,6.0,0.0,0.0,0.0,0.0,4.2,4.2,5.0,9.2,88.0,76.0,173.0,0.32,0.16,0.48,0.32,0.48,0.22,0.27,0.49,0.22,0.49,Matches,Jadon Sancho,M/AM RL,22,155,177,"England,Trinidad and Tobago",Manchester UFC,13,13,18,14,16,13,5,10,6,7,16,12,7,18,10,15,9,14,12,15,14,13,16,6,15,6,13,13,15,18,14,9,13,15,13,8,11,5,15,6,14,1,2,2,3,2,3,2,1,2,3,4,12,17,14,9,14,12,13,10,1,1,1,1,1,1,1,20,1,18,20,14,18,10,180,76,9,20,142837290,7747,7497,6747,Mixed_Race,148,12,2000/3/25,23,3,318977.0,,28108490
483,Gianluca Scamacca,West Ham,1999,464.0,it ITA,FW,23.0,10.3,10.0,5.0,1.0,3.0,6.0,2.0,2.0,100.0,0.0,3.0,0.0,3.0,4.0,14.0,5.0,0.0,Matches,464.0,it ITA,FW,23.0,10.3,24.0,2.33,20.0,0.0,1.0,2.0,0.0,1.0,1.0,0.1,1.0,0.0,0.0,0.0,0.0,0.0,Matches,,,,,,,,,,,,,,,,,,,,,,,,,,,,,,,,,,,,,,,,,,,,,,,,,,,,,,,,464.0,it ITA,FW,23.0,10.3,3.0,0.0,0.0,16.0,10.0,6.0,1.0,4.0,5.0,0.0,0.0,0.0,23.0,17.0,21.0,44.7,Matches,464.0,it ITA,FW,23.0,10.3,177.0,173.0,3.0,0.0,0.0,8.0,1.0,0.0,0.0,0.0,0.0,0.0,118.0,1.0,7.0,Matches,464.0,it ITA,FW,23.0,10.3,118.0,177.0,66.7,2014.0,378.0,63.0,85.0,74.1,31.0,52.0,59.6,17.0,21.0,81.0,0.0,0.7,0.5,-0.7,13.0,14.0,5.0,1.0,17.0,Matches,584,it ITA,FW,23,16,926.0,58.0,27.1,10.3,11,73.0,3,5,24.0,4,0.88,9.0,12.0,-3.0,-0.29,0.07,13.4,11.4,2.0,0.19,0.41,Matches,464.0,it ITA,FW,23.0,10.3,273.0,5.0,13.0,136.0,127.0,38.0,273.0,15.0,7.0,46.7,6.0,40.0,143.0,660.0,282.0,13.0,7.0,3.0,23.0,19.0,203.0,48.0,Matches,464.0,it ITA,FW,23.0,10.3,3.0,30.0,10.0,33.3,2.92,0.97,0.1,0.3,18.7,1.0,0.0,0.0,2.5,2.5,0.08,0.5,0.5,Matches,464.0,it ITA,FW,23.0,16.0,11.0,926.0,10.3,3.0,0.0,3.0,3.0,0.0,0.0,3.0,0.0,2.5,2.5,0.7,3.1,13.0,17.0,48.0,0.29,0.0,0.29,0.29,0.29,0.24,0.07,0.31,0.24,0.31,Matches,Gianluca Scamacca,S,23,142,161,Italy,West Ham United,4,5,11,17,14,13,16,16,4,4,12,12,5,14,14,14,14,13,13,12,13,16,16,12,15,4,14,14,11,12,16,16,15,13,14,16,14,8,13,5,7,1,3,3,1,1,2,2,2,3,3,2,10,16,9,9,13,14,9,9,1,1,1,1,1,1,1,1,1,1,1,1,1,20,195,85,12,20,52126681,7100,7350,5250,Mediterranean_Hispanic,141,3,1999/1/1,7,0,81194.0,,37053643
484,Fabian Schär,Newcastle Utd,1991,467.0,ch SUI,DF,30.0,35.6,47.0,22.0,31.0,13.0,3.0,24.0,39.0,61.5,15.0,34.0,19.0,15.0,52.0,99.0,139.0,0.0,Matches,467.0,ch SUI,DF,30.0,35.6,59.0,1.66,43.0,0.0,2.0,9.0,2.0,3.0,8.0,0.22,5.0,0.0,0.0,0.0,1.0,2.0,Matches,,,,,,,,,,,,,,,,,,,,,,,,,,,,,,,,,,,,,,,,,,,,,,,,,,,,,,,,467.0,ch SUI,DF,30.0,35.6,7.0,0.0,0.0,20.0,27.0,6.0,18.0,52.0,22.0,0.0,0.0,1.0,209.0,112.0,55.0,67.1,Matches,467.0,ch SUI,DF,30.0,35.6,1846.0,1770.0,73.0,62.0,7.0,34.0,18.0,10.0,0.0,0.0,0.0,0.0,1423.0,3.0,19.0,Matches,467.0,ch SUI,DF,30.0,35.6,1423.0,1846.0,77.1,29289.0,11775.0,480.0,560.0,85.7,734.0,851.0,86.3,199.0,386.0,51.6,3.0,3.3,2.1,-0.3,19.0,142.0,23.0,4.0,139.0,Matches,587,ch SUI,DF,30,36,3206.0,89.0,93.7,35.6,36,89.0,32,0,,1,1.97,67.0,28.0,39.0,1.09,2.78,69.7,35.6,34.1,0.96,1.7,Matches,467.0,ch SUI,DF,30.0,35.6,2235.0,248.0,1101.0,938.0,213.0,73.0,2235.0,13.0,4.0,30.8,7.0,53.8,1214.0,6337.0,4115.0,27.0,26.0,3.0,20.0,7.0,1341.0,32.0,Matches,467.0,ch SUI,DF,30.0,35.6,1.0,56.0,14.0,25.0,1.57,0.39,0.02,0.07,14.4,3.0,0.0,0.0,4.9,4.9,0.09,-3.9,-3.9,Matches,467.0,ch SUI,DF,30.0,36.0,36.0,3206.0,35.6,1.0,3.0,4.0,1.0,0.0,0.0,7.0,0.0,4.9,4.9,3.3,8.2,27.0,139.0,32.0,0.03,0.08,0.11,0.03,0.11,0.14,0.09,0.23,0.14,0.23,Matches,Fabian Schär,D C,30,138,138,Switzerland,Newcastle United,6,9,12,10,13,12,15,12,8,15,13,14,15,12,17,13,13,14,14,14,12,12,9,11,9,15,16,12,10,10,12,14,12,13,13,15,12,15,14,10,4,4,2,3,2,2,1,2,1,1,2,2,10,13,6,12,14,15,14,16,1,1,20,10,1,8,13,1,1,1,1,1,1,1,188,84,12,20,38768484,6900,6750,5500,Northern_European,138,5,1991/12/20,71,8,52196.0,,98007212
485,Jeffrey Schlupp,Crystal Palace,1992,468.0,gh GHA,MFFW,29.0,28.1,66.0,46.0,28.0,29.0,9.0,22.0,43.0,51.2,21.0,39.0,8.0,31.0,23.0,89.0,38.0,0.0,Matches,468.0,gh GHA,MFFW,29.0,28.1,44.0,1.56,34.0,0.0,3.0,5.0,1.0,1.0,5.0,0.18,2.0,0.0,0.0,1.0,1.0,1.0,Matches,,,,,,,,,,,,,,,,,,,,,,,,,,,,,,,,,,,,,,,,,,,,,,,,,,,,,,,,468.0,gh GHA,MFFW,29.0,28.1,7.0,0.0,0.0,51.0,33.0,0.0,16.0,23.0,46.0,0.0,0.0,0.0,150.0,26.0,44.0,37.1,Matches,468.0,gh GHA,MFFW,29.0,28.1,900.0,854.0,40.0,12.0,3.0,1.0,16.0,24.0,0.0,0.0,0.0,0.0,665.0,6.0,21.0,Matches,468.0,gh GHA,MFFW,29.0,28.1,665.0,900.0,73.9,10562.0,2798.0,338.0,418.0,80.9,254.0,312.0,81.4,52.0,104.0,50.0,1.0,1.4,1.0,-0.4,18.0,59.0,11.0,0.0,98.0,Matches,588,gh GHA,MFFW,29,34,2531.0,74.0,74.0,28.1,30,81.0,11,4,23.0,0,1.18,33.0,38.0,-5.0,-0.18,0.23,29.5,36.4,-6.9,-0.25,-0.05,Matches,468.0,gh GHA,MFFW,29.0,28.1,1193.0,63.0,281.0,640.0,293.0,48.0,1193.0,56.0,30.0,53.6,19.0,33.9,602.0,3035.0,1232.0,32.0,25.0,11.0,33.0,33.0,707.0,67.0,Matches,468.0,gh GHA,MFFW,29.0,28.1,3.0,28.0,9.0,32.1,1.0,0.32,0.11,0.33,17.5,0.0,0.0,0.0,3.2,3.2,0.12,-0.2,-0.2,Matches,468.0,gh GHA,MFFW,29.0,34.0,30.0,2531.0,28.1,3.0,1.0,4.0,3.0,0.0,0.0,7.0,0.0,3.2,3.2,1.4,4.6,32.0,98.0,67.0,0.11,0.04,0.14,0.11,0.14,0.11,0.05,0.17,0.11,0.17,Matches,Jeffrey Schlupp,M/AM LC,29,133,137,"Ghana,Germany,England",Crystal Palace,9,11,13,12,12,9,10,9,10,12,11,10,11,13,10,13,14,13,12,10,11,13,12,8,13,12,15,14,15,15,13,11,13,15,15,12,11,9,10,13,18,3,1,1,3,1,1,3,1,2,1,1,16,11,9,10,14,13,11,12,1,12,1,1,14,1,13,20,16,8,17,11,10,11,178,74,20,8,10446929,6649,6649,5499,African_Caribbean,128,17,1992/12/23,19,1,69595.0,,29045055
486,Nélson Semedo,Wolves,1993,469.0,pt POR,DF,28.0,29.2,71.0,42.0,48.0,19.0,4.0,33.0,64.0,51.6,31.0,42.0,15.0,27.0,29.0,100.0,83.0,2.0,Matches,469.0,pt POR,DF,28.0,29.2,35.0,1.2,28.0,0.0,0.0,4.0,3.0,0.0,3.0,0.1,3.0,0.0,0.0,0.0,0.0,0.0,Matches,,,,,,,,,,,,,,,,,,,,,,,,,,,,,,,,,,,,,,,,,,,,,,,,,,,,,,,,469.0,pt POR,DF,28.0,29.2,11.0,1.0,0.0,47.0,24.0,0.0,60.0,29.0,42.0,0.0,0.0,0.0,167.0,30.0,37.0,44.8,Matches,469.0,pt POR,DF,28.0,29.2,1499.0,1263.0,233.0,6.0,4.0,1.0,60.0,227.0,0.0,0.0,0.0,0.0,1211.0,3.0,34.0,Matches,469.0,pt POR,DF,28.0,29.2,1211.0,1499.0,80.8,18149.0,6122.0,706.0,772.0,91.5,427.0,525.0,81.3,59.0,126.0,46.8,1.0,0.7,0.9,0.3,11.0,103.0,15.0,5.0,110.0,Matches,590,pt POR,DF,28,36,2632.0,73.0,77.0,29.2,31,83.0,23,5,15.0,1,1.06,25.0,42.0,-17.0,-0.58,0.56,25.0,49.0,-24.0,-0.82,-0.93,Matches,469.0,pt POR,DF,28.0,29.2,1858.0,139.0,589.0,837.0,451.0,29.0,1858.0,73.0,33.0,45.2,33.0,45.2,998.0,5308.0,2691.0,50.0,42.0,5.0,42.0,19.0,1087.0,147.0,Matches,469.0,pt POR,DF,28.0,29.2,0.0,9.0,0.0,0.0,0.31,0.0,0.0,,20.5,0.0,0.0,0.0,0.4,0.4,0.05,-0.4,-0.4,Matches,469.0,pt POR,DF,28.0,36.0,31.0,2632.0,29.2,0.0,1.0,1.0,0.0,0.0,0.0,11.0,1.0,0.4,0.4,0.7,1.2,50.0,110.0,147.0,0.0,0.03,0.03,0.0,0.03,0.01,0.03,0.04,0.01,0.04,Matches,Nélson Semedo,D/WB R,28,148,164,"Portugal,Cape Verde Islands",Wolverhampton Wanderers,8,12,15,9,15,8,7,10,11,11,12,8,14,15,13,14,14,10,12,12,11,15,14,6,15,12,14,15,17,16,14,8,15,16,15,13,13,11,15,7,15,3,1,2,2,3,1,3,2,2,2,3,16,13,10,14,15,15,13,10,1,13,1,20,10,20,1,1,1,10,1,1,10,1,177,69,10,20,38922317,7400,7350,6200,African_Caribbean,139,13,1993/11/16,24,0,98593.0,,55061470
487,Marcos Senesi,Bournemouth,1997,471.0,ar ARG,DF,25.0,27.7,50.0,35.0,28.0,22.0,0.0,23.0,44.0,52.3,21.0,38.0,20.0,18.0,43.0,93.0,146.0,2.0,Matches,471.0,ar ARG,DF,25.0,27.7,16.0,0.58,14.0,1.0,0.0,1.0,0.0,0.0,3.0,0.11,3.0,0.0,0.0,0.0,0.0,0.0,Matches,,,,,,,,,,,,,,,,,,,,,,,,,,,,,,,,,,,,,,,,,,,,,,,,,,,,,,,,471.0,ar ARG,DF,25.0,27.7,7.0,0.0,0.0,29.0,13.0,0.0,8.0,43.0,35.0,0.0,2.0,0.0,168.0,26.0,22.0,54.2,Matches,471.0,ar ARG,DF,25.0,27.7,1322.0,1257.0,56.0,40.0,1.0,15.0,8.0,14.0,0.0,0.0,0.0,0.0,1064.0,9.0,18.0,Matches,471.0,ar ARG,DF,25.0,27.7,1064.0,1322.0,80.5,21380.0,9358.0,360.0,399.0,90.2,551.0,625.0,88.2,137.0,245.0,55.9,0.0,0.5,0.4,-0.5,5.0,86.0,4.0,1.0,66.0,Matches,592,ar ARG,DF,25,31,2491.0,80.0,72.8,27.7,29,85.0,22,2,12.0,5,0.9,28.0,55.0,-27.0,-0.98,-0.3,29.6,46.9,-17.3,-0.62,0.16,Matches,471.0,ar ARG,DF,25.0,27.7,1647.0,340.0,1037.0,568.0,57.0,16.0,1647.0,13.0,8.0,61.5,4.0,30.8,929.0,4383.0,2386.0,9.0,12.0,1.0,15.0,4.0,983.0,3.0,Matches,471.0,ar ARG,DF,25.0,27.7,2.0,8.0,2.0,25.0,0.29,0.07,0.25,1.0,9.1,0.0,0.0,0.0,1.6,1.6,0.2,0.4,0.4,Matches,471.0,ar ARG,DF,25.0,31.0,29.0,2491.0,27.7,2.0,0.0,2.0,2.0,0.0,0.0,7.0,0.0,1.6,1.6,0.5,2.1,9.0,66.0,3.0,0.07,0.0,0.07,0.07,0.07,0.06,0.02,0.08,0.06,0.08,Matches,Marcos Senesi,D C,25,135,147,"Argentina,Italy",AFC Bournemouth,6,10,10,8,13,7,14,7,3,13,13,6,14,14,10,15,13,13,12,13,13,13,11,13,10,14,15,15,14,11,14,15,14,11,15,12,13,12,13,6,3,1,3,2,1,3,2,2,1,1,3,2,14,10,1,12,13,15,14,17,1,10,20,1,1,1,1,1,1,1,1,1,1,1,184,80,20,10,24283271,6750,6400,5550,Mediterranean_Hispanic,133,8,1997/5/10,1,0,52196.0,,14080605
488,Luke Shaw,Manchester Utd,1995,473.0,eng ENG,DF,27.0,28.4,55.0,36.0,31.0,22.0,2.0,32.0,46.0,69.6,14.0,51.0,17.0,34.0,36.0,91.0,55.0,2.0,Matches,473.0,eng ENG,DF,27.0,28.4,67.0,2.36,50.0,9.0,3.0,1.0,4.0,0.0,7.0,0.25,6.0,0.0,0.0,0.0,1.0,0.0,Matches,,,,,,,,,,,,,,,,,,,,,,,,,,,,,,,,,,,,,,,,,,,,,,,,,,,,,,,,473.0,eng ENG,DF,27.0,28.4,8.0,0.0,0.0,46.0,27.0,1.0,89.0,36.0,36.0,0.0,1.0,0.0,189.0,46.0,29.0,61.3,Matches,473.0,eng ENG,DF,27.0,28.4,2098.0,1792.0,297.0,36.0,2.0,13.0,89.0,195.0,38.0,20.0,7.0,0.0,1757.0,9.0,37.0,Matches,473.0,eng ENG,DF,27.0,28.4,1757.0,2098.0,83.7,27648.0,10568.0,962.0,1047.0,91.9,641.0,732.0,87.6,112.0,205.0,54.6,2.0,3.6,2.9,-1.6,34.0,169.0,28.0,14.0,140.0,Matches,594,eng ENG,DF,27,31,2552.0,82.0,74.6,28.4,30,84.0,24,1,45.0,4,1.74,43.0,35.0,8.0,0.28,-0.44,45.3,38.0,7.3,0.26,-0.78,Matches,473.0,eng ENG,DF,27.0,28.4,2388.0,175.0,810.0,1124.0,475.0,22.0,2388.0,39.0,14.0,35.9,17.0,43.6,1298.0,6356.0,3352.0,53.0,44.0,3.0,24.0,8.0,1459.0,76.0,Matches,473.0,eng ENG,DF,27.0,28.4,1.0,14.0,4.0,28.6,0.49,0.14,0.07,0.25,18.7,1.0,0.0,0.0,1.1,1.1,0.08,-0.1,-0.1,Matches,473.0,eng ENG,DF,27.0,31.0,30.0,2552.0,28.4,1.0,2.0,3.0,1.0,0.0,0.0,8.0,0.0,1.1,1.1,3.6,4.7,53.0,140.0,76.0,0.04,0.07,0.11,0.04,0.11,0.04,0.13,0.16,0.04,0.16,Matches,Luke Shaw,D/WB L,27,147,162,England,Manchester UFC,15,14,14,8,15,13,12,6,12,14,14,8,13,14,10,13,12,14,13,13,14,10,10,9,15,14,14,12,15,15,15,13,11,15,15,14,13,12,13,12,15,2,1,3,2,1,4,1,2,1,3,1,15,15,6,12,10,12,13,16,1,20,13,1,16,1,1,1,1,1,1,1,1,1,181,75,20,8,27532418,7100,7900,6500,Northern_European,149,0,1995/7/12,21,2,197186.0,,29076105
489,Bernardo Silva,Manchester City,1994,476.0,pt POR,MFFW,27.0,24.5,44.0,23.0,11.0,25.0,8.0,18.0,45.0,40.0,27.0,23.0,6.0,17.0,16.0,60.0,6.0,0.0,Matches,476.0,pt POR,MFFW,27.0,24.5,75.0,3.06,65.0,1.0,4.0,1.0,3.0,1.0,12.0,0.49,11.0,0.0,0.0,0.0,1.0,0.0,Matches,,,,,,,,,,,,,,,,,,,,,,,,,,,,,,,,,,,,,,,,,,,,,,,,,,,,,,,,476.0,pt POR,MFFW,27.0,24.5,5.0,0.0,0.0,31.0,15.0,2.0,75.0,16.0,23.0,1.0,0.0,0.0,122.0,4.0,13.0,23.5,Matches,476.0,pt POR,MFFW,27.0,24.5,1543.0,1468.0,73.0,15.0,3.0,10.0,75.0,48.0,7.0,0.0,2.0,0.0,1317.0,2.0,27.0,Matches,476.0,pt POR,MFFW,27.0,24.5,1317.0,1543.0,85.4,20840.0,3604.0,717.0,771.0,93.0,462.0,529.0,87.3,92.0,149.0,61.7,5.0,3.3,4.0,1.7,31.0,76.0,35.0,11.0,130.0,Matches,599,pt POR,MFFW,27,34,2205.0,65.0,64.5,24.5,24,85.0,16,10,16.0,4,2.35,61.0,24.0,37.0,1.51,-0.27,48.0,22.9,25.1,1.02,-0.56,Matches,476.0,pt POR,MFFW,27.0,24.5,1772.0,31.0,281.0,797.0,707.0,92.0,1772.0,64.0,28.0,43.8,29.0,45.3,1115.0,7092.0,3523.0,90.0,73.0,29.0,30.0,31.0,1324.0,188.0,Matches,476.0,pt POR,MFFW,27.0,24.5,4.0,25.0,9.0,36.0,1.02,0.37,0.16,0.44,18.1,0.0,0.0,0.0,2.2,2.2,0.09,1.8,1.8,Matches,476.0,pt POR,MFFW,27.0,34.0,24.0,2205.0,24.5,4.0,5.0,9.0,4.0,0.0,0.0,5.0,0.0,2.2,2.2,3.3,5.4,90.0,130.0,188.0,0.16,0.2,0.37,0.16,0.37,0.09,0.13,0.22,0.09,0.22,Matches,Bernardo Silva,M/AM RC,27,176,180,Portugal,Manchester City,14,15,17,15,17,13,10,13,2,12,17,13,8,18,13,16,15,16,15,17,15,16,17,12,17,13,16,20,15,19,16,7,17,14,17,9,16,10,16,6,13,2,2,1,3,2,1,1,1,2,2,2,15,17,14,11,13,17,12,8,1,1,1,1,1,1,1,12,20,16,12,20,19,9,173,64,20,8,347975206,8800,8750,8500,Mediterranean_Hispanic,174,6,1994/8/10,70,8,208785.0,,55041632
490,Thiago Silva,Chelsea,1984,477.0,br BRA,DF,37.0,26.1,41.0,27.0,24.0,17.0,0.0,21.0,31.0,67.7,10.0,38.0,29.0,9.0,34.0,75.0,111.0,3.0,Matches,477.0,br BRA,DF,37.0,26.1,18.0,0.69,16.0,1.0,0.0,1.0,0.0,0.0,2.0,0.08,2.0,0.0,0.0,0.0,0.0,0.0,Matches,,,,,,,,,,,,,,,,,,,,,,,,,,,,,,,,,,,,,,,,,,,,,,,,,,,,,,,,477.0,br BRA,DF,37.0,26.1,2.0,0.0,0.0,10.0,13.0,0.0,2.0,34.0,27.0,0.0,0.0,0.0,148.0,61.0,23.0,72.6,Matches,477.0,br BRA,DF,37.0,26.1,2042.0,1976.0,59.0,54.0,1.0,15.0,2.0,2.0,0.0,0.0,0.0,0.0,1856.0,7.0,8.0,Matches,477.0,br BRA,DF,37.0,26.1,1856.0,2042.0,90.9,34998.0,13939.0,678.0,718.0,94.4,993.0,1035.0,95.9,172.0,258.0,66.7,2.0,0.5,1.0,1.5,5.0,115.0,13.0,0.0,104.0,Matches,600,br BRA,DF,37,27,2352.0,87.0,68.8,26.1,26,87.0,25,1,84.0,2,1.19,27.0,32.0,-5.0,-0.19,0.15,31.6,34.1,-2.5,-0.1,-0.06,Matches,477.0,br BRA,DF,37.0,26.1,2302.0,348.0,1167.0,1081.0,58.0,24.0,2302.0,4.0,3.0,75.0,0.0,0.0,1460.0,6608.0,3887.0,8.0,14.0,0.0,6.0,1.0,1674.0,2.0,Matches,477.0,br BRA,DF,37.0,26.1,0.0,15.0,2.0,13.3,0.57,0.08,0.0,0.0,13.0,0.0,0.0,0.0,1.5,1.5,0.1,-1.5,-1.5,Matches,477.0,br BRA,DF,37.0,27.0,26.0,2352.0,26.1,0.0,2.0,2.0,0.0,0.0,0.0,2.0,0.0,1.5,1.5,0.5,2.0,8.0,104.0,2.0,0.0,0.08,0.08,0.0,0.08,0.06,0.02,0.08,0.06,0.08,Matches,Thiago Silva,D C,37,168,174,"Brazil,France",Chelsea,4,5,9,7,14,8,17,7,7,17,13,14,16,13,17,17,15,20,17,13,17,15,8,19,8,19,15,14,10,12,16,13,14,10,14,14,15,7,13,11,8,4,2,2,3,1,3,2,2,1,1,2,13,17,6,15,11,20,18,15,1,1,20,1,1,1,1,1,1,1,1,1,1,1,183,79,8,20,26674923,8400,8250,7750,Mixed_Race,164,12,1984/9/22,107,7,114999.0,,8833628
491,Oliver Skipp,Tottenham,2000,480.0,eng ENG,MF,21.0,16.6,34.0,17.0,18.0,15.0,1.0,16.0,33.0,48.5,17.0,17.0,8.0,9.0,17.0,51.0,19.0,1.0,Matches,480.0,eng ENG,MF,21.0,16.6,27.0,1.63,24.0,0.0,0.0,0.0,2.0,1.0,1.0,0.06,0.0,0.0,0.0,0.0,1.0,0.0,Matches,,,,,,,,,,,,,,,,,,,,,,,,,,,,,,,,,,,,,,,,,,,,,,,,,,,,,,,,480.0,eng ENG,MF,21.0,16.6,7.0,0.0,0.0,23.0,17.0,0.0,10.0,17.0,17.0,0.0,0.0,0.0,107.0,7.0,25.0,21.9,Matches,480.0,eng ENG,MF,21.0,16.6,772.0,755.0,12.0,7.0,1.0,4.0,10.0,0.0,0.0,0.0,0.0,0.0,660.0,5.0,14.0,Matches,480.0,eng ENG,MF,21.0,16.6,660.0,772.0,85.5,10674.0,2638.0,326.0,354.0,92.1,270.0,300.0,90.0,42.0,63.0,66.7,0.0,0.6,0.4,-0.6,10.0,52.0,7.0,1.0,56.0,Matches,604,eng ENG,MF,21,23,1491.0,65.0,43.6,16.6,18,82.0,8,5,5.0,10,1.43,27.0,28.0,-1.0,-0.06,-0.43,24.4,22.5,1.8,0.11,-0.15,Matches,480.0,eng ENG,MF,21.0,16.6,915.0,45.0,245.0,554.0,124.0,7.0,915.0,15.0,11.0,73.3,3.0,20.0,496.0,2147.0,941.0,14.0,15.0,2.0,17.0,16.0,634.0,25.0,Matches,480.0,eng ENG,MF,21.0,16.6,1.0,7.0,3.0,42.9,0.42,0.18,0.14,0.33,23.2,0.0,0.0,0.0,0.3,0.3,0.04,0.7,0.7,Matches,480.0,eng ENG,MF,21.0,23.0,18.0,1491.0,16.6,1.0,0.0,1.0,1.0,0.0,0.0,7.0,0.0,0.3,0.3,0.6,0.9,14.0,56.0,25.0,0.06,0.0,0.06,0.06,0.06,0.02,0.04,0.05,0.02,0.05,Matches,Oliver Skipp,DM/M C,21,141,156,England,Tottenham Hotspur,8,6,10,7,13,7,12,9,6,13,14,7,16,12,15,15,17,16,11,12,14,14,7,11,13,14,15,17,13,12,13,9,15,14,16,14,15,8,14,5,7,3,2,2,1,1,1,1,1,1,2,1,10,13,6,11,14,15,14,15,1,8,12,9,1,1,20,1,20,1,1,1,1,1,181,70,11,20,40481116,7050,7050,5500,Northern_European,140,2,2000/9/16,0,0,57996.0,,28116496
492,Adam Smith,Bournemouth,1991,481.0,eng ENG,DF,31.0,32.7,49.0,29.0,27.0,19.0,3.0,29.0,60.0,48.3,31.0,30.0,13.0,17.0,25.0,74.0,81.0,1.0,Matches,481.0,eng ENG,DF,31.0,32.7,29.0,0.89,25.0,1.0,0.0,2.0,0.0,1.0,2.0,0.06,2.0,0.0,0.0,0.0,0.0,0.0,Matches,,,,,,,,,,,,,,,,,,,,,,,,,,,,,,,,,,,,,,,,,,,,,,,,,,,,,,,,481.0,eng ENG,DF,31.0,32.7,11.0,0.0,0.0,29.0,27.0,0.0,48.0,25.0,29.0,0.0,1.0,0.0,128.0,29.0,38.0,43.3,Matches,481.0,eng ENG,DF,31.0,32.7,1264.0,987.0,276.0,22.0,0.0,2.0,48.0,254.0,0.0,0.0,0.0,0.0,953.0,1.0,29.0,Matches,481.0,eng ENG,DF,31.0,32.7,953.0,1264.0,75.4,16233.0,6898.0,450.0,513.0,87.7,398.0,501.0,79.4,88.0,194.0,45.4,1.0,1.3,1.5,-0.3,16.0,70.0,28.0,19.0,83.0,Matches,605,eng ENG,DF,31,37,2943.0,80.0,86.1,32.7,34,84.0,25,3,29.0,0,1.05,34.0,58.0,-24.0,-0.73,1.15,33.3,53.1,-19.8,-0.61,0.44,Matches,481.0,eng ENG,DF,31.0,32.7,1527.0,112.0,602.0,650.0,296.0,17.0,1527.0,30.0,6.0,20.0,17.0,56.7,647.0,2762.0,1368.0,28.0,21.0,3.0,21.0,4.0,771.0,54.0,Matches,481.0,eng ENG,DF,31.0,32.7,0.0,5.0,1.0,20.0,0.15,0.03,0.0,0.0,16.2,0.0,0.0,0.0,0.5,0.5,0.1,-0.5,-0.5,Matches,481.0,eng ENG,DF,31.0,37.0,34.0,2943.0,32.7,0.0,1.0,1.0,0.0,0.0,0.0,11.0,0.0,0.5,0.5,1.3,1.8,28.0,83.0,54.0,0.0,0.03,0.03,0.0,0.03,0.02,0.04,0.05,0.02,0.05,Matches,Adam Smith,D/WB RL,31,128,136,England,AFC Bournemouth,6,12,12,7,13,6,7,9,3,12,13,4,13,13,10,13,13,13,11,9,12,14,9,11,13,13,13,15,14,13,11,7,15,14,15,11,15,10,14,5,13,3,1,2,2,2,2,4,3,2,3,4,12,14,2,8,11,15,13,11,1,19,14,20,16,18,1,1,1,8,1,1,5,1,180,79,8,20,4567028,6300,6300,4250,Northern_European,117,4,1991/4/29,0,0,28998.0,,28011401
493,Dominic Solanke,Bournemouth,1997,485.0,eng ENG,FWMF,24.0,31.8,15.0,9.0,8.0,3.0,4.0,5.0,22.0,22.7,17.0,26.0,7.0,19.0,6.0,21.0,46.0,0.0,Matches,485.0,eng ENG,FWMF,24.0,31.8,61.0,1.92,36.0,1.0,11.0,10.0,2.0,1.0,13.0,0.41,10.0,1.0,0.0,2.0,0.0,0.0,Matches,,,,,,,,,,,,,,,,,,,,,,,,,,,,,,,,,,,,,,,,,,,,,,,,,,,,,,,,485.0,eng ENG,FWMF,24.0,31.8,2.0,0.0,0.0,40.0,53.0,11.0,13.0,6.0,9.0,0.0,0.0,0.0,87.0,52.0,98.0,34.7,Matches,485.0,eng ENG,FWMF,24.0,31.8,533.0,479.0,52.0,0.0,3.0,1.0,13.0,4.0,0.0,0.0,0.0,0.0,363.0,2.0,34.0,Matches,485.0,eng ENG,FWMF,24.0,31.8,363.0,533.0,68.1,4673.0,1106.0,225.0,294.0,76.5,101.0,135.0,74.8,14.0,24.0,58.3,7.0,3.9,2.4,3.1,21.0,22.0,17.0,1.0,47.0,Matches,612,eng ENG,FWMF,24,33,2860.0,87.0,83.6,31.8,32,88.0,19,1,45.0,0,1.15,35.0,52.0,-17.0,-0.53,2.2,34.4,51.3,-16.9,-0.53,0.81,Matches,485.0,eng ENG,FWMF,24.0,31.8,1012.0,54.0,157.0,423.0,454.0,159.0,1012.0,110.0,45.0,40.9,54.0,49.1,638.0,4488.0,1731.0,70.0,41.0,36.0,134.0,74.0,730.0,167.0,Matches,485.0,eng ENG,FWMF,24.0,31.8,6.0,76.0,28.0,36.8,2.39,0.88,0.08,0.21,12.8,0.0,0.0,0.0,9.1,9.1,0.12,-3.1,-3.1,Matches,485.0,eng ENG,FWMF,24.0,33.0,32.0,2860.0,31.8,6.0,7.0,13.0,6.0,0.0,0.0,2.0,0.0,9.1,9.1,3.9,13.0,70.0,47.0,167.0,0.19,0.22,0.41,0.19,0.41,0.29,0.12,0.41,0.29,0.41,Matches,Dominic Solanke,S,24,135,150,"England,Nigeria",AFC Bournemouth,5,10,12,14,14,8,12,10,7,7,11,12,8,15,13,13,13,13,11,11,12,12,12,5,15,9,14,17,14,12,13,14,17,14,13,14,13,8,12,8,7,2,2,1,1,3,2,3,2,2,1,2,12,15,6,10,11,12,12,12,1,1,1,1,1,1,1,1,1,1,1,12,1,20,187,74,12,20,34828546,6750,6750,5300,African_Caribbean,134,11,1997/9/14,1,0,52196.0,,29125191
494,Tomáš Souček,West Ham,1995,487.0,cz CZE,MF,27.0,31.3,77.0,37.0,41.0,29.0,7.0,28.0,58.0,48.3,30.0,42.0,17.0,25.0,53.0,130.0,71.0,3.0,Matches,487.0,cz CZE,MF,27.0,31.3,52.0,1.66,41.0,0.0,0.0,8.0,1.0,2.0,3.0,0.1,2.0,0.0,0.0,1.0,0.0,0.0,Matches,,,,,,,,,,,,,,,,,,,,,,,,,,,,,,,,,,,,,,,,,,,,,,,,,,,,,,,,487.0,cz CZE,MF,27.0,31.3,3.0,0.0,0.0,50.0,16.0,2.0,20.0,53.0,37.0,0.0,0.0,0.0,143.0,114.0,92.0,55.3,Matches,487.0,cz CZE,MF,27.0,31.3,994.0,982.0,12.0,10.0,0.0,6.0,20.0,0.0,1.0,1.0,0.0,0.0,709.0,0.0,28.0,Matches,487.0,cz CZE,MF,27.0,31.3,709.0,994.0,71.3,11602.0,3417.0,360.0,476.0,75.6,255.0,338.0,75.4,66.0,106.0,62.3,3.0,1.9,1.1,1.1,15.0,67.0,11.0,6.0,88.0,Matches,614,cz CZE,MF,27,36,2815.0,78.0,82.3,31.3,32,84.0,24,4,31.0,1,1.11,38.0,42.0,-4.0,-0.13,1.21,41.4,42.7,-1.3,-0.04,0.34,Matches,487.0,cz CZE,MF,27.0,31.3,1366.0,124.0,432.0,652.0,288.0,71.0,1366.0,17.0,2.0,11.8,12.0,70.6,544.0,2087.0,695.0,11.0,17.0,0.0,23.0,18.0,742.0,52.0,Matches,487.0,cz CZE,MF,27.0,31.3,2.0,34.0,13.0,38.2,1.09,0.42,0.06,0.15,10.8,0.0,0.0,0.0,4.0,4.0,0.12,-2.0,-2.0,Matches,487.0,cz CZE,MF,27.0,36.0,32.0,2815.0,31.3,2.0,3.0,5.0,2.0,0.0,0.0,3.0,0.0,4.0,4.0,1.9,6.0,11.0,88.0,52.0,0.06,0.1,0.16,0.06,0.16,0.13,0.06,0.19,0.13,0.19,Matches,Tomáš Souček,DM/M C,27,150,155,Czech Republic,West Ham United,2,8,12,14,12,2,18,12,2,15,13,16,16,12,15,15,15,15,15,10,16,16,5,12,15,15,17,18,13,9,15,17,18,12,19,16,18,10,14,10,18,2,2,4,1,2,1,1,2,2,3,1,11,13,8,15,14,16,17,9,1,1,12,1,1,1,17,1,20,1,1,1,1,1,192,86,10,20,50908773,7500,7500,6000,Northern_European,146,1,1995/2/27,52,9,57996.0,,25041687
495,Boubakary Soumaré,Leicester City,1999,488.0,fr FRA,MF,23.0,18.1,57.0,34.0,29.0,26.0,2.0,23.0,44.0,52.3,21.0,15.0,4.0,11.0,33.0,90.0,27.0,1.0,Matches,488.0,fr FRA,MF,23.0,18.1,23.0,1.27,22.0,0.0,1.0,0.0,0.0,0.0,1.0,0.06,1.0,0.0,0.0,0.0,0.0,0.0,Matches,,,,,,,,,,,,,,,,,,,,,,,,,,,,,,,,,,,,,,,,,,,,,,,,,,,,,,,,488.0,fr FRA,MF,23.0,18.1,9.0,0.0,0.0,31.0,22.0,1.0,2.0,33.0,34.0,0.0,0.0,0.0,119.0,18.0,14.0,56.3,Matches,488.0,fr FRA,MF,23.0,18.1,902.0,895.0,7.0,6.0,2.0,2.0,2.0,0.0,0.0,0.0,0.0,0.0,776.0,0.0,19.0,Matches,488.0,fr FRA,MF,23.0,18.1,776.0,902.0,86.0,11579.0,3059.0,429.0,470.0,91.3,276.0,314.0,87.9,39.0,57.0,68.4,0.0,0.4,0.5,-0.4,11.0,80.0,5.0,1.0,73.0,Matches,615,fr FRA,MF,23,26,1629.0,63.0,47.6,18.1,20,75.0,9,6,23.0,3,1.0,19.0,30.0,-11.0,-0.61,-0.31,23.1,33.7,-10.5,-0.58,-0.47,Matches,488.0,fr FRA,MF,23.0,18.1,1091.0,45.0,319.0,675.0,112.0,2.0,1091.0,22.0,12.0,54.5,6.0,27.3,588.0,2940.0,1182.0,17.0,12.0,0.0,26.0,22.0,733.0,20.0,Matches,488.0,fr FRA,MF,23.0,18.1,0.0,1.0,0.0,0.0,0.06,0.0,0.0,,28.0,0.0,0.0,0.0,0.0,0.0,0.03,0.0,0.0,Matches,488.0,fr FRA,MF,23.0,26.0,20.0,1629.0,18.1,0.0,0.0,0.0,0.0,0.0,0.0,9.0,0.0,0.0,0.0,0.4,0.4,17.0,73.0,20.0,0.0,0.0,0.0,0.0,0.0,0.0,0.02,0.02,0.0,0.02,Matches,Boubakary Soumaré,DM/M C,23,137,154,"France,Senegal",Leicester City,10,13,14,10,14,8,10,10,8,13,15,8,14,14,8,14,14,14,13,14,14,12,14,13,14,13,15,12,11,13,15,14,13,12,15,16,14,11,12,11,12,2,3,2,1,2,2,2,2,2,3,4,9,15,3,13,13,14,15,16,1,1,1,1,1,1,18,1,20,1,1,1,1,1,188,82,8,20,35077931,6850,6850,5250,African_Caribbean,139,17,1999/2/27,0,0,92793.0,,48044576
496,Harry Souttar,Leicester City,1998,489.0,au AUS,DF,23.0,11.0,15.0,9.0,10.0,5.0,0.0,7.0,18.0,38.9,11.0,16.0,12.0,4.0,12.0,27.0,45.0,0.0,Matches,489.0,au AUS,DF,23.0,11.0,8.0,0.73,4.0,0.0,2.0,2.0,0.0,0.0,2.0,0.18,1.0,0.0,0.0,1.0,0.0,0.0,Matches,,,,,,,,,,,,,,,,,,,,,,,,,,,,,,,,,,,,,,,,,,,,,,,,,,,,,,,,489.0,au AUS,DF,23.0,11.0,2.0,0.0,0.0,5.0,5.0,1.0,0.0,12.0,9.0,0.0,0.0,1.0,45.0,38.0,6.0,86.4,Matches,489.0,au AUS,DF,23.0,11.0,555.0,531.0,19.0,17.0,1.0,9.0,0.0,2.0,0.0,0.0,0.0,0.0,448.0,5.0,3.0,Matches,489.0,au AUS,DF,23.0,11.0,448.0,555.0,80.7,8500.0,3295.0,145.0,160.0,90.6,265.0,303.0,87.5,34.0,76.0,44.7,1.0,0.2,0.1,0.8,3.0,39.0,1.0,0.0,29.0,Matches,617,au AUS,DF,23,12,992.0,83.0,29.0,11.0,11,90.0,11,1,2.0,6,0.67,13.0,19.0,-6.0,-0.54,-0.14,14.6,18.7,-4.0,-0.37,-0.04,Matches,489.0,au AUS,DF,23.0,11.0,663.0,104.0,365.0,282.0,20.0,15.0,663.0,5.0,3.0,60.0,0.0,0.0,390.0,1878.0,948.0,6.0,2.0,1.0,3.0,0.0,420.0,4.0,Matches,489.0,au AUS,DF,23.0,11.0,0.0,8.0,1.0,12.5,0.73,0.09,0.0,0.0,9.6,0.0,0.0,0.0,1.4,1.4,0.18,-1.4,-1.4,Matches,489.0,au AUS,DF,23.0,12.0,11.0,992.0,11.0,0.0,1.0,1.0,0.0,0.0,0.0,2.0,0.0,1.4,1.4,0.2,1.6,6.0,29.0,4.0,0.0,0.09,0.09,0.0,0.09,0.13,0.02,0.15,0.13,0.15,Matches,Harry Souttar,D C,23,120,137,"Australia,Scotland",Stoke City,5,3,6,6,8,5,13,4,9,14,7,7,14,9,13,12,10,10,12,3,12,14,4,12,4,13,13,13,7,10,13,20,12,12,15,15,17,4,13,4,4,3,1,2,3,3,3,3,2,3,2,2,12,14,4,8,15,16,13,13,1,1,20,1,1,1,1,1,1,1,1,1,1,1,199,0,10,20,4479589,5900,5900,3250,Northern_European,114,1,1998/10/22,5,6,9279.0,,61069532
497,Jack Stephens,Bournemouth,1994,497.0,eng ENG,DF,28.0,13.0,15.0,11.0,10.0,4.0,1.0,6.0,10.0,60.0,4.0,23.0,16.0,7.0,16.0,31.0,53.0,0.0,Matches,497.0,eng ENG,DF,28.0,13.0,10.0,0.77,9.0,0.0,0.0,1.0,0.0,0.0,1.0,0.08,1.0,0.0,0.0,0.0,0.0,0.0,Matches,,,,,,,,,,,,,,,,,,,,,,,,,,,,,,,,,,,,,,,,,,,,,,,,,,,,,,,,497.0,eng ENG,DF,28.0,13.0,3.0,0.0,0.0,8.0,2.0,0.0,2.0,16.0,11.0,0.0,0.0,0.0,66.0,16.0,19.0,45.7,Matches,497.0,eng ENG,DF,28.0,13.0,543.0,538.0,5.0,4.0,2.0,2.0,2.0,1.0,0.0,0.0,0.0,0.0,446.0,0.0,6.0,Matches,497.0,eng ENG,DF,28.0,13.0,446.0,543.0,82.1,8713.0,3133.0,156.0,173.0,90.2,233.0,263.0,88.6,53.0,94.0,56.4,0.0,0.2,0.2,-0.2,3.0,37.0,3.0,2.0,34.0,Matches,625,eng ENG,DF,28,15,1173.0,78.0,34.3,13.0,13,90.0,13,2,2.0,15,1.4,16.0,22.0,-6.0,-0.46,0.66,20.0,24.0,-4.1,-0.31,0.54,Matches,497.0,eng ENG,DF,28.0,13.0,665.0,125.0,364.0,275.0,28.0,7.0,665.0,3.0,3.0,100.0,0.0,0.0,368.0,1674.0,863.0,7.0,3.0,0.0,5.0,1.0,398.0,3.0,Matches,497.0,eng ENG,DF,28.0,13.0,0.0,2.0,1.0,50.0,0.15,0.08,0.0,0.0,5.2,0.0,0.0,0.0,0.4,0.4,0.19,-0.4,-0.4,Matches,497.0,eng ENG,DF,28.0,15.0,13.0,1173.0,13.0,0.0,0.0,0.0,0.0,0.0,0.0,3.0,0.0,0.4,0.4,0.2,0.6,7.0,34.0,3.0,0.0,0.0,0.0,0.0,0.0,0.03,0.02,0.05,0.03,0.05,Matches,Jack Stephens,D C,28,128,138,England,Southampton,9,10,11,7,13,10,14,8,10,14,13,9,14,13,13,14,14,14,13,12,12,14,11,14,10,13,13,12,11,11,11,14,13,11,13,14,12,6,11,6,16,1,4,2,2,1,3,1,2,1,1,1,12,10,11,12,12,14,14,12,1,1,20,14,1,14,15,1,10,10,1,1,1,1,185,84,9,20,9496935,6399,6399,4999,Northern_European,128,4,1994/1/27,0,0,52196.0,AFC Bournemouth,29071914
498,Raheem Sterling,Chelsea,1994,498.0,eng ENG,FWMF,27.0,21.0,18.0,10.0,5.0,4.0,9.0,8.0,14.0,57.1,6.0,17.0,0.0,17.0,2.0,20.0,5.0,0.0,Matches,498.0,eng ENG,FWMF,27.0,21.0,68.0,3.23,53.0,0.0,7.0,3.0,4.0,1.0,4.0,0.19,3.0,0.0,1.0,0.0,0.0,0.0,Matches,,,,,,,,,,,,,,,,,,,,,,,,,,,,,,,,,,,,,,,,,,,,,,,,,,,,,,,,498.0,eng ENG,FWMF,27.0,21.0,4.0,0.0,0.0,21.0,32.0,11.0,46.0,2.0,10.0,0.0,0.0,0.0,66.0,5.0,13.0,27.8,Matches,498.0,eng ENG,FWMF,27.0,21.0,685.0,662.0,21.0,0.0,6.0,0.0,46.0,7.0,7.0,7.0,0.0,0.0,514.0,2.0,33.0,Matches,498.0,eng ENG,FWMF,27.0,21.0,514.0,685.0,75.0,6522.0,1357.0,326.0,386.0,84.5,136.0,179.0,76.0,18.0,33.0,54.5,3.0,4.6,3.2,-1.6,34.0,26.0,31.0,9.0,59.0,Matches,626,eng ENG,FWMF,27,28,1891.0,68.0,55.3,21.0,23,76.0,7,5,28.0,1,1.14,24.0,27.0,-3.0,-0.14,0.21,25.7,27.0,-1.3,-0.06,0.04,Matches,498.0,eng ENG,FWMF,27.0,21.0,910.0,8.0,63.0,278.0,583.0,121.0,910.0,93.0,39.0,41.9,46.0,49.5,651.0,4002.0,2153.0,81.0,56.0,39.0,46.0,50.0,749.0,186.0,Matches,498.0,eng ENG,FWMF,27.0,21.0,6.0,42.0,16.0,38.1,2.0,0.76,0.14,0.38,13.6,0.0,0.0,0.0,6.2,6.2,0.15,-0.2,-0.2,Matches,498.0,eng ENG,FWMF,27.0,28.0,23.0,1891.0,21.0,6.0,3.0,9.0,6.0,0.0,0.0,4.0,0.0,6.2,6.2,4.6,10.8,81.0,59.0,186.0,0.29,0.14,0.43,0.29,0.43,0.29,0.22,0.51,0.29,0.51,Matches,Raheem Sterling,M/AM RL,27,168,180,"England,Jamaica",Chelsea,8,13,15,13,13,10,12,12,5,7,13,8,8,13,12,18,11,12,13,13,13,13,14,12,20,9,14,15,18,18,14,8,20,17,18,12,14,4,13,2,14,2,2,3,3,2,1,3,2,1,2,3,18,16,12,8,11,17,10,14,1,1,1,1,1,1,1,16,1,17,20,12,20,12,170,69,8,20,197383136,8400,8400,7750,African_Caribbean,162,15,1994/12/8,77,19,405971.0,,28054109
499,John Stones,Manchester City,1994,499.0,eng ENG,DFMF,28.0,20.5,23.0,13.0,11.0,8.0,4.0,7.0,10.0,70.0,3.0,17.0,10.0,7.0,9.0,32.0,40.0,0.0,Matches,499.0,eng ENG,DFMF,28.0,20.5,16.0,0.78,12.0,1.0,0.0,3.0,0.0,0.0,5.0,0.24,4.0,0.0,0.0,1.0,0.0,0.0,Matches,,,,,,,,,,,,,,,,,,,,,,,,,,,,,,,,,,,,,,,,,,,,,,,,,,,,,,,,499.0,eng ENG,DFMF,28.0,20.5,2.0,0.0,0.0,10.0,8.0,1.0,6.0,9.0,13.0,0.0,0.0,1.0,90.0,33.0,16.0,67.3,Matches,499.0,eng ENG,DFMF,28.0,20.5,1563.0,1496.0,66.0,17.0,1.0,14.0,6.0,45.0,1.0,0.0,0.0,0.0,1453.0,1.0,10.0,Matches,499.0,eng ENG,DFMF,28.0,20.5,1453.0,1563.0,93.0,24351.0,6789.0,708.0,740.0,95.7,625.0,666.0,93.8,99.0,124.0,79.8,2.0,1.4,1.0,0.6,8.0,109.0,3.0,0.0,101.0,Matches,628,eng ENG,DFMF,28,23,1846.0,80.0,54.0,20.5,21,85.0,16,2,31.0,6,2.52,52.0,17.0,35.0,1.71,0.22,44.9,13.3,31.6,1.54,0.69,Matches,499.0,eng ENG,DFMF,28.0,20.5,1690.0,101.0,544.0,942.0,210.0,27.0,1690.0,10.0,6.0,60.0,1.0,10.0,1080.0,6201.0,3250.0,28.0,32.0,1.0,8.0,4.0,1312.0,34.0,Matches,499.0,eng ENG,DFMF,28.0,20.5,2.0,11.0,3.0,27.3,0.54,0.15,0.18,0.67,13.4,0.0,0.0,0.0,1.0,1.0,0.1,1.0,1.0,Matches,499.0,eng ENG,DFMF,28.0,23.0,21.0,1846.0,20.5,2.0,2.0,4.0,2.0,0.0,0.0,2.0,0.0,1.0,1.0,1.4,2.4,28.0,101.0,34.0,0.1,0.1,0.2,0.1,0.2,0.05,0.07,0.12,0.05,0.12,Matches,John Stones,D C,28,161,170,England,Manchester City,5,8,13,8,14,5,14,5,8,13,16,12,16,15,13,15,16,17,15,14,14,13,12,13,14,16,16,17,14,13,12,16,16,15,16,15,16,8,14,9,10,1,3,2,1,2,2,1,2,2,1,3,10,18,7,15,12,15,13,16,1,1,20,10,1,1,12,1,1,1,1,1,1,1,188,72,12,20,128950907,8050,8050,7500,Northern_European,161,5,1994/5/28,58,3,231983.0,,28060397
500,Pascal Struijk,Leeds United,1999,500.0,nl NED,DF,22.0,24.4,84.0,57.0,43.0,31.0,10.0,49.0,75.0,65.3,26.0,32.0,12.0,20.0,32.0,116.0,70.0,1.0,Matches,500.0,nl NED,DF,22.0,24.4,35.0,1.43,25.0,4.0,0.0,5.0,0.0,1.0,2.0,0.08,0.0,0.0,0.0,2.0,0.0,0.0,Matches,,,,,,,,,,,,,,,,,,,,,,,,,,,,,,,,,,,,,,,,,,,,,,,,,,,,,,,,500.0,nl NED,DF,22.0,24.4,5.0,0.0,0.0,29.0,12.0,0.0,21.0,32.0,57.0,0.0,2.0,0.0,139.0,60.0,43.0,58.3,Matches,500.0,nl NED,DF,22.0,24.4,1320.0,1065.0,250.0,28.0,0.0,3.0,21.0,222.0,0.0,0.0,0.0,0.0,1046.0,5.0,26.0,Matches,500.0,nl NED,DF,22.0,24.4,1046.0,1320.0,79.2,15839.0,6757.0,571.0,655.0,87.2,396.0,485.0,81.6,51.0,104.0,49.0,1.0,2.4,1.2,-1.4,14.0,90.0,13.0,4.0,119.0,Matches,630,nl NED,DF,22,29,2200.0,76.0,64.3,24.4,26,84.0,20,3,7.0,5,0.9,33.0,52.0,-19.0,-0.78,0.03,31.7,42.7,-11.0,-0.45,0.19,Matches,500.0,nl NED,DF,22.0,24.4,1619.0,92.0,538.0,708.0,379.0,31.0,1619.0,18.0,9.0,50.0,7.0,38.9,700.0,2806.0,1465.0,24.0,25.0,1.0,25.0,12.0,803.0,53.0,Matches,500.0,nl NED,DF,22.0,24.4,2.0,16.0,7.0,43.8,0.65,0.29,0.13,0.29,13.4,0.0,0.0,0.0,1.4,1.4,0.09,0.6,0.6,Matches,500.0,nl NED,DF,22.0,29.0,26.0,2200.0,24.4,2.0,1.0,3.0,2.0,0.0,0.0,5.0,0.0,1.4,1.4,2.4,3.7,24.0,119.0,53.0,0.08,0.04,0.12,0.08,0.12,0.06,0.1,0.15,0.06,0.15,Matches,Pascal Struijk,D C,22,135,156,"Holland,Belgium,Indonesia",Leeds United,3,7,9,5,12,3,16,5,5,13,13,8,14,13,13,14,14,13,13,13,13,13,8,6,9,14,14,14,13,11,13,15,14,14,14,14,13,6,12,6,15,3,4,2,2,3,2,3,1,2,1,1,14,13,5,11,13,14,10,11,1,12,20,4,1,1,14,1,11,1,1,1,1,1,190,75,20,14,36894651,6750,6750,5750,Northern_European,135,6,1999/8/11,0,0,34798.0,,37059452
501,Kamaldeen Sulemana,Southampton,2002,501.0,gh GHA,FWMF,20.0,10.7,15.0,9.0,4.0,7.0,4.0,4.0,14.0,28.6,10.0,16.0,0.0,16.0,6.0,21.0,6.0,0.0,Matches,501.0,gh GHA,FWMF,20.0,10.7,40.0,3.72,24.0,0.0,9.0,4.0,1.0,2.0,3.0,0.28,2.0,0.0,1.0,0.0,0.0,0.0,Matches,,,,,,,,,,,,,,,,,,,,,,,,,,,,,,,,,,,,,,,,,,,,,,,,,,,,,,,,501.0,gh GHA,FWMF,20.0,10.7,1.0,0.0,0.0,9.0,12.0,2.0,18.0,6.0,9.0,0.0,0.0,0.0,39.0,5.0,14.0,26.3,Matches,501.0,gh GHA,FWMF,20.0,10.7,265.0,257.0,6.0,0.0,1.0,1.0,18.0,1.0,1.0,0.0,0.0,0.0,189.0,2.0,12.0,Matches,501.0,gh GHA,FWMF,20.0,10.7,189.0,265.0,71.3,2901.0,617.0,103.0,128.0,80.5,59.0,75.0,78.7,16.0,31.0,51.6,1.0,1.3,1.0,-0.3,14.0,11.0,10.0,1.0,36.0,Matches,631,gh GHA,FWMF,20,18,966.0,54.0,28.2,10.7,10,76.0,2,8,26.0,0,0.56,11.0,20.0,-9.0,-0.84,0.19,12.2,18.2,-6.0,-0.56,0.07,Matches,501.0,gh GHA,FWMF,20.0,10.7,431.0,7.0,47.0,175.0,222.0,44.0,431.0,68.0,36.0,52.9,31.0,45.6,277.0,2315.0,973.0,32.0,27.0,18.0,35.0,16.0,294.0,80.0,Matches,501.0,gh GHA,FWMF,20.0,10.7,2.0,24.0,7.0,29.2,2.24,0.65,0.08,0.29,18.8,0.0,0.0,0.0,1.7,1.7,0.07,0.3,0.3,Matches,501.0,gh GHA,FWMF,20.0,18.0,10.0,966.0,10.7,2.0,1.0,3.0,2.0,0.0,0.0,1.0,0.0,1.7,1.7,1.3,3.0,32.0,36.0,80.0,0.19,0.09,0.28,0.19,0.28,0.16,0.12,0.28,0.16,0.28,Matches,Kamaldeen Sulemana,M/AM L,20,122,-8,Ghana,Stade Rennais FC,8,11,15,14,12,6,5,12,2,3,11,10,3,16,9,12,11,12,9,12,12,13,17,3,14,5,9,12,16,15,8,8,12,16,8,7,11,13,9,12,9,1,2,3,3,2,2,1,1,2,1,3,12,13,7,12,11,14,13,13,1,1,1,1,1,1,1,16,1,13,20,12,14,11,175,69,12,20,70117004,6093,6093,3993,African_Caribbean,117,14,2002/2/15,11,0,9270.0,,29244869
502,Crysencio Summerville,Leeds United,2001,502.0,nl NED,FW,20.0,15.8,30.0,20.0,14.0,14.0,2.0,11.0,23.0,47.8,12.0,20.0,2.0,18.0,13.0,43.0,11.0,0.0,Matches,502.0,nl NED,FW,20.0,15.8,49.0,3.09,29.0,1.0,3.0,4.0,10.0,2.0,5.0,0.32,3.0,0.0,0.0,0.0,1.0,1.0,Matches,,,,,,,,,,,,,,,,,,,,,,,,,,,,,,,,,,,,,,,,,,,,,,,,,,,,,,,,502.0,nl NED,FW,20.0,15.8,4.0,0.0,0.0,22.0,41.0,8.0,14.0,13.0,20.0,1.0,0.0,0.0,90.0,5.0,17.0,22.7,Matches,502.0,nl NED,FW,20.0,15.8,411.0,402.0,6.0,1.0,1.0,1.0,14.0,1.0,3.0,0.0,0.0,0.0,308.0,3.0,15.0,Matches,502.0,nl NED,FW,20.0,15.8,308.0,411.0,74.9,3839.0,1067.0,208.0,256.0,81.3,72.0,92.0,78.3,9.0,24.0,37.5,2.0,1.6,1.1,0.4,16.0,20.0,12.0,2.0,45.0,Matches,632,nl NED,FW,20,28,1426.0,51.0,41.7,15.8,12,82.0,7,16,28.0,8,0.86,19.0,38.0,-19.0,-1.2,-0.7,19.7,29.7,-10.0,-0.63,-0.19,Matches,502.0,nl NED,FW,20.0,15.8,637.0,10.0,99.0,241.0,311.0,70.0,637.0,60.0,24.0,40.0,22.0,36.7,420.0,2617.0,1326.0,51.0,27.0,19.0,45.0,36.0,438.0,92.0,Matches,502.0,nl NED,FW,20.0,15.8,4.0,29.0,9.0,31.0,1.83,0.57,0.14,0.44,15.3,0.0,0.0,0.0,2.9,2.9,0.1,1.1,1.1,Matches,502.0,nl NED,FW,20.0,28.0,12.0,1426.0,15.8,4.0,2.0,6.0,4.0,0.0,0.0,4.0,0.0,2.9,2.9,1.6,4.5,51.0,45.0,92.0,0.25,0.13,0.38,0.25,0.38,0.18,0.1,0.28,0.18,0.28,Matches,Crysencio Summerville,AM RL,20,118,139,"Holland,Suriname",Leeds United,5,11,15,8,12,4,3,6,2,4,8,8,4,12,7,11,8,9,6,9,7,11,14,4,11,4,11,12,18,16,13,4,9,17,12,4,12,6,8,4,12,1,1,1,1,2,1,4,1,1,1,2,15,10,11,12,9,9,10,11,1,1,1,1,1,1,1,14,1,15,19,1,20,8,164,0,12,20,7711131,5900,5900,3752,African_Caribbean,108,15,2001/10/30,0,0,8699.0,,37065567
503,James Tarkowski,Everton,1992,506.0,eng ENG,DF,29.0,38.0,51.0,26.0,36.0,13.0,2.0,20.0,39.0,51.3,19.0,99.0,78.0,21.0,51.0,102.0,201.0,3.0,Matches,506.0,eng ENG,DF,29.0,38.0,23.0,0.61,17.0,0.0,0.0,5.0,0.0,1.0,2.0,0.05,1.0,0.0,0.0,1.0,0.0,0.0,Matches,,,,,,,,,,,,,,,,,,,,,,,,,,,,,,,,,,,,,,,,,,,,,,,,,,,,,,,,506.0,eng ENG,DF,29.0,38.0,6.0,0.0,0.0,40.0,23.0,2.0,0.0,51.0,26.0,0.0,1.0,0.0,173.0,120.0,48.0,71.4,Matches,506.0,eng ENG,DF,29.0,38.0,1633.0,1578.0,48.0,41.0,3.0,18.0,0.0,6.0,0.0,0.0,0.0,0.0,1322.0,7.0,4.0,Matches,506.0,eng ENG,DF,29.0,38.0,1322.0,1633.0,81.0,26359.0,10115.0,448.0,512.0,87.5,693.0,794.0,87.3,167.0,297.0,56.2,1.0,2.9,1.9,-1.9,15.0,98.0,3.0,0.0,106.0,Matches,637,eng ENG,DF,29,38,3420.0,90.0,100.0,38.0,38,90.0,38,0,,0,0.95,34.0,57.0,-23.0,-0.61,,45.2,65.5,-20.4,-0.54,,Matches,506.0,eng ENG,DF,29.0,38.0,2119.0,369.0,1090.0,926.0,113.0,81.0,2119.0,10.0,9.0,90.0,1.0,10.0,982.0,4413.0,2295.0,13.0,3.0,1.0,22.0,5.0,1209.0,11.0,Matches,506.0,eng ENG,DF,29.0,38.0,1.0,32.0,9.0,28.1,0.84,0.24,0.03,0.11,9.0,0.0,0.0,0.0,3.1,3.1,0.1,-2.1,-2.1,Matches,506.0,eng ENG,DF,29.0,38.0,38.0,3420.0,38.0,1.0,1.0,2.0,1.0,0.0,0.0,6.0,0.0,3.1,3.1,2.9,6.0,13.0,106.0,11.0,0.03,0.03,0.05,0.03,0.05,0.08,0.08,0.16,0.08,0.16,Matches,James Tarkowski,D C,29,138,150,"England,Poland",Everton,3,6,10,8,13,4,16,6,7,15,14,10,15,12,13,15,14,14,15,10,12,13,10,13,8,14,16,15,14,10,13,14,14,14,13,13,14,10,12,9,8,3,1,4,2,3,2,1,1,2,3,3,12,15,5,7,13,7,11,12,1,1,20,10,1,1,9,1,1,1,1,1,1,1,186,77,9,20,53683875,7200,6900,6000,Northern_European,138,5,1992/11/19,2,0,104393.0,,29055569
504,Marcus Tavernier,Bournemouth,1999,507.0,eng ENG,MFFW,23.0,19.4,33.0,22.0,19.0,11.0,3.0,11.0,33.0,33.3,22.0,25.0,4.0,21.0,9.0,42.0,23.0,0.0,Matches,507.0,eng ENG,MFFW,23.0,19.4,48.0,2.48,31.0,7.0,5.0,3.0,2.0,0.0,8.0,0.41,3.0,2.0,1.0,2.0,0.0,0.0,Matches,,,,,,,,,,,,,,,,,,,,,,,,,,,,,,,,,,,,,,,,,,,,,,,,,,,,,,,,507.0,eng ENG,MFFW,23.0,19.4,1.0,0.0,0.0,21.0,28.0,4.0,93.0,9.0,22.0,0.0,0.0,0.0,124.0,17.0,32.0,34.7,Matches,507.0,eng ENG,MFFW,23.0,19.4,724.0,623.0,100.0,21.0,5.0,7.0,93.0,34.0,42.0,22.0,11.0,3.0,510.0,1.0,28.0,Matches,507.0,eng ENG,MFFW,23.0,19.4,510.0,724.0,70.4,8048.0,2431.0,285.0,339.0,84.1,165.0,225.0,73.3,40.0,100.0,40.0,4.0,2.9,1.3,1.1,19.0,34.0,16.0,5.0,56.0,Matches,638,eng ENG,MFFW,23,23,1743.0,76.0,51.0,19.4,19,83.0,10,4,40.0,0,1.39,25.0,37.0,-12.0,-0.62,0.56,19.6,31.8,-12.2,-0.63,0.08,Matches,507.0,eng ENG,MFFW,23.0,19.4,1008.0,37.0,200.0,390.0,450.0,59.0,1008.0,97.0,46.0,47.4,45.0,46.4,592.0,4060.0,2028.0,67.0,43.0,21.0,46.0,40.0,636.0,137.0,Matches,507.0,eng ENG,MFFW,23.0,19.4,5.0,37.0,14.0,37.8,1.91,0.72,0.14,0.36,17.3,2.0,0.0,0.0,3.1,3.1,0.08,1.9,1.9,Matches,507.0,eng ENG,MFFW,23.0,23.0,19.0,1743.0,19.4,5.0,4.0,9.0,5.0,0.0,0.0,1.0,0.0,3.1,3.1,2.9,6.0,67.0,56.0,137.0,0.26,0.21,0.46,0.26,0.46,0.16,0.15,0.31,0.16,0.31,Matches,Marcus Tavernier,M/AM RLC,23,127,142,England,AFC Bournemouth,12,12,14,11,13,12,7,11,6,11,13,11,9,13,10,11,11,11,10,11,11,12,12,10,14,10,14,15,14,13,13,10,10,14,14,10,12,7,11,8,16,1,2,3,3,1,1,1,1,2,3,2,12,14,9,11,11,10,10,12,1,8,1,8,14,14,1,12,18,12,15,20,15,10,178,0,20,11,13857438,6350,6350,3500,African_Caribbean,123,13,1999/3/22,0,0,28998.0,,29162667
505,Kenny Tete,Fulham,1995,509.0,nl NED,DF,26.0,28.5,83.0,46.0,41.0,29.0,13.0,38.0,51.0,74.5,13.0,48.0,17.0,31.0,52.0,135.0,81.0,1.0,Matches,509.0,nl NED,DF,26.0,28.5,49.0,1.72,39.0,5.0,0.0,0.0,3.0,2.0,12.0,0.42,11.0,1.0,0.0,0.0,0.0,0.0,Matches,,,,,,,,,,,,,,,,,,,,,,,,,,,,,,,,,,,,,,,,,,,,,,,,,,,,,,,,509.0,nl NED,DF,26.0,28.5,8.0,0.0,0.0,42.0,54.0,0.0,99.0,52.0,46.0,0.0,0.0,0.0,141.0,33.0,29.0,53.2,Matches,509.0,nl NED,DF,26.0,28.5,1530.0,1176.0,344.0,37.0,1.0,10.0,99.0,307.0,0.0,0.0,0.0,0.0,1110.0,10.0,48.0,Matches,509.0,nl NED,DF,26.0,28.5,1110.0,1530.0,72.5,17550.0,7197.0,598.0,691.0,86.5,403.0,563.0,71.6,81.0,165.0,49.1,5.0,1.9,1.9,3.1,23.0,75.0,25.0,18.0,103.0,Matches,642,nl NED,DF,26,31,2569.0,83.0,75.1,28.5,29,87.0,21,2,19.0,1,1.45,42.0,36.0,6.0,0.21,0.63,33.4,46.7,-13.2,-0.46,-0.02,Matches,509.0,nl NED,DF,26.0,28.5,1896.0,107.0,556.0,877.0,489.0,30.0,1896.0,37.0,21.0,56.8,12.0,32.4,821.0,4563.0,2401.0,75.0,55.0,4.0,22.0,24.0,946.0,69.0,Matches,509.0,nl NED,DF,26.0,28.5,1.0,13.0,5.0,38.5,0.46,0.18,0.08,0.2,18.9,0.0,0.0,0.0,0.7,0.7,0.05,0.3,0.3,Matches,509.0,nl NED,DF,26.0,31.0,29.0,2569.0,28.5,1.0,5.0,6.0,1.0,0.0,0.0,8.0,0.0,0.7,0.7,1.9,2.6,75.0,103.0,69.0,0.04,0.18,0.21,0.04,0.21,0.02,0.07,0.09,0.02,0.09,Matches,Kenny Tete,D/WB R,26,137,138,"Holland,Ghana,Mozambique",Fulham,7,16,10,7,12,7,12,10,12,14,12,7,15,12,13,13,15,12,11,10,13,14,9,8,11,14,14,15,15,11,14,12,14,14,15,14,12,10,14,8,13,2,2,3,3,2,1,3,1,3,2,1,12,12,10,12,11,12,4,8,1,11,14,20,11,19,1,1,1,1,1,1,1,1,180,71,10,20,28764795,6842,6842,5242,African_Caribbean,135,13,1995/10/9,13,0,40597.0,,37039829
506,Luke Thomas,Leicester City,2001,510.0,eng ENG,DF,21.0,11.9,23.0,19.0,15.0,5.0,3.0,15.0,32.0,46.9,17.0,20.0,4.0,16.0,27.0,50.0,35.0,0.0,Matches,510.0,eng ENG,DF,21.0,11.9,16.0,1.34,11.0,2.0,0.0,1.0,0.0,2.0,2.0,0.17,1.0,0.0,0.0,1.0,0.0,0.0,Matches,,,,,,,,,,,,,,,,,,,,,,,,,,,,,,,,,,,,,,,,,,,,,,,,,,,,,,,,510.0,eng ENG,DF,21.0,11.9,3.0,0.0,0.0,12.0,7.0,0.0,9.0,27.0,19.0,0.0,0.0,1.0,69.0,11.0,14.0,44.0,Matches,510.0,eng ENG,DF,21.0,11.9,654.0,519.0,133.0,17.0,3.0,1.0,9.0,116.0,0.0,0.0,0.0,0.0,521.0,2.0,22.0,Matches,510.0,eng ENG,DF,21.0,11.9,521.0,654.0,79.7,8116.0,3439.0,291.0,329.0,88.4,194.0,238.0,81.5,32.0,57.0,56.1,0.0,0.7,0.5,-0.7,5.0,38.0,7.0,2.0,48.0,Matches,643,eng ENG,DF,21,17,1073.0,63.0,31.4,11.9,11,86.0,8,6,21.0,19,0.88,14.0,20.0,-6.0,-0.5,-0.08,16.8,23.2,-6.4,-0.54,-0.29,Matches,510.0,eng ENG,DF,21.0,11.9,786.0,39.0,319.0,359.0,115.0,3.0,786.0,12.0,6.0,50.0,5.0,41.7,355.0,1374.0,610.0,10.0,8.0,1.0,9.0,8.0,414.0,13.0,Matches,510.0,eng ENG,DF,21.0,11.9,0.0,3.0,0.0,0.0,0.25,0.0,0.0,,16.6,0.0,0.0,0.0,0.1,0.1,0.03,-0.1,-0.1,Matches,510.0,eng ENG,DF,21.0,17.0,11.0,1073.0,11.9,0.0,0.0,0.0,0.0,0.0,0.0,3.0,0.0,0.1,0.1,0.7,0.8,10.0,48.0,13.0,0.0,0.0,0.0,0.0,0.0,0.01,0.06,0.07,0.01,0.07,Matches,Luke Thomas,D/WB L,21,134,160,England,Leicester City,10,15,13,10,14,11,12,11,11,13,14,9,14,13,8,13,13,13,12,11,13,14,7,10,11,12,13,16,14,12,9,11,14,13,15,10,14,8,13,5,16,2,1,3,3,1,1,2,3,1,2,1,11,12,6,15,12,14,14,15,1,20,8,1,17,1,8,12,8,1,1,1,1,1,181,0,20,10,44529227,6700,6700,5150,Northern_European,131,2,2001/6/10,0,0,28998.0,,28117365
507,Youri Tielemans,Leicester City,1997,511.0,be BEL,MF,25.0,26.0,66.0,39.0,27.0,30.0,9.0,23.0,62.0,37.1,39.0,35.0,8.0,27.0,28.0,94.0,24.0,1.0,Matches,511.0,be BEL,MF,25.0,26.0,78.0,2.99,64.0,4.0,1.0,7.0,1.0,1.0,4.0,0.15,2.0,1.0,0.0,1.0,0.0,0.0,Matches,,,,,,,,,,,,,,,,,,,,,,,,,,,,,,,,,,,,,,,,,,,,,,,,,,,,,,,,511.0,be BEL,MF,25.0,26.0,4.0,0.0,0.0,33.0,25.0,1.0,45.0,28.0,39.0,0.0,0.0,0.0,195.0,26.0,12.0,68.4,Matches,511.0,be BEL,MF,25.0,26.0,1623.0,1517.0,100.0,51.0,12.0,8.0,45.0,16.0,20.0,8.0,9.0,0.0,1303.0,6.0,38.0,Matches,511.0,be BEL,MF,25.0,26.0,1303.0,1623.0,80.3,21370.0,7448.0,651.0,734.0,88.7,501.0,592.0,84.6,111.0,208.0,53.4,2.0,4.7,3.3,-2.7,30.0,169.0,28.0,7.0,181.0,Matches,644,be BEL,MF,25,31,2344.0,76.0,68.5,26.0,27,82.0,16,4,30.0,0,0.97,35.0,49.0,-14.0,-0.54,-0.29,33.0,45.0,-12.0,-0.46,-0.39,Matches,511.0,be BEL,MF,25.0,26.0,1877.0,62.0,436.0,1080.0,382.0,14.0,1875.0,35.0,26.0,74.3,5.0,14.3,952.0,4043.0,2088.0,35.0,25.0,1.0,33.0,15.0,1309.0,56.0,Matches,511.0,be BEL,MF,25.0,26.0,3.0,29.0,8.0,27.6,1.11,0.31,0.07,0.25,27.7,1.0,1.0,2.0,2.5,0.9,0.03,0.5,1.1,Matches,511.0,be BEL,MF,25.0,31.0,27.0,2344.0,26.0,3.0,2.0,5.0,2.0,1.0,2.0,4.0,0.0,2.5,0.9,4.7,5.6,35.0,181.0,56.0,0.12,0.08,0.19,0.08,0.15,0.1,0.18,0.28,0.04,0.21,Matches,Youri Tielemans,DM/M C,25,152,170,"Belgium,Democratic Republic of Congo",Leicester City,11,13,13,12,16,12,9,12,3,11,18,15,12,17,13,15,12,15,12,17,16,14,15,14,15,12,14,13,12,13,12,8,17,10,12,10,14,8,12,5,15,1,2,3,2,2,1,3,1,2,2,1,11,17,7,13,13,14,15,15,1,1,1,1,1,1,18,8,20,8,1,14,1,1,176,72,14,20,44325652,7600,7600,6500,Mixed_Race,150,12,1997/5/7,52,5,139190.0,,18077264
508,Harry Toffolo,Nott'ham Forest,1995,513.0,eng ENG,DF,26.0,10.4,17.0,8.0,10.0,4.0,3.0,10.0,14.0,71.4,4.0,16.0,8.0,8.0,10.0,27.0,33.0,0.0,Matches,513.0,eng ENG,DF,26.0,10.4,19.0,1.82,14.0,3.0,1.0,0.0,0.0,1.0,0.0,0.0,0.0,0.0,0.0,0.0,0.0,0.0,Matches,,,,,,,,,,,,,,,,,,,,,,,,,,,,,,,,,,,,,,,,,,,,,,,,,,,,,,,,513.0,eng ENG,DF,26.0,10.4,2.0,0.0,0.0,10.0,5.0,0.0,29.0,10.0,8.0,0.0,1.0,0.0,54.0,13.0,14.0,48.1,Matches,513.0,eng ENG,DF,26.0,10.4,387.0,313.0,72.0,5.0,0.0,1.0,29.0,65.0,2.0,2.0,0.0,0.0,242.0,2.0,12.0,Matches,513.0,eng ENG,DF,26.0,10.4,242.0,387.0,62.5,3806.0,1892.0,136.0,166.0,81.9,92.0,148.0,62.2,11.0,47.0,23.4,0.0,0.8,0.9,-0.8,5.0,14.0,7.0,4.0,29.0,Matches,646,eng ENG,DF,26,19,940.0,49.0,27.5,10.4,9,86.0,7,10,16.0,10,1.0,7.0,17.0,-10.0,-0.96,-0.23,9.5,18.7,-9.2,-0.88,-0.31,Matches,513.0,eng ENG,DF,26.0,10.4,498.0,48.0,175.0,179.0,151.0,12.0,498.0,9.0,3.0,33.3,5.0,55.6,191.0,721.0,342.0,8.0,6.0,4.0,10.0,6.0,223.0,43.0,Matches,513.0,eng ENG,DF,26.0,10.4,0.0,6.0,2.0,33.3,0.57,0.19,0.0,0.0,17.6,0.0,0.0,0.0,0.3,0.3,0.05,-0.3,-0.3,Matches,513.0,eng ENG,DF,26.0,19.0,9.0,940.0,10.4,0.0,0.0,0.0,0.0,0.0,0.0,2.0,0.0,0.3,0.3,0.8,1.0,8.0,29.0,43.0,0.0,0.0,0.0,0.0,0.0,0.03,0.07,0.1,0.03,0.1,Matches,Harry Toffolo,D/WB L,26,120,130,"England,Italy",Nottingham Forest,12,13,11,12,13,14,12,10,10,11,12,7,12,12,11,12,11,12,11,13,13,12,7,9,12,12,13,12,13,12,11,10,14,12,15,11,14,6,9,7,12,1,1,3,1,3,2,2,2,2,1,3,11,10,3,11,11,14,10,11,1,20,1,1,19,1,1,14,1,1,1,1,1,1,183,71,20,8,1832428,6000,6000,3500,Northern_European,118,3,1995/8/19,0,0,40597.0,,29079834
509,Ivan Toney,Brentford,1996,516.0,eng ENG,FW,26.0,32.8,23.0,13.0,4.0,9.0,10.0,7.0,23.0,30.4,16.0,24.0,9.0,15.0,14.0,37.0,36.0,0.0,Matches,516.0,eng ENG,FW,26.0,32.8,66.0,2.01,39.0,4.0,4.0,5.0,14.0,0.0,8.0,0.24,3.0,0.0,1.0,0.0,4.0,0.0,Matches,,,,,,,,,,,,,,,,,,,,,,,,,,,,,,,,,,,,,,,,,,,,,,,,,,,,,,,,516.0,eng ENG,FW,26.0,32.8,9.0,0.0,0.0,52.0,74.0,27.0,34.0,14.0,13.0,3.0,0.0,0.0,103.0,109.0,117.0,48.2,Matches,516.0,eng ENG,FW,26.0,32.8,787.0,751.0,29.0,8.0,12.0,3.0,34.0,10.0,1.0,0.0,0.0,0.0,468.0,7.0,31.0,Matches,516.0,eng ENG,FW,26.0,32.8,468.0,787.0,59.5,5947.0,2037.0,299.0,424.0,70.5,103.0,180.0,57.2,24.0,53.0,45.3,4.0,5.1,3.5,-1.1,27.0,54.0,26.0,5.0,79.0,Matches,649,eng ENG,FW,26,33,2951.0,89.0,86.3,32.8,33,89.0,29,0,,0,1.39,47.0,42.0,5.0,0.15,-1.19,47.0,42.6,4.4,0.13,-0.31,Matches,516.0,eng ENG,FW,26.0,32.8,1219.0,50.0,141.0,529.0,557.0,156.0,1212.0,54.0,16.0,29.6,29.0,53.7,625.0,2463.0,724.0,14.0,21.0,8.0,100.0,47.0,889.0,165.0,Matches,516.0,eng ENG,FW,26.0,32.8,20.0,87.0,33.0,37.9,2.65,1.01,0.16,0.42,16.5,9.0,6.0,7.0,18.7,13.2,0.15,1.3,0.8,Matches,516.0,eng ENG,FW,26.0,33.0,33.0,2951.0,32.8,20.0,4.0,24.0,14.0,6.0,7.0,9.0,0.0,18.7,13.2,5.1,18.3,14.0,79.0,165.0,0.61,0.12,0.73,0.43,0.55,0.57,0.15,0.73,0.4,0.56,Matches,Ivan Toney,S,26,143,150,"England,Jamaica",Brentford,4,10,12,16,13,9,15,13,5,4,12,19,8,14,15,12,14,14,12,12,13,16,12,14,12,10,15,15,14,12,13,15,14,15,14,15,17,15,15,5,11,3,3,4,2,3,1,1,2,2,3,3,14,16,11,11,14,15,7,7,1,1,1,1,1,1,1,1,1,1,1,1,1,20,187,87,11,20,44049485,7144,6994,5744,African_Caribbean,143,15,1996/3/16,0,0,52196.0,,29116247
510,Adama Traoré,Wolves,1996,517.0,es ESP,FWMF,26.0,16.6,14.0,7.0,7.0,4.0,3.0,4.0,9.0,44.4,5.0,8.0,1.0,7.0,3.0,17.0,17.0,0.0,Matches,517.0,es ESP,FWMF,26.0,16.6,45.0,2.71,37.0,0.0,3.0,2.0,3.0,0.0,4.0,0.24,2.0,0.0,0.0,2.0,0.0,0.0,Matches,,,,,,,,,,,,,,,,,,,,,,,,,,,,,,,,,,,,,,,,,,,,,,,,,,,,,,,,517.0,es ESP,FWMF,26.0,16.6,2.0,0.0,0.0,21.0,34.0,7.0,81.0,3.0,7.0,0.0,0.0,0.0,66.0,39.0,25.0,60.9,Matches,517.0,es ESP,FWMF,26.0,16.6,494.0,491.0,1.0,0.0,3.0,0.0,81.0,1.0,0.0,0.0,0.0,0.0,325.0,2.0,27.0,Matches,517.0,es ESP,FWMF,26.0,16.6,325.0,494.0,65.8,4826.0,1228.0,198.0,264.0,75.0,85.0,129.0,65.9,25.0,46.0,54.3,1.0,3.7,3.2,-2.7,24.0,17.0,22.0,14.0,36.0,Matches,650,es ESP,FWMF,26,34,1496.0,44.0,43.7,16.6,12,73.0,3,22,28.0,2,1.18,12.0,30.0,-18.0,-1.08,-0.66,17.6,30.2,-12.6,-0.76,-0.27,Matches,517.0,es ESP,FWMF,26.0,16.6,715.0,18.0,102.0,253.0,379.0,56.0,715.0,111.0,56.0,50.5,34.0,30.6,462.0,4043.0,2113.0,85.0,41.0,25.0,59.0,27.0,556.0,157.0,Matches,517.0,es ESP,FWMF,26.0,16.6,2.0,19.0,7.0,36.8,1.14,0.42,0.11,0.29,15.0,0.0,0.0,0.0,1.4,1.4,0.07,0.6,0.6,Matches,517.0,es ESP,FWMF,26.0,34.0,12.0,1496.0,16.6,2.0,1.0,3.0,2.0,0.0,0.0,2.0,0.0,1.4,1.4,3.7,5.1,85.0,36.0,157.0,0.12,0.06,0.18,0.12,0.18,0.08,0.23,0.31,0.08,0.31,Matches,Adama Traoré,M/AM RL,26,146,154,"Spain,Mali",Wolverhampton Wanderers,7,13,18,10,12,8,10,13,7,7,11,9,7,12,12,9,11,10,8,10,6,14,18,5,9,10,9,10,20,15,15,14,12,20,10,17,9,11,10,6,11,2,3,2,2,1,1,1,2,1,1,4,11,14,11,10,12,11,10,11,1,1,1,1,1,13,1,16,1,18,16,10,20,13,178,72,10,20,39437190,7300,7450,6250,African_Caribbean,136,14,1996/1/25,9,0,49876.0,,67174729
511,Mark Travers,Bournemouth,1999,520.0,ie IRL,GK,23.0,11.5,0.0,0.0,0.0,0.0,0.0,0.0,0.0,,0.0,1.0,0.0,1.0,0.0,0.0,6.0,0.0,Matches,520.0,ie IRL,GK,23.0,11.5,0.0,0.0,0.0,0.0,0.0,0.0,0.0,0.0,0.0,0.0,0.0,0.0,0.0,0.0,0.0,0.0,Matches,37.0,ie IRL,GK,23.0,11.5,32.0,2.0,0.0,8.0,2.0,24.0,0.34,-6.0,-0.52,71.0,154.0,46.1,250.0,54.0,35.6,31.9,118.0,55.1,43.8,229.0,5.0,2.2,5.0,0.43,10.5,Matches,37.0,ie IRL,GK,23.0,12.0,11.0,1035.0,11.5,32.0,2.78,66.0,36.0,54.5,2.0,0.0,9.0,2.0,18.2,2.0,2.0,0.0,0.0,0.0,Matches,520.0,ie IRL,GK,23.0,11.5,0.0,0.0,0.0,0.0,0.0,0.0,0.0,0.0,0.0,0.0,0.0,0.0,6.0,4.0,0.0,100.0,Matches,520.0,ie IRL,GK,23.0,11.5,368.0,214.0,154.0,35.0,0.0,0.0,0.0,1.0,0.0,0.0,0.0,0.0,281.0,0.0,0.0,Matches,520.0,ie IRL,GK,23.0,11.5,281.0,368.0,76.4,7963.0,5655.0,97.0,97.0,100.0,101.0,102.0,99.0,82.0,168.0,48.8,0.0,0.0,0.0,0.0,0.0,5.0,0.0,0.0,0.0,Matches,653,ie IRL,GK,23,12,1035.0,86.0,30.3,11.5,11,90.0,11,1,45.0,26,0.5,10.0,32.0,-22.0,-1.91,-1.46,7.9,19.8,-11.9,-1.03,-0.53,Matches,520.0,ie IRL,GK,23.0,11.5,402.0,373.0,401.0,1.0,0.0,0.0,402.0,0.0,0.0,,0.0,,182.0,884.0,457.0,0.0,0.0,0.0,0.0,0.0,145.0,0.0,Matches,520.0,ie IRL,GK,23.0,11.5,0.0,0.0,0.0,,0.0,0.0,,,,0.0,0.0,0.0,0.0,0.0,,0.0,0.0,Matches,520.0,ie IRL,GK,23.0,12.0,11.0,1035.0,11.5,0.0,0.0,0.0,0.0,0.0,0.0,0.0,0.0,0.0,0.0,0.0,0.0,0.0,0.0,0.0,0.0,0.0,0.0,0.0,0.0,0.0,0.0,0.0,0.0,0.0,Matches,Mark Travers,GK,23,125,145,Republic of Ireland,AFC Bournemouth,7,3,1,1,9,8,1,1,3,2,10,2,3,10,8,14,12,10,12,11,11,12,6,8,3,14,11,12,11,13,10,13,14,11,15,11,13,7,12,9,12,14,11,13,7,14,14,12,15,8,7,14,10,10,6,15,13,14,12,12,20,1,1,1,1,1,1,1,1,1,1,1,1,1,191,0,8,20,8818215,6250,6250,3757,Northern_European,123,4,1999/5/18,3,0,23198.0,,52080573
512,Kieran Trippier,Newcastle Utd,1990,521.0,eng ENG,DF,31.0,37.1,71.0,49.0,36.0,27.0,8.0,46.0,90.0,51.1,44.0,45.0,15.0,30.0,43.0,114.0,84.0,2.0,Matches,521.0,eng ENG,DF,31.0,37.1,178.0,4.79,79.0,94.0,1.0,1.0,2.0,1.0,10.0,0.27,6.0,4.0,0.0,0.0,0.0,0.0,Matches,,,,,,,,,,,,,,,,,,,,,,,,,,,,,,,,,,,,,,,,,,,,,,,,,,,,,,,,521.0,eng ENG,DF,31.0,37.1,5.0,0.0,0.0,48.0,29.0,7.0,393.0,43.0,49.0,0.0,1.0,1.0,264.0,49.0,35.0,58.3,Matches,521.0,eng ENG,DF,31.0,37.1,2788.0,2061.0,714.0,180.0,16.0,16.0,393.0,318.0,216.0,93.0,82.0,15.0,1995.0,13.0,50.0,Matches,521.0,eng ENG,DF,31.0,37.1,1995.0,2788.0,71.6,38118.0,16809.0,877.0,992.0,88.4,745.0,980.0,76.0,333.0,674.0,49.4,7.0,12.4,11.8,-5.4,110.0,182.0,97.0,26.0,260.0,Matches,655,eng ENG,DF,31,38,3341.0,88.0,97.7,37.1,38,88.0,31,0,,0,1.87,65.0,31.0,34.0,0.92,-0.22,70.4,37.6,32.8,0.88,1.37,Matches,521.0,eng ENG,DF,31.0,37.1,3102.0,124.0,774.0,1282.0,1066.0,26.0,3102.0,35.0,19.0,54.3,12.0,34.3,1300.0,4599.0,2393.0,45.0,46.0,1.0,27.0,9.0,1593.0,151.0,Matches,521.0,eng ENG,DF,31.0,37.1,1.0,14.0,4.0,28.6,0.38,0.11,0.07,0.25,27.1,12.0,0.0,0.0,0.9,0.9,0.06,0.1,0.1,Matches,521.0,eng ENG,DF,31.0,38.0,38.0,3341.0,37.1,1.0,7.0,8.0,1.0,0.0,0.0,5.0,0.0,0.9,0.9,12.4,13.3,45.0,260.0,151.0,0.03,0.19,0.22,0.03,0.22,0.02,0.33,0.36,0.02,0.36,Matches,Kieran Trippier,D/WB RL,31,152,153,England,Newcastle United,14,16,12,9,14,16,11,10,11,13,13,5,15,14,12,14,13,15,13,14,14,15,8,16,15,14,16,17,13,13,14,9,16,14,16,12,15,8,11,7,13,3,4,1,1,2,2,1,3,3,3,2,13,12,4,12,13,15,14,14,1,15,1,20,14,19,1,1,1,13,1,1,1,1,178,72,8,20,347975206,7595,7745,6595,Northern_European,146,7,1990/9/19,37,1,115992.0,,28018613
513,Leandro Trossard,Arsenal,1994,522.0,be BEL,FW,27.0,10.3,12.0,7.0,4.0,2.0,6.0,6.0,18.0,33.3,12.0,18.0,0.0,18.0,6.0,18.0,3.0,1.0,Matches,522.0,be BEL,FW,27.0,10.3,34.0,3.29,23.0,7.0,1.0,1.0,2.0,0.0,9.0,0.87,8.0,1.0,0.0,0.0,0.0,0.0,Matches,,,,,,,,,,,,,,,,,,,,,,,,,,,,,,,,,,,,,,,,,,,,,,,,,,,,,,,,522.0,be BEL,FW,27.0,10.3,0.0,0.0,0.0,9.0,17.0,4.0,55.0,6.0,7.0,0.0,0.0,0.0,46.0,1.0,4.0,20.0,Matches,522.0,be BEL,FW,27.0,10.3,452.0,402.0,47.0,3.0,6.0,6.0,55.0,5.0,31.0,22.0,1.0,0.0,347.0,3.0,19.0,Matches,522.0,be BEL,FW,27.0,10.3,347.0,452.0,76.8,5770.0,1501.0,165.0,191.0,86.4,133.0,158.0,84.2,35.0,59.0,59.3,10.0,4.7,3.9,5.3,22.0,20.0,30.0,5.0,57.0,Matches,656,be BEL,FW,27,20,931.0,47.0,27.2,10.3,10,66.0,1,10,27.0,0,1.85,29.0,15.0,14.0,1.35,0.23,20.1,11.3,8.8,0.85,0.1,Matches,522.0,be BEL,FW,27.0,10.3,567.0,9.0,64.0,179.0,331.0,43.0,567.0,26.0,15.0,57.7,6.0,23.1,374.0,2386.0,1107.0,36.0,16.0,10.0,18.0,23.0,417.0,102.0,Matches,522.0,be BEL,FW,27.0,10.3,1.0,17.0,5.0,29.4,1.64,0.48,0.06,0.2,17.5,0.0,0.0,0.0,1.8,1.8,0.11,-0.8,-0.8,Matches,522.0,be BEL,FW,27.0,20.0,10.0,931.0,10.3,1.0,10.0,11.0,1.0,0.0,0.0,0.0,0.0,1.8,1.8,4.7,6.6,36.0,57.0,102.0,0.1,0.97,1.06,0.1,1.06,0.18,0.46,0.64,0.18,0.64,Matches,Leandro Trossard,WB/M/AM LC,27,152,157,Belgium,Brighton & Hove Albion,14,12,15,14,14,12,5,13,4,6,14,15,4,16,13,12,13,13,14,15,13,11,15,8,15,9,10,12,16,13,13,6,10,15,13,9,14,8,15,8,17,1,2,3,1,3,2,2,1,2,3,2,12,14,6,8,12,11,12,11,1,1,1,1,17,1,1,17,1,1,20,19,14,15,172,67,15,20,50900273,7600,7600,6250,Northern_European,143,2,1994/12/4,19,5,69595.0,,18054004
514,Virgil van Dijk,Liverpool,1991,527.0,nl NED,DF,31.0,31.5,27.0,14.0,13.0,11.0,3.0,8.0,19.0,42.1,11.0,24.0,16.0,8.0,31.0,58.0,138.0,3.0,Matches,527.0,nl NED,DF,31.0,31.5,22.0,0.7,17.0,0.0,0.0,4.0,0.0,1.0,3.0,0.1,2.0,0.0,0.0,1.0,0.0,0.0,Matches,,,,,,,,,,,,,,,,,,,,,,,,,,,,,,,,,,,,,,,,,,,,,,,,,,,,,,,,527.0,nl NED,DF,31.0,31.5,3.0,0.0,0.0,13.0,3.0,3.0,1.0,31.0,14.0,0.0,1.0,0.0,168.0,98.0,34.0,74.2,Matches,527.0,nl NED,DF,31.0,31.5,2592.0,2492.0,99.0,73.0,1.0,31.0,1.0,9.0,0.0,0.0,0.0,0.0,2345.0,1.0,9.0,Matches,527.0,nl NED,DF,31.0,31.5,2345.0,2592.0,90.5,45523.0,16670.0,843.0,900.0,93.7,1236.0,1306.0,94.6,244.0,344.0,70.9,1.0,1.2,1.1,-0.2,7.0,156.0,6.0,0.0,127.0,Matches,664,nl NED,DF,31,32,2835.0,89.0,82.9,31.5,32,89.0,31,0,,1,1.91,68.0,36.0,32.0,1.02,1.63,60.9,40.5,20.4,0.65,0.46,Matches,527.0,nl NED,DF,31.0,31.5,2876.0,361.0,1327.0,1427.0,128.0,66.0,2876.0,2.0,2.0,100.0,0.0,0.0,1760.0,6644.0,3152.0,10.0,14.0,2.0,7.0,0.0,2085.0,8.0,Matches,527.0,nl NED,DF,31.0,31.5,3.0,30.0,9.0,30.0,0.95,0.29,0.1,0.33,12.8,0.0,0.0,0.0,2.6,2.6,0.09,0.4,0.4,Matches,527.0,nl NED,DF,31.0,32.0,32.0,2835.0,31.5,3.0,1.0,4.0,3.0,0.0,0.0,3.0,0.0,2.6,2.6,1.2,3.8,10.0,127.0,8.0,0.1,0.03,0.13,0.1,0.13,0.08,0.04,0.12,0.08,0.12,Matches,Virgil van Dijk,D C,31,181,183,"Holland,Suriname",Liverpool,3,5,13,8,17,12,18,7,8,17,16,7,17,16,17,17,15,17,16,14,17,16,12,17,8,17,14,12,15,12,15,17,17,16,14,17,18,12,18,5,4,3,2,1,3,3,2,3,1,3,2,3,18,18,10,12,17,16,12,18,1,1,20,1,1,1,12,1,1,1,1,1,1,10,193,92,9,20,347975206,9150,8700,8500,African_Caribbean,182,14,1991/7/8,47,5,278380.0,,37024025
515,Raphaël Varane,Manchester Utd,1993,528.0,fr FRA,DF,29.0,21.2,24.0,9.0,18.0,6.0,0.0,7.0,17.0,41.2,10.0,24.0,17.0,7.0,11.0,35.0,91.0,0.0,Matches,528.0,fr FRA,DF,29.0,21.2,17.0,0.8,12.0,1.0,0.0,3.0,0.0,1.0,0.0,0.0,0.0,0.0,0.0,0.0,0.0,0.0,Matches,,,,,,,,,,,,,,,,,,,,,,,,,,,,,,,,,,,,,,,,,,,,,,,,,,,,,,,,528.0,fr FRA,DF,29.0,21.2,1.0,0.0,0.0,12.0,3.0,2.0,1.0,11.0,9.0,0.0,0.0,1.0,100.0,42.0,16.0,72.4,Matches,528.0,fr FRA,DF,29.0,21.2,1106.0,1073.0,30.0,27.0,2.0,4.0,1.0,3.0,0.0,0.0,0.0,0.0,954.0,3.0,6.0,Matches,528.0,fr FRA,DF,29.0,21.2,954.0,1106.0,86.3,17988.0,5712.0,319.0,355.0,89.9,551.0,597.0,92.3,72.0,128.0,56.3,0.0,0.2,0.5,-0.2,4.0,82.0,3.0,0.0,63.0,Matches,665,fr FRA,DF,29,24,1911.0,80.0,55.9,21.2,22,85.0,16,2,23.0,6,1.96,28.0,22.0,6.0,0.28,-0.25,33.3,26.8,6.5,0.31,-0.34,Matches,528.0,fr FRA,DF,29.0,21.2,1293.0,153.0,611.0,631.0,54.0,18.0,1293.0,10.0,6.0,60.0,4.0,40.0,797.0,5357.0,3030.0,17.0,15.0,0.0,2.0,1.0,850.0,4.0,Matches,528.0,fr FRA,DF,29.0,21.2,0.0,8.0,4.0,50.0,0.38,0.19,0.0,0.0,11.6,0.0,0.0,0.0,0.7,0.7,0.09,-0.7,-0.7,Matches,528.0,fr FRA,DF,29.0,24.0,22.0,1911.0,21.2,0.0,0.0,0.0,0.0,0.0,0.0,1.0,0.0,0.7,0.7,0.2,0.9,17.0,63.0,4.0,0.0,0.0,0.0,0.0,0.0,0.03,0.01,0.04,0.03,0.04,Matches,Raphaël Varane,D C,29,160,172,"France,Martinique",Manchester UFC,4,6,10,6,13,8,16,6,10,17,14,10,16,14,11,16,13,13,15,9,13,12,11,10,6,17,14,12,16,13,11,17,16,16,15,15,14,6,15,14,14,1,3,2,3,1,2,3,3,2,3,3,12,16,8,13,17,14,17,16,1,1,20,10,1,1,6,1,1,1,1,1,1,1,191,81,8,20,198946111,8000,8150,8000,North_African__Middle_Eastern,159,12,1993/4/25,86,5,405971.0,,85075627
516,Jamie Vardy,Leicester City,1987,529.0,eng ENG,FW,35.0,20.6,9.0,5.0,4.0,2.0,3.0,1.0,8.0,12.5,7.0,17.0,3.0,14.0,2.0,11.0,30.0,0.0,Matches,529.0,eng ENG,FW,35.0,20.6,34.0,1.65,23.0,0.0,6.0,3.0,2.0,0.0,7.0,0.34,5.0,0.0,1.0,0.0,1.0,0.0,Matches,,,,,,,,,,,,,,,,,,,,,,,,,,,,,,,,,,,,,,,,,,,,,,,,,,,,,,,,529.0,eng ENG,FW,35.0,20.6,1.0,0.0,0.0,21.0,7.0,29.0,7.0,2.0,5.0,2.0,0.0,0.0,41.0,47.0,78.0,37.6,Matches,529.0,eng ENG,FW,35.0,20.6,263.0,239.0,23.0,0.0,3.0,1.0,7.0,0.0,0.0,0.0,0.0,0.0,137.0,1.0,9.0,Matches,529.0,eng ENG,FW,35.0,20.6,137.0,263.0,52.1,1931.0,364.0,69.0,119.0,58.0,47.0,88.0,53.4,7.0,15.0,46.7,4.0,1.4,0.7,2.6,14.0,7.0,5.0,1.0,14.0,Matches,666,eng ENG,FW,35,37,1857.0,50.0,54.3,20.6,19,74.0,6,18,26.0,1,0.92,24.0,38.0,-14.0,-0.68,-0.51,23.8,34.0,-10.2,-0.5,-0.35,Matches,529.0,eng ENG,FW,35.0,20.6,437.0,32.0,59.0,175.0,206.0,71.0,436.0,29.0,12.0,41.4,14.0,48.3,192.0,926.0,358.0,16.0,9.0,13.0,33.0,16.0,261.0,101.0,Matches,529.0,eng ENG,FW,35.0,20.6,3.0,27.0,13.0,48.1,1.31,0.63,0.11,0.23,12.3,0.0,0.0,1.0,6.7,5.9,0.22,-3.7,-2.9,Matches,529.0,eng ENG,FW,35.0,37.0,19.0,1857.0,20.6,3.0,4.0,7.0,3.0,0.0,1.0,1.0,0.0,6.7,5.9,1.4,7.3,16.0,14.0,101.0,0.15,0.19,0.34,0.15,0.34,0.32,0.07,0.39,0.29,0.35,Matches,Jamie Vardy,S,35,153,163,England,Leicester City,7,12,12,17,14,7,12,12,5,3,12,17,12,15,17,15,17,15,16,14,13,17,12,13,16,5,16,16,17,12,12,11,16,15,16,13,14,17,14,13,10,1,3,3,3,2,1,2,2,3,2,3,8,16,14,18,15,16,10,7,1,1,1,1,1,1,1,1,1,1,12,10,12,20,179,72,10,20,347975206,7650,7400,6500,Northern_European,152,5,1987/1/11,26,7,185587.0,,90008752
517,Joël Veltman,Brighton,1992,530.0,nl NED,DF,30.0,24.3,62.0,32.0,44.0,14.0,4.0,37.0,57.0,64.9,20.0,27.0,8.0,19.0,19.0,81.0,51.0,0.0,Matches,530.0,nl NED,DF,30.0,24.3,36.0,1.48,30.0,4.0,0.0,1.0,0.0,1.0,4.0,0.16,3.0,0.0,0.0,1.0,0.0,0.0,Matches,,,,,,,,,,,,,,,,,,,,,,,,,,,,,,,,,,,,,,,,,,,,,,,,,,,,,,,,530.0,nl NED,DF,30.0,24.3,6.0,0.0,0.0,27.0,38.0,0.0,23.0,19.0,32.0,0.0,1.0,0.0,125.0,26.0,18.0,59.1,Matches,530.0,nl NED,DF,30.0,24.3,1512.0,1286.0,219.0,34.0,1.0,3.0,23.0,185.0,0.0,0.0,0.0,0.0,1261.0,7.0,29.0,Matches,530.0,nl NED,DF,30.0,24.3,1261.0,1512.0,83.4,21830.0,7101.0,532.0,594.0,89.6,624.0,711.0,87.8,84.0,142.0,59.2,1.0,0.7,1.1,0.3,10.0,157.0,13.0,4.0,153.0,Matches,667,nl NED,DF,30,31,2188.0,71.0,64.0,24.3,25,79.0,14,6,35.0,2,1.71,47.0,29.0,18.0,0.74,0.67,47.5,26.2,21.3,0.88,0.75,Matches,530.0,nl NED,DF,30.0,24.3,1740.0,92.0,563.0,895.0,293.0,23.0,1740.0,20.0,5.0,25.0,8.0,40.0,952.0,4436.0,2233.0,43.0,32.0,2.0,20.0,10.0,1065.0,49.0,Matches,530.0,nl NED,DF,30.0,24.3,1.0,15.0,5.0,33.3,0.62,0.21,0.07,0.2,16.3,0.0,0.0,0.0,1.8,1.8,0.12,-0.8,-0.8,Matches,530.0,nl NED,DF,30.0,31.0,25.0,2188.0,24.3,1.0,1.0,2.0,1.0,0.0,0.0,6.0,0.0,1.8,1.8,0.7,2.5,43.0,153.0,49.0,0.04,0.04,0.08,0.04,0.08,0.07,0.03,0.1,0.07,0.1,Matches,Joël Veltman,D RC,30,139,142,Holland,Brighton & Hove Albion,7,11,10,8,13,4,14,5,9,14,13,7,16,13,17,14,14,14,16,11,14,16,9,15,11,16,14,14,12,12,11,13,16,12,14,12,16,12,13,12,11,2,2,3,3,2,3,2,2,2,2,3,8,9,4,18,15,18,14,16,1,1,20,19,1,14,10,1,1,10,1,1,1,1,182,73,8,20,24479847,6950,7000,6250,Northern_European,139,4,1992/1/15,28,2,57996.0,,37024733
518,Carlos Vinícius,Fulham,1995,534.0,br BRA,FW,27.0,12.3,4.0,1.0,0.0,2.0,2.0,0.0,4.0,0.0,4.0,7.0,0.0,7.0,0.0,4.0,10.0,0.0,Matches,534.0,br BRA,FW,27.0,12.3,16.0,1.3,13.0,0.0,2.0,0.0,1.0,0.0,6.0,0.49,5.0,0.0,1.0,0.0,0.0,0.0,Matches,,,,,,,,,,,,,,,,,,,,,,,,,,,,,,,,,,,,,,,,,,,,,,,,,,,,,,,,534.0,br BRA,FW,27.0,12.3,3.0,0.0,0.0,21.0,15.0,6.0,6.0,0.0,1.0,0.0,0.0,0.0,22.0,27.0,63.0,30.0,Matches,534.0,br BRA,FW,27.0,12.3,189.0,181.0,7.0,0.0,3.0,0.0,6.0,0.0,0.0,0.0,0.0,0.0,119.0,1.0,12.0,Matches,534.0,br BRA,FW,27.0,12.3,119.0,189.0,63.0,1470.0,387.0,71.0,102.0,69.6,32.0,47.0,68.1,4.0,9.0,44.4,2.0,0.8,0.8,1.2,7.0,12.0,5.0,1.0,15.0,Matches,672,br BRA,FW,27,28,1109.0,40.0,32.4,12.3,11,85.0,7,17,10.0,5,1.29,18.0,20.0,-2.0,-0.16,-0.32,11.6,23.6,-12.0,-0.97,-0.76,Matches,534.0,br BRA,FW,27.0,12.3,330.0,11.0,24.0,136.0,174.0,57.0,330.0,16.0,5.0,31.3,8.0,50.0,183.0,879.0,301.0,9.0,10.0,6.0,48.0,23.0,249.0,46.0,Matches,534.0,br BRA,FW,27.0,12.3,5.0,21.0,12.0,57.1,1.7,0.97,0.24,0.42,11.9,0.0,0.0,0.0,3.3,3.3,0.16,1.7,1.7,Matches,534.0,br BRA,FW,27.0,28.0,11.0,1109.0,12.3,5.0,2.0,7.0,5.0,0.0,0.0,3.0,0.0,3.3,3.3,0.8,4.0,9.0,15.0,46.0,0.41,0.16,0.57,0.41,0.57,0.27,0.06,0.33,0.27,0.33,Matches,Carlos Vinícius,S,27,136,145,Brazil,Fulham,10,12,12,14,14,11,8,12,2,7,11,15,8,15,12,14,13,16,14,14,14,14,12,10,12,8,13,12,12,11,14,15,16,14,14,17,13,10,16,8,9,2,2,1,3,1,3,3,3,2,2,2,14,14,11,10,16,15,14,13,1,1,1,1,1,1,1,1,1,1,1,1,1,20,192,86,20,11,6438724,6000,5624,5624,Mixed_Race,135,11,1995/3/25,0,0,63795.0,,19242476
519,Kyle Walker,Manchester City,1990,536.0,eng ENG,DF,32.0,21.8,13.0,9.0,8.0,5.0,0.0,4.0,24.0,16.7,20.0,12.0,2.0,10.0,18.0,31.0,22.0,0.0,Matches,536.0,eng ENG,DF,32.0,21.8,25.0,1.15,22.0,2.0,0.0,0.0,0.0,1.0,3.0,0.14,3.0,0.0,0.0,0.0,0.0,0.0,Matches,,,,,,,,,,,,,,,,,,,,,,,,,,,,,,,,,,,,,,,,,,,,,,,,,,,,,,,,536.0,eng ENG,DF,32.0,21.8,3.0,0.0,0.0,15.0,10.0,0.0,28.0,18.0,9.0,0.0,0.0,0.0,124.0,23.0,11.0,67.6,Matches,536.0,eng ENG,DF,32.0,21.8,1892.0,1732.0,158.0,25.0,4.0,21.0,28.0,133.0,0.0,0.0,0.0,0.0,1661.0,2.0,18.0,Matches,536.0,eng ENG,DF,32.0,21.8,1661.0,1892.0,87.8,29177.0,8283.0,744.0,795.0,93.6,753.0,826.0,91.2,144.0,216.0,66.7,0.0,0.2,0.9,-0.2,6.0,189.0,10.0,4.0,162.0,Matches,676,eng ENG,DF,32,27,1958.0,73.0,57.3,21.8,22,85.0,18,5,19.0,5,2.37,54.0,20.0,34.0,1.56,-0.1,44.9,20.4,24.4,1.12,-0.24,Matches,536.0,eng ENG,DF,32.0,21.8,1996.0,57.0,438.0,1198.0,370.0,15.0,1996.0,19.0,13.0,68.4,4.0,21.1,1189.0,5455.0,2900.0,50.0,40.0,2.0,14.0,6.0,1542.0,75.0,Matches,536.0,eng ENG,DF,32.0,21.8,0.0,5.0,1.0,20.0,0.23,0.05,0.0,0.0,24.8,0.0,0.0,0.0,0.4,0.4,0.08,-0.4,-0.4,Matches,536.0,eng ENG,DF,32.0,27.0,22.0,1958.0,21.8,0.0,0.0,0.0,0.0,0.0,0.0,3.0,0.0,0.4,0.4,0.2,0.7,50.0,162.0,75.0,0.0,0.0,0.0,0.0,0.0,0.02,0.01,0.03,0.02,0.03,Matches,Kyle Walker,D/WB R,32,164,164,England,Manchester City,8,11,14,7,13,11,13,8,12,14,13,6,13,13,13,16,13,13,13,12,13,16,10,11,13,14,15,16,19,13,13,11,19,18,17,13,18,5,13,7,14,2,2,4,1,3,3,1,1,2,2,1,10,15,7,14,7,13,14,15,5,10,14,20,1,18,1,1,1,5,1,1,5,1,178,83,10,20,347975206,8200,8500,7500,Mixed_Race,154,11,1990/5/28,68,0,202986.0,,28009441
520,Kyle Walker-Peters,Southampton,1997,537.0,eng ENG,DF,25.0,29.4,61.0,32.0,34.0,24.0,3.0,22.0,43.0,51.2,21.0,47.0,8.0,39.0,27.0,88.0,52.0,0.0,Matches,537.0,eng ENG,DF,25.0,29.4,53.0,1.8,33.0,4.0,8.0,3.0,4.0,1.0,3.0,0.1,1.0,1.0,0.0,0.0,0.0,1.0,Matches,,,,,,,,,,,,,,,,,,,,,,,,,,,,,,,,,,,,,,,,,,,,,,,,,,,,,,,,537.0,eng ENG,DF,25.0,29.4,4.0,0.0,0.0,25.0,41.0,1.0,50.0,27.0,32.0,0.0,1.0,0.0,156.0,16.0,28.0,36.4,Matches,537.0,eng ENG,DF,25.0,29.4,1324.0,1046.0,274.0,16.0,1.0,1.0,50.0,255.0,3.0,0.0,0.0,0.0,1019.0,4.0,51.0,Matches,537.0,eng ENG,DF,25.0,29.4,1019.0,1324.0,77.0,14866.0,5809.0,607.0,673.0,90.2,332.0,440.0,75.5,48.0,111.0,43.2,0.0,1.4,2.5,-1.4,15.0,71.0,28.0,9.0,97.0,Matches,677,eng ENG,DF,25,31,2650.0,85.0,77.5,29.4,30,88.0,26,1,20.0,1,0.68,31.0,58.0,-27.0,-0.92,0.25,29.7,50.3,-20.6,-0.7,-0.39,Matches,537.0,eng ENG,DF,25.0,29.4,1692.0,90.0,469.0,731.0,520.0,50.0,1692.0,104.0,50.0,48.1,39.0,37.5,877.0,5862.0,3236.0,102.0,76.0,19.0,39.0,43.0,917.0,114.0,Matches,537.0,eng ENG,DF,25.0,29.4,1.0,13.0,5.0,38.5,0.44,0.17,0.08,0.2,18.1,0.0,0.0,0.0,1.0,1.0,0.08,0.0,0.0,Matches,537.0,eng ENG,DF,25.0,31.0,30.0,2650.0,29.4,1.0,0.0,1.0,1.0,0.0,0.0,4.0,0.0,1.0,1.0,1.4,2.5,102.0,97.0,114.0,0.03,0.0,0.03,0.03,0.03,0.03,0.05,0.08,0.03,0.08,Matches,Kyle Walker-Peters,D/WB RL,25,145,150,"England,Antigua and Barbuda",Southampton,10,14,15,10,14,6,10,8,5,11,12,8,14,13,12,13,12,13,11,12,13,14,11,8,14,14,15,16,14,14,14,6,18,14,17,11,13,5,5,9,15,3,1,1,1,2,1,3,3,2,1,2,10,12,5,14,14,14,12,14,1,18,1,20,13,18,1,1,1,10,1,1,1,1,174,64,12,20,43479502,7250,7250,5850,African_Caribbean,135,15,1997/4/13,2,0,57996.0,,29126231
521,Aaron Wan-Bissaka,Manchester Utd,1997,538.0,eng ENG,DF,24.0,15.9,40.0,25.0,20.0,17.0,3.0,23.0,25.0,92.0,2.0,24.0,8.0,16.0,22.0,62.0,41.0,0.0,Matches,538.0,eng ENG,DF,24.0,15.9,30.0,1.88,29.0,0.0,0.0,1.0,0.0,0.0,1.0,0.06,1.0,0.0,0.0,0.0,0.0,0.0,Matches,,,,,,,,,,,,,,,,,,,,,,,,,,,,,,,,,,,,,,,,,,,,,,,,,,,,,,,,538.0,eng ENG,DF,24.0,15.9,2.0,0.0,0.0,11.0,2.0,0.0,14.0,22.0,25.0,0.0,0.0,0.0,73.0,13.0,17.0,43.3,Matches,538.0,eng ENG,DF,24.0,15.9,840.0,715.0,123.0,4.0,2.0,2.0,14.0,119.0,0.0,0.0,0.0,0.0,706.0,2.0,22.0,Matches,538.0,eng ENG,DF,24.0,15.9,706.0,840.0,84.0,9538.0,3292.0,448.0,483.0,92.8,194.0,240.0,80.8,28.0,44.0,63.6,0.0,1.0,0.9,-1.0,15.0,48.0,10.0,2.0,55.0,Matches,679,eng ENG,DF,24,19,1435.0,76.0,42.0,15.9,16,87.0,12,3,15.0,7,2.21,28.0,10.0,18.0,1.13,1.26,35.0,19.3,15.7,0.98,0.91,Matches,538.0,eng ENG,DF,24.0,15.9,1026.0,75.0,346.0,400.0,286.0,44.0,1026.0,35.0,17.0,48.6,18.0,51.4,524.0,2614.0,1370.0,41.0,24.0,4.0,14.0,10.0,600.0,64.0,Matches,538.0,eng ENG,DF,24.0,15.9,0.0,10.0,2.0,20.0,0.63,0.13,0.0,0.0,14.7,0.0,0.0,0.0,1.2,1.2,0.12,-1.2,-1.2,Matches,538.0,eng ENG,DF,24.0,19.0,16.0,1435.0,15.9,0.0,0.0,0.0,0.0,0.0,0.0,2.0,0.0,1.2,1.2,1.0,2.2,41.0,55.0,64.0,0.0,0.0,0.0,0.0,0.0,0.07,0.06,0.14,0.07,0.14,Matches,Aaron Wan-Bissaka,D R,24,138,150,"England,Democratic Republic of Congo",Manchester UFC,5,11,12,5,12,4,8,3,10,13,10,5,20,11,15,12,18,11,10,5,12,11,12,6,11,9,14,13,17,18,15,10,15,15,16,13,13,8,12,5,10,2,1,2,2,2,2,1,1,1,1,2,9,14,8,13,15,14,14,15,1,1,1,20,1,13,1,1,1,1,1,1,1,1,183,72,8,20,33915983,7100,7200,6500,African_Caribbean,131,15,1997/11/26,0,0,115992.0,,28100123
522,Danny Ward,Leicester City,1993,539.0,wls WAL,GK,29.0,26.0,1.0,1.0,1.0,0.0,0.0,1.0,3.0,33.3,2.0,0.0,0.0,0.0,0.0,1.0,14.0,2.0,Matches,539.0,wls WAL,GK,29.0,26.0,2.0,0.08,2.0,0.0,0.0,0.0,0.0,0.0,0.0,0.0,0.0,0.0,0.0,0.0,0.0,0.0,Matches,38.0,wls WAL,GK,29.0,26.0,46.0,2.0,2.0,6.0,4.0,36.5,0.29,-5.5,-0.21,94.0,303.0,31.0,750.0,154.0,29.7,30.4,190.0,42.1,35.1,355.0,20.0,5.6,42.0,1.62,15.9,Matches,38.0,wls WAL,GK,29.0,26.0,26.0,2340.0,26.0,46.0,1.77,119.0,75.0,63.0,7.0,3.0,16.0,6.0,23.1,3.0,2.0,1.0,0.0,33.3,Matches,539.0,wls WAL,GK,29.0,26.0,0.0,0.0,0.0,0.0,5.0,0.0,0.0,0.0,1.0,0.0,0.0,0.0,27.0,3.0,0.0,100.0,Matches,539.0,wls WAL,GK,29.0,26.0,945.0,679.0,261.0,71.0,0.0,4.0,0.0,0.0,0.0,0.0,0.0,0.0,708.0,5.0,2.0,Matches,539.0,wls WAL,GK,29.0,26.0,708.0,945.0,74.9,16865.0,10488.0,197.0,199.0,99.0,352.0,355.0,99.2,158.0,383.0,41.3,0.0,0.0,0.0,0.0,0.0,7.0,0.0,0.0,0.0,Matches,680,wls WAL,GK,29,26,2340.0,90.0,68.4,26.0,26,90.0,26,0,,9,0.92,37.0,46.0,-9.0,-0.35,0.32,32.9,43.1,-10.1,-0.39,-0.17,Matches,539.0,wls WAL,GK,29.0,26.0,1000.0,806.0,996.0,5.0,0.0,0.0,1000.0,0.0,0.0,,0.0,,559.0,2832.0,1665.0,0.0,0.0,0.0,0.0,0.0,482.0,0.0,Matches,539.0,wls WAL,GK,29.0,26.0,0.0,0.0,0.0,,0.0,0.0,,,,0.0,0.0,0.0,0.0,0.0,,0.0,0.0,Matches,539.0,wls WAL,GK,29.0,26.0,26.0,2340.0,26.0,0.0,0.0,0.0,0.0,0.0,0.0,0.0,0.0,0.0,0.0,0.0,0.0,0.0,0.0,0.0,0.0,0.0,0.0,0.0,0.0,0.0,0.0,0.0,0.0,0.0,Matches,Danny Ward,GK,29,129,145,Wales,Leicester City,3,3,1,1,10,7,1,3,1,1,11,2,1,10,12,13,13,13,13,10,12,14,1,10,1,12,12,11,12,12,12,12,13,11,13,13,13,14,16,8,13,13,14,13,6,14,13,11,13,13,9,13,10,13,8,14,15,16,12,16,20,1,1,1,1,1,1,1,1,1,1,1,1,1,193,88,8,20,5131270,6450,6850,5000,Northern_European,125,6,1993/6/22,26,0,40597.0,,29058892
523,Joel Ward,Crystal Palace,1989,540.0,eng ENG,DF,32.0,25.1,50.0,36.0,30.0,11.0,9.0,30.0,41.0,73.2,11.0,32.0,16.0,16.0,25.0,75.0,80.0,1.0,Matches,540.0,eng ENG,DF,32.0,25.1,22.0,0.88,17.0,0.0,1.0,1.0,3.0,0.0,1.0,0.04,0.0,0.0,0.0,1.0,0.0,0.0,Matches,,,,,,,,,,,,,,,,,,,,,,,,,,,,,,,,,,,,,,,,,,,,,,,,,,,,,,,,540.0,eng ENG,DF,32.0,25.1,6.0,0.0,0.0,29.0,11.0,0.0,36.0,25.0,36.0,0.0,0.0,0.0,116.0,58.0,39.0,59.8,Matches,540.0,eng ENG,DF,32.0,25.1,1223.0,1014.0,208.0,24.0,0.0,2.0,36.0,184.0,0.0,0.0,0.0,0.0,921.0,1.0,29.0,Matches,540.0,eng ENG,DF,32.0,25.1,921.0,1223.0,75.3,14816.0,6577.0,460.0,531.0,86.6,375.0,464.0,80.8,57.0,157.0,36.3,0.0,0.4,0.8,-0.4,9.0,80.0,11.0,6.0,101.0,Matches,681,eng ENG,DF,32,28,2256.0,81.0,66.0,25.1,24,89.0,22,4,30.0,7,1.36,34.0,35.0,-1.0,-0.04,0.58,28.6,31.3,-2.7,-0.11,0.37,Matches,540.0,eng ENG,DF,32.0,25.1,1469.0,119.0,546.0,637.0,292.0,21.0,1469.0,9.0,7.0,77.8,1.0,11.1,620.0,2382.0,1228.0,22.0,15.0,1.0,25.0,10.0,761.0,46.0,Matches,540.0,eng ENG,DF,32.0,25.1,1.0,8.0,2.0,25.0,0.32,0.08,0.13,0.5,16.5,0.0,0.0,0.0,1.1,1.1,0.19,-0.1,-0.1,Matches,540.0,eng ENG,DF,32.0,28.0,24.0,2256.0,25.1,1.0,0.0,1.0,1.0,0.0,0.0,6.0,0.0,1.1,1.1,0.4,1.5,22.0,101.0,46.0,0.04,0.0,0.04,0.04,0.04,0.04,0.02,0.06,0.04,0.06,Matches,Joel Ward,D RLC,32,130,136,England,Crystal Palace,8,9,10,5,10,6,14,8,10,14,11,5,15,11,15,15,16,11,16,9,13,18,3,14,11,13,16,15,10,12,12,15,14,11,12,14,13,5,10,6,12,3,2,1,2,2,3,4,3,1,1,1,14,12,1,16,9,15,10,13,1,15,16,20,1,10,11,1,7,1,1,1,1,1,187,82,11,20,2826614,6500,6500,5400,Northern_European,123,5,1989/10/29,0,0,46397.0,,28004100
524,James Ward-Prowse,Southampton,1994,541.0,eng ENG,MF,27.0,37.5,65.0,37.0,31.0,27.0,7.0,21.0,61.0,34.4,40.0,30.0,10.0,20.0,55.0,120.0,48.0,0.0,Matches,541.0,eng ENG,MF,27.0,37.5,127.0,3.39,62.0,59.0,1.0,3.0,1.0,1.0,9.0,0.24,3.0,3.0,1.0,2.0,0.0,0.0,Matches,,,,,,,,,,,,,,,,,,,,,,,,,,,,,,,,,,,,,,,,,,,,,,,,,,,,,,,,541.0,eng ENG,MF,27.0,37.5,6.0,0.0,0.0,34.0,19.0,0.0,241.0,55.0,37.0,0.0,0.0,1.0,222.0,44.0,52.0,45.8,Matches,541.0,eng ENG,MF,27.0,37.5,2176.0,1840.0,329.0,148.0,2.0,14.0,241.0,8.0,145.0,62.0,63.0,0.0,1716.0,7.0,36.0,Matches,541.0,eng ENG,MF,27.0,37.5,1716.0,2176.0,78.9,28997.0,8717.0,834.0,922.0,90.5,687.0,809.0,84.9,153.0,342.0,44.7,4.0,6.2,5.3,-2.2,74.0,177.0,31.0,16.0,189.0,Matches,682,eng ENG,MF,27,38,3371.0,89.0,98.6,37.5,38,89.0,36,0,,0,0.66,36.0,72.0,-36.0,-0.96,0.88,37.5,59.8,-22.3,-0.6,1.15,Matches,541.0,eng ENG,MF,27.0,37.5,2484.0,97.0,447.0,1380.0,667.0,28.0,2480.0,20.0,7.0,35.0,12.0,60.0,1172.0,4364.0,2014.0,19.0,27.0,1.0,26.0,22.0,1462.0,58.0,Matches,541.0,eng ENG,MF,27.0,37.5,9.0,40.0,16.0,40.0,1.07,0.43,0.18,0.44,27.1,17.0,2.0,4.0,5.7,2.5,0.06,3.3,4.5,Matches,541.0,eng ENG,MF,27.0,38.0,38.0,3371.0,37.5,9.0,4.0,13.0,7.0,2.0,4.0,6.0,0.0,5.7,2.5,6.2,8.7,19.0,189.0,58.0,0.24,0.11,0.35,0.19,0.29,0.15,0.17,0.32,0.07,0.23,Matches,James Ward-Prowse,DM/M C,27,152,155,England,Southampton,20,18,10,12,13,20,7,11,6,9,15,12,13,15,15,13,13,14,13,16,14,17,11,18,13,13,17,19,12,13,14,7,20,11,20,12,17,11,13,6,14,2,3,3,3,1,3,3,3,2,3,1,11,14,4,18,12,17,14,13,1,1,1,12,1,12,18,10,20,14,10,14,14,1,173,66,10,20,61090523,7600,7600,6450,Northern_European,150,4,1994/11/1,11,2,115992.0,,29076100
525,Ollie Watkins,Aston Villa,1995,542.0,eng ENG,FW,26.0,34.7,19.0,13.0,3.0,13.0,3.0,10.0,27.0,37.0,17.0,21.0,4.0,17.0,10.0,29.0,39.0,0.0,Matches,542.0,eng ENG,FW,26.0,34.7,79.0,2.27,51.0,0.0,6.0,11.0,11.0,0.0,14.0,0.4,6.0,0.0,2.0,5.0,1.0,0.0,Matches,,,,,,,,,,,,,,,,,,,,,,,,,,,,,,,,,,,,,,,,,,,,,,,,,,,,,,,,542.0,eng ENG,FW,26.0,34.7,4.0,0.0,0.0,26.0,39.0,18.0,9.0,10.0,13.0,1.0,0.0,0.0,59.0,70.0,100.0,41.2,Matches,542.0,eng ENG,FW,26.0,34.7,566.0,554.0,9.0,0.0,0.0,2.0,9.0,3.0,0.0,0.0,0.0,0.0,391.0,3.0,13.0,Matches,542.0,eng ENG,FW,26.0,34.7,391.0,566.0,69.1,4682.0,840.0,261.0,344.0,75.9,84.0,122.0,68.9,12.0,15.0,80.0,6.0,3.8,2.7,2.2,31.0,23.0,16.0,2.0,39.0,Matches,684,eng ENG,FW,26,37,3127.0,85.0,91.4,34.7,36,86.0,26,1,25.0,0,1.57,47.0,40.0,7.0,0.2,0.82,44.8,47.1,-2.3,-0.06,-0.07,Matches,542.0,eng ENG,FW,26.0,34.7,927.0,47.0,86.0,365.0,488.0,164.0,925.0,65.0,18.0,27.7,36.0,55.4,475.0,2519.0,1164.0,50.0,24.0,32.0,82.0,39.0,684.0,196.0,Matches,542.0,eng ENG,FW,26.0,34.7,15.0,84.0,45.0,53.6,2.42,1.3,0.17,0.31,12.6,0.0,1.0,2.0,16.5,14.9,0.18,-1.5,-0.9,Matches,542.0,eng ENG,FW,26.0,37.0,36.0,3127.0,34.7,15.0,6.0,21.0,14.0,1.0,2.0,4.0,0.0,16.5,14.9,3.8,18.7,50.0,39.0,196.0,0.43,0.17,0.6,0.4,0.58,0.47,0.11,0.58,0.43,0.54,Matches,Ollie Watkins,AM/S RL,26,141,150,England,Aston Villa,8,11,13,15,12,7,13,11,5,6,13,11,7,12,10,13,15,10,12,12,9,15,13,9,14,5,16,19,15,15,11,12,17,14,17,14,14,4,13,5,12,1,4,3,3,4,2,2,3,2,1,2,13,13,6,10,12,16,11,13,1,1,1,1,1,1,1,1,1,1,18,12,17,20,180,70,11,20,40597107,7250,7250,6000,African_Caribbean,134,14,1995/12/30,7,2,52196.0,,29110623
526,Adam Webster,Brighton,1995,543.0,eng ENG,DF,27.0,22.1,22.0,12.0,10.0,9.0,3.0,11.0,19.0,57.9,8.0,30.0,19.0,11.0,19.0,41.0,55.0,4.0,Matches,543.0,eng ENG,DF,27.0,22.1,20.0,0.91,19.0,1.0,0.0,0.0,0.0,0.0,1.0,0.05,1.0,0.0,0.0,0.0,0.0,0.0,Matches,,,,,,,,,,,,,,,,,,,,,,,,,,,,,,,,,,,,,,,,,,,,,,,,,,,,,,,,543.0,eng ENG,DF,27.0,22.1,2.0,0.0,0.0,10.0,6.0,1.0,2.0,19.0,12.0,0.0,0.0,1.0,143.0,60.0,27.0,69.0,Matches,543.0,eng ENG,DF,27.0,22.1,1715.0,1650.0,63.0,28.0,0.0,6.0,2.0,35.0,0.0,0.0,0.0,0.0,1514.0,2.0,10.0,Matches,543.0,eng ENG,DF,27.0,22.1,1514.0,1715.0,88.3,27890.0,10260.0,565.0,612.0,92.3,811.0,886.0,91.5,125.0,178.0,70.2,0.0,0.2,0.4,-0.2,6.0,120.0,5.0,1.0,119.0,Matches,685,eng ENG,DF,27,27,1985.0,74.0,58.0,22.1,23,85.0,17,4,7.0,4,1.74,41.0,27.0,14.0,0.63,0.32,43.8,24.9,18.8,0.85,0.58,Matches,543.0,eng ENG,DF,27.0,22.1,1888.0,170.0,819.0,969.0,108.0,27.0,1888.0,8.0,3.0,37.5,4.0,50.0,1228.0,6306.0,3739.0,19.0,18.0,0.0,11.0,5.0,1369.0,9.0,Matches,543.0,eng ENG,DF,27.0,22.1,0.0,18.0,2.0,11.1,0.82,0.09,0.0,0.0,11.2,0.0,0.0,0.0,1.8,1.8,0.1,-1.8,-1.8,Matches,543.0,eng ENG,DF,27.0,27.0,23.0,1985.0,22.1,0.0,0.0,0.0,0.0,0.0,0.0,2.0,0.0,1.8,1.8,0.2,1.9,19.0,119.0,9.0,0.0,0.0,0.0,0.0,0.0,0.08,0.01,0.09,0.08,0.09,Matches,Adam Webster,D C,27,142,144,England,Brighton & Hove Albion,5,6,13,6,13,5,14,7,6,14,14,7,15,13,12,14,13,14,13,13,13,14,7,14,8,14,13,14,13,11,10,15,13,15,14,13,14,8,15,13,10,3,2,2,3,3,2,2,1,2,1,2,12,12,3,13,12,13,11,13,1,1,20,11,1,1,1,1,1,1,1,1,1,1,190,77,17,20,40294485,7095,7095,5495,Northern_European,142,4,1995/1/4,0,0,63795.0,,29080394
527,Danny Welbeck,Brighton,1990,545.0,eng ENG,FW,31.0,20.6,15.0,7.0,0.0,7.0,8.0,4.0,11.0,36.4,7.0,24.0,2.0,22.0,5.0,20.0,20.0,0.0,Matches,545.0,eng ENG,FW,31.0,20.6,65.0,3.16,49.0,0.0,5.0,6.0,4.0,1.0,9.0,0.44,5.0,0.0,1.0,1.0,2.0,0.0,Matches,,,,,,,,,,,,,,,,,,,,,,,,,,,,,,,,,,,,,,,,,,,,,,,,,,,,,,,,545.0,eng ENG,FW,31.0,20.6,0.0,0.0,0.0,25.0,18.0,5.0,0.0,5.0,7.0,1.0,0.0,0.0,37.0,32.0,27.0,54.2,Matches,545.0,eng ENG,FW,31.0,20.6,442.0,416.0,24.0,0.0,6.0,0.0,0.0,1.0,0.0,0.0,0.0,0.0,373.0,2.0,7.0,Matches,545.0,eng ENG,FW,31.0,20.6,373.0,442.0,84.4,4456.0,872.0,244.0,275.0,88.7,92.0,106.0,86.8,5.0,11.0,45.5,3.0,4.3,1.7,-1.3,30.0,32.0,15.0,0.0,49.0,Matches,687,eng ENG,FW,31,31,1854.0,60.0,54.2,20.6,21,76.0,7,10,26.0,1,1.68,36.0,28.0,8.0,0.39,-0.24,37.2,26.2,11.0,0.53,-0.16,Matches,545.0,eng ENG,FW,31.0,20.6,693.0,23.0,44.0,281.0,376.0,117.0,693.0,45.0,22.0,48.9,18.0,40.0,407.0,1859.0,878.0,31.0,18.0,10.0,60.0,23.0,519.0,134.0,Matches,545.0,eng ENG,FW,31.0,20.6,6.0,62.0,22.0,35.5,3.01,1.07,0.1,0.27,14.1,1.0,0.0,0.0,9.4,9.4,0.15,-3.4,-3.4,Matches,545.0,eng ENG,FW,31.0,31.0,21.0,1854.0,20.6,6.0,3.0,9.0,6.0,0.0,0.0,0.0,0.0,9.4,9.4,4.3,13.7,31.0,49.0,134.0,0.29,0.15,0.44,0.29,0.44,0.46,0.21,0.66,0.46,0.66,Matches,Danny Welbeck,AM/S RL,31,134,160,"England,Ghana",Brighton & Hove Albion,5,8,13,14,13,4,13,9,3,6,11,10,6,14,11,12,13,12,13,12,13,14,14,4,15,8,15,16,15,13,13,14,15,15,14,14,12,5,12,16,12,2,1,3,2,2,4,4,3,1,1,1,9,15,4,16,13,15,11,15,1,1,1,1,1,1,1,1,1,1,19,11,17,20,185,73,9,20,13316132,6698,6698,5998,African_Caribbean,132,17,1990/11/26,42,16,57996.0,,28010491
528,Neco Williams,Nott'ham Forest,2001,549.0,wls WAL,DF,21.0,20.9,72.0,47.0,49.0,17.0,6.0,38.0,71.0,53.5,33.0,33.0,8.0,25.0,33.0,105.0,48.0,0.0,Matches,549.0,wls WAL,DF,21.0,20.9,39.0,1.86,23.0,4.0,4.0,2.0,3.0,3.0,2.0,0.1,1.0,0.0,0.0,1.0,0.0,0.0,Matches,,,,,,,,,,,,,,,,,,,,,,,,,,,,,,,,,,,,,,,,,,,,,,,,,,,,,,,,549.0,wls WAL,DF,21.0,20.9,7.0,0.0,0.0,33.0,27.0,2.0,89.0,33.0,47.0,1.0,0.0,0.0,127.0,17.0,27.0,38.6,Matches,549.0,wls WAL,DF,21.0,20.9,840.0,651.0,182.0,28.0,3.0,7.0,89.0,141.0,13.0,7.0,6.0,0.0,533.0,7.0,38.0,Matches,549.0,wls WAL,DF,21.0,20.9,533.0,840.0,63.5,9565.0,3461.0,254.0,307.0,82.7,196.0,286.0,68.5,68.0,177.0,38.4,0.0,1.4,1.2,-1.4,15.0,29.0,14.0,9.0,33.0,Matches,696,wls WAL,DF,21,31,1882.0,61.0,55.0,20.9,20,85.0,15,11,16.0,2,0.94,18.0,41.0,-23.0,-1.1,-0.69,22.6,38.8,-16.2,-0.77,-0.26,Matches,549.0,wls WAL,DF,21.0,20.9,1153.0,82.0,445.0,422.0,309.0,23.0,1153.0,55.0,19.0,34.5,31.0,56.4,555.0,3620.0,2064.0,51.0,33.0,5.0,31.0,17.0,532.0,67.0,Matches,549.0,wls WAL,DF,21.0,20.9,1.0,25.0,7.0,28.0,1.2,0.33,0.04,0.14,21.2,2.0,0.0,0.0,1.3,1.3,0.05,-0.3,-0.3,Matches,549.0,wls WAL,DF,21.0,31.0,20.0,1882.0,20.9,1.0,0.0,1.0,1.0,0.0,0.0,7.0,0.0,1.3,1.3,1.4,2.7,51.0,33.0,67.0,0.05,0.0,0.05,0.05,0.05,0.06,0.07,0.13,0.06,0.13,Matches,Neco Williams,D/WB/AM RL,21,134,155,"Wales,England",Nottingham Forest,8,15,13,11,14,7,11,12,10,11,12,6,13,13,12,11,12,13,10,12,13,14,11,6,11,11,14,14,14,13,13,11,15,14,14,11,11,8,10,10,8,2,3,2,3,1,2,3,1,2,1,3,14,14,8,16,12,14,12,12,1,15,1,18,16,20,1,1,1,14,1,1,17,1,183,0,8,20,55351256,6695,6695,5395,Northern_European,125,6,2001/4/13,21,2,46397.0,,28115792
529,Willian,Fulham,1988,550.0,br BRA,FW,33.0,23.6,13.0,8.0,8.0,3.0,2.0,7.0,25.0,28.0,18.0,13.0,0.0,13.0,9.0,22.0,9.0,0.0,Matches,550.0,br BRA,FW,33.0,23.6,105.0,4.44,71.0,16.0,5.0,8.0,4.0,1.0,12.0,0.51,7.0,3.0,1.0,1.0,0.0,0.0,Matches,,,,,,,,,,,,,,,,,,,,,,,,,,,,,,,,,,,,,,,,,,,,,,,,,,,,,,,,550.0,br BRA,FW,33.0,23.6,2.0,0.0,0.0,11.0,24.0,4.0,60.0,9.0,8.0,0.0,0.0,0.0,105.0,8.0,24.0,25.0,Matches,550.0,br BRA,FW,33.0,23.6,912.0,860.0,49.0,14.0,4.0,12.0,60.0,3.0,32.0,8.0,11.0,2.0,712.0,3.0,20.0,Matches,550.0,br BRA,FW,33.0,23.6,712.0,912.0,78.1,12115.0,2563.0,369.0,429.0,86.0,236.0,286.0,82.5,86.0,143.0,60.1,5.0,4.4,3.1,0.6,51.0,41.0,30.0,1.0,113.0,Matches,698,br BRA,FW,33,27,2126.0,79.0,62.2,23.6,25,82.0,6,2,38.0,0,1.63,39.0,22.0,17.0,0.72,1.76,32.4,34.4,-2.1,-0.09,0.98,Matches,550.0,br BRA,FW,33.0,23.6,1121.0,10.0,118.0,419.0,602.0,78.0,1121.0,71.0,37.0,52.1,22.0,31.0,749.0,5394.0,2727.0,97.0,69.0,29.0,44.0,25.0,831.0,152.0,Matches,550.0,br BRA,FW,33.0,23.6,5.0,41.0,17.0,41.5,1.74,0.72,0.12,0.29,18.8,3.0,0.0,0.0,3.4,3.4,0.08,1.6,1.6,Matches,550.0,br BRA,FW,33.0,27.0,25.0,2126.0,23.6,5.0,5.0,10.0,5.0,0.0,0.0,2.0,0.0,3.4,3.4,4.4,7.8,97.0,113.0,152.0,0.21,0.21,0.42,0.21,0.42,0.14,0.19,0.33,0.14,0.33,Matches,Willian,AM RLC,33,134,162,Brazil,Fulham,10,13,16,11,15,14,9,14,8,5,13,13,8,16,9,14,9,13,11,13,13,10,14,8,14,7,14,13,13,14,12,9,12,14,12,11,12,8,14,13,12,1,1,1,1,1,1,1,1,1,1,1,14,10,8,14,11,16,13,12,1,1,1,1,1,1,1,15,13,15,18,18,20,12,175,78,8,20,6705620,7000,6700,6000,African_Caribbean,132,17,1988/8/9,70,9,52196.0,,8832889
530,Joe Willock,Newcastle Utd,1999,551.0,eng ENG,MF,22.0,28.4,51.0,30.0,13.0,26.0,12.0,25.0,58.0,43.1,33.0,54.0,8.0,46.0,25.0,76.0,17.0,0.0,Matches,551.0,eng ENG,MF,22.0,28.4,85.0,2.99,67.0,0.0,7.0,7.0,3.0,1.0,9.0,0.32,6.0,0.0,1.0,1.0,1.0,0.0,Matches,,,,,,,,,,,,,,,,,,,,,,,,,,,,,,,,,,,,,,,,,,,,,,,,,,,,,,,,551.0,eng ENG,MF,22.0,28.4,1.0,0.0,0.0,35.0,23.0,3.0,51.0,25.0,30.0,0.0,0.0,0.0,136.0,16.0,16.0,50.0,Matches,551.0,eng ENG,MF,22.0,28.4,951.0,922.0,25.0,3.0,4.0,3.0,51.0,8.0,0.0,0.0,0.0,0.0,777.0,4.0,18.0,Matches,551.0,eng ENG,MF,22.0,28.4,777.0,951.0,81.7,12123.0,3082.0,434.0,485.0,89.5,266.0,310.0,85.8,55.0,86.0,64.0,6.0,6.0,4.4,0.0,39.0,91.0,34.0,8.0,121.0,Matches,699,eng ENG,MF,22,35,2558.0,73.0,74.8,28.4,31,79.0,8,4,28.0,0,1.97,56.0,26.0,30.0,1.06,0.53,53.3,29.1,24.2,0.85,0.01,Matches,551.0,eng ENG,MF,22.0,28.4,1324.0,37.0,202.0,586.0,556.0,114.0,1324.0,93.0,37.0,39.8,43.0,46.2,784.0,5213.0,2866.0,97.0,62.0,33.0,65.0,27.0,896.0,152.0,Matches,551.0,eng ENG,MF,22.0,28.4,3.0,58.0,16.0,27.6,2.04,0.56,0.05,0.19,16.9,0.0,0.0,0.0,7.0,7.0,0.12,-4.0,-4.0,Matches,551.0,eng ENG,MF,22.0,35.0,31.0,2558.0,28.4,3.0,6.0,9.0,3.0,0.0,0.0,1.0,0.0,7.0,7.0,6.0,13.0,97.0,121.0,152.0,0.11,0.21,0.32,0.11,0.32,0.25,0.21,0.46,0.25,0.46,Matches,Joe Willock,M C,22,135,155,"England,Montserrat",Newcastle United,7,11,14,13,14,10,7,11,4,7,14,9,10,14,10,12,12,14,12,13,13,13,15,4,14,9,14,14,17,17,12,8,13,14,14,12,13,6,13,8,14,3,2,4,2,3,3,3,3,2,1,2,17,16,8,12,13,13,13,14,1,1,1,1,1,1,12,12,20,12,13,12,13,1,179,71,10,20,49505273,6750,6750,5500,African_Caribbean,133,15,1999/8/20,0,0,92793.0,,28106684
531,Callum Wilson,Newcastle Utd,1992,552.0,eng ENG,FW,30.0,20.9,9.0,3.0,0.0,8.0,1.0,0.0,3.0,0.0,3.0,8.0,0.0,8.0,1.0,10.0,5.0,0.0,Matches,552.0,eng ENG,FW,30.0,20.9,43.0,2.06,24.0,0.0,6.0,7.0,6.0,0.0,10.0,0.48,5.0,0.0,3.0,2.0,0.0,0.0,Matches,,,,,,,,,,,,,,,,,,,,,,,,,,,,,,,,,,,,,,,,,,,,,,,,,,,,,,,,552.0,eng ENG,FW,30.0,20.9,4.0,0.0,0.0,21.0,31.0,15.0,6.0,1.0,3.0,0.0,0.0,0.0,39.0,20.0,48.0,29.4,Matches,552.0,eng ENG,FW,30.0,20.9,242.0,234.0,7.0,1.0,2.0,3.0,6.0,0.0,0.0,0.0,0.0,0.0,160.0,1.0,23.0,Matches,552.0,eng ENG,FW,30.0,20.9,160.0,242.0,66.1,1996.0,339.0,111.0,143.0,77.6,33.0,45.0,73.3,4.0,11.0,36.4,5.0,2.7,2.1,2.3,23.0,10.0,7.0,0.0,19.0,Matches,700,eng ENG,FW,30,31,1877.0,61.0,54.9,20.9,21,76.0,2,10,28.0,1,1.97,44.0,16.0,28.0,1.34,0.93,40.9,22.0,19.0,0.91,0.13,Matches,552.0,eng ENG,FW,30.0,20.9,482.0,8.0,25.0,179.0,281.0,124.0,479.0,36.0,12.0,33.3,19.0,52.8,304.0,1484.0,673.0,27.0,14.0,16.0,72.0,36.0,360.0,118.0,Matches,552.0,eng ENG,FW,30.0,20.9,18.0,70.0,31.0,44.3,3.36,1.49,0.21,0.48,12.4,0.0,3.0,3.0,17.4,15.1,0.22,0.6,-0.1,Matches,552.0,eng ENG,FW,30.0,31.0,21.0,1877.0,20.9,18.0,5.0,23.0,15.0,3.0,3.0,4.0,0.0,17.4,15.1,2.7,17.8,27.0,19.0,118.0,0.86,0.24,1.1,0.72,0.96,0.84,0.13,0.97,0.72,0.85,Matches,Callum Wilson,S,30,144,155,England,Newcastle United,6,8,14,16,13,6,11,9,4,4,13,14,5,13,10,15,12,14,13,11,15,15,11,9,15,8,12,15,16,14,14,10,16,16,14,15,13,5,13,15,7,1,1,3,3,2,2,3,3,1,3,2,12,13,7,14,12,15,12,12,1,1,1,1,1,1,1,1,1,1,1,1,1,20,180,66,10,20,54659950,7200,7200,6000,African_Caribbean,143,14,1992/2/27,4,1,104393.0,,28030268
532,Harry Wilson,Fulham,1997,553.0,wls WAL,FW,25.0,12.2,21.0,13.0,9.0,9.0,3.0,8.0,18.0,44.4,10.0,17.0,2.0,15.0,6.0,27.0,14.0,0.0,Matches,553.0,wls WAL,FW,25.0,12.2,32.0,2.62,18.0,2.0,1.0,3.0,8.0,0.0,9.0,0.74,4.0,0.0,0.0,1.0,4.0,0.0,Matches,,,,,,,,,,,,,,,,,,,,,,,,,,,,,,,,,,,,,,,,,,,,,,,,,,,,,,,,553.0,wls WAL,FW,25.0,12.2,1.0,0.0,0.0,11.0,32.0,2.0,22.0,6.0,13.0,2.0,0.0,0.0,54.0,4.0,12.0,25.0,Matches,553.0,wls WAL,FW,25.0,12.2,404.0,383.0,20.0,4.0,1.0,3.0,22.0,5.0,10.0,2.0,3.0,0.0,310.0,1.0,16.0,Matches,553.0,wls WAL,FW,25.0,12.2,310.0,404.0,76.7,4943.0,1086.0,163.0,192.0,84.9,105.0,127.0,82.7,25.0,46.0,54.3,3.0,0.9,1.0,2.1,12.0,20.0,13.0,1.0,37.0,Matches,701,wls WAL,FW,25,29,1100.0,38.0,32.2,12.2,13,69.0,1,16,13.0,1,1.31,21.0,15.0,6.0,0.49,0.65,15.5,20.9,-5.4,-0.44,0.03,Matches,553.0,wls WAL,FW,25.0,12.2,551.0,18.0,89.0,214.0,253.0,37.0,551.0,33.0,12.0,36.4,14.0,42.4,343.0,1989.0,780.0,18.0,16.0,8.0,23.0,15.0,397.0,87.0,Matches,553.0,wls WAL,FW,25.0,12.2,2.0,18.0,4.0,22.2,1.47,0.33,0.11,0.5,16.0,1.0,0.0,0.0,2.0,2.0,0.11,0.0,0.0,Matches,553.0,wls WAL,FW,25.0,29.0,13.0,1100.0,12.2,2.0,3.0,5.0,2.0,0.0,0.0,1.0,0.0,2.0,2.0,0.9,2.9,18.0,37.0,87.0,0.16,0.25,0.41,0.16,0.41,0.16,0.07,0.24,0.16,0.24,Matches,Harry Wilson,AM RLC,25,135,140,Wales,Fulham,14,15,15,14,14,16,5,14,3,6,14,15,7,15,11,12,10,15,9,14,14,15,14,12,14,7,12,13,14,14,14,6,13,14,13,8,12,5,12,9,9,3,1,2,1,3,2,3,2,3,1,1,11,14,8,16,10,14,10,13,1,1,1,1,1,1,1,13,11,11,16,18,20,12,173,0,20,9,33726766,6750,7000,5250,Northern_European,136,3,1997/3/22,39,5,46397.0,,28094949
533,Yoane Wissa,Brentford,1996,554.0,cd COD,FW,25.0,17.8,17.0,12.0,4.0,7.0,6.0,6.0,13.0,46.2,7.0,10.0,0.0,10.0,6.0,23.0,15.0,0.0,Matches,554.0,cd COD,FW,25.0,17.8,36.0,2.02,29.0,0.0,1.0,2.0,3.0,1.0,6.0,0.34,4.0,0.0,0.0,0.0,1.0,1.0,Matches,,,,,,,,,,,,,,,,,,,,,,,,,,,,,,,,,,,,,,,,,,,,,,,,,,,,,,,,554.0,cd COD,FW,25.0,17.8,3.0,0.0,0.0,21.0,26.0,19.0,12.0,6.0,12.0,1.0,0.0,0.0,69.0,24.0,26.0,48.0,Matches,554.0,cd COD,FW,25.0,17.8,344.0,334.0,7.0,1.0,4.0,2.0,12.0,2.0,0.0,0.0,0.0,0.0,238.0,3.0,15.0,Matches,554.0,cd COD,FW,25.0,17.8,238.0,344.0,69.2,3147.0,601.0,164.0,198.0,82.8,51.0,78.0,65.4,10.0,27.0,37.0,3.0,2.5,1.0,0.5,13.0,21.0,8.0,0.0,27.0,Matches,703,cd COD,FW,25,38,1606.0,42.0,47.0,17.8,16,75.0,1,22,19.0,0,1.55,30.0,17.0,13.0,0.73,0.78,28.8,21.2,7.6,0.43,0.47,Matches,554.0,cd COD,FW,25.0,17.8,517.0,14.0,67.0,193.0,268.0,62.0,517.0,44.0,20.0,45.5,15.0,34.1,312.0,1573.0,658.0,24.0,12.0,11.0,41.0,25.0,345.0,104.0,Matches,554.0,cd COD,FW,25.0,17.8,7.0,32.0,15.0,46.9,1.79,0.84,0.22,0.47,14.1,0.0,0.0,0.0,5.6,5.6,0.18,1.4,1.4,Matches,554.0,cd COD,FW,25.0,38.0,16.0,1606.0,17.8,7.0,3.0,10.0,7.0,0.0,0.0,3.0,0.0,5.6,5.6,2.5,8.2,24.0,27.0,104.0,0.39,0.17,0.56,0.39,0.56,0.32,0.14,0.46,0.32,0.46,Matches,Yoane Wissa,M/AM/S L,25,130,136,"Democratic Republic of Congo,France",Brentford,9,12,13,13,12,11,8,10,6,6,13,13,6,13,10,13,12,12,12,13,12,13,13,7,14,8,13,14,15,14,12,8,14,15,14,12,13,8,12,7,12,3,1,1,2,1,2,2,2,2,1,2,12,13,6,13,12,14,15,14,1,1,1,1,1,1,1,17,1,1,20,1,10,18,176,74,7,20,11763156,6495,6495,5245,African_Caribbean,127,16,1996/9/3,6,2,32478.0,,85140175
534,Maximilian Wöber,Leeds United,1998,555.0,at AUT,DF,24.0,14.1,25.0,18.0,9.0,15.0,1.0,16.0,24.0,66.7,8.0,32.0,14.0,18.0,27.0,52.0,67.0,1.0,Matches,555.0,at AUT,DF,24.0,14.1,12.0,0.85,8.0,2.0,0.0,2.0,0.0,0.0,1.0,0.07,1.0,0.0,0.0,0.0,0.0,0.0,Matches,,,,,,,,,,,,,,,,,,,,,,,,,,,,,,,,,,,,,,,,,,,,,,,,,,,,,,,,555.0,at AUT,DF,24.0,14.1,3.0,0.0,0.0,15.0,1.0,1.0,7.0,27.0,18.0,0.0,1.0,0.0,75.0,27.0,21.0,56.3,Matches,555.0,at AUT,DF,24.0,14.1,684.0,638.0,43.0,13.0,0.0,2.0,7.0,30.0,0.0,0.0,0.0,0.0,483.0,3.0,10.0,Matches,555.0,at AUT,DF,24.0,14.1,483.0,684.0,70.6,9430.0,4157.0,175.0,221.0,79.2,255.0,319.0,79.9,50.0,122.0,41.0,0.0,0.6,0.4,-0.6,6.0,63.0,3.0,2.0,54.0,Matches,704,at AUT,DF,24,16,1266.0,79.0,37.0,14.1,14,85.0,12,2,41.0,1,0.63,15.0,23.0,-8.0,-0.57,0.35,15.1,23.4,-8.2,-0.59,-0.1,Matches,555.0,at AUT,DF,24.0,14.1,858.0,110.0,381.0,400.0,81.0,17.0,858.0,1.0,0.0,0.0,1.0,100.0,426.0,2270.0,1309.0,15.0,9.0,0.0,6.0,2.0,438.0,15.0,Matches,555.0,at AUT,DF,24.0,14.1,0.0,9.0,2.0,22.2,0.64,0.14,0.0,0.0,13.3,1.0,0.0,0.0,0.7,0.7,0.08,-0.7,-0.7,Matches,555.0,at AUT,DF,24.0,16.0,14.0,1266.0,14.1,0.0,0.0,0.0,0.0,0.0,0.0,3.0,0.0,0.7,0.7,0.6,1.4,15.0,54.0,15.0,0.0,0.0,0.0,0.0,0.0,0.05,0.05,0.1,0.05,0.1,Matches,Maximilian Wöber,D LC,24,132,141,Austria,Fussballclub RB Salzburg,6,8,10,6,12,12,14,9,9,13,13,14,14,11,11,13,14,13,13,11,12,16,6,10,10,14,13,15,14,12,12,14,14,13,13,13,13,8,11,12,11,3,3,2,2,2,3,2,2,3,3,1,10,15,3,14,15,15,15,18,1,18,20,1,10,1,13,1,1,1,1,1,1,1,188,85,20,10,6842392,6607,6607,5255,Northern_European,132,4,1998/2/4,9,0,24931.0,,16147700
535,Joe Worrall,Nott'ham Forest,1997,558.0,eng ENG,DF,25.0,24.7,53.0,25.0,39.0,12.0,2.0,25.0,35.0,71.4,10.0,33.0,23.0,10.0,26.0,79.0,111.0,1.0,Matches,558.0,eng ENG,DF,25.0,24.7,16.0,0.65,14.0,1.0,0.0,0.0,1.0,0.0,0.0,0.0,0.0,0.0,0.0,0.0,0.0,0.0,Matches,,,,,,,,,,,,,,,,,,,,,,,,,,,,,,,,,,,,,,,,,,,,,,,,,,,,,,,,558.0,eng ENG,DF,25.0,24.7,6.0,0.0,0.0,27.0,4.0,0.0,3.0,26.0,25.0,0.0,2.0,0.0,123.0,55.0,33.0,62.5,Matches,558.0,eng ENG,DF,25.0,24.7,1157.0,1058.0,97.0,33.0,0.0,8.0,3.0,58.0,0.0,0.0,0.0,0.0,891.0,2.0,9.0,Matches,558.0,eng ENG,DF,25.0,24.7,891.0,1157.0,77.0,18605.0,7188.0,265.0,322.0,82.3,475.0,560.0,84.8,143.0,250.0,57.2,0.0,0.8,0.6,-0.8,5.0,75.0,6.0,0.0,67.0,Matches,708,eng ENG,DF,25,30,2224.0,74.0,65.0,24.7,21,89.0,20,9,40.0,8,1.1,26.0,44.0,-18.0,-0.73,0.17,26.6,43.6,-16.9,-0.69,-0.08,Matches,558.0,eng ENG,DF,25.0,24.7,1408.0,213.0,813.0,524.0,75.0,29.0,1408.0,4.0,3.0,75.0,1.0,25.0,684.0,2948.0,1604.0,5.0,5.0,1.0,6.0,4.0,796.0,1.0,Matches,558.0,eng ENG,DF,25.0,24.7,1.0,7.0,2.0,28.6,0.28,0.08,0.14,0.5,12.2,0.0,0.0,0.0,0.8,0.8,0.11,0.2,0.2,Matches,558.0,eng ENG,DF,25.0,30.0,21.0,2224.0,24.7,1.0,0.0,1.0,1.0,0.0,0.0,6.0,0.0,0.8,0.8,0.8,1.6,5.0,67.0,1.0,0.04,0.0,0.04,0.04,0.04,0.03,0.03,0.06,0.03,0.06,Matches,Joe Worrall,D C,25,127,142,England,Nottingham Forest,6,7,6,5,11,6,15,5,7,12,12,5,14,10,14,12,16,13,11,7,12,13,7,15,7,13,15,13,11,12,12,16,12,13,15,15,14,10,12,5,10,2,3,2,3,1,1,2,3,2,1,2,16,12,9,14,12,14,14,16,1,4,20,4,1,1,1,1,1,1,1,1,1,1,193,64,11,20,7152503,6350,6350,4500,Northern_European,125,5,1997/1/10,0,0,28998.0,,29122252
536,Granit Xhaka,Arsenal,1992,559.0,ch SUI,MF,29.0,33.3,34.0,27.0,11.0,18.0,5.0,16.0,41.0,39.0,25.0,28.0,10.0,18.0,15.0,49.0,45.0,1.0,Matches,559.0,ch SUI,MF,29.0,33.3,110.0,3.31,94.0,3.0,5.0,4.0,3.0,1.0,17.0,0.51,16.0,0.0,0.0,1.0,0.0,0.0,Matches,,,,,,,,,,,,,,,,,,,,,,,,,,,,,,,,,,,,,,,,,,,,,,,,,,,,,,,,559.0,ch SUI,MF,29.0,33.3,4.0,0.0,0.0,26.0,39.0,5.0,39.0,15.0,27.0,0.0,0.0,0.0,152.0,37.0,30.0,55.2,Matches,559.0,ch SUI,MF,29.0,33.3,1632.0,1574.0,55.0,34.0,6.0,6.0,39.0,19.0,1.0,0.0,0.0,0.0,1382.0,3.0,27.0,Matches,559.0,ch SUI,MF,29.0,33.3,1382.0,1632.0,84.7,22642.0,5919.0,675.0,762.0,88.6,552.0,635.0,86.9,113.0,139.0,81.3,7.0,5.2,4.0,1.8,47.0,148.0,40.0,4.0,196.0,Matches,710,ch SUI,MF,29,37,2993.0,81.0,87.5,33.3,36,83.0,24,1,7.0,0,2.24,75.0,35.0,40.0,1.2,0.15,60.7,36.5,24.3,0.73,-0.42,Matches,559.0,ch SUI,MF,29.0,33.3,1891.0,84.0,341.0,900.0,658.0,106.0,1891.0,28.0,15.0,53.6,10.0,35.7,1113.0,4243.0,2162.0,42.0,38.0,9.0,35.0,25.0,1397.0,175.0,Matches,559.0,ch SUI,MF,29.0,33.3,7.0,40.0,14.0,35.0,1.2,0.42,0.18,0.5,16.6,3.0,0.0,0.0,4.7,4.7,0.12,2.3,2.3,Matches,559.0,ch SUI,MF,29.0,37.0,36.0,2993.0,33.3,7.0,7.0,14.0,7.0,0.0,0.0,4.0,0.0,4.7,4.7,5.2,9.9,42.0,196.0,175.0,0.21,0.21,0.42,0.21,0.42,0.14,0.16,0.3,0.14,0.3,Matches,Granit Xhaka,DM/M C,29,142,160,"Switzerland,Albania,Kosovo",Arsenal,11,13,12,9,16,15,12,17,6,10,18,10,11,17,17,13,15,10,9,17,13,13,13,13,13,10,15,14,10,9,13,13,14,12,15,16,11,17,10,7,10,2,3,1,2,2,1,1,3,1,2,3,13,14,15,12,10,11,10,5,1,13,10,1,1,1,18,1,20,1,1,8,1,1,185,82,20,10,87489801,7245,7749,6396,Mediterranean_Hispanic,140,8,1992/9/27,104,12,127591.0,,98003821
537,Ryan Yates,Nott'ham Forest,1997,560.0,eng ENG,MF,24.0,20.4,38.0,19.0,19.0,16.0,3.0,14.0,22.0,63.6,8.0,26.0,8.0,18.0,10.0,48.0,44.0,0.0,Matches,560.0,eng ENG,MF,24.0,20.4,24.0,1.18,18.0,0.0,0.0,4.0,2.0,0.0,3.0,0.15,1.0,0.0,0.0,2.0,0.0,0.0,Matches,,,,,,,,,,,,,,,,,,,,,,,,,,,,,,,,,,,,,,,,,,,,,,,,,,,,,,,,560.0,eng ENG,MF,24.0,20.4,5.0,0.0,0.0,50.0,53.0,1.0,8.0,10.0,19.0,1.0,0.0,0.0,111.0,29.0,21.0,58.0,Matches,560.0,eng ENG,MF,24.0,20.4,592.0,526.0,62.0,12.0,0.0,6.0,8.0,3.0,0.0,0.0,0.0,0.0,455.0,4.0,17.0,Matches,560.0,eng ENG,MF,24.0,20.4,455.0,592.0,76.9,7587.0,1812.0,204.0,248.0,82.3,205.0,237.0,86.5,32.0,61.0,52.5,2.0,1.2,0.4,0.8,7.0,26.0,4.0,1.0,43.0,Matches,712,eng ENG,MF,24,26,1837.0,71.0,53.7,20.4,21,81.0,14,5,27.0,0,1.04,22.0,36.0,-14.0,-0.69,0.22,22.1,29.0,-6.9,-0.34,0.69,Matches,560.0,eng ENG,MF,24.0,20.4,790.0,66.0,235.0,418.0,143.0,34.0,790.0,10.0,5.0,50.0,3.0,30.0,303.0,1260.0,577.0,11.0,4.0,3.0,18.0,15.0,384.0,27.0,Matches,560.0,eng ENG,MF,24.0,20.4,0.0,26.0,5.0,19.2,1.27,0.24,0.0,0.0,16.8,0.0,0.0,0.0,2.3,2.3,0.09,-2.3,-2.3,Matches,560.0,eng ENG,MF,24.0,26.0,21.0,1837.0,20.4,0.0,2.0,2.0,0.0,0.0,0.0,5.0,0.0,2.3,2.3,1.2,3.4,11.0,43.0,27.0,0.0,0.1,0.1,0.0,0.1,0.11,0.06,0.17,0.11,0.17,Matches,Ryan Yates,DM/M C,24,128,138,England,Nottingham Forest,7,10,10,11,12,10,15,9,4,12,13,4,14,12,12,12,15,11,12,12,12,15,6,12,13,14,15,15,11,13,12,14,14,13,16,13,13,8,13,4,12,4,3,2,3,2,3,2,2,1,3,1,10,12,8,14,13,14,13,10,1,1,12,1,1,1,16,1,20,10,1,12,1,1,190,0,13,20,8821307,6400,6400,4500,Northern_European,127,4,1997/11/21,0,0,28998.0,,29136230
538,Ashley Young,Aston Villa,1985,561.0,eng ENG,DF,37.0,22.6,50.0,27.0,34.0,15.0,1.0,37.0,50.0,74.0,13.0,25.0,11.0,14.0,21.0,71.0,65.0,0.0,Matches,561.0,eng ENG,DF,37.0,22.6,40.0,1.77,34.0,3.0,2.0,1.0,0.0,0.0,2.0,0.09,2.0,0.0,0.0,0.0,0.0,0.0,Matches,,,,,,,,,,,,,,,,,,,,,,,,,,,,,,,,,,,,,,,,,,,,,,,,,,,,,,,,561.0,eng ENG,DF,37.0,22.6,7.0,0.0,0.0,24.0,28.0,1.0,42.0,21.0,27.0,0.0,1.0,0.0,131.0,13.0,11.0,54.2,Matches,561.0,eng ENG,DF,37.0,22.6,1188.0,945.0,235.0,57.0,2.0,12.0,42.0,172.0,6.0,2.0,1.0,2.0,897.0,8.0,28.0,Matches,561.0,eng ENG,DF,37.0,22.6,897.0,1188.0,75.5,16006.0,6166.0,415.0,468.0,88.7,396.0,490.0,80.8,77.0,177.0,43.5,0.0,1.0,0.8,-1.0,14.0,82.0,18.0,5.0,107.0,Matches,713,eng ENG,DF,37,29,2036.0,70.0,59.5,22.6,23,82.0,15,6,25.0,9,1.69,27.0,28.0,-1.0,-0.04,-0.43,25.9,32.0,-6.1,-0.27,-0.52,Matches,561.0,eng ENG,DF,37.0,22.6,1411.0,86.0,502.0,675.0,252.0,10.0,1411.0,22.0,8.0,36.4,10.0,45.5,701.0,3235.0,1554.0,29.0,20.0,4.0,18.0,5.0,767.0,33.0,Matches,561.0,eng ENG,DF,37.0,22.6,1.0,15.0,3.0,20.0,0.66,0.13,0.07,0.33,25.1,0.0,0.0,0.0,0.5,0.5,0.03,0.5,0.5,Matches,561.0,eng ENG,DF,37.0,29.0,23.0,2036.0,22.6,1.0,0.0,1.0,1.0,0.0,0.0,7.0,0.0,0.5,0.5,1.0,1.4,29.0,107.0,33.0,0.04,0.0,0.04,0.04,0.04,0.02,0.04,0.06,0.02,0.06,Matches,Ashley Young,D/WB/M RL,37,133,156,England,Aston Villa,12,15,12,10,14,14,7,11,8,10,13,12,10,13,7,13,10,11,12,10,12,14,9,15,13,12,16,15,13,13,12,7,15,13,11,12,13,10,15,5,16,1,3,1,2,1,1,2,4,2,1,2,16,13,4,17,12,18,10,14,1,18,1,15,20,15,1,19,1,15,10,1,7,1,175,65,12,20,1625288,6650,6650,5750,African_Caribbean,124,14,1985/7/9,39,7,92793.0,,5113149
539,Wilfried Zaha,Crystal Palace,1992,563.0,ci CIV,FWMF,29.0,25.4,32.0,20.0,12.0,12.0,8.0,8.0,21.0,38.1,13.0,21.0,1.0,20.0,16.0,48.0,9.0,0.0,Matches,563.0,ci CIV,FWMF,29.0,25.4,91.0,3.58,57.0,0.0,12.0,4.0,17.0,1.0,7.0,0.28,6.0,0.0,0.0,1.0,0.0,0.0,Matches,,,,,,,,,,,,,,,,,,,,,,,,,,,,,,,,,,,,,,,,,,,,,,,,,,,,,,,,563.0,ci CIV,FWMF,29.0,25.4,5.0,0.0,0.0,35.0,77.0,14.0,39.0,16.0,20.0,1.0,0.0,0.0,97.0,6.0,16.0,27.3,Matches,563.0,ci CIV,FWMF,29.0,25.4,650.0,628.0,20.0,5.0,3.0,1.0,39.0,5.0,0.0,0.0,0.0,0.0,502.0,2.0,25.0,Matches,563.0,ci CIV,FWMF,29.0,25.4,502.0,650.0,77.2,7047.0,1594.0,322.0,370.0,87.0,148.0,185.0,80.0,18.0,37.0,48.6,2.0,2.7,3.0,-0.7,26.0,18.0,41.0,3.0,75.0,Matches,716,ci CIV,FWMF,29,27,2288.0,85.0,66.9,25.4,27,85.0,21,0,,0,1.22,22.0,34.0,-12.0,-0.47,-0.71,24.9,32.4,-7.5,-0.3,-0.2,Matches,563.0,ci CIV,FWMF,29.0,25.4,1040.0,12.0,100.0,388.0,567.0,143.0,1038.0,137.0,55.0,40.1,65.0,47.4,729.0,4850.0,2139.0,86.0,43.0,59.0,95.0,82.0,821.0,238.0,Matches,563.0,ci CIV,FWMF,29.0,25.4,7.0,64.0,21.0,32.8,2.52,0.83,0.11,0.33,16.8,0.0,0.0,2.0,6.5,4.8,0.08,0.5,2.2,Matches,563.0,ci CIV,FWMF,29.0,27.0,27.0,2288.0,25.4,7.0,2.0,9.0,7.0,0.0,2.0,5.0,0.0,6.5,4.8,2.7,7.5,86.0,75.0,238.0,0.28,0.08,0.35,0.28,0.35,0.26,0.11,0.36,0.19,0.3,Matches,Wilfried Zaha,AM/S RL,29,150,154,"Ivory Coast,England",Crystal Palace,8,11,17,14,14,10,7,14,7,8,11,14,6,15,13,12,11,15,11,11,14,14,17,11,13,8,12,12,15,15,14,11,16,15,15,13,15,12,16,7,15,3,3,1,1,1,3,3,1,3,2,2,12,18,11,10,15,9,9,7,1,1,1,1,1,1,1,15,1,12,20,1,17,18,181,74,11,20,33585767,7496,7496,6496,African_Caribbean,144,17,1992/11/10,26,5,150789.0,,28051378
540,Jordan Zemura,Bournemouth,1999,565.0,zw ZIM,DF,22.0,16.2,39.0,24.0,24.0,14.0,1.0,23.0,44.0,52.3,21.0,31.0,9.0,22.0,16.0,55.0,32.0,0.0,Matches,565.0,zw ZIM,DF,22.0,16.2,36.0,2.23,25.0,0.0,7.0,2.0,2.0,0.0,2.0,0.12,2.0,0.0,0.0,0.0,0.0,0.0,Matches,,,,,,,,,,,,,,,,,,,,,,,,,,,,,,,,,,,,,,,,,,,,,,,,,,,,,,,,565.0,zw ZIM,DF,22.0,16.2,1.0,0.0,0.0,17.0,14.0,0.0,18.0,16.0,24.0,0.0,1.0,0.0,78.0,7.0,11.0,38.9,Matches,565.0,zw ZIM,DF,22.0,16.2,594.0,466.0,127.0,8.0,0.0,1.0,18.0,119.0,0.0,0.0,0.0,0.0,423.0,1.0,30.0,Matches,565.0,zw ZIM,DF,22.0,16.2,423.0,594.0,71.2,6117.0,3247.0,242.0,284.0,85.2,133.0,187.0,71.1,23.0,55.0,41.8,1.0,1.9,2.1,-0.9,18.0,32.0,12.0,5.0,45.0,Matches,718,zw ZIM,DF,22,19,1454.0,77.0,42.5,16.2,17,83.0,12,2,23.0,5,0.95,14.0,31.0,-17.0,-1.05,-0.27,14.0,26.9,-12.9,-0.8,-0.23,Matches,565.0,zw ZIM,DF,22.0,16.2,808.0,46.0,302.0,297.0,222.0,31.0,808.0,43.0,21.0,48.8,18.0,41.9,375.0,2345.0,1235.0,39.0,29.0,10.0,35.0,16.0,409.0,48.0,Matches,565.0,zw ZIM,DF,22.0,16.2,0.0,4.0,0.0,0.0,0.25,0.0,0.0,,12.9,0.0,0.0,0.0,0.4,0.4,0.1,-0.4,-0.4,Matches,565.0,zw ZIM,DF,22.0,19.0,17.0,1454.0,16.2,0.0,1.0,1.0,0.0,0.0,0.0,1.0,0.0,0.4,0.4,1.9,2.2,39.0,45.0,48.0,0.0,0.06,0.06,0.0,0.06,0.02,0.11,0.14,0.02,0.14,Matches,Jordan Zemura,D/WB L,22,125,147,"Zimbabwe,England",AFC Bournemouth,7,11,14,9,11,6,8,6,7,11,11,6,13,12,9,11,9,12,11,11,11,14,11,8,12,11,14,17,15,14,12,7,16,15,17,9,14,6,10,4,8,1,3,3,3,1,3,2,1,3,1,3,10,12,4,15,10,15,13,14,1,20,1,1,19,1,1,7,1,1,1,1,1,1,173,0,20,8,15171719,6250,6250,3255,African_Caribbean,115,16,1999/11/14,6,0,28998.0,,29164969
541,Oleksandr Zinchenko,Arsenal,1996,566.0,ua UKR,DF,25.0,23.5,40.0,18.0,14.0,17.0,9.0,21.0,40.0,52.5,19.0,20.0,2.0,18.0,22.0,62.0,38.0,2.0,Matches,566.0,ua UKR,DF,25.0,23.5,56.0,2.38,49.0,1.0,0.0,4.0,1.0,1.0,4.0,0.17,3.0,0.0,0.0,1.0,0.0,0.0,Matches,,,,,,,,,,,,,,,,,,,,,,,,,,,,,,,,,,,,,,,,,,,,,,,,,,,,,,,,566.0,ua UKR,DF,25.0,23.5,3.0,0.0,0.0,6.0,11.0,1.0,37.0,22.0,18.0,0.0,0.0,0.0,163.0,51.0,20.0,71.8,Matches,566.0,ua UKR,DF,25.0,23.5,1911.0,1703.0,203.0,49.0,6.0,12.0,37.0,153.0,1.0,0.0,0.0,0.0,1652.0,5.0,29.0,Matches,566.0,ua UKR,DF,25.0,23.5,1652.0,1911.0,86.4,27023.0,7899.0,808.0,876.0,92.2,696.0,798.0,87.2,105.0,148.0,70.9,2.0,1.4,2.4,0.6,19.0,201.0,41.0,4.0,227.0,Matches,719,ua UKR,DF,25,27,2118.0,78.0,61.9,23.5,26,81.0,8,1,18.0,0,2.26,54.0,28.0,26.0,1.1,-0.21,45.3,26.5,18.8,0.8,0.05,Matches,566.0,ua UKR,DF,25.0,23.5,2112.0,77.0,463.0,1058.0,610.0,33.0,2112.0,25.0,15.0,60.0,9.0,36.0,1263.0,6899.0,3787.0,67.0,66.0,8.0,16.0,15.0,1398.0,68.0,Matches,566.0,ua UKR,DF,25.0,23.5,1.0,28.0,7.0,25.0,1.19,0.3,0.04,0.14,22.7,0.0,0.0,0.0,1.4,1.4,0.05,-0.4,-0.4,Matches,566.0,ua UKR,DF,25.0,27.0,26.0,2118.0,23.5,1.0,2.0,3.0,1.0,0.0,0.0,3.0,0.0,1.4,1.4,1.4,2.8,67.0,227.0,68.0,0.04,0.08,0.13,0.04,0.13,0.06,0.06,0.12,0.06,0.12,Matches,Oleksandr Zinchenko,D/WB/M/AM RLC,25,156,160,Ukraine,Arsenal,12,12,13,10,13,13,12,12,9,11,13,9,12,14,13,15,15,16,14,14,14,18,13,9,15,11,16,16,13,13,14,10,13,14,15,10,14,11,14,8,18,3,3,2,3,3,3,4,3,2,1,2,18,15,3,13,14,13,13,13,1,20,1,8,19,8,15,15,16,16,15,16,16,7,175,61,20,12,219941228,7800,7800,6750,Northern_European,140,4,1996/12/15,52,8,139190.0,,71081391
542,Kurt Zouma,West Ham,1994,568.0,fr FRA,DF,27.0,22.1,9.0,4.0,4.0,5.0,0.0,5.0,8.0,62.5,3.0,17.0,14.0,3.0,30.0,39.0,120.0,1.0,Matches,568.0,fr FRA,DF,27.0,22.1,9.0,0.41,7.0,1.0,0.0,1.0,0.0,0.0,2.0,0.09,1.0,0.0,0.0,1.0,0.0,0.0,Matches,,,,,,,,,,,,,,,,,,,,,,,,,,,,,,,,,,,,,,,,,,,,,,,,,,,,,,,,568.0,fr FRA,DF,27.0,22.1,0.0,0.0,0.0,14.0,7.0,0.0,0.0,30.0,4.0,0.0,0.0,0.0,84.0,55.0,13.0,80.9,Matches,568.0,fr FRA,DF,27.0,22.1,831.0,801.0,28.0,14.0,0.0,14.0,0.0,3.0,0.0,0.0,0.0,0.0,701.0,2.0,3.0,Matches,568.0,fr FRA,DF,27.0,22.1,701.0,831.0,84.4,13480.0,4437.0,247.0,271.0,91.1,363.0,407.0,89.2,79.0,129.0,61.2,0.0,0.1,0.1,-0.1,1.0,19.0,2.0,0.0,31.0,Matches,721,fr FRA,DF,27,25,1989.0,80.0,58.2,22.1,24,82.0,21,1,22.0,3,1.2,26.0,29.0,-3.0,-0.14,0.49,29.2,27.8,1.4,0.07,0.4,Matches,568.0,fr FRA,DF,27.0,22.1,1049.0,230.0,654.0,363.0,35.0,29.0,1049.0,5.0,2.0,40.0,3.0,60.0,523.0,2150.0,1018.0,3.0,1.0,0.0,5.0,2.0,621.0,1.0,Matches,568.0,fr FRA,DF,27.0,22.1,2.0,19.0,5.0,26.3,0.86,0.23,0.11,0.4,10.1,0.0,0.0,0.0,2.2,2.2,0.12,-0.2,-0.2,Matches,568.0,fr FRA,DF,27.0,25.0,24.0,1989.0,22.1,2.0,0.0,2.0,2.0,0.0,0.0,0.0,0.0,2.2,2.2,0.1,2.3,3.0,31.0,1.0,0.09,0.0,0.09,0.09,0.09,0.1,0.0,0.1,0.1,0.1,Matches,Kurt Zouma,D RC,27,156,162,"France,Central African Republic",West Ham United,4,10,9,8,11,6,17,7,8,13,11,7,15,10,15,13,14,11,12,8,14,16,7,13,8,14,13,15,18,11,19,18,14,15,14,20,15,13,15,9,8,2,3,3,2,1,2,2,1,1,1,2,8,17,5,13,14,17,15,13,1,1,20,15,1,10,14,1,1,1,1,1,1,1,190,96,7,20,68398007,7800,7500,6500,African_Caribbean,152,17,1994/10/27,11,1,115992.0,,85075595
543,Martin Ødegaard,Arsenal,1998,569.0,no NOR,MF,23.0,34.7,36.0,23.0,12.0,14.0,10.0,14.0,47.0,29.8,33.0,20.0,5.0,15.0,6.0,42.0,12.0,1.0,Matches,569.0,no NOR,MF,23.0,34.7,163.0,4.69,123.0,15.0,4.0,12.0,6.0,3.0,17.0,0.49,15.0,0.0,0.0,2.0,0.0,0.0,Matches,,,,,,,,,,,,,,,,,,,,,,,,,,,,,,,,,,,,,,,,,,,,,,,,,,,,,,,,569.0,no NOR,MF,23.0,34.7,4.0,0.0,0.0,30.0,26.0,1.0,91.0,6.0,23.0,0.0,0.0,0.0,178.0,13.0,20.0,39.4,Matches,569.0,no NOR,MF,23.0,34.7,1804.0,1683.0,110.0,79.0,23.0,9.0,91.0,13.0,18.0,9.0,6.0,1.0,1449.0,11.0,45.0,Matches,569.0,no NOR,MF,23.0,34.7,1449.0,1804.0,80.3,22540.0,6014.0,759.0,873.0,86.9,518.0,617.0,84.0,110.0,175.0,62.9,7.0,8.1,7.9,-1.1,76.0,135.0,91.0,4.0,266.0,Matches,723,no NOR,MF,23,37,3127.0,85.0,91.4,34.7,37,85.0,14,0,,0,2.19,82.0,38.0,44.0,1.27,0.96,66.9,37.5,29.4,0.85,0.74,Matches,569.0,no NOR,MF,23.0,34.7,2100.0,27.0,199.0,864.0,1060.0,122.0,2100.0,83.0,48.0,57.8,29.0,34.9,1284.0,6930.0,3022.0,83.0,60.0,26.0,42.0,45.0,1550.0,193.0,Matches,569.0,no NOR,MF,23.0,34.7,15.0,93.0,31.0,33.3,2.68,0.89,0.16,0.48,19.2,9.0,0.0,0.0,10.0,10.0,0.11,5.0,5.0,Matches,569.0,no NOR,MF,23.0,37.0,37.0,3127.0,34.7,15.0,7.0,22.0,15.0,0.0,0.0,4.0,0.0,10.0,10.0,8.1,18.1,83.0,266.0,193.0,0.43,0.2,0.63,0.43,0.63,0.29,0.23,0.52,0.29,0.52,Matches,Martin Ødegaard,M/AM C,23,160,178,Norway,Arsenal,14,14,16,12,17,15,9,13,7,10,16,10,8,17,7,18,10,15,12,17,16,15,16,14,16,9,17,14,14,16,15,9,13,13,15,11,11,4,12,7,13,1,1,3,2,1,3,1,1,3,1,2,13,16,6,12,14,18,13,14,1,1,1,1,1,1,13,10,18,13,10,20,14,8,178,68,20,10,272952661,7996,7996,7746,Northern_European,162,1,1998/12/17,43,2,139190.0,,53095137
544,Marcos Acuña,Sevilla,1991,3.0,ar ARG,DF,30.0,21.2,57.0,36.0,34.0,17.0,6.0,30.0,42.0,71.4,12.0,16.0,5.0,11.0,23.0,80.0,36.0,0.0,Matches,3.0,ar ARG,DF,30.0,21.2,65.0,3.04,45.0,14.0,3.0,3.0,0.0,0.0,4.0,0.19,4.0,0.0,0.0,0.0,0.0,0.0,Matches,,,,,,,,,,,,,,,,,,,,,,,,,,,,,,,,,,,,,,,,,,,,,,,,,,,,,,,,3.0,ar ARG,DF,30.0,21.2,10.0,3.0,0.0,32.0,34.0,1.0,147.0,23.0,36.0,0.0,1.0,0.0,141.0,30.0,18.0,62.5,Matches,3.0,ar ARG,DF,30.0,21.2,1307.0,1048.0,257.0,49.0,3.0,14.0,147.0,174.0,34.0,7.0,22.0,0.0,970.0,2.0,25.0,Matches,3.0,ar ARG,DF,30.0,21.2,970.0,1307.0,74.2,18018.0,6997.0,446.0,499.0,89.4,380.0,491.0,77.4,128.0,260.0,49.2,2.0,4.3,5.7,-2.3,38.0,71.0,38.0,19.0,102.0,Matches,3,ar ARG,DF,30,30,1912.0,64.0,55.9,21.2,21,79.0,10,9,28.0,0,1.33,27.0,34.0,-7.0,-0.33,-0.33,27.1,29.5,-2.5,-0.12,0.21,Matches,3.0,ar ARG,DF,30.0,21.2,1523.0,69.0,406.0,670.0,467.0,26.0,1523.0,54.0,26.0,48.1,23.0,42.6,823.0,4070.0,2178.0,49.0,43.0,5.0,29.0,20.0,903.0,94.0,Matches,3.0,ar ARG,DF,30.0,21.2,3.0,21.0,5.0,23.8,0.99,0.24,0.14,0.6,25.6,1.0,0.0,0.0,1.2,1.2,0.06,1.8,1.8,Matches,3.0,ar ARG,DF,30.0,30.0,21.0,1912.0,21.2,3.0,2.0,5.0,3.0,0.0,0.0,10.0,3.0,1.2,1.2,4.3,5.5,49.0,102.0,94.0,0.14,0.09,0.24,0.14,0.24,0.05,0.2,0.26,0.05,0.26,Matches,Marcos Acuña,D/WB/M/AM L,30,150,152,Argentina,Sevilla,16,16,14,10,14,13,7,14,10,12,15,9,14,14,18,14,14,14,15,15,12,17,16,14,14,12,15,15,13,14,15,7,12,13,15,12,14,16,15,13,13,3,1,2,2,1,2,1,2,3,3,3,14,15,15,8,15,12,7,7,1,20,10,1,20,1,10,19,10,5,18,10,13,1,172,72,20,9,45899999,7300,7300,6000,Mediterranean_Hispanic,141,6,1991/10/28,41,0,36287.0,,14044037
545,Álvaro Aguado,Valladolid,1996,5.0,es ESP,MF,26.0,21.0,27.0,15.0,13.0,11.0,3.0,15.0,25.0,60.0,10.0,16.0,4.0,12.0,13.0,40.0,15.0,0.0,Matches,5.0,es ESP,MF,26.0,21.0,76.0,3.62,56.0,13.0,3.0,0.0,4.0,0.0,4.0,0.19,2.0,2.0,0.0,0.0,0.0,0.0,Matches,,,,,,,,,,,,,,,,,,,,,,,,,,,,,,,,,,,,,,,,,,,,,,,,,,,,,,,,5.0,es ESP,MF,26.0,21.0,4.0,0.0,0.0,13.0,33.0,0.0,57.0,13.0,15.0,0.0,1.0,0.0,130.0,15.0,17.0,46.9,Matches,5.0,es ESP,MF,26.0,21.0,1142.0,1040.0,95.0,50.0,3.0,39.0,57.0,5.0,35.0,3.0,24.0,0.0,930.0,7.0,17.0,Matches,5.0,es ESP,MF,26.0,21.0,930.0,1142.0,81.4,18906.0,5096.0,359.0,404.0,88.9,371.0,429.0,86.5,174.0,246.0,70.7,2.0,2.2,2.0,-0.2,35.0,111.0,11.0,2.0,139.0,Matches,5,es ESP,MF,26,34,1888.0,56.0,55.2,21.0,18,78.0,11,16,31.0,4,1.15,19.0,36.0,-17.0,-0.81,-0.05,21.7,36.1,-14.4,-0.68,0.04,Matches,5.0,es ESP,MF,26.0,21.0,1292.0,36.0,255.0,742.0,315.0,18.0,1292.0,31.0,13.0,41.9,9.0,29.0,833.0,5476.0,2508.0,29.0,43.0,3.0,24.0,9.0,908.0,50.0,Matches,5.0,es ESP,MF,26.0,21.0,1.0,20.0,6.0,30.0,0.95,0.29,0.05,0.17,24.6,1.0,0.0,0.0,1.0,1.0,0.05,0.0,0.0,Matches,5.0,es ESP,MF,26.0,34.0,18.0,1888.0,21.0,1.0,2.0,3.0,1.0,0.0,0.0,4.0,0.0,1.0,1.0,2.2,3.2,29.0,139.0,50.0,0.05,0.1,0.14,0.05,0.14,0.05,0.11,0.15,0.05,0.15,Matches,Álvaro Aguado,M/AM C,26,130,135,Spain,Valladolid,11,11,12,9,13,8,7,10,5,10,13,8,11,13,12,12,13,13,13,14,15,13,14,12,12,13,14,14,12,14,14,8,14,13,13,11,13,14,14,5,12,2,2,3,1,1,3,1,1,1,1,4,7,13,5,10,12,14,13,13,1,1,1,1,1,1,12,1,20,1,1,16,1,1,174,66,12,20,2556749,6500,6500,4001,Mediterranean_Hispanic,128,7,1996/5/1,0,0,4861.0,,67245476
546,Joseph Aidoo,Celta Vigo,1995,6.0,gh GHA,DF,26.0,34.7,51.0,36.0,33.0,17.0,1.0,16.0,28.0,57.1,12.0,26.0,14.0,12.0,31.0,82.0,150.0,0.0,Matches,6.0,gh GHA,DF,26.0,34.7,10.0,0.29,8.0,0.0,0.0,1.0,0.0,1.0,0.0,0.0,0.0,0.0,0.0,0.0,0.0,0.0,Matches,,,,,,,,,,,,,,,,,,,,,,,,,,,,,,,,,,,,,,,,,,,,,,,,,,,,,,,,6.0,gh GHA,DF,26.0,34.7,6.0,1.0,1.0,18.0,18.0,0.0,2.0,31.0,36.0,0.0,1.0,0.0,214.0,63.0,63.0,50.0,Matches,6.0,gh GHA,DF,26.0,34.7,1766.0,1710.0,51.0,42.0,0.0,5.0,2.0,8.0,0.0,0.0,0.0,0.0,1525.0,5.0,13.0,Matches,6.0,gh GHA,DF,26.0,34.7,1525.0,1766.0,86.4,31337.0,9650.0,383.0,439.0,87.2,974.0,1050.0,92.8,163.0,244.0,66.8,0.0,0.1,0.3,-0.1,2.0,83.0,4.0,0.0,95.0,Matches,6,gh GHA,DF,26,35,3119.0,89.0,91.2,34.7,35,89.0,33,0,,0,1.14,40.0,48.0,-8.0,-0.23,0.37,40.1,40.6,-0.5,-0.02,0.66,Matches,6.0,gh GHA,DF,26.0,34.7,2082.0,301.0,1114.0,938.0,46.0,15.0,2082.0,13.0,8.0,61.5,2.0,15.4,1306.0,6192.0,3226.0,15.0,6.0,0.0,12.0,9.0,1321.0,2.0,Matches,6.0,gh GHA,DF,26.0,34.7,3.0,14.0,3.0,21.4,0.4,0.09,0.21,1.0,13.2,0.0,0.0,0.0,1.0,1.0,0.07,2.0,2.0,Matches,6.0,gh GHA,DF,26.0,35.0,35.0,3119.0,34.7,3.0,0.0,3.0,3.0,0.0,0.0,6.0,1.0,1.0,1.0,0.1,1.1,15.0,95.0,2.0,0.09,0.0,0.09,0.09,0.09,0.03,0.0,0.03,0.03,0.03,Matches,Joseph Aidoo,D C,26,130,140,Ghana,Vigo,7,7,7,4,11,8,14,7,9,14,11,6,15,11,12,12,14,11,9,11,13,14,7,11,8,13,14,13,14,15,15,12,15,14,15,16,11,8,12,5,6,3,1,2,2,3,3,1,1,3,2,2,14,13,4,10,13,13,14,14,1,1,20,5,1,1,1,1,1,1,1,1,1,1,184,80,7,20,4007288,6500,6700,5000,African_Caribbean,130,15,1995/9/29,8,0,36438.0,,13158416
547,Sergio Akieme,Almería,1997,7.0,es ESP,DF,24.0,25.5,27.0,16.0,19.0,6.0,2.0,12.0,22.0,54.5,10.0,22.0,6.0,16.0,14.0,41.0,41.0,0.0,Matches,7.0,es ESP,DF,24.0,25.5,36.0,1.41,29.0,1.0,1.0,3.0,0.0,2.0,3.0,0.12,2.0,0.0,1.0,0.0,0.0,0.0,Matches,,,,,,,,,,,,,,,,,,,,,,,,,,,,,,,,,,,,,,,,,,,,,,,,,,,,,,,,7.0,es ESP,DF,24.0,25.5,5.0,0.0,0.0,20.0,18.0,0.0,70.0,14.0,16.0,0.0,0.0,0.0,127.0,14.0,15.0,48.3,Matches,7.0,es ESP,DF,24.0,25.5,1061.0,824.0,230.0,25.0,3.0,13.0,70.0,205.0,0.0,0.0,0.0,0.0,821.0,7.0,20.0,Matches,7.0,es ESP,DF,24.0,25.5,821.0,1061.0,77.4,13314.0,5012.0,430.0,485.0,88.7,315.0,386.0,81.6,52.0,128.0,40.6,0.0,2.0,2.2,-2.0,21.0,43.0,22.0,17.0,58.0,Matches,7,es ESP,DF,24,29,2297.0,79.0,67.2,25.5,27,84.0,23,2,9.0,4,0.93,31.0,45.0,-14.0,-0.55,-0.39,29.6,42.8,-13.3,-0.52,-0.22,Matches,7.0,es ESP,DF,24.0,25.5,1283.0,78.0,434.0,563.0,307.0,35.0,1283.0,51.0,27.0,52.9,18.0,35.3,660.0,4200.0,2232.0,60.0,34.0,11.0,29.0,25.0,710.0,84.0,Matches,7.0,es ESP,DF,24.0,25.5,1.0,23.0,7.0,30.4,0.9,0.27,0.04,0.14,20.2,0.0,0.0,0.0,1.5,1.5,0.07,-0.5,-0.5,Matches,7.0,es ESP,DF,24.0,29.0,27.0,2297.0,25.5,1.0,0.0,1.0,1.0,0.0,0.0,5.0,0.0,1.5,1.5,2.0,3.5,60.0,58.0,84.0,0.04,0.0,0.04,0.04,0.04,0.06,0.08,0.14,0.06,0.14,Matches,Sergio Akieme,D/WB L,24,126,144,"Spain,Equatorial Guinea",Almería,8,13,12,8,13,7,9,9,12,9,12,8,12,13,13,12,13,10,10,9,14,12,12,8,12,11,13,14,15,13,12,11,15,15,15,14,12,10,12,5,12,3,3,3,3,2,1,3,3,3,3,3,15,12,5,14,11,14,13,12,1,20,1,1,18,1,1,10,1,1,8,1,1,1,175,70,20,6,3406194,6200,6200,4207,North_African__Middle_Eastern,121,14,1997/12/16,0,0,3068.0,,67213135
548,David Alaba,Real Madrid,1992,10.0,at AUT,DF,30.0,20.4,15.0,11.0,8.0,4.0,3.0,9.0,15.0,60.0,6.0,18.0,9.0,9.0,14.0,29.0,37.0,1.0,Matches,10.0,at AUT,DF,30.0,20.4,27.0,1.32,23.0,3.0,0.0,1.0,0.0,0.0,4.0,0.2,3.0,0.0,0.0,1.0,0.0,0.0,Matches,,,,,,,,,,,,,,,,,,,,,,,,,,,,,,,,,,,,,,,,,,,,,,,,,,,,,,,,10.0,at AUT,DF,30.0,20.4,3.0,0.0,0.0,9.0,3.0,0.0,26.0,14.0,11.0,0.0,1.0,0.0,94.0,11.0,8.0,57.9,Matches,10.0,at AUT,DF,30.0,20.4,1189.0,1082.0,98.0,45.0,4.0,3.0,26.0,46.0,3.0,3.0,0.0,0.0,1042.0,9.0,11.0,Matches,10.0,at AUT,DF,30.0,20.4,1042.0,1189.0,87.6,15258.0,5475.0,601.0,626.0,96.0,340.0,388.0,87.6,53.0,99.0,53.5,3.0,1.1,1.3,1.9,16.0,68.0,9.0,4.0,67.0,Matches,10,at AUT,DF,30,23,1838.0,80.0,53.7,20.4,21,86.0,16,2,19.0,3,2.3,49.0,18.0,31.0,1.52,1.06,43.8,21.5,22.3,1.09,0.28,Matches,10.0,at AUT,DF,30.0,20.4,1293.0,137.0,531.0,530.0,240.0,22.0,1293.0,4.0,3.0,75.0,1.0,25.0,779.0,3566.0,2070.0,16.0,24.0,2.0,7.0,5.0,938.0,60.0,Matches,10.0,at AUT,DF,30.0,20.4,1.0,14.0,3.0,21.4,0.69,0.15,0.07,0.33,19.8,5.0,0.0,0.0,0.8,0.8,0.06,0.2,0.2,Matches,10.0,at AUT,DF,30.0,23.0,21.0,1838.0,20.4,1.0,3.0,4.0,1.0,0.0,0.0,3.0,0.0,0.8,0.8,1.1,1.9,16.0,67.0,60.0,0.05,0.15,0.2,0.05,0.2,0.04,0.05,0.09,0.04,0.09,Matches,David Alaba,D/WB/M LC,30,164,174,"Austria,Philippines,Nigeria",R. Madrid,12,11,12,10,15,15,13,14,13,14,16,14,13,15,13,15,12,16,15,13,15,16,12,15,14,16,15,14,15,12,14,12,18,15,15,13,14,8,15,7,19,2,3,1,2,1,1,4,3,3,2,3,12,17,10,14,15,15,12,10,1,20,19,1,17,1,14,12,17,1,12,10,1,1,180,78,20,10,184320073,8200,8200,7450,South_East_Asian,158,15,1992/6/24,94,14,419579.0,,16010162
549,Jordi Alba,Barcelona,1989,13.0,es ESP,DF,33.0,15.8,25.0,18.0,13.0,11.0,1.0,12.0,28.0,42.9,16.0,12.0,5.0,7.0,11.0,36.0,23.0,0.0,Matches,13.0,es ESP,DF,33.0,15.8,59.0,3.74,52.0,5.0,1.0,1.0,0.0,0.0,6.0,0.38,5.0,1.0,0.0,0.0,0.0,0.0,Matches,,,,,,,,,,,,,,,,,,,,,,,,,,,,,,,,,,,,,,,,,,,,,,,,,,,,,,,,13.0,es ESP,DF,33.0,15.8,6.0,1.0,1.0,11.0,4.0,10.0,91.0,11.0,18.0,0.0,0.0,0.0,118.0,8.0,15.0,34.8,Matches,13.0,es ESP,DF,33.0,15.8,1460.0,1277.0,178.0,40.0,4.0,8.0,91.0,137.0,1.0,0.0,0.0,0.0,1217.0,5.0,24.0,Matches,13.0,es ESP,DF,33.0,15.8,1217.0,1460.0,83.4,19141.0,5490.0,668.0,728.0,91.8,441.0,521.0,84.6,78.0,139.0,56.1,3.0,6.2,6.7,-3.2,38.0,120.0,43.0,15.0,141.0,Matches,13,es ESP,DF,33,24,1419.0,59.0,41.5,15.8,14,83.0,6,10,26.0,12,2.17,27.0,8.0,19.0,1.21,-0.19,30.7,13.3,17.5,1.11,-0.01,Matches,13.0,es ESP,DF,33.0,15.8,1558.0,34.0,299.0,765.0,506.0,39.0,1558.0,8.0,4.0,50.0,4.0,50.0,957.0,3881.0,2079.0,42.0,27.0,6.0,7.0,7.0,1121.0,157.0,Matches,13.0,es ESP,DF,33.0,15.8,2.0,13.0,4.0,30.8,0.82,0.25,0.15,0.5,23.3,0.0,0.0,0.0,0.8,0.8,0.06,1.2,1.2,Matches,13.0,es ESP,DF,33.0,24.0,14.0,1419.0,15.8,2.0,3.0,5.0,2.0,0.0,0.0,6.0,1.0,0.8,0.8,6.2,7.0,42.0,141.0,157.0,0.13,0.19,0.32,0.13,0.32,0.05,0.4,0.44,0.05,0.44,Matches,Jordi Alba,D/WB L,33,154,166,Spain,Barcelona,12,14,13,13,16,10,5,10,12,12,13,10,14,15,15,16,15,12,12,15,14,16,13,13,18,12,15,16,17,14,15,6,13,15,15,9,13,14,14,11,12,2,3,2,1,3,2,2,2,1,1,2,15,18,13,14,13,14,6,7,1,20,1,1,19,1,1,14,1,1,12,1,1,1,170,68,20,9,28910713,7700,7700,7500,Mediterranean_Hispanic,146,5,1989/3/21,85,9,215384.0,,67052513
550,Raúl Albiol,Villarreal,1985,14.0,es ESP,DF,36.0,23.5,25.0,17.0,17.0,6.0,2.0,14.0,18.0,77.8,4.0,17.0,13.0,4.0,14.0,39.0,111.0,0.0,Matches,14.0,es ESP,DF,36.0,23.5,12.0,0.51,12.0,0.0,0.0,0.0,0.0,0.0,0.0,0.0,0.0,0.0,0.0,0.0,0.0,0.0,Matches,,,,,,,,,,,,,,,,,,,,,,,,,,,,,,,,,,,,,,,,,,,,,,,,,,,,,,,,14.0,es ESP,DF,36.0,23.5,6.0,0.0,0.0,17.0,13.0,1.0,1.0,14.0,17.0,0.0,0.0,0.0,108.0,38.0,25.0,60.3,Matches,14.0,es ESP,DF,36.0,23.5,1472.0,1428.0,42.0,34.0,0.0,15.0,1.0,0.0,0.0,0.0,0.0,0.0,1303.0,2.0,7.0,Matches,14.0,es ESP,DF,36.0,23.5,1303.0,1472.0,88.5,28074.0,10667.0,321.0,349.0,92.0,757.0,811.0,93.3,215.0,287.0,74.9,0.0,0.0,0.5,0.0,2.0,98.0,5.0,0.0,100.0,Matches,14,es ESP,DF,36,25,2119.0,85.0,62.0,23.5,24,88.0,22,1,15.0,2,1.52,29.0,23.0,6.0,0.25,-0.64,33.8,27.7,6.0,0.26,-0.14,Matches,14.0,es ESP,DF,36.0,23.5,1687.0,223.0,856.0,796.0,44.0,9.0,1687.0,7.0,4.0,57.1,3.0,42.9,1047.0,6928.0,4616.0,12.0,10.0,0.0,11.0,5.0,1152.0,3.0,Matches,14.0,es ESP,DF,36.0,23.5,0.0,2.0,1.0,50.0,0.08,0.04,0.0,0.0,25.2,0.0,0.0,0.0,0.1,0.1,0.05,-0.1,-0.1,Matches,14.0,es ESP,DF,36.0,25.0,24.0,2119.0,23.5,0.0,0.0,0.0,0.0,0.0,0.0,6.0,0.0,0.1,0.1,0.0,0.1,12.0,100.0,3.0,0.0,0.0,0.0,0.0,0.0,0.0,0.0,0.01,0.0,0.01,Matches,Raúl Albiol,D C,36,152,161,Spain,Villarreal,4,10,8,9,12,6,15,11,12,16,12,9,16,12,11,14,17,14,14,12,16,13,6,14,9,16,17,16,10,11,16,15,13,11,13,15,16,9,16,12,9,1,2,2,1,1,1,3,1,3,2,1,16,15,6,14,13,15,12,7,1,1,20,10,1,1,10,1,1,1,1,1,1,1,190,82,10,20,3403402,7600,7600,5900,Mediterranean_Hispanic,151,4,1985/9/4,58,0,47492.0,,7452450
551,Rubén Alcaraz,Cádiz,1991,15.0,es ESP,MF,31.0,22.7,43.0,31.0,24.0,18.0,1.0,19.0,54.0,35.2,35.0,23.0,8.0,15.0,19.0,62.0,37.0,0.0,Matches,15.0,es ESP,MF,31.0,22.7,47.0,2.07,34.0,9.0,1.0,1.0,2.0,0.0,2.0,0.09,2.0,0.0,0.0,0.0,0.0,0.0,Matches,,,,,,,,,,,,,,,,,,,,,,,,,,,,,,,,,,,,,,,,,,,,,,,,,,,,,,,,15.0,es ESP,MF,31.0,22.7,11.0,1.0,1.0,45.0,33.0,0.0,44.0,19.0,31.0,0.0,1.0,0.0,159.0,30.0,29.0,50.8,Matches,15.0,es ESP,MF,31.0,22.7,1046.0,978.0,63.0,44.0,6.0,27.0,44.0,0.0,15.0,9.0,2.0,2.0,827.0,5.0,17.0,Matches,15.0,es ESP,MF,31.0,22.7,827.0,1046.0,79.1,16517.0,4831.0,331.0,386.0,85.8,340.0,388.0,87.6,138.0,219.0,63.0,0.0,1.3,1.2,-1.3,20.0,93.0,16.0,8.0,105.0,Matches,15,es ESP,MF,31,31,2043.0,66.0,59.7,22.7,22,80.0,10,9,31.0,0,1.29,18.0,26.0,-8.0,-0.35,0.63,24.5,34.4,-9.8,-0.43,0.24,Matches,15.0,es ESP,MF,31.0,22.7,1286.0,64.0,309.0,768.0,224.0,22.0,1283.0,24.0,12.0,50.0,10.0,41.7,715.0,3713.0,1587.0,30.0,27.0,3.0,34.0,31.0,775.0,20.0,Matches,15.0,es ESP,MF,31.0,22.7,3.0,31.0,4.0,12.9,1.37,0.18,0.03,0.25,23.5,3.0,2.0,3.0,4.0,1.6,0.05,-1.0,-0.6,Matches,15.0,es ESP,MF,31.0,31.0,22.0,2043.0,22.7,3.0,0.0,3.0,1.0,2.0,3.0,11.0,1.0,4.0,1.6,1.3,2.9,30.0,105.0,20.0,0.13,0.0,0.13,0.04,0.04,0.18,0.06,0.23,0.07,0.13,Matches,Rubén Alcaraz,DM/M C,31,131,142,Spain,Cádiz,12,13,8,7,13,16,7,14,8,9,13,11,13,12,11,15,13,14,14,13,15,10,10,12,13,14,15,16,12,12,13,9,13,12,14,11,15,11,9,9,11,2,2,1,1,1,3,1,1,2,3,3,19,11,6,11,10,10,8,19,1,1,1,1,1,1,16,1,20,1,1,1,1,1,180,80,10,20,347975206,6550,6550,4700,Mediterranean_Hispanic,130,5,1991/5/1,0,0,11568.0,,67178038
552,Omar Alderete,Getafe,1996,16.0,py PAR,DF,25.0,22.7,35.0,20.0,21.0,14.0,0.0,28.0,40.0,70.0,12.0,23.0,16.0,7.0,26.0,61.0,85.0,0.0,Matches,16.0,py PAR,DF,25.0,22.7,24.0,1.06,22.0,0.0,0.0,2.0,0.0,0.0,3.0,0.13,3.0,0.0,0.0,0.0,0.0,0.0,Matches,,,,,,,,,,,,,,,,,,,,,,,,,,,,,,,,,,,,,,,,,,,,,,,,,,,,,,,,16.0,py PAR,DF,25.0,22.7,9.0,0.0,0.0,35.0,10.0,0.0,7.0,26.0,20.0,0.0,0.0,0.0,141.0,61.0,31.0,66.3,Matches,16.0,py PAR,DF,25.0,22.7,877.0,826.0,37.0,30.0,1.0,25.0,7.0,7.0,0.0,0.0,0.0,0.0,509.0,14.0,13.0,Matches,16.0,py PAR,DF,25.0,22.7,509.0,877.0,58.0,11252.0,5744.0,153.0,218.0,70.2,260.0,351.0,74.1,94.0,268.0,35.1,1.0,0.8,1.0,0.2,5.0,69.0,12.0,0.0,96.0,Matches,16,py PAR,DF,25,25,2047.0,82.0,59.9,22.7,23,87.0,19,2,23.0,6,1.04,19.0,24.0,-5.0,-0.22,0.17,23.2,27.7,-4.5,-0.2,0.12,Matches,16.0,py PAR,DF,25.0,22.7,1114.0,118.0,458.0,591.0,81.0,25.0,1114.0,22.0,17.0,77.3,5.0,22.7,529.0,2843.0,1937.0,28.0,15.0,2.0,15.0,8.0,533.0,8.0,Matches,16.0,py PAR,DF,25.0,22.7,1.0,17.0,8.0,47.1,0.75,0.35,0.06,0.13,17.6,0.0,0.0,0.0,0.6,0.6,0.04,0.4,0.4,Matches,16.0,py PAR,DF,25.0,25.0,23.0,2047.0,22.7,1.0,1.0,2.0,1.0,0.0,0.0,9.0,0.0,0.6,0.6,0.8,1.4,28.0,96.0,8.0,0.04,0.04,0.09,0.04,0.09,0.03,0.03,0.06,0.03,0.06,Matches,Omar Alderete,D C,25,140,149,Paraguay,Hertha Berlin,3,8,10,6,12,6,16,4,12,15,13,12,16,11,16,13,18,13,14,8,13,14,6,8,10,15,13,13,11,10,16,15,15,13,14,15,13,14,12,6,11,1,1,3,1,1,2,3,2,1,1,1,12,11,5,11,10,14,15,13,1,14,20,1,1,1,1,1,1,1,1,1,1,1,188,92,20,10,7325905,6600,6600,5250,Native_American,139,9,1996/12/26,11,0,28846.0,Getafe,79027217
553,Iván Alejo,Cádiz,1995,17.0,es ESP,MFFW,27.0,14.6,32.0,21.0,19.0,9.0,4.0,17.0,37.0,45.9,20.0,18.0,3.0,15.0,5.0,37.0,12.0,1.0,Matches,17.0,es ESP,MFFW,27.0,14.6,40.0,2.75,27.0,3.0,3.0,5.0,2.0,0.0,0.0,0.0,0.0,0.0,0.0,0.0,0.0,0.0,Matches,,,,,,,,,,,,,,,,,,,,,,,,,,,,,,,,,,,,,,,,,,,,,,,,,,,,,,,,17.0,es ESP,MFFW,27.0,14.6,13.0,1.0,1.0,38.0,44.0,2.0,108.0,5.0,21.0,0.0,1.0,0.0,76.0,25.0,17.0,59.5,Matches,17.0,es ESP,MFFW,27.0,14.6,392.0,365.0,25.0,5.0,1.0,0.0,108.0,13.0,7.0,2.0,4.0,0.0,219.0,2.0,26.0,Matches,17.0,es ESP,MFFW,27.0,14.6,219.0,392.0,55.9,3409.0,1108.0,128.0,173.0,74.0,55.0,111.0,49.5,24.0,61.0,39.3,1.0,2.4,1.6,-1.4,21.0,10.0,24.0,20.0,16.0,Matches,17,es ESP,MFFW,27,31,1311.0,42.0,38.3,14.6,13,69.0,2,18,23.0,2,1.06,8.0,26.0,-18.0,-1.24,-1.02,17.1,25.8,-8.7,-0.6,-0.11,Matches,17.0,es ESP,MFFW,27.0,14.6,590.0,23.0,131.0,185.0,283.0,22.0,590.0,47.0,12.0,25.5,25.0,53.2,356.0,2612.0,1275.0,52.0,32.0,2.0,38.0,23.0,378.0,103.0,Matches,17.0,es ESP,MFFW,27.0,14.6,0.0,23.0,6.0,26.1,1.58,0.41,0.0,0.0,21.3,0.0,0.0,0.0,1.2,1.2,0.05,-1.2,-1.2,Matches,17.0,es ESP,MFFW,27.0,31.0,13.0,1311.0,14.6,0.0,1.0,1.0,0.0,0.0,0.0,13.0,1.0,1.2,1.2,2.4,3.6,52.0,16.0,103.0,0.0,0.07,0.07,0.0,0.07,0.08,0.17,0.25,0.08,0.25,Matches,Iván Alejo,AM RL,27,125,129,Spain,Cádiz,10,12,11,9,12,9,8,10,7,7,12,9,7,13,15,12,14,9,10,12,10,11,13,10,14,10,11,18,15,13,14,11,11,14,12,11,9,16,14,9,11,3,1,1,2,2,3,4,3,3,1,2,8,10,14,12,12,13,9,7,1,1,1,1,1,1,1,11,1,14,15,8,20,1,186,79,12,20,1187344,6000,6000,3750,Mediterranean_Hispanic,121,2,1995/2/10,0,0,5899.0,,67176059
554,Carles Aleñá,Getafe,1998,18.0,es ESP,MFFW,24.0,23.5,18.0,10.0,7.0,5.0,6.0,5.0,34.0,14.7,29.0,19.0,1.0,18.0,4.0,22.0,18.0,0.0,Matches,18.0,es ESP,MFFW,24.0,23.5,44.0,1.87,30.0,2.0,1.0,2.0,9.0,0.0,4.0,0.17,4.0,0.0,0.0,0.0,0.0,0.0,Matches,,,,,,,,,,,,,,,,,,,,,,,,,,,,,,,,,,,,,,,,,,,,,,,,,,,,,,,,18.0,es ESP,MFFW,24.0,23.5,12.0,1.0,1.0,60.0,50.0,3.0,43.0,4.0,10.0,0.0,1.0,0.0,120.0,15.0,38.0,28.3,Matches,18.0,es ESP,MFFW,24.0,23.5,809.0,782.0,21.0,8.0,3.0,10.0,43.0,2.0,9.0,5.0,4.0,0.0,607.0,6.0,18.0,Matches,18.0,es ESP,MFFW,24.0,23.5,607.0,809.0,75.0,10256.0,2596.0,291.0,346.0,84.1,211.0,270.0,78.1,69.0,120.0,57.5,2.0,1.6,1.8,0.4,15.0,71.0,20.0,6.0,87.0,Matches,18,es ESP,MFFW,24,35,2119.0,61.0,62.0,23.5,26,75.0,7,9,20.0,0,1.0,17.0,27.0,-10.0,-0.42,-0.36,21.3,25.1,-3.8,-0.16,0.22,Matches,18.0,es ESP,MFFW,24.0,23.5,1024.0,17.0,149.0,579.0,312.0,28.0,1024.0,43.0,24.0,55.8,13.0,30.2,608.0,2796.0,1235.0,24.0,23.0,2.0,47.0,24.0,728.0,78.0,Matches,18.0,es ESP,MFFW,24.0,23.5,2.0,33.0,10.0,30.3,1.4,0.42,0.06,0.2,22.3,0.0,0.0,0.0,2.3,2.3,0.07,-0.3,-0.3,Matches,18.0,es ESP,MFFW,24.0,35.0,26.0,2119.0,23.5,2.0,2.0,4.0,2.0,0.0,0.0,12.0,1.0,2.3,2.3,1.6,3.9,24.0,87.0,78.0,0.08,0.08,0.17,0.08,0.17,0.1,0.07,0.17,0.1,0.17,Matches,Carles Aleñá,M/AM C,24,137,156,Spain,Getafe,14,13,15,12,17,13,7,12,8,5,17,14,7,17,10,14,11,14,12,16,14,13,18,11,14,9,13,12,12,12,12,10,14,13,12,11,12,10,17,6,9,2,1,2,1,2,3,2,1,3,3,3,18,16,7,17,14,13,11,12,1,1,1,1,1,1,6,10,20,9,9,18,11,8,180,73,20,9,8478633,6850,6850,5350,Mediterranean_Hispanic,134,7,1998/1/5,0,0,76922.0,,67213011
555,Marcos Alonso,Barcelona,1990,23.0,es ESP,DF,31.0,13.0,15.0,10.0,10.0,5.0,0.0,9.0,12.0,75.0,3.0,14.0,10.0,4.0,11.0,26.0,32.0,0.0,Matches,23.0,es ESP,DF,31.0,13.0,14.0,1.08,13.0,0.0,0.0,1.0,0.0,0.0,1.0,0.08,1.0,0.0,0.0,0.0,0.0,0.0,Matches,,,,,,,,,,,,,,,,,,,,,,,,,,,,,,,,,,,,,,,,,,,,,,,,,,,,,,,,23.0,es ESP,DF,31.0,13.0,3.0,0.0,0.0,10.0,8.0,0.0,23.0,11.0,10.0,0.0,1.0,0.0,85.0,26.0,10.0,72.2,Matches,23.0,es ESP,DF,31.0,13.0,1005.0,956.0,47.0,16.0,1.0,11.0,23.0,16.0,12.0,6.0,4.0,0.0,896.0,2.0,8.0,Matches,23.0,es ESP,DF,31.0,13.0,896.0,1005.0,89.2,16393.0,5539.0,360.0,386.0,93.3,442.0,475.0,93.1,81.0,117.0,69.2,0.0,0.3,0.9,-0.3,6.0,70.0,9.0,4.0,71.0,Matches,25,es ESP,DF,31,24,1172.0,49.0,34.3,13.0,11,80.0,8,13,22.0,10,2.29,22.0,11.0,11.0,0.84,-0.72,23.2,14.0,9.2,0.71,-0.62,Matches,23.0,es ESP,DF,31.0,13.0,1114.0,98.0,402.0,624.0,94.0,11.0,1114.0,2.0,2.0,100.0,0.0,0.0,727.0,4516.0,2674.0,26.0,11.0,0.0,8.0,1.0,816.0,12.0,Matches,23.0,es ESP,DF,31.0,13.0,1.0,6.0,2.0,33.3,0.46,0.15,0.17,0.5,12.0,0.0,0.0,0.0,0.9,0.9,0.15,0.1,0.1,Matches,23.0,es ESP,DF,31.0,24.0,11.0,1172.0,13.0,1.0,0.0,1.0,1.0,0.0,0.0,3.0,0.0,0.9,0.9,0.3,1.2,26.0,71.0,12.0,0.08,0.0,0.08,0.08,0.08,0.07,0.03,0.09,0.07,0.09,Matches,Marcos Alonso,D/WB/M L,31,144,151,Spain,Barcelona,14,13,12,14,14,15,16,14,12,13,14,12,14,14,12,14,12,14,12,13,14,13,12,9,15,13,14,15,12,10,15,13,14,12,16,15,14,9,13,7,13,2,2,2,1,1,2,3,4,3,3,3,13,14,10,12,13,14,13,12,1,18,12,1,20,1,1,19,1,1,1,1,1,1,188,87,20,9,7352534,7200,7250,6500,Mediterranean_Hispanic,143,5,1990/12/28,9,0,115992.0,,67080310
556,Gastón Álvarez,Getafe,2000,25.0,uy URU,DF,22.0,16.7,38.0,30.0,24.0,9.0,5.0,23.0,42.0,54.8,19.0,15.0,5.0,10.0,15.0,53.0,35.0,0.0,Matches,25.0,uy URU,DF,22.0,16.7,16.0,0.96,9.0,5.0,0.0,1.0,0.0,1.0,1.0,0.06,1.0,0.0,0.0,0.0,0.0,0.0,Matches,,,,,,,,,,,,,,,,,,,,,,,,,,,,,,,,,,,,,,,,,,,,,,,,,,,,,,,,25.0,uy URU,DF,22.0,16.7,7.0,1.0,0.0,27.0,12.0,0.0,23.0,15.0,30.0,0.0,1.0,0.0,53.0,31.0,31.0,50.0,Matches,25.0,uy URU,DF,22.0,16.7,579.0,431.0,147.0,6.0,0.0,2.0,23.0,141.0,0.0,0.0,0.0,0.0,350.0,1.0,16.0,Matches,25.0,uy URU,DF,22.0,16.7,350.0,579.0,60.4,5840.0,3078.0,176.0,209.0,84.2,136.0,228.0,59.6,30.0,103.0,29.1,0.0,0.2,0.4,-0.2,4.0,27.0,4.0,3.0,38.0,Matches,27,uy URU,DF,22,22,1501.0,68.0,43.9,16.7,16,86.0,10,6,22.0,14,1.41,17.0,15.0,2.0,0.12,0.73,20.6,19.7,0.9,0.05,0.54,Matches,25.0,uy URU,DF,22.0,16.7,732.0,42.0,218.0,376.0,144.0,8.0,732.0,19.0,8.0,42.1,9.0,47.4,254.0,933.0,437.0,11.0,8.0,0.0,13.0,3.0,318.0,27.0,Matches,25.0,uy URU,DF,22.0,16.7,2.0,5.0,2.0,40.0,0.3,0.12,0.4,1.0,16.9,0.0,0.0,0.0,0.5,0.5,0.11,1.5,1.5,Matches,25.0,uy URU,DF,22.0,22.0,16.0,1501.0,16.7,2.0,0.0,2.0,2.0,0.0,0.0,7.0,1.0,0.5,0.5,0.2,0.8,11.0,38.0,27.0,0.12,0.0,0.12,0.12,0.12,0.03,0.01,0.05,0.03,0.05,Matches,Gastón Álvarez,D LC,22,122,147,Uruguay,Club Atlético Boston River S.A.D.,4,7,10,5,12,1,14,9,10,13,9,7,11,11,11,13,12,11,14,11,15,10,5,10,10,12,7,12,11,12,11,12,7,13,8,13,16,9,5,8,16,2,4,1,1,3,3,3,2,4,2,3,12,10,1,10,13,13,12,15,1,18,20,1,1,1,14,1,1,1,1,1,1,1,184,72,20,12,2198024,6100,5048,4171,African_Caribbean,116,13,2000/3/24,0,0,32033.0,Getafe,78094302
557,Mauro Arambarri,Getafe,1995,35.0,uy URU,MF,26.0,11.0,14.0,6.0,9.0,4.0,1.0,3.0,17.0,17.6,14.0,17.0,5.0,12.0,14.0,28.0,19.0,0.0,Matches,35.0,uy URU,MF,26.0,11.0,25.0,2.27,8.0,14.0,1.0,1.0,0.0,1.0,3.0,0.27,2.0,1.0,0.0,0.0,0.0,0.0,Matches,,,,,,,,,,,,,,,,,,,,,,,,,,,,,,,,,,,,,,,,,,,,,,,,,,,,,,,,35.0,uy URU,MF,26.0,11.0,5.0,1.0,1.0,21.0,11.0,0.0,42.0,14.0,6.0,0.0,0.0,1.0,63.0,15.0,12.0,55.6,Matches,35.0,uy URU,MF,26.0,11.0,421.0,355.0,66.0,44.0,0.0,6.0,42.0,0.0,22.0,14.0,7.0,1.0,326.0,0.0,7.0,Matches,35.0,uy URU,MF,26.0,11.0,326.0,421.0,77.4,6549.0,2050.0,112.0,128.0,87.5,150.0,177.0,84.7,58.0,99.0,58.6,1.0,1.5,1.6,-0.5,15.0,32.0,4.0,2.0,33.0,Matches,42,uy URU,MF,26,13,992.0,76.0,29.0,11.0,13,76.0,5,0,,0,1.08,11.0,18.0,-7.0,-0.64,-0.49,11.5,13.2,-1.7,-0.16,0.13,Matches,35.0,uy URU,MF,26.0,11.0,514.0,30.0,118.0,304.0,102.0,3.0,514.0,4.0,4.0,100.0,0.0,0.0,234.0,1162.0,503.0,8.0,10.0,0.0,13.0,4.0,248.0,7.0,Matches,35.0,uy URU,MF,26.0,11.0,0.0,8.0,0.0,0.0,0.73,0.0,0.0,,28.6,1.0,0.0,0.0,0.2,0.2,0.03,-0.2,-0.2,Matches,35.0,uy URU,MF,26.0,13.0,13.0,992.0,11.0,0.0,1.0,1.0,0.0,0.0,0.0,5.0,1.0,0.2,0.2,1.5,1.8,8.0,33.0,7.0,0.0,0.09,0.09,0.0,0.09,0.02,0.14,0.16,0.02,0.16,Matches,Mauro Arambarri,DM/M RC,26,139,149,Uruguay,Getafe,8,10,12,10,13,11,8,12,4,13,13,6,15,13,14,14,16,13,15,12,13,15,11,8,12,14,16,16,13,12,14,6,12,13,16,13,15,11,13,9,12,4,2,3,1,1,2,2,3,1,3,2,8,12,2,9,13,14,10,13,1,1,1,1,1,1,20,1,18,15,1,1,1,1,174,71,12,20,7343554,6950,6950,6200,Mediterranean_Hispanic,138,7,1995/9/30,12,0,19137.0,,78064881
558,Sergio Asenjo,Valladolid,1989,42.0,es ESP,GK,33.0,10.0,0.0,0.0,0.0,0.0,0.0,0.0,0.0,,0.0,0.0,0.0,0.0,0.0,0.0,10.0,2.0,Matches,42.0,es ESP,GK,33.0,10.0,2.0,0.2,1.0,1.0,0.0,0.0,0.0,0.0,0.0,0.0,0.0,0.0,0.0,0.0,0.0,0.0,Matches,3.0,es ESP,GK,33.0,10.0,21.0,1.0,1.0,0.0,0.0,16.8,0.31,-4.2,-0.42,58.0,162.0,35.8,260.0,46.0,38.8,35.8,92.0,66.3,51.2,166.0,5.0,3.0,17.0,1.7,16.1,Matches,3.0,es ESP,GK,33.0,10.0,10.0,900.0,10.0,21.0,2.1,51.0,30.0,60.8,2.0,2.0,6.0,1.0,10.0,1.0,1.0,0.0,0.0,0.0,Matches,42.0,es ESP,GK,33.0,10.0,0.0,0.0,0.0,0.0,4.0,0.0,0.0,0.0,0.0,0.0,0.0,0.0,22.0,0.0,0.0,,Matches,42.0,es ESP,GK,33.0,10.0,353.0,234.0,118.0,26.0,0.0,2.0,0.0,0.0,0.0,0.0,0.0,0.0,233.0,1.0,1.0,Matches,42.0,es ESP,GK,33.0,10.0,233.0,353.0,66.0,7218.0,5138.0,33.0,33.0,100.0,107.0,112.0,95.5,91.0,203.0,44.8,0.0,0.0,0.0,0.0,0.0,4.0,0.0,0.0,0.0,Matches,51,es ESP,GK,33,10,900.0,90.0,26.3,10.0,10,90.0,10,0,,20,0.8,7.0,21.0,-14.0,-1.4,-0.83,8.7,18.4,-9.7,-0.97,-0.36,Matches,42.0,es ESP,GK,33.0,10.0,384.0,327.0,384.0,0.0,0.0,0.0,384.0,0.0,0.0,,0.0,,198.0,910.0,556.0,0.0,0.0,0.0,2.0,0.0,153.0,0.0,Matches,42.0,es ESP,GK,33.0,10.0,0.0,0.0,0.0,,0.0,0.0,,,,0.0,0.0,0.0,0.0,0.0,,0.0,0.0,Matches,42.0,es ESP,GK,33.0,10.0,10.0,900.0,10.0,0.0,0.0,0.0,0.0,0.0,0.0,0.0,0.0,0.0,0.0,0.0,0.0,0.0,0.0,0.0,0.0,0.0,0.0,0.0,0.0,0.0,0.0,0.0,0.0,0.0,Matches,Sergio Asenjo,GK,33,138,157,Spain,Valladolid,1,3,2,3,11,3,5,1,2,3,11,4,3,10,9,14,16,15,15,7,15,14,5,11,3,14,13,14,7,12,10,11,8,9,11,13,13,8,11,16,1,11,14,15,7,15,14,13,15,12,8,14,14,14,6,13,11,17,15,16,20,1,1,1,1,1,1,1,1,1,1,1,1,1,189,87,8,20,347975206,6900,6900,5250,Mediterranean_Hispanic,139,6,1989/6/28,1,0,17507.0,,67006488
559,Marco Asensio,Real Madrid,1996,43.0,es ESP,FWMF,26.0,16.0,16.0,10.0,8.0,6.0,2.0,8.0,19.0,42.1,11.0,8.0,3.0,5.0,5.0,21.0,4.0,0.0,Matches,43.0,es ESP,FWMF,26.0,16.0,76.0,4.74,47.0,16.0,6.0,4.0,3.0,0.0,12.0,0.75,7.0,2.0,2.0,0.0,1.0,0.0,Matches,,,,,,,,,,,,,,,,,,,,,,,,,,,,,,,,,,,,,,,,,,,,,,,,,,,,,,,,43.0,es ESP,FWMF,26.0,16.0,1.0,0.0,0.0,10.0,16.0,4.0,82.0,5.0,10.0,1.0,1.0,0.0,45.0,3.0,2.0,60.0,Matches,43.0,es ESP,FWMF,26.0,16.0,802.0,722.0,76.0,18.0,5.0,7.0,82.0,8.0,48.0,25.0,7.0,0.0,650.0,4.0,28.0,Matches,43.0,es ESP,FWMF,26.0,16.0,650.0,802.0,81.0,9900.0,2248.0,378.0,415.0,91.1,187.0,222.0,84.2,56.0,102.0,54.9,6.0,4.9,4.2,1.1,41.0,60.0,26.0,6.0,70.0,Matches,52,es ESP,FWMF,26,31,1442.0,47.0,42.2,16.0,15,80.0,7,16,16.0,6,1.9,34.0,16.0,18.0,1.12,0.17,38.7,16.0,22.7,1.42,0.79,Matches,43.0,es ESP,FWMF,26.0,16.0,951.0,11.0,66.0,375.0,517.0,71.0,950.0,33.0,23.0,69.7,7.0,21.2,609.0,3688.0,1856.0,56.0,39.0,11.0,19.0,13.0,725.0,108.0,Matches,43.0,es ESP,FWMF,26.0,16.0,9.0,58.0,24.0,41.4,3.62,1.5,0.16,0.38,21.5,5.0,0.0,1.0,6.3,5.5,0.1,2.7,3.5,Matches,43.0,es ESP,FWMF,26.0,31.0,15.0,1442.0,16.0,9.0,6.0,15.0,9.0,0.0,1.0,1.0,0.0,6.3,5.5,4.9,10.4,56.0,70.0,108.0,0.56,0.37,0.94,0.56,0.94,0.39,0.3,0.7,0.35,0.65,Matches,Marco Asensio,AM RLC,26,152,165,"Spain,Holland",R. Madrid,15,15,16,15,17,15,8,18,7,5,16,14,8,18,9,14,10,14,11,15,13,15,17,8,12,11,12,13,14,14,11,10,17,15,14,12,9,10,10,8,14,3,2,1,1,2,2,2,1,2,3,1,12,8,7,10,14,12,10,12,1,1,1,1,1,1,1,10,12,12,19,18,20,6,182,76,20,9,30099999,7600,7600,7000,Mediterranean_Hispanic,152,6,1996/1/21,29,1,136985.0,,67197125
560,Iago Aspas,Celta Vigo,1987,44.0,es ESP,FW,34.0,31.9,8.0,4.0,0.0,4.0,4.0,3.0,22.0,13.6,19.0,10.0,1.0,9.0,7.0,15.0,23.0,0.0,Matches,44.0,es ESP,FW,34.0,31.9,141.0,4.42,110.0,8.0,5.0,8.0,9.0,1.0,8.0,0.25,8.0,0.0,0.0,0.0,0.0,0.0,Matches,,,,,,,,,,,,,,,,,,,,,,,,,,,,,,,,,,,,,,,,,,,,,,,,,,,,,,,,44.0,es ESP,FW,34.0,31.9,6.0,0.0,0.0,16.0,59.0,12.0,45.0,7.0,4.0,0.0,0.0,0.0,103.0,31.0,45.0,40.8,Matches,44.0,es ESP,FW,34.0,31.9,1227.0,1146.0,75.0,23.0,15.0,15.0,45.0,11.0,23.0,8.0,6.0,0.0,936.0,6.0,33.0,Matches,44.0,es ESP,FW,34.0,31.9,936.0,1227.0,76.3,14650.0,3382.0,517.0,625.0,82.7,275.0,353.0,77.9,91.0,131.0,69.5,3.0,5.6,5.4,-2.6,83.0,90.0,47.0,2.0,162.0,Matches,53,es ESP,FW,34,37,2868.0,78.0,83.9,31.9,31,89.0,27,6,20.0,0,1.16,36.0,46.0,-10.0,-0.31,-0.31,37.7,37.4,0.3,0.01,0.52,Matches,44.0,es ESP,FW,34.0,31.9,1487.0,26.0,111.0,643.0,748.0,145.0,1484.0,56.0,22.0,39.3,25.0,44.6,1030.0,5114.0,2370.0,80.0,58.0,30.0,52.0,46.0,1199.0,239.0,Matches,44.0,es ESP,FW,34.0,31.9,12.0,75.0,29.0,38.7,2.35,0.91,0.13,0.34,19.5,7.0,2.0,3.0,11.0,8.7,0.12,1.0,1.3,Matches,44.0,es ESP,FW,34.0,37.0,31.0,2868.0,31.9,12.0,3.0,15.0,10.0,2.0,3.0,6.0,0.0,11.0,8.7,5.6,14.3,80.0,162.0,239.0,0.38,0.09,0.47,0.31,0.41,0.35,0.18,0.52,0.27,0.45,Matches,Iago Aspas,AM/S RC,34,154,160,Spain,Vigo,12,12,14,16,14,15,13,15,6,5,13,16,6,16,12,16,13,16,13,14,15,15,17,18,17,8,14,15,15,15,15,11,16,13,12,7,13,16,18,5,14,2,2,1,2,2,1,2,3,2,1,1,8,14,15,16,13,11,8,6,1,1,1,1,1,1,1,1,1,1,5,17,18,20,176,67,20,14,347975206,7600,7600,6000,Mediterranean_Hispanic,154,5,1987/8/1,18,6,49863.0,,67010455
561,Ezequiel Ávila,Osasuna,1994,47.0,ar ARG,FWMF,28.0,19.0,8.0,5.0,2.0,4.0,2.0,6.0,23.0,26.1,17.0,12.0,1.0,11.0,8.0,16.0,16.0,0.0,Matches,47.0,ar ARG,FWMF,28.0,19.0,41.0,2.16,28.0,2.0,4.0,4.0,2.0,1.0,2.0,0.11,1.0,0.0,0.0,1.0,0.0,0.0,Matches,,,,,,,,,,,,,,,,,,,,,,,,,,,,,,,,,,,,,,,,,,,,,,,,,,,,,,,,47.0,ar ARG,FWMF,28.0,19.0,7.0,1.0,0.0,25.0,35.0,14.0,81.0,8.0,5.0,0.0,0.0,0.0,54.0,35.0,50.0,41.2,Matches,47.0,ar ARG,FWMF,28.0,19.0,526.0,478.0,43.0,10.0,2.0,24.0,81.0,8.0,15.0,6.0,7.0,0.0,287.0,5.0,21.0,Matches,47.0,ar ARG,FWMF,28.0,19.0,287.0,526.0,54.6,5983.0,1501.0,131.0,185.0,70.8,87.0,151.0,57.6,62.0,139.0,44.6,2.0,1.8,2.1,0.2,18.0,24.0,25.0,14.0,39.0,Matches,57,ar ARG,FWMF,28,29,1709.0,59.0,50.0,19.0,23,68.0,1,6,23.0,3,1.31,18.0,17.0,1.0,0.05,0.37,19.6,20.2,-0.6,-0.03,0.25,Matches,47.0,ar ARG,FWMF,28.0,19.0,739.0,18.0,83.0,275.0,383.0,61.0,736.0,34.0,17.0,50.0,14.0,41.2,422.0,1922.0,710.0,23.0,18.0,6.0,39.0,18.0,509.0,96.0,Matches,47.0,ar ARG,FWMF,28.0,19.0,8.0,64.0,21.0,32.8,3.37,1.11,0.09,0.29,21.9,2.0,2.0,3.0,7.0,4.7,0.07,1.0,1.3,Matches,47.0,ar ARG,FWMF,28.0,29.0,23.0,1709.0,19.0,8.0,2.0,10.0,6.0,2.0,3.0,7.0,1.0,7.0,4.7,1.8,6.5,23.0,39.0,96.0,0.42,0.11,0.53,0.32,0.42,0.37,0.1,0.47,0.25,0.34,Matches,Ezequiel Ávila,AM/S RLC,28,130,138,"Argentina,Spain",Atlético Pamplona,9,13,12,13,13,10,9,14,7,7,12,14,5,13,15,14,16,9,9,10,10,13,14,9,15,6,14,15,14,14,12,13,13,14,14,13,10,13,14,13,8,1,1,1,3,1,1,1,3,2,3,2,12,13,9,13,12,11,10,17,1,1,1,1,1,1,1,1,1,1,16,18,19,20,172,65,9,20,6233562,6750,6250,5500,Native_American,122,8,1994/2/6,0,0,14881.0,,14027117
562,Iddrisu Baba,Mallorca,1996,48.0,gh GHA,MFDF,26.0,18.9,31.0,17.0,15.0,16.0,0.0,15.0,32.0,46.9,17.0,18.0,8.0,10.0,11.0,42.0,39.0,0.0,Matches,48.0,gh GHA,MFDF,26.0,18.9,13.0,0.67,10.0,0.0,0.0,1.0,1.0,1.0,1.0,0.05,0.0,0.0,0.0,1.0,0.0,0.0,Matches,,,,,,,,,,,,,,,,,,,,,,,,,,,,,,,,,,,,,,,,,,,,,,,,,,,,,,,,48.0,gh GHA,MFDF,26.0,18.9,5.0,0.0,0.0,31.0,30.0,0.0,0.0,11.0,17.0,0.0,0.0,0.0,122.0,37.0,28.0,56.9,Matches,48.0,gh GHA,MFDF,26.0,18.9,584.0,571.0,10.0,9.0,1.0,7.0,0.0,1.0,0.0,0.0,0.0,0.0,476.0,3.0,9.0,Matches,48.0,gh GHA,MFDF,26.0,18.9,476.0,584.0,81.5,8907.0,2460.0,190.0,212.0,89.6,221.0,252.0,87.7,57.0,93.0,61.3,0.0,0.2,0.3,-0.2,5.0,42.0,2.0,0.0,47.0,Matches,58,gh GHA,MFDF,26,29,1705.0,59.0,49.9,18.9,20,76.0,10,9,21.0,6,1.45,14.0,24.0,-10.0,-0.53,-0.74,16.6,25.5,-8.9,-0.46,-0.33,Matches,48.0,gh GHA,MFDF,26.0,18.9,773.0,61.0,253.0,476.0,60.0,8.0,773.0,19.0,11.0,57.9,5.0,26.3,413.0,1926.0,498.0,3.0,5.0,0.0,28.0,15.0,398.0,8.0,Matches,48.0,gh GHA,MFDF,26.0,18.9,0.0,12.0,2.0,16.7,0.63,0.11,0.0,0.0,24.0,0.0,0.0,0.0,0.6,0.6,0.05,-0.6,-0.6,Matches,48.0,gh GHA,MFDF,26.0,29.0,20.0,1705.0,18.9,0.0,0.0,0.0,0.0,0.0,0.0,5.0,0.0,0.6,0.6,0.2,0.8,3.0,47.0,8.0,0.0,0.0,0.0,0.0,0.0,0.03,0.01,0.04,0.03,0.04,Matches,Iddrisu Baba,DM/M C,26,127,144,"Ghana,Spain",Mallorca,5,8,9,5,11,6,11,9,7,13,10,8,15,10,14,15,15,12,14,9,13,7,9,10,6,15,15,16,12,13,12,11,14,14,16,14,13,9,12,12,13,2,3,3,2,1,3,3,3,2,2,3,9,12,6,10,11,12,11,13,1,1,11,1,1,1,20,1,18,1,1,1,1,1,182,73,10,20,2757278,6300,6300,4050,African_Caribbean,125,16,1996/1/22,18,0,7258.0,,67233494
563,Srđan Babić,Almería,1996,49.0,rs SRB,DF,26.0,33.3,28.0,18.0,20.0,8.0,0.0,15.0,32.0,46.9,17.0,34.0,22.0,12.0,29.0,57.0,124.0,1.0,Matches,49.0,rs SRB,DF,26.0,33.3,20.0,0.6,18.0,0.0,0.0,2.0,0.0,0.0,1.0,0.03,0.0,0.0,0.0,1.0,0.0,0.0,Matches,,,,,,,,,,,,,,,,,,,,,,,,,,,,,,,,,,,,,,,,,,,,,,,,,,,,,,,,49.0,rs SRB,DF,26.0,33.3,5.0,0.0,0.0,24.0,9.0,2.0,2.0,29.0,18.0,0.0,0.0,0.0,136.0,71.0,46.0,60.7,Matches,49.0,rs SRB,DF,26.0,33.3,1373.0,1295.0,71.0,65.0,1.0,12.0,2.0,5.0,0.0,0.0,0.0,0.0,1172.0,7.0,9.0,Matches,49.0,rs SRB,DF,26.0,33.3,1172.0,1373.0,85.4,23290.0,8365.0,382.0,420.0,91.0,637.0,700.0,91.0,142.0,223.0,63.7,0.0,0.3,0.4,-0.3,7.0,55.0,3.0,1.0,63.0,Matches,59,rs SRB,DF,26,34,2998.0,88.0,87.7,33.3,33,89.0,32,1,45.0,3,1.15,42.0,56.0,-14.0,-0.42,0.01,39.5,51.7,-12.2,-0.37,0.67,Matches,49.0,rs SRB,DF,26.0,33.3,1640.0,237.0,976.0,633.0,43.0,16.0,1640.0,8.0,4.0,50.0,4.0,50.0,891.0,4831.0,2792.0,21.0,13.0,1.0,10.0,3.0,1013.0,5.0,Matches,49.0,rs SRB,DF,26.0,33.3,3.0,9.0,5.0,55.6,0.27,0.15,0.33,0.6,10.1,0.0,0.0,0.0,1.2,1.2,0.13,1.8,1.8,Matches,49.0,rs SRB,DF,26.0,34.0,33.0,2998.0,33.3,3.0,0.0,3.0,3.0,0.0,0.0,5.0,0.0,1.2,1.2,0.3,1.5,21.0,63.0,5.0,0.09,0.0,0.09,0.09,0.09,0.04,0.01,0.04,0.04,0.04,Matches,Srđan Babić,D C,26,125,146,"Serbia,Bosnia and Herzegovina",Almería,8,8,7,7,11,8,13,8,10,14,12,8,13,8,12,14,12,14,15,11,13,15,10,12,10,13,13,13,10,12,13,16,13,11,13,14,15,9,14,7,10,2,3,2,3,3,2,1,3,3,2,2,13,13,9,11,14,13,13,12,1,14,20,12,1,1,1,1,1,1,1,1,1,1,195,85,20,7,3116778,6250,6100,4600,Northern_European,125,4,1996/4/22,0,0,6673.0,,62124086
564,Alejandro Balde,Barcelona,2003,53.0,es ESP,DF,18.0,27.5,42.0,30.0,22.0,16.0,4.0,24.0,41.0,58.5,17.0,25.0,3.0,22.0,12.0,54.0,17.0,1.0,Matches,53.0,es ESP,DF,18.0,27.5,66.0,2.4,50.0,0.0,8.0,2.0,5.0,1.0,8.0,0.29,8.0,0.0,0.0,0.0,0.0,0.0,Matches,,,,,,,,,,,,,,,,,,,,,,,,,,,,,,,,,,,,,,,,,,,,,,,,,,,,,,,,53.0,es ESP,DF,18.0,27.5,4.0,0.0,0.0,27.0,29.0,5.0,67.0,12.0,30.0,0.0,0.0,0.0,145.0,19.0,18.0,51.4,Matches,53.0,es ESP,DF,18.0,27.5,1670.0,1444.0,217.0,32.0,0.0,5.0,67.0,185.0,0.0,0.0,0.0,0.0,1482.0,9.0,19.0,Matches,53.0,es ESP,DF,18.0,27.5,1482.0,1670.0,88.7,21525.0,4340.0,892.0,951.0,93.8,486.0,536.0,90.7,71.0,106.0,67.0,6.0,4.9,5.4,1.1,22.0,74.0,22.0,16.0,79.0,Matches,64,es ESP,DF,18,33,2471.0,75.0,72.3,27.5,30,81.0,21,3,9.0,4,2.45,48.0,15.0,33.0,1.2,-0.41,53.8,25.9,27.9,1.02,-0.35,Matches,53.0,es ESP,DF,18.0,27.5,1939.0,40.0,419.0,874.0,672.0,78.0,1939.0,96.0,50.0,52.1,36.0,37.5,1270.0,7276.0,4100.0,96.0,69.0,35.0,41.0,24.0,1348.0,234.0,Matches,53.0,es ESP,DF,18.0,27.5,1.0,19.0,4.0,21.1,0.69,0.15,0.05,0.25,17.9,0.0,0.0,0.0,1.9,1.9,0.1,-0.9,-0.9,Matches,53.0,es ESP,DF,18.0,33.0,30.0,2471.0,27.5,1.0,6.0,7.0,1.0,0.0,0.0,4.0,0.0,1.9,1.9,4.9,6.8,96.0,79.0,234.0,0.04,0.22,0.25,0.04,0.25,0.07,0.18,0.25,0.07,0.25,Matches,Alejandro Balde,D/WB/M L,18,127,-9,"Spain,Guinea-Bissau,Dominican Republic",Barcelona,8,13,12,8,12,9,8,9,10,10,12,8,11,13,12,11,12,10,10,11,12,14,13,7,13,9,11,12,16,17,12,8,15,16,13,8,15,10,14,8,15,2,2,2,3,1,2,1,2,1,3,1,12,13,5,14,15,14,13,15,1,20,1,13,19,12,1,17,1,13,15,1,14,1,175,69,20,5,33000000,6350,6350,4350,African_Caribbean,111,13,2003/10/18,0,0,3989.0,,67296654
565,Iván Balliu,Rayo Vallecano,1992,55.0,al ALB,DF,30.0,35.9,52.0,29.0,26.0,20.0,6.0,18.0,30.0,60.0,12.0,26.0,3.0,23.0,25.0,77.0,72.0,1.0,Matches,55.0,al ALB,DF,30.0,35.9,66.0,1.84,51.0,11.0,0.0,1.0,3.0,0.0,0.0,0.0,0.0,0.0,0.0,0.0,0.0,0.0,Matches,,,,,,,,,,,,,,,,,,,,,,,,,,,,,,,,,,,,,,,,,,,,,,,,,,,,,,,,55.0,al ALB,DF,30.0,35.9,6.0,0.0,0.0,42.0,34.0,7.0,105.0,25.0,29.0,0.0,2.0,2.0,145.0,29.0,37.0,43.9,Matches,55.0,al ALB,DF,30.0,35.9,1850.0,1406.0,430.0,24.0,1.0,2.0,105.0,406.0,0.0,0.0,0.0,0.0,1422.0,14.0,46.0,Matches,55.0,al ALB,DF,30.0,35.9,1422.0,1850.0,76.9,23328.0,9525.0,718.0,792.0,90.7,551.0,707.0,77.9,118.0,235.0,50.2,0.0,2.8,2.6,-2.8,32.0,95.0,34.0,18.0,131.0,Matches,66,al ALB,DF,30,37,3232.0,87.0,94.5,35.9,37,87.0,31,0,,0,1.3,43.0,47.0,-4.0,-0.11,1.8,38.7,46.1,-7.4,-0.21,-0.67,Matches,55.0,al ALB,DF,30.0,35.9,2116.0,88.0,503.0,925.0,695.0,26.0,2116.0,31.0,11.0,35.5,12.0,38.7,1021.0,5129.0,2879.0,75.0,51.0,4.0,22.0,9.0,1150.0,147.0,Matches,55.0,al ALB,DF,30.0,35.9,0.0,6.0,1.0,16.7,0.17,0.03,0.0,0.0,17.4,0.0,0.0,0.0,0.3,0.3,0.06,-0.3,-0.3,Matches,55.0,al ALB,DF,30.0,37.0,37.0,3232.0,35.9,0.0,0.0,0.0,0.0,0.0,0.0,6.0,0.0,0.3,0.3,2.8,3.1,75.0,131.0,147.0,0.0,0.0,0.0,0.0,0.0,0.01,0.08,0.09,0.01,0.09,Matches,Iván Balliu,D/WB R,30,133,136,"Albania,Spain",Vallecano,8,14,12,7,13,8,9,12,14,11,13,7,14,13,12,13,14,13,13,12,12,12,6,7,13,13,15,15,14,14,10,6,14,14,15,10,14,6,12,5,15,2,1,3,3,2,1,1,3,1,3,2,15,14,4,10,12,14,15,13,1,13,1,20,9,17,1,1,1,12,1,1,1,1,172,63,12,20,3647641,6650,6650,4650,Mediterranean_Hispanic,130,4,1992/1/1,6,0,12637.0,,67053461
566,Léo Baptistão,Almería,1992,56.0,br BRA,FWMF,29.0,19.2,32.0,20.0,13.0,16.0,3.0,13.0,33.0,39.4,20.0,17.0,2.0,15.0,19.0,51.0,12.0,0.0,Matches,56.0,br BRA,FWMF,29.0,19.2,53.0,2.77,37.0,0.0,4.0,8.0,2.0,2.0,3.0,0.16,2.0,0.0,0.0,1.0,0.0,0.0,Matches,,,,,,,,,,,,,,,,,,,,,,,,,,,,,,,,,,,,,,,,,,,,,,,,,,,,,,,,56.0,br BRA,FWMF,29.0,19.2,7.0,0.0,0.0,30.0,23.0,10.0,18.0,19.0,20.0,0.0,0.0,0.0,104.0,27.0,40.0,40.3,Matches,56.0,br BRA,FWMF,29.0,19.2,540.0,526.0,11.0,2.0,6.0,7.0,18.0,8.0,0.0,0.0,0.0,0.0,359.0,3.0,25.0,Matches,56.0,br BRA,FWMF,29.0,19.2,359.0,540.0,66.5,5742.0,1514.0,179.0,229.0,78.2,124.0,178.0,69.7,30.0,66.0,45.5,1.0,1.2,0.9,-0.2,18.0,30.0,13.0,3.0,51.0,Matches,67,br BRA,FWMF,29,28,1726.0,62.0,50.5,19.2,24,69.0,1,4,19.0,1,1.29,28.0,30.0,-2.0,-0.1,0.64,20.6,28.7,-8.2,-0.43,0.05,Matches,56.0,br BRA,FWMF,29.0,19.2,789.0,16.0,158.0,391.0,262.0,61.0,789.0,36.0,14.0,38.9,16.0,44.4,465.0,2611.0,1484.0,38.0,31.0,9.0,56.0,17.0,525.0,83.0,Matches,56.0,br BRA,FWMF,29.0,19.2,5.0,45.0,16.0,35.6,2.35,0.83,0.11,0.31,14.9,0.0,0.0,0.0,4.9,4.9,0.11,0.1,0.1,Matches,56.0,br BRA,FWMF,29.0,28.0,24.0,1726.0,19.2,5.0,1.0,6.0,5.0,0.0,0.0,7.0,0.0,4.9,4.9,1.2,6.2,38.0,51.0,83.0,0.26,0.05,0.31,0.26,0.31,0.26,0.06,0.32,0.26,0.32,Matches,Léo Baptistão,AM/S RLC,29,129,151,"Brazil,Spain,Italy",Almería,9,12,15,12,14,11,10,12,5,5,14,12,5,15,10,13,9,12,12,14,12,14,16,9,14,5,10,9,13,13,10,12,10,13,11,10,10,8,9,15,7,4,2,1,2,3,2,3,1,2,1,2,16,12,7,9,11,13,10,8,1,1,1,1,1,1,1,15,8,15,17,17,20,18,184,73,14,20,6233559,6450,6450,5000,Mediterranean_Hispanic,122,5,1992/8/26,0,0,9152.0,,67153647
567,Kike Barja,Osasuna,1997,58.0,es ESP,FWMF,25.0,14.6,15.0,9.0,6.0,5.0,4.0,8.0,24.0,33.3,16.0,7.0,0.0,7.0,4.0,19.0,3.0,0.0,Matches,58.0,es ESP,FWMF,25.0,14.6,49.0,3.36,36.0,7.0,5.0,0.0,0.0,1.0,8.0,0.55,7.0,1.0,0.0,0.0,0.0,0.0,Matches,,,,,,,,,,,,,,,,,,,,,,,,,,,,,,,,,,,,,,,,,,,,,,,,,,,,,,,,58.0,es ESP,FWMF,25.0,14.6,1.0,0.0,0.0,18.0,15.0,7.0,110.0,4.0,9.0,0.0,0.0,0.0,65.0,8.0,11.0,42.1,Matches,58.0,es ESP,FWMF,25.0,14.6,487.0,458.0,28.0,2.0,2.0,2.0,110.0,12.0,13.0,5.0,5.0,0.0,316.0,1.0,21.0,Matches,58.0,es ESP,FWMF,25.0,14.6,316.0,487.0,64.9,5033.0,1204.0,174.0,216.0,80.6,96.0,153.0,62.7,30.0,65.0,46.2,6.0,3.9,3.6,2.1,28.0,13.0,25.0,18.0,35.0,Matches,70,es ESP,FWMF,25,27,1312.0,49.0,38.4,14.6,15,70.0,1,12,22.0,11,1.3,19.0,18.0,1.0,0.07,0.32,15.0,18.6,-3.6,-0.25,-0.15,Matches,58.0,es ESP,FWMF,25.0,14.6,674.0,6.0,65.0,199.0,413.0,55.0,674.0,89.0,39.0,43.8,44.0,49.4,459.0,3154.0,1499.0,61.0,28.0,18.0,44.0,25.0,498.0,185.0,Matches,58.0,es ESP,FWMF,25.0,14.6,1.0,17.0,6.0,35.3,1.17,0.41,0.06,0.17,15.3,0.0,0.0,0.0,1.2,1.2,0.07,-0.2,-0.2,Matches,58.0,es ESP,FWMF,25.0,27.0,15.0,1312.0,14.6,1.0,6.0,7.0,1.0,0.0,0.0,1.0,0.0,1.2,1.2,3.9,5.1,61.0,35.0,185.0,0.07,0.41,0.48,0.07,0.48,0.08,0.26,0.35,0.08,0.35,Matches,Kike Barja,M/AM RL,25,130,142,"Spain,Pays Basque",Atlético Pamplona,13,13,14,12,13,8,8,11,6,6,13,13,7,14,11,10,14,10,12,12,13,11,14,11,13,12,14,13,14,13,11,8,11,14,13,11,12,11,11,12,14,1,2,2,3,3,1,1,3,3,1,2,16,13,6,10,11,12,10,20,1,5,1,8,10,10,1,18,1,18,20,1,20,1,178,0,13,20,3918237,6300,6300,3800,Mediterranean_Hispanic,129,6,1997/4/1,0,0,7405.0,,67196202
568,Fran Beltrán,Celta Vigo,1999,64.0,es ESP,MF,23.0,31.7,34.0,22.0,15.0,14.0,5.0,14.0,55.0,25.5,41.0,29.0,5.0,24.0,53.0,87.0,35.0,2.0,Matches,64.0,es ESP,MF,23.0,31.7,66.0,2.08,53.0,10.0,0.0,1.0,0.0,2.0,4.0,0.13,2.0,1.0,0.0,0.0,0.0,1.0,Matches,,,,,,,,,,,,,,,,,,,,,,,,,,,,,,,,,,,,,,,,,,,,,,,,,,,,,,,,64.0,es ESP,MF,23.0,31.7,4.0,0.0,0.0,26.0,16.0,2.0,51.0,53.0,22.0,0.0,1.0,0.0,196.0,18.0,48.0,27.3,Matches,64.0,es ESP,MF,23.0,31.7,1816.0,1667.0,147.0,88.0,0.0,12.0,51.0,8.0,38.0,18.0,14.0,1.0,1604.0,2.0,19.0,Matches,64.0,es ESP,MF,23.0,31.7,1604.0,1816.0,88.3,28935.0,6589.0,658.0,716.0,91.9,743.0,808.0,92.0,164.0,221.0,74.2,2.0,1.7,2.5,0.3,24.0,136.0,12.0,4.0,138.0,Matches,78,es ESP,MF,23,36,2855.0,79.0,83.5,31.7,33,84.0,22,3,28.0,0,1.17,35.0,44.0,-9.0,-0.28,-0.12,37.3,35.8,1.5,0.05,0.73,Matches,64.0,es ESP,MF,23.0,31.7,2062.0,62.0,454.0,1253.0,366.0,11.0,2062.0,22.0,16.0,72.7,6.0,27.3,1239.0,6158.0,2685.0,27.0,45.0,4.0,26.0,17.0,1354.0,33.0,Matches,64.0,es ESP,MF,23.0,31.7,0.0,24.0,2.0,8.3,0.76,0.06,0.0,0.0,27.3,0.0,0.0,0.0,0.9,0.9,0.04,-0.9,-0.9,Matches,64.0,es ESP,MF,23.0,36.0,33.0,2855.0,31.7,0.0,2.0,2.0,0.0,0.0,0.0,4.0,0.0,0.9,0.9,1.7,2.6,27.0,138.0,33.0,0.0,0.06,0.06,0.0,0.06,0.03,0.05,0.08,0.03,0.08,Matches,Fran Beltrán,DM/M C,23,137,156,Spain,Vigo,9,10,12,10,14,8,7,12,13,12,16,8,13,14,12,15,12,13,12,14,15,12,13,9,14,14,15,14,12,13,13,7,13,12,13,10,12,9,12,7,8,3,2,2,1,2,1,1,3,2,3,3,8,11,8,12,14,15,12,14,1,1,1,1,1,1,20,5,20,1,1,14,1,1,165,64,11,20,10760075,6550,6550,4300,Mediterranean_Hispanic,135,1,1999/2/3,1,0,11317.0,,67232115
569,Karim Benzema,Real Madrid,1987,66.0,fr FRA,FW,34.0,22.6,9.0,5.0,2.0,4.0,3.0,2.0,11.0,18.2,9.0,11.0,0.0,11.0,2.0,11.0,5.0,0.0,Matches,66.0,fr FRA,FW,34.0,22.6,102.0,4.5,86.0,1.0,6.0,7.0,2.0,0.0,7.0,0.31,5.0,0.0,1.0,1.0,0.0,0.0,Matches,,,,,,,,,,,,,,,,,,,,,,,,,,,,,,,,,,,,,,,,,,,,,,,,,,,,,,,,66.0,fr FRA,FW,34.0,22.6,1.0,0.0,0.0,10.0,6.0,22.0,3.0,2.0,5.0,2.0,0.0,0.0,35.0,14.0,13.0,51.9,Matches,66.0,fr FRA,FW,34.0,22.6,1070.0,1012.0,52.0,4.0,9.0,7.0,3.0,4.0,9.0,0.0,0.0,0.0,924.0,6.0,25.0,Matches,66.0,fr FRA,FW,34.0,22.6,924.0,1070.0,86.4,10990.0,2417.0,624.0,695.0,89.8,193.0,210.0,91.9,24.0,32.0,75.0,3.0,5.8,5.5,-2.8,48.0,71.0,51.0,0.0,138.0,Matches,80,fr FRA,FW,34,24,2038.0,85.0,59.6,22.6,24,85.0,18,0,,0,2.08,46.0,17.0,29.0,1.28,0.63,47.5,23.9,23.6,1.04,0.2,Matches,66.0,fr FRA,FW,34.0,22.6,1284.0,7.0,56.0,457.0,776.0,175.0,1276.0,44.0,20.0,45.5,22.0,50.0,796.0,3734.0,1900.0,72.0,43.0,31.0,32.0,28.0,1092.0,157.0,Matches,66.0,fr FRA,FW,34.0,22.6,19.0,99.0,36.0,36.4,4.37,1.59,0.12,0.33,15.9,6.0,7.0,8.0,21.5,14.9,0.15,-2.5,-2.9,Matches,66.0,fr FRA,FW,34.0,24.0,24.0,2038.0,22.6,19.0,3.0,22.0,12.0,7.0,8.0,1.0,0.0,21.5,14.9,5.8,20.7,72.0,138.0,157.0,0.84,0.13,0.97,0.53,0.66,0.95,0.26,1.2,0.66,0.91,Matches,Karim Benzema,S,34,185,185,"France,Algeria",R. Madrid,10,13,16,17,20,12,15,12,7,7,18,15,9,20,7,14,10,18,14,18,17,18,17,11,15,12,16,14,15,14,15,11,11,15,14,14,14,4,15,8,8,3,1,2,3,3,1,2,4,1,2,2,15,14,17,12,15,15,17,18,1,1,1,1,1,1,1,1,1,1,13,12,8,20,185,82,17,20,102955257,9250,8750,8750,North_African__Middle_Eastern,183,9,1987/12/19,97,37,321918.0,,8435089
570,Álex Berenguer,Athletic Club,1995,68.0,es ESP,FW,27.0,25.5,58.0,37.0,17.0,25.0,16.0,23.0,60.0,38.3,37.0,37.0,4.0,33.0,10.0,68.0,6.0,0.0,Matches,68.0,es ESP,FW,27.0,25.5,98.0,3.84,48.0,29.0,9.0,5.0,4.0,3.0,4.0,0.16,2.0,0.0,1.0,1.0,0.0,0.0,Matches,,,,,,,,,,,,,,,,,,,,,,,,,,,,,,,,,,,,,,,,,,,,,,,,,,,,,,,,68.0,es ESP,FW,27.0,25.5,2.0,0.0,0.0,48.0,25.0,19.0,162.0,10.0,37.0,0.0,0.0,0.0,114.0,35.0,42.0,45.5,Matches,68.0,es ESP,FW,27.0,25.5,955.0,792.0,151.0,35.0,0.0,2.0,162.0,15.0,100.0,36.0,32.0,1.0,630.0,12.0,31.0,Matches,68.0,es ESP,FW,27.0,25.5,630.0,955.0,66.0,9379.0,2766.0,372.0,441.0,84.4,163.0,266.0,61.3,62.0,152.0,40.8,1.0,4.6,5.2,-3.6,52.0,25.0,41.0,16.0,77.0,Matches,82,es ESP,FW,27,37,2297.0,62.0,67.2,25.5,26,78.0,10,11,25.0,1,1.3,30.0,33.0,-3.0,-0.12,-0.68,33.7,25.4,8.4,0.33,-0.39,Matches,68.0,es ESP,FW,27.0,25.5,1298.0,22.0,135.0,390.0,794.0,117.0,1298.0,85.0,37.0,43.5,44.0,51.8,716.0,4451.0,2024.0,73.0,54.0,35.0,63.0,39.0,848.0,249.0,Matches,68.0,es ESP,FW,27.0,25.5,4.0,56.0,19.0,33.9,2.19,0.74,0.07,0.21,18.0,4.0,0.0,0.0,4.3,4.3,0.08,-0.3,-0.3,Matches,68.0,es ESP,FW,27.0,37.0,26.0,2297.0,25.5,4.0,1.0,5.0,4.0,0.0,0.0,2.0,0.0,4.3,4.3,4.6,9.0,73.0,77.0,249.0,0.16,0.04,0.2,0.16,0.2,0.17,0.18,0.35,0.17,0.35,Matches,Álex Berenguer,WB/M/AM RLC,27,144,153,"Spain,Pays Basque",A. Bilbao,14,12,15,13,13,12,6,10,5,8,13,8,7,14,9,11,11,12,11,12,12,14,14,8,14,9,11,13,15,16,14,7,13,14,12,8,12,10,12,7,18,1,2,4,1,3,2,2,1,1,1,1,7,13,2,11,12,12,13,12,1,14,1,8,17,12,1,19,1,17,20,15,15,14,175,73,12,20,60000001,7200,7200,6450,Mediterranean_Hispanic,129,6,1995/7/4,0,0,24903.0,,67157520
571,Pedro Bigas,Elche,1990,69.0,es ESP,DF,31.0,22.4,37.0,20.0,30.0,7.0,0.0,18.0,29.0,62.1,11.0,25.0,14.0,11.0,33.0,70.0,95.0,0.0,Matches,69.0,es ESP,DF,31.0,22.4,14.0,0.62,9.0,0.0,1.0,2.0,1.0,1.0,3.0,0.13,1.0,0.0,0.0,1.0,1.0,0.0,Matches,,,,,,,,,,,,,,,,,,,,,,,,,,,,,,,,,,,,,,,,,,,,,,,,,,,,,,,,69.0,es ESP,DF,31.0,22.4,4.0,2.0,0.0,17.0,16.0,0.0,5.0,33.0,20.0,1.0,1.0,0.0,123.0,42.0,19.0,68.9,Matches,69.0,es ESP,DF,31.0,22.4,1053.0,976.0,68.0,52.0,0.0,18.0,5.0,13.0,0.0,0.0,0.0,0.0,843.0,9.0,10.0,Matches,69.0,es ESP,DF,31.0,22.4,843.0,1053.0,80.1,16786.0,7505.0,284.0,314.0,90.4,449.0,500.0,89.8,100.0,200.0,50.0,0.0,0.0,0.3,0.0,0.0,63.0,1.0,1.0,83.0,Matches,84,es ESP,DF,31,28,2020.0,72.0,59.1,22.4,25,77.0,17,3,28.0,4,0.57,11.0,41.0,-30.0,-1.34,-0.89,18.1,37.9,-19.8,-0.88,-0.06,Matches,69.0,es ESP,DF,31.0,22.4,1302.0,174.0,681.0,569.0,63.0,19.0,1302.0,8.0,5.0,62.5,3.0,37.5,722.0,3899.0,2273.0,19.0,13.0,0.0,13.0,4.0,766.0,3.0,Matches,69.0,es ESP,DF,31.0,22.4,0.0,22.0,8.0,36.4,0.98,0.36,0.0,0.0,15.5,0.0,0.0,0.0,1.8,1.8,0.08,-1.8,-1.8,Matches,69.0,es ESP,DF,31.0,28.0,25.0,2020.0,22.4,0.0,0.0,0.0,0.0,0.0,0.0,4.0,2.0,1.8,1.8,0.0,1.8,19.0,83.0,3.0,0.0,0.0,0.0,0.0,0.0,0.08,0.0,0.08,0.08,0.08,Matches,Pedro Bigas,D/DM LC,32,133,142,Spain,Elche,6,7,9,9,10,8,14,8,6,14,10,11,14,11,12,13,14,13,14,10,13,14,10,14,11,14,14,15,12,12,12,12,14,13,14,14,14,10,15,14,17,1,2,2,3,1,3,3,4,2,2,3,13,13,5,8,13,15,14,11,1,17,20,9,12,8,18,9,14,1,7,1,1,1,181,78,20,8,2238806,6650,6650,4650,Mediterranean_Hispanic,129,4,1990/5/15,0,0,12637.0,,67122014
572,El Bilal Touré,Almería,2001,70.0,ml MLI,FW,20.0,14.0,4.0,3.0,2.0,1.0,1.0,0.0,3.0,0.0,3.0,6.0,1.0,5.0,1.0,5.0,23.0,0.0,Matches,70.0,ml MLI,FW,20.0,14.0,36.0,2.56,26.0,1.0,2.0,4.0,3.0,0.0,4.0,0.28,3.0,0.0,1.0,0.0,0.0,0.0,Matches,,,,,,,,,,,,,,,,,,,,,,,,,,,,,,,,,,,,,,,,,,,,,,,,,,,,,,,,70.0,ml MLI,FW,20.0,14.0,0.0,0.0,0.0,25.0,7.0,13.0,4.0,1.0,3.0,0.0,0.0,0.0,46.0,44.0,46.0,48.9,Matches,70.0,ml MLI,FW,20.0,14.0,258.0,231.0,25.0,0.0,0.0,0.0,4.0,0.0,0.0,0.0,0.0,0.0,183.0,2.0,8.0,Matches,70.0,ml MLI,FW,20.0,14.0,183.0,258.0,70.9,2226.0,311.0,130.0,158.0,82.3,44.0,65.0,67.7,2.0,2.0,100.0,2.0,1.3,0.7,0.7,14.0,7.0,3.0,1.0,14.0,Matches,85,ml MLI,FW,20,21,1264.0,60.0,37.0,14.0,15,73.0,1,6,27.0,3,1.1,23.0,23.0,0.0,0.0,0.67,17.3,18.6,-1.4,-0.1,0.56,Matches,70.0,ml MLI,FW,20.0,14.0,407.0,26.0,46.0,196.0,172.0,53.0,407.0,17.0,6.0,35.3,9.0,52.9,201.0,1136.0,519.0,18.0,16.0,9.0,44.0,9.0,261.0,51.0,Matches,70.0,ml MLI,FW,20.0,14.0,7.0,29.0,14.0,48.3,2.06,1.0,0.24,0.5,11.5,0.0,0.0,0.0,6.3,6.3,0.22,0.7,0.7,Matches,70.0,ml MLI,FW,20.0,21.0,15.0,1264.0,14.0,7.0,2.0,9.0,7.0,0.0,0.0,0.0,0.0,6.3,6.3,1.3,7.6,18.0,14.0,51.0,0.5,0.14,0.64,0.5,0.64,0.45,0.09,0.54,0.45,0.54,Matches,El Bilal Touré,S,20,122,147,"Mali,Ivory Coast",Almería,8,7,12,12,14,9,12,11,10,6,12,13,6,14,8,12,10,12,11,11,11,11,12,8,12,9,9,10,16,11,11,11,11,14,14,13,11,7,10,8,6,2,1,2,3,1,3,2,3,3,3,4,15,14,12,7,10,8,14,10,1,1,1,1,1,1,1,1,1,1,1,1,10,20,185,72,10,20,7992601,6100,6100,4200,African_Caribbean,120,17,2001/10/3,13,4,4814.0,,12081007
573,Theo Bongonda,Cádiz,1995,73.0,cd COD,MFFW,26.0,21.5,28.0,20.0,11.0,14.0,3.0,17.0,40.0,42.5,23.0,21.0,2.0,19.0,6.0,34.0,14.0,0.0,Matches,73.0,cd COD,MFFW,26.0,21.5,45.0,2.09,27.0,3.0,4.0,4.0,6.0,1.0,5.0,0.23,3.0,0.0,1.0,1.0,0.0,0.0,Matches,,,,,,,,,,,,,,,,,,,,,,,,,,,,,,,,,,,,,,,,,,,,,,,,,,,,,,,,73.0,cd COD,MFFW,26.0,21.5,2.0,0.0,0.0,15.0,37.0,6.0,68.0,6.0,20.0,0.0,0.0,0.0,96.0,14.0,13.0,51.9,Matches,73.0,cd COD,MFFW,26.0,21.5,489.0,437.0,48.0,17.0,2.0,2.0,68.0,7.0,24.0,11.0,3.0,0.0,329.0,4.0,18.0,Matches,73.0,cd COD,MFFW,26.0,21.5,329.0,489.0,67.3,4564.0,1295.0,207.0,254.0,81.5,87.0,123.0,70.7,20.0,70.0,28.6,3.0,3.0,2.4,0.0,20.0,20.0,11.0,4.0,39.0,Matches,89,cd COD,MFFW,26,31,1938.0,63.0,56.7,21.5,24,72.0,4,7,30.0,5,1.19,18.0,25.0,-7.0,-0.33,0.65,23.0,32.2,-9.2,-0.43,0.23,Matches,73.0,cd COD,MFFW,26.0,21.5,766.0,17.0,118.0,282.0,387.0,55.0,765.0,98.0,40.0,40.8,42.0,42.9,480.0,3985.0,2088.0,74.0,47.0,20.0,57.0,26.0,497.0,105.0,Matches,73.0,cd COD,MFFW,26.0,21.5,4.0,42.0,14.0,33.3,1.95,0.65,0.07,0.21,21.1,2.0,1.0,1.0,5.2,4.4,0.1,-1.2,-1.4,Matches,73.0,cd COD,MFFW,26.0,31.0,24.0,1938.0,21.5,4.0,3.0,7.0,3.0,1.0,1.0,2.0,0.0,5.2,4.4,3.0,7.4,74.0,39.0,105.0,0.19,0.14,0.33,0.14,0.28,0.24,0.14,0.38,0.2,0.34,Matches,Theo Bongonda,M/AM RLC,26,133,140,"Democratic Republic of Congo,Belgium",Cádiz,10,12,14,11,14,11,7,12,9,6,14,7,7,14,12,12,14,10,11,9,12,12,15,12,14,6,13,13,15,14,12,13,10,15,11,8,9,6,12,9,9,1,1,1,2,1,1,2,3,1,2,2,15,14,17,12,12,12,13,9,1,1,1,1,1,1,1,17,1,16,20,18,18,12,177,73,20,12,3957817,6500,6600,5000,Mixed_Race,127,13,1995/11/20,3,0,22741.0,,18081111
574,Yassine Bounou,Sevilla,1991,74.0,ma MAR,GK,31.0,23.9,2.0,1.0,2.0,0.0,0.0,1.0,4.0,25.0,3.0,0.0,0.0,0.0,2.0,4.0,11.0,1.0,Matches,74.0,ma MAR,GK,31.0,23.9,2.0,0.08,2.0,0.0,0.0,0.0,0.0,0.0,0.0,0.0,0.0,0.0,0.0,0.0,0.0,0.0,Matches,5.0,ma MAR,GK,31.0,23.9,41.0,2.0,1.0,3.0,2.0,37.3,0.34,-1.7,-0.07,115.0,303.0,38.0,785.0,92.0,27.9,30.9,162.0,51.9,42.1,308.0,20.0,6.5,39.0,1.63,17.4,Matches,5.0,ma MAR,GK,31.0,25.0,25.0,2151.0,23.9,41.0,1.72,106.0,66.0,63.2,7.0,6.0,12.0,4.0,16.0,3.0,2.0,1.0,0.0,33.3,Matches,74.0,ma MAR,GK,31.0,23.9,2.0,0.0,0.0,0.0,1.0,0.0,0.0,2.0,1.0,0.0,0.0,0.0,34.0,4.0,2.0,66.7,Matches,74.0,ma MAR,GK,31.0,23.9,949.0,735.0,212.0,50.0,0.0,2.0,0.0,0.0,0.0,0.0,0.0,0.0,717.0,2.0,0.0,Matches,74.0,ma MAR,GK,31.0,23.9,717.0,949.0,75.6,18725.0,13212.0,155.0,155.0,100.0,341.0,349.0,97.7,219.0,440.0,49.8,0.0,0.0,0.0,0.0,0.0,7.0,0.0,0.0,1.0,Matches,90,ma MAR,GK,31,25,2151.0,86.0,62.9,23.9,25,86.0,23,0,,12,1.04,27.0,42.0,-15.0,-0.63,-1.19,28.1,37.8,-9.7,-0.41,-0.53,Matches,74.0,ma MAR,GK,31.0,23.9,1011.0,766.0,995.0,17.0,0.0,0.0,1011.0,1.0,1.0,100.0,0.0,0.0,596.0,2682.0,1374.0,0.0,0.0,0.0,4.0,0.0,566.0,0.0,Matches,74.0,ma MAR,GK,31.0,23.9,0.0,0.0,0.0,,0.0,0.0,,,,0.0,0.0,0.0,0.0,0.0,,0.0,0.0,Matches,74.0,ma MAR,GK,31.0,25.0,25.0,2151.0,23.9,0.0,0.0,0.0,0.0,0.0,0.0,2.0,0.0,0.0,0.0,0.0,0.0,0.0,1.0,0.0,0.0,0.0,0.0,0.0,0.0,0.0,0.0,0.0,0.0,0.0,Matches,Yassine Bounou,GK,31,150,152,"Morocco,Canada",Sevilla,4,1,2,1,7,9,8,2,1,2,7,1,3,5,7,12,13,14,16,8,14,12,6,11,2,15,15,13,10,13,9,15,10,13,11,14,13,2,16,13,13,14,15,15,4,16,15,16,15,9,11,15,11,12,4,14,11,16,15,17,20,1,1,1,1,1,1,1,1,1,1,1,1,1,191,80,20,11,347975206,7250,7250,6050,North_African__Middle_Eastern,150,11,1991/4/5,43,0,34215.0,,12029963
575,Lucas Boyé,Elche,1996,75.0,ar ARG,FW,26.0,27.4,36.0,16.0,12.0,16.0,8.0,17.0,35.0,48.6,18.0,33.0,5.0,28.0,15.0,51.0,46.0,0.0,Matches,75.0,ar ARG,FW,26.0,27.4,75.0,2.74,51.0,0.0,12.0,5.0,5.0,2.0,7.0,0.26,5.0,0.0,0.0,1.0,0.0,1.0,Matches,,,,,,,,,,,,,,,,,,,,,,,,,,,,,,,,,,,,,,,,,,,,,,,,,,,,,,,,75.0,ar ARG,FW,26.0,27.4,7.0,1.0,0.0,61.0,45.0,14.0,15.0,15.0,16.0,0.0,0.0,0.0,104.0,49.0,57.0,46.2,Matches,75.0,ar ARG,FW,26.0,27.4,650.0,591.0,55.0,1.0,2.0,7.0,15.0,0.0,0.0,0.0,0.0,0.0,510.0,4.0,30.0,Matches,75.0,ar ARG,FW,26.0,27.4,510.0,650.0,78.5,7080.0,1364.0,292.0,338.0,86.4,140.0,169.0,82.8,32.0,39.0,82.1,2.0,2.9,1.6,-0.9,29.0,35.0,22.0,5.0,63.0,Matches,91,ar ARG,FW,26,35,2462.0,70.0,72.0,27.4,29,81.0,14,6,21.0,0,0.69,24.0,47.0,-23.0,-0.84,0.47,27.5,44.8,-17.3,-0.63,0.8,Matches,75.0,ar ARG,FW,26.0,27.4,1121.0,50.0,107.0,585.0,456.0,116.0,1120.0,130.0,78.0,60.0,48.0,36.9,720.0,3507.0,1434.0,58.0,33.0,25.0,139.0,85.0,810.0,160.0,Matches,75.0,ar ARG,FW,26.0,27.4,7.0,71.0,20.0,28.2,2.6,0.73,0.1,0.35,14.4,1.0,0.0,1.0,8.3,7.5,0.11,-1.3,-0.5,Matches,75.0,ar ARG,FW,26.0,35.0,29.0,2462.0,27.4,7.0,2.0,9.0,7.0,0.0,1.0,7.0,1.0,8.3,7.5,2.9,10.5,58.0,63.0,160.0,0.26,0.07,0.33,0.26,0.33,0.3,0.11,0.41,0.27,0.38,Matches,Lucas Boyé,AM/S RLC,26,135,140,"Argentina,Italy",Elche,9,10,16,12,13,11,14,12,6,7,10,12,7,14,11,11,10,11,10,11,9,11,15,7,12,6,15,18,15,13,15,12,12,15,13,17,10,4,9,7,10,2,3,1,3,1,3,1,3,2,3,2,11,14,6,12,7,12,14,13,1,1,1,1,1,1,1,1,1,1,15,18,15,20,183,80,10,20,6332507,6700,6200,5050,Mediterranean_Hispanic,130,1,1996/2/28,1,0,8901.0,,14110829
576,Martin Braithwaite,Espanyol,1991,76.0,dk DEN,FWMF,31.0,27.3,12.0,2.0,2.0,4.0,6.0,5.0,14.0,35.7,9.0,10.0,0.0,10.0,5.0,17.0,11.0,0.0,Matches,76.0,dk DEN,FWMF,31.0,27.3,48.0,1.76,31.0,0.0,2.0,9.0,6.0,0.0,7.0,0.26,4.0,0.0,0.0,3.0,0.0,0.0,Matches,,,,,,,,,,,,,,,,,,,,,,,,,,,,,,,,,,,,,,,,,,,,,,,,,,,,,,,,76.0,dk DEN,FWMF,31.0,27.3,5.0,1.0,0.0,20.0,42.0,13.0,20.0,5.0,2.0,0.0,0.0,0.0,58.0,48.0,59.0,44.9,Matches,76.0,dk DEN,FWMF,31.0,27.3,446.0,427.0,17.0,0.0,3.0,2.0,20.0,0.0,0.0,0.0,0.0,0.0,294.0,2.0,21.0,Matches,76.0,dk DEN,FWMF,31.0,27.3,294.0,446.0,65.9,4173.0,986.0,183.0,242.0,75.6,74.0,112.0,66.1,19.0,30.0,63.3,2.0,1.4,1.1,0.6,12.0,26.0,13.0,2.0,54.0,Matches,92,dk DEN,FWMF,31,31,2456.0,79.0,71.8,27.3,29,83.0,14,2,29.0,0,0.94,35.0,46.0,-11.0,-0.4,0.16,32.4,40.5,-8.1,-0.3,0.01,Matches,76.0,dk DEN,FWMF,31.0,27.3,696.0,10.0,55.0,287.0,362.0,75.0,696.0,53.0,17.0,32.1,26.0,49.1,410.0,2073.0,983.0,32.0,29.0,11.0,52.0,19.0,514.0,126.0,Matches,76.0,dk DEN,FWMF,31.0,27.3,10.0,58.0,25.0,43.1,2.13,0.92,0.17,0.4,16.0,4.0,0.0,0.0,9.2,9.2,0.16,0.8,0.8,Matches,76.0,dk DEN,FWMF,31.0,31.0,29.0,2456.0,27.3,10.0,2.0,12.0,10.0,0.0,0.0,5.0,1.0,9.2,9.2,1.4,10.6,32.0,54.0,126.0,0.37,0.07,0.44,0.37,0.44,0.34,0.05,0.39,0.34,0.39,Matches,Martin Braithwaite,AM/S RL,31,140,145,"Denmark,Guyana",Espanyol,8,11,12,12,12,9,11,10,4,3,11,10,5,12,12,13,13,13,15,12,13,15,14,13,15,5,16,15,14,14,12,12,14,15,14,13,12,7,14,11,13,1,2,2,1,2,3,2,3,3,3,1,14,15,6,14,12,16,15,16,1,1,1,1,1,1,1,8,1,8,18,14,18,20,177,77,12,20,347975206,7000,6950,6000,Mixed_Race,129,12,1991/6/5,60,10,20593.0,,27013113
577,Darko Brašanac,Osasuna,1992,78.0,rs SRB,MF,30.0,11.6,29.0,20.0,12.0,10.0,7.0,12.0,23.0,52.2,11.0,14.0,2.0,12.0,12.0,41.0,9.0,0.0,Matches,78.0,rs SRB,MF,30.0,11.6,22.0,1.9,20.0,0.0,0.0,1.0,1.0,0.0,1.0,0.09,1.0,0.0,0.0,0.0,0.0,0.0,Matches,,,,,,,,,,,,,,,,,,,,,,,,,,,,,,,,,,,,,,,,,,,,,,,,,,,,,,,,78.0,rs SRB,MF,30.0,11.6,5.0,0.0,0.0,16.0,14.0,3.0,7.0,12.0,20.0,0.0,1.0,0.0,50.0,15.0,15.0,50.0,Matches,78.0,rs SRB,MF,30.0,11.6,376.0,351.0,23.0,8.0,0.0,0.0,7.0,2.0,0.0,0.0,0.0,0.0,306.0,2.0,10.0,Matches,78.0,rs SRB,MF,30.0,11.6,306.0,376.0,81.4,4620.0,1215.0,162.0,179.0,90.5,118.0,143.0,82.5,11.0,19.0,57.9,1.0,0.6,0.6,0.4,7.0,40.0,7.0,2.0,49.0,Matches,94,rs SRB,MF,30,25,1041.0,42.0,30.4,11.6,9,74.0,3,16,23.0,2,1.36,11.0,14.0,-3.0,-0.26,-0.18,11.9,14.5,-2.6,-0.23,-0.1,Matches,78.0,rs SRB,MF,30.0,11.6,489.0,12.0,79.0,245.0,171.0,28.0,489.0,10.0,4.0,40.0,3.0,30.0,246.0,1254.0,668.0,18.0,14.0,0.0,20.0,10.0,292.0,36.0,Matches,78.0,rs SRB,MF,30.0,11.6,1.0,11.0,4.0,36.4,0.95,0.35,0.09,0.25,12.4,0.0,0.0,0.0,1.2,1.2,0.1,-0.2,-0.2,Matches,78.0,rs SRB,MF,30.0,25.0,9.0,1041.0,11.6,1.0,1.0,2.0,1.0,0.0,0.0,5.0,0.0,1.2,1.2,0.6,1.8,18.0,49.0,36.0,0.09,0.09,0.17,0.09,0.17,0.1,0.05,0.15,0.1,0.15,Matches,Darko Brašanac,M/AM C,30,135,139,Serbia,Atlético Pamplona,10,11,9,12,13,10,13,11,7,11,13,11,13,13,14,15,16,11,16,13,12,12,11,10,14,14,17,16,13,13,12,12,12,12,15,11,14,8,13,7,14,2,1,1,2,1,2,3,2,2,2,3,11,13,8,9,13,9,10,13,1,1,1,1,1,1,14,1,20,1,12,16,1,1,178,73,12,20,1848916,6494,5958,4531,Northern_European,134,4,1992/2/12,3,0,9921.0,,62039552
578,Claudio Bravo,Betis,1983,79.0,cl CHI,GK,39.0,12.0,0.0,0.0,0.0,0.0,0.0,0.0,0.0,,0.0,0.0,0.0,0.0,2.0,2.0,1.0,1.0,Matches,79.0,cl CHI,GK,39.0,12.0,3.0,0.25,1.0,2.0,0.0,0.0,0.0,0.0,0.0,0.0,0.0,0.0,0.0,0.0,0.0,0.0,Matches,6.0,cl CHI,GK,39.0,12.0,9.0,1.0,0.0,1.0,0.0,11.0,0.24,2.0,0.17,75.0,225.0,33.3,288.0,42.0,51.7,39.6,101.0,75.2,52.5,213.0,4.0,1.9,6.0,0.5,12.1,Matches,6.0,cl CHI,GK,39.0,12.0,12.0,1080.0,12.0,9.0,0.75,42.0,33.0,81.0,5.0,5.0,2.0,4.0,33.3,1.0,1.0,0.0,0.0,0.0,Matches,79.0,cl CHI,GK,39.0,12.0,2.0,0.0,0.0,0.0,0.0,0.0,0.0,2.0,0.0,0.0,0.0,0.0,14.0,3.0,0.0,100.0,Matches,79.0,cl CHI,GK,39.0,12.0,392.0,241.0,148.0,47.0,0.0,2.0,0.0,0.0,0.0,0.0,0.0,0.0,232.0,3.0,0.0,Matches,79.0,cl CHI,GK,39.0,12.0,232.0,392.0,59.2,7419.0,5674.0,44.0,44.0,100.0,89.0,91.0,97.8,96.0,251.0,38.2,0.0,0.0,0.0,0.0,0.0,5.0,1.0,0.0,1.0,Matches,95,cl CHI,GK,39,12,1080.0,90.0,31.6,12.0,12,90.0,12,0,,21,1.67,13.0,9.0,4.0,0.33,0.29,16.8,14.9,1.9,0.16,0.18,Matches,79.0,cl CHI,GK,39.0,12.0,414.0,333.0,412.0,3.0,0.0,0.0,414.0,0.0,0.0,,0.0,,208.0,1175.0,724.0,0.0,0.0,0.0,0.0,0.0,144.0,0.0,Matches,79.0,cl CHI,GK,39.0,12.0,0.0,0.0,0.0,,0.0,0.0,,,,0.0,0.0,0.0,0.0,0.0,,0.0,0.0,Matches,79.0,cl CHI,GK,39.0,12.0,12.0,1080.0,12.0,0.0,0.0,0.0,0.0,0.0,0.0,2.0,0.0,0.0,0.0,0.0,0.0,0.0,1.0,0.0,0.0,0.0,0.0,0.0,0.0,0.0,0.0,0.0,0.0,0.0,Matches,Claudio Bravo,GK,39,143,167,"Chile,Spain",Real Hispalis,3,3,9,1,13,7,6,1,2,2,15,8,3,14,12,13,15,13,14,15,13,14,10,16,4,13,16,7,11,12,11,11,16,13,13,12,13,8,10,13,13,12,14,15,10,16,16,12,12,11,10,14,12,14,9,17,8,17,13,12,20,1,1,1,1,1,1,1,1,1,1,1,1,1,184,84,8,20,1007571,7150,7500,6150,Mediterranean_Hispanic,143,9,1983/4/13,143,0,27253.0,,5251774
579,Ante Budimir,Osasuna,1991,80.0,hr CRO,FW,31.0,20.0,19.0,9.0,0.0,12.0,7.0,2.0,10.0,20.0,8.0,10.0,0.0,10.0,5.0,24.0,19.0,0.0,Matches,80.0,hr CRO,FW,31.0,20.0,34.0,1.7,21.0,0.0,6.0,3.0,3.0,1.0,1.0,0.05,0.0,0.0,0.0,0.0,1.0,0.0,Matches,,,,,,,,,,,,,,,,,,,,,,,,,,,,,,,,,,,,,,,,,,,,,,,,,,,,,,,,80.0,hr CRO,FW,31.0,20.0,5.0,0.0,0.0,48.0,23.0,12.0,3.0,5.0,9.0,1.0,0.0,0.0,37.0,97.0,104.0,48.3,Matches,80.0,hr CRO,FW,31.0,20.0,315.0,300.0,15.0,0.0,1.0,0.0,3.0,2.0,0.0,0.0,0.0,0.0,194.0,0.0,7.0,Matches,80.0,hr CRO,FW,31.0,20.0,194.0,315.0,61.6,2324.0,372.0,123.0,172.0,71.5,55.0,97.0,56.7,1.0,7.0,14.3,0.0,0.7,0.6,-0.7,10.0,13.0,3.0,0.0,23.0,Matches,97,hr CRO,FW,31,31,1798.0,58.0,52.6,20.0,22,73.0,3,9,20.0,6,1.48,22.0,19.0,3.0,0.15,0.59,22.6,22.0,0.6,0.03,0.39,Matches,80.0,hr CRO,FW,31.0,20.0,563.0,18.0,36.0,254.0,281.0,118.0,563.0,34.0,16.0,47.1,14.0,41.2,259.0,1199.0,449.0,23.0,16.0,10.0,62.0,27.0,398.0,98.0,Matches,80.0,hr CRO,FW,31.0,20.0,8.0,58.0,21.0,36.2,2.9,1.05,0.14,0.38,11.6,0.0,0.0,0.0,7.6,7.6,0.13,0.4,0.4,Matches,80.0,hr CRO,FW,31.0,31.0,22.0,1798.0,20.0,8.0,0.0,8.0,8.0,0.0,0.0,5.0,0.0,7.6,7.6,0.7,8.3,23.0,23.0,98.0,0.4,0.0,0.4,0.4,0.4,0.38,0.03,0.41,0.38,0.41,Matches,Ante Budimir,S,31,135,142,Croatia,Atlético Pamplona,6,8,10,15,11,4,17,10,3,7,12,16,12,12,13,16,14,14,13,10,13,16,13,5,16,12,14,14,11,11,15,16,15,12,14,18,14,8,12,7,8,2,3,2,1,3,3,1,1,3,4,2,11,13,7,8,10,13,12,12,1,1,1,1,1,1,1,1,1,1,7,1,7,20,190,75,20,8,347975206,6600,6700,4500,Northern_European,134,3,1991/7/22,14,1,11901.0,,24003746
580,Santiago Bueno,Girona,1998,81.0,uy URU,DF,23.0,33.4,63.0,38.0,43.0,19.0,1.0,24.0,36.0,66.7,12.0,34.0,22.0,12.0,31.0,94.0,105.0,2.0,Matches,81.0,uy URU,DF,23.0,33.4,24.0,0.72,18.0,0.0,1.0,3.0,2.0,0.0,4.0,0.12,3.0,0.0,0.0,0.0,1.0,0.0,Matches,,,,,,,,,,,,,,,,,,,,,,,,,,,,,,,,,,,,,,,,,,,,,,,,,,,,,,,,81.0,uy URU,DF,23.0,33.4,7.0,1.0,1.0,37.0,34.0,2.0,4.0,31.0,38.0,2.0,1.0,0.0,144.0,74.0,41.0,64.3,Matches,81.0,uy URU,DF,23.0,33.4,1823.0,1732.0,87.0,70.0,1.0,25.0,4.0,17.0,0.0,0.0,0.0,0.0,1576.0,4.0,15.0,Matches,81.0,uy URU,DF,23.0,33.4,1576.0,1823.0,86.5,31141.0,10648.0,509.0,557.0,91.4,875.0,940.0,93.1,173.0,279.0,62.0,1.0,1.0,0.7,0.0,9.0,148.0,5.0,1.0,148.0,Matches,98,uy URU,DF,23,34,3010.0,89.0,88.0,33.4,34,89.0,32,0,,0,1.44,55.0,48.0,7.0,0.21,1.09,45.5,45.9,-0.3,-0.01,0.85,Matches,81.0,uy URU,DF,23.0,33.4,2098.0,194.0,1016.0,1038.0,54.0,17.0,2098.0,4.0,2.0,50.0,0.0,0.0,1305.0,7395.0,4721.0,30.0,13.0,0.0,6.0,1.0,1447.0,4.0,Matches,81.0,uy URU,DF,23.0,33.4,0.0,13.0,3.0,23.1,0.39,0.09,0.0,0.0,12.2,0.0,0.0,0.0,1.3,1.3,0.1,-1.3,-1.3,Matches,81.0,uy URU,DF,23.0,34.0,34.0,3010.0,33.4,0.0,1.0,1.0,0.0,0.0,0.0,7.0,1.0,1.3,1.3,1.0,2.3,30.0,148.0,4.0,0.0,0.03,0.03,0.0,0.03,0.04,0.03,0.07,0.04,0.07,Matches,Santiago Bueno,D C,23,127,143,"Uruguay,Italy",Girona,4,7,8,7,12,5,14,9,8,14,12,8,14,10,14,14,13,12,14,9,13,13,7,6,6,14,14,13,11,11,12,14,11,13,14,13,12,13,9,11,5,2,3,2,1,1,1,2,1,1,2,2,15,12,5,9,12,13,13,15,1,1,20,1,1,1,5,1,1,1,1,1,1,1,186,71,12,20,3091343,6250,5750,4251,Mediterranean_Hispanic,127,6,1998/11/9,0,0,3320.0,,78076996
581,Sergio Busquets,Barcelona,1988,82.0,es ESP,MF,34.0,26.0,58.0,26.0,24.0,26.0,8.0,29.0,51.0,56.9,22.0,32.0,6.0,26.0,27.0,85.0,36.0,2.0,Matches,82.0,es ESP,MF,34.0,26.0,74.0,2.85,68.0,0.0,0.0,1.0,4.0,1.0,6.0,0.23,6.0,0.0,0.0,0.0,0.0,0.0,Matches,,,,,,,,,,,,,,,,,,,,,,,,,,,,,,,,,,,,,,,,,,,,,,,,,,,,,,,,82.0,es ESP,MF,34.0,26.0,8.0,1.0,1.0,31.0,40.0,0.0,7.0,27.0,26.0,0.0,0.0,0.0,187.0,53.0,59.0,47.3,Matches,82.0,es ESP,MF,34.0,26.0,1949.0,1870.0,74.0,71.0,15.0,5.0,7.0,3.0,0.0,0.0,0.0,0.0,1722.0,5.0,17.0,Matches,82.0,es ESP,MF,34.0,26.0,1722.0,1949.0,88.4,30610.0,9017.0,756.0,825.0,91.6,745.0,822.0,90.6,183.0,222.0,82.4,4.0,2.8,3.7,1.2,25.0,230.0,33.0,3.0,254.0,Matches,99,es ESP,MF,34,30,2339.0,78.0,68.4,26.0,28,81.0,17,2,30.0,4,2.43,41.0,11.0,30.0,1.15,-0.51,49.4,22.6,26.8,1.03,-0.25,Matches,82.0,es ESP,MF,34.0,26.0,2172.0,62.0,387.0,1427.0,373.0,14.0,2172.0,16.0,11.0,68.8,3.0,18.8,1279.0,5074.0,2594.0,26.0,32.0,1.0,19.0,12.0,1551.0,32.0,Matches,82.0,es ESP,MF,34.0,26.0,0.0,9.0,2.0,22.2,0.35,0.08,0.0,0.0,23.5,0.0,0.0,0.0,0.4,0.4,0.05,-0.4,-0.4,Matches,82.0,es ESP,MF,34.0,30.0,28.0,2339.0,26.0,0.0,4.0,4.0,0.0,0.0,0.0,8.0,1.0,0.4,0.4,2.8,3.3,26.0,254.0,32.0,0.0,0.15,0.15,0.0,0.15,0.02,0.11,0.13,0.02,0.13,Matches,Sergio Busquets,DM/M C,34,157,171,Spain,Barcelona,8,11,12,8,16,8,11,9,8,15,17,10,15,16,12,19,12,18,18,16,18,16,9,13,10,17,19,15,10,10,11,14,15,11,12,11,16,13,14,5,13,1,1,3,3,1,2,3,1,3,2,3,15,14,7,18,14,14,6,9,1,1,8,1,1,1,20,1,18,1,1,1,1,1,189,76,12,20,22162801,7850,7850,7500,Mediterranean_Hispanic,156,6,1988/7/16,137,2,230768.0,,1510566
582,Leandro Cabrera,Espanyol,1991,83.0,uy URU,DF,31.0,29.7,46.0,24.0,34.0,12.0,0.0,28.0,43.0,65.1,15.0,37.0,23.0,14.0,43.0,89.0,114.0,2.0,Matches,83.0,uy URU,DF,31.0,29.7,35.0,1.18,26.0,3.0,0.0,6.0,0.0,0.0,3.0,0.1,3.0,0.0,0.0,0.0,0.0,0.0,Matches,,,,,,,,,,,,,,,,,,,,,,,,,,,,,,,,,,,,,,,,,,,,,,,,,,,,,,,,83.0,uy URU,DF,31.0,29.7,10.0,2.0,1.0,29.0,20.0,1.0,14.0,43.0,24.0,0.0,1.0,1.0,138.0,62.0,37.0,62.6,Matches,83.0,uy URU,DF,31.0,29.7,1343.0,1183.0,147.0,64.0,1.0,10.0,14.0,83.0,0.0,0.0,0.0,0.0,959.0,13.0,12.0,Matches,83.0,uy URU,DF,31.0,29.7,959.0,1343.0,71.4,19673.0,9222.0,307.0,368.0,83.4,502.0,614.0,81.8,137.0,314.0,43.6,1.0,1.5,1.3,-0.5,14.0,87.0,12.0,4.0,95.0,Matches,100,uy URU,DF,31,32,2669.0,83.0,78.0,29.7,31,86.0,27,1,1.0,2,1.03,40.0,54.0,-14.0,-0.47,-0.11,38.5,45.0,-6.5,-0.22,0.38,Matches,83.0,uy URU,DF,31.0,29.7,1642.0,198.0,723.0,802.0,125.0,40.0,1642.0,9.0,6.0,66.7,2.0,22.2,763.0,3158.0,1406.0,13.0,9.0,1.0,9.0,5.0,893.0,8.0,Matches,83.0,uy URU,DF,31.0,29.7,0.0,23.0,6.0,26.1,0.78,0.2,0.0,0.0,11.2,0.0,0.0,0.0,2.3,2.3,0.1,-2.3,-2.3,Matches,83.0,uy URU,DF,31.0,32.0,31.0,2669.0,29.7,0.0,1.0,1.0,0.0,0.0,0.0,10.0,2.0,2.3,2.3,1.5,3.7,13.0,95.0,8.0,0.0,0.03,0.03,0.0,0.03,0.08,0.05,0.13,0.08,0.13,Matches,Leandro Cabrera,D LC,31,136,145,"Uruguay,Spain",Espanyol,4,8,6,4,8,7,13,8,18,15,8,5,15,8,16,12,18,11,16,9,12,18,6,14,8,15,18,18,10,10,9,16,9,14,14,16,17,14,8,11,15,1,1,3,3,3,1,2,1,2,3,1,16,14,4,7,13,17,7,6,1,15,20,1,14,1,1,1,1,1,1,1,1,1,188,82,20,10,347975206,6700,6250,5300,Mediterranean_Hispanic,134,4,1991/6/17,0,0,14410.0,,78027200
583,Fernando Calero,Espanyol,1995,85.0,es ESP,DFMF,26.0,17.9,46.0,29.0,27.0,15.0,4.0,21.0,34.0,61.8,13.0,31.0,13.0,18.0,13.0,59.0,52.0,0.0,Matches,85.0,es ESP,DFMF,26.0,17.9,22.0,1.23,20.0,0.0,0.0,1.0,0.0,1.0,4.0,0.22,2.0,0.0,0.0,1.0,0.0,1.0,Matches,,,,,,,,,,,,,,,,,,,,,,,,,,,,,,,,,,,,,,,,,,,,,,,,,,,,,,,,85.0,es ESP,DFMF,26.0,17.9,6.0,0.0,0.0,22.0,9.0,1.0,4.0,13.0,29.0,0.0,0.0,0.0,86.0,35.0,29.0,54.7,Matches,85.0,es ESP,DFMF,26.0,17.9,765.0,691.0,72.0,29.0,0.0,11.0,4.0,41.0,0.0,0.0,0.0,0.0,617.0,2.0,5.0,Matches,85.0,es ESP,DFMF,26.0,17.9,617.0,765.0,80.7,11710.0,4547.0,245.0,275.0,89.1,289.0,335.0,86.3,78.0,139.0,56.1,1.0,0.6,0.4,0.4,4.0,58.0,3.0,0.0,64.0,Matches,102,es ESP,DFMF,26,27,1611.0,60.0,47.1,17.9,20,73.0,7,7,23.0,9,1.07,21.0,29.0,-8.0,-0.45,0.0,21.8,25.7,-3.8,-0.21,0.17,Matches,85.0,es ESP,DFMF,26.0,17.9,944.0,83.0,377.0,499.0,77.0,14.0,944.0,3.0,1.0,33.3,2.0,66.7,454.0,1933.0,951.0,9.0,8.0,1.0,12.0,6.0,518.0,4.0,Matches,85.0,es ESP,DFMF,26.0,17.9,0.0,7.0,2.0,28.6,0.39,0.11,0.0,0.0,9.1,0.0,0.0,0.0,0.7,0.7,0.1,-0.7,-0.7,Matches,85.0,es ESP,DFMF,26.0,27.0,20.0,1611.0,17.9,0.0,1.0,1.0,0.0,0.0,0.0,6.0,0.0,0.7,0.7,0.6,1.3,9.0,64.0,4.0,0.0,0.06,0.06,0.0,0.06,0.04,0.03,0.07,0.04,0.07,Matches,Fernando Calero,D C,26,129,145,Spain,Espanyol,7,6,5,5,14,9,13,11,10,14,13,9,14,13,10,14,14,12,12,13,12,12,11,12,10,14,15,14,13,12,12,11,11,14,13,13,13,7,12,10,11,1,1,3,2,3,1,1,3,3,1,2,15,11,1,12,10,11,10,19,1,1,20,1,1,1,1,1,1,1,1,1,1,1,183,71,10,20,4363492,6450,6450,4950,Mediterranean_Hispanic,129,8,1995/9/14,0,0,9641.0,,67211739
584,Eduardo Camavinga,Real Madrid,2002,87.0,fr FRA,MFDF,19.0,22.3,68.0,48.0,32.0,21.0,15.0,24.0,64.0,37.5,40.0,24.0,5.0,19.0,17.0,85.0,25.0,0.0,Matches,87.0,fr FRA,MFDF,19.0,22.3,72.0,3.23,55.0,0.0,5.0,3.0,9.0,0.0,5.0,0.22,3.0,0.0,0.0,1.0,1.0,0.0,Matches,,,,,,,,,,,,,,,,,,,,,,,,,,,,,,,,,,,,,,,,,,,,,,,,,,,,,,,,87.0,fr FRA,MFDF,19.0,22.3,6.0,0.0,0.0,39.0,69.0,3.0,6.0,17.0,48.0,0.0,0.0,0.0,136.0,22.0,11.0,66.7,Matches,87.0,fr FRA,MFDF,19.0,22.3,1504.0,1389.0,107.0,34.0,4.0,6.0,6.0,73.0,0.0,0.0,0.0,0.0,1364.0,8.0,15.0,Matches,87.0,fr FRA,MFDF,19.0,22.3,1364.0,1504.0,90.7,21221.0,5654.0,711.0,763.0,93.2,517.0,548.0,94.3,89.0,112.0,79.5,1.0,1.5,2.2,-0.5,24.0,138.0,17.0,1.0,165.0,Matches,105,fr FRA,MFDF,19,37,2010.0,54.0,58.8,22.3,21,78.0,11,16,23.0,0,2.11,51.0,16.0,35.0,1.57,1.31,47.6,20.8,26.8,1.2,0.58,Matches,87.0,fr FRA,MFDF,19.0,22.3,1770.0,51.0,372.0,942.0,485.0,39.0,1770.0,71.0,38.0,53.5,25.0,35.2,1162.0,6589.0,3684.0,69.0,77.0,12.0,39.0,28.0,1326.0,99.0,Matches,87.0,fr FRA,MFDF,19.0,22.3,0.0,18.0,3.0,16.7,0.81,0.13,0.0,0.0,23.2,0.0,0.0,0.0,0.8,0.8,0.04,-0.8,-0.8,Matches,87.0,fr FRA,MFDF,19.0,37.0,21.0,2010.0,22.3,0.0,1.0,1.0,0.0,0.0,0.0,6.0,0.0,0.8,0.8,1.5,2.3,69.0,165.0,99.0,0.0,0.04,0.04,0.0,0.04,0.04,0.07,0.1,0.04,0.1,Matches,Eduardo Camavinga,DM/M C,19,147,180,"France,Congo",R. Madrid,6,8,12,10,14,6,11,9,4,14,14,7,15,15,15,15,14,14,13,13,14,15,12,12,13,15,14,16,14,14,14,11,14,14,15,16,15,9,15,5,11,1,3,2,2,3,1,2,2,1,1,3,13,13,5,14,16,15,13,17,1,1,1,1,1,1,18,1,20,1,1,1,1,1,182,68,20,10,78600001,7350,6800,7000,African_Caribbean,145,16,2002/11/10,3,1,148675.0,,49056243
585,Sergio Camello,Rayo Vallecano,2001,88.0,es ESP,FW,21.0,26.7,16.0,10.0,3.0,9.0,4.0,5.0,17.0,29.4,12.0,9.0,1.0,8.0,2.0,18.0,26.0,0.0,Matches,88.0,es ESP,FW,21.0,26.7,62.0,2.32,49.0,1.0,6.0,2.0,4.0,0.0,7.0,0.26,5.0,0.0,1.0,1.0,0.0,0.0,Matches,,,,,,,,,,,,,,,,,,,,,,,,,,,,,,,,,,,,,,,,,,,,,,,,,,,,,,,,88.0,es ESP,FW,21.0,26.7,1.0,0.0,0.0,12.0,19.0,11.0,4.0,2.0,10.0,0.0,0.0,0.0,63.0,27.0,49.0,35.5,Matches,88.0,es ESP,FW,21.0,26.7,523.0,475.0,46.0,2.0,1.0,0.0,4.0,4.0,0.0,0.0,0.0,0.0,408.0,2.0,10.0,Matches,88.0,es ESP,FW,21.0,26.7,408.0,523.0,78.0,5782.0,733.0,235.0,285.0,82.5,126.0,156.0,80.8,20.0,28.0,71.4,5.0,2.4,1.7,2.6,28.0,15.0,13.0,0.0,42.0,Matches,106,es ESP,FW,21,38,2401.0,63.0,70.2,26.7,27,78.0,4,11,26.0,0,1.29,36.0,38.0,-2.0,-0.07,0.45,31.7,36.7,-4.9,-0.19,-0.06,Matches,88.0,es ESP,FW,21.0,26.7,782.0,29.0,51.0,337.0,406.0,101.0,782.0,46.0,18.0,39.1,24.0,52.2,483.0,2631.0,1053.0,40.0,36.0,17.0,71.0,35.0,561.0,122.0,Matches,88.0,es ESP,FW,21.0,26.7,6.0,76.0,19.0,25.0,2.85,0.71,0.08,0.32,16.0,0.0,0.0,0.0,7.3,7.3,0.1,-1.3,-1.3,Matches,88.0,es ESP,FW,21.0,38.0,27.0,2401.0,26.7,6.0,5.0,11.0,6.0,0.0,0.0,1.0,0.0,7.3,7.3,2.4,9.6,40.0,42.0,122.0,0.22,0.19,0.41,0.22,0.41,0.27,0.09,0.36,0.27,0.36,Matches,Sergio Camello,S,21,127,154,Spain,A. Madrid,7,8,12,16,14,7,11,9,7,8,11,15,9,12,8,13,11,14,13,12,12,16,13,8,14,15,12,12,13,12,11,9,10,13,13,12,11,5,16,9,16,1,1,3,1,3,3,1,2,3,1,1,15,8,8,13,11,11,11,11,1,1,1,1,1,1,1,1,1,1,1,1,1,20,177,69,12,20,10305000,6348,6348,4348,Mediterranean_Hispanic,126,4,2001/2/10,0,0,9843.0,Vallecano,67272502
586,Sergio Canales,Betis,1991,89.0,es ESP,FWMF,31.0,26.7,25.0,14.0,10.0,8.0,7.0,14.0,33.0,42.4,19.0,18.0,0.0,18.0,14.0,39.0,8.0,0.0,Matches,89.0,es ESP,FWMF,31.0,26.7,111.0,4.16,85.0,16.0,3.0,3.0,3.0,1.0,8.0,0.3,5.0,2.0,0.0,1.0,0.0,0.0,Matches,,,,,,,,,,,,,,,,,,,,,,,,,,,,,,,,,,,,,,,,,,,,,,,,,,,,,,,,89.0,es ESP,FWMF,31.0,26.7,4.0,2.0,1.0,9.0,32.0,4.0,135.0,14.0,14.0,0.0,0.0,0.0,121.0,13.0,24.0,35.1,Matches,89.0,es ESP,FWMF,31.0,26.7,1474.0,1324.0,134.0,51.0,13.0,14.0,135.0,7.0,72.0,24.0,36.0,1.0,1116.0,16.0,53.0,Matches,89.0,es ESP,FWMF,31.0,26.7,1116.0,1474.0,75.7,16689.0,4491.0,623.0,697.0,89.4,319.0,407.0,78.4,99.0,211.0,46.9,3.0,5.6,5.1,-2.6,56.0,94.0,51.0,14.0,143.0,Matches,107,es ESP,FWMF,31,31,2402.0,77.0,70.2,26.7,28,82.0,14,3,40.0,0,1.52,31.0,28.0,3.0,0.11,-0.06,32.6,34.7,-2.1,-0.08,-0.38,Matches,89.0,es ESP,FWMF,31.0,26.7,1677.0,13.0,180.0,745.0,781.0,54.0,1676.0,54.0,28.0,51.9,19.0,35.2,1051.0,6475.0,3161.0,82.0,69.0,5.0,55.0,41.0,1275.0,150.0,Matches,89.0,es ESP,FWMF,31.0,26.7,4.0,38.0,10.0,26.3,1.42,0.37,0.08,0.3,22.8,6.0,1.0,1.0,4.3,3.5,0.09,-0.3,-0.5,Matches,89.0,es ESP,FWMF,31.0,31.0,28.0,2402.0,26.7,4.0,3.0,7.0,3.0,1.0,1.0,4.0,2.0,4.3,3.5,5.6,9.1,82.0,143.0,150.0,0.15,0.11,0.26,0.11,0.22,0.16,0.21,0.37,0.13,0.34,Matches,Sergio Canales,M/AM C,31,157,160,Spain,Real Hispalis,14,13,16,14,17,14,8,14,10,7,17,13,8,17,7,16,11,15,14,17,15,12,16,14,16,10,15,14,15,15,15,8,12,13,13,12,15,6,15,12,13,2,3,3,2,1,1,3,1,2,3,3,11,13,7,14,12,17,16,14,1,1,1,1,1,1,12,1,19,1,14,20,13,5,180,64,20,8,347975206,7600,7600,6700,Mediterranean_Hispanic,159,5,1991/2/16,10,1,31256.0,,67053076
587,Étienne Capoue,Villarreal,1988,91.0,fr FRA,MF,34.0,21.7,21.0,12.0,6.0,13.0,2.0,10.0,18.0,55.6,8.0,12.0,5.0,7.0,19.0,40.0,20.0,1.0,Matches,91.0,fr FRA,MF,34.0,21.7,46.0,2.12,33.0,1.0,2.0,4.0,4.0,2.0,4.0,0.18,3.0,0.0,0.0,1.0,0.0,0.0,Matches,,,,,,,,,,,,,,,,,,,,,,,,,,,,,,,,,,,,,,,,,,,,,,,,,,,,,,,,91.0,fr FRA,MF,34.0,21.7,4.0,0.0,0.0,18.0,41.0,0.0,9.0,19.0,12.0,0.0,0.0,0.0,113.0,25.0,19.0,56.8,Matches,91.0,fr FRA,MF,34.0,21.7,1043.0,1016.0,27.0,23.0,6.0,6.0,9.0,3.0,0.0,0.0,0.0,0.0,915.0,0.0,15.0,Matches,91.0,fr FRA,MF,34.0,21.7,915.0,1043.0,87.7,14387.0,3476.0,469.0,516.0,90.9,362.0,393.0,92.1,52.0,78.0,66.7,0.0,1.2,1.0,-1.2,10.0,115.0,8.0,1.0,98.0,Matches,110,fr FRA,MF,34,28,1955.0,70.0,57.2,21.7,22,82.0,12,6,25.0,1,1.5,33.0,26.0,7.0,0.32,-0.41,35.1,26.5,8.6,0.4,0.2,Matches,91.0,fr FRA,MF,34.0,21.7,1211.0,40.0,199.0,726.0,301.0,24.0,1211.0,62.0,31.0,50.0,22.0,35.5,782.0,4150.0,2035.0,45.0,27.0,10.0,26.0,13.0,948.0,72.0,Matches,91.0,fr FRA,MF,34.0,21.7,3.0,26.0,12.0,46.2,1.2,0.55,0.12,0.25,20.9,1.0,0.0,0.0,2.6,2.6,0.11,0.4,0.4,Matches,91.0,fr FRA,MF,34.0,28.0,22.0,1955.0,21.7,3.0,0.0,3.0,3.0,0.0,0.0,4.0,0.0,2.6,2.6,1.2,3.8,45.0,98.0,72.0,0.14,0.0,0.14,0.14,0.14,0.12,0.06,0.18,0.12,0.18,Matches,Étienne Capoue,DM/M C,34,146,148,"France,Guadeloupe",Villarreal,5,9,12,9,16,8,14,8,7,14,15,10,16,15,14,13,14,15,15,14,14,11,12,10,15,15,15,16,11,13,16,13,16,13,16,16,13,13,15,8,10,3,2,2,2,1,2,1,1,2,3,1,8,10,13,12,8,5,14,10,1,1,7,12,1,12,20,7,20,7,1,4,1,1,189,80,8,20,347975206,7300,6750,5800,African_Caribbean,148,13,1988/7/11,7,1,35606.0,,8448716
588,Juan Carlos,Girona,1988,93.0,es ESP,GK,34.0,10.0,0.0,0.0,0.0,0.0,0.0,0.0,0.0,,0.0,0.0,0.0,0.0,1.0,1.0,7.0,1.0,Matches,93.0,es ESP,GK,34.0,10.0,0.0,0.0,0.0,0.0,0.0,0.0,0.0,0.0,0.0,0.0,0.0,0.0,0.0,0.0,0.0,0.0,Matches,7.0,es ESP,GK,34.0,10.0,18.0,2.0,2.0,1.0,0.0,16.7,0.35,-1.3,-0.13,23.0,64.0,35.9,278.0,51.0,17.6,28.7,62.0,24.2,30.3,120.0,6.0,5.0,21.0,2.1,16.9,Matches,7.0,es ESP,GK,34.0,10.0,10.0,900.0,10.0,18.0,1.8,43.0,25.0,62.8,2.0,2.0,6.0,0.0,0.0,2.0,2.0,0.0,0.0,0.0,Matches,93.0,es ESP,GK,34.0,10.0,0.0,0.0,0.0,0.0,0.0,0.0,0.0,1.0,0.0,0.0,0.0,0.0,16.0,1.0,0.0,100.0,Matches,93.0,es ESP,GK,34.0,10.0,340.0,265.0,75.0,13.0,0.0,0.0,0.0,0.0,0.0,0.0,0.0,0.0,288.0,0.0,0.0,Matches,93.0,es ESP,GK,34.0,10.0,288.0,340.0,84.7,7160.0,4635.0,52.0,53.0,98.1,170.0,176.0,96.6,66.0,111.0,59.5,0.0,0.0,0.0,0.0,0.0,1.0,0.0,0.0,0.0,Matches,113,es ESP,GK,34,10,900.0,90.0,26.3,10.0,10,90.0,10,0,,28,0.8,14.0,18.0,-4.0,-0.4,-0.65,13.5,12.8,0.7,0.07,0.24,Matches,93.0,es ESP,GK,34.0,10.0,356.0,324.0,355.0,1.0,0.0,0.0,356.0,0.0,0.0,,0.0,,212.0,903.0,476.0,0.0,0.0,0.0,0.0,0.0,188.0,0.0,Matches,93.0,es ESP,GK,34.0,10.0,0.0,0.0,0.0,,0.0,0.0,,,,0.0,0.0,0.0,0.0,0.0,,0.0,0.0,Matches,93.0,es ESP,GK,34.0,10.0,10.0,900.0,10.0,0.0,0.0,0.0,0.0,0.0,0.0,0.0,0.0,0.0,0.0,0.0,0.0,0.0,0.0,0.0,0.0,0.0,0.0,0.0,0.0,0.0,0.0,0.0,0.0,0.0,Matches,Juan Carlos,GK,34,131,135,Spain,Girona,4,2,3,3,12,7,2,1,2,3,13,2,1,9,2,12,9,12,14,9,11,2,5,5,5,12,12,11,13,14,13,13,13,11,12,13,12,4,10,8,12,14,13,13,6,15,13,14,16,13,14,13,7,11,3,9,11,12,13,16,20,1,1,1,1,1,1,1,1,1,1,1,1,1,187,82,5,20,892410,6400,6400,4000,Mediterranean_Hispanic,129,6,1988/1/20,0,0,4245.0,,67039108
589,Yannick Carrasco,Atlético Madrid,1993,98.0,be BEL,DFMF,28.0,25.7,35.0,14.0,21.0,10.0,4.0,23.0,54.0,42.6,31.0,23.0,1.0,22.0,12.0,47.0,19.0,0.0,Matches,98.0,be BEL,DFMF,28.0,25.7,97.0,3.77,59.0,14.0,14.0,8.0,2.0,0.0,9.0,0.35,4.0,2.0,1.0,2.0,0.0,0.0,Matches,,,,,,,,,,,,,,,,,,,,,,,,,,,,,,,,,,,,,,,,,,,,,,,,,,,,,,,,98.0,be BEL,DFMF,28.0,25.7,2.0,0.0,0.0,24.0,21.0,6.0,107.0,12.0,14.0,0.0,0.0,0.0,134.0,5.0,9.0,35.7,Matches,98.0,be BEL,DFMF,28.0,25.7,1091.0,929.0,156.0,27.0,4.0,7.0,107.0,66.0,63.0,37.0,9.0,0.0,863.0,6.0,31.0,Matches,98.0,be BEL,DFMF,28.0,25.7,863.0,1091.0,79.1,11833.0,3379.0,565.0,612.0,92.3,210.0,277.0,75.8,42.0,97.0,43.3,3.0,4.1,4.1,-1.1,47.0,35.0,36.0,7.0,84.0,Matches,118,be BEL,DFMF,28,35,2317.0,66.0,67.7,25.7,26,77.0,7,9,36.0,1,2.06,43.0,25.0,18.0,0.7,-0.85,42.1,31.3,10.9,0.42,-0.38,Matches,98.0,be BEL,DFMF,28.0,25.7,1404.0,32.0,230.0,456.0,745.0,160.0,1403.0,124.0,60.0,48.4,51.0,41.1,822.0,6278.0,3577.0,146.0,58.0,71.0,52.0,34.0,922.0,264.0,Matches,98.0,be BEL,DFMF,28.0,25.7,7.0,66.0,21.0,31.8,2.56,0.82,0.09,0.29,17.2,2.0,1.0,1.0,8.0,7.2,0.11,-1.0,-1.2,Matches,98.0,be BEL,DFMF,28.0,35.0,26.0,2317.0,25.7,7.0,3.0,10.0,6.0,1.0,1.0,2.0,0.0,8.0,7.2,4.1,11.2,146.0,84.0,264.0,0.27,0.12,0.39,0.23,0.35,0.31,0.16,0.47,0.28,0.44,Matches,Yannick Carrasco,WB/M/AM RL,28,164,167,"Belgium,Spain,Portugal",A. Madrid,14,13,17,13,14,15,8,13,6,4,14,15,4,17,11,12,10,14,12,15,13,15,16,9,16,7,10,12,16,14,14,10,12,17,13,11,12,10,13,11,12,2,2,1,4,3,1,4,1,3,4,2,10,16,14,9,13,12,12,8,1,14,1,1,19,1,1,18,1,15,20,12,16,10,180,71,14,20,62700001,8100,7750,7400,Mediterranean_Hispanic,153,6,1993/9/4,57,8,164999.0,,18027198
590,Dani Carvajal,Real Madrid,1992,99.0,es ESP,DF,30.0,19.8,32.0,18.0,15.0,12.0,5.0,18.0,35.0,51.4,17.0,24.0,6.0,18.0,15.0,47.0,49.0,0.0,Matches,99.0,es ESP,DF,30.0,19.8,40.0,2.02,37.0,0.0,0.0,1.0,1.0,1.0,1.0,0.05,1.0,0.0,0.0,0.0,0.0,0.0,Matches,,,,,,,,,,,,,,,,,,,,,,,,,,,,,,,,,,,,,,,,,,,,,,,,,,,,,,,,99.0,es ESP,DF,30.0,19.8,8.0,1.0,1.0,22.0,15.0,5.0,49.0,15.0,18.0,0.0,1.0,0.0,109.0,10.0,9.0,52.6,Matches,99.0,es ESP,DF,30.0,19.8,1333.0,1185.0,146.0,15.0,2.0,10.0,49.0,131.0,0.0,0.0,0.0,0.0,1133.0,2.0,27.0,Matches,99.0,es ESP,DF,30.0,19.8,1133.0,1333.0,85.0,18356.0,4041.0,607.0,664.0,91.4,416.0,483.0,86.1,86.0,123.0,69.9,2.0,2.0,2.0,0.0,22.0,57.0,21.0,8.0,58.0,Matches,121,es ESP,DF,30,27,1784.0,66.0,52.2,19.8,20,82.0,8,7,20.0,5,1.96,38.0,22.0,16.0,0.81,-0.46,38.4,21.3,17.1,0.86,-0.21,Matches,99.0,es ESP,DF,30.0,19.8,1512.0,85.0,412.0,580.0,526.0,39.0,1512.0,17.0,9.0,52.9,5.0,29.4,864.0,3105.0,1547.0,22.0,30.0,3.0,23.0,7.0,1049.0,147.0,Matches,99.0,es ESP,DF,30.0,19.8,0.0,12.0,0.0,0.0,0.61,0.0,0.0,,17.5,0.0,0.0,0.0,0.8,0.8,0.06,-0.8,-0.8,Matches,99.0,es ESP,DF,30.0,27.0,20.0,1784.0,19.8,0.0,2.0,2.0,0.0,0.0,0.0,8.0,1.0,0.8,0.8,2.0,2.8,22.0,58.0,147.0,0.0,0.1,0.1,0.0,0.1,0.04,0.1,0.14,0.04,0.14,Matches,Dani Carvajal,D/WB R,30,152,162,Spain,R. Madrid,11,14,13,8,13,8,10,10,13,14,13,9,15,12,17,13,18,13,13,12,13,16,12,14,17,14,16,18,15,14,17,8,14,14,16,13,14,12,12,18,13,3,1,1,1,1,1,3,1,3,2,3,15,15,5,19,14,19,8,9,1,14,1,20,10,18,1,1,1,8,1,1,1,1,173,74,10,20,23822102,7592,7592,6992,Mediterranean_Hispanic,150,6,1992/1/11,29,0,178081.0,,67139735
591,William Carvalho,Betis,1992,100.0,pt POR,MF,30.0,27.1,43.0,27.0,18.0,23.0,2.0,17.0,44.0,38.6,27.0,27.0,6.0,21.0,16.0,59.0,22.0,0.0,Matches,100.0,pt POR,MF,30.0,27.1,60.0,2.19,53.0,3.0,2.0,2.0,0.0,0.0,7.0,0.26,7.0,0.0,0.0,0.0,0.0,0.0,Matches,,,,,,,,,,,,,,,,,,,,,,,,,,,,,,,,,,,,,,,,,,,,,,,,,,,,,,,,100.0,pt POR,MF,30.0,27.1,6.0,1.0,0.0,29.0,40.0,2.0,5.0,16.0,27.0,0.0,0.0,0.0,159.0,32.0,27.0,54.2,Matches,100.0,pt POR,MF,30.0,27.1,1745.0,1696.0,43.0,42.0,13.0,19.0,5.0,1.0,0.0,0.0,0.0,0.0,1510.0,6.0,20.0,Matches,100.0,pt POR,MF,30.0,27.1,1510.0,1745.0,86.5,24743.0,7482.0,786.0,859.0,91.5,525.0,599.0,87.6,148.0,194.0,76.3,1.0,1.6,2.1,-0.6,22.0,170.0,23.0,1.0,203.0,Matches,122,pt POR,MF,30,33,2438.0,74.0,71.3,27.1,31,77.0,14,2,22.0,0,1.7,34.0,24.0,10.0,0.37,0.83,37.9,32.0,5.9,0.21,0.64,Matches,100.0,pt POR,MF,30.0,27.1,1979.0,40.0,303.0,1323.0,370.0,37.0,1979.0,52.0,29.0,55.8,17.0,32.7,1276.0,5717.0,2667.0,46.0,43.0,7.0,23.0,27.0,1591.0,52.0,Matches,100.0,pt POR,MF,30.0,27.1,3.0,26.0,9.0,34.6,0.96,0.33,0.12,0.33,16.5,0.0,0.0,0.0,3.1,3.1,0.12,-0.1,-0.1,Matches,100.0,pt POR,MF,30.0,33.0,31.0,2438.0,27.1,3.0,1.0,4.0,3.0,0.0,0.0,6.0,1.0,3.1,3.1,1.6,4.7,46.0,203.0,52.0,0.11,0.04,0.15,0.11,0.15,0.11,0.06,0.17,0.11,0.17,Matches,William Carvalho,DM/M C,30,152,156,"Portugal,Angola",Real Hispalis,8,9,13,9,15,10,11,9,11,12,15,9,16,14,13,13,14,17,18,15,15,12,9,15,10,17,17,11,10,10,18,14,13,10,16,18,12,8,14,6,6,3,3,1,1,2,1,3,1,2,3,2,14,10,10,8,15,19,16,15,1,1,10,1,1,1,18,1,20,1,1,1,1,1,187,83,13,20,23154542,7400,7650,6500,African_Caribbean,148,17,1992/4/7,73,5,36638.0,,55012106
592,Valentín Castellanos,Girona,1998,102.0,ar ARG,FW,23.0,28.9,12.0,5.0,2.0,7.0,3.0,0.0,18.0,0.0,18.0,22.0,2.0,20.0,6.0,18.0,26.0,0.0,Matches,102.0,ar ARG,FW,23.0,28.9,41.0,1.42,29.0,0.0,4.0,4.0,4.0,0.0,5.0,0.17,3.0,0.0,0.0,2.0,0.0,0.0,Matches,,,,,,,,,,,,,,,,,,,,,,,,,,,,,,,,,,,,,,,,,,,,,,,,,,,,,,,,102.0,ar ARG,FW,23.0,28.9,11.0,0.0,0.0,43.0,46.0,31.0,10.0,6.0,5.0,0.0,0.0,0.0,56.0,51.0,70.0,42.1,Matches,102.0,ar ARG,FW,23.0,28.9,397.0,352.0,41.0,0.0,4.0,1.0,10.0,1.0,0.0,0.0,0.0,0.0,244.0,4.0,19.0,Matches,102.0,ar ARG,FW,23.0,28.9,244.0,397.0,61.5,3345.0,704.0,144.0,200.0,72.0,74.0,125.0,59.2,12.0,17.0,70.6,0.0,1.7,2.3,-1.7,15.0,17.0,16.0,1.0,34.0,Matches,126,ar ARG,FW,23,35,2597.0,74.0,75.9,28.9,33,77.0,8,2,22.0,0,1.29,43.0,41.0,2.0,0.07,-0.04,35.6,38.5,-2.8,-0.1,0.06,Matches,102.0,ar ARG,FW,23.0,28.9,672.0,28.0,65.0,278.0,343.0,123.0,671.0,43.0,14.0,32.6,21.0,48.8,361.0,1903.0,923.0,30.0,27.0,11.0,46.0,22.0,478.0,128.0,Matches,102.0,ar ARG,FW,23.0,28.9,13.0,85.0,32.0,37.6,2.95,1.11,0.14,0.38,15.0,0.0,1.0,1.0,11.2,10.4,0.12,1.8,1.6,Matches,102.0,ar ARG,FW,23.0,35.0,33.0,2597.0,28.9,13.0,0.0,13.0,12.0,1.0,1.0,11.0,0.0,11.2,10.4,1.7,12.1,30.0,34.0,128.0,0.45,0.0,0.45,0.42,0.42,0.39,0.06,0.45,0.36,0.42,Matches,Valentín Castellanos,S C,23,122,130,"Argentina,United States",New York City FC,10,11,14,13,14,12,12,11,8,7,11,12,7,14,6,13,9,11,10,12,11,12,15,9,13,10,10,12,13,13,11,11,12,13,14,10,13,4,12,15,8,1,4,3,1,1,2,3,1,4,1,3,12,14,7,10,10,12,11,10,1,1,1,1,1,1,1,12,10,12,14,15,14,20,178,70,10,20,5240469,6100,6100,5000,Native_American,119,10,1998/10/3,0,0,6297.0,Girona,75042244
593,Samu Castillejo,Valencia,1995,103.0,es ESP,FWMF,27.0,15.1,21.0,12.0,8.0,9.0,4.0,8.0,40.0,20.0,32.0,21.0,2.0,19.0,9.0,30.0,2.0,0.0,Matches,103.0,es ESP,FWMF,27.0,15.1,63.0,4.16,38.0,11.0,8.0,4.0,0.0,2.0,1.0,0.07,0.0,0.0,0.0,1.0,0.0,0.0,Matches,,,,,,,,,,,,,,,,,,,,,,,,,,,,,,,,,,,,,,,,,,,,,,,,,,,,,,,,103.0,es ESP,FWMF,27.0,15.1,7.0,0.0,0.0,32.0,40.0,7.0,87.0,9.0,12.0,0.0,0.0,0.0,66.0,7.0,19.0,26.9,Matches,103.0,es ESP,FWMF,27.0,15.1,622.0,551.0,68.0,19.0,2.0,6.0,87.0,8.0,40.0,21.0,10.0,0.0,474.0,3.0,15.0,Matches,103.0,es ESP,FWMF,27.0,15.1,474.0,622.0,76.2,7687.0,2158.0,251.0,284.0,88.4,159.0,197.0,80.7,44.0,90.0,48.9,0.0,3.0,2.7,-3.0,30.0,49.0,21.0,6.0,76.0,Matches,127,es ESP,FWMF,27,25,1362.0,54.0,39.8,15.1,17,70.0,3,8,21.0,4,0.88,14.0,15.0,-1.0,-0.07,0.02,17.8,14.0,3.8,0.25,0.16,Matches,103.0,es ESP,FWMF,27.0,15.1,840.0,2.0,81.0,345.0,422.0,49.0,840.0,65.0,23.0,35.4,33.0,50.8,561.0,3278.0,1701.0,54.0,41.0,11.0,43.0,28.0,604.0,115.0,Matches,103.0,es ESP,FWMF,27.0,15.1,4.0,37.0,10.0,27.0,2.44,0.66,0.11,0.4,18.5,2.0,0.0,0.0,2.9,2.9,0.08,1.1,1.1,Matches,103.0,es ESP,FWMF,27.0,25.0,17.0,1362.0,15.1,4.0,0.0,4.0,4.0,0.0,0.0,7.0,0.0,2.9,2.9,3.0,5.9,54.0,76.0,115.0,0.26,0.0,0.26,0.26,0.26,0.19,0.2,0.39,0.19,0.39,Matches,Samu Castillejo,M/AM RLC,27,135,140,Spain,Valencia,13,14,15,11,14,10,7,11,6,7,14,11,9,15,11,12,11,10,12,13,11,11,14,8,13,10,14,12,15,15,10,10,13,15,12,8,12,6,11,13,15,1,2,1,3,2,4,1,1,1,1,2,13,12,5,12,10,14,11,8,1,1,1,1,1,1,1,14,10,16,18,15,20,12,182,67,20,10,9090611,6750,6750,5900,Mediterranean_Hispanic,131,2,1995/1/18,0,0,17006.0,,67142868
594,Edinson Cavani,Valencia,1987,105.0,uy URU,FW,35.0,16.1,7.0,4.0,3.0,3.0,1.0,3.0,15.0,20.0,12.0,10.0,3.0,7.0,2.0,9.0,11.0,0.0,Matches,105.0,uy URU,FW,35.0,16.1,24.0,1.49,19.0,1.0,0.0,4.0,0.0,0.0,4.0,0.25,4.0,0.0,0.0,0.0,0.0,0.0,Matches,,,,,,,,,,,,,,,,,,,,,,,,,,,,,,,,,,,,,,,,,,,,,,,,,,,,,,,,105.0,uy URU,FW,35.0,16.1,6.0,0.0,0.0,18.0,8.0,15.0,3.0,2.0,4.0,0.0,0.0,0.0,37.0,20.0,28.0,41.7,Matches,105.0,uy URU,FW,35.0,16.1,354.0,325.0,26.0,0.0,4.0,4.0,3.0,0.0,0.0,0.0,0.0,0.0,263.0,3.0,7.0,Matches,105.0,uy URU,FW,35.0,16.1,263.0,354.0,74.3,4029.0,556.0,161.0,203.0,79.3,73.0,94.0,77.7,22.0,27.0,81.5,2.0,1.7,1.1,0.3,12.0,14.0,4.0,0.0,20.0,Matches,129,uy URU,FW,35,25,1449.0,58.0,42.4,16.1,20,69.0,4,5,14.0,1,0.88,18.0,15.0,3.0,0.19,0.46,19.3,17.9,1.5,0.09,-0.11,Matches,105.0,uy URU,FW,35.0,16.1,476.0,13.0,54.0,217.0,208.0,54.0,473.0,10.0,4.0,40.0,5.0,50.0,230.0,904.0,316.0,8.0,7.0,3.0,30.0,9.0,356.0,53.0,Matches,105.0,uy URU,FW,35.0,16.1,5.0,31.0,8.0,25.8,1.93,0.5,0.1,0.38,14.7,3.0,2.0,3.0,6.0,3.6,0.12,-1.0,-0.6,Matches,105.0,uy URU,FW,35.0,25.0,20.0,1449.0,16.1,5.0,2.0,7.0,3.0,2.0,3.0,6.0,0.0,6.0,3.6,1.7,5.3,8.0,20.0,53.0,0.31,0.12,0.43,0.19,0.31,0.37,0.11,0.48,0.22,0.33,Matches,Edinson Cavani,S,35,148,174,"Uruguay,Italy",Valencia,10,12,10,16,13,14,18,13,4,10,12,16,9,13,16,14,16,14,13,10,12,17,10,14,16,12,14,17,13,14,14,15,18,13,12,15,14,8,14,13,13,3,2,2,2,3,4,1,2,4,4,1,9,17,9,13,13,15,17,10,1,1,1,1,1,1,1,1,1,1,10,1,5,20,184,71,10,20,347975206,7550,8228,7230,Mediterranean_Hispanic,147,8,1987/2/14,133,58,44162.0,,78005742
595,Dani Ceballos,Real Madrid,1996,106.0,es ESP,MF,25.0,17.4,43.0,29.0,13.0,15.0,15.0,25.0,64.0,39.1,39.0,23.0,2.0,21.0,25.0,68.0,6.0,1.0,Matches,106.0,es ESP,MF,25.0,17.4,81.0,4.66,60.0,8.0,5.0,2.0,5.0,1.0,9.0,0.52,8.0,0.0,0.0,0.0,1.0,0.0,Matches,,,,,,,,,,,,,,,,,,,,,,,,,,,,,,,,,,,,,,,,,,,,,,,,,,,,,,,,106.0,es ESP,MF,25.0,17.4,8.0,0.0,0.0,17.0,41.0,1.0,16.0,25.0,29.0,0.0,0.0,0.0,132.0,4.0,8.0,33.3,Matches,106.0,es ESP,MF,25.0,17.4,1504.0,1437.0,57.0,26.0,6.0,26.0,16.0,20.0,9.0,2.0,2.0,0.0,1362.0,10.0,25.0,Matches,106.0,es ESP,MF,25.0,17.4,1362.0,1504.0,90.6,21362.0,6610.0,745.0,785.0,94.9,445.0,475.0,93.7,117.0,146.0,80.1,4.0,2.1,2.0,1.9,30.0,198.0,18.0,1.0,204.0,Matches,130,es ESP,MF,25,30,1564.0,52.0,45.7,17.4,19,74.0,5,11,15.0,3,2.17,26.0,14.0,12.0,0.69,-0.62,30.8,16.6,14.1,0.81,-0.28,Matches,106.0,es ESP,MF,25.0,17.4,1690.0,29.0,258.0,986.0,465.0,34.0,1690.0,66.0,40.0,60.6,22.0,33.3,1243.0,6885.0,3318.0,60.0,52.0,7.0,19.0,26.0,1366.0,60.0,Matches,106.0,es ESP,MF,25.0,17.4,0.0,18.0,5.0,27.8,1.04,0.29,0.0,0.0,21.0,0.0,0.0,0.0,0.9,0.9,0.05,-0.9,-0.9,Matches,106.0,es ESP,MF,25.0,30.0,19.0,1564.0,17.4,0.0,4.0,4.0,0.0,0.0,0.0,8.0,0.0,0.9,0.9,2.1,3.0,60.0,204.0,60.0,0.0,0.23,0.23,0.0,0.23,0.05,0.12,0.17,0.05,0.17,Matches,Dani Ceballos,M C,25,140,163,Spain,R. Madrid,10,11,16,12,16,11,7,13,12,8,16,10,12,16,13,13,15,12,12,14,12,11,13,10,14,12,14,13,14,15,13,8,11,13,13,9,10,11,11,11,15,3,3,2,1,1,1,3,3,4,3,3,12,12,13,10,11,13,10,8,1,1,1,1,1,1,1,1,20,1,12,14,12,1,179,71,11,20,4882684,7000,7000,6500,Mediterranean_Hispanic,139,11,1996/8/7,11,1,149999.0,,67202350
596,Álex Centelles,Almería,1997,107.0,es ESP,DF,24.0,12.5,22.0,14.0,16.0,3.0,3.0,16.0,22.0,72.7,6.0,13.0,2.0,11.0,11.0,33.0,40.0,0.0,Matches,107.0,es ESP,DF,24.0,12.5,24.0,1.92,15.0,7.0,2.0,0.0,0.0,0.0,4.0,0.32,3.0,1.0,0.0,0.0,0.0,0.0,Matches,,,,,,,,,,,,,,,,,,,,,,,,,,,,,,,,,,,,,,,,,,,,,,,,,,,,,,,,107.0,es ESP,DF,24.0,12.5,0.0,1.0,0.0,7.0,5.0,0.0,46.0,11.0,14.0,0.0,0.0,0.0,66.0,7.0,17.0,29.2,Matches,107.0,es ESP,DF,24.0,12.5,577.0,446.0,130.0,24.0,0.0,4.0,46.0,106.0,0.0,0.0,0.0,0.0,412.0,1.0,20.0,Matches,107.0,es ESP,DF,24.0,12.5,412.0,577.0,71.4,7029.0,2965.0,190.0,223.0,85.2,170.0,216.0,78.7,37.0,97.0,38.1,2.0,1.3,1.1,0.7,13.0,32.0,9.0,6.0,35.0,Matches,132,es ESP,DF,24,15,1123.0,75.0,32.8,12.5,11,88.0,9,4,38.0,12,1.06,19.0,21.0,-2.0,-0.16,0.39,15.9,19.7,-3.8,-0.3,0.22,Matches,107.0,es ESP,DF,24.0,12.5,686.0,55.0,269.0,244.0,180.0,7.0,686.0,14.0,6.0,42.9,7.0,50.0,341.0,1561.0,854.0,17.0,11.0,1.0,11.0,6.0,368.0,48.0,Matches,107.0,es ESP,DF,24.0,12.5,1.0,5.0,2.0,40.0,0.4,0.16,0.2,0.5,21.2,0.0,0.0,0.0,0.4,0.4,0.08,0.6,0.6,Matches,107.0,es ESP,DF,24.0,15.0,11.0,1123.0,12.5,1.0,2.0,3.0,1.0,0.0,0.0,0.0,1.0,0.4,0.4,1.3,1.7,17.0,35.0,48.0,0.08,0.16,0.24,0.08,0.24,0.03,0.11,0.14,0.03,0.14,Matches,Álex Centelles,D/WB L,22,120,145,Spain,Almería,12,13,13,5,12,10,8,10,10,9,13,9,10,14,10,10,10,13,10,13,14,12,13,8,13,10,12,12,14,13,14,13,14,14,13,11,10,8,9,4,10,2,3,1,1,3,1,3,2,1,3,3,13,12,6,12,14,14,11,14,1,20,1,1,18,1,1,1,1,1,1,1,1,1,185,78,20,8,3569999,5990,5990,3740,Mediterranean_Hispanic,115,4,1999/8/30,0,0,3584.0,,67246344
597,Franco Cervi,Celta Vigo,1994,108.0,ar ARG,MFDF,28.0,21.0,76.0,46.0,29.0,36.0,11.0,33.0,66.0,50.0,33.0,33.0,1.0,32.0,36.0,112.0,16.0,0.0,Matches,108.0,ar ARG,MFDF,28.0,21.0,61.0,2.9,42.0,8.0,3.0,4.0,4.0,0.0,5.0,0.24,4.0,0.0,0.0,1.0,0.0,0.0,Matches,,,,,,,,,,,,,,,,,,,,,,,,,,,,,,,,,,,,,,,,,,,,,,,,,,,,,,,,108.0,ar ARG,MFDF,28.0,21.0,2.0,1.0,0.0,27.0,42.0,2.0,113.0,36.0,46.0,0.0,0.0,0.0,145.0,12.0,25.0,32.4,Matches,108.0,ar ARG,MFDF,28.0,21.0,874.0,771.0,99.0,12.0,1.0,1.0,113.0,43.0,44.0,9.0,27.0,0.0,620.0,4.0,30.0,Matches,108.0,ar ARG,MFDF,28.0,21.0,620.0,874.0,70.9,9395.0,3007.0,348.0,410.0,84.9,207.0,272.0,76.1,44.0,109.0,40.4,4.0,2.7,2.9,1.3,27.0,49.0,26.0,9.0,69.0,Matches,133,ar ARG,MFDF,28,36,1894.0,53.0,55.4,21.0,21,76.0,6,15,21.0,1,1.11,19.0,37.0,-18.0,-0.86,-1.33,23.9,26.1,-2.3,-0.11,-0.07,Matches,108.0,ar ARG,MFDF,28.0,21.0,1143.0,16.0,219.0,496.0,437.0,50.0,1143.0,51.0,21.0,41.2,22.0,43.1,637.0,3430.0,1526.0,45.0,38.0,8.0,30.0,16.0,650.0,113.0,Matches,108.0,ar ARG,MFDF,28.0,21.0,0.0,23.0,6.0,26.1,1.09,0.29,0.0,0.0,19.4,0.0,0.0,0.0,2.3,2.3,0.1,-2.3,-2.3,Matches,108.0,ar ARG,MFDF,28.0,36.0,21.0,1894.0,21.0,0.0,4.0,4.0,0.0,0.0,0.0,2.0,1.0,2.3,2.3,2.7,5.1,45.0,69.0,113.0,0.0,0.19,0.19,0.0,0.19,0.11,0.13,0.24,0.11,0.24,Matches,Franco Cervi,M/AM L,28,135,143,"Argentina,Italy",Vigo,12,10,13,11,12,12,4,13,8,11,13,12,13,13,16,14,14,10,14,13,11,18,13,9,15,13,14,18,15,15,16,7,17,15,15,8,12,14,10,11,12,3,1,3,3,1,3,3,2,2,3,3,7,13,6,14,12,14,7,11,1,10,1,1,14,1,1,19,1,1,20,14,10,1,167,60,20,7,5698861,6498,5907,5091,Mediterranean_Hispanic,135,6,1994/5/26,4,1,47944.0,,14078688
598,Andreas Christensen,Barcelona,1996,111.0,dk DEN,DF,26.0,19.6,20.0,15.0,9.0,11.0,0.0,10.0,16.0,62.5,6.0,14.0,12.0,2.0,21.0,41.0,47.0,0.0,Matches,111.0,dk DEN,DF,26.0,19.6,15.0,0.77,15.0,0.0,0.0,0.0,0.0,0.0,2.0,0.1,2.0,0.0,0.0,0.0,0.0,0.0,Matches,,,,,,,,,,,,,,,,,,,,,,,,,,,,,,,,,,,,,,,,,,,,,,,,,,,,,,,,111.0,dk DEN,DF,26.0,19.6,2.0,0.0,0.0,18.0,7.0,0.0,1.0,21.0,15.0,0.0,0.0,1.0,107.0,42.0,19.0,68.9,Matches,111.0,dk DEN,DF,26.0,19.6,1507.0,1445.0,62.0,48.0,3.0,14.0,1.0,10.0,0.0,0.0,0.0,0.0,1416.0,0.0,7.0,Matches,111.0,dk DEN,DF,26.0,19.6,1416.0,1507.0,94.0,25804.0,8685.0,549.0,580.0,94.7,740.0,761.0,97.2,113.0,142.0,79.6,1.0,0.5,0.9,0.5,6.0,114.0,4.0,0.0,91.0,Matches,136,dk DEN,DF,26,23,1760.0,77.0,51.5,19.6,22,80.0,15,1,6.0,4,2.3,33.0,13.0,20.0,1.02,-0.6,34.9,19.5,15.4,0.79,-0.67,Matches,111.0,dk DEN,DF,26.0,19.6,1652.0,127.0,645.0,962.0,50.0,13.0,1652.0,2.0,0.0,0.0,2.0,100.0,1170.0,5841.0,3232.0,18.0,15.0,0.0,10.0,1.0,1257.0,5.0,Matches,111.0,dk DEN,DF,26.0,19.6,1.0,10.0,5.0,50.0,0.51,0.26,0.1,0.2,12.2,0.0,0.0,0.0,1.0,1.0,0.1,0.0,0.0,Matches,111.0,dk DEN,DF,26.0,23.0,22.0,1760.0,19.6,1.0,1.0,2.0,1.0,0.0,0.0,2.0,0.0,1.0,1.0,0.5,1.5,18.0,91.0,5.0,0.05,0.05,0.1,0.05,0.1,0.05,0.03,0.08,0.05,0.08,Matches,Andreas Christensen,D/DM/M C,26,155,165,Denmark,Barcelona,5,10,11,9,14,5,15,8,12,15,14,9,14,13,7,17,8,16,16,10,17,11,7,9,10,16,15,13,12,14,12,14,14,15,13,10,15,6,15,4,15,1,1,2,4,2,1,1,2,2,2,3,16,15,5,10,14,13,16,18,1,1,20,14,1,10,16,1,16,1,1,1,1,1,188,78,10,20,42075000,7750,8200,6250,Northern_European,151,4,1996/4/10,56,2,230768.0,,27066387
599,Samuel Chukwueze,Villarreal,1999,112.0,ng NGA,FWMF,23.0,26.0,14.0,7.0,7.0,2.0,5.0,7.0,23.0,30.4,16.0,13.0,0.0,13.0,12.0,26.0,16.0,0.0,Matches,112.0,ng NGA,FWMF,23.0,26.0,110.0,4.23,75.0,4.0,24.0,2.0,4.0,1.0,15.0,0.58,9.0,0.0,5.0,0.0,1.0,0.0,Matches,,,,,,,,,,,,,,,,,,,,,,,,,,,,,,,,,,,,,,,,,,,,,,,,,,,,,,,,112.0,ng NGA,FWMF,23.0,26.0,1.0,0.0,0.0,19.0,34.0,11.0,28.0,12.0,7.0,1.0,0.0,0.0,110.0,14.0,20.0,41.2,Matches,112.0,ng NGA,FWMF,23.0,26.0,908.0,873.0,30.0,3.0,9.0,4.0,28.0,15.0,12.0,3.0,0.0,0.0,697.0,5.0,32.0,Matches,112.0,ng NGA,FWMF,23.0,26.0,697.0,908.0,76.8,10572.0,2312.0,402.0,467.0,86.1,229.0,289.0,79.2,50.0,76.0,65.8,5.0,4.3,4.4,0.7,44.0,35.0,45.0,7.0,85.0,Matches,137,ng NGA,FWMF,23,37,2339.0,63.0,68.4,26.0,27,77.0,9,10,25.0,1,1.73,41.0,33.0,8.0,0.31,-0.61,42.0,34.9,7.2,0.28,-0.11,Matches,112.0,ng NGA,FWMF,23.0,26.0,1241.0,15.0,131.0,437.0,696.0,143.0,1241.0,178.0,86.0,48.3,76.0,42.7,876.0,6197.0,3639.0,133.0,63.0,71.0,66.0,29.0,974.0,261.0,Matches,112.0,ng NGA,FWMF,23.0,26.0,6.0,60.0,17.0,28.3,2.31,0.65,0.1,0.35,17.4,0.0,0.0,0.0,6.5,6.5,0.11,-0.5,-0.5,Matches,112.0,ng NGA,FWMF,23.0,37.0,27.0,2339.0,26.0,6.0,5.0,11.0,6.0,0.0,0.0,1.0,0.0,6.5,6.5,4.3,10.8,133.0,85.0,261.0,0.23,0.19,0.42,0.23,0.42,0.25,0.16,0.41,0.25,0.41,Matches,Samuel Chukwueze,M/AM RL,23,140,165,Nigeria,Villarreal,12,14,17,11,14,12,12,11,12,8,14,9,8,17,11,15,11,12,9,10,9,16,16,5,10,8,10,13,16,14,13,7,12,16,15,10,11,5,15,6,17,2,2,4,2,3,2,2,1,2,2,3,18,14,2,13,14,10,11,12,1,1,1,1,1,1,1,14,1,18,16,13,20,14,172,70,20,6,23444317,7000,7000,4650,African_Caribbean,136,14,1999/5/22,24,4,23429.0,,67269484
600,Víctor Chust,Cádiz,2000,113.0,es ESP,DF,22.0,10.7,9.0,6.0,7.0,2.0,0.0,4.0,7.0,57.1,3.0,8.0,3.0,5.0,10.0,19.0,53.0,0.0,Matches,113.0,es ESP,DF,22.0,10.7,5.0,0.47,4.0,1.0,0.0,0.0,0.0,0.0,0.0,0.0,0.0,0.0,0.0,0.0,0.0,0.0,Matches,,,,,,,,,,,,,,,,,,,,,,,,,,,,,,,,,,,,,,,,,,,,,,,,,,,,,,,,113.0,es ESP,DF,22.0,10.7,3.0,0.0,0.0,11.0,4.0,1.0,0.0,10.0,6.0,0.0,1.0,0.0,46.0,16.0,17.0,48.5,Matches,113.0,es ESP,DF,22.0,10.7,440.0,412.0,25.0,23.0,0.0,5.0,0.0,2.0,0.0,0.0,0.0,0.0,364.0,3.0,5.0,Matches,113.0,es ESP,DF,22.0,10.7,364.0,440.0,82.7,8016.0,2967.0,105.0,118.0,89.0,172.0,192.0,89.6,78.0,113.0,69.0,0.0,0.0,0.1,0.0,1.0,22.0,1.0,0.0,22.0,Matches,138,es ESP,DF,22,14,965.0,69.0,28.2,10.7,10,78.0,8,4,48.0,4,0.86,7.0,20.0,-13.0,-1.21,-0.85,8.7,20.3,-11.6,-1.08,-0.77,Matches,113.0,es ESP,DF,22.0,10.7,533.0,71.0,291.0,237.0,13.0,6.0,533.0,3.0,1.0,33.3,2.0,66.7,246.0,1462.0,718.0,4.0,2.0,1.0,2.0,1.0,305.0,2.0,Matches,113.0,es ESP,DF,22.0,10.7,1.0,2.0,2.0,100.0,0.19,0.19,0.5,0.5,7.0,0.0,0.0,0.0,0.9,0.9,0.47,0.1,0.1,Matches,113.0,es ESP,DF,22.0,14.0,10.0,965.0,10.7,1.0,0.0,1.0,1.0,0.0,0.0,3.0,0.0,0.9,0.9,0.0,1.0,4.0,22.0,2.0,0.09,0.0,0.09,0.09,0.09,0.09,0.0,0.09,0.09,0.09,Matches,Víctor Chust,D C,22,124,149,Spain,Cádiz,6,8,7,5,10,5,13,6,13,14,12,8,14,10,12,13,14,11,14,10,14,13,8,12,12,14,14,15,11,9,11,14,14,10,14,15,14,9,14,7,11,2,2,1,3,1,2,3,3,1,2,3,16,12,1,13,14,10,12,20,1,1,20,10,1,1,1,1,1,1,1,1,1,1,182,74,7,20,5808000,5500,5368,2537,Mediterranean_Hispanic,123,3,2000/3/5,0,0,4619.0,,67258572
601,Pathé Ciss,Rayo Vallecano,1994,114.0,sn SEN,MFDF,28.0,14.2,39.0,29.0,11.0,23.0,5.0,15.0,34.0,44.1,19.0,23.0,10.0,13.0,22.0,61.0,34.0,0.0,Matches,114.0,sn SEN,MFDF,28.0,14.2,21.0,1.48,19.0,0.0,0.0,1.0,1.0,0.0,0.0,0.0,0.0,0.0,0.0,0.0,0.0,0.0,Matches,,,,,,,,,,,,,,,,,,,,,,,,,,,,,,,,,,,,,,,,,,,,,,,,,,,,,,,,114.0,sn SEN,MFDF,28.0,14.2,4.0,0.0,0.0,38.0,13.0,1.0,3.0,22.0,29.0,0.0,0.0,1.0,101.0,34.0,28.0,54.8,Matches,114.0,sn SEN,MFDF,28.0,14.2,700.0,676.0,21.0,20.0,0.0,15.0,3.0,1.0,0.0,0.0,0.0,0.0,575.0,3.0,12.0,Matches,114.0,sn SEN,MFDF,28.0,14.2,575.0,700.0,82.1,11074.0,3062.0,226.0,268.0,84.3,273.0,307.0,88.9,70.0,96.0,72.9,0.0,0.3,0.3,-0.3,6.0,63.0,4.0,0.0,65.0,Matches,139,sn SEN,MFDF,28,32,1282.0,40.0,37.5,14.2,12,77.0,6,20,18.0,6,1.47,9.0,27.0,-18.0,-1.26,-1.68,15.3,21.8,-6.5,-0.46,-0.46,Matches,114.0,sn SEN,MFDF,28.0,14.2,891.0,57.0,243.0,543.0,114.0,19.0,891.0,11.0,5.0,45.5,5.0,45.5,480.0,2279.0,1032.0,10.0,16.0,1.0,14.0,13.0,518.0,5.0,Matches,114.0,sn SEN,MFDF,28.0,14.2,1.0,20.0,5.0,25.0,1.4,0.35,0.05,0.2,18.8,0.0,0.0,0.0,2.6,2.6,0.13,-1.6,-1.6,Matches,114.0,sn SEN,MFDF,28.0,32.0,12.0,1282.0,14.2,1.0,0.0,1.0,1.0,0.0,0.0,4.0,0.0,2.6,2.6,0.3,2.9,10.0,65.0,5.0,0.07,0.0,0.07,0.07,0.07,0.18,0.02,0.2,0.18,0.2,Matches,Pathé Ciss,DM/M C,28,131,138,Senegal,Vallecano,7,7,9,7,12,7,13,9,11,13,13,8,15,11,12,15,12,12,13,11,13,10,6,11,7,15,14,14,14,11,13,14,15,14,16,16,12,7,12,3,7,1,1,2,2,2,2,3,3,3,1,2,13,12,6,12,12,14,12,13,1,1,12,1,1,1,18,1,20,1,1,1,1,1,183,71,8,20,4301354,6548,6548,4548,African_Caribbean,123,14,1994/3/16,0,0,10690.0,,13181623
602,Carlos Clerc,Elche,1992,115.0,es ESP,DFMF,30.0,29.3,75.0,51.0,55.0,16.0,4.0,31.0,50.0,62.0,19.0,29.0,7.0,22.0,28.0,103.0,94.0,1.0,Matches,115.0,es ESP,DFMF,30.0,29.3,41.0,1.4,31.0,3.0,1.0,2.0,4.0,0.0,4.0,0.14,3.0,0.0,0.0,0.0,1.0,0.0,Matches,,,,,,,,,,,,,,,,,,,,,,,,,,,,,,,,,,,,,,,,,,,,,,,,,,,,,,,,115.0,es ESP,DFMF,30.0,29.3,5.0,0.0,0.0,32.0,31.0,2.0,89.0,28.0,51.0,0.0,0.0,0.0,151.0,20.0,22.0,47.6,Matches,115.0,es ESP,DFMF,30.0,29.3,1397.0,1124.0,267.0,30.0,1.0,8.0,89.0,234.0,3.0,0.0,3.0,0.0,1040.0,6.0,36.0,Matches,115.0,es ESP,DFMF,30.0,29.3,1040.0,1397.0,74.4,16100.0,6659.0,563.0,638.0,88.2,392.0,495.0,79.2,63.0,179.0,35.2,1.0,2.1,2.0,-1.1,16.0,78.0,18.0,9.0,107.0,Matches,140,es ESP,DFMF,30,32,2639.0,82.0,77.2,29.3,31,84.0,21,1,22.0,5,0.72,24.0,50.0,-26.0,-0.89,0.38,29.1,50.7,-21.7,-0.74,0.51,Matches,115.0,es ESP,DFMF,30.0,29.3,1714.0,131.0,596.0,761.0,370.0,25.0,1714.0,56.0,26.0,46.4,23.0,41.1,884.0,4694.0,2204.0,51.0,40.0,2.0,28.0,10.0,950.0,91.0,Matches,115.0,es ESP,DFMF,30.0,29.3,0.0,9.0,3.0,33.3,0.31,0.1,0.0,0.0,17.9,0.0,0.0,0.0,0.6,0.6,0.06,-0.6,-0.6,Matches,115.0,es ESP,DFMF,30.0,32.0,31.0,2639.0,29.3,0.0,1.0,1.0,0.0,0.0,0.0,5.0,0.0,0.6,0.6,2.1,2.7,51.0,107.0,91.0,0.0,0.03,0.03,0.0,0.03,0.02,0.07,0.09,0.02,0.09,Matches,Carlos Clerc,D/WB L,30,131,137,Spain,Elche,9,13,11,7,12,8,10,8,13,13,11,9,13,12,13,13,14,12,14,12,14,12,12,9,13,13,15,15,14,13,13,10,14,15,14,12,14,9,13,8,9,2,2,4,1,1,1,1,1,3,3,4,12,14,8,12,13,14,12,11,1,20,1,1,19,1,1,10,1,1,8,1,1,1,182,69,20,8,3481890,6550,6550,4250,Mediterranean_Hispanic,132,6,1992/2/21,0,0,18506.0,,67147196
603,Eray Cömert,Valencia,1998,118.0,ch SUI,DF,24.0,18.6,35.0,23.0,24.0,10.0,1.0,17.0,33.0,51.5,16.0,23.0,8.0,15.0,29.0,64.0,76.0,1.0,Matches,118.0,ch SUI,DF,24.0,18.6,12.0,0.65,8.0,0.0,1.0,1.0,2.0,0.0,0.0,0.0,0.0,0.0,0.0,0.0,0.0,0.0,Matches,,,,,,,,,,,,,,,,,,,,,,,,,,,,,,,,,,,,,,,,,,,,,,,,,,,,,,,,118.0,ch SUI,DF,24.0,18.6,5.0,1.0,0.0,22.0,11.0,1.0,1.0,29.0,23.0,0.0,0.0,0.0,106.0,44.0,31.0,58.7,Matches,118.0,ch SUI,DF,24.0,18.6,945.0,890.0,53.0,44.0,0.0,24.0,1.0,0.0,0.0,0.0,0.0,0.0,815.0,2.0,6.0,Matches,118.0,ch SUI,DF,24.0,18.6,815.0,945.0,86.2,17301.0,5980.0,208.0,234.0,88.9,484.0,514.0,94.2,113.0,170.0,66.5,0.0,0.1,0.2,-0.1,3.0,48.0,2.0,0.0,54.0,Matches,144,ch SUI,DF,24,23,1672.0,73.0,48.9,18.6,19,84.0,15,4,20.0,12,1.22,22.0,22.0,0.0,0.0,0.15,24.6,24.7,0.0,0.0,-0.3,Matches,118.0,ch SUI,DF,24.0,18.6,1129.0,162.0,598.0,510.0,33.0,10.0,1129.0,2.0,2.0,100.0,0.0,0.0,680.0,3720.0,2119.0,6.0,9.0,1.0,1.0,0.0,691.0,1.0,Matches,118.0,ch SUI,DF,24.0,18.6,1.0,10.0,6.0,60.0,0.54,0.32,0.1,0.17,18.2,0.0,0.0,0.0,0.5,0.5,0.05,0.5,0.5,Matches,118.0,ch SUI,DF,24.0,23.0,19.0,1672.0,18.6,1.0,0.0,1.0,1.0,0.0,0.0,5.0,1.0,0.5,0.5,0.1,0.6,6.0,54.0,1.0,0.05,0.0,0.05,0.05,0.05,0.03,0.0,0.03,0.03,0.03,Matches,Eray Cömert,D C,24,127,143,"Switzerland,Turkey",Valencia,5,7,11,6,13,12,13,13,7,14,13,11,16,13,14,14,14,13,11,11,12,12,8,12,8,12,14,12,11,12,13,12,13,12,15,13,11,12,13,5,11,1,1,3,2,2,1,3,1,1,3,3,13,13,7,12,13,14,10,12,1,1,20,1,1,1,12,1,1,1,1,1,1,1,183,80,12,20,3205831,6350,6600,4550,Mediterranean_Hispanic,127,6,1998/2/4,9,0,9182.0,,98033710
604,Santi Comesaña,Rayo Vallecano,1996,119.0,es ESP,MF,25.0,27.2,71.0,44.0,24.0,41.0,6.0,38.0,82.0,46.3,44.0,39.0,3.0,36.0,32.0,103.0,17.0,0.0,Matches,119.0,es ESP,MF,25.0,27.2,87.0,3.2,73.0,1.0,6.0,2.0,2.0,3.0,5.0,0.18,4.0,0.0,1.0,0.0,0.0,0.0,Matches,,,,,,,,,,,,,,,,,,,,,,,,,,,,,,,,,,,,,,,,,,,,,,,,,,,,,,,,119.0,es ESP,MF,25.0,27.2,6.0,0.0,0.0,49.0,28.0,4.0,17.0,32.0,44.0,0.0,0.0,0.0,173.0,32.0,44.0,42.1,Matches,119.0,es ESP,MF,25.0,27.2,1240.0,1199.0,37.0,31.0,0.0,10.0,17.0,2.0,0.0,0.0,0.0,0.0,1024.0,4.0,24.0,Matches,119.0,es ESP,MF,25.0,27.2,1024.0,1240.0,82.6,16598.0,5032.0,533.0,604.0,88.2,377.0,449.0,84.0,83.0,115.0,72.2,2.0,2.2,2.0,-0.2,41.0,136.0,17.0,2.0,150.0,Matches,145,es ESP,MF,25,35,2451.0,70.0,71.7,27.2,29,77.0,7,6,36.0,0,1.2,36.0,33.0,3.0,0.11,1.13,33.2,34.9,-1.7,-0.06,0.38,Matches,119.0,es ESP,MF,25.0,27.2,1544.0,34.0,229.0,927.0,405.0,58.0,1544.0,58.0,35.0,60.3,18.0,31.0,830.0,4235.0,2292.0,40.0,43.0,8.0,38.0,34.0,1010.0,58.0,Matches,119.0,es ESP,MF,25.0,27.2,3.0,25.0,7.0,28.0,0.92,0.26,0.12,0.43,16.2,0.0,0.0,0.0,2.5,2.5,0.11,0.5,0.5,Matches,119.0,es ESP,MF,25.0,35.0,29.0,2451.0,27.2,3.0,2.0,5.0,3.0,0.0,0.0,6.0,0.0,2.5,2.5,2.2,4.6,40.0,150.0,58.0,0.11,0.07,0.18,0.11,0.18,0.09,0.08,0.17,0.09,0.17,Matches,Santi Comesaña,DM/M C,25,135,145,Spain,Vallecano,9,10,11,11,13,7,14,10,6,12,14,7,13,13,12,15,13,12,13,13,14,14,11,14,13,14,14,14,12,13,12,13,15,13,14,14,13,12,10,8,13,1,3,3,2,3,3,2,1,2,1,1,14,15,8,12,12,13,10,8,1,1,9,1,1,1,18,1,20,1,1,12,1,1,184,75,11,20,5468604,6750,6750,4750,Mediterranean_Hispanic,134,5,1996/10/5,0,0,14585.0,,67224142
605,Ángel Correa,Atlético Madrid,1995,123.0,ar ARG,FWMF,27.0,16.2,12.0,6.0,6.0,3.0,3.0,5.0,16.0,31.3,11.0,17.0,0.0,17.0,10.0,22.0,6.0,1.0,Matches,123.0,ar ARG,FWMF,27.0,16.2,61.0,3.78,45.0,3.0,5.0,6.0,1.0,1.0,11.0,0.68,5.0,0.0,2.0,3.0,0.0,1.0,Matches,,,,,,,,,,,,,,,,,,,,,,,,,,,,,,,,,,,,,,,,,,,,,,,,,,,,,,,,123.0,ar ARG,FWMF,27.0,16.2,3.0,1.0,0.0,19.0,20.0,14.0,22.0,10.0,6.0,0.0,0.0,0.0,63.0,5.0,16.0,23.8,Matches,123.0,ar ARG,FWMF,27.0,16.2,520.0,493.0,23.0,2.0,2.0,5.0,22.0,2.0,9.0,1.0,5.0,0.0,406.0,4.0,16.0,Matches,123.0,ar ARG,FWMF,27.0,16.2,406.0,520.0,78.1,5237.0,1201.0,270.0,310.0,87.1,93.0,118.0,78.8,16.0,37.0,43.2,1.0,3.5,3.6,-2.5,23.0,27.0,19.0,3.0,58.0,Matches,152,ar ARG,FWMF,27,35,1455.0,42.0,42.5,16.2,13,69.0,1,22,25.0,1,1.94,29.0,15.0,14.0,0.87,-0.19,30.9,19.4,11.5,0.71,0.29,Matches,123.0,ar ARG,FWMF,27.0,16.2,738.0,11.0,84.0,283.0,379.0,119.0,738.0,59.0,23.0,39.0,33.0,55.9,472.0,2244.0,971.0,44.0,20.0,24.0,58.0,31.0,568.0,142.0,Matches,123.0,ar ARG,FWMF,27.0,16.2,9.0,43.0,18.0,41.9,2.66,1.11,0.21,0.5,15.3,0.0,0.0,0.0,7.1,7.1,0.17,1.9,1.9,Matches,123.0,ar ARG,FWMF,27.0,35.0,13.0,1455.0,16.2,9.0,1.0,10.0,9.0,0.0,0.0,3.0,1.0,7.1,7.1,3.5,10.7,44.0,58.0,142.0,0.56,0.06,0.62,0.56,0.62,0.44,0.22,0.66,0.44,0.66,Matches,Ángel Correa,M/AM/S RLC,27,156,162,"Argentina,Spain",A. Madrid,13,15,16,13,16,10,8,11,9,5,15,11,6,17,10,15,11,13,13,15,14,13,18,10,17,8,11,13,14,16,14,6,16,14,12,10,15,13,12,8,11,3,1,1,1,3,2,2,1,1,1,1,13,14,10,15,14,14,14,11,1,1,1,1,1,1,1,13,1,18,15,18,20,18,172,67,12,20,44000003,7700,7600,7150,North_African__Middle_Eastern,147,8,1995/3/9,20,3,96153.0,,14043349
606,Jaume Costa,Mallorca,1988,125.0,es ESP,DF,34.0,28.9,50.0,34.0,26.0,17.0,7.0,29.0,51.0,56.9,22.0,13.0,5.0,8.0,22.0,72.0,44.0,1.0,Matches,125.0,es ESP,DF,34.0,28.9,58.0,2.01,44.0,5.0,1.0,1.0,5.0,2.0,4.0,0.14,3.0,1.0,0.0,0.0,0.0,0.0,Matches,,,,,,,,,,,,,,,,,,,,,,,,,,,,,,,,,,,,,,,,,,,,,,,,,,,,,,,,125.0,es ESP,DF,34.0,28.9,10.0,0.0,0.0,44.0,32.0,7.0,75.0,22.0,34.0,0.0,0.0,0.0,122.0,30.0,26.0,53.6,Matches,125.0,es ESP,DF,34.0,28.9,1165.0,946.0,210.0,12.0,0.0,9.0,75.0,198.0,0.0,0.0,0.0,0.0,854.0,9.0,31.0,Matches,125.0,es ESP,DF,34.0,28.9,854.0,1165.0,73.3,14099.0,5450.0,440.0,505.0,87.1,336.0,449.0,74.8,66.0,139.0,47.5,1.0,2.5,2.7,-1.5,31.0,55.0,31.0,17.0,74.0,Matches,154,es ESP,DF,34,32,2599.0,81.0,76.0,28.9,30,84.0,19,2,45.0,1,1.44,31.0,32.0,-1.0,-0.03,0.51,25.0,36.8,-11.8,-0.41,-0.47,Matches,125.0,es ESP,DF,34.0,28.9,1364.0,62.0,360.0,603.0,415.0,37.0,1364.0,25.0,10.0,40.0,12.0,48.0,689.0,3495.0,1980.0,60.0,38.0,10.0,23.0,8.0,810.0,123.0,Matches,125.0,es ESP,DF,34.0,28.9,0.0,11.0,6.0,54.5,0.38,0.21,0.0,0.0,15.7,0.0,0.0,0.0,1.0,1.0,0.09,-1.0,-1.0,Matches,125.0,es ESP,DF,34.0,32.0,30.0,2599.0,28.9,0.0,1.0,1.0,0.0,0.0,0.0,10.0,0.0,1.0,1.0,2.5,3.5,60.0,74.0,123.0,0.0,0.03,0.03,0.0,0.03,0.04,0.09,0.12,0.04,0.12,Matches,Jaume Costa,D/WB RL,34,129,145,Spain,Mallorca,12,14,11,7,12,8,7,10,13,13,12,6,14,12,15,14,15,12,13,11,13,15,11,6,14,13,16,16,12,14,15,6,14,12,15,10,13,13,13,5,9,2,3,1,1,2,1,3,1,3,2,2,17,12,6,13,13,14,11,12,1,20,1,15,19,7,1,14,1,1,1,1,1,1,171,61,20,8,312630,6400,6400,4500,Mediterranean_Hispanic,125,6,1988/3/18,0,0,8491.0,,67065398
607,Thibaut Courtois,Real Madrid,1992,127.0,be BEL,GK,30.0,31.0,1.0,0.0,1.0,0.0,0.0,1.0,1.0,100.0,0.0,0.0,0.0,0.0,3.0,4.0,7.0,1.0,Matches,127.0,be BEL,GK,30.0,31.0,5.0,0.16,2.0,3.0,0.0,0.0,0.0,0.0,0.0,0.0,0.0,0.0,0.0,0.0,0.0,0.0,Matches,8.0,be BEL,GK,30.0,31.0,29.0,4.0,0.0,1.0,0.0,29.7,0.22,0.7,0.02,83.0,214.0,38.8,982.0,194.0,18.4,27.7,152.0,21.7,29.5,366.0,32.0,8.7,40.0,1.29,15.4,Matches,8.0,be BEL,GK,30.0,31.0,31.0,2790.0,31.0,29.0,0.94,118.0,88.0,78.8,20.0,5.0,6.0,10.0,32.3,5.0,4.0,1.0,0.0,20.0,Matches,127.0,be BEL,GK,30.0,31.0,0.0,0.0,0.0,0.0,3.0,0.0,0.0,3.0,0.0,0.0,0.0,0.0,59.0,9.0,0.0,100.0,Matches,127.0,be BEL,GK,30.0,31.0,1136.0,942.0,192.0,40.0,0.0,3.0,0.0,0.0,0.0,0.0,0.0,0.0,980.0,2.0,1.0,Matches,127.0,be BEL,GK,30.0,31.0,980.0,1136.0,86.3,23008.0,14737.0,219.0,220.0,99.5,560.0,567.0,98.8,196.0,341.0,57.5,0.0,0.4,0.0,-0.4,2.0,6.0,1.0,0.0,0.0,Matches,156,be BEL,GK,30,31,2790.0,90.0,81.6,31.0,31,90.0,31,0,,1,2.1,61.0,29.0,32.0,1.03,0.03,61.5,32.3,29.2,0.94,-0.11,Matches,127.0,be BEL,GK,30.0,31.0,1209.0,1020.0,1205.0,5.0,0.0,0.0,1209.0,2.0,2.0,100.0,0.0,0.0,824.0,4223.0,2619.0,0.0,0.0,0.0,2.0,0.0,704.0,0.0,Matches,127.0,be BEL,GK,30.0,31.0,0.0,0.0,0.0,,0.0,0.0,,,,0.0,0.0,0.0,0.0,0.0,,0.0,0.0,Matches,127.0,be BEL,GK,30.0,31.0,31.0,2790.0,31.0,0.0,0.0,0.0,0.0,0.0,0.0,0.0,0.0,0.0,0.0,0.4,0.4,0.0,0.0,0.0,0.0,0.0,0.0,0.0,0.0,0.0,0.01,0.01,0.0,0.01,Matches,Thibaut Courtois,GK,30,181,181,Belgium,R. Madrid,6,1,10,2,10,9,10,1,2,3,13,5,3,12,8,15,15,12,16,9,16,16,14,13,3,16,14,11,12,13,14,18,12,11,8,14,16,5,18,5,15,20,16,14,5,16,16,18,19,12,6,15,14,14,10,15,16,15,14,14,20,1,1,1,1,1,1,1,1,1,1,1,1,1,199,96,20,9,255605643,9050,8750,8500,Northern_European,178,2,1992/5/11,94,0,296047.0,,18026122
608,Yan Couto,Girona,2002,128.0,br BRA,DFMF,20.0,12.9,25.0,18.0,11.0,11.0,3.0,12.0,20.0,60.0,8.0,7.0,2.0,5.0,5.0,30.0,10.0,0.0,Matches,128.0,br BRA,DFMF,20.0,12.9,45.0,3.5,35.0,2.0,4.0,1.0,2.0,1.0,4.0,0.31,3.0,1.0,0.0,0.0,0.0,0.0,Matches,,,,,,,,,,,,,,,,,,,,,,,,,,,,,,,,,,,,,,,,,,,,,,,,,,,,,,,,128.0,br BRA,DFMF,20.0,12.9,3.0,0.0,0.0,12.0,15.0,2.0,63.0,5.0,18.0,0.0,0.0,0.0,78.0,1.0,7.0,12.5,Matches,128.0,br BRA,DFMF,20.0,12.9,598.0,525.0,72.0,5.0,0.0,5.0,63.0,66.0,1.0,1.0,0.0,0.0,444.0,1.0,17.0,Matches,128.0,br BRA,DFMF,20.0,12.9,444.0,598.0,74.2,7221.0,2170.0,229.0,262.0,87.4,158.0,212.0,74.5,39.0,73.0,53.4,2.0,2.5,2.1,-0.5,19.0,33.0,20.0,11.0,55.0,Matches,157,br BRA,DFMF,20,25,1158.0,46.0,33.9,12.9,12,77.0,5,13,18.0,4,1.12,20.0,15.0,5.0,0.39,0.47,15.5,16.7,-1.2,-0.09,0.03,Matches,128.0,br BRA,DFMF,20.0,12.9,734.0,20.0,184.0,295.0,266.0,20.0,734.0,60.0,28.0,46.7,27.0,45.0,447.0,3355.0,1826.0,56.0,31.0,12.0,26.0,13.0,482.0,89.0,Matches,128.0,br BRA,DFMF,20.0,12.9,1.0,8.0,1.0,12.5,0.62,0.08,0.13,1.0,20.2,0.0,0.0,0.0,0.5,0.5,0.07,0.5,0.5,Matches,128.0,br BRA,DFMF,20.0,25.0,12.0,1158.0,12.9,1.0,2.0,3.0,1.0,0.0,0.0,3.0,0.0,0.5,0.5,2.5,3.0,56.0,55.0,89.0,0.08,0.16,0.23,0.08,0.23,0.04,0.19,0.23,0.04,0.23,Matches,Yan Couto,D/WB R,20,132,-8,"Brazil,Portugal",Manchester City,12,14,14,10,13,10,10,10,12,12,14,11,9,14,10,13,11,14,13,14,14,12,13,9,14,11,14,12,13,14,15,5,13,13,13,10,13,7,7,6,12,1,2,3,1,1,2,2,2,1,3,2,14,13,6,12,11,12,8,12,1,10,1,19,1,20,1,1,1,14,1,1,13,1,170,65,11,20,71914876,6550,6150,4158,Mixed_Race,130,7,2002/6/3,0,0,5800.0,Girona,19383257
609,Sergi Darder,Espanyol,1993,136.0,es ESP,MF,28.0,36.9,69.0,38.0,12.0,43.0,14.0,29.0,73.0,39.7,44.0,34.0,2.0,32.0,24.0,93.0,23.0,0.0,Matches,136.0,es ESP,MF,28.0,36.9,150.0,4.07,98.0,35.0,8.0,4.0,4.0,1.0,11.0,0.3,9.0,1.0,0.0,1.0,0.0,0.0,Matches,,,,,,,,,,,,,,,,,,,,,,,,,,,,,,,,,,,,,,,,,,,,,,,,,,,,,,,,136.0,es ESP,MF,28.0,36.9,4.0,0.0,0.0,31.0,78.0,2.0,181.0,24.0,38.0,0.0,0.0,0.0,205.0,12.0,13.0,48.0,Matches,136.0,es ESP,MF,28.0,36.9,1628.0,1381.0,237.0,109.0,14.0,19.0,181.0,11.0,93.0,39.0,37.0,3.0,1181.0,10.0,40.0,Matches,136.0,es ESP,MF,28.0,36.9,1181.0,1628.0,72.5,22446.0,8537.0,488.0,563.0,86.7,509.0,619.0,82.2,163.0,362.0,45.0,3.0,7.5,6.3,-4.5,73.0,158.0,52.0,16.0,233.0,Matches,166,es ESP,MF,28,38,3320.0,87.0,97.1,36.9,38,87.0,31,0,,0,0.97,51.0,64.0,-13.0,-0.35,3.25,47.8,56.6,-8.8,-0.24,2.13,Matches,136.0,es ESP,MF,28.0,36.9,1980.0,43.0,276.0,1145.0,605.0,39.0,1980.0,135.0,68.0,50.4,54.0,40.0,1214.0,8752.0,4719.0,111.0,95.0,9.0,43.0,26.0,1273.0,75.0,Matches,136.0,es ESP,MF,28.0,36.9,6.0,39.0,13.0,33.3,1.06,0.35,0.15,0.46,22.6,0.0,0.0,0.0,3.5,3.5,0.09,2.5,2.5,Matches,136.0,es ESP,MF,28.0,38.0,38.0,3320.0,36.9,6.0,3.0,9.0,6.0,0.0,0.0,4.0,0.0,3.5,3.5,7.5,10.9,111.0,233.0,75.0,0.16,0.08,0.24,0.16,0.24,0.09,0.2,0.3,0.09,0.3,Matches,Sergi Darder,DM/M C,28,145,154,Spain,Espanyol,7,9,11,7,15,11,10,12,5,14,16,10,15,16,13,14,13,13,14,17,13,15,12,8,16,14,13,13,13,13,13,10,12,12,13,12,13,10,12,7,11,1,2,3,3,1,1,2,2,3,2,3,12,15,7,12,16,15,11,12,1,1,1,1,1,1,18,1,20,1,1,1,1,1,180,72,12,20,15315091,7150,7150,5750,Mediterranean_Hispanic,144,6,1993/12/22,0,0,36413.0,,67118372
610,Rodrigo De Paul,Atlético Madrid,1994,137.0,ar ARG,MF,28.0,21.4,35.0,21.0,11.0,18.0,6.0,18.0,35.0,51.4,17.0,20.0,3.0,17.0,8.0,43.0,7.0,0.0,Matches,137.0,ar ARG,MF,28.0,21.4,88.0,4.12,77.0,7.0,1.0,0.0,3.0,0.0,11.0,0.52,10.0,0.0,0.0,0.0,1.0,0.0,Matches,,,,,,,,,,,,,,,,,,,,,,,,,,,,,,,,,,,,,,,,,,,,,,,,,,,,,,,,137.0,ar ARG,MF,28.0,21.4,5.0,0.0,0.0,33.0,49.0,0.0,47.0,8.0,21.0,0.0,0.0,0.0,127.0,6.0,8.0,42.9,Matches,137.0,ar ARG,MF,28.0,21.4,1421.0,1335.0,74.0,47.0,17.0,32.0,47.0,15.0,8.0,2.0,4.0,0.0,1160.0,12.0,27.0,Matches,137.0,ar ARG,MF,28.0,21.4,1160.0,1421.0,81.6,19936.0,6409.0,593.0,655.0,90.5,383.0,455.0,84.2,144.0,223.0,64.6,7.0,5.5,3.8,1.5,48.0,145.0,47.0,7.0,182.0,Matches,168,ar ARG,MF,28,30,1923.0,64.0,56.2,21.4,24,74.0,5,6,27.0,3,2.07,40.0,20.0,20.0,0.94,-0.09,33.1,23.3,9.8,0.46,-0.2,Matches,137.0,ar ARG,MF,28.0,21.4,1598.0,14.0,261.0,923.0,425.0,18.0,1598.0,32.0,16.0,50.0,11.0,34.4,1026.0,5240.0,2897.0,55.0,41.0,3.0,32.0,15.0,1279.0,68.0,Matches,137.0,ar ARG,MF,28.0,21.4,2.0,21.0,5.0,23.8,0.98,0.23,0.1,0.4,24.5,1.0,0.0,0.0,1.6,1.6,0.07,0.4,0.4,Matches,137.0,ar ARG,MF,28.0,30.0,24.0,1923.0,21.4,2.0,7.0,9.0,2.0,0.0,0.0,5.0,0.0,1.6,1.6,5.5,7.1,55.0,182.0,68.0,0.09,0.33,0.42,0.09,0.42,0.07,0.26,0.33,0.07,0.33,Matches,Rodrigo De Paul,M/AM RLC,28,154,160,"Argentina,Italy",A. Madrid,15,16,17,13,16,14,8,15,3,10,16,15,12,16,13,15,13,13,12,15,14,15,16,15,13,6,15,14,14,14,14,9,15,14,13,12,13,15,14,8,14,1,3,3,3,2,1,3,3,3,2,1,13,16,11,14,14,15,12,12,1,1,1,1,1,1,1,12,20,12,16,18,15,12,180,70,12,20,40726823,7500,7650,6700,Mediterranean_Hispanic,150,6,1994/5/24,41,2,111504.0,,14048343
611,Ousmane Dembélé,Barcelona,1997,141.0,fr FRA,FW,25.0,15.7,19.0,12.0,4.0,8.0,7.0,4.0,15.0,26.7,11.0,10.0,1.0,9.0,0.0,19.0,2.0,0.0,Matches,141.0,fr FRA,FW,25.0,15.7,86.0,5.48,52.0,13.0,15.0,3.0,3.0,0.0,12.0,0.76,9.0,0.0,2.0,1.0,0.0,0.0,Matches,,,,,,,,,,,,,,,,,,,,,,,,,,,,,,,,,,,,,,,,,,,,,,,,,,,,,,,,141.0,fr FRA,FW,25.0,15.7,4.0,0.0,0.0,16.0,19.0,5.0,106.0,0.0,12.0,0.0,0.0,0.0,60.0,4.0,12.0,25.0,Matches,141.0,fr FRA,FW,25.0,15.7,854.0,768.0,80.0,7.0,13.0,4.0,106.0,8.0,65.0,17.0,19.0,1.0,642.0,6.0,38.0,Matches,141.0,fr FRA,FW,25.0,15.7,642.0,854.0,75.2,10068.0,2037.0,376.0,427.0,88.1,195.0,256.0,76.2,54.0,106.0,50.9,7.0,4.9,5.0,2.1,41.0,21.0,37.0,5.0,74.0,Matches,172,fr FRA,FW,25,25,1410.0,56.0,41.2,15.7,16,73.0,3,9,28.0,0,2.36,32.0,11.0,21.0,1.34,0.04,32.1,15.5,16.6,1.06,-0.1,Matches,141.0,fr FRA,FW,25.0,15.7,1041.0,2.0,30.0,311.0,719.0,103.0,1041.0,114.0,52.0,45.6,50.0,43.9,755.0,6024.0,3328.0,124.0,75.0,56.0,27.0,18.0,841.0,209.0,Matches,141.0,fr FRA,FW,25.0,15.7,5.0,49.0,16.0,32.7,3.13,1.02,0.1,0.31,16.7,0.0,0.0,0.0,3.9,3.9,0.08,1.1,1.1,Matches,141.0,fr FRA,FW,25.0,25.0,16.0,1410.0,15.7,5.0,7.0,12.0,5.0,0.0,0.0,4.0,0.0,3.9,3.9,4.9,8.8,124.0,74.0,209.0,0.32,0.45,0.77,0.32,0.77,0.25,0.31,0.56,0.25,0.56,Matches,Ousmane Dembélé,M/AM RL,25,162,176,"France,Mauritania",Barcelona,13,16,19,12,14,10,7,13,6,4,12,11,5,17,9,11,11,9,8,14,8,13,18,8,14,5,7,11,18,18,11,9,12,18,12,9,11,5,13,14,14,1,1,4,4,1,1,3,1,3,2,3,12,14,14,9,11,9,14,12,1,1,1,1,1,1,1,16,1,17,19,14,20,13,178,67,20,19,96249998,8000,8150,7600,African_Caribbean,153,16,1997/5/15,27,4,230768.0,,85140178
612,Mouctar Diakhaby,Valencia,1996,142.0,gn GUI,DF,25.0,27.2,30.0,16.0,19.0,11.0,0.0,13.0,20.0,65.0,7.0,30.0,17.0,13.0,20.0,50.0,111.0,2.0,Matches,142.0,gn GUI,DF,25.0,27.2,15.0,0.55,13.0,0.0,0.0,2.0,0.0,0.0,1.0,0.04,1.0,0.0,0.0,0.0,0.0,0.0,Matches,,,,,,,,,,,,,,,,,,,,,,,,,,,,,,,,,,,,,,,,,,,,,,,,,,,,,,,,142.0,gn GUI,DF,25.0,27.2,7.0,1.0,1.0,23.0,13.0,4.0,1.0,20.0,16.0,0.0,0.0,0.0,149.0,48.0,40.0,54.5,Matches,142.0,gn GUI,DF,25.0,27.2,1185.0,1141.0,42.0,37.0,0.0,12.0,1.0,1.0,0.0,0.0,0.0,0.0,971.0,2.0,6.0,Matches,142.0,gn GUI,DF,25.0,27.2,971.0,1185.0,81.9,20225.0,7159.0,264.0,304.0,86.8,569.0,643.0,88.5,131.0,221.0,59.3,0.0,0.3,0.4,-0.3,5.0,76.0,0.0,0.0,86.0,Matches,173,gn GUI,DF,25,29,2446.0,84.0,71.5,27.2,28,86.0,24,1,36.0,4,1.14,32.0,29.0,3.0,0.11,0.66,35.5,27.7,7.8,0.29,0.47,Matches,142.0,gn GUI,DF,25.0,27.2,1452.0,188.0,711.0,659.0,90.0,52.0,1452.0,10.0,5.0,50.0,4.0,40.0,823.0,4136.0,2149.0,19.0,14.0,1.0,14.0,3.0,868.0,11.0,Matches,142.0,gn GUI,DF,25.0,27.2,3.0,21.0,7.0,33.3,0.77,0.26,0.14,0.43,10.9,0.0,0.0,0.0,2.7,2.7,0.13,0.3,0.3,Matches,142.0,gn GUI,DF,25.0,29.0,28.0,2446.0,27.2,3.0,0.0,3.0,3.0,0.0,0.0,7.0,1.0,2.7,2.7,0.3,3.0,19.0,86.0,11.0,0.11,0.0,0.11,0.11,0.11,0.1,0.01,0.11,0.1,0.11,Matches,Mouctar Diakhaby,D C,25,140,149,"France,Guinea",Valencia,6,6,12,7,11,6,16,6,6,14,13,10,13,9,14,13,15,14,13,12,13,15,8,11,8,15,14,15,13,12,14,16,15,13,15,16,12,12,13,5,8,1,1,1,1,2,3,2,2,2,3,2,15,14,3,12,13,16,15,12,1,1,20,1,1,1,12,1,1,1,1,1,1,1,192,80,8,20,9131129,6950,6950,5000,African_Caribbean,140,19,1996/12/19,0,0,15332.0,,48036643
613,Stole Dimitrievski,Rayo Vallecano,1993,145.0,mk MKD,GK,28.0,36.9,1.0,0.0,1.0,0.0,0.0,1.0,2.0,50.0,1.0,2.0,0.0,2.0,1.0,2.0,17.0,3.0,Matches,145.0,mk MKD,GK,28.0,36.9,4.0,0.11,2.0,2.0,0.0,0.0,0.0,0.0,0.0,0.0,0.0,0.0,0.0,0.0,0.0,0.0,Matches,9.0,mk MKD,GK,28.0,36.9,49.0,4.0,0.0,9.0,4.0,44.2,0.3,-0.8,-0.02,152.0,537.0,28.3,816.0,199.0,45.0,38.6,299.0,56.9,46.7,500.0,24.0,4.8,52.0,1.41,16.1,Matches,9.0,mk MKD,GK,28.0,37.0,37.0,3324.0,36.9,49.0,1.33,139.0,94.0,67.6,13.0,10.0,14.0,9.0,24.3,5.0,4.0,0.0,1.0,0.0,Matches,145.0,mk MKD,GK,28.0,36.9,4.0,0.0,0.0,0.0,3.0,0.0,0.0,1.0,0.0,0.0,0.0,0.0,40.0,9.0,1.0,90.0,Matches,145.0,mk MKD,GK,28.0,36.9,1124.0,717.0,398.0,99.0,0.0,4.0,0.0,0.0,0.0,0.0,0.0,0.0,690.0,9.0,1.0,Matches,145.0,mk MKD,GK,28.0,36.9,690.0,1124.0,61.4,20209.0,14772.0,118.0,118.0,100.0,331.0,336.0,98.5,240.0,658.0,36.5,0.0,0.0,0.0,0.0,1.0,21.0,0.0,0.0,0.0,Matches,177,mk MKD,GK,28,37,3324.0,90.0,97.2,36.9,37,90.0,36,0,,1,1.32,44.0,49.0,-5.0,-0.14,2.68,43.0,48.5,-5.5,-0.15,0.67,Matches,145.0,mk MKD,GK,28.0,36.9,1194.0,993.0,1185.0,9.0,0.0,0.0,1194.0,0.0,0.0,,0.0,,619.0,3767.0,2427.0,0.0,0.0,0.0,0.0,0.0,426.0,1.0,Matches,145.0,mk MKD,GK,28.0,36.9,0.0,0.0,0.0,,0.0,0.0,,,,0.0,0.0,0.0,0.0,0.0,,0.0,0.0,Matches,145.0,mk MKD,GK,28.0,37.0,37.0,3324.0,36.9,0.0,0.0,0.0,0.0,0.0,0.0,4.0,0.0,0.0,0.0,0.0,0.0,0.0,0.0,1.0,0.0,0.0,0.0,0.0,0.0,0.0,0.0,0.0,0.0,0.0,Matches,Stole Dimitrievski,GK,28,133,142,"North Macedonia,Spain",Vallecano,4,2,1,2,12,8,1,2,2,2,13,5,1,12,15,12,13,12,13,11,12,15,1,12,1,12,9,12,11,12,12,14,10,11,11,13,15,7,14,5,12,13,14,13,5,14,12,13,15,11,11,14,15,12,5,12,12,14,12,15,20,1,1,1,1,1,1,1,1,1,1,1,1,1,188,89,12,20,4259600,6645,6245,4645,Northern_European,131,5,1993/12/25,56,0,12637.0,,47022611
614,Marko Dmitrović,Sevilla,1992,147.0,rs SRB,GK,30.0,14.1,0.0,0.0,0.0,0.0,0.0,0.0,0.0,,0.0,0.0,0.0,0.0,0.0,0.0,6.0,0.0,Matches,147.0,rs SRB,GK,30.0,14.1,4.0,0.28,2.0,2.0,0.0,0.0,0.0,0.0,0.0,0.0,0.0,0.0,0.0,0.0,0.0,0.0,Matches,10.0,rs SRB,GK,30.0,14.1,13.0,0.0,0.0,2.0,1.0,12.2,0.23,0.2,0.02,103.0,326.0,31.6,372.0,44.0,58.1,44.0,131.0,84.0,62.4,216.0,12.0,5.6,10.0,0.71,12.2,Matches,10.0,rs SRB,GK,30.0,15.0,13.0,1269.0,14.1,13.0,0.92,55.0,43.0,76.4,6.0,4.0,3.0,5.0,38.5,0.0,0.0,0.0,0.0,,Matches,147.0,rs SRB,GK,30.0,14.1,1.0,0.0,0.0,0.0,1.0,0.0,0.0,0.0,0.0,0.0,0.0,0.0,23.0,4.0,0.0,100.0,Matches,147.0,rs SRB,GK,30.0,14.1,508.0,330.0,173.0,42.0,0.0,1.0,0.0,0.0,0.0,0.0,0.0,0.0,271.0,5.0,2.0,Matches,147.0,rs SRB,GK,30.0,14.1,271.0,508.0,53.3,9990.0,8313.0,33.0,33.0,100.0,111.0,112.0,99.1,127.0,356.0,35.7,0.0,0.0,0.1,0.0,0.0,22.0,1.0,0.0,0.0,Matches,179,rs SRB,GK,30,15,1269.0,85.0,37.1,14.1,13,90.0,13,2,50.0,21,1.73,20.0,13.0,7.0,0.5,1.08,18.2,16.4,1.8,0.13,0.53,Matches,147.0,rs SRB,GK,30.0,14.1,540.0,455.0,539.0,1.0,0.0,0.0,540.0,0.0,0.0,,0.0,,268.0,1454.0,792.0,0.0,1.0,0.0,1.0,0.0,209.0,0.0,Matches,147.0,rs SRB,GK,30.0,14.1,0.0,0.0,0.0,,0.0,0.0,,,,0.0,0.0,0.0,0.0,0.0,,0.0,0.0,Matches,147.0,rs SRB,GK,30.0,15.0,13.0,1269.0,14.1,0.0,0.0,0.0,0.0,0.0,0.0,1.0,0.0,0.0,0.0,0.0,0.0,0.0,0.0,0.0,0.0,0.0,0.0,0.0,0.0,0.0,0.0,0.0,0.0,0.0,Matches,Marko Dmitrović,GK,30,138,145,Serbia,Sevilla,3,10,8,5,8,7,9,10,10,8,3,10,8,7,9,13,14,13,15,8,14,12,6,10,9,14,11,12,10,13,12,14,11,11,12,11,15,10,10,7,9,15,14,14,8,14,16,13,15,9,10,15,11,12,8,13,11,12,11,11,20,1,1,1,1,1,1,1,1,1,1,1,1,1,190,81,20,11,7346698,6900,6800,5400,Northern_European,139,4,1992/1/24,19,0,21487.0,,62038612
615,Domingos Duarte,Getafe,1995,152.0,pt POR,DF,27.0,29.5,26.0,18.0,21.0,5.0,0.0,19.0,26.0,73.1,7.0,29.0,23.0,6.0,39.0,65.0,145.0,0.0,Matches,152.0,pt POR,DF,27.0,29.5,15.0,0.51,13.0,0.0,0.0,2.0,0.0,0.0,3.0,0.1,2.0,0.0,0.0,1.0,0.0,0.0,Matches,,,,,,,,,,,,,,,,,,,,,,,,,,,,,,,,,,,,,,,,,,,,,,,,,,,,,,,,152.0,pt POR,DF,27.0,29.5,11.0,1.0,1.0,32.0,21.0,2.0,0.0,39.0,18.0,0.0,2.0,1.0,126.0,47.0,30.0,61.0,Matches,152.0,pt POR,DF,27.0,29.5,963.0,927.0,34.0,31.0,0.0,10.0,0.0,3.0,0.0,0.0,0.0,0.0,742.0,2.0,4.0,Matches,152.0,pt POR,DF,27.0,29.5,742.0,963.0,77.1,15659.0,6506.0,238.0,281.0,84.7,369.0,442.0,83.5,130.0,225.0,57.8,2.0,0.8,0.1,1.2,4.0,52.0,1.0,0.0,63.0,Matches,188,pt POR,DF,27,31,2657.0,86.0,77.7,29.5,30,88.0,28,1,13.0,5,0.94,26.0,40.0,-14.0,-0.47,-0.83,24.9,38.4,-13.6,-0.46,-0.96,Matches,152.0,pt POR,DF,27.0,29.5,1246.0,178.0,677.0,538.0,35.0,22.0,1246.0,6.0,5.0,83.3,1.0,16.7,583.0,2704.0,1231.0,6.0,2.0,0.0,6.0,3.0,621.0,0.0,Matches,152.0,pt POR,DF,27.0,29.5,0.0,16.0,4.0,25.0,0.54,0.14,0.0,0.0,11.0,0.0,0.0,0.0,1.3,1.3,0.08,-1.3,-1.3,Matches,152.0,pt POR,DF,27.0,31.0,30.0,2657.0,29.5,0.0,2.0,2.0,0.0,0.0,0.0,11.0,1.0,1.3,1.3,0.8,2.1,6.0,63.0,0.0,0.0,0.07,0.07,0.0,0.07,0.04,0.03,0.07,0.04,0.07,Matches,Domingos Duarte,D C,27,138,153,Portugal,Getafe,4,6,9,9,11,6,14,6,9,15,11,11,14,11,13,13,14,13,15,8,13,14,7,13,8,15,15,14,12,12,14,15,16,13,15,15,13,13,12,10,3,1,2,1,4,3,3,1,3,2,2,3,14,13,5,14,11,15,15,15,1,1,20,1,1,1,1,1,1,1,1,1,1,1,190,84,8,20,8620126,6900,6900,4750,Mediterranean_Hispanic,137,5,1995/3/10,3,0,18130.0,,55063355
616,Hugo Duro,Valencia,1999,154.0,es ESP,FW,22.0,15.4,15.0,12.0,2.0,6.0,7.0,7.0,17.0,41.2,10.0,11.0,1.0,10.0,2.0,17.0,7.0,1.0,Matches,154.0,es ESP,FW,22.0,15.4,22.0,1.43,17.0,0.0,2.0,0.0,3.0,0.0,2.0,0.13,1.0,0.0,0.0,0.0,1.0,0.0,Matches,,,,,,,,,,,,,,,,,,,,,,,,,,,,,,,,,,,,,,,,,,,,,,,,,,,,,,,,154.0,es ESP,FW,22.0,15.4,5.0,0.0,0.0,20.0,35.0,3.0,2.0,2.0,12.0,0.0,0.0,0.0,37.0,32.0,61.0,34.4,Matches,154.0,es ESP,FW,22.0,15.4,277.0,248.0,27.0,2.0,0.0,3.0,2.0,1.0,0.0,0.0,0.0,0.0,203.0,2.0,9.0,Matches,154.0,es ESP,FW,22.0,15.4,203.0,277.0,73.3,2602.0,327.0,134.0,169.0,79.3,47.0,63.0,74.6,6.0,12.0,50.0,1.0,1.1,0.5,-0.1,11.0,13.0,1.0,0.0,19.0,Matches,190,es ESP,FW,22,30,1385.0,46.0,40.5,15.4,12,75.0,6,18,27.0,5,1.13,16.0,20.0,-4.0,-0.26,-0.3,21.1,18.8,2.3,0.15,-0.01,Matches,154.0,es ESP,FW,22.0,15.4,431.0,11.0,29.0,187.0,217.0,73.0,430.0,13.0,2.0,15.4,8.0,61.5,229.0,704.0,357.0,9.0,6.0,6.0,31.0,19.0,319.0,67.0,Matches,154.0,es ESP,FW,22.0,15.4,1.0,32.0,9.0,28.1,2.08,0.58,0.03,0.11,11.9,0.0,0.0,1.0,4.4,3.6,0.11,-3.4,-2.6,Matches,154.0,es ESP,FW,22.0,30.0,12.0,1385.0,15.4,1.0,1.0,2.0,1.0,0.0,1.0,5.0,0.0,4.4,3.6,1.1,4.7,9.0,19.0,67.0,0.06,0.06,0.13,0.06,0.13,0.29,0.07,0.36,0.23,0.31,Matches,Hugo Duro,AM/S LC,22,132,155,Spain,Valencia,10,11,13,13,12,11,12,12,9,7,13,15,9,12,14,13,14,14,14,12,13,15,12,12,14,12,13,14,14,13,12,11,12,13,14,13,14,10,11,4,12,2,3,1,1,3,3,2,1,3,1,4,13,14,11,14,9,15,11,10,1,1,1,1,1,1,1,1,1,1,17,15,12,20,182,76,20,10,13740001,6600,6600,4300,Mediterranean_Hispanic,132,1,1999/11/10,0,0,8000.0,,67274349
617,Íñigo Eguaras,Almería,1992,155.0,es ESP,MF,30.0,10.7,11.0,8.0,4.0,6.0,1.0,5.0,18.0,27.8,13.0,9.0,3.0,6.0,6.0,17.0,15.0,0.0,Matches,155.0,es ESP,MF,30.0,10.7,25.0,2.33,22.0,0.0,0.0,1.0,1.0,1.0,2.0,0.19,2.0,0.0,0.0,0.0,0.0,0.0,Matches,,,,,,,,,,,,,,,,,,,,,,,,,,,,,,,,,,,,,,,,,,,,,,,,,,,,,,,,155.0,es ESP,MF,30.0,10.7,6.0,0.0,0.0,7.0,8.0,0.0,3.0,6.0,8.0,0.0,0.0,0.0,67.0,3.0,5.0,37.5,Matches,155.0,es ESP,MF,30.0,10.7,543.0,524.0,15.0,11.0,5.0,5.0,3.0,1.0,2.0,0.0,0.0,0.0,458.0,4.0,7.0,Matches,155.0,es ESP,MF,30.0,10.7,458.0,543.0,84.3,7955.0,2756.0,223.0,247.0,90.3,172.0,193.0,89.1,51.0,73.0,69.9,1.0,0.6,1.2,0.4,11.0,50.0,9.0,2.0,61.0,Matches,191,es ESP,MF,30,25,967.0,39.0,28.3,10.7,10,73.0,4,15,16.0,11,1.4,11.0,19.0,-8.0,-0.74,-0.45,11.1,19.8,-8.6,-0.8,-0.49,Matches,155.0,es ESP,MF,30.0,10.7,614.0,26.0,174.0,369.0,75.0,3.0,614.0,5.0,4.0,80.0,1.0,20.0,354.0,1476.0,706.0,8.0,8.0,0.0,7.0,4.0,433.0,7.0,Matches,155.0,es ESP,MF,30.0,10.7,1.0,8.0,3.0,37.5,0.74,0.28,0.13,0.33,21.2,0.0,0.0,0.0,1.0,1.0,0.13,0.0,0.0,Matches,155.0,es ESP,MF,30.0,25.0,10.0,967.0,10.7,1.0,1.0,2.0,1.0,0.0,0.0,6.0,0.0,1.0,1.0,0.6,1.7,8.0,61.0,7.0,0.09,0.09,0.19,0.09,0.19,0.1,0.06,0.16,0.1,0.16,Matches,Íñigo Eguaras,DM C,30,127,130,"Spain,Pays Basque",Almería,11,10,11,8,17,10,10,12,4,11,16,11,11,15,9,14,11,17,11,17,14,14,13,13,8,16,15,11,10,13,9,11,9,8,13,8,10,9,10,10,11,3,1,4,3,1,2,1,1,1,3,1,9,8,5,13,17,14,11,16,1,1,1,1,1,1,20,1,15,1,1,1,1,1,181,77,12,20,4560694,6349,6349,3999,Mediterranean_Hispanic,126,6,1992/3/7,0,0,7913.0,,67111494
618,Aritz Elustondo,Real Sociedad,1994,156.0,es ESP,DF,28.0,16.1,26.0,17.0,15.0,10.0,1.0,14.0,26.0,53.8,12.0,15.0,6.0,9.0,20.0,46.0,43.0,1.0,Matches,156.0,es ESP,DF,28.0,16.1,9.0,0.56,5.0,2.0,0.0,2.0,0.0,0.0,2.0,0.12,0.0,1.0,0.0,1.0,0.0,0.0,Matches,,,,,,,,,,,,,,,,,,,,,,,,,,,,,,,,,,,,,,,,,,,,,,,,,,,,,,,,156.0,es ESP,DF,28.0,16.1,5.0,1.0,0.0,21.0,9.0,1.0,9.0,20.0,17.0,0.0,0.0,0.0,58.0,18.0,23.0,43.9,Matches,156.0,es ESP,DF,28.0,16.1,809.0,680.0,125.0,14.0,0.0,1.0,9.0,111.0,0.0,0.0,0.0,0.0,653.0,4.0,9.0,Matches,156.0,es ESP,DF,28.0,16.1,653.0,809.0,80.7,10994.0,4008.0,302.0,337.0,89.6,296.0,359.0,82.5,42.0,81.0,51.9,1.0,1.1,0.4,-0.1,4.0,39.0,7.0,2.0,52.0,Matches,192,es ESP,DF,28,25,1449.0,58.0,42.4,16.1,16,78.0,8,9,22.0,4,2.2,26.0,14.0,12.0,0.75,0.56,21.9,13.9,8.0,0.5,-0.04,Matches,156.0,es ESP,DF,28.0,16.1,952.0,68.0,360.0,488.0,107.0,14.0,952.0,8.0,5.0,62.5,3.0,37.5,470.0,2264.0,1160.0,21.0,12.0,1.0,13.0,7.0,547.0,19.0,Matches,156.0,es ESP,DF,28.0,16.1,0.0,8.0,0.0,0.0,0.5,0.0,0.0,,21.5,0.0,0.0,0.0,0.7,0.7,0.09,-0.7,-0.7,Matches,156.0,es ESP,DF,28.0,25.0,16.0,1449.0,16.1,0.0,1.0,1.0,0.0,0.0,0.0,5.0,1.0,0.7,0.7,1.1,1.8,21.0,52.0,19.0,0.0,0.06,0.06,0.0,0.06,0.04,0.07,0.11,0.04,0.11,Matches,Aritz Elustondo,D RC,28,145,145,"Spain,Pays Basque",Real San Sebastián,4,13,10,11,12,7,15,12,9,14,13,6,15,13,13,14,16,13,15,13,14,16,4,17,9,14,16,15,12,12,12,13,13,14,15,14,15,11,13,11,13,3,3,1,3,2,1,2,1,1,1,3,8,12,5,18,13,15,16,14,1,1,20,16,1,1,1,1,1,1,1,1,1,1,182,72,10,20,31704505,7245,7245,4895,Mediterranean_Hispanic,145,5,1994/3/28,0,0,32504.0,,67190072
619,Rodrigo Ely,Almería,1993,157.0,br BRA,DF,28.0,35.1,30.0,21.0,26.0,4.0,0.0,18.0,25.0,72.0,7.0,46.0,33.0,13.0,31.0,61.0,203.0,1.0,Matches,157.0,br BRA,DF,28.0,35.1,21.0,0.6,14.0,1.0,1.0,5.0,0.0,0.0,2.0,0.06,2.0,0.0,0.0,0.0,0.0,0.0,Matches,,,,,,,,,,,,,,,,,,,,,,,,,,,,,,,,,,,,,,,,,,,,,,,,,,,,,,,,157.0,br BRA,DF,28.0,35.1,10.0,1.0,1.0,25.0,14.0,2.0,3.0,31.0,21.0,0.0,0.0,1.0,142.0,79.0,38.0,67.5,Matches,157.0,br BRA,DF,28.0,35.1,1475.0,1393.0,78.0,75.0,2.0,16.0,3.0,2.0,0.0,0.0,0.0,0.0,1197.0,4.0,6.0,Matches,157.0,br BRA,DF,28.0,35.1,1197.0,1475.0,81.2,26201.0,10151.0,292.0,339.0,86.1,705.0,777.0,90.7,192.0,336.0,57.1,1.0,0.8,0.6,0.2,6.0,54.0,3.0,0.0,52.0,Matches,193,br BRA,DF,28,36,3155.0,88.0,92.3,35.1,36,88.0,33,0,,0,1.03,45.0,61.0,-16.0,-0.46,-0.46,38.8,57.8,-18.9,-0.54,-1.18,Matches,157.0,br BRA,DF,28.0,35.1,1857.0,376.0,1164.0,646.0,54.0,30.0,1857.0,7.0,5.0,71.4,1.0,14.3,964.0,3809.0,1958.0,6.0,8.0,1.0,16.0,2.0,1084.0,4.0,Matches,157.0,br BRA,DF,28.0,35.1,0.0,19.0,1.0,5.3,0.54,0.03,0.0,0.0,14.7,1.0,0.0,0.0,1.0,1.0,0.05,-1.0,-1.0,Matches,157.0,br BRA,DF,28.0,36.0,36.0,3155.0,35.1,0.0,1.0,1.0,0.0,0.0,0.0,10.0,1.0,1.0,1.0,0.8,1.8,6.0,52.0,4.0,0.0,0.03,0.03,0.0,0.03,0.03,0.02,0.05,0.03,0.05,Matches,Rodrigo Ely,D C,28,128,141,"Brazil,Italy",Almería,4,5,6,6,12,8,13,7,10,14,13,6,14,12,12,14,13,14,14,11,13,14,4,11,8,15,14,11,11,12,14,13,7,12,11,13,13,13,8,14,5,2,1,4,1,3,2,2,1,3,2,1,16,15,4,15,12,13,14,14,1,1,20,1,1,1,1,1,1,1,1,1,1,1,188,83,11,20,5209475,6400,6050,3500,Mediterranean_Hispanic,127,1,1993/11/3,0,0,8532.0,,43080624
620,Youssef En-Nesyri,Sevilla,1997,160.0,ma MAR,FW,25.0,18.5,16.0,8.0,3.0,7.0,6.0,4.0,14.0,28.6,10.0,6.0,2.0,4.0,4.0,20.0,16.0,0.0,Matches,160.0,ma MAR,FW,25.0,18.5,32.0,1.73,21.0,1.0,2.0,6.0,2.0,0.0,5.0,0.27,3.0,0.0,1.0,1.0,0.0,0.0,Matches,,,,,,,,,,,,,,,,,,,,,,,,,,,,,,,,,,,,,,,,,,,,,,,,,,,,,,,,160.0,ma MAR,FW,25.0,18.5,4.0,0.0,0.0,10.0,11.0,21.0,4.0,4.0,8.0,0.0,0.0,0.0,28.0,60.0,90.0,40.0,Matches,160.0,ma MAR,FW,25.0,18.5,241.0,204.0,35.0,0.0,1.0,2.0,4.0,2.0,0.0,0.0,0.0,0.0,156.0,2.0,5.0,Matches,160.0,ma MAR,FW,25.0,18.5,156.0,241.0,64.7,2202.0,328.0,96.0,135.0,71.1,50.0,75.0,66.7,4.0,8.0,50.0,1.0,1.1,0.5,-0.1,10.0,4.0,1.0,0.0,12.0,Matches,196,ma MAR,FW,25,31,1661.0,54.0,48.6,18.5,17,76.0,6,14,26.0,6,1.42,26.0,22.0,4.0,0.22,0.78,25.6,23.3,2.3,0.12,0.64,Matches,160.0,ma MAR,FW,25.0,18.5,439.0,19.0,44.0,186.0,211.0,103.0,439.0,23.0,4.0,17.4,16.0,69.6,190.0,927.0,369.0,16.0,5.0,14.0,46.0,9.0,286.0,71.0,Matches,160.0,ma MAR,FW,25.0,18.5,8.0,60.0,23.0,38.3,3.25,1.25,0.13,0.35,11.6,0.0,0.0,0.0,8.1,8.1,0.14,-0.1,-0.1,Matches,160.0,ma MAR,FW,25.0,31.0,17.0,1661.0,18.5,8.0,1.0,9.0,8.0,0.0,0.0,4.0,0.0,8.1,8.1,1.1,9.2,16.0,12.0,71.0,0.43,0.05,0.49,0.43,0.49,0.44,0.06,0.5,0.44,0.5,Matches,Youssef En-Nesyri,S L,25,148,159,Morocco,Sevilla,9,11,14,15,12,9,14,13,7,5,11,12,6,14,6,15,14,12,13,11,12,13,12,11,16,6,13,14,16,14,10,15,13,15,13,12,12,13,9,4,8,2,1,2,2,2,3,3,2,1,3,1,9,17,9,10,11,12,12,7,1,1,1,1,1,1,1,1,1,1,15,9,10,20,189,73,20,15,30481155,7400,7250,6500,African_Caribbean,147,7,1997/6/1,48,14,57496.0,,67229630
621,Gonzalo Escalante,Cádiz,1993,161.0,ar ARG,MF,29.0,12.5,36.0,24.0,15.0,20.0,1.0,15.0,29.0,51.7,14.0,18.0,4.0,14.0,17.0,53.0,26.0,1.0,Matches,161.0,ar ARG,MF,29.0,12.5,25.0,2.01,22.0,0.0,2.0,1.0,0.0,0.0,3.0,0.24,1.0,0.0,1.0,1.0,0.0,0.0,Matches,,,,,,,,,,,,,,,,,,,,,,,,,,,,,,,,,,,,,,,,,,,,,,,,,,,,,,,,161.0,ar ARG,MF,29.0,12.5,4.0,0.0,0.0,14.0,17.0,0.0,4.0,17.0,24.0,0.0,1.0,0.0,86.0,27.0,28.0,49.1,Matches,161.0,ar ARG,MF,29.0,12.5,433.0,419.0,11.0,6.0,2.0,4.0,4.0,0.0,0.0,0.0,0.0,0.0,325.0,3.0,4.0,Matches,161.0,ar ARG,MF,29.0,12.5,325.0,433.0,75.1,5212.0,1513.0,178.0,208.0,85.6,120.0,152.0,78.9,23.0,52.0,44.2,1.0,1.5,1.0,-0.5,10.0,41.0,5.0,2.0,50.0,Matches,197,ar ARG,MF,29,14,1121.0,80.0,32.8,12.5,13,83.0,8,1,45.0,1,1.57,13.0,13.0,0.0,0.0,0.9,16.6,17.2,-0.6,-0.05,0.72,Matches,161.0,ar ARG,MF,29.0,12.5,585.0,45.0,161.0,316.0,115.0,24.0,585.0,10.0,7.0,70.0,2.0,20.0,251.0,1085.0,523.0,3.0,7.0,0.0,14.0,8.0,289.0,12.0,Matches,161.0,ar ARG,MF,29.0,12.5,4.0,14.0,6.0,42.9,1.12,0.48,0.29,0.67,12.5,0.0,0.0,0.0,3.5,3.5,0.25,0.5,0.5,Matches,161.0,ar ARG,MF,29.0,14.0,13.0,1121.0,12.5,4.0,1.0,5.0,4.0,0.0,0.0,4.0,0.0,3.5,3.5,1.5,5.0,3.0,50.0,12.0,0.32,0.08,0.4,0.32,0.4,0.28,0.12,0.4,0.28,0.4,Matches,Gonzalo Escalante,DM/M C,29,128,145,"Argentina,Italy",S.S. Lazio,8,9,10,10,13,10,13,13,3,12,13,8,15,11,16,15,15,13,14,11,12,15,9,10,12,15,15,14,13,12,13,11,13,13,14,12,13,16,12,9,13,2,1,3,1,2,3,2,3,2,2,1,14,15,5,13,14,18,16,14,1,1,1,1,1,1,20,1,20,14,1,1,1,1,183,75,8,20,2167865,6400,6000,5300,Native_American,129,5,1993/3/27,0,0,40922.0,Cremonese,14024699
622,Sergio Escudero,Valladolid,1989,162.0,es ESP,DF,32.0,16.0,33.0,19.0,21.0,8.0,4.0,15.0,35.0,42.9,20.0,26.0,6.0,20.0,26.0,59.0,46.0,0.0,Matches,162.0,es ESP,DF,32.0,16.0,35.0,2.19,20.0,7.0,0.0,6.0,2.0,0.0,0.0,0.0,0.0,0.0,0.0,0.0,0.0,0.0,Matches,,,,,,,,,,,,,,,,,,,,,,,,,,,,,,,,,,,,,,,,,,,,,,,,,,,,,,,,162.0,es ESP,DF,32.0,16.0,3.0,0.0,0.0,19.0,20.0,1.0,56.0,26.0,19.0,0.0,0.0,0.0,89.0,24.0,24.0,50.0,Matches,162.0,es ESP,DF,32.0,16.0,743.0,548.0,189.0,23.0,0.0,6.0,56.0,147.0,19.0,5.0,13.0,0.0,528.0,6.0,23.0,Matches,162.0,es ESP,DF,32.0,16.0,528.0,743.0,71.1,9041.0,3725.0,259.0,286.0,90.6,201.0,271.0,74.2,55.0,132.0,41.7,0.0,1.8,1.6,-1.8,16.0,30.0,16.0,9.0,40.0,Matches,198,es ESP,DF,32,23,1439.0,63.0,42.1,16.0,17,76.0,8,6,25.0,10,1.13,15.0,21.0,-6.0,-0.38,0.72,16.9,23.1,-6.2,-0.39,0.54,Matches,162.0,es ESP,DF,32.0,16.0,937.0,61.0,320.0,371.0,255.0,16.0,937.0,17.0,7.0,41.2,9.0,52.9,363.0,1672.0,814.0,17.0,16.0,3.0,13.0,8.0,435.0,37.0,Matches,162.0,es ESP,DF,32.0,16.0,1.0,27.0,7.0,25.9,1.69,0.44,0.04,0.14,23.4,3.0,0.0,0.0,1.5,1.5,0.06,-0.5,-0.5,Matches,162.0,es ESP,DF,32.0,23.0,17.0,1439.0,16.0,1.0,0.0,1.0,1.0,0.0,0.0,3.0,0.0,1.5,1.5,1.8,3.3,17.0,40.0,37.0,0.06,0.0,0.06,0.06,0.06,0.09,0.11,0.2,0.09,0.2,Matches,Sergio Escudero,D/WB/M L,32,133,152,Spain,Valladolid,10,13,12,9,12,10,11,14,15,12,13,9,12,13,8,13,12,12,12,12,13,13,13,8,12,12,14,15,14,13,13,12,12,13,16,11,12,8,14,10,12,1,3,1,1,2,1,3,1,2,3,4,13,11,8,11,9,12,12,13,1,20,1,1,18,1,1,16,1,1,12,1,1,1,176,72,20,8,347975206,6650,6650,5750,Mediterranean_Hispanic,129,5,1989/9/2,0,0,12637.0,,67065536
623,Alfonso Espino,Cádiz,1992,163.0,uy URU,DF,30.0,34.7,87.0,56.0,55.0,20.0,12.0,48.0,96.0,50.0,48.0,52.0,11.0,41.0,48.0,135.0,99.0,3.0,Matches,163.0,uy URU,DF,30.0,34.7,70.0,2.02,59.0,6.0,1.0,0.0,2.0,2.0,7.0,0.2,5.0,1.0,1.0,0.0,0.0,0.0,Matches,,,,,,,,,,,,,,,,,,,,,,,,,,,,,,,,,,,,,,,,,,,,,,,,,,,,,,,,163.0,uy URU,DF,30.0,34.7,7.0,0.0,0.0,49.0,36.0,3.0,110.0,48.0,56.0,0.0,3.0,0.0,253.0,33.0,43.0,43.4,Matches,163.0,uy URU,DF,30.0,34.7,1542.0,1206.0,328.0,40.0,4.0,15.0,110.0,280.0,8.0,1.0,5.0,0.0,989.0,8.0,53.0,Matches,163.0,uy URU,DF,30.0,34.7,989.0,1542.0,64.1,17362.0,8062.0,467.0,571.0,81.8,395.0,582.0,67.9,107.0,294.0,36.4,4.0,4.2,3.7,-0.2,35.0,84.0,37.0,21.0,107.0,Matches,199,uy URU,DF,30,36,3122.0,87.0,91.3,34.7,35,89.0,33,1,18.0,1,1.17,29.0,43.0,-14.0,-0.4,2.31,39.6,53.6,-14.0,-0.4,1.46,Matches,163.0,uy URU,DF,30.0,34.7,1994.0,126.0,672.0,871.0,480.0,33.0,1994.0,52.0,25.0,48.1,23.0,44.2,820.0,3796.0,2147.0,53.0,34.0,7.0,52.0,23.0,860.0,129.0,Matches,163.0,uy URU,DF,30.0,34.7,0.0,20.0,1.0,5.0,0.58,0.03,0.0,0.0,28.9,0.0,0.0,0.0,1.5,1.5,0.08,-1.5,-1.5,Matches,163.0,uy URU,DF,30.0,36.0,35.0,3122.0,34.7,0.0,4.0,4.0,0.0,0.0,0.0,7.0,0.0,1.5,1.5,4.2,5.7,53.0,107.0,129.0,0.0,0.12,0.12,0.0,0.12,0.04,0.12,0.16,0.04,0.16,Matches,Alfonso Espino,D L,30,132,141,"Uruguay,Spain",Cádiz,7,11,10,6,11,6,6,10,13,14,11,7,14,9,15,12,16,11,14,11,11,15,9,15,13,12,16,19,15,14,14,6,17,14,18,14,12,10,13,5,5,1,2,1,1,1,2,1,1,3,3,2,13,13,7,16,14,15,9,11,1,20,1,1,12,1,1,9,1,1,1,1,1,1,172,71,20,7,3271293,6600,6600,4800,Mediterranean_Hispanic,131,7,1992/1/5,0,0,18509.0,,78066692
624,Edu Expósito,Espanyol,1996,165.0,es ESP,MF,25.0,12.9,34.0,20.0,16.0,15.0,3.0,13.0,23.0,56.5,10.0,7.0,0.0,7.0,12.0,46.0,20.0,0.0,Matches,165.0,es ESP,MF,25.0,12.9,45.0,3.49,30.0,5.0,4.0,3.0,2.0,1.0,9.0,0.7,8.0,0.0,1.0,0.0,0.0,0.0,Matches,,,,,,,,,,,,,,,,,,,,,,,,,,,,,,,,,,,,,,,,,,,,,,,,,,,,,,,,165.0,es ESP,MF,25.0,12.9,3.0,1.0,0.0,14.0,29.0,0.0,48.0,12.0,20.0,0.0,0.0,0.0,69.0,14.0,12.0,53.8,Matches,165.0,es ESP,MF,25.0,12.9,530.0,479.0,49.0,21.0,3.0,5.0,48.0,2.0,13.0,6.0,3.0,0.0,389.0,2.0,10.0,Matches,165.0,es ESP,MF,25.0,12.9,389.0,530.0,73.4,6692.0,2025.0,166.0,198.0,83.8,168.0,206.0,81.6,36.0,86.0,41.9,2.0,2.4,2.2,-0.4,22.0,45.0,20.0,4.0,72.0,Matches,204,es ESP,MF,25,28,1160.0,41.0,33.9,12.9,13,65.0,0,15,21.0,9,0.89,21.0,26.0,-5.0,-0.39,0.09,16.7,19.3,-2.6,-0.2,0.15,Matches,165.0,es ESP,MF,25.0,12.9,689.0,28.0,124.0,329.0,242.0,20.0,689.0,23.0,11.0,47.8,7.0,30.4,358.0,1755.0,901.0,19.0,15.0,2.0,25.0,13.0,428.0,59.0,Matches,165.0,es ESP,MF,25.0,12.9,2.0,19.0,7.0,36.8,1.47,0.54,0.11,0.29,24.7,2.0,0.0,0.0,0.9,0.9,0.05,1.1,1.1,Matches,165.0,es ESP,MF,25.0,28.0,13.0,1160.0,12.9,2.0,2.0,4.0,2.0,0.0,0.0,3.0,1.0,0.9,0.9,2.4,3.3,19.0,72.0,59.0,0.16,0.16,0.31,0.16,0.31,0.07,0.18,0.25,0.07,0.25,Matches,Edu Expósito,M C,25,134,143,Spain,Espanyol,9,10,12,12,14,12,9,14,7,12,14,12,13,13,11,15,14,14,15,11,15,11,9,13,10,14,13,13,13,12,12,8,11,13,12,11,16,11,13,11,13,2,3,2,1,4,1,2,2,3,1,3,14,9,7,13,11,11,11,18,1,1,1,1,1,1,14,1,20,1,1,14,1,1,179,0,13,20,6242651,6550,6550,4700,Mediterranean_Hispanic,134,6,1996/8/1,0,0,11317.0,,67224139
625,Fali,Cádiz,1993,169.0,es ESP,DFMF,28.0,19.0,27.0,19.0,19.0,8.0,0.0,18.0,29.0,62.1,11.0,24.0,15.0,9.0,13.0,40.0,70.0,1.0,Matches,169.0,es ESP,DFMF,28.0,19.0,11.0,0.58,9.0,1.0,0.0,0.0,1.0,0.0,1.0,0.05,1.0,0.0,0.0,0.0,0.0,0.0,Matches,,,,,,,,,,,,,,,,,,,,,,,,,,,,,,,,,,,,,,,,,,,,,,,,,,,,,,,,169.0,es ESP,DFMF,28.0,19.0,6.0,0.0,0.0,16.0,18.0,1.0,2.0,13.0,19.0,0.0,0.0,0.0,95.0,26.0,26.0,50.0,Matches,169.0,es ESP,DFMF,28.0,19.0,593.0,567.0,25.0,25.0,2.0,13.0,2.0,0.0,0.0,0.0,0.0,0.0,455.0,1.0,4.0,Matches,169.0,es ESP,DFMF,28.0,19.0,455.0,593.0,76.7,10475.0,4321.0,117.0,133.0,88.0,239.0,281.0,85.1,97.0,165.0,58.8,0.0,0.2,0.2,-0.2,4.0,49.0,4.0,0.0,56.0,Matches,208,es ESP,DFMF,28,25,1714.0,69.0,50.1,19.0,22,73.0,11,3,33.0,6,1.16,17.0,25.0,-8.0,-0.42,0.37,20.3,27.9,-7.6,-0.4,0.26,Matches,169.0,es ESP,DFMF,28.0,19.0,766.0,109.0,380.0,351.0,39.0,15.0,766.0,5.0,2.0,40.0,2.0,40.0,392.0,2170.0,1337.0,9.0,3.0,0.0,8.0,1.0,408.0,10.0,Matches,169.0,es ESP,DFMF,28.0,19.0,0.0,9.0,0.0,0.0,0.47,0.0,0.0,,16.6,0.0,0.0,0.0,0.6,0.6,0.07,-0.6,-0.6,Matches,169.0,es ESP,DFMF,28.0,25.0,22.0,1714.0,19.0,0.0,0.0,0.0,0.0,0.0,0.0,6.0,0.0,0.6,0.6,0.2,0.8,9.0,56.0,10.0,0.0,0.0,0.0,0.0,0.0,0.03,0.01,0.04,0.03,0.04,Matches,Fali,D/DM C,28,121,126,Spain,Cádiz,5,9,8,5,9,10,11,9,12,12,9,8,12,5,14,14,17,13,13,11,12,18,7,17,10,12,18,18,11,9,14,14,14,12,15,17,15,12,13,6,11,3,1,2,2,1,2,1,1,3,1,3,12,14,2,15,13,14,12,17,1,1,20,1,1,1,17,1,8,1,1,1,1,1,186,84,8,20,1068609,6000,6150,3450,Mediterranean_Hispanic,121,12,1993/8/12,0,0,7111.0,,67155014
626,Ansu Fati,Barcelona,2002,171.0,es ESP,FW,19.0,15.5,16.0,9.0,8.0,4.0,4.0,5.0,18.0,27.8,13.0,19.0,0.0,19.0,5.0,21.0,6.0,0.0,Matches,171.0,es ESP,FW,19.0,15.5,50.0,3.23,35.0,1.0,8.0,5.0,0.0,1.0,7.0,0.45,4.0,0.0,1.0,2.0,0.0,0.0,Matches,,,,,,,,,,,,,,,,,,,,,,,,,,,,,,,,,,,,,,,,,,,,,,,,,,,,,,,,171.0,es ESP,FW,19.0,15.5,3.0,0.0,0.0,18.0,13.0,10.0,9.0,5.0,9.0,0.0,0.0,0.0,65.0,7.0,14.0,33.3,Matches,171.0,es ESP,FW,19.0,15.5,609.0,590.0,14.0,3.0,1.0,3.0,9.0,3.0,5.0,1.0,0.0,0.0,509.0,5.0,21.0,Matches,171.0,es ESP,FW,19.0,15.5,509.0,609.0,83.6,6451.0,1024.0,359.0,398.0,90.2,114.0,136.0,83.8,18.0,23.0,78.3,3.0,1.7,2.3,1.3,16.0,23.0,19.0,1.0,48.0,Matches,211,es ESP,FW,19,36,1393.0,39.0,40.7,15.5,12,71.0,1,24,22.0,1,2.36,36.0,5.0,31.0,2.0,1.16,31.8,13.1,18.7,1.21,0.16,Matches,171.0,es ESP,FW,19.0,15.5,805.0,10.0,64.0,278.0,469.0,128.0,805.0,47.0,23.0,48.9,21.0,44.7,556.0,2983.0,1399.0,47.0,28.0,31.0,35.0,30.0,639.0,178.0,Matches,171.0,es ESP,FW,19.0,15.5,7.0,61.0,18.0,29.5,3.94,1.16,0.11,0.39,15.0,3.0,0.0,0.0,9.1,9.1,0.16,-2.1,-2.1,Matches,171.0,es ESP,FW,19.0,36.0,12.0,1393.0,15.5,7.0,3.0,10.0,7.0,0.0,0.0,3.0,0.0,9.1,9.1,1.7,10.7,47.0,48.0,178.0,0.45,0.19,0.65,0.45,0.65,0.59,0.11,0.69,0.59,0.69,Matches,Ansu Fati,AM/S RL,19,149,-95,"Spain,Guinea-Bissau",Barcelona,7,13,16,16,14,7,11,14,6,4,12,12,5,16,8,14,12,14,13,14,13,16,19,9,16,5,10,10,16,17,13,8,15,15,11,10,14,5,15,14,15,3,2,1,3,3,1,1,1,2,2,1,15,14,5,15,15,14,13,15,1,1,1,1,1,1,1,14,1,13,20,10,19,19,178,66,12,20,74100001,7800,7800,6900,African_Caribbean,143,16,2002/10/31,4,1,230768.0,,67276122
627,Nabil Fekir,Betis,1993,173.0,fr FRA,MF,29.0,10.7,11.0,5.0,3.0,3.0,5.0,2.0,9.0,22.2,7.0,6.0,2.0,4.0,1.0,12.0,0.0,0.0,Matches,173.0,fr FRA,MF,29.0,10.7,56.0,5.24,31.0,10.0,4.0,2.0,9.0,0.0,5.0,0.47,2.0,0.0,1.0,0.0,2.0,0.0,Matches,,,,,,,,,,,,,,,,,,,,,,,,,,,,,,,,,,,,,,,,,,,,,,,,,,,,,,,,173.0,fr FRA,MF,29.0,10.7,4.0,1.0,0.0,21.0,39.0,7.0,48.0,1.0,5.0,1.0,0.0,0.0,31.0,8.0,11.0,42.1,Matches,173.0,fr FRA,MF,29.0,10.7,484.0,416.0,66.0,27.0,2.0,3.0,48.0,4.0,33.0,13.0,16.0,0.0,378.0,2.0,7.0,Matches,173.0,fr FRA,MF,29.0,10.7,378.0,484.0,78.1,4746.0,1367.0,226.0,258.0,87.6,90.0,107.0,84.1,18.0,55.0,32.7,2.0,2.7,2.4,-0.7,23.0,34.0,14.0,1.0,41.0,Matches,213,fr FRA,MF,29,15,961.0,64.0,28.1,10.7,12,73.0,5,3,28.0,0,1.73,19.0,10.0,9.0,0.84,0.99,19.9,10.1,9.7,0.91,1.22,Matches,173.0,fr FRA,MF,29.0,10.7,607.0,2.0,37.0,254.0,321.0,43.0,606.0,44.0,17.0,38.6,19.0,43.2,406.0,2332.0,1072.0,42.0,27.0,13.0,34.0,22.0,489.0,76.0,Matches,173.0,fr FRA,MF,29.0,10.7,2.0,24.0,6.0,25.0,2.25,0.56,0.04,0.17,21.5,9.0,1.0,1.0,2.4,1.6,0.07,-0.4,-0.6,Matches,173.0,fr FRA,MF,29.0,15.0,12.0,961.0,10.7,2.0,2.0,4.0,1.0,1.0,1.0,4.0,1.0,2.4,1.6,2.7,4.4,42.0,41.0,76.0,0.19,0.19,0.37,0.09,0.28,0.23,0.26,0.48,0.15,0.41,Matches,Nabil Fekir,AM/S RLC,29,153,158,"France,Algeria",Real Hispalis,15,13,16,15,16,15,6,14,4,5,16,13,5,17,10,13,12,15,13,16,15,16,16,16,14,8,12,12,15,16,16,5,12,15,14,17,12,12,16,10,13,2,1,2,2,1,3,3,3,4,3,2,10,15,9,13,12,14,9,10,1,1,1,1,1,1,1,1,12,1,16,20,16,17,173,72,20,6,43312502,7650,7400,7000,North_African__Middle_Eastern,153,11,1993/7/18,25,2,123288.0,,29114975
628,Luiz Felipe,Betis,1997,175.0,it ITA,DF,25.0,19.6,34.0,23.0,23.0,11.0,0.0,18.0,34.0,52.9,16.0,43.0,24.0,19.0,28.0,62.0,106.0,0.0,Matches,175.0,it ITA,DF,25.0,19.6,7.0,0.36,6.0,0.0,0.0,1.0,0.0,0.0,1.0,0.05,1.0,0.0,0.0,0.0,0.0,0.0,Matches,,,,,,,,,,,,,,,,,,,,,,,,,,,,,,,,,,,,,,,,,,,,,,,,,,,,,,,,175.0,it ITA,DF,25.0,19.6,3.0,3.0,0.0,10.0,10.0,0.0,2.0,28.0,23.0,0.0,0.0,0.0,80.0,31.0,36.0,46.3,Matches,175.0,it ITA,DF,25.0,19.6,884.0,843.0,39.0,36.0,0.0,9.0,2.0,3.0,0.0,0.0,0.0,0.0,753.0,2.0,11.0,Matches,175.0,it ITA,DF,25.0,19.6,753.0,884.0,85.2,13198.0,5133.0,306.0,336.0,91.1,356.0,397.0,89.7,69.0,111.0,62.2,0.0,0.3,0.3,-0.3,3.0,33.0,1.0,1.0,42.0,Matches,215,it ITA,DF,25,23,1763.0,77.0,51.5,19.6,22,79.0,16,1,16.0,3,1.35,23.0,23.0,0.0,0.0,-0.27,27.6,25.3,2.3,0.12,0.18,Matches,175.0,it ITA,DF,25.0,19.6,1130.0,182.0,601.0,507.0,23.0,7.0,1130.0,9.0,5.0,55.6,4.0,44.4,586.0,2625.0,1212.0,1.0,1.0,0.0,9.0,0.0,664.0,0.0,Matches,175.0,it ITA,DF,25.0,19.6,0.0,3.0,1.0,33.3,0.15,0.05,0.0,0.0,11.2,0.0,0.0,0.0,0.2,0.2,0.06,-0.2,-0.2,Matches,175.0,it ITA,DF,25.0,23.0,22.0,1763.0,19.6,0.0,0.0,0.0,0.0,0.0,0.0,3.0,3.0,0.2,0.2,0.3,0.5,1.0,42.0,0.0,0.0,0.0,0.0,0.0,0.0,0.01,0.02,0.03,0.01,0.03,Matches,Luiz Felipe,D C,25,146,150,"Italy,Brazil",Real Hispalis,4,3,9,5,12,3,16,3,3,15,12,6,18,13,18,17,20,11,10,13,11,15,12,7,9,15,17,16,13,14,16,14,16,14,15,14,12,11,15,13,12,2,3,3,1,1,2,3,1,1,1,2,15,15,6,12,12,15,15,13,1,11,20,11,1,1,1,1,1,1,1,1,1,1,187,76,14,20,21665069,7300,7300,6100,Mixed_Race,145,4,1997/3/22,1,0,32884.0,,19225765
629,Kiko Femenía,Villarreal,1991,177.0,es ESP,DF,31.0,12.6,18.0,9.0,14.0,3.0,1.0,13.0,18.0,72.2,5.0,15.0,6.0,9.0,20.0,38.0,22.0,0.0,Matches,177.0,es ESP,DF,31.0,12.6,24.0,1.9,23.0,0.0,0.0,0.0,1.0,0.0,0.0,0.0,0.0,0.0,0.0,0.0,0.0,0.0,Matches,,,,,,,,,,,,,,,,,,,,,,,,,,,,,,,,,,,,,,,,,,,,,,,,,,,,,,,,177.0,es ESP,DF,31.0,12.6,0.0,0.0,0.0,6.0,8.0,0.0,31.0,20.0,9.0,0.0,0.0,0.0,61.0,9.0,6.0,60.0,Matches,177.0,es ESP,DF,31.0,12.6,778.0,661.0,114.0,16.0,0.0,1.0,31.0,97.0,1.0,0.0,0.0,0.0,667.0,3.0,14.0,Matches,177.0,es ESP,DF,31.0,12.6,667.0,778.0,85.7,10318.0,2945.0,344.0,371.0,92.7,273.0,308.0,88.6,32.0,62.0,51.6,0.0,0.7,0.4,-0.7,9.0,49.0,10.0,4.0,66.0,Matches,217,es ESP,DF,31,20,1133.0,57.0,33.1,12.6,13,78.0,6,7,17.0,9,1.45,13.0,14.0,-1.0,-0.08,-0.87,17.9,16.0,1.9,0.15,-0.24,Matches,177.0,es ESP,DF,31.0,12.6,877.0,41.0,299.0,377.0,211.0,8.0,877.0,13.0,6.0,46.2,4.0,30.8,508.0,2763.0,1461.0,36.0,27.0,1.0,8.0,9.0,570.0,47.0,Matches,177.0,es ESP,DF,31.0,12.6,0.0,2.0,0.0,0.0,0.16,0.0,0.0,,23.7,0.0,0.0,0.0,0.1,0.1,0.03,-0.1,-0.1,Matches,177.0,es ESP,DF,31.0,20.0,13.0,1133.0,12.6,0.0,0.0,0.0,0.0,0.0,0.0,0.0,0.0,0.1,0.1,0.7,0.7,36.0,66.0,47.0,0.0,0.0,0.0,0.0,0.0,0.0,0.05,0.06,0.0,0.06,Matches,Kiko Femenía,D/WB/M R,31,134,141,Spain,Villarreal,10,14,13,9,12,9,8,9,14,10,14,11,13,14,9,9,13,10,12,12,12,11,13,9,12,12,10,11,16,11,12,8,14,16,13,9,13,6,11,6,16,3,2,2,2,1,3,2,3,2,3,1,12,12,11,13,8,14,16,7,1,14,1,18,14,20,1,12,1,16,11,1,11,1,176,71,13,20,6273716,6700,6700,5250,Mediterranean_Hispanic,126,6,1991/2/2,0,0,16393.0,,67063051
630,Aitor Fernández,Osasuna,1991,178.0,es ESP,GK,31.0,21.0,1.0,1.0,1.0,0.0,0.0,0.0,1.0,0.0,1.0,0.0,0.0,0.0,2.0,3.0,17.0,0.0,Matches,178.0,es ESP,GK,31.0,21.0,4.0,0.19,2.0,2.0,0.0,0.0,0.0,0.0,1.0,0.05,1.0,0.0,0.0,0.0,0.0,0.0,Matches,11.0,es ESP,GK,31.0,21.0,19.0,0.0,0.0,0.0,1.0,17.7,0.24,-0.3,-0.01,191.0,438.0,43.6,615.0,87.0,50.9,41.1,174.0,71.8,54.2,319.0,14.0,4.4,37.0,1.76,16.3,Matches,11.0,es ESP,GK,31.0,21.0,21.0,1890.0,21.0,19.0,0.9,77.0,59.0,75.3,10.0,5.0,6.0,8.0,38.1,0.0,0.0,0.0,0.0,,Matches,178.0,es ESP,GK,31.0,21.0,1.0,0.0,0.0,0.0,0.0,0.0,0.0,2.0,1.0,0.0,0.0,0.0,27.0,3.0,1.0,75.0,Matches,178.0,es ESP,GK,31.0,21.0,793.0,528.0,261.0,87.0,0.0,2.0,0.0,0.0,0.0,0.0,0.0,0.0,518.0,4.0,0.0,Matches,178.0,es ESP,GK,31.0,21.0,518.0,793.0,65.3,18920.0,16063.0,44.0,45.0,97.8,205.0,212.0,96.7,269.0,531.0,50.7,0.0,0.0,0.1,0.0,0.0,33.0,0.0,0.0,1.0,Matches,218,es ESP,GK,31,21,1890.0,90.0,55.3,21.0,21,90.0,21,0,,17,1.67,23.0,19.0,4.0,0.19,0.72,20.6,24.3,-3.6,-0.17,-0.04,Matches,178.0,es ESP,GK,31.0,21.0,846.0,701.0,835.0,11.0,0.0,0.0,846.0,0.0,0.0,,0.0,,443.0,2217.0,1515.0,0.0,0.0,0.0,1.0,0.0,335.0,0.0,Matches,178.0,es ESP,GK,31.0,21.0,0.0,0.0,0.0,,0.0,0.0,,,,0.0,0.0,0.0,0.0,0.0,,0.0,0.0,Matches,178.0,es ESP,GK,31.0,21.0,21.0,1890.0,21.0,0.0,0.0,0.0,0.0,0.0,0.0,1.0,0.0,0.0,0.0,0.0,0.0,0.0,1.0,0.0,0.0,0.0,0.0,0.0,0.0,0.0,0.0,0.0,0.0,0.0,Matches,Aitor Fernández,GK,31,139,145,"Spain,Pays Basque",Atlético Pamplona,2,2,1,1,10,1,9,1,1,1,11,3,3,10,12,14,12,13,14,9,14,14,3,9,3,13,14,12,12,14,12,12,14,11,12,10,14,8,14,8,1,13,13,14,5,13,13,15,16,14,8,13,14,13,8,12,14,14,14,10,20,1,1,1,1,1,1,1,1,1,1,1,1,1,182,78,10,20,347975206,6891,6891,5391,Mediterranean_Hispanic,138,6,1991/5/3,0,0,25449.0,,67054783
631,Álex Fernández,Cádiz,1992,179.0,es ESP,MFFW,29.0,17.5,13.0,7.0,6.0,4.0,3.0,4.0,14.0,28.6,10.0,14.0,1.0,13.0,8.0,21.0,19.0,0.0,Matches,179.0,es ESP,MFFW,29.0,17.5,39.0,2.23,27.0,10.0,1.0,0.0,1.0,0.0,1.0,0.06,1.0,0.0,0.0,0.0,0.0,0.0,Matches,,,,,,,,,,,,,,,,,,,,,,,,,,,,,,,,,,,,,,,,,,,,,,,,,,,,,,,,179.0,es ESP,MFFW,29.0,17.5,0.0,0.0,0.0,7.0,14.0,0.0,37.0,8.0,7.0,0.0,0.0,0.0,77.0,12.0,30.0,28.6,Matches,179.0,es ESP,MFFW,29.0,17.5,720.0,656.0,63.0,34.0,2.0,10.0,37.0,1.0,21.0,8.0,6.0,0.0,602.0,1.0,7.0,Matches,179.0,es ESP,MFFW,29.0,17.5,602.0,720.0,83.6,10263.0,3036.0,305.0,329.0,92.7,207.0,237.0,87.3,74.0,120.0,61.7,0.0,1.6,1.9,-1.6,17.0,57.0,6.0,2.0,69.0,Matches,219,es ESP,MFFW,29,28,1576.0,56.0,46.1,17.5,17,78.0,9,11,23.0,3,1.11,12.0,26.0,-14.0,-0.8,-0.36,17.2,29.6,-12.4,-0.71,-0.33,Matches,179.0,es ESP,MFFW,29.0,17.5,850.0,38.0,174.0,482.0,198.0,25.0,849.0,11.0,5.0,45.5,4.0,36.4,482.0,2226.0,983.0,19.0,21.0,3.0,18.0,24.0,583.0,26.0,Matches,179.0,es ESP,MFFW,29.0,17.5,3.0,16.0,8.0,50.0,0.91,0.46,0.13,0.25,12.9,0.0,1.0,1.0,2.7,1.9,0.12,0.3,0.1,Matches,179.0,es ESP,MFFW,29.0,28.0,17.0,1576.0,17.5,3.0,0.0,3.0,2.0,1.0,1.0,0.0,0.0,2.7,1.9,1.6,3.4,19.0,69.0,26.0,0.17,0.0,0.17,0.11,0.11,0.15,0.09,0.24,0.11,0.2,Matches,Álex Fernández,M/AM RLC,29,129,142,Spain,Cádiz,12,12,12,10,15,10,8,11,8,9,17,16,9,15,9,14,11,12,12,15,14,15,12,13,13,10,14,12,11,10,11,9,14,11,12,11,12,8,11,6,15,3,1,1,2,1,3,1,3,3,2,1,13,12,5,15,12,16,10,10,1,1,1,5,1,1,14,15,19,18,5,20,9,1,182,72,12,20,6926575,6697,6697,4347,Mediterranean_Hispanic,125,3,1992/10/15,0,0,22055.0,,67085790
632,Álvaro Fernández,Espanyol,1998,180.0,es ESP,GK,24.0,11.0,0.0,0.0,0.0,0.0,0.0,0.0,0.0,,0.0,0.0,0.0,0.0,0.0,0.0,7.0,2.0,Matches,180.0,es ESP,GK,24.0,11.0,1.0,0.09,0.0,1.0,0.0,0.0,0.0,0.0,0.0,0.0,0.0,0.0,0.0,0.0,0.0,0.0,Matches,12.0,es ESP,GK,24.0,11.0,18.0,0.0,0.0,4.0,1.0,15.2,0.31,-1.8,-0.17,104.0,221.0,47.1,253.0,37.0,55.7,42.5,103.0,77.7,54.8,153.0,5.0,3.3,15.0,1.36,16.3,Matches,12.0,es ESP,GK,24.0,11.0,11.0,990.0,11.0,18.0,1.64,50.0,33.0,64.0,3.0,4.0,4.0,2.0,18.2,0.0,0.0,0.0,0.0,,Matches,180.0,es ESP,GK,24.0,11.0,1.0,0.0,0.0,0.0,2.0,0.0,0.0,0.0,0.0,0.0,0.0,0.0,15.0,2.0,1.0,66.7,Matches,180.0,es ESP,GK,24.0,11.0,358.0,203.0,153.0,50.0,0.0,2.0,0.0,0.0,0.0,0.0,0.0,0.0,231.0,2.0,0.0,Matches,180.0,es ESP,GK,24.0,11.0,231.0,358.0,64.5,8998.0,7511.0,19.0,19.0,100.0,83.0,85.0,97.6,129.0,252.0,51.2,0.0,0.2,0.1,-0.2,1.0,16.0,0.0,0.0,0.0,Matches,220,es ESP,GK,24,11,990.0,90.0,28.9,11.0,11,90.0,11,0,,23,1.33,17.0,18.0,-1.0,-0.09,0.5,13.5,15.3,-1.8,-0.16,0.2,Matches,180.0,es ESP,GK,24.0,11.0,382.0,296.0,375.0,7.0,0.0,0.0,382.0,0.0,0.0,,0.0,,174.0,1053.0,714.0,0.0,0.0,0.0,0.0,1.0,124.0,0.0,Matches,180.0,es ESP,GK,24.0,11.0,0.0,0.0,0.0,,0.0,0.0,,,,0.0,0.0,0.0,0.0,0.0,,0.0,0.0,Matches,180.0,es ESP,GK,24.0,11.0,11.0,990.0,11.0,0.0,0.0,0.0,0.0,0.0,0.0,1.0,0.0,0.0,0.0,0.2,0.2,0.0,0.0,0.0,0.0,0.0,0.0,0.0,0.0,0.0,0.01,0.01,0.0,0.01,Matches,Álvaro Fernández,GK,24,133,148,"Spain,Pays Basque",Huesca,5,1,1,1,11,7,3,1,2,2,10,3,2,9,12,13,13,12,13,11,14,15,7,8,8,12,12,13,11,13,11,13,15,11,12,12,11,3,12,4,12,13,13,13,8,14,12,14,15,14,7,13,14,15,7,13,14,15,14,15,20,1,1,1,1,1,1,1,1,1,1,1,1,1,185,75,11,20,4438630,6650,6650,5400,Mediterranean_Hispanic,131,6,1998/4/13,1,0,14802.0,Espanyol,67246951
633,Fernando,Almería,1990,185.0,es ESP,GK,32.0,36.5,0.0,0.0,0.0,0.0,0.0,0.0,2.0,0.0,2.0,2.0,0.0,2.0,1.0,1.0,20.0,3.0,Matches,185.0,es ESP,GK,32.0,36.5,4.0,0.11,1.0,3.0,0.0,0.0,0.0,0.0,0.0,0.0,0.0,0.0,0.0,0.0,0.0,0.0,Matches,13.0,es ESP,GK,32.0,36.5,61.0,4.0,1.0,4.0,1.0,60.5,0.29,0.5,0.01,199.0,557.0,35.7,967.0,211.0,39.1,36.9,341.0,52.5,42.9,614.0,39.0,6.4,26.0,0.71,12.4,Matches,13.0,es ESP,GK,32.0,37.0,37.0,3285.0,36.5,61.0,1.67,193.0,132.0,70.5,11.0,8.0,18.0,4.0,10.8,6.0,4.0,1.0,1.0,20.0,Matches,185.0,es ESP,GK,32.0,36.5,3.0,0.0,0.0,0.0,6.0,0.0,0.0,1.0,0.0,0.0,0.0,0.0,35.0,2.0,1.0,66.7,Matches,185.0,es ESP,GK,32.0,36.5,1313.0,836.0,472.0,131.0,0.0,2.0,0.0,0.0,0.0,0.0,0.0,0.0,919.0,5.0,1.0,Matches,185.0,es ESP,GK,32.0,36.5,919.0,1313.0,70.0,27494.0,20366.0,132.0,133.0,99.2,440.0,448.0,98.2,342.0,721.0,47.4,0.0,0.0,0.0,0.0,0.0,16.0,0.0,0.0,0.0,Matches,226,es ESP,GK,32,37,3285.0,89.0,96.1,36.5,37,89.0,36,0,,1,1.11,48.0,61.0,-13.0,-0.36,1.64,44.2,60.3,-16.1,-0.44,0.18,Matches,185.0,es ESP,GK,32.0,36.5,1409.0,1270.0,1403.0,6.0,0.0,0.0,1409.0,1.0,1.0,100.0,0.0,0.0,703.0,3796.0,2345.0,0.0,0.0,0.0,0.0,0.0,536.0,0.0,Matches,185.0,es ESP,GK,32.0,36.5,0.0,0.0,0.0,,0.0,0.0,,,,0.0,0.0,0.0,0.0,0.0,,0.0,0.0,Matches,185.0,es ESP,GK,32.0,37.0,37.0,3285.0,36.5,0.0,0.0,0.0,0.0,0.0,0.0,3.0,0.0,0.0,0.0,0.0,0.0,0.0,0.0,0.0,0.0,0.0,0.0,0.0,0.0,0.0,0.0,0.0,0.0,0.0,Matches,Fernando,DM/M C,35,145,150,"Brazil,Portugal",Sevilla,7,9,11,8,12,8,13,10,10,14,13,12,15,12,14,18,15,16,17,13,16,15,6,14,13,18,19,15,10,10,14,13,14,12,14,14,18,13,14,10,10,3,2,1,4,1,2,2,2,4,1,1,16,13,5,17,16,16,13,13,1,1,12,1,1,1,20,1,18,1,1,1,1,1,183,76,8,20,347975206,7249,7249,6249,African_Caribbean,145,16,1987/7/25,0,0,34215.0,,2115577
634,Dimitri Foulquier,Valencia,1993,188.0,fr FRA,DF,29.0,19.3,31.0,19.0,17.0,8.0,6.0,20.0,28.0,71.4,8.0,19.0,3.0,16.0,14.0,45.0,40.0,0.0,Matches,188.0,fr FRA,DF,29.0,19.3,29.0,1.5,25.0,1.0,0.0,2.0,0.0,1.0,2.0,0.1,2.0,0.0,0.0,0.0,0.0,0.0,Matches,,,,,,,,,,,,,,,,,,,,,,,,,,,,,,,,,,,,,,,,,,,,,,,,,,,,,,,,188.0,fr FRA,DF,29.0,19.3,4.0,0.0,0.0,28.0,14.0,1.0,86.0,14.0,19.0,0.0,0.0,0.0,111.0,18.0,19.0,48.6,Matches,188.0,fr FRA,DF,29.0,19.3,932.0,712.0,217.0,22.0,0.0,2.0,86.0,194.0,1.0,0.0,0.0,0.0,663.0,3.0,37.0,Matches,188.0,fr FRA,DF,29.0,19.3,663.0,932.0,71.1,11039.0,4516.0,338.0,381.0,88.7,261.0,361.0,72.3,51.0,120.0,42.5,2.0,1.7,2.0,0.3,12.0,61.0,21.0,14.0,70.0,Matches,230,fr FRA,DF,29,30,1738.0,58.0,50.8,19.3,17,88.0,15,13,19.0,8,1.17,17.0,24.0,-7.0,-0.36,-0.58,19.8,25.3,-5.5,-0.28,-0.89,Matches,188.0,fr FRA,DF,29.0,19.3,1116.0,59.0,306.0,491.0,332.0,20.0,1116.0,42.0,19.0,45.2,22.0,52.4,557.0,3479.0,2048.0,51.0,34.0,7.0,33.0,9.0,591.0,84.0,Matches,188.0,fr FRA,DF,29.0,19.3,0.0,3.0,0.0,0.0,0.16,0.0,0.0,,13.3,0.0,0.0,0.0,0.2,0.2,0.05,-0.2,-0.2,Matches,188.0,fr FRA,DF,29.0,30.0,17.0,1738.0,19.3,0.0,2.0,2.0,0.0,0.0,0.0,4.0,0.0,0.2,0.2,1.7,1.8,51.0,70.0,84.0,0.0,0.1,0.1,0.0,0.1,0.01,0.09,0.09,0.01,0.09,Matches,Dimitri Foulquier,D RL,29,135,138,"Guadeloupe,France",Valencia,9,13,12,9,12,6,9,9,11,13,11,7,12,12,11,12,14,13,13,11,13,14,11,7,13,13,12,13,16,13,14,11,15,15,14,14,13,10,13,7,16,2,1,3,3,3,1,3,4,3,3,2,12,13,5,13,10,14,15,15,1,18,1,20,14,15,1,10,1,12,9,1,10,1,183,77,10,20,8499721,6750,6750,4350,African_Caribbean,132,15,1993/3/23,2,0,9000.0,,85045661
635,Juan Foyth,Villarreal,1998,189.0,ar ARG,DF,24.0,21.8,73.0,48.0,49.0,22.0,2.0,41.0,57.0,71.9,16.0,32.0,11.0,21.0,20.0,93.0,68.0,0.0,Matches,189.0,ar ARG,DF,24.0,21.8,29.0,1.33,28.0,1.0,0.0,0.0,0.0,0.0,2.0,0.09,2.0,0.0,0.0,0.0,0.0,0.0,Matches,,,,,,,,,,,,,,,,,,,,,,,,,,,,,,,,,,,,,,,,,,,,,,,,,,,,,,,,189.0,ar ARG,DF,24.0,21.8,6.0,0.0,0.0,40.0,9.0,0.0,10.0,20.0,48.0,0.0,1.0,0.0,125.0,36.0,22.0,62.1,Matches,189.0,ar ARG,DF,24.0,21.8,1276.0,1058.0,211.0,41.0,4.0,14.0,10.0,170.0,0.0,0.0,0.0,0.0,1116.0,7.0,13.0,Matches,189.0,ar ARG,DF,24.0,21.8,1116.0,1276.0,87.5,18588.0,7017.0,571.0,619.0,92.2,438.0,480.0,91.3,91.0,132.0,68.9,0.0,1.6,1.4,-1.6,13.0,90.0,13.0,3.0,100.0,Matches,231,ar ARG,DF,24,24,1958.0,82.0,57.3,21.8,22,86.0,17,2,36.0,3,1.92,41.0,24.0,17.0,0.78,0.66,36.7,30.1,6.6,0.3,-0.01,Matches,189.0,ar ARG,DF,24.0,21.8,1545.0,109.0,516.0,783.0,264.0,21.0,1545.0,48.0,27.0,56.3,18.0,37.5,778.0,4537.0,2657.0,47.0,36.0,1.0,21.0,15.0,895.0,18.0,Matches,189.0,ar ARG,DF,24.0,21.8,1.0,14.0,4.0,28.6,0.64,0.18,0.07,0.25,13.7,0.0,0.0,0.0,1.1,1.1,0.08,-0.1,-0.1,Matches,189.0,ar ARG,DF,24.0,24.0,22.0,1958.0,21.8,1.0,0.0,1.0,1.0,0.0,0.0,6.0,0.0,1.1,1.1,1.6,2.7,47.0,100.0,18.0,0.05,0.0,0.05,0.05,0.05,0.05,0.08,0.13,0.05,0.13,Matches,Juan Foyth,D/DM RC,24,145,157,"Argentina,Spain",Villarreal,7,11,13,8,15,11,15,7,8,14,14,8,16,15,14,13,16,16,12,13,11,12,12,10,13,14,15,16,13,14,14,13,13,14,15,13,11,13,13,6,12,1,3,1,2,1,1,1,3,1,1,2,15,11,7,10,12,13,10,14,1,1,19,20,1,10,16,1,1,1,1,1,1,1,187,69,11,20,23749899,7250,7250,5250,Northern_European,144,4,1998/1/12,15,0,33574.0,,14186894
636,Iván Fresneda,Valladolid,2004,190.0,es ESP,DF,17.0,19.4,48.0,34.0,31.0,13.0,4.0,29.0,47.0,61.7,18.0,32.0,8.0,24.0,15.0,63.0,60.0,0.0,Matches,190.0,es ESP,DF,17.0,19.4,39.0,1.98,33.0,4.0,0.0,0.0,1.0,1.0,3.0,0.15,1.0,1.0,0.0,0.0,1.0,0.0,Matches,,,,,,,,,,,,,,,,,,,,,,,,,,,,,,,,,,,,,,,,,,,,,,,,,,,,,,,,190.0,es ESP,DF,17.0,19.4,3.0,0.0,0.0,13.0,25.0,0.0,59.0,15.0,34.0,0.0,0.0,0.0,103.0,8.0,18.0,30.8,Matches,190.0,es ESP,DF,17.0,19.4,922.0,729.0,190.0,19.0,1.0,0.0,59.0,171.0,0.0,0.0,0.0,0.0,710.0,3.0,30.0,Matches,190.0,es ESP,DF,17.0,19.4,710.0,922.0,77.0,11295.0,3707.0,366.0,413.0,88.6,264.0,336.0,78.6,56.0,108.0,51.9,0.0,1.5,1.2,-1.5,18.0,55.0,16.0,11.0,62.0,Matches,232,es ESP,DF,17,22,1743.0,79.0,51.0,19.4,18,85.0,15,4,51.0,12,0.86,20.0,34.0,-14.0,-0.72,0.14,19.9,35.8,-15.9,-0.81,-0.22,Matches,190.0,es ESP,DF,17.0,19.4,1163.0,87.0,390.0,497.0,284.0,16.0,1163.0,42.0,15.0,35.7,19.0,45.2,563.0,3218.0,1672.0,48.0,26.0,7.0,22.0,18.0,625.0,101.0,Matches,190.0,es ESP,DF,17.0,19.4,0.0,4.0,0.0,0.0,0.21,0.0,0.0,,17.8,0.0,0.0,0.0,0.6,0.6,0.15,-0.6,-0.6,Matches,190.0,es ESP,DF,17.0,22.0,18.0,1743.0,19.4,0.0,0.0,0.0,0.0,0.0,0.0,3.0,0.0,0.6,0.6,1.5,2.1,48.0,62.0,101.0,0.0,0.0,0.0,0.0,0.0,0.03,0.08,0.11,0.03,0.11,Matches,Iván Fresneda,D R,17,95,-8,Spain,Valladolid,8,6,9,8,10,3,10,5,3,11,10,8,15,10,12,11,11,10,12,6,13,12,5,10,9,8,14,14,14,12,10,8,15,11,11,6,11,9,9,7,14,2,3,1,2,2,1,2,3,2,2,2,19,9,4,13,10,13,10,12,1,1,1,20,1,1,1,1,1,1,1,1,1,1,184,75,5,20,11424001,4746,4746,2780,Mediterranean_Hispanic,87,3,2004/9/28,0,0,856.0,,2000165653
637,Javi Galán,Celta Vigo,1994,191.0,es ESP,DF,27.0,35.1,104.0,72.0,60.0,40.0,4.0,48.0,98.0,49.0,50.0,54.0,5.0,49.0,41.0,145.0,63.0,1.0,Matches,191.0,es ESP,DF,27.0,35.1,93.0,2.65,70.0,14.0,4.0,1.0,2.0,2.0,4.0,0.11,3.0,0.0,0.0,0.0,0.0,1.0,Matches,,,,,,,,,,,,,,,,,,,,,,,,,,,,,,,,,,,,,,,,,,,,,,,,,,,,,,,,191.0,es ESP,DF,27.0,35.1,6.0,0.0,0.0,50.0,73.0,8.0,162.0,41.0,72.0,0.0,1.0,0.0,211.0,33.0,24.0,57.9,Matches,191.0,es ESP,DF,27.0,35.1,2039.0,1600.0,427.0,56.0,2.0,19.0,162.0,344.0,27.0,15.0,7.0,0.0,1577.0,12.0,47.0,Matches,191.0,es ESP,DF,27.0,35.1,1577.0,2039.0,77.3,26915.0,8515.0,750.0,845.0,88.8,655.0,791.0,82.8,143.0,293.0,48.8,3.0,4.1,4.2,-1.1,52.0,76.0,56.0,28.0,125.0,Matches,235,es ESP,DF,27,37,3160.0,85.0,92.4,35.1,36,87.0,32,1,15.0,0,1.16,42.0,49.0,-7.0,-0.2,0.84,40.0,41.3,-1.2,-0.03,0.52,Matches,191.0,es ESP,DF,27.0,35.1,2506.0,87.0,712.0,1045.0,788.0,35.0,2506.0,154.0,72.0,46.8,61.0,39.6,1445.0,9172.0,5506.0,141.0,104.0,19.0,64.0,41.0,1492.0,244.0,Matches,191.0,es ESP,DF,27.0,35.1,0.0,13.0,1.0,7.7,0.37,0.03,0.0,0.0,22.4,0.0,0.0,0.0,0.6,0.6,0.05,-0.6,-0.6,Matches,191.0,es ESP,DF,27.0,37.0,36.0,3160.0,35.1,0.0,3.0,3.0,0.0,0.0,0.0,6.0,0.0,0.6,0.6,4.1,4.6,141.0,125.0,244.0,0.0,0.09,0.09,0.0,0.09,0.02,0.12,0.13,0.02,0.13,Matches,Javi Galán,D/WB L,27,149,155,Spain,Vigo,13,16,16,11,11,11,6,7,13,11,14,9,15,13,14,15,14,12,13,12,14,16,13,10,14,14,15,17,15,15,14,9,15,14,16,12,16,6,16,3,15,1,1,3,2,3,3,1,2,3,1,3,12,13,3,15,15,18,15,11,1,20,1,1,20,1,1,13,1,1,8,1,1,1,172,0,20,7,13198635,6997,6997,4747,Mediterranean_Hispanic,143,6,1994/11/19,0,0,28766.0,,67243881
638,Aleix García,Girona,1997,193.0,es ESP,MF,25.0,26.0,37.0,20.0,9.0,18.0,10.0,15.0,33.0,45.5,18.0,24.0,8.0,16.0,31.0,68.0,35.0,1.0,Matches,193.0,es ESP,MF,25.0,26.0,125.0,4.82,69.0,47.0,3.0,3.0,0.0,3.0,16.0,0.62,10.0,3.0,1.0,0.0,0.0,2.0,Matches,,,,,,,,,,,,,,,,,,,,,,,,,,,,,,,,,,,,,,,,,,,,,,,,,,,,,,,,193.0,es ESP,MF,25.0,26.0,1.0,0.0,0.0,14.0,29.0,1.0,179.0,31.0,20.0,0.0,0.0,0.0,132.0,13.0,6.0,68.4,Matches,193.0,es ESP,MF,25.0,26.0,1657.0,1441.0,203.0,101.0,3.0,43.0,179.0,13.0,88.0,35.0,42.0,1.0,1370.0,13.0,22.0,Matches,193.0,es ESP,MF,25.0,26.0,1370.0,1657.0,82.7,24515.0,7738.0,661.0,710.0,93.1,471.0,536.0,87.9,182.0,303.0,60.1,5.0,6.2,6.0,-1.2,64.0,154.0,23.0,10.0,156.0,Matches,238,es ESP,MF,25,30,2337.0,78.0,68.3,26.0,26,83.0,18,4,46.0,0,1.13,39.0,37.0,2.0,0.08,-0.01,35.9,32.4,3.5,0.13,0.78,Matches,193.0,es ESP,MF,25.0,26.0,1867.0,68.0,386.0,1003.0,490.0,23.0,1867.0,26.0,13.0,50.0,9.0,34.6,1041.0,4868.0,2266.0,41.0,35.0,7.0,19.0,12.0,1302.0,76.0,Matches,193.0,es ESP,MF,25.0,26.0,1.0,32.0,14.0,43.8,1.23,0.54,0.03,0.07,23.2,4.0,0.0,0.0,1.8,1.8,0.06,-0.8,-0.8,Matches,193.0,es ESP,MF,25.0,30.0,26.0,2337.0,26.0,1.0,5.0,6.0,1.0,0.0,0.0,1.0,0.0,1.8,1.8,6.2,8.0,41.0,156.0,76.0,0.04,0.19,0.23,0.04,0.23,0.07,0.24,0.31,0.07,0.31,Matches,Aleix García,DM/M C,25,124,142,Spain,Girona,12,12,13,9,14,13,7,11,2,7,14,10,9,14,10,12,11,14,13,15,14,12,14,11,14,12,14,14,11,12,14,8,14,12,12,10,13,7,12,6,11,2,3,3,3,1,2,3,2,2,3,3,12,11,8,12,13,16,14,13,1,1,1,1,1,1,18,10,20,10,10,14,10,1,173,68,12,20,1363599,6150,6150,4500,Mediterranean_Hispanic,124,6,1997/6/28,0,0,5408.0,,67190888
639,Álvaro García,Rayo Vallecano,1992,194.0,es ESP,FWMF,29.0,31.9,49.0,28.0,21.0,13.0,15.0,11.0,33.0,33.3,22.0,41.0,4.0,37.0,34.0,83.0,24.0,1.0,Matches,194.0,es ESP,FWMF,29.0,31.9,95.0,2.98,70.0,2.0,6.0,6.0,7.0,4.0,14.0,0.44,9.0,0.0,2.0,0.0,3.0,0.0,Matches,,,,,,,,,,,,,,,,,,,,,,,,,,,,,,,,,,,,,,,,,,,,,,,,,,,,,,,,194.0,es ESP,FWMF,29.0,31.9,7.0,0.0,0.0,36.0,32.0,12.0,159.0,34.0,28.0,2.0,0.0,0.0,184.0,12.0,8.0,60.0,Matches,194.0,es ESP,FWMF,29.0,31.9,1036.0,968.0,61.0,4.0,1.0,4.0,159.0,53.0,4.0,2.0,0.0,0.0,664.0,7.0,49.0,Matches,194.0,es ESP,FWMF,29.0,31.9,664.0,1036.0,64.1,10196.0,3009.0,383.0,473.0,81.0,214.0,337.0,63.5,46.0,128.0,35.9,5.0,5.7,4.9,-0.7,48.0,28.0,41.0,27.0,71.0,Matches,239,es ESP,FWMF,29,35,2870.0,82.0,83.9,31.9,34,84.0,15,1,28.0,0,1.31,35.0,41.0,-6.0,-0.19,0.14,37.0,40.4,-3.4,-0.11,0.39,Matches,194.0,es ESP,FWMF,29.0,31.9,1347.0,30.0,208.0,346.0,809.0,118.0,1347.0,52.0,21.0,40.4,25.0,48.1,785.0,4400.0,2237.0,116.0,28.0,45.0,52.0,17.0,834.0,293.0,Matches,194.0,es ESP,FWMF,29.0,31.9,5.0,52.0,21.0,40.4,1.63,0.66,0.1,0.24,17.7,0.0,0.0,0.0,3.6,3.6,0.07,1.4,1.4,Matches,194.0,es ESP,FWMF,29.0,35.0,34.0,2870.0,31.9,5.0,5.0,10.0,5.0,0.0,0.0,7.0,0.0,3.6,3.6,5.7,9.3,116.0,71.0,293.0,0.16,0.16,0.31,0.16,0.31,0.11,0.18,0.29,0.11,0.29,Matches,Álvaro García,M/AM/S RLC,29,141,142,Spain,Vallecano,9,11,13,11,12,8,6,10,5,7,11,9,7,13,10,13,12,10,11,11,11,11,12,8,14,8,12,13,18,14,11,5,14,17,12,8,12,6,13,10,11,2,1,2,3,1,3,2,3,3,2,1,19,8,4,10,12,14,9,10,1,9,1,4,10,7,1,19,1,14,20,15,17,16,168,58,20,9,9012919,7048,7048,5548,Mediterranean_Hispanic,125,6,1992/10/27,0,0,21126.0,,67184140
640,Dani García,Athletic Club,1990,197.0,es ESP,MF,32.0,16.5,46.0,27.0,17.0,25.0,4.0,29.0,47.0,61.7,18.0,21.0,6.0,15.0,19.0,65.0,21.0,1.0,Matches,197.0,es ESP,MF,32.0,16.5,23.0,1.39,20.0,0.0,0.0,0.0,1.0,2.0,4.0,0.24,4.0,0.0,0.0,0.0,0.0,0.0,Matches,,,,,,,,,,,,,,,,,,,,,,,,,,,,,,,,,,,,,,,,,,,,,,,,,,,,,,,,197.0,es ESP,MF,32.0,16.5,6.0,0.0,0.0,34.0,14.0,0.0,5.0,19.0,27.0,0.0,0.0,0.0,97.0,21.0,17.0,55.3,Matches,197.0,es ESP,MF,32.0,16.5,720.0,688.0,29.0,28.0,3.0,7.0,5.0,0.0,0.0,0.0,0.0,0.0,571.0,3.0,8.0,Matches,197.0,es ESP,MF,32.0,16.5,571.0,720.0,79.3,9716.0,2877.0,274.0,319.0,85.9,232.0,275.0,84.4,54.0,99.0,54.5,2.0,0.7,0.7,1.3,10.0,71.0,7.0,2.0,73.0,Matches,242,es ESP,MF,32,25,1485.0,59.0,43.4,16.5,18,77.0,6,7,15.0,6,1.44,24.0,19.0,5.0,0.3,0.35,23.6,18.2,5.5,0.33,-0.22,Matches,197.0,es ESP,MF,32.0,16.5,868.0,43.0,183.0,560.0,130.0,5.0,868.0,2.0,2.0,100.0,0.0,0.0,411.0,1289.0,514.0,6.0,6.0,0.0,6.0,4.0,497.0,8.0,Matches,197.0,es ESP,MF,32.0,16.5,0.0,9.0,0.0,0.0,0.55,0.0,0.0,,18.2,0.0,0.0,0.0,1.4,1.4,0.16,-1.4,-1.4,Matches,197.0,es ESP,MF,32.0,25.0,18.0,1485.0,16.5,0.0,2.0,2.0,0.0,0.0,0.0,6.0,0.0,1.4,1.4,0.7,2.1,6.0,73.0,8.0,0.0,0.12,0.12,0.0,0.12,0.09,0.04,0.13,0.09,0.13,Matches,Dani García,DM/M C,32,141,152,"Spain,Pays Basque",A. Bilbao,11,10,10,8,14,10,13,10,6,15,13,9,15,13,15,13,15,14,14,11,14,13,13,15,11,15,18,17,12,13,13,10,13,13,13,14,12,13,12,8,10,4,2,2,3,3,3,3,1,3,3,2,17,13,8,15,13,15,15,14,1,1,1,1,1,1,20,1,19,1,1,10,1,1,180,82,11,20,20511447,7050,7050,5550,Mediterranean_Hispanic,141,4,1990/5/24,0,0,24310.0,,67104797
641,David García,Osasuna,1994,198.0,es ESP,DF,28.0,29.8,34.0,20.0,22.0,12.0,0.0,19.0,22.0,86.4,3.0,28.0,13.0,15.0,45.0,79.0,151.0,0.0,Matches,198.0,es ESP,DF,28.0,29.8,19.0,0.64,19.0,0.0,0.0,0.0,0.0,0.0,2.0,0.07,2.0,0.0,0.0,0.0,0.0,0.0,Matches,,,,,,,,,,,,,,,,,,,,,,,,,,,,,,,,,,,,,,,,,,,,,,,,,,,,,,,,198.0,es ESP,DF,28.0,29.8,8.0,1.0,0.0,54.0,15.0,0.0,2.0,45.0,20.0,0.0,1.0,0.0,162.0,84.0,36.0,70.0,Matches,198.0,es ESP,DF,28.0,29.8,1424.0,1385.0,38.0,36.0,1.0,14.0,2.0,2.0,0.0,0.0,0.0,0.0,1152.0,1.0,8.0,Matches,198.0,es ESP,DF,28.0,29.8,1152.0,1424.0,80.9,23635.0,9514.0,380.0,429.0,88.6,586.0,669.0,87.6,175.0,302.0,57.9,0.0,0.4,0.6,-0.4,5.0,117.0,6.0,0.0,105.0,Matches,243,es ESP,DF,28,32,2680.0,84.0,78.4,29.8,31,86.0,27,1,16.0,1,1.56,32.0,35.0,-3.0,-0.1,0.14,32.1,33.3,-1.2,-0.04,0.53,Matches,198.0,es ESP,DF,28.0,29.8,1742.0,198.0,830.0,862.0,53.0,22.0,1742.0,4.0,4.0,100.0,0.0,0.0,908.0,4507.0,2507.0,16.0,8.0,1.0,8.0,2.0,1019.0,4.0,Matches,198.0,es ESP,DF,28.0,29.8,2.0,15.0,3.0,20.0,0.5,0.1,0.13,0.67,10.2,0.0,0.0,0.0,0.7,0.7,0.05,1.3,1.3,Matches,198.0,es ESP,DF,28.0,32.0,31.0,2680.0,29.8,2.0,0.0,2.0,2.0,0.0,0.0,8.0,1.0,0.7,0.7,0.4,1.1,16.0,105.0,4.0,0.07,0.0,0.07,0.07,0.07,0.02,0.01,0.04,0.02,0.04,Matches,David García,D C,28,134,145,"Spain,Pays Basque",Atlético Pamplona,4,5,10,6,10,4,16,3,3,14,11,5,14,11,13,14,14,13,15,9,13,15,7,15,6,16,15,15,11,11,13,16,13,12,14,14,15,12,12,7,13,2,1,1,2,3,1,3,3,1,2,1,16,11,6,11,12,9,13,10,1,1,20,1,1,1,10,1,1,1,1,1,1,1,185,75,8,20,7747426,6650,6650,4003,Mediterranean_Hispanic,133,3,1994/2/14,0,0,12894.0,,67215230
642,Eric García,Barcelona,2001,199.0,es ESP,DFMF,21.0,15.7,24.0,16.0,16.0,5.0,3.0,9.0,20.0,45.0,11.0,23.0,10.0,13.0,19.0,43.0,36.0,1.0,Matches,199.0,es ESP,DFMF,21.0,15.7,10.0,0.63,10.0,0.0,0.0,0.0,0.0,0.0,0.0,0.0,0.0,0.0,0.0,0.0,0.0,0.0,Matches,,,,,,,,,,,,,,,,,,,,,,,,,,,,,,,,,,,,,,,,,,,,,,,,,,,,,,,,199.0,es ESP,DFMF,21.0,15.7,3.0,0.0,0.0,18.0,8.0,0.0,0.0,19.0,16.0,0.0,2.0,0.0,90.0,23.0,15.0,60.5,Matches,199.0,es ESP,DFMF,21.0,15.7,1257.0,1205.0,50.0,33.0,2.0,13.0,0.0,16.0,0.0,0.0,0.0,0.0,1142.0,2.0,8.0,Matches,199.0,es ESP,DFMF,21.0,15.7,1142.0,1257.0,90.9,21550.0,7275.0,429.0,460.0,93.3,578.0,612.0,94.4,122.0,158.0,77.2,0.0,0.2,0.6,-0.2,1.0,130.0,2.0,0.0,105.0,Matches,244,es ESP,DFMF,21,24,1417.0,59.0,41.4,15.7,15,79.0,10,9,25.0,14,2.0,30.0,10.0,20.0,1.27,-0.08,30.6,14.0,16.7,1.06,-0.09,Matches,199.0,es ESP,DFMF,21.0,15.7,1397.0,97.0,538.0,781.0,84.0,5.0,1397.0,4.0,2.0,50.0,2.0,50.0,918.0,4539.0,2686.0,25.0,22.0,0.0,10.0,2.0,1049.0,6.0,Matches,199.0,es ESP,DFMF,21.0,15.7,1.0,7.0,1.0,14.3,0.44,0.06,0.14,1.0,12.9,0.0,0.0,0.0,1.6,1.6,0.22,-0.6,-0.6,Matches,199.0,es ESP,DFMF,21.0,24.0,15.0,1417.0,15.7,1.0,0.0,1.0,1.0,0.0,0.0,3.0,0.0,1.6,1.6,0.2,1.8,25.0,105.0,6.0,0.06,0.0,0.06,0.06,0.06,0.1,0.02,0.11,0.1,0.11,Matches,Eric García,D C,21,144,165,Spain,Barcelona,4,9,12,7,14,6,13,7,8,15,15,9,15,14,12,14,13,15,12,14,14,16,12,14,12,15,15,14,13,14,12,12,12,13,14,13,13,8,13,5,10,1,2,4,2,3,2,3,1,1,2,2,13,16,3,10,12,16,14,15,1,1,20,12,1,8,1,1,1,1,1,1,1,1,182,79,12,20,33000000,7240,7240,6490,Mediterranean_Hispanic,144,7,2001/1/9,17,0,57692.0,,28116427
643,Raúl García,Athletic Club,1986,202.0,es ESP,FWMF,36.0,10.7,12.0,8.0,3.0,4.0,5.0,5.0,15.0,33.3,10.0,13.0,1.0,12.0,6.0,18.0,9.0,0.0,Matches,202.0,es ESP,FWMF,36.0,10.7,33.0,3.07,18.0,0.0,2.0,10.0,1.0,2.0,7.0,0.65,5.0,0.0,1.0,1.0,0.0,0.0,Matches,,,,,,,,,,,,,,,,,,,,,,,,,,,,,,,,,,,,,,,,,,,,,,,,,,,,,,,,202.0,es ESP,FWMF,36.0,10.7,4.0,0.0,0.0,14.0,19.0,8.0,13.0,6.0,8.0,0.0,0.0,0.0,31.0,40.0,38.0,51.3,Matches,202.0,es ESP,FWMF,36.0,10.7,318.0,306.0,10.0,2.0,1.0,3.0,13.0,4.0,0.0,0.0,0.0,0.0,199.0,2.0,9.0,Matches,202.0,es ESP,FWMF,36.0,10.7,199.0,318.0,62.6,3061.0,743.0,118.0,151.0,78.1,57.0,107.0,53.3,17.0,33.0,51.5,3.0,1.1,0.8,1.9,8.0,24.0,7.0,0.0,38.0,Matches,247,es ESP,FWMF,36,35,967.0,28.0,28.3,10.7,6,71.0,1,29,19.0,3,1.29,12.0,13.0,-1.0,-0.09,-0.28,16.1,11.9,4.2,0.39,-0.1,Matches,202.0,es ESP,FWMF,36.0,10.7,446.0,9.0,32.0,192.0,224.0,68.0,446.0,12.0,6.0,50.0,5.0,41.7,230.0,940.0,453.0,12.0,15.0,2.0,13.0,8.0,321.0,62.0,Matches,202.0,es ESP,FWMF,36.0,10.7,2.0,52.0,14.0,26.9,4.84,1.3,0.04,0.14,14.6,0.0,0.0,0.0,5.2,5.2,0.1,-3.2,-3.2,Matches,202.0,es ESP,FWMF,36.0,35.0,6.0,967.0,10.7,2.0,3.0,5.0,2.0,0.0,0.0,4.0,0.0,5.2,5.2,1.1,6.3,12.0,38.0,62.0,0.19,0.28,0.47,0.19,0.47,0.48,0.1,0.59,0.48,0.59,Matches,Raúl García,M/AM/S C,36,147,175,"Spain,Pays Basque",A. Bilbao,10,11,11,14,14,11,16,17,10,11,14,15,12,13,15,14,15,16,14,13,15,14,13,13,15,15,16,15,11,12,12,12,16,12,14,15,14,15,13,11,14,3,1,3,1,3,3,3,2,2,3,4,15,14,9,15,9,15,7,8,1,1,1,1,1,1,1,10,16,13,6,20,13,18,184,84,13,20,6073476,7350,7350,6600,Mediterranean_Hispanic,146,5,1986/7/11,2,0,159999.0,,1502117
644,Rubén García,Osasuna,1993,203.0,es ESP,FWMF,29.0,12.9,20.0,11.0,12.0,4.0,4.0,7.0,24.0,29.2,17.0,14.0,1.0,13.0,12.0,32.0,13.0,0.0,Matches,203.0,es ESP,FWMF,29.0,12.9,54.0,4.2,29.0,20.0,1.0,2.0,2.0,0.0,4.0,0.31,2.0,2.0,0.0,0.0,0.0,0.0,Matches,,,,,,,,,,,,,,,,,,,,,,,,,,,,,,,,,,,,,,,,,,,,,,,,,,,,,,,,203.0,es ESP,FWMF,29.0,12.9,2.0,0.0,0.0,14.0,17.0,1.0,79.0,12.0,11.0,0.0,0.0,0.0,71.0,12.0,35.0,25.5,Matches,203.0,es ESP,FWMF,29.0,12.9,567.0,493.0,71.0,30.0,6.0,5.0,79.0,3.0,35.0,16.0,14.0,2.0,411.0,3.0,15.0,Matches,203.0,es ESP,FWMF,29.0,12.9,411.0,567.0,72.5,6895.0,1810.0,223.0,254.0,87.8,116.0,158.0,73.4,53.0,111.0,47.7,2.0,2.0,2.2,0.0,25.0,23.0,13.0,3.0,40.0,Matches,248,es ESP,FWMF,29,29,1159.0,40.0,33.9,12.9,11,69.0,0,18,22.0,4,1.31,9.0,13.0,-4.0,-0.31,-0.27,12.1,14.6,-2.5,-0.19,-0.06,Matches,203.0,es ESP,FWMF,29.0,12.9,711.0,18.0,100.0,277.0,339.0,26.0,711.0,16.0,6.0,37.5,9.0,56.3,385.0,1773.0,657.0,16.0,13.0,3.0,27.0,10.0,465.0,92.0,Matches,203.0,es ESP,FWMF,29.0,12.9,2.0,20.0,4.0,20.0,1.55,0.31,0.1,0.5,19.1,1.0,0.0,0.0,1.8,1.8,0.09,0.2,0.2,Matches,203.0,es ESP,FWMF,29.0,29.0,11.0,1159.0,12.9,2.0,2.0,4.0,2.0,0.0,0.0,2.0,0.0,1.8,1.8,2.0,3.8,16.0,40.0,92.0,0.16,0.16,0.31,0.16,0.31,0.14,0.15,0.29,0.14,0.29,Matches,Rubén García,AM RLC,29,138,150,Spain,Atlético Pamplona,14,15,14,12,14,14,9,13,4,5,14,13,9,15,11,12,14,13,13,15,14,15,16,7,14,6,14,13,14,14,12,5,12,13,13,11,13,8,12,11,12,1,2,3,1,2,2,2,1,1,1,2,13,14,7,14,13,14,14,10,1,1,1,1,1,1,1,15,15,15,18,20,18,8,171,72,20,10,7730057,6950,6950,4900,Mediterranean_Hispanic,134,6,1993/7/14,0,0,18853.0,,67155012
645,Gavi,Barcelona,2004,208.0,es ESP,MFFW,17.0,28.1,47.0,31.0,7.0,30.0,10.0,21.0,55.0,38.2,34.0,32.0,5.0,27.0,18.0,65.0,22.0,0.0,Matches,208.0,es ESP,MFFW,17.0,28.1,72.0,2.56,59.0,0.0,3.0,4.0,3.0,3.0,7.0,0.25,6.0,0.0,1.0,0.0,0.0,0.0,Matches,,,,,,,,,,,,,,,,,,,,,,,,,,,,,,,,,,,,,,,,,,,,,,,,,,,,,,,,208.0,es ESP,MFFW,17.0,28.1,10.0,0.0,0.0,74.0,72.0,9.0,38.0,18.0,31.0,0.0,0.0,0.0,113.0,39.0,33.0,54.2,Matches,208.0,es ESP,MFFW,17.0,28.1,1206.0,1157.0,45.0,13.0,8.0,13.0,38.0,9.0,0.0,0.0,0.0,0.0,1026.0,4.0,27.0,Matches,208.0,es ESP,MFFW,17.0,28.1,1026.0,1206.0,85.1,14584.0,2930.0,652.0,711.0,91.7,289.0,340.0,85.0,55.0,79.0,69.6,4.0,3.7,3.8,0.3,38.0,98.0,40.0,4.0,134.0,Matches,254,es ESP,MFFW,17,36,2531.0,70.0,74.0,28.1,30,78.0,13,6,33.0,0,2.36,52.0,11.0,41.0,1.46,0.55,53.9,21.9,32.0,1.14,0.1,Matches,208.0,es ESP,MFFW,17.0,28.1,1509.0,27.0,148.0,797.0,578.0,71.0,1509.0,63.0,27.0,42.9,26.0,41.3,1002.0,5348.0,2505.0,49.0,68.0,8.0,56.0,33.0,1133.0,153.0,Matches,208.0,es ESP,MFFW,17.0,28.1,2.0,28.0,8.0,28.6,1.0,0.28,0.07,0.25,16.6,0.0,0.0,0.0,3.2,3.2,0.11,-1.2,-1.2,Matches,208.0,es ESP,MFFW,17.0,36.0,30.0,2531.0,28.1,2.0,4.0,6.0,2.0,0.0,0.0,10.0,0.0,3.2,3.2,3.7,6.9,49.0,134.0,153.0,0.07,0.14,0.21,0.07,0.21,0.11,0.13,0.24,0.11,0.24,Matches,Gavi,M/AM C,17,148,-95,Spain,Barcelona,12,14,15,10,15,11,6,11,8,11,14,9,10,16,14,15,14,14,14,16,16,16,15,12,15,12,14,15,14,15,15,6,14,12,14,8,15,5,15,7,16,1,2,1,4,1,3,3,1,3,3,1,15,15,5,12,14,15,14,13,1,1,1,1,1,1,15,10,20,14,10,17,12,5,173,68,12,20,74100001,7598,7598,6248,Mediterranean_Hispanic,147,6,2004/8/5,10,1,144230.0,,2000049413
646,Paulo Gazzaniga,Girona,1992,209.0,ar ARG,GK,30.0,28.0,0.0,0.0,0.0,0.0,0.0,0.0,1.0,0.0,1.0,0.0,0.0,0.0,1.0,1.0,9.0,5.0,Matches,209.0,ar ARG,GK,30.0,28.0,2.0,0.07,1.0,1.0,0.0,0.0,0.0,0.0,0.0,0.0,0.0,0.0,0.0,0.0,0.0,0.0,Matches,15.0,ar ARG,GK,30.0,28.0,37.0,4.0,0.0,4.0,0.0,45.3,0.33,8.3,0.3,146.0,400.0,36.5,822.0,141.0,31.1,32.4,242.0,59.5,47.9,477.0,37.0,7.8,38.0,1.36,15.1,Matches,15.0,ar ARG,GK,30.0,28.0,28.0,2520.0,28.0,37.0,1.32,125.0,87.0,73.6,11.0,8.0,9.0,4.0,14.3,6.0,4.0,1.0,1.0,20.0,Matches,209.0,ar ARG,GK,30.0,28.0,4.0,0.0,0.0,0.0,6.0,0.0,0.0,1.0,0.0,0.0,0.0,0.0,36.0,4.0,0.0,100.0,Matches,209.0,ar ARG,GK,30.0,28.0,1070.0,738.0,326.0,83.0,0.0,3.0,0.0,0.0,0.0,0.0,0.0,0.0,783.0,6.0,0.0,Matches,209.0,ar ARG,GK,30.0,28.0,783.0,1070.0,73.2,21240.0,15708.0,201.0,201.0,100.0,349.0,359.0,97.2,231.0,501.0,46.1,0.0,0.2,0.0,-0.2,1.0,21.0,0.0,0.0,0.0,Matches,255,ar ARG,GK,30,28,2520.0,90.0,73.7,28.0,28,90.0,28,0,,7,1.46,44.0,37.0,7.0,0.25,0.65,37.2,42.1,-4.9,-0.18,-0.24,Matches,209.0,ar ARG,GK,30.0,28.0,1140.0,981.0,1133.0,7.0,0.0,0.0,1140.0,1.0,1.0,100.0,0.0,0.0,667.0,3263.0,1663.0,0.0,0.0,0.0,3.0,2.0,504.0,0.0,Matches,209.0,ar ARG,GK,30.0,28.0,0.0,0.0,0.0,,0.0,0.0,,,,0.0,0.0,0.0,0.0,0.0,,0.0,0.0,Matches,209.0,ar ARG,GK,30.0,28.0,28.0,2520.0,28.0,0.0,0.0,0.0,0.0,0.0,0.0,4.0,0.0,0.0,0.0,0.2,0.2,0.0,0.0,0.0,0.0,0.0,0.0,0.0,0.0,0.0,0.01,0.01,0.0,0.01,Matches,Paulo Gazzaniga,GK,30,128,142,"Argentina,Italy",Fulham,3,1,3,1,8,5,6,1,3,1,10,2,1,13,9,12,13,10,12,14,12,13,6,6,4,12,11,12,8,15,11,17,11,7,12,13,14,9,12,8,1,15,12,12,5,13,16,13,16,12,7,13,18,8,4,11,13,14,13,14,20,1,1,1,1,1,1,1,1,1,1,1,1,1,196,90,9,20,3658538,6400,6100,4750,Mediterranean_Hispanic,127,4,1992/1/2,1,0,28998.0,Girona,67136579
647,Bryan Gil,Sevilla,2001,210.0,es ESP,FWDF,21.0,10.2,22.0,11.0,11.0,7.0,4.0,10.0,23.0,43.5,13.0,10.0,0.0,10.0,8.0,30.0,10.0,0.0,Matches,210.0,es ESP,FWDF,21.0,10.2,25.0,2.45,20.0,0.0,1.0,1.0,2.0,1.0,4.0,0.39,3.0,0.0,0.0,1.0,0.0,0.0,Matches,,,,,,,,,,,,,,,,,,,,,,,,,,,,,,,,,,,,,,,,,,,,,,,,,,,,,,,,210.0,es ESP,FWDF,21.0,10.2,4.0,0.0,0.0,18.0,21.0,3.0,29.0,8.0,11.0,0.0,0.0,0.0,63.0,4.0,9.0,30.8,Matches,210.0,es ESP,FWDF,21.0,10.2,374.0,330.0,40.0,3.0,0.0,2.0,29.0,32.0,5.0,0.0,1.0,0.0,284.0,4.0,17.0,Matches,210.0,es ESP,FWDF,21.0,10.2,284.0,374.0,75.9,3630.0,945.0,182.0,201.0,90.5,88.0,114.0,77.2,3.0,22.0,13.6,2.0,0.7,0.7,1.3,8.0,10.0,10.0,3.0,22.0,Matches,256,es ESP,FWDF,21,17,918.0,54.0,26.8,10.2,10,72.0,1,7,29.0,2,1.47,13.0,13.0,0.0,0.0,0.25,13.8,11.2,2.6,0.26,0.63,Matches,210.0,es ESP,FWDF,21.0,10.2,515.0,10.0,81.0,188.0,254.0,25.0,515.0,45.0,19.0,42.2,17.0,37.8,339.0,1802.0,743.0,28.0,21.0,4.0,31.0,18.0,337.0,75.0,Matches,210.0,es ESP,FWDF,21.0,10.2,2.0,17.0,4.0,23.5,1.67,0.39,0.12,0.5,13.7,0.0,0.0,0.0,2.9,2.9,0.17,-0.9,-0.9,Matches,210.0,es ESP,FWDF,21.0,17.0,10.0,918.0,10.2,2.0,2.0,4.0,2.0,0.0,0.0,4.0,0.0,2.9,2.9,0.7,3.5,28.0,22.0,75.0,0.2,0.2,0.39,0.2,0.39,0.28,0.07,0.35,0.28,0.35,Matches,Bryan Gil,M/AM RLC,21,135,-85,Spain,Tottenham Hotspur,10,14,16,13,13,10,8,11,6,6,12,10,5,14,10,13,9,11,11,13,12,15,17,7,14,5,10,12,16,15,14,7,12,14,13,8,12,7,12,10,11,1,1,3,1,3,3,2,3,3,1,2,8,14,6,14,16,16,15,10,1,13,1,1,14,1,1,19,1,14,20,18,15,8,175,69,20,9,82446926,6750,6750,6000,Mediterranean_Hispanic,129,2,2001/2/11,4,0,92793.0,,67260440
648,Óscar Gil,Espanyol,1997,212.0,es ESP,DF,25.0,28.4,63.0,37.0,38.0,16.0,9.0,32.0,61.0,52.5,29.0,51.0,18.0,33.0,31.0,94.0,55.0,1.0,Matches,212.0,es ESP,DF,25.0,28.4,33.0,1.16,25.0,1.0,2.0,2.0,3.0,0.0,2.0,0.07,1.0,0.0,1.0,0.0,0.0,0.0,Matches,,,,,,,,,,,,,,,,,,,,,,,,,,,,,,,,,,,,,,,,,,,,,,,,,,,,,,,,212.0,es ESP,DF,25.0,28.4,14.0,0.0,0.0,54.0,39.0,0.0,38.0,31.0,37.0,0.0,1.0,0.0,124.0,13.0,39.0,25.0,Matches,212.0,es ESP,DF,25.0,28.4,991.0,737.0,252.0,16.0,1.0,3.0,38.0,236.0,0.0,0.0,0.0,0.0,757.0,2.0,34.0,Matches,212.0,es ESP,DF,25.0,28.4,757.0,991.0,76.4,12559.0,3678.0,358.0,416.0,86.1,323.0,397.0,81.4,54.0,109.0,49.5,1.0,2.9,1.9,-1.9,15.0,29.0,11.0,7.0,47.0,Matches,258,es ESP,DF,25,33,2559.0,78.0,74.8,28.4,31,82.0,17,2,16.0,0,1.06,34.0,48.0,-14.0,-0.49,-0.18,35.5,44.5,-9.0,-0.32,-0.06,Matches,212.0,es ESP,DF,25.0,28.4,1334.0,88.0,406.0,570.0,371.0,27.0,1334.0,49.0,23.0,46.9,22.0,44.9,576.0,2930.0,1283.0,39.0,24.0,5.0,52.0,14.0,602.0,111.0,Matches,212.0,es ESP,DF,25.0,28.4,0.0,11.0,2.0,18.2,0.39,0.07,0.0,0.0,18.9,0.0,0.0,0.0,0.6,0.6,0.05,-0.6,-0.6,Matches,212.0,es ESP,DF,25.0,33.0,31.0,2559.0,28.4,0.0,1.0,1.0,0.0,0.0,0.0,14.0,0.0,0.6,0.6,2.9,3.5,39.0,47.0,111.0,0.0,0.04,0.04,0.0,0.04,0.02,0.1,0.12,0.02,0.12,Matches,Óscar Gil,D/WB R,24,129,141,Spain,Espanyol,7,10,9,9,11,7,9,8,11,14,12,8,13,10,6,10,15,9,12,7,12,15,15,10,11,12,16,18,15,14,10,10,14,15,16,14,11,2,9,8,12,3,2,3,1,3,1,3,2,3,1,2,12,11,3,16,12,18,18,2,1,12,1,20,1,18,1,1,1,11,1,1,1,1,175,75,9,20,4121075,6450,6450,4450,Mediterranean_Hispanic,126,6,1998/4/26,1,0,9588.0,,67227188
649,Moi Gómez,Osasuna,1994,216.0,es ESP,MFFW,28.0,27.3,26.0,17.0,9.0,14.0,3.0,15.0,32.0,46.9,17.0,15.0,3.0,12.0,10.0,36.0,5.0,1.0,Matches,216.0,es ESP,MFFW,28.0,27.3,94.0,3.45,67.0,21.0,1.0,4.0,1.0,0.0,6.0,0.22,5.0,1.0,0.0,0.0,0.0,0.0,Matches,,,,,,,,,,,,,,,,,,,,,,,,,,,,,,,,,,,,,,,,,,,,,,,,,,,,,,,,216.0,es ESP,MFFW,28.0,27.3,5.0,0.0,0.0,14.0,26.0,1.0,115.0,10.0,17.0,0.0,0.0,0.0,176.0,7.0,25.0,21.9,Matches,216.0,es ESP,MFFW,28.0,27.3,1559.0,1413.0,140.0,71.0,1.0,34.0,115.0,6.0,62.0,26.0,26.0,0.0,1314.0,6.0,26.0,Matches,216.0,es ESP,MFFW,28.0,27.3,1314.0,1559.0,84.3,24801.0,6445.0,579.0,619.0,93.5,522.0,584.0,89.4,186.0,286.0,65.0,2.0,4.5,4.8,-2.5,53.0,170.0,34.0,13.0,184.0,Matches,264,es ESP,MFFW,28,33,2453.0,74.0,71.7,27.3,28,83.0,17,5,23.0,1,1.42,21.0,27.0,-6.0,-0.22,-0.31,27.4,29.1,-1.7,-0.06,0.33,Matches,216.0,es ESP,MFFW,28.0,27.3,1712.0,23.0,237.0,1013.0,489.0,23.0,1712.0,40.0,27.0,67.5,11.0,27.5,1149.0,6450.0,2740.0,37.0,48.0,7.0,33.0,18.0,1247.0,67.0,Matches,216.0,es ESP,MFFW,28.0,27.3,3.0,19.0,9.0,47.4,0.7,0.33,0.16,0.33,21.0,0.0,0.0,0.0,1.8,1.8,0.09,1.2,1.2,Matches,216.0,es ESP,MFFW,28.0,33.0,28.0,2453.0,27.3,3.0,2.0,5.0,3.0,0.0,0.0,5.0,0.0,1.8,1.8,4.5,6.2,37.0,184.0,67.0,0.11,0.07,0.18,0.11,0.18,0.06,0.16,0.23,0.06,0.23,Matches,Moi Gómez,M/AM LC,28,137,154,Spain,Atlético Pamplona,13,14,12,12,15,12,8,13,8,7,15,12,10,16,8,12,9,12,12,15,14,14,15,8,14,11,14,14,11,14,14,7,13,12,13,11,11,8,13,8,14,2,1,2,3,1,1,2,2,2,2,3,8,9,7,15,13,12,6,12,1,1,1,1,1,1,1,12,16,10,20,18,12,1,176,73,14,20,8924879,6850,6850,4450,Mediterranean_Hispanic,134,5,1994/6/23,0,0,16866.0,,67142544
650,Sergi Gómez,Espanyol,1992,218.0,es ESP,DF,30.0,26.0,29.0,16.0,20.0,9.0,0.0,18.0,22.0,81.8,4.0,33.0,19.0,14.0,27.0,56.0,125.0,1.0,Matches,218.0,es ESP,DF,30.0,26.0,11.0,0.42,9.0,0.0,0.0,2.0,0.0,0.0,1.0,0.04,0.0,0.0,0.0,1.0,0.0,0.0,Matches,,,,,,,,,,,,,,,,,,,,,,,,,,,,,,,,,,,,,,,,,,,,,,,,,,,,,,,,218.0,es ESP,DF,30.0,26.0,1.0,2.0,0.0,9.0,8.0,0.0,3.0,27.0,16.0,0.0,0.0,0.0,113.0,43.0,36.0,54.4,Matches,218.0,es ESP,DF,30.0,26.0,1132.0,1070.0,59.0,49.0,0.0,11.0,3.0,7.0,0.0,0.0,0.0,0.0,968.0,3.0,3.0,Matches,218.0,es ESP,DF,30.0,26.0,968.0,1132.0,85.5,20365.0,7288.0,277.0,302.0,91.7,561.0,600.0,93.5,127.0,214.0,59.3,0.0,0.4,0.7,-0.4,5.0,38.0,1.0,0.0,43.0,Matches,266,es ESP,DF,30,29,2339.0,81.0,68.4,26.0,26,84.0,18,3,52.0,4,0.79,35.0,46.0,-11.0,-0.42,0.08,31.6,40.8,-9.2,-0.36,-0.17,Matches,218.0,es ESP,DF,30.0,26.0,1379.0,188.0,736.0,620.0,33.0,19.0,1379.0,0.0,0.0,,0.0,,719.0,3044.0,1464.0,2.0,2.0,0.0,5.0,0.0,827.0,1.0,Matches,218.0,es ESP,DF,30.0,26.0,0.0,9.0,4.0,44.4,0.35,0.15,0.0,0.0,12.8,0.0,0.0,0.0,0.9,0.9,0.1,-0.9,-0.9,Matches,218.0,es ESP,DF,30.0,29.0,26.0,2339.0,26.0,0.0,0.0,0.0,0.0,0.0,0.0,1.0,2.0,0.9,0.9,0.4,1.3,2.0,43.0,1.0,0.0,0.0,0.0,0.0,0.0,0.03,0.01,0.05,0.03,0.05,Matches,Sergi Gómez,D C,30,138,149,Spain,Espanyol,6,9,10,8,12,7,14,9,12,14,14,9,15,14,10,14,13,13,13,14,13,13,7,14,8,16,15,14,12,10,11,13,13,15,13,14,14,9,12,10,6,1,3,2,3,1,3,3,3,3,1,3,13,12,2,13,11,11,12,15,1,1,20,13,1,1,9,1,1,1,1,1,1,1,183,75,9,20,10182524,6900,6900,5400,Mediterranean_Hispanic,138,5,1992/3/28,0,0,18533.0,,67071183
651,Diego González,Elche,1995,220.0,es ESP,DF,27.0,10.6,12.0,7.0,9.0,3.0,0.0,7.0,11.0,63.6,4.0,14.0,12.0,2.0,7.0,19.0,50.0,1.0,Matches,220.0,es ESP,DF,27.0,10.6,0.0,0.0,0.0,0.0,0.0,0.0,0.0,0.0,0.0,0.0,0.0,0.0,0.0,0.0,0.0,0.0,Matches,,,,,,,,,,,,,,,,,,,,,,,,,,,,,,,,,,,,,,,,,,,,,,,,,,,,,,,,220.0,es ESP,DF,27.0,10.6,4.0,0.0,0.0,17.0,5.0,0.0,1.0,7.0,7.0,0.0,1.0,0.0,47.0,19.0,8.0,70.4,Matches,220.0,es ESP,DF,27.0,10.6,382.0,351.0,31.0,18.0,0.0,2.0,1.0,13.0,0.0,0.0,0.0,0.0,299.0,0.0,6.0,Matches,220.0,es ESP,DF,27.0,10.6,299.0,382.0,78.3,6351.0,2599.0,80.0,92.0,87.0,164.0,183.0,89.6,47.0,90.0,52.2,0.0,0.0,0.0,0.0,0.0,16.0,1.0,0.0,13.0,Matches,269,es ESP,DF,27,16,958.0,60.0,28.0,10.6,8,85.0,5,8,35.0,16,0.5,8.0,23.0,-15.0,-1.41,-0.6,8.9,24.4,-15.6,-1.46,-0.84,Matches,220.0,es ESP,DF,27.0,10.6,487.0,79.0,321.0,151.0,17.0,8.0,487.0,3.0,1.0,33.3,2.0,66.7,240.0,1266.0,689.0,1.0,0.0,0.0,2.0,3.0,265.0,2.0,Matches,220.0,es ESP,DF,27.0,10.6,0.0,6.0,0.0,0.0,0.56,0.0,0.0,,12.8,0.0,0.0,0.0,0.8,0.8,0.13,-0.8,-0.8,Matches,220.0,es ESP,DF,27.0,16.0,8.0,958.0,10.6,0.0,0.0,0.0,0.0,0.0,0.0,4.0,0.0,0.8,0.8,0.0,0.8,1.0,13.0,2.0,0.0,0.0,0.0,0.0,0.0,0.07,0.0,0.07,0.07,0.07,Matches,Diego González,D C,27,123,129,Spain,Elche,3,14,11,4,12,5,14,5,4,15,13,7,14,12,14,11,14,13,11,6,10,13,10,14,7,13,13,14,13,13,7,13,13,13,14,13,13,11,12,5,14,2,3,2,1,1,3,1,2,2,2,1,13,12,5,12,8,12,13,13,1,14,20,12,12,4,12,10,10,1,1,1,1,1,185,83,20,15,1709774,6150,6150,4400,Mediterranean_Hispanic,124,5,1995/1/28,0,0,5408.0,,67184689
652,Giovanni González,Mallorca,1994,222.0,uy URU,DF,27.0,10.3,16.0,8.0,11.0,2.0,3.0,9.0,22.0,40.9,13.0,8.0,2.0,6.0,7.0,23.0,22.0,0.0,Matches,222.0,uy URU,DF,27.0,10.3,12.0,1.17,10.0,1.0,0.0,1.0,0.0,0.0,3.0,0.29,3.0,0.0,0.0,0.0,0.0,0.0,Matches,,,,,,,,,,,,,,,,,,,,,,,,,,,,,,,,,,,,,,,,,,,,,,,,,,,,,,,,222.0,uy URU,DF,27.0,10.3,5.0,0.0,0.0,16.0,17.0,1.0,20.0,7.0,8.0,0.0,0.0,0.0,48.0,12.0,11.0,52.2,Matches,222.0,uy URU,DF,27.0,10.3,428.0,363.0,64.0,2.0,0.0,0.0,20.0,62.0,0.0,0.0,0.0,0.0,336.0,1.0,5.0,Matches,222.0,uy URU,DF,27.0,10.3,336.0,428.0,78.5,5449.0,2264.0,188.0,213.0,88.3,123.0,156.0,78.8,21.0,46.0,45.7,2.0,1.2,0.6,0.8,5.0,19.0,7.0,4.0,28.0,Matches,272,uy URU,DF,27,15,926.0,62.0,27.1,10.3,9,87.0,7,6,24.0,15,1.56,13.0,8.0,5.0,0.49,0.88,10.3,8.8,1.6,0.15,0.61,Matches,222.0,uy URU,DF,27.0,10.3,506.0,32.0,170.0,228.0,111.0,14.0,506.0,16.0,8.0,50.0,6.0,37.5,234.0,1003.0,494.0,10.0,7.0,3.0,7.0,2.0,275.0,39.0,Matches,222.0,uy URU,DF,27.0,10.3,0.0,4.0,0.0,0.0,0.39,0.0,0.0,,19.0,0.0,0.0,0.0,0.2,0.2,0.05,-0.2,-0.2,Matches,222.0,uy URU,DF,27.0,15.0,9.0,926.0,10.3,0.0,2.0,2.0,0.0,0.0,0.0,5.0,0.0,0.2,0.2,1.2,1.4,10.0,28.0,39.0,0.0,0.19,0.19,0.0,0.19,0.02,0.12,0.14,0.02,0.14,Matches,Giovanni González,D/WB/M RL,27,129,132,"Uruguay,Italy",Mallorca,7,12,12,13,11,11,9,10,13,12,11,6,11,12,13,11,12,10,12,10,12,12,11,13,15,11,13,16,15,14,9,8,15,13,14,10,13,11,10,8,16,1,2,2,2,3,3,2,3,4,1,1,11,13,8,13,11,12,10,12,1,15,1,18,10,20,8,1,1,19,1,1,1,1,173,73,10,20,4878009,6650,6650,5800,Mediterranean_Hispanic,121,9,1994/9/20,16,0,12637.0,,78071163
653,Nicolás González,Valencia,2002,223.0,es ESP,MF,20.0,15.6,27.0,15.0,11.0,13.0,3.0,9.0,25.0,36.0,16.0,21.0,7.0,14.0,19.0,46.0,16.0,0.0,Matches,223.0,es ESP,MF,20.0,15.6,33.0,2.12,25.0,1.0,3.0,2.0,2.0,0.0,2.0,0.13,2.0,0.0,0.0,0.0,0.0,0.0,Matches,,,,,,,,,,,,,,,,,,,,,,,,,,,,,,,,,,,,,,,,,,,,,,,,,,,,,,,,223.0,es ESP,MF,20.0,15.6,2.0,0.0,0.0,33.0,13.0,0.0,3.0,19.0,15.0,0.0,1.0,1.0,95.0,27.0,15.0,64.3,Matches,223.0,es ESP,MF,20.0,15.6,778.0,748.0,28.0,26.0,2.0,5.0,3.0,1.0,0.0,0.0,0.0,0.0,676.0,2.0,8.0,Matches,223.0,es ESP,MF,20.0,15.6,676.0,778.0,86.9,10855.0,3185.0,339.0,372.0,91.1,293.0,328.0,89.3,31.0,52.0,59.6,1.0,1.3,1.4,-0.3,12.0,92.0,9.0,0.0,81.0,Matches,273,es ESP,MF,20,26,1405.0,54.0,41.1,15.6,18,68.0,3,8,22.0,0,1.35,22.0,21.0,1.0,0.06,0.24,23.4,18.2,5.2,0.33,0.3,Matches,223.0,es ESP,MF,20.0,15.6,921.0,30.0,164.0,555.0,209.0,19.0,921.0,39.0,28.0,71.8,6.0,15.4,528.0,2629.0,1277.0,21.0,26.0,1.0,12.0,15.0,606.0,17.0,Matches,223.0,es ESP,MF,20.0,15.6,1.0,14.0,3.0,21.4,0.9,0.19,0.07,0.33,15.2,0.0,0.0,0.0,1.5,1.5,0.11,-0.5,-0.5,Matches,223.0,es ESP,MF,20.0,26.0,18.0,1405.0,15.6,1.0,1.0,2.0,1.0,0.0,0.0,2.0,0.0,1.5,1.5,1.3,2.8,21.0,81.0,17.0,0.06,0.06,0.13,0.06,0.13,0.1,0.09,0.18,0.1,0.18,Matches,Nicolás González,AM/S RL,24,147,158,"Argentina,Italy",ACF Fiorentina,9,14,16,12,15,7,15,12,4,4,14,15,6,14,16,13,16,14,10,13,11,17,15,7,15,6,11,15,16,14,13,12,14,16,12,11,14,9,12,9,12,3,3,2,2,3,2,2,1,2,3,1,16,15,12,12,14,14,10,7,1,1,1,1,1,1,1,15,1,11,20,10,18,17,180,75,20,8,24227050,7450,7100,6000,Native_American,139,8,1998/4/6,21,3,61731.0,,14181375
654,Andoni Gorosabel,Real Sociedad,1996,225.0,es ESP,DF,25.0,19.0,41.0,25.0,23.0,9.0,9.0,26.0,43.0,60.5,17.0,21.0,2.0,19.0,17.0,58.0,23.0,0.0,Matches,225.0,es ESP,DF,25.0,19.0,30.0,1.58,22.0,6.0,0.0,0.0,1.0,1.0,1.0,0.05,1.0,0.0,0.0,0.0,0.0,0.0,Matches,,,,,,,,,,,,,,,,,,,,,,,,,,,,,,,,,,,,,,,,,,,,,,,,,,,,,,,,225.0,es ESP,DF,25.0,19.0,3.0,0.0,0.0,25.0,17.0,0.0,41.0,17.0,25.0,0.0,0.0,0.0,82.0,19.0,33.0,36.5,Matches,225.0,es ESP,DF,25.0,19.0,1049.0,834.0,213.0,29.0,0.0,2.0,41.0,184.0,0.0,0.0,0.0,0.0,888.0,2.0,20.0,Matches,225.0,es ESP,DF,25.0,19.0,888.0,1049.0,84.7,13271.0,4844.0,512.0,561.0,91.3,297.0,344.0,86.3,50.0,83.0,60.2,0.0,1.0,1.7,-1.0,13.0,42.0,22.0,12.0,68.0,Matches,276,es ESP,DF,25,27,1708.0,63.0,49.9,19.0,19,80.0,9,8,23.0,5,1.78,23.0,19.0,4.0,0.21,-0.42,28.6,16.7,11.9,0.63,0.21,Matches,225.0,es ESP,DF,25.0,19.0,1205.0,35.0,288.0,589.0,335.0,17.0,1205.0,19.0,9.0,47.4,6.0,31.6,599.0,2830.0,1483.0,42.0,30.0,1.0,14.0,8.0,705.0,75.0,Matches,225.0,es ESP,DF,25.0,19.0,0.0,14.0,1.0,7.1,0.74,0.05,0.0,0.0,21.7,0.0,0.0,0.0,0.6,0.6,0.04,-0.6,-0.6,Matches,225.0,es ESP,DF,25.0,27.0,19.0,1708.0,19.0,0.0,0.0,0.0,0.0,0.0,0.0,3.0,0.0,0.6,0.6,1.0,1.6,42.0,68.0,75.0,0.0,0.0,0.0,0.0,0.0,0.03,0.05,0.08,0.03,0.08,Matches,Andoni Gorosabel,D/WB R,25,135,146,"Spain,Pays Basque",Real San Sebastián,7,15,13,9,12,8,9,10,8,14,12,11,13,13,14,13,13,13,11,12,13,13,8,9,16,12,14,16,14,13,14,8,13,14,14,15,12,6,10,8,8,3,3,3,3,1,2,3,3,3,3,3,13,14,6,15,12,13,11,11,1,1,1,20,1,18,1,1,1,1,1,1,1,1,174,70,9,20,11101677,6700,6700,4500,Mediterranean_Hispanic,131,2,1996/8/4,0,0,15871.0,,67202652
655,Ivo Grbić,Atlético Madrid,1996,227.0,hr CRO,GK,26.0,10.2,0.0,0.0,0.0,0.0,0.0,0.0,0.0,,0.0,0.0,0.0,0.0,0.0,0.0,9.0,1.0,Matches,227.0,hr CRO,GK,26.0,10.2,1.0,0.1,1.0,0.0,0.0,0.0,0.0,0.0,0.0,0.0,0.0,0.0,0.0,0.0,0.0,0.0,Matches,18.0,hr CRO,GK,26.0,10.2,12.0,3.0,0.0,4.0,0.0,13.8,0.23,1.8,0.17,46.0,148.0,31.1,230.0,50.0,37.4,34.1,99.0,62.6,47.4,214.0,23.0,10.7,7.0,0.68,9.2,Matches,18.0,hr CRO,GK,26.0,12.0,10.0,922.0,10.2,12.0,1.17,48.0,36.0,81.3,6.0,3.0,1.0,2.0,20.0,3.0,3.0,0.0,0.0,0.0,Matches,227.0,hr CRO,GK,26.0,10.2,3.0,0.0,0.0,1.0,1.0,0.0,0.0,0.0,0.0,0.0,1.0,0.0,9.0,4.0,1.0,80.0,Matches,227.0,hr CRO,GK,26.0,10.2,330.0,207.0,122.0,23.0,0.0,0.0,0.0,0.0,0.0,0.0,0.0,0.0,219.0,1.0,0.0,Matches,227.0,hr CRO,GK,26.0,10.2,219.0,330.0,66.4,6085.0,4302.0,57.0,58.0,98.3,81.0,81.0,100.0,80.0,189.0,42.3,0.0,0.0,0.0,0.0,0.0,0.0,0.0,0.0,0.0,Matches,278,hr CRO,GK,26,12,922.0,77.0,27.0,10.2,10,89.0,9,2,14.0,25,1.92,28.0,13.0,15.0,1.46,0.67,17.9,14.9,3.0,0.29,-0.35,Matches,227.0,hr CRO,GK,26.0,10.2,361.0,330.0,360.0,1.0,0.0,0.0,361.0,0.0,0.0,,0.0,,181.0,1016.0,681.0,0.0,0.0,0.0,0.0,0.0,123.0,0.0,Matches,227.0,hr CRO,GK,26.0,10.2,0.0,0.0,0.0,,0.0,0.0,,,,0.0,0.0,0.0,0.0,0.0,,0.0,0.0,Matches,227.0,hr CRO,GK,26.0,12.0,10.0,922.0,10.2,0.0,0.0,0.0,0.0,0.0,0.0,3.0,0.0,0.0,0.0,0.0,0.0,0.0,0.0,0.0,0.0,0.0,0.0,0.0,0.0,0.0,0.0,0.0,0.0,0.0,Matches,Ivo Grbić,GK,26,136,147,Croatia,A. Madrid,3,2,3,1,6,7,8,1,3,3,10,1,1,6,11,16,13,14,14,6,11,14,3,12,3,16,12,10,12,12,13,17,13,11,12,16,12,5,6,5,11,15,17,12,7,13,11,14,14,11,12,11,15,13,4,11,15,16,12,15,20,1,1,1,1,1,1,1,1,1,1,1,1,1,196,83,9,20,6344876,6800,6024,5321,Northern_European,136,1,1996/1/18,2,0,19448.0,,24039943
656,Antoine Griezmann,Atlético Madrid,1991,230.0,fr FRA,FWMF,31.0,31.8,49.0,34.0,15.0,23.0,11.0,20.0,66.0,30.3,46.0,34.0,3.0,31.0,24.0,73.0,31.0,0.0,Matches,230.0,fr FRA,FWMF,31.0,31.8,162.0,5.1,111.0,23.0,10.0,7.0,8.0,3.0,26.0,0.82,18.0,5.0,1.0,2.0,0.0,0.0,Matches,,,,,,,,,,,,,,,,,,,,,,,,,,,,,,,,,,,,,,,,,,,,,,,,,,,,,,,,230.0,fr FRA,FWMF,31.0,31.8,2.0,0.0,0.0,22.0,41.0,11.0,131.0,24.0,34.0,0.0,0.0,0.0,150.0,28.0,34.0,45.2,Matches,230.0,fr FRA,FWMF,31.0,31.8,1597.0,1457.0,136.0,34.0,16.0,20.0,131.0,6.0,72.0,42.0,17.0,0.0,1236.0,4.0,39.0,Matches,230.0,fr FRA,FWMF,31.0,31.8,1236.0,1597.0,77.4,18976.0,5448.0,685.0,774.0,88.5,384.0,487.0,78.9,104.0,207.0,50.2,16.0,13.8,9.8,2.2,84.0,117.0,58.0,13.0,171.0,Matches,281,fr FRA,FWMF,31,38,2859.0,75.0,83.6,31.8,31,86.0,23,7,29.0,0,2.03,61.0,29.0,32.0,1.01,0.21,54.9,34.0,20.9,0.66,0.67,Matches,230.0,fr FRA,FWMF,31.0,31.8,1971.0,45.0,247.0,933.0,818.0,153.0,1970.0,83.0,47.0,56.6,28.0,33.7,1104.0,5999.0,3089.0,99.0,66.0,25.0,41.0,35.0,1445.0,202.0,Matches,230.0,fr FRA,FWMF,31.0,31.8,15.0,111.0,44.0,39.6,3.49,1.39,0.14,0.34,17.6,5.0,0.0,0.0,12.3,12.3,0.11,2.7,2.7,Matches,230.0,fr FRA,FWMF,31.0,38.0,31.0,2859.0,31.8,15.0,16.0,31.0,15.0,0.0,0.0,2.0,0.0,12.3,12.3,13.8,26.1,99.0,171.0,202.0,0.47,0.5,0.98,0.47,0.98,0.39,0.44,0.82,0.39,0.82,Matches,Antoine Griezmann,AM/S RLC,31,162,180,"France,Portugal,Pays Basque",A. Madrid,14,15,16,14,15,15,13,14,4,5,15,13,10,17,12,15,12,11,12,16,13,17,17,10,17,10,12,14,15,14,13,9,15,14,13,10,11,9,11,5,14,3,1,1,3,2,1,3,1,1,1,4,14,18,13,12,13,14,11,9,1,1,1,1,1,1,1,12,1,11,19,19,19,20,175,71,20,14,347975206,8100,8400,7500,Mediterranean_Hispanic,149,6,1991/3/21,108,42,268492.0,,67086656
657,Andrés Guardado,Betis,1986,231.0,mx MEX,MF,35.0,15.3,41.0,25.0,17.0,20.0,4.0,18.0,43.0,41.9,25.0,14.0,5.0,9.0,23.0,64.0,29.0,0.0,Matches,231.0,mx MEX,MF,35.0,15.3,32.0,2.1,26.0,3.0,0.0,2.0,1.0,0.0,5.0,0.33,4.0,0.0,0.0,1.0,0.0,0.0,Matches,,,,,,,,,,,,,,,,,,,,,,,,,,,,,,,,,,,,,,,,,,,,,,,,,,,,,,,,231.0,mx MEX,MF,35.0,15.3,7.0,0.0,0.0,16.0,10.0,0.0,9.0,23.0,25.0,0.0,0.0,0.0,121.0,17.0,29.0,37.0,Matches,231.0,mx MEX,MF,35.0,15.3,870.0,806.0,63.0,45.0,3.0,14.0,9.0,11.0,7.0,1.0,5.0,0.0,739.0,1.0,14.0,Matches,231.0,mx MEX,MF,35.0,15.3,739.0,870.0,84.9,13792.0,3995.0,341.0,363.0,93.9,292.0,333.0,87.7,95.0,137.0,69.3,1.0,1.1,1.0,-0.1,12.0,70.0,5.0,0.0,72.0,Matches,282,mx MEX,MF,35,26,1373.0,53.0,40.1,15.3,16,75.0,6,10,18.0,9,1.65,22.0,23.0,-1.0,-0.07,-0.33,20.3,21.5,-1.2,-0.08,-0.2,Matches,231.0,mx MEX,MF,35.0,15.3,1022.0,34.0,277.0,610.0,151.0,6.0,1022.0,10.0,5.0,50.0,4.0,40.0,590.0,2806.0,1360.0,14.0,16.0,0.0,18.0,6.0,659.0,13.0,Matches,231.0,mx MEX,MF,35.0,15.3,1.0,8.0,3.0,37.5,0.52,0.2,0.13,0.33,23.2,1.0,0.0,0.0,0.3,0.3,0.04,0.7,0.7,Matches,231.0,mx MEX,MF,35.0,26.0,16.0,1373.0,15.3,1.0,1.0,2.0,1.0,0.0,0.0,7.0,0.0,0.3,0.3,1.1,1.4,14.0,72.0,13.0,0.07,0.07,0.13,0.07,0.13,0.02,0.07,0.09,0.02,0.09,Matches,Andrés Guardado,DM/M LC,35,137,148,"Mexico,Spain",Real Hispalis,13,13,11,10,14,12,6,15,10,9,16,17,11,14,13,11,16,13,14,15,13,17,12,15,15,12,14,15,12,13,14,9,15,12,12,10,12,8,12,14,13,3,1,3,1,3,2,3,1,3,1,3,11,14,8,12,18,18,12,15,1,12,8,1,14,1,20,18,20,1,15,15,1,1,169,60,20,8,764362,6850,7400,5850,Mediterranean_Hispanic,127,11,1986/9/28,175,28,18389.0,,5667723
658,Sergi Guardiola,Cádiz,1991,233.0,es ESP,FW,31.0,12.9,9.0,7.0,0.0,6.0,3.0,3.0,12.0,25.0,9.0,5.0,0.0,5.0,3.0,12.0,7.0,0.0,Matches,233.0,es ESP,FW,31.0,12.9,31.0,2.39,21.0,0.0,2.0,5.0,2.0,1.0,0.0,0.0,0.0,0.0,0.0,0.0,0.0,0.0,Matches,,,,,,,,,,,,,,,,,,,,,,,,,,,,,,,,,,,,,,,,,,,,,,,,,,,,,,,,233.0,es ESP,FW,31.0,12.9,2.0,0.0,0.0,7.0,21.0,11.0,14.0,3.0,7.0,0.0,0.0,0.0,39.0,11.0,31.0,26.2,Matches,233.0,es ESP,FW,31.0,12.9,294.0,278.0,15.0,0.0,0.0,0.0,14.0,0.0,0.0,0.0,0.0,0.0,203.0,1.0,12.0,Matches,233.0,es ESP,FW,31.0,12.9,203.0,294.0,69.0,2803.0,548.0,121.0,152.0,79.6,60.0,88.0,68.2,10.0,15.0,66.7,0.0,0.5,0.3,-0.5,9.0,11.0,3.0,1.0,28.0,Matches,284,es ESP,FW,31,17,1165.0,69.0,34.1,12.9,14,77.0,2,3,31.0,1,1.35,14.0,10.0,4.0,0.31,1.39,18.7,18.4,0.3,0.02,0.84,Matches,233.0,es ESP,FW,31.0,12.9,413.0,8.0,34.0,174.0,208.0,41.0,413.0,24.0,12.0,50.0,10.0,41.7,241.0,1015.0,344.0,12.0,10.0,5.0,27.0,24.0,303.0,55.0,Matches,233.0,es ESP,FW,31.0,12.9,3.0,27.0,13.0,48.1,2.09,1.0,0.11,0.23,15.5,0.0,0.0,0.0,3.4,3.4,0.12,-0.4,-0.4,Matches,233.0,es ESP,FW,31.0,17.0,14.0,1165.0,12.9,3.0,0.0,3.0,3.0,0.0,0.0,2.0,0.0,3.4,3.4,0.5,3.9,12.0,28.0,55.0,0.23,0.0,0.23,0.23,0.23,0.26,0.04,0.3,0.26,0.3,Matches,Sergi Guardiola,AM/S RLC,31,131,139,Spain,Valladolid,7,12,13,14,12,9,14,12,7,3,13,12,4,13,11,13,13,14,13,12,13,16,11,12,15,10,12,14,12,12,11,14,15,14,12,14,15,9,17,8,13,3,2,2,1,4,3,2,2,1,2,3,14,13,10,12,13,14,13,12,1,1,1,1,1,1,1,12,1,12,17,17,15,20,187,76,20,8,2685172,6550,6550,4550,Mediterranean_Hispanic,128,5,1991/5/29,0,0,5345.0,,67138759
659,Nemanja Gudelj,Sevilla,1991,234.0,rs SRB,DFMF,30.0,30.9,43.0,33.0,22.0,18.0,3.0,20.0,33.0,60.6,13.0,39.0,29.0,10.0,34.0,77.0,102.0,1.0,Matches,234.0,rs SRB,DFMF,30.0,30.9,30.0,0.97,25.0,1.0,0.0,3.0,1.0,0.0,3.0,0.1,2.0,0.0,0.0,1.0,0.0,0.0,Matches,,,,,,,,,,,,,,,,,,,,,,,,,,,,,,,,,,,,,,,,,,,,,,,,,,,,,,,,234.0,rs SRB,DFMF,30.0,30.9,8.0,0.0,0.0,26.0,21.0,1.0,3.0,34.0,33.0,0.0,0.0,0.0,119.0,47.0,23.0,67.1,Matches,234.0,rs SRB,DFMF,30.0,30.9,1602.0,1527.0,70.0,57.0,1.0,9.0,3.0,6.0,0.0,0.0,0.0,0.0,1445.0,5.0,4.0,Matches,234.0,rs SRB,DFMF,30.0,30.9,1445.0,1602.0,90.2,25141.0,8231.0,593.0,639.0,92.8,737.0,781.0,94.4,88.0,134.0,65.7,1.0,0.4,0.6,0.6,5.0,113.0,6.0,2.0,110.0,Matches,285,rs SRB,DFMF,30,34,2779.0,82.0,81.3,30.9,31,87.0,28,3,30.0,2,1.29,36.0,46.0,-10.0,-0.32,-0.75,37.3,42.6,-5.3,-0.17,0.21,Matches,234.0,rs SRB,DFMF,30.0,30.9,1911.0,206.0,837.0,910.0,169.0,18.0,1911.0,5.0,3.0,60.0,2.0,40.0,1103.0,5878.0,3393.0,29.0,37.0,0.0,14.0,2.0,1278.0,6.0,Matches,234.0,rs SRB,DFMF,30.0,30.9,3.0,38.0,9.0,23.7,1.23,0.29,0.08,0.33,25.8,3.0,0.0,0.0,1.7,1.7,0.05,1.3,1.3,Matches,234.0,rs SRB,DFMF,30.0,34.0,31.0,2779.0,30.9,3.0,1.0,4.0,3.0,0.0,0.0,8.0,0.0,1.7,1.7,0.4,2.1,29.0,110.0,6.0,0.1,0.03,0.13,0.1,0.13,0.06,0.01,0.07,0.06,0.07,Matches,Nemanja Gudelj,DM/M C,30,136,144,"Serbia,Holland,Bosnia and Herzegovina",Sevilla,14,12,13,10,15,13,11,13,12,9,14,12,9,13,16,13,13,14,13,13,12,16,14,11,13,10,15,17,12,13,13,12,14,11,15,14,15,13,13,9,12,2,1,3,2,3,1,4,3,4,2,1,14,16,10,3,17,14,11,7,1,1,15,1,1,1,20,1,19,1,1,12,1,1,186,77,11,20,7634150,6797,6947,5247,Mediterranean_Hispanic,129,6,1991/11/16,48,1,101700.0,,62013805
660,Pape Gueye,Sevilla,1999,237.0,sn SEN,MF,23.0,13.0,37.0,22.0,13.0,21.0,3.0,16.0,33.0,48.5,17.0,21.0,5.0,16.0,22.0,59.0,10.0,0.0,Matches,237.0,sn SEN,MF,23.0,13.0,31.0,2.38,22.0,0.0,4.0,1.0,3.0,1.0,6.0,0.46,5.0,0.0,0.0,0.0,1.0,0.0,Matches,,,,,,,,,,,,,,,,,,,,,,,,,,,,,,,,,,,,,,,,,,,,,,,,,,,,,,,,237.0,sn SEN,MF,23.0,13.0,6.0,3.0,2.0,30.0,34.0,1.0,18.0,22.0,22.0,2.0,0.0,0.0,81.0,19.0,17.0,52.8,Matches,237.0,sn SEN,MF,23.0,13.0,553.0,536.0,15.0,15.0,1.0,10.0,18.0,0.0,0.0,0.0,0.0,0.0,447.0,2.0,10.0,Matches,237.0,sn SEN,MF,23.0,13.0,447.0,553.0,80.8,8299.0,2200.0,205.0,223.0,91.9,177.0,209.0,84.7,61.0,94.0,64.9,3.0,1.2,0.9,1.8,10.0,52.0,2.0,1.0,59.0,Matches,289,sn SEN,MF,23,16,1171.0,73.0,34.2,13.0,15,76.0,8,1,36.0,0,1.38,16.0,21.0,-5.0,-0.38,-0.3,17.6,18.6,-1.0,-0.07,0.21,Matches,237.0,sn SEN,MF,23.0,13.0,699.0,24.0,144.0,422.0,141.0,21.0,699.0,23.0,14.0,60.9,6.0,26.1,403.0,1927.0,818.0,9.0,13.0,2.0,19.0,11.0,438.0,27.0,Matches,237.0,sn SEN,MF,23.0,13.0,1.0,20.0,5.0,25.0,1.54,0.38,0.05,0.2,19.2,0.0,0.0,0.0,1.3,1.3,0.06,-0.3,-0.3,Matches,237.0,sn SEN,MF,23.0,16.0,15.0,1171.0,13.0,1.0,3.0,4.0,1.0,0.0,0.0,6.0,3.0,1.3,1.3,1.2,2.4,9.0,59.0,27.0,0.08,0.23,0.31,0.08,0.31,0.1,0.09,0.18,0.1,0.18,Matches,Pape Gueye,DM/M C,23,125,145,"Senegal,France",Olympique de Marseille,11,8,11,6,13,10,10,14,3,12,14,9,14,13,12,13,11,7,8,12,12,13,13,12,13,14,15,14,14,11,14,10,14,14,14,14,11,11,10,12,9,2,1,3,3,2,1,2,2,1,1,2,13,15,13,7,8,7,11,10,1,1,1,1,1,1,20,1,18,1,1,1,1,1,183,65,20,10,4159691,6250,6000,4500,African_Caribbean,125,17,1999/1/24,11,0,27615.0,,48043484
661,Hugo Guillamón,Valencia,2000,238.0,es ESP,MF,22.0,18.1,20.0,12.0,10.0,8.0,2.0,8.0,24.0,33.3,16.0,14.0,2.0,12.0,19.0,39.0,30.0,2.0,Matches,238.0,es ESP,MF,22.0,18.1,61.0,3.36,42.0,13.0,0.0,0.0,5.0,1.0,6.0,0.33,4.0,2.0,0.0,0.0,0.0,0.0,Matches,,,,,,,,,,,,,,,,,,,,,,,,,,,,,,,,,,,,,,,,,,,,,,,,,,,,,,,,238.0,es ESP,MF,22.0,18.1,5.0,0.0,0.0,35.0,34.0,0.0,32.0,19.0,12.0,0.0,2.0,1.0,96.0,20.0,20.0,50.0,Matches,238.0,es ESP,MF,22.0,18.1,1028.0,932.0,88.0,69.0,4.0,18.0,32.0,1.0,16.0,2.0,13.0,0.0,852.0,8.0,14.0,Matches,238.0,es ESP,MF,22.0,18.1,852.0,1028.0,82.9,15768.0,4177.0,367.0,407.0,90.2,335.0,389.0,86.1,122.0,169.0,72.2,4.0,1.6,1.5,2.4,25.0,96.0,11.0,3.0,101.0,Matches,290,es ESP,MF,22,25,1632.0,65.0,47.7,18.1,19,80.0,11,6,20.0,11,1.04,20.0,23.0,-3.0,-0.17,-0.17,19.9,21.2,-1.2,-0.07,-0.42,Matches,238.0,es ESP,MF,22.0,18.1,1168.0,60.0,270.0,651.0,257.0,6.0,1167.0,5.0,1.0,20.0,3.0,60.0,603.0,2516.0,1107.0,11.0,15.0,0.0,9.0,15.0,781.0,20.0,Matches,238.0,es ESP,MF,22.0,18.1,1.0,3.0,1.0,33.3,0.17,0.06,0.0,0.0,22.7,0.0,1.0,1.0,1.1,0.3,0.1,-0.1,-0.3,Matches,238.0,es ESP,MF,22.0,25.0,19.0,1632.0,18.1,1.0,4.0,5.0,0.0,1.0,1.0,5.0,0.0,1.1,0.3,1.6,1.9,11.0,101.0,20.0,0.06,0.22,0.28,0.0,0.22,0.06,0.09,0.15,0.02,0.1,Matches,Hugo Guillamón,D/DM/M C,22,140,156,"Spain,Pays Basque",Valencia,9,9,11,8,13,9,11,10,11,12,14,11,12,13,12,14,13,14,15,14,15,15,13,9,12,15,15,15,13,13,13,12,14,12,14,12,14,12,11,6,12,2,3,3,2,2,1,3,3,2,1,3,12,14,4,17,15,16,11,12,1,1,18,1,1,1,20,1,18,1,1,1,1,1,182,76,12,20,33389998,7000,7000,5500,Mediterranean_Hispanic,138,2,2000/1/31,2,1,8351.0,,67258817
662,Gerard Gumbau,Elche,1994,239.0,es ESP,MF,27.0,30.4,44.0,25.0,17.0,23.0,4.0,18.0,51.0,35.3,33.0,32.0,8.0,24.0,28.0,72.0,40.0,0.0,Matches,239.0,es ESP,MF,27.0,30.4,121.0,3.98,56.0,57.0,2.0,5.0,1.0,0.0,7.0,0.23,3.0,4.0,0.0,0.0,0.0,0.0,Matches,,,,,,,,,,,,,,,,,,,,,,,,,,,,,,,,,,,,,,,,,,,,,,,,,,,,,,,,239.0,es ESP,MF,27.0,30.4,11.0,0.0,0.0,51.0,21.0,2.0,164.0,28.0,25.0,0.0,0.0,0.0,165.0,22.0,30.0,42.3,Matches,239.0,es ESP,MF,27.0,30.4,1446.0,1239.0,196.0,76.0,3.0,42.0,164.0,2.0,114.0,44.0,48.0,4.0,1112.0,11.0,37.0,Matches,239.0,es ESP,MF,27.0,30.4,1112.0,1446.0,76.9,22189.0,7192.0,458.0,523.0,87.6,414.0,484.0,85.5,204.0,337.0,60.5,6.0,6.2,6.1,-0.2,73.0,124.0,24.0,12.0,145.0,Matches,292,es ESP,MF,27,35,2737.0,78.0,80.0,30.4,31,84.0,20,4,36.0,0,0.69,24.0,54.0,-30.0,-0.99,-0.06,31.4,56.7,-25.3,-0.83,0.13,Matches,239.0,es ESP,MF,27.0,30.4,1709.0,60.0,336.0,955.0,433.0,28.0,1709.0,20.0,7.0,35.0,9.0,45.0,916.0,3944.0,1874.0,18.0,21.0,2.0,27.0,12.0,1050.0,52.0,Matches,239.0,es ESP,MF,27.0,30.4,1.0,47.0,18.0,38.3,1.55,0.59,0.02,0.06,25.5,6.0,0.0,0.0,2.3,2.3,0.05,-1.3,-1.3,Matches,239.0,es ESP,MF,27.0,35.0,31.0,2737.0,30.4,1.0,6.0,7.0,1.0,0.0,0.0,11.0,0.0,2.3,2.3,6.2,8.5,18.0,145.0,52.0,0.03,0.2,0.23,0.03,0.23,0.08,0.2,0.28,0.08,0.28,Matches,Gerard Gumbau,DM/M C,27,128,135,Spain,Elche,10,11,8,9,14,12,12,14,10,11,16,12,14,14,12,14,11,14,15,16,13,12,9,8,13,15,15,15,9,9,8,15,13,12,13,13,14,9,14,7,12,4,3,2,3,1,2,2,2,3,1,2,13,14,5,11,10,13,8,16,1,1,12,1,1,1,20,1,17,1,1,1,1,1,187,77,20,10,1704499,6200,6200,4500,Mediterranean_Hispanic,131,5,1994/12/18,0,0,6023.0,,67207185
663,Raúl Guti,Elche,1996,241.0,es ESP,MF,25.0,12.4,18.0,12.0,8.0,9.0,1.0,8.0,18.0,44.4,10.0,10.0,3.0,7.0,8.0,26.0,6.0,0.0,Matches,241.0,es ESP,MF,25.0,12.4,16.0,1.32,13.0,0.0,1.0,2.0,0.0,0.0,2.0,0.17,2.0,0.0,0.0,0.0,0.0,0.0,Matches,,,,,,,,,,,,,,,,,,,,,,,,,,,,,,,,,,,,,,,,,,,,,,,,,,,,,,,,241.0,es ESP,MF,25.0,12.4,1.0,0.0,0.0,8.0,22.0,1.0,9.0,8.0,12.0,0.0,0.0,0.0,64.0,6.0,10.0,37.5,Matches,241.0,es ESP,MF,25.0,12.4,409.0,399.0,8.0,3.0,0.0,8.0,9.0,1.0,3.0,0.0,3.0,0.0,327.0,2.0,10.0,Matches,241.0,es ESP,MF,25.0,12.4,327.0,409.0,80.0,4925.0,1368.0,194.0,217.0,89.4,87.0,103.0,84.5,30.0,52.0,57.7,0.0,0.1,0.3,-0.1,2.0,26.0,6.0,1.0,32.0,Matches,294,es ESP,MF,25,28,1117.0,40.0,32.7,12.4,12,67.0,3,16,20.0,9,0.68,11.0,25.0,-14.0,-1.13,-0.23,10.2,24.6,-14.4,-1.19,-0.49,Matches,241.0,es ESP,MF,25.0,12.4,521.0,12.0,120.0,283.0,123.0,18.0,521.0,13.0,5.0,38.5,8.0,61.5,307.0,1210.0,445.0,4.0,13.0,2.0,14.0,18.0,358.0,17.0,Matches,241.0,es ESP,MF,25.0,12.4,0.0,20.0,8.0,40.0,1.61,0.64,0.0,0.0,18.9,0.0,0.0,0.0,1.6,1.6,0.08,-1.6,-1.6,Matches,241.0,es ESP,MF,25.0,28.0,12.0,1117.0,12.4,0.0,0.0,0.0,0.0,0.0,0.0,1.0,0.0,1.6,1.6,0.1,1.7,4.0,32.0,17.0,0.0,0.0,0.0,0.0,0.0,0.13,0.01,0.14,0.13,0.14,Matches,Raúl Guti,DM/M RC,25,127,140,Spain,Elche,8,8,11,9,13,8,12,12,7,12,13,10,13,14,14,12,15,11,15,11,12,12,12,11,12,12,15,15,13,11,14,10,15,13,16,14,17,11,13,13,13,2,1,2,1,2,1,4,1,2,3,2,14,8,3,17,13,16,15,14,1,1,1,1,1,1,16,13,20,15,1,14,9,1,177,74,11,20,2255955,6200,6200,4550,Mediterranean_Hispanic,127,3,1996/12/30,0,0,3099.0,,67199098
664,Miguel Gutiérrez,Girona,2001,242.0,es ESP,DF,21.0,26.6,41.0,23.0,23.0,13.0,5.0,23.0,37.0,62.2,14.0,23.0,5.0,18.0,18.0,59.0,42.0,1.0,Matches,242.0,es ESP,DF,21.0,26.6,55.0,2.07,40.0,5.0,5.0,2.0,3.0,0.0,8.0,0.3,6.0,1.0,0.0,0.0,1.0,0.0,Matches,,,,,,,,,,,,,,,,,,,,,,,,,,,,,,,,,,,,,,,,,,,,,,,,,,,,,,,,242.0,es ESP,DF,21.0,26.6,6.0,0.0,0.0,23.0,24.0,3.0,104.0,18.0,23.0,0.0,0.0,0.0,157.0,9.0,16.0,36.0,Matches,242.0,es ESP,DF,21.0,26.6,1386.0,1142.0,240.0,25.0,2.0,1.0,104.0,213.0,2.0,0.0,0.0,0.0,1130.0,4.0,27.0,Matches,242.0,es ESP,DF,21.0,26.6,1130.0,1386.0,81.5,17750.0,5265.0,631.0,689.0,91.6,405.0,494.0,82.0,70.0,129.0,54.3,3.0,3.3,3.1,-0.3,22.0,92.0,29.0,16.0,125.0,Matches,295,es ESP,DF,21,34,2390.0,70.0,69.9,26.6,27,81.0,12,7,29.0,2,1.24,36.0,36.0,0.0,0.0,-0.26,35.1,34.4,0.7,0.02,0.45,Matches,242.0,es ESP,DF,21.0,26.6,1628.0,66.0,466.0,697.0,482.0,39.0,1628.0,75.0,35.0,46.7,32.0,42.7,959.0,5765.0,2803.0,81.0,43.0,17.0,36.0,25.0,1037.0,148.0,Matches,242.0,es ESP,DF,21.0,26.6,2.0,17.0,4.0,23.5,0.64,0.15,0.12,0.5,19.4,0.0,0.0,0.0,0.8,0.8,0.05,1.2,1.2,Matches,242.0,es ESP,DF,21.0,34.0,27.0,2390.0,26.6,2.0,3.0,5.0,2.0,0.0,0.0,6.0,0.0,0.8,0.8,3.3,4.1,81.0,125.0,148.0,0.08,0.11,0.19,0.08,0.19,0.03,0.12,0.15,0.03,0.15,Matches,Miguel Gutiérrez,D/WB L,20,122,155,Spain,Girona,11,14,15,9,13,9,9,6,13,12,13,4,12,14,11,12,10,10,11,13,13,16,12,15,13,11,11,11,15,12,13,12,12,14,11,9,9,12,10,13,12,2,3,3,3,3,2,3,1,4,1,1,19,10,7,9,10,12,11,20,1,20,1,1,16,1,1,1,1,1,1,1,1,1,180,73,20,10,10344000,6200,6200,3250,Mediterranean_Hispanic,117,5,2001/7/27,0,0,6023.0,,67276071
665,Luiz Henrique,Betis,2001,247.0,br BRA,FW,21.0,20.1,48.0,34.0,27.0,15.0,6.0,20.0,44.0,45.5,24.0,22.0,0.0,22.0,14.0,62.0,17.0,0.0,Matches,247.0,br BRA,FW,21.0,20.1,47.0,2.34,28.0,0.0,10.0,5.0,2.0,2.0,4.0,0.2,2.0,0.0,1.0,1.0,0.0,0.0,Matches,,,,,,,,,,,,,,,,,,,,,,,,,,,,,,,,,,,,,,,,,,,,,,,,,,,,,,,,247.0,br BRA,FW,21.0,20.1,6.0,0.0,0.0,25.0,41.0,5.0,31.0,14.0,34.0,0.0,0.0,0.0,127.0,27.0,41.0,39.7,Matches,247.0,br BRA,FW,21.0,20.1,561.0,549.0,11.0,2.0,1.0,3.0,31.0,9.0,0.0,0.0,0.0,0.0,415.0,1.0,31.0,Matches,247.0,br BRA,FW,21.0,20.1,415.0,561.0,74.0,5705.0,1138.0,265.0,310.0,85.5,114.0,154.0,74.0,17.0,32.0,53.1,3.0,2.9,2.1,0.1,17.0,13.0,14.0,6.0,26.0,Matches,301,br BRA,FW,21,33,1807.0,55.0,52.8,20.1,21,68.0,3,12,31.0,2,1.42,13.0,25.0,-12.0,-0.6,-1.55,20.2,29.3,-9.0,-0.45,-1.03,Matches,247.0,br BRA,FW,21.0,20.1,880.0,17.0,160.0,369.0,375.0,60.0,880.0,125.0,56.0,44.8,50.0,40.0,564.0,4024.0,1665.0,61.0,41.0,24.0,58.0,59.0,596.0,137.0,Matches,247.0,br BRA,FW,21.0,20.1,1.0,42.0,17.0,40.5,2.09,0.85,0.02,0.06,19.7,0.0,0.0,0.0,2.9,2.9,0.07,-1.9,-1.9,Matches,247.0,br BRA,FW,21.0,33.0,21.0,1807.0,20.1,1.0,3.0,4.0,1.0,0.0,0.0,6.0,0.0,2.9,2.9,2.9,5.8,61.0,26.0,137.0,0.05,0.15,0.2,0.05,0.2,0.15,0.14,0.29,0.15,0.29,Matches,Luiz Henrique,AM/S RL,21,130,150,Brazil,Real Hispalis,7,12,15,11,13,8,10,11,7,6,13,11,7,15,8,12,11,12,11,12,12,13,15,8,12,7,11,13,15,14,11,11,10,15,12,11,12,5,10,4,12,1,3,2,2,3,1,2,3,2,2,3,15,11,6,12,11,12,7,11,1,1,1,1,1,1,1,12,1,12,18,1,20,16,182,0,20,7,10500000,6350,6350,2000,African_Caribbean,124,17,2001/1/2,0,0,8759.0,,19377206
666,Mario Hermoso,Atlético Madrid,1995,248.0,es ESP,DF,27.0,23.4,22.0,15.0,14.0,6.0,2.0,9.0,30.0,30.0,21.0,19.0,9.0,10.0,19.0,41.0,85.0,1.0,Matches,248.0,es ESP,DF,27.0,23.4,33.0,1.41,27.0,0.0,0.0,4.0,1.0,1.0,3.0,0.13,1.0,0.0,0.0,2.0,0.0,0.0,Matches,,,,,,,,,,,,,,,,,,,,,,,,,,,,,,,,,,,,,,,,,,,,,,,,,,,,,,,,248.0,es ESP,DF,27.0,23.4,7.0,2.0,2.0,27.0,13.0,2.0,16.0,19.0,15.0,0.0,1.0,0.0,137.0,35.0,27.0,56.5,Matches,248.0,es ESP,DF,27.0,23.4,1514.0,1381.0,126.0,39.0,5.0,38.0,16.0,87.0,0.0,0.0,0.0,0.0,1309.0,7.0,17.0,Matches,248.0,es ESP,DF,27.0,23.4,1309.0,1514.0,86.5,23825.0,8990.0,609.0,655.0,93.0,523.0,568.0,92.1,154.0,236.0,65.3,2.0,1.4,1.4,0.6,14.0,89.0,11.0,2.0,115.0,Matches,302,es ESP,DF,27,26,2110.0,81.0,61.7,23.4,24,87.0,21,2,15.0,10,2.19,52.0,19.0,33.0,1.41,1.13,41.7,25.5,16.2,0.69,0.37,Matches,248.0,es ESP,DF,27.0,23.4,1717.0,139.0,717.0,840.0,171.0,21.0,1717.0,22.0,14.0,63.6,7.0,31.8,886.0,3555.0,1979.0,23.0,16.0,0.0,20.0,9.0,1145.0,17.0,Matches,248.0,es ESP,DF,27.0,23.4,3.0,15.0,5.0,33.3,0.64,0.21,0.2,0.6,16.1,0.0,0.0,0.0,2.1,2.1,0.15,0.9,0.9,Matches,248.0,es ESP,DF,27.0,26.0,24.0,2110.0,23.4,3.0,2.0,5.0,3.0,0.0,0.0,7.0,2.0,2.1,2.1,1.4,3.5,23.0,115.0,17.0,0.13,0.09,0.21,0.13,0.21,0.09,0.06,0.15,0.09,0.15,Matches,Mario Hermoso,D LC,27,143,158,Spain,A. Madrid,7,10,10,7,10,8,14,9,14,15,12,10,16,12,13,14,14,14,14,11,12,14,8,10,9,15,14,14,14,14,13,11,13,15,14,14,12,11,13,8,15,1,1,1,2,1,3,1,1,2,3,3,13,12,12,9,10,13,7,7,1,17,20,1,12,1,1,8,1,1,1,1,1,1,184,75,20,10,13716520,7150,7150,6150,Mediterranean_Hispanic,142,4,1995/6/18,5,0,164999.0,,67196188
667,Aridane Hernández,Osasuna,1989,250.0,es ESP,DF,33.0,19.9,21.0,15.0,17.0,4.0,0.0,12.0,25.0,48.0,13.0,34.0,21.0,13.0,28.0,49.0,96.0,1.0,Matches,250.0,es ESP,DF,33.0,19.9,12.0,0.6,10.0,1.0,0.0,1.0,0.0,0.0,2.0,0.1,1.0,1.0,0.0,0.0,0.0,0.0,Matches,,,,,,,,,,,,,,,,,,,,,,,,,,,,,,,,,,,,,,,,,,,,,,,,,,,,,,,,250.0,es ESP,DF,33.0,19.9,1.0,0.0,0.0,14.0,12.0,0.0,0.0,28.0,15.0,0.0,0.0,1.0,107.0,30.0,15.0,66.7,Matches,250.0,es ESP,DF,33.0,19.9,882.0,836.0,46.0,44.0,0.0,12.0,0.0,1.0,0.0,0.0,0.0,0.0,745.0,0.0,7.0,Matches,250.0,es ESP,DF,33.0,19.9,745.0,882.0,84.5,15152.0,4941.0,248.0,271.0,91.5,390.0,439.0,88.8,105.0,160.0,65.6,1.0,0.7,0.4,0.3,3.0,42.0,2.0,0.0,47.0,Matches,304,es ESP,DF,33,23,1793.0,78.0,52.4,19.9,20,88.0,19,3,13.0,12,1.17,17.0,25.0,-8.0,-0.4,-0.57,18.4,27.3,-9.0,-0.45,-0.62,Matches,250.0,es ESP,DF,33.0,19.9,1081.0,157.0,567.0,496.0,26.0,11.0,1081.0,7.0,6.0,85.7,0.0,0.0,593.0,2801.0,1407.0,6.0,5.0,1.0,6.0,3.0,614.0,0.0,Matches,250.0,es ESP,DF,33.0,19.9,0.0,5.0,1.0,20.0,0.25,0.05,0.0,0.0,11.0,0.0,0.0,0.0,0.2,0.2,0.04,-0.2,-0.2,Matches,250.0,es ESP,DF,33.0,23.0,20.0,1793.0,19.9,0.0,1.0,1.0,0.0,0.0,0.0,1.0,0.0,0.2,0.2,0.7,0.9,6.0,47.0,0.0,0.0,0.05,0.05,0.0,0.05,0.01,0.04,0.05,0.01,0.05,Matches,Aridane Hernández,D C,33,133,136,Spain,Atlético Pamplona,6,7,8,8,7,6,16,7,9,14,9,7,13,11,13,15,15,13,14,9,12,14,11,13,7,16,14,14,11,10,14,16,13,12,14,15,14,9,14,10,8,3,2,2,3,3,3,3,3,3,2,3,19,13,9,13,10,11,12,13,1,1,20,5,1,1,8,1,1,1,1,1,1,1,186,77,8,20,1762406,6800,6800,3800,Mediterranean_Hispanic,131,8,1989/3/23,0,0,15875.0,,67006487
668,Luis Hernández,Cádiz,1989,251.0,es ESP,DF,33.0,35.0,33.0,21.0,25.0,7.0,1.0,22.0,36.0,61.1,14.0,31.0,24.0,7.0,31.0,64.0,145.0,0.0,Matches,251.0,es ESP,DF,33.0,35.0,36.0,1.03,20.0,13.0,0.0,2.0,0.0,1.0,3.0,0.09,2.0,1.0,0.0,0.0,0.0,0.0,Matches,,,,,,,,,,,,,,,,,,,,,,,,,,,,,,,,,,,,,,,,,,,,,,,,,,,,,,,,251.0,es ESP,DF,33.0,35.0,8.0,1.0,1.0,27.0,7.0,2.0,18.0,31.0,21.0,0.0,0.0,0.0,148.0,40.0,23.0,63.5,Matches,251.0,es ESP,DF,33.0,35.0,1488.0,1232.0,250.0,65.0,0.0,25.0,18.0,184.0,0.0,0.0,0.0,0.0,1078.0,6.0,14.0,Matches,251.0,es ESP,DF,33.0,35.0,1078.0,1488.0,72.4,23046.0,9678.0,323.0,361.0,89.5,558.0,670.0,83.3,186.0,415.0,44.8,0.0,0.9,1.0,-0.9,12.0,81.0,7.0,4.0,95.0,Matches,305,es ESP,DF,33,35,3149.0,90.0,92.1,35.0,35,90.0,34,0,,1,1.17,28.0,46.0,-18.0,-0.51,1.15,39.6,55.7,-16.1,-0.46,0.87,Matches,251.0,es ESP,DF,33.0,35.0,1788.0,218.0,833.0,731.0,230.0,14.0,1788.0,4.0,3.0,75.0,0.0,0.0,783.0,3449.0,2033.0,10.0,5.0,0.0,5.0,2.0,894.0,8.0,Matches,251.0,es ESP,DF,33.0,35.0,0.0,7.0,1.0,14.3,0.2,0.03,0.0,0.0,12.2,0.0,0.0,0.0,0.3,0.3,0.04,-0.3,-0.3,Matches,251.0,es ESP,DF,33.0,35.0,35.0,3149.0,35.0,0.0,0.0,0.0,0.0,0.0,0.0,8.0,1.0,0.3,0.3,0.9,1.2,10.0,95.0,8.0,0.0,0.0,0.0,0.0,0.0,0.01,0.02,0.03,0.01,0.03,Matches,Luis Hernández,D C,33,129,141,Spain,Cádiz,10,11,10,6,11,7,12,10,20,14,12,10,13,11,12,14,12,12,12,10,14,14,9,10,10,13,14,14,11,12,10,13,13,12,14,12,14,8,14,5,14,2,1,1,1,2,3,1,2,1,2,3,7,13,7,13,9,14,12,10,1,1,20,14,1,10,1,1,1,1,1,1,1,1,183,75,13,20,768021,6350,6350,5050,Mediterranean_Hispanic,128,6,1989/4/14,0,0,10015.0,,67030712
669,Sergio Herrera,Osasuna,1993,255.0,es ESP,GK,29.0,17.0,2.0,0.0,2.0,0.0,0.0,2.0,2.0,100.0,0.0,1.0,0.0,1.0,1.0,3.0,6.0,2.0,Matches,255.0,es ESP,GK,29.0,17.0,7.0,0.41,7.0,0.0,0.0,0.0,0.0,0.0,1.0,0.06,1.0,0.0,0.0,0.0,0.0,0.0,Matches,20.0,es ESP,GK,29.0,17.0,23.0,1.0,1.0,3.0,1.0,21.4,0.28,-0.6,-0.04,151.0,351.0,43.0,475.0,58.0,56.0,42.7,135.0,63.0,48.3,215.0,16.0,7.4,20.0,1.18,18.5,Matches,20.0,es ESP,GK,29.0,17.0,17.0,1530.0,17.0,23.0,1.35,71.0,48.0,69.0,5.0,3.0,9.0,3.0,17.6,4.0,1.0,1.0,2.0,50.0,Matches,255.0,es ESP,GK,29.0,17.0,3.0,0.0,0.0,1.0,4.0,0.0,0.0,1.0,0.0,0.0,1.0,1.0,12.0,2.0,1.0,66.7,Matches,255.0,es ESP,GK,29.0,17.0,611.0,413.0,197.0,62.0,0.0,3.0,0.0,0.0,0.0,0.0,0.0,0.0,389.0,1.0,0.0,Matches,255.0,es ESP,GK,29.0,17.0,389.0,611.0,63.7,14092.0,11862.0,31.0,32.0,96.9,158.0,162.0,97.5,200.0,415.0,48.2,0.0,0.0,0.0,0.0,1.0,28.0,0.0,0.0,0.0,Matches,310,es ESP,GK,29,17,1530.0,90.0,44.7,17.0,17,90.0,17,0,,19,1.06,14.0,23.0,-9.0,-0.53,-0.72,19.2,21.4,-2.2,-0.13,0.04,Matches,255.0,es ESP,GK,29.0,17.0,653.0,515.0,645.0,8.0,0.0,0.0,653.0,2.0,2.0,100.0,0.0,0.0,336.0,1990.0,1230.0,0.0,0.0,0.0,2.0,0.0,266.0,0.0,Matches,255.0,es ESP,GK,29.0,17.0,0.0,0.0,0.0,,0.0,0.0,,,,0.0,0.0,0.0,0.0,0.0,,0.0,0.0,Matches,255.0,es ESP,GK,29.0,17.0,17.0,1530.0,17.0,0.0,0.0,0.0,0.0,0.0,0.0,3.0,0.0,0.0,0.0,0.0,0.0,0.0,0.0,0.0,0.0,0.0,0.0,0.0,0.0,0.0,0.0,0.0,0.0,0.0,Matches,Sergio Herrera,GK,29,132,142,"Spain,Pays Basque",Atlético Pamplona,4,3,3,1,10,9,3,2,2,3,9,2,2,9,10,13,12,12,14,9,12,15,5,11,3,11,13,12,11,14,10,13,13,11,14,14,14,9,13,15,13,13,13,14,13,14,10,14,16,12,11,13,9,13,7,12,10,12,11,20,20,1,1,1,1,1,1,1,1,1,1,1,1,1,192,82,9,20,5788304,6600,6600,4750,Mediterranean_Hispanic,129,8,1993/6/5,0,0,11901.0,,67181753
670,Yangel Herrera,Girona,1998,256.0,ve VEN,MFFW,24.0,10.7,26.0,9.0,9.0,14.0,3.0,6.0,15.0,40.0,9.0,14.0,1.0,13.0,4.0,30.0,12.0,0.0,Matches,256.0,ve VEN,MFFW,24.0,10.7,21.0,1.96,17.0,0.0,0.0,1.0,1.0,2.0,3.0,0.28,2.0,0.0,0.0,0.0,0.0,1.0,Matches,,,,,,,,,,,,,,,,,,,,,,,,,,,,,,,,,,,,,,,,,,,,,,,,,,,,,,,,256.0,ve VEN,MFFW,24.0,10.7,4.0,0.0,0.0,34.0,22.0,2.0,19.0,4.0,9.0,0.0,0.0,0.0,45.0,18.0,31.0,36.7,Matches,256.0,ve VEN,MFFW,24.0,10.7,418.0,407.0,8.0,1.0,4.0,4.0,19.0,1.0,0.0,0.0,0.0,0.0,332.0,3.0,5.0,Matches,256.0,ve VEN,MFFW,24.0,10.7,332.0,418.0,79.4,4970.0,1262.0,186.0,206.0,90.3,109.0,134.0,81.3,24.0,44.0,54.5,2.0,1.0,1.0,1.0,11.0,31.0,10.0,2.0,46.0,Matches,311,ve VEN,MFFW,24,20,963.0,48.0,28.2,10.7,12,63.0,2,8,27.0,1,1.0,12.0,19.0,-7.0,-0.65,-1.02,11.9,17.6,-5.7,-0.53,-0.58,Matches,256.0,ve VEN,MFFW,24.0,10.7,556.0,17.0,82.0,301.0,180.0,32.0,556.0,23.0,12.0,52.2,8.0,34.8,346.0,1611.0,686.0,18.0,14.0,3.0,25.0,22.0,417.0,56.0,Matches,256.0,ve VEN,MFFW,24.0,10.7,2.0,24.0,8.0,33.3,2.24,0.75,0.08,0.25,17.9,0.0,0.0,0.0,2.3,2.3,0.09,-0.3,-0.3,Matches,256.0,ve VEN,MFFW,24.0,20.0,12.0,963.0,10.7,2.0,2.0,4.0,2.0,0.0,0.0,4.0,0.0,2.3,2.3,1.0,3.3,18.0,46.0,56.0,0.19,0.19,0.37,0.19,0.37,0.22,0.1,0.31,0.21,0.31,Matches,Yangel Herrera,DM/M C,24,138,155,Venezuela,Manchester City,8,9,11,9,13,9,12,14,8,11,14,11,12,14,16,14,14,13,14,13,15,14,8,13,12,9,13,15,14,13,13,12,15,13,15,13,13,13,12,10,13,2,3,4,4,2,3,1,3,3,1,4,13,15,12,10,12,11,10,8,1,1,12,1,1,1,16,11,20,1,1,7,1,1,184,77,12,20,16363534,6900,6900,5500,Mediterranean_Hispanic,138,12,1998/1/7,25,2,23198.0,Girona,86047272
671,Martin Hongla,Valladolid,1998,258.0,cm CMR,DFMF,24.0,14.5,18.0,13.0,13.0,5.0,0.0,11.0,21.0,52.4,10.0,15.0,12.0,3.0,8.0,26.0,46.0,1.0,Matches,258.0,cm CMR,DFMF,24.0,14.5,11.0,0.76,9.0,2.0,0.0,0.0,0.0,0.0,1.0,0.07,1.0,0.0,0.0,0.0,0.0,0.0,Matches,,,,,,,,,,,,,,,,,,,,,,,,,,,,,,,,,,,,,,,,,,,,,,,,,,,,,,,,258.0,cm CMR,DFMF,24.0,14.5,7.0,2.0,1.0,21.0,3.0,2.0,7.0,8.0,13.0,0.0,1.0,0.0,98.0,7.0,16.0,30.4,Matches,258.0,cm CMR,DFMF,24.0,14.5,634.0,610.0,18.0,15.0,1.0,10.0,7.0,1.0,0.0,0.0,0.0,0.0,520.0,6.0,7.0,Matches,258.0,cm CMR,DFMF,24.0,14.5,520.0,634.0,82.0,11242.0,3295.0,147.0,172.0,85.5,265.0,285.0,93.0,98.0,151.0,64.9,0.0,0.3,0.3,-0.3,2.0,33.0,4.0,1.0,50.0,Matches,315,cm CMR,DFMF,24,16,1306.0,82.0,38.2,14.5,15,84.0,9,1,44.0,0,1.0,15.0,25.0,-10.0,-0.69,0.16,15.0,25.5,-10.4,-0.72,-0.03,Matches,258.0,cm CMR,DFMF,24.0,14.5,745.0,84.0,333.0,371.0,46.0,1.0,745.0,11.0,9.0,81.8,2.0,18.2,455.0,2458.0,1302.0,6.0,7.0,1.0,14.0,1.0,463.0,5.0,Matches,258.0,cm CMR,DFMF,24.0,14.5,0.0,1.0,0.0,0.0,0.07,0.0,0.0,,33.5,0.0,0.0,0.0,0.0,0.0,0.03,0.0,0.0,Matches,258.0,cm CMR,DFMF,24.0,16.0,15.0,1306.0,14.5,0.0,0.0,0.0,0.0,0.0,0.0,7.0,2.0,0.0,0.0,0.3,0.3,6.0,50.0,5.0,0.0,0.0,0.0,0.0,0.0,0.0,0.02,0.02,0.0,0.02,Matches,Martin Hongla,DM/M C,24,125,138,Cameroon,Hellas Verona,5,8,10,8,13,9,12,12,9,11,13,12,12,12,16,12,12,13,13,12,13,12,8,10,12,12,15,15,13,12,14,12,15,12,16,14,14,12,11,6,13,3,3,1,3,2,1,3,3,1,4,3,11,12,8,11,12,14,12,10,1,1,14,1,1,1,20,1,20,1,1,1,1,1,181,79,9,20,2574089,6250,5900,4250,African_Caribbean,124,18,1998/3/16,17,0,5999.0,,13157239
672,Borja Iglesias,Betis,1993,261.0,es ESP,FW,29.0,26.3,8.0,4.0,3.0,3.0,2.0,2.0,13.0,15.4,11.0,9.0,1.0,8.0,1.0,9.0,17.0,0.0,Matches,261.0,es ESP,FW,29.0,26.3,40.0,1.52,29.0,1.0,1.0,5.0,4.0,0.0,5.0,0.19,4.0,0.0,0.0,1.0,0.0,0.0,Matches,,,,,,,,,,,,,,,,,,,,,,,,,,,,,,,,,,,,,,,,,,,,,,,,,,,,,,,,261.0,es ESP,FW,29.0,26.3,2.0,1.0,0.0,40.0,52.0,22.0,0.0,1.0,4.0,0.0,0.0,0.0,46.0,24.0,44.0,35.3,Matches,261.0,es ESP,FW,29.0,26.3,522.0,467.0,54.0,1.0,5.0,4.0,0.0,4.0,0.0,0.0,0.0,0.0,397.0,1.0,24.0,Matches,261.0,es ESP,FW,29.0,26.3,397.0,522.0,76.1,4818.0,691.0,260.0,320.0,81.3,73.0,97.0,75.3,19.0,22.0,86.4,3.0,2.8,2.2,0.2,22.0,13.0,14.0,0.0,33.0,Matches,318,es ESP,FW,29,35,2365.0,68.0,69.2,26.3,29,76.0,6,6,29.0,0,1.63,36.0,24.0,12.0,0.46,1.05,37.0,30.6,6.4,0.24,0.68,Matches,261.0,es ESP,FW,29.0,26.3,776.0,18.0,39.0,357.0,387.0,118.0,770.0,32.0,12.0,37.5,14.0,43.8,467.0,2132.0,691.0,20.0,14.0,20.0,81.0,38.0,638.0,147.0,Matches,261.0,es ESP,FW,29.0,26.3,15.0,58.0,21.0,36.2,2.21,0.8,0.17,0.48,15.2,0.0,5.0,6.0,14.9,10.2,0.18,0.1,-0.2,Matches,261.0,es ESP,FW,29.0,35.0,29.0,2365.0,26.3,15.0,3.0,18.0,10.0,5.0,6.0,2.0,1.0,14.9,10.2,2.8,13.0,20.0,33.0,147.0,0.57,0.11,0.68,0.38,0.49,0.57,0.11,0.67,0.39,0.49,Matches,Borja Iglesias,S,29,151,155,Spain,Real Hispalis,5,11,13,16,13,10,16,12,7,7,12,14,8,13,12,15,14,13,14,12,14,14,12,13,16,9,15,16,13,13,13,15,14,15,13,16,12,7,13,6,10,3,2,1,2,3,2,1,1,2,2,2,11,12,6,12,14,16,18,14,1,1,1,1,1,1,1,1,1,1,10,1,14,20,187,86,11,20,18054223,7100,7100,6000,Mediterranean_Hispanic,150,5,1993/1/17,0,0,25377.0,,67173048
673,Asier Illarramendi,Real Sociedad,1990,262.0,es ESP,MF,32.0,12.0,36.0,18.0,10.0,22.0,4.0,16.0,44.0,36.4,28.0,27.0,8.0,19.0,18.0,54.0,20.0,0.0,Matches,262.0,es ESP,MF,32.0,12.0,27.0,2.26,22.0,3.0,0.0,0.0,1.0,1.0,2.0,0.17,2.0,0.0,0.0,0.0,0.0,0.0,Matches,,,,,,,,,,,,,,,,,,,,,,,,,,,,,,,,,,,,,,,,,,,,,,,,,,,,,,,,262.0,es ESP,MF,32.0,12.0,5.0,0.0,0.0,25.0,13.0,0.0,6.0,18.0,18.0,0.0,0.0,0.0,67.0,16.0,20.0,44.4,Matches,262.0,es ESP,MF,32.0,12.0,640.0,607.0,29.0,18.0,0.0,3.0,6.0,5.0,3.0,0.0,2.0,0.0,545.0,4.0,10.0,Matches,262.0,es ESP,MF,32.0,12.0,545.0,640.0,85.2,8295.0,2035.0,297.0,329.0,90.3,198.0,220.0,90.0,32.0,49.0,65.3,0.0,0.4,0.4,-0.4,10.0,53.0,3.0,1.0,48.0,Matches,319,es ESP,MF,32,24,1076.0,45.0,31.5,12.0,13,69.0,2,11,16.0,13,2.04,15.0,5.0,10.0,0.84,0.61,14.1,9.3,4.8,0.4,-0.18,Matches,262.0,es ESP,MF,32.0,12.0,790.0,33.0,160.0,477.0,156.0,12.0,790.0,7.0,7.0,100.0,0.0,0.0,426.0,1917.0,799.0,10.0,18.0,1.0,15.0,8.0,516.0,24.0,Matches,262.0,es ESP,MF,32.0,12.0,1.0,11.0,3.0,27.3,0.92,0.25,0.09,0.33,20.5,0.0,0.0,0.0,0.8,0.8,0.07,0.2,0.2,Matches,262.0,es ESP,MF,32.0,24.0,13.0,1076.0,12.0,1.0,0.0,1.0,1.0,0.0,0.0,5.0,0.0,0.8,0.8,0.4,1.2,10.0,48.0,24.0,0.08,0.0,0.08,0.08,0.08,0.07,0.03,0.1,0.07,0.1,Matches,Asier Illarramendi,DM/M C,32,136,155,"Spain,Pays Basque",Real San Sebastián,11,10,11,11,13,12,8,14,6,14,15,9,14,15,15,14,14,14,16,15,15,9,7,12,9,15,19,17,10,11,13,10,11,9,11,13,13,13,14,15,9,1,1,2,2,1,2,3,1,1,1,1,12,12,4,17,11,17,15,15,1,1,1,1,1,1,20,1,20,1,1,1,1,1,179,76,8,20,5971909,6800,6800,6000,Mediterranean_Hispanic,137,5,1990/3/8,3,1,55000.0,,67039257
674,Nicolas Jackson,Villarreal,2001,266.0,sn SEN,FW,21.0,17.8,14.0,11.0,2.0,10.0,2.0,2.0,8.0,25.0,6.0,18.0,2.0,16.0,2.0,16.0,4.0,0.0,Matches,266.0,sn SEN,FW,21.0,17.8,47.0,2.65,31.0,1.0,8.0,5.0,2.0,0.0,14.0,0.79,4.0,0.0,7.0,2.0,1.0,0.0,Matches,,,,,,,,,,,,,,,,,,,,,,,,,,,,,,,,,,,,,,,,,,,,,,,,,,,,,,,,266.0,sn SEN,FW,21.0,17.8,6.0,1.0,1.0,32.0,26.0,13.0,5.0,2.0,11.0,0.0,0.0,0.0,46.0,13.0,30.0,30.2,Matches,266.0,sn SEN,FW,21.0,17.8,325.0,299.0,25.0,0.0,0.0,0.0,5.0,1.0,0.0,0.0,0.0,0.0,246.0,1.0,10.0,Matches,266.0,sn SEN,FW,21.0,17.8,246.0,325.0,75.7,3440.0,710.0,143.0,183.0,78.1,69.0,84.0,82.1,13.0,15.0,86.7,4.0,3.1,2.0,0.9,21.0,25.0,9.0,0.0,40.0,Matches,325,sn SEN,FW,21,26,1598.0,61.0,46.7,17.8,16,78.0,5,10,35.0,3,1.62,35.0,18.0,17.0,0.96,0.86,31.8,21.1,10.7,0.6,0.55,Matches,266.0,sn SEN,FW,21.0,17.8,524.0,9.0,35.0,210.0,290.0,93.0,524.0,37.0,23.0,62.2,11.0,29.7,347.0,2501.0,1231.0,49.0,26.0,19.0,55.0,39.0,376.0,117.0,Matches,266.0,sn SEN,FW,21.0,17.8,12.0,41.0,23.0,56.1,2.31,1.3,0.29,0.52,13.4,0.0,0.0,0.0,7.8,7.8,0.19,4.2,4.2,Matches,266.0,sn SEN,FW,21.0,26.0,16.0,1598.0,17.8,12.0,4.0,16.0,12.0,0.0,0.0,6.0,1.0,7.8,7.8,3.1,11.0,49.0,40.0,117.0,0.68,0.23,0.9,0.68,0.9,0.44,0.18,0.62,0.44,0.62,Matches,Nicolas Jackson,AM/S RLC,21,133,158,"Senegal,The Gambia",Villarreal,8,9,15,14,12,8,13,10,6,8,11,13,9,15,7,10,12,13,11,12,10,12,12,7,9,11,9,12,16,13,8,12,8,16,14,12,9,7,6,13,16,3,1,1,4,3,1,3,3,3,4,1,13,9,5,13,11,9,12,16,1,1,1,1,1,1,1,12,12,12,16,16,18,20,186,78,7,20,18300000,6650,6650,4850,African_Caribbean,121,17,2001/6/20,0,0,15220.0,,12087972
675,Frenkie de Jong,Barcelona,1997,270.0,nl NED,MF,25.0,28.2,46.0,26.0,16.0,21.0,9.0,17.0,41.0,41.5,24.0,11.0,1.0,10.0,35.0,81.0,22.0,1.0,Matches,270.0,nl NED,MF,25.0,28.2,110.0,3.91,94.0,5.0,6.0,2.0,1.0,2.0,11.0,0.39,10.0,1.0,0.0,0.0,0.0,0.0,Matches,,,,,,,,,,,,,,,,,,,,,,,,,,,,,,,,,,,,,,,,,,,,,,,,,,,,,,,,270.0,nl NED,MF,25.0,28.2,3.0,0.0,0.0,33.0,34.0,1.0,37.0,35.0,26.0,0.0,0.0,0.0,182.0,32.0,15.0,68.1,Matches,270.0,nl NED,MF,25.0,28.2,2320.0,2246.0,63.0,39.0,19.0,17.0,37.0,15.0,8.0,2.0,2.0,0.0,2089.0,11.0,24.0,Matches,270.0,nl NED,MF,25.0,28.2,2089.0,2320.0,90.0,33411.0,10589.0,1121.0,1186.0,94.5,782.0,849.0,92.1,144.0,186.0,77.4,4.0,4.3,6.3,-0.3,45.0,250.0,59.0,7.0,279.0,Matches,333,nl NED,MF,25,33,2534.0,77.0,74.1,28.2,29,83.0,20,4,29.0,1,2.33,56.0,20.0,36.0,1.28,-0.14,58.4,24.3,34.2,1.21,0.39,Matches,270.0,nl NED,MF,25.0,28.2,2526.0,45.0,391.0,1553.0,607.0,47.0,2526.0,60.0,35.0,58.3,20.0,33.3,1797.0,11018.0,6412.0,92.0,95.0,9.0,24.0,22.0,2036.0,83.0,Matches,270.0,nl NED,MF,25.0,28.2,2.0,18.0,10.0,55.6,0.64,0.36,0.11,0.2,17.8,0.0,0.0,0.0,2.4,2.4,0.13,-0.4,-0.4,Matches,270.0,nl NED,MF,25.0,33.0,29.0,2534.0,28.2,2.0,4.0,6.0,2.0,0.0,0.0,3.0,0.0,2.4,2.4,4.3,6.7,92.0,279.0,83.0,0.07,0.14,0.21,0.07,0.21,0.09,0.15,0.24,0.09,0.24,Matches,Frenkie de Jong,DM/M C,25,163,183,Holland,Barcelona,9,11,16,10,17,13,10,8,6,10,16,11,12,16,7,17,11,16,15,18,16,15,15,11,15,14,17,14,14,16,13,10,13,13,13,10,15,2,13,5,17,2,2,1,1,2,2,1,3,3,2,4,14,15,12,14,13,16,16,17,1,1,15,1,1,1,20,10,20,10,10,13,10,1,181,69,12,20,134021250,8100,8000,7450,Northern_European,155,4,1997/5/12,43,1,269230.0,,37047745
676,Joan Jordán,Sevilla,1994,271.0,es ESP,MF,28.0,17.7,32.0,17.0,13.0,17.0,2.0,16.0,38.0,42.1,22.0,14.0,7.0,7.0,16.0,48.0,14.0,2.0,Matches,271.0,es ESP,MF,28.0,17.7,30.0,1.7,23.0,3.0,0.0,0.0,2.0,2.0,2.0,0.11,1.0,1.0,0.0,0.0,0.0,0.0,Matches,,,,,,,,,,,,,,,,,,,,,,,,,,,,,,,,,,,,,,,,,,,,,,,,,,,,,,,,271.0,es ESP,MF,28.0,17.7,8.0,0.0,0.0,34.0,12.0,0.0,8.0,16.0,17.0,0.0,0.0,0.0,113.0,11.0,12.0,47.8,Matches,271.0,es ESP,MF,28.0,17.7,1102.0,1051.0,44.0,34.0,2.0,21.0,8.0,3.0,7.0,3.0,2.0,0.0,963.0,7.0,11.0,Matches,271.0,es ESP,MF,28.0,17.7,963.0,1102.0,87.4,17030.0,4971.0,473.0,511.0,92.6,357.0,397.0,89.9,113.0,148.0,76.4,1.0,0.6,0.8,0.4,8.0,134.0,6.0,0.0,123.0,Matches,334,es ESP,MF,28,23,1592.0,69.0,46.5,17.7,19,78.0,11,4,28.0,4,1.26,18.0,28.0,-10.0,-0.57,-0.71,21.4,28.3,-6.9,-0.39,-0.34,Matches,271.0,es ESP,MF,28.0,17.7,1221.0,30.0,248.0,734.0,243.0,8.0,1221.0,10.0,5.0,50.0,4.0,40.0,690.0,2675.0,1112.0,9.0,19.0,0.0,16.0,5.0,903.0,22.0,Matches,271.0,es ESP,MF,28.0,17.7,0.0,13.0,3.0,23.1,0.73,0.17,0.0,0.0,21.4,3.0,0.0,0.0,0.9,0.9,0.07,-0.9,-0.9,Matches,271.0,es ESP,MF,28.0,23.0,19.0,1592.0,17.7,0.0,1.0,1.0,0.0,0.0,0.0,8.0,0.0,0.9,0.9,0.6,1.5,9.0,123.0,22.0,0.0,0.06,0.06,0.0,0.06,0.05,0.03,0.08,0.05,0.08,Matches,Joan Jordán,DM/M C,28,146,149,Spain,Sevilla,15,11,12,10,16,15,9,12,3,10,15,12,12,14,10,13,11,16,15,15,16,14,13,11,14,12,14,13,13,13,12,11,14,12,14,13,16,9,13,7,11,1,2,3,4,2,3,2,3,3,1,2,14,13,8,12,14,15,13,9,1,1,1,1,1,1,16,1,20,1,1,14,1,1,184,74,12,20,18718439,7200,7200,5750,Mediterranean_Hispanic,145,6,1994/7/6,0,0,32145.0,,67187249
677,Joselu,Espanyol,1990,274.0,es ESP,FW,32.0,33.2,13.0,11.0,3.0,4.0,6.0,4.0,17.0,23.5,13.0,25.0,4.0,21.0,8.0,21.0,43.0,0.0,Matches,274.0,es ESP,FW,32.0,33.2,66.0,1.99,41.0,0.0,4.0,7.0,14.0,0.0,8.0,0.24,4.0,0.0,0.0,2.0,2.0,0.0,Matches,,,,,,,,,,,,,,,,,,,,,,,,,,,,,,,,,,,,,,,,,,,,,,,,,,,,,,,,274.0,es ESP,FW,32.0,33.2,2.0,0.0,0.0,23.0,70.0,26.0,17.0,8.0,11.0,2.0,0.0,0.0,69.0,174.0,107.0,61.9,Matches,274.0,es ESP,FW,32.0,33.2,759.0,721.0,36.0,0.0,2.0,5.0,17.0,1.0,1.0,0.0,0.0,0.0,458.0,2.0,21.0,Matches,274.0,es ESP,FW,32.0,33.2,458.0,759.0,60.3,6536.0,1417.0,277.0,406.0,68.2,126.0,221.0,57.0,27.0,53.0,50.9,2.0,2.4,2.0,-0.4,22.0,41.0,12.0,1.0,66.0,Matches,337,es ESP,FW,32,34,2990.0,88.0,87.4,33.2,33,90.0,33,1,20.0,1,0.94,43.0,61.0,-18.0,-0.54,-0.75,42.5,53.2,-10.7,-0.32,-0.17,Matches,274.0,es ESP,FW,32.0,33.2,1111.0,44.0,90.0,501.0,523.0,152.0,1106.0,42.0,18.0,42.9,22.0,52.4,520.0,1850.0,616.0,23.0,21.0,16.0,84.0,43.0,833.0,147.0,Matches,274.0,es ESP,FW,32.0,33.2,16.0,87.0,33.0,37.9,2.62,0.99,0.13,0.33,16.1,2.0,5.0,5.0,14.5,10.5,0.12,1.5,0.5,Matches,274.0,es ESP,FW,32.0,34.0,33.0,2990.0,33.2,16.0,2.0,18.0,11.0,5.0,5.0,2.0,0.0,14.5,10.5,2.4,13.0,23.0,66.0,147.0,0.48,0.06,0.54,0.33,0.39,0.44,0.07,0.51,0.32,0.39,Matches,Joselu,S,32,135,139,Spain,Espanyol,5,9,11,15,14,10,15,12,6,7,12,13,10,12,8,14,13,13,13,12,13,8,13,6,13,7,13,13,11,12,12,15,11,12,13,15,11,12,13,6,5,1,3,3,3,1,2,2,2,1,1,1,8,17,14,6,12,10,10,12,1,1,1,1,1,1,1,1,1,1,1,1,1,20,192,88,15,20,347975206,6750,6750,5300,Mediterranean_Hispanic,134,7,1990/3/27,0,0,15440.0,,67055991
678,Juanmi,Betis,1993,275.0,es ESP,FW,29.0,10.3,14.0,10.0,4.0,7.0,3.0,7.0,31.0,22.6,24.0,10.0,0.0,10.0,4.0,18.0,4.0,0.0,Matches,275.0,es ESP,FW,29.0,10.3,20.0,1.94,13.0,0.0,3.0,1.0,3.0,0.0,2.0,0.19,1.0,0.0,1.0,0.0,0.0,0.0,Matches,,,,,,,,,,,,,,,,,,,,,,,,,,,,,,,,,,,,,,,,,,,,,,,,,,,,,,,,275.0,es ESP,FW,29.0,10.3,3.0,0.0,0.0,15.0,22.0,15.0,0.0,4.0,10.0,0.0,0.0,0.0,45.0,9.0,16.0,36.0,Matches,275.0,es ESP,FW,29.0,10.3,245.0,240.0,5.0,0.0,3.0,3.0,0.0,5.0,0.0,0.0,0.0,0.0,207.0,0.0,6.0,Matches,275.0,es ESP,FW,29.0,10.3,207.0,245.0,84.5,2759.0,466.0,133.0,145.0,91.7,54.0,62.0,87.1,7.0,12.0,58.3,0.0,0.9,0.9,-0.9,4.0,7.0,3.0,0.0,15.0,Matches,338,es ESP,FW,29,22,925.0,42.0,27.0,10.3,9,75.0,3,13,19.0,3,1.68,18.0,18.0,0.0,0.0,-0.18,18.1,16.8,1.3,0.13,0.13,Matches,275.0,es ESP,FW,29.0,10.3,363.0,7.0,56.0,184.0,128.0,38.0,363.0,32.0,12.0,37.5,15.0,46.9,209.0,1144.0,454.0,10.0,16.0,4.0,23.0,13.0,251.0,37.0,Matches,275.0,es ESP,FW,29.0,10.3,4.0,18.0,8.0,44.4,1.75,0.78,0.22,0.5,12.8,0.0,0.0,0.0,3.7,3.7,0.2,0.3,0.3,Matches,275.0,es ESP,FW,29.0,22.0,9.0,925.0,10.3,4.0,0.0,4.0,4.0,0.0,0.0,3.0,0.0,3.7,3.7,0.9,4.5,10.0,15.0,37.0,0.39,0.0,0.39,0.39,0.39,0.36,0.08,0.44,0.36,0.44,Matches,Juanmi,AM/S L,29,142,150,Spain,Real Hispalis,7,11,14,14,15,13,10,11,6,6,13,10,8,15,10,15,9,13,12,13,12,15,14,9,16,9,13,14,16,15,12,7,12,15,12,7,12,7,14,10,7,1,3,3,1,3,1,3,3,3,2,2,7,15,5,16,12,12,14,12,1,1,1,1,1,1,1,12,1,6,20,13,11,20,172,63,11,20,12207392,6950,6950,5500,Mediterranean_Hispanic,137,5,1993/5/20,1,0,20555.0,,67106568
679,Juanpe,Girona,1991,276.0,es ESP,DF,31.0,15.8,19.0,11.0,10.0,9.0,0.0,11.0,17.0,64.7,6.0,12.0,9.0,3.0,10.0,29.0,60.0,1.0,Matches,276.0,es ESP,DF,31.0,15.8,15.0,0.95,14.0,0.0,1.0,0.0,0.0,0.0,0.0,0.0,0.0,0.0,0.0,0.0,0.0,0.0,Matches,,,,,,,,,,,,,,,,,,,,,,,,,,,,,,,,,,,,,,,,,,,,,,,,,,,,,,,,276.0,es ESP,DF,31.0,15.8,3.0,0.0,0.0,11.0,2.0,0.0,3.0,10.0,11.0,0.0,1.0,0.0,59.0,18.0,9.0,66.7,Matches,276.0,es ESP,DF,31.0,15.8,881.0,822.0,55.0,41.0,0.0,9.0,3.0,2.0,0.0,0.0,0.0,0.0,753.0,4.0,7.0,Matches,276.0,es ESP,DF,31.0,15.8,753.0,881.0,85.5,14726.0,5562.0,234.0,250.0,93.6,428.0,466.0,91.8,85.0,139.0,61.2,0.0,0.3,0.4,-0.3,3.0,32.0,1.0,0.0,38.0,Matches,339,es ESP,DF,31,19,1426.0,75.0,41.7,15.8,17,83.0,13,2,6.0,11,1.21,29.0,25.0,4.0,0.25,0.3,18.5,23.9,-5.4,-0.34,-0.39,Matches,276.0,es ESP,DF,31.0,15.8,992.0,169.0,573.0,395.0,31.0,16.0,992.0,1.0,1.0,100.0,0.0,0.0,595.0,3035.0,1700.0,8.0,2.0,0.0,0.0,2.0,693.0,3.0,Matches,276.0,es ESP,DF,31.0,15.8,1.0,5.0,1.0,20.0,0.32,0.06,0.2,1.0,9.8,0.0,0.0,0.0,0.5,0.5,0.09,0.5,0.5,Matches,276.0,es ESP,DF,31.0,19.0,17.0,1426.0,15.8,1.0,0.0,1.0,1.0,0.0,0.0,3.0,0.0,0.5,0.5,0.3,0.8,8.0,38.0,3.0,0.06,0.0,0.06,0.06,0.06,0.03,0.02,0.05,0.03,0.05,Matches,Juanpe,D C,31,130,135,Spain,Girona,6,6,8,4,12,6,15,7,8,15,13,5,15,12,11,14,13,13,14,11,14,12,9,11,8,14,14,14,11,8,7,15,14,13,13,14,13,7,11,8,10,4,3,3,4,3,1,2,1,3,2,3,12,10,9,12,8,14,15,15,1,1,20,4,1,1,15,1,1,1,1,1,1,1,190,80,10,20,1784183,6400,6400,3510,Mediterranean_Hispanic,130,6,1991/4/30,0,0,4245.0,,67072242
680,Franck Kessié,Barcelona,1996,285.0,ci CIV,MF,25.0,11.0,15.0,9.0,6.0,6.0,3.0,8.0,18.0,44.4,10.0,10.0,2.0,8.0,12.0,27.0,11.0,2.0,Matches,285.0,ci CIV,MF,25.0,11.0,21.0,1.91,15.0,0.0,2.0,4.0,0.0,0.0,2.0,0.18,1.0,0.0,0.0,1.0,0.0,0.0,Matches,,,,,,,,,,,,,,,,,,,,,,,,,,,,,,,,,,,,,,,,,,,,,,,,,,,,,,,,285.0,ci CIV,MF,25.0,11.0,4.0,0.0,0.0,17.0,16.0,3.0,5.0,12.0,9.0,0.0,0.0,0.0,61.0,7.0,8.0,46.7,Matches,285.0,ci CIV,MF,25.0,11.0,457.0,441.0,13.0,6.0,2.0,5.0,5.0,3.0,1.0,0.0,0.0,0.0,391.0,3.0,5.0,Matches,285.0,ci CIV,MF,25.0,11.0,391.0,457.0,85.6,5955.0,1170.0,207.0,231.0,89.6,152.0,174.0,87.4,20.0,29.0,69.0,1.0,0.7,0.9,0.3,8.0,23.0,6.0,1.0,39.0,Matches,348,ci CIV,MF,25,28,990.0,35.0,28.9,11.0,7,66.0,1,21,25.0,7,2.14,16.0,7.0,9.0,0.82,-0.7,18.3,12.1,6.2,0.57,-0.77,Matches,285.0,ci CIV,MF,25.0,11.0,575.0,25.0,110.0,336.0,133.0,25.0,575.0,18.0,9.0,50.0,6.0,33.3,349.0,1732.0,674.0,14.0,11.0,2.0,23.0,10.0,426.0,43.0,Matches,285.0,ci CIV,MF,25.0,11.0,1.0,15.0,3.0,20.0,1.36,0.27,0.07,0.33,15.9,0.0,0.0,0.0,1.8,1.8,0.12,-0.8,-0.8,Matches,285.0,ci CIV,MF,25.0,28.0,7.0,990.0,11.0,1.0,1.0,2.0,1.0,0.0,0.0,4.0,0.0,1.8,1.8,0.7,2.5,14.0,39.0,43.0,0.09,0.09,0.18,0.09,0.18,0.16,0.07,0.23,0.16,0.23,Matches,Franck Kessié,DM/M C,25,156,164,"Ivory Coast,Italy",Barcelona,5,7,12,12,13,6,9,11,8,15,14,18,15,12,16,14,16,14,14,12,14,17,8,14,13,15,19,17,13,13,17,10,17,15,18,19,16,13,15,7,11,1,2,3,1,2,3,2,2,1,3,4,18,17,6,12,14,13,11,8,1,1,8,1,1,1,18,1,20,1,1,12,1,1,183,89,9,20,105806260,7800,7250,6700,African_Caribbean,152,18,1996/12/19,56,6,230768.0,,13136664
681,Justin Kluivert,Valencia,1999,287.0,nl NED,FWMF,23.0,16.1,17.0,14.0,7.0,4.0,6.0,6.0,12.0,50.0,6.0,4.0,0.0,4.0,7.0,24.0,4.0,0.0,Matches,287.0,nl NED,FWMF,23.0,16.1,61.0,3.79,39.0,8.0,5.0,5.0,2.0,2.0,4.0,0.25,1.0,0.0,0.0,2.0,1.0,0.0,Matches,,,,,,,,,,,,,,,,,,,,,,,,,,,,,,,,,,,,,,,,,,,,,,,,,,,,,,,,287.0,nl NED,FWMF,23.0,16.1,4.0,0.0,0.0,24.0,19.0,10.0,64.0,7.0,14.0,1.0,0.0,0.0,69.0,8.0,22.0,26.7,Matches,287.0,nl NED,FWMF,23.0,16.1,399.0,345.0,49.0,8.0,0.0,2.0,64.0,6.0,31.0,5.0,10.0,0.0,276.0,5.0,12.0,Matches,287.0,nl NED,FWMF,23.0,16.1,276.0,399.0,69.2,4236.0,977.0,163.0,203.0,80.3,80.0,112.0,71.4,23.0,50.0,46.0,0.0,2.4,2.1,-2.4,23.0,15.0,21.0,10.0,33.0,Matches,351,nl NED,FWMF,23,26,1447.0,56.0,42.3,16.1,15,78.0,3,11,25.0,1,1.0,22.0,21.0,1.0,0.06,0.24,26.6,19.0,7.6,0.47,0.55,Matches,287.0,nl NED,FWMF,23.0,16.1,583.0,7.0,48.0,153.0,401.0,65.0,582.0,63.0,30.0,47.6,30.0,47.6,358.0,3045.0,1553.0,58.0,33.0,22.0,39.0,22.0,392.0,126.0,Matches,287.0,nl NED,FWMF,23.0,16.1,6.0,43.0,15.0,34.9,2.67,0.93,0.12,0.33,18.1,2.0,1.0,1.0,6.6,5.9,0.14,-0.6,-0.9,Matches,287.0,nl NED,FWMF,23.0,26.0,15.0,1447.0,16.1,6.0,0.0,6.0,5.0,1.0,1.0,4.0,0.0,6.6,5.9,2.4,8.2,58.0,33.0,126.0,0.37,0.0,0.37,0.31,0.31,0.41,0.15,0.56,0.36,0.51,Matches,Justin Kluivert,M/AM RL,23,139,155,"Holland,Suriname",Associazione Sportiva Roma,9,10,16,11,16,8,7,12,2,3,14,10,6,16,16,9,13,11,10,11,10,15,15,7,12,6,11,12,17,17,11,7,12,16,11,8,12,14,14,11,14,1,1,2,3,3,2,3,1,3,2,3,13,16,13,9,13,14,12,12,1,1,1,1,1,1,1,16,1,15,20,14,18,13,172,66,14,20,9869723,6950,6750,5750,African_Caribbean,132,12,1999/5/5,2,0,64038.0,Valencia,37055841
682,Koke,Atlético Madrid,1992,288.0,es ESP,MF,30.0,28.3,55.0,38.0,23.0,25.0,7.0,28.0,72.0,38.9,44.0,35.0,13.0,22.0,20.0,75.0,19.0,0.0,Matches,288.0,es ESP,MF,30.0,28.3,70.0,2.48,67.0,0.0,0.0,2.0,1.0,0.0,6.0,0.21,6.0,0.0,0.0,0.0,0.0,0.0,Matches,,,,,,,,,,,,,,,,,,,,,,,,,,,,,,,,,,,,,,,,,,,,,,,,,,,,,,,,288.0,es ESP,MF,30.0,28.3,4.0,0.0,0.0,20.0,27.0,1.0,24.0,20.0,38.0,0.0,0.0,0.0,170.0,11.0,14.0,44.0,Matches,288.0,es ESP,MF,30.0,28.3,2038.0,1964.0,59.0,52.0,8.0,17.0,24.0,4.0,0.0,0.0,0.0,0.0,1784.0,15.0,30.0,Matches,288.0,es ESP,MF,30.0,28.3,1784.0,2038.0,87.5,27145.0,8772.0,990.0,1055.0,93.8,578.0,649.0,89.1,127.0,187.0,67.9,3.0,1.7,1.7,1.3,28.0,179.0,19.0,3.0,175.0,Matches,353,es ESP,MF,30,33,2545.0,77.0,74.4,28.3,30,82.0,12,3,26.0,1,2.18,53.0,24.0,29.0,1.03,0.2,46.3,28.3,18.1,0.64,0.36,Matches,288.0,es ESP,MF,30.0,28.3,2244.0,70.0,542.0,1337.0,376.0,21.0,2244.0,22.0,13.0,59.1,8.0,36.4,1246.0,4448.0,2069.0,15.0,25.0,0.0,21.0,18.0,1736.0,37.0,Matches,288.0,es ESP,MF,30.0,28.3,0.0,16.0,1.0,6.3,0.57,0.04,0.0,0.0,22.9,0.0,0.0,0.0,0.7,0.7,0.05,-0.7,-0.7,Matches,288.0,es ESP,MF,30.0,33.0,30.0,2545.0,28.3,0.0,3.0,3.0,0.0,0.0,0.0,4.0,0.0,0.7,0.7,1.7,2.4,15.0,175.0,37.0,0.0,0.11,0.11,0.0,0.11,0.03,0.06,0.09,0.03,0.09,Matches,Koke,DM/M RLC,30,157,162,Spain,A. Madrid,15,15,13,12,14,14,9,14,6,12,16,10,14,14,14,15,15,15,16,15,15,16,10,14,15,15,17,16,13,12,15,9,14,13,15,12,16,10,13,6,18,3,3,2,3,2,1,1,2,1,1,3,10,15,6,17,12,16,11,12,1,1,1,1,1,1,20,15,20,15,10,14,8,1,178,73,14,20,134021250,7850,7850,7300,Mediterranean_Hispanic,158,6,1992/1/8,66,0,306644.0,,67047092
683,Geoffrey Kondogbia,Atlético Madrid,1993,290.0,cf CTA,MF,29.0,11.2,40.0,23.0,19.0,20.0,1.0,17.0,25.0,68.0,8.0,9.0,1.0,8.0,26.0,66.0,12.0,1.0,Matches,290.0,cf CTA,MF,29.0,11.2,12.0,1.07,10.0,0.0,0.0,1.0,1.0,0.0,2.0,0.18,2.0,0.0,0.0,0.0,0.0,0.0,Matches,,,,,,,,,,,,,,,,,,,,,,,,,,,,,,,,,,,,,,,,,,,,,,,,,,,,,,,,290.0,cf CTA,MF,29.0,11.2,5.0,0.0,0.0,17.0,19.0,2.0,0.0,26.0,23.0,0.0,0.0,0.0,101.0,12.0,10.0,54.5,Matches,290.0,cf CTA,MF,29.0,11.2,634.0,620.0,14.0,13.0,0.0,11.0,0.0,1.0,0.0,0.0,0.0,0.0,567.0,0.0,2.0,Matches,290.0,cf CTA,MF,29.0,11.2,567.0,634.0,89.4,8841.0,2652.0,313.0,337.0,92.9,186.0,203.0,91.6,44.0,59.0,74.6,2.0,0.9,0.3,1.1,5.0,45.0,3.0,0.0,42.0,Matches,355,cf CTA,MF,29,20,1006.0,50.0,29.4,11.2,10,82.0,6,10,19.0,13,2.1,15.0,11.0,4.0,0.36,-0.87,14.4,12.6,1.7,0.16,-0.55,Matches,290.0,cf CTA,MF,29.0,11.2,751.0,29.0,196.0,498.0,66.0,8.0,751.0,10.0,5.0,50.0,2.0,20.0,413.0,1449.0,637.0,6.0,7.0,1.0,6.0,10.0,511.0,5.0,Matches,290.0,cf CTA,MF,29.0,11.2,0.0,11.0,0.0,0.0,0.98,0.0,0.0,,19.7,0.0,0.0,0.0,0.7,0.7,0.07,-0.7,-0.7,Matches,290.0,cf CTA,MF,29.0,20.0,10.0,1006.0,11.2,0.0,2.0,2.0,0.0,0.0,0.0,5.0,0.0,0.7,0.7,0.9,1.6,6.0,42.0,5.0,0.0,0.18,0.18,0.0,0.18,0.07,0.08,0.14,0.07,0.14,Matches,Geoffrey Kondogbia,DM/M C,29,149,155,"Central African Republic,France",A. Madrid,8,11,15,12,15,8,14,16,7,12,15,9,15,16,16,14,16,12,11,13,13,13,14,14,13,15,14,15,14,14,16,14,15,14,16,16,13,13,12,9,12,2,4,1,1,2,1,2,1,1,3,3,11,15,9,13,13,15,14,14,1,1,1,1,1,1,20,1,19,1,1,5,1,1,188,80,20,7,22274691,7400,7250,6600,African_Caribbean,152,15,1993/2/15,13,1,124642.0,,85033422
684,Jules Koundé,Barcelona,1998,291.0,fr FRA,DF,23.0,27.0,37.0,23.0,18.0,13.0,6.0,21.0,31.0,67.7,10.0,24.0,9.0,15.0,19.0,56.0,61.0,3.0,Matches,291.0,fr FRA,DF,23.0,27.0,41.0,1.52,39.0,1.0,0.0,1.0,0.0,0.0,7.0,0.26,7.0,0.0,0.0,0.0,0.0,0.0,Matches,,,,,,,,,,,,,,,,,,,,,,,,,,,,,,,,,,,,,,,,,,,,,,,,,,,,,,,,291.0,fr FRA,DF,23.0,27.0,2.0,0.0,0.0,22.0,12.0,2.0,36.0,19.0,23.0,0.0,0.0,1.0,157.0,43.0,22.0,66.2,Matches,291.0,fr FRA,DF,23.0,27.0,2024.0,1840.0,180.0,50.0,4.0,11.0,36.0,130.0,0.0,0.0,0.0,0.0,1775.0,4.0,25.0,Matches,291.0,fr FRA,DF,23.0,27.0,1775.0,2024.0,87.7,29836.0,9690.0,827.0,895.0,92.4,792.0,866.0,91.5,123.0,182.0,67.6,3.0,2.8,2.3,0.2,16.0,176.0,15.0,6.0,185.0,Matches,357,fr FRA,DF,23,29,2426.0,84.0,70.9,27.0,28,86.0,24,1,9.0,2,2.38,51.0,12.0,39.0,1.45,0.45,53.0,21.6,31.4,1.16,0.17,Matches,291.0,fr FRA,DF,23.0,27.0,2234.0,117.0,675.0,1215.0,362.0,45.0,2234.0,28.0,15.0,53.6,9.0,32.1,1477.0,7400.0,4587.0,58.0,52.0,5.0,23.0,18.0,1611.0,61.0,Matches,291.0,fr FRA,DF,23.0,27.0,1.0,14.0,1.0,7.1,0.52,0.04,0.07,1.0,14.3,0.0,0.0,0.0,1.1,1.1,0.08,-0.1,-0.1,Matches,291.0,fr FRA,DF,23.0,29.0,28.0,2426.0,27.0,1.0,3.0,4.0,1.0,0.0,0.0,2.0,0.0,1.1,1.1,2.8,3.9,58.0,185.0,61.0,0.04,0.11,0.15,0.04,0.15,0.04,0.1,0.15,0.04,0.15,Matches,Jules Koundé,D RC,23,162,175,"France,Benin",Barcelona,6,13,12,9,13,5,16,7,8,16,14,8,16,13,14,17,16,14,16,14,14,16,12,14,12,15,16,16,15,16,16,13,15,14,15,14,15,7,14,9,15,3,1,1,1,2,1,1,1,3,2,1,15,15,6,13,13,16,13,12,1,1,20,15,1,15,1,1,1,1,1,1,1,1,178,70,10,20,122512503,8000,7750,7250,African_Caribbean,165,12,1998/11/12,11,0,182692.0,,48036304
685,Toni Kroos,Real Madrid,1990,292.0,de GER,MF,32.0,23.9,51.0,32.0,16.0,33.0,2.0,23.0,69.0,33.3,46.0,23.0,4.0,19.0,24.0,75.0,11.0,0.0,Matches,292.0,de GER,MF,32.0,23.9,103.0,4.3,64.0,33.0,0.0,3.0,2.0,1.0,6.0,0.25,5.0,1.0,0.0,0.0,0.0,0.0,Matches,,,,,,,,,,,,,,,,,,,,,,,,,,,,,,,,,,,,,,,,,,,,,,,,,,,,,,,,292.0,de GER,MF,32.0,23.9,2.0,1.0,1.0,28.0,36.0,0.0,122.0,24.0,32.0,0.0,1.0,0.0,154.0,7.0,4.0,63.6,Matches,292.0,de GER,MF,32.0,23.9,2482.0,2246.0,223.0,123.0,4.0,41.0,122.0,15.0,84.0,27.0,30.0,1.0,2255.0,13.0,12.0,Matches,292.0,de GER,MF,32.0,23.9,2255.0,2482.0,90.9,42174.0,15247.0,991.0,1022.0,97.0,907.0,964.0,94.1,314.0,419.0,74.9,4.0,4.4,5.5,-0.4,55.0,372.0,26.0,7.0,319.0,Matches,358,de GER,MF,32,30,2155.0,72.0,63.0,23.9,25,82.0,12,5,22.0,3,2.0,48.0,23.0,25.0,1.04,0.05,43.8,26.7,17.1,0.71,-0.67,Matches,292.0,de GER,MF,32.0,23.9,2633.0,58.0,531.0,1618.0,506.0,18.0,2633.0,26.0,9.0,34.6,10.0,38.5,1796.0,8015.0,4384.0,51.0,41.0,3.0,10.0,12.0,2106.0,38.0,Matches,292.0,de GER,MF,32.0,23.9,2.0,31.0,11.0,35.5,1.29,0.46,0.06,0.18,25.4,5.0,0.0,0.0,1.4,1.4,0.05,0.6,0.6,Matches,292.0,de GER,MF,32.0,30.0,25.0,2155.0,23.9,2.0,4.0,6.0,2.0,0.0,0.0,2.0,1.0,1.4,1.4,4.4,5.9,51.0,319.0,38.0,0.08,0.17,0.25,0.08,0.25,0.06,0.19,0.24,0.06,0.24,Matches,Toni Kroos,DM/M C,32,166,176,Germany,R. Madrid,19,18,14,13,18,14,7,17,8,8,20,13,9,16,9,17,9,18,14,18,17,10,11,12,15,14,16,11,11,10,12,10,12,12,12,14,13,10,14,7,13,1,3,2,3,1,1,3,1,1,1,3,8,14,7,10,14,17,18,17,1,1,1,1,1,1,17,10,20,1,1,11,1,1,183,76,15,20,37521116,8300,8500,7700,Northern_European,164,5,1990/1/4,105,17,359588.0,,156772
686,Takefusa Kubo,Real Sociedad,2001,293.0,jp JPN,FWMF,21.0,27.1,44.0,26.0,18.0,16.0,10.0,16.0,38.0,42.1,22.0,29.0,1.0,28.0,9.0,53.0,4.0,0.0,Matches,293.0,jp JPN,FWMF,21.0,27.1,96.0,3.55,63.0,10.0,7.0,5.0,10.0,1.0,11.0,0.41,6.0,0.0,2.0,0.0,2.0,1.0,Matches,,,,,,,,,,,,,,,,,,,,,,,,,,,,,,,,,,,,,,,,,,,,,,,,,,,,,,,,293.0,jp JPN,FWMF,21.0,27.1,3.0,0.0,0.0,35.0,48.0,21.0,72.0,9.0,26.0,2.0,0.0,0.0,107.0,16.0,25.0,39.0,Matches,293.0,jp JPN,FWMF,21.0,27.1,875.0,823.0,42.0,5.0,3.0,5.0,72.0,5.0,29.0,10.0,12.0,1.0,621.0,10.0,35.0,Matches,293.0,jp JPN,FWMF,21.0,27.1,621.0,875.0,71.0,8389.0,2340.0,382.0,454.0,84.1,174.0,249.0,69.9,29.0,65.0,44.6,4.0,6.0,5.4,-2.0,39.0,33.0,34.0,4.0,81.0,Matches,359,jp JPN,FWMF,21,35,2439.0,70.0,71.3,27.1,29,77.0,7,6,34.0,2,1.91,38.0,21.0,17.0,0.63,0.72,37.4,20.6,16.9,0.62,0.35,Matches,293.0,jp JPN,FWMF,21.0,27.1,1240.0,6.0,94.0,431.0,736.0,141.0,1240.0,117.0,49.0,41.9,50.0,42.7,841.0,5895.0,3281.0,117.0,60.0,66.0,90.0,42.0,929.0,239.0,Matches,293.0,jp JPN,FWMF,21.0,27.1,9.0,72.0,30.0,41.7,2.66,1.11,0.13,0.3,17.8,3.0,0.0,0.0,5.9,5.9,0.08,3.1,3.1,Matches,293.0,jp JPN,FWMF,21.0,35.0,29.0,2439.0,27.1,9.0,4.0,13.0,9.0,0.0,0.0,3.0,0.0,5.9,5.9,6.0,11.9,117.0,81.0,239.0,0.33,0.15,0.48,0.33,0.48,0.22,0.22,0.44,0.22,0.44,Matches,Takefusa Kubo,M/AM RC,21,143,159,Japan,Real San Sebastián,14,12,15,14,15,12,7,11,8,6,15,8,6,15,8,15,12,14,14,15,15,7,15,7,14,7,15,14,14,14,15,7,10,12,13,12,14,6,11,10,11,3,1,1,1,2,1,1,2,3,2,2,13,13,2,10,9,13,11,13,1,1,1,1,1,1,1,1,12,16,1,20,15,15,167,60,20,11,45540002,7150,7150,6000,10,141,7,2001/6/4,18,1,41953.0,,45104608
687,Cyle Larin,Valladolid,1995,297.0,ca CAN,FW,27.0,16.3,9.0,3.0,2.0,4.0,3.0,3.0,7.0,42.9,4.0,6.0,3.0,3.0,0.0,9.0,15.0,0.0,Matches,297.0,ca CAN,FW,27.0,16.3,33.0,2.02,21.0,0.0,5.0,5.0,2.0,0.0,7.0,0.43,5.0,0.0,1.0,1.0,0.0,0.0,Matches,,,,,,,,,,,,,,,,,,,,,,,,,,,,,,,,,,,,,,,,,,,,,,,,,,,,,,,,297.0,ca CAN,FW,27.0,16.3,4.0,0.0,0.0,23.0,25.0,29.0,6.0,0.0,3.0,0.0,1.0,0.0,41.0,43.0,60.0,41.7,Matches,297.0,ca CAN,FW,27.0,16.3,247.0,241.0,6.0,0.0,1.0,2.0,6.0,0.0,0.0,0.0,0.0,0.0,170.0,0.0,16.0,Matches,297.0,ca CAN,FW,27.0,16.3,170.0,247.0,68.8,2289.0,370.0,106.0,134.0,79.1,42.0,58.0,72.4,9.0,14.0,64.3,3.0,2.6,1.1,0.4,16.0,5.0,7.0,1.0,17.0,Matches,363,ca CAN,FW,27,19,1469.0,77.0,43.0,16.3,16,87.0,13,3,26.0,1,1.21,20.0,26.0,-6.0,-0.37,0.74,19.4,27.4,-8.0,-0.49,0.37,Matches,297.0,ca CAN,FW,27.0,16.3,472.0,21.0,48.0,189.0,242.0,89.0,470.0,26.0,10.0,38.5,15.0,57.7,304.0,1538.0,607.0,25.0,15.0,11.0,65.0,36.0,370.0,72.0,Matches,297.0,ca CAN,FW,27.0,16.3,8.0,49.0,17.0,34.7,3.0,1.04,0.12,0.35,14.1,0.0,2.0,2.0,7.5,5.9,0.12,0.5,0.1,Matches,297.0,ca CAN,FW,27.0,19.0,16.0,1469.0,16.3,8.0,3.0,11.0,6.0,2.0,2.0,4.0,0.0,7.5,5.9,2.6,8.5,25.0,17.0,72.0,0.49,0.18,0.67,0.37,0.55,0.46,0.16,0.62,0.36,0.52,Matches,Cyle Larin,AM/S RL,27,120,130,"Canada,United States",Club Brugge KV,2,6,11,13,12,2,14,9,4,7,10,11,7,11,14,13,14,12,10,7,11,7,10,5,13,5,13,13,11,11,13,15,15,11,13,13,11,10,12,7,2,4,3,3,2,2,3,2,3,1,3,2,12,8,8,6,12,6,16,15,1,1,1,1,1,1,1,1,1,1,18,1,15,20,188,90,13,20,5939999,6600,6660,5695,African_Caribbean,110,15,1995/4/17,52,24,7499.0,,72044151
688,Toni Lato,Valencia,1997,299.0,es ESP,DFMF,24.0,10.2,23.0,11.0,9.0,12.0,2.0,9.0,21.0,42.9,12.0,10.0,1.0,9.0,6.0,29.0,14.0,0.0,Matches,299.0,es ESP,DFMF,24.0,10.2,28.0,2.76,20.0,5.0,1.0,0.0,1.0,1.0,3.0,0.3,1.0,0.0,1.0,0.0,1.0,0.0,Matches,,,,,,,,,,,,,,,,,,,,,,,,,,,,,,,,,,,,,,,,,,,,,,,,,,,,,,,,299.0,es ESP,DFMF,24.0,10.2,1.0,0.0,0.0,12.0,9.0,4.0,32.0,6.0,11.0,0.0,0.0,0.0,50.0,4.0,19.0,17.4,Matches,299.0,es ESP,DFMF,24.0,10.2,490.0,417.0,72.0,10.0,1.0,3.0,32.0,50.0,12.0,2.0,6.0,0.0,390.0,1.0,9.0,Matches,299.0,es ESP,DFMF,24.0,10.2,390.0,490.0,79.6,6140.0,2040.0,205.0,228.0,89.9,148.0,177.0,83.6,26.0,61.0,42.6,0.0,0.9,1.0,-0.9,15.0,32.0,10.0,2.0,40.0,Matches,365,es ESP,DFMF,24,24,914.0,38.0,26.7,10.2,9,70.0,0,15,19.0,9,1.29,12.0,11.0,1.0,0.1,0.24,11.2,12.2,-1.0,-0.1,-0.34,Matches,299.0,es ESP,DFMF,24.0,10.2,583.0,22.0,149.0,247.0,191.0,18.0,583.0,10.0,7.0,70.0,2.0,20.0,280.0,1402.0,794.0,18.0,15.0,2.0,8.0,2.0,346.0,47.0,Matches,299.0,es ESP,DFMF,24.0,10.2,1.0,9.0,1.0,11.1,0.89,0.1,0.11,1.0,17.3,1.0,0.0,0.0,0.8,0.8,0.09,0.2,0.2,Matches,299.0,es ESP,DFMF,24.0,24.0,9.0,914.0,10.2,1.0,0.0,1.0,1.0,0.0,0.0,1.0,0.0,0.8,0.8,0.9,1.8,18.0,40.0,47.0,0.1,0.0,0.1,0.1,0.1,0.08,0.09,0.18,0.08,0.18,Matches,Toni Lato,D/WB L,24,126,148,Spain,Valencia,7,12,13,10,12,7,8,6,10,12,13,10,13,12,12,12,12,10,12,12,12,12,12,8,12,12,13,15,15,14,12,7,14,14,14,9,12,8,7,7,10,2,1,3,3,1,3,3,3,3,2,2,10,10,5,16,10,12,14,10,1,20,1,1,18,1,1,1,1,1,1,1,1,1,173,69,20,8,2222776,6300,6300,4250,Mediterranean_Hispanic,118,2,1997/11/21,0,0,8119.0,,67203459
689,Robin Le Normand,Real Sociedad,1996,301.0,es ESP,DF,25.0,31.1,36.0,23.0,25.0,9.0,2.0,14.0,27.0,51.9,13.0,22.0,14.0,8.0,33.0,69.0,93.0,0.0,Matches,301.0,es ESP,DF,25.0,31.1,15.0,0.48,13.0,0.0,0.0,2.0,0.0,0.0,1.0,0.03,1.0,0.0,0.0,0.0,0.0,0.0,Matches,,,,,,,,,,,,,,,,,,,,,,,,,,,,,,,,,,,,,,,,,,,,,,,,,,,,,,,,301.0,es ESP,DF,25.0,31.1,6.0,0.0,0.0,44.0,29.0,2.0,1.0,33.0,23.0,0.0,0.0,1.0,147.0,108.0,37.0,74.5,Matches,301.0,es ESP,DF,25.0,31.1,1740.0,1653.0,85.0,61.0,2.0,7.0,1.0,3.0,0.0,0.0,0.0,0.0,1533.0,2.0,4.0,Matches,301.0,es ESP,DF,25.0,31.1,1533.0,1740.0,88.1,30128.0,8968.0,485.0,542.0,89.5,862.0,926.0,93.1,171.0,240.0,71.3,0.0,0.1,0.6,-0.1,3.0,93.0,2.0,0.0,122.0,Matches,367,es ESP,DF,25,33,2796.0,85.0,81.8,31.1,31,89.0,30,2,13.0,1,1.79,37.0,25.0,12.0,0.39,-0.19,42.8,27.5,15.3,0.49,-0.16,Matches,301.0,es ESP,DF,25.0,31.1,1976.0,242.0,946.0,988.0,53.0,21.0,1976.0,2.0,2.0,100.0,0.0,0.0,1200.0,6631.0,3761.0,26.0,11.0,0.0,8.0,9.0,1272.0,2.0,Matches,301.0,es ESP,DF,25.0,31.1,0.0,12.0,2.0,16.7,0.39,0.06,0.0,0.0,12.8,0.0,0.0,0.0,1.0,1.0,0.08,-1.0,-1.0,Matches,301.0,es ESP,DF,25.0,33.0,31.0,2796.0,31.1,0.0,0.0,0.0,0.0,0.0,0.0,6.0,0.0,1.0,1.0,0.1,1.0,26.0,122.0,2.0,0.0,0.0,0.0,0.0,0.0,0.03,0.0,0.03,0.03,0.03,Matches,Robin Le Normand,D C,25,149,152,"France,Pays Basque",Real San Sebastián,8,7,9,7,12,10,15,10,10,14,14,11,16,14,14,15,14,14,15,8,15,14,8,14,7,14,15,14,13,13,13,16,16,14,15,16,14,9,12,8,18,3,3,2,3,3,1,2,3,3,2,1,7,8,5,12,9,16,14,12,1,1,20,1,1,1,1,1,1,1,1,1,1,1,187,80,5,20,40428563,7450,7450,5750,Northern_European,150,4,1996/11/11,0,0,40376.0,,48037162
690,Benjamin Lecomte,Espanyol,1991,302.0,fr FRA,GK,31.0,10.0,0.0,0.0,0.0,0.0,0.0,0.0,0.0,,0.0,0.0,0.0,0.0,0.0,0.0,3.0,2.0,Matches,302.0,fr FRA,GK,31.0,10.0,2.0,0.2,1.0,1.0,0.0,0.0,0.0,0.0,0.0,0.0,0.0,0.0,0.0,0.0,0.0,0.0,Matches,22.0,fr FRA,GK,31.0,10.0,14.0,0.0,0.0,2.0,1.0,10.4,0.26,-2.6,-0.26,72.0,160.0,45.0,192.0,25.0,57.3,43.1,80.0,62.5,47.0,146.0,4.0,2.7,11.0,1.1,15.3,Matches,22.0,fr FRA,GK,31.0,10.0,10.0,899.0,10.0,14.0,1.4,40.0,27.0,65.0,1.0,5.0,4.0,1.0,10.0,0.0,0.0,0.0,0.0,,Matches,302.0,fr FRA,GK,31.0,10.0,1.0,1.0,0.0,1.0,0.0,0.0,0.0,0.0,0.0,0.0,0.0,1.0,16.0,0.0,0.0,,Matches,302.0,fr FRA,GK,31.0,10.0,275.0,149.0,123.0,43.0,0.0,2.0,0.0,0.0,0.0,0.0,0.0,0.0,179.0,3.0,0.0,Matches,302.0,fr FRA,GK,31.0,10.0,179.0,275.0,65.1,6302.0,5234.0,21.0,21.0,100.0,66.0,67.0,98.5,92.0,184.0,50.0,0.0,0.1,0.0,-0.1,1.0,5.0,0.0,0.0,0.0,Matches,368,fr FRA,GK,31,10,899.0,90.0,26.3,10.0,10,90.0,9,0,,4,0.8,10.0,14.0,-4.0,-0.4,0.06,11.2,11.2,0.0,0.0,0.41,Matches,302.0,fr FRA,GK,31.0,10.0,298.0,228.0,290.0,8.0,0.0,0.0,298.0,0.0,0.0,,0.0,,124.0,746.0,506.0,0.0,0.0,0.0,0.0,0.0,87.0,0.0,Matches,302.0,fr FRA,GK,31.0,10.0,0.0,0.0,0.0,,0.0,0.0,,,,0.0,0.0,0.0,0.0,0.0,,0.0,0.0,Matches,302.0,fr FRA,GK,31.0,10.0,10.0,899.0,10.0,0.0,0.0,0.0,0.0,0.0,0.0,1.0,1.0,0.0,0.0,0.1,0.1,0.0,0.0,0.0,0.0,0.0,0.0,0.0,0.0,0.0,0.01,0.01,0.0,0.01,Matches,Benjamin Lecomte,GK,31,132,141,France,AS Monaco,4,3,2,2,11,8,10,2,2,3,11,3,2,12,8,12,14,11,15,11,11,14,6,12,10,14,13,12,11,14,15,14,14,10,13,14,13,8,13,9,1,12,12,11,8,14,13,14,15,13,13,12,14,14,5,15,13,15,14,15,20,1,1,1,1,1,1,1,1,1,1,1,1,1,187,78,20,6,4659598,6600,6800,4500,Northern_European,132,5,1991/4/26,0,0,34520.0,Espanyol,85041077
691,Jeremías Ledesma,Cádiz,1993,303.0,ar ARG,GK,29.0,34.0,3.0,2.0,3.0,0.0,0.0,3.0,7.0,42.9,4.0,1.0,0.0,1.0,2.0,5.0,23.0,3.0,Matches,303.0,ar ARG,GK,29.0,34.0,10.0,0.29,6.0,3.0,0.0,0.0,1.0,0.0,1.0,0.03,0.0,0.0,0.0,0.0,1.0,0.0,Matches,23.0,ar ARG,GK,29.0,34.0,48.0,8.0,1.0,6.0,0.0,47.1,0.22,-0.9,-0.03,236.0,735.0,32.1,824.0,135.0,58.5,44.9,285.0,88.8,64.1,595.0,42.0,7.1,26.0,0.76,10.8,Matches,23.0,ar ARG,GK,29.0,34.0,34.0,3060.0,34.0,48.0,1.41,179.0,130.0,77.7,9.0,11.0,14.0,12.0,35.3,9.0,8.0,1.0,0.0,11.1,Matches,303.0,ar ARG,GK,29.0,34.0,2.0,0.0,0.0,1.0,7.0,0.0,0.0,2.0,2.0,0.0,1.0,0.0,39.0,8.0,3.0,72.7,Matches,303.0,ar ARG,GK,29.0,34.0,1114.0,674.0,435.0,150.0,0.0,3.0,0.0,0.0,0.0,0.0,0.0,0.0,585.0,5.0,0.0,Matches,303.0,ar ARG,GK,29.0,34.0,585.0,1114.0,52.5,22172.0,18695.0,58.0,60.0,96.7,223.0,230.0,97.0,303.0,818.0,37.0,0.0,0.0,0.1,0.0,1.0,42.0,1.0,0.0,0.0,Matches,369,ar ARG,GK,29,34,3060.0,90.0,89.5,34.0,34,90.0,34,0,,0,1.12,27.0,48.0,-21.0,-0.62,-0.12,35.5,53.5,-18.0,-0.53,0.0,Matches,303.0,ar ARG,GK,29.0,34.0,1221.0,1001.0,1209.0,9.0,3.0,3.0,1221.0,4.0,4.0,100.0,0.0,0.0,602.0,3956.0,2788.0,0.0,1.0,0.0,1.0,0.0,372.0,0.0,Matches,303.0,ar ARG,GK,29.0,34.0,0.0,1.0,0.0,0.0,0.03,0.0,0.0,,11.2,0.0,0.0,0.0,0.0,0.0,0.05,0.0,0.0,Matches,303.0,ar ARG,GK,29.0,34.0,34.0,3060.0,34.0,0.0,0.0,0.0,0.0,0.0,0.0,2.0,0.0,0.0,0.0,0.0,0.1,0.0,0.0,0.0,0.0,0.0,0.0,0.0,0.0,0.0,0.0,0.0,0.0,0.0,Matches,Jeremías Ledesma,GK,29,143,149,"Argentina,Italy",Cádiz,6,2,1,2,7,9,6,2,1,2,8,2,2,9,9,11,15,13,14,11,12,15,3,13,4,12,15,17,11,16,11,14,12,11,11,14,15,5,15,9,16,12,13,12,12,13,17,15,17,13,13,12,10,13,4,15,14,16,13,13,20,1,1,1,1,1,1,1,1,1,1,1,1,1,186,85,8,20,10196337,7093,7093,5493,Mediterranean_Hispanic,140,2,1993/2/13,0,0,16196.0,,14063109
692,Florian Lejeune,Rayo Vallecano,1991,304.0,fr FRA,DF,31.0,28.5,28.0,17.0,19.0,8.0,1.0,17.0,25.0,68.0,8.0,24.0,16.0,8.0,15.0,43.0,123.0,0.0,Matches,304.0,fr FRA,DF,31.0,28.5,20.0,0.7,17.0,0.0,1.0,2.0,0.0,0.0,1.0,0.04,0.0,0.0,0.0,1.0,0.0,0.0,Matches,,,,,,,,,,,,,,,,,,,,,,,,,,,,,,,,,,,,,,,,,,,,,,,,,,,,,,,,304.0,fr FRA,DF,31.0,28.5,6.0,3.0,1.0,23.0,9.0,5.0,9.0,15.0,17.0,0.0,1.0,1.0,123.0,59.0,32.0,64.8,Matches,304.0,fr FRA,DF,31.0,28.5,1417.0,1329.0,82.0,71.0,1.0,38.0,9.0,6.0,4.0,4.0,0.0,0.0,1110.0,6.0,11.0,Matches,304.0,fr FRA,DF,31.0,28.5,1110.0,1417.0,78.3,26005.0,10316.0,248.0,285.0,87.0,633.0,696.0,90.9,221.0,401.0,55.1,0.0,0.3,0.4,-0.3,8.0,119.0,5.0,1.0,80.0,Matches,370,fr FRA,DF,31,31,2565.0,83.0,75.0,28.5,31,83.0,26,0,,4,1.26,32.0,37.0,-5.0,-0.18,0.14,32.6,39.0,-6.5,-0.23,-0.23,Matches,304.0,fr FRA,DF,31.0,28.5,1666.0,187.0,804.0,789.0,86.0,21.0,1666.0,7.0,4.0,57.1,2.0,28.6,956.0,4325.0,2516.0,8.0,9.0,0.0,6.0,1.0,1052.0,3.0,Matches,304.0,fr FRA,DF,31.0,28.5,4.0,41.0,14.0,34.1,1.44,0.49,0.1,0.29,28.0,18.0,0.0,0.0,2.8,2.8,0.07,1.2,1.2,Matches,304.0,fr FRA,DF,31.0,31.0,31.0,2565.0,28.5,4.0,0.0,4.0,4.0,0.0,0.0,6.0,3.0,2.8,2.8,0.3,3.1,8.0,80.0,3.0,0.14,0.0,0.14,0.14,0.14,0.1,0.01,0.11,0.1,0.11,Matches,Florian Lejeune,D C,31,133,141,France,Alavés,4,10,10,7,11,10,15,9,5,15,13,7,14,11,11,14,15,13,12,12,13,14,7,11,7,15,15,14,10,10,13,14,13,13,13,15,11,11,14,7,10,3,2,3,3,3,3,2,2,2,3,2,12,15,7,12,11,13,14,14,1,1,20,1,1,1,8,1,1,1,1,1,1,1,190,82,10,20,5654060,6639,6639,4639,Northern_European,133,6,1991/5/20,0,0,32000.0,Vallecano,85063747
693,Thomas Lemar,Atlético Madrid,1995,306.0,fr FRA,MF,26.0,13.9,30.0,18.0,10.0,13.0,7.0,10.0,28.0,35.7,18.0,12.0,3.0,9.0,7.0,37.0,12.0,0.0,Matches,306.0,fr FRA,MF,26.0,13.9,45.0,3.23,33.0,5.0,3.0,1.0,1.0,2.0,7.0,0.5,4.0,0.0,1.0,1.0,0.0,1.0,Matches,,,,,,,,,,,,,,,,,,,,,,,,,,,,,,,,,,,,,,,,,,,,,,,,,,,,,,,,306.0,fr FRA,MF,26.0,13.9,1.0,0.0,0.0,7.0,17.0,2.0,44.0,7.0,18.0,0.0,0.0,0.0,75.0,5.0,7.0,41.7,Matches,306.0,fr FRA,MF,26.0,13.9,814.0,776.0,36.0,10.0,6.0,7.0,44.0,9.0,15.0,5.0,7.0,0.0,690.0,2.0,16.0,Matches,306.0,fr FRA,MF,26.0,13.9,690.0,814.0,84.8,10150.0,2771.0,404.0,435.0,92.9,202.0,238.0,84.9,52.0,82.0,63.4,3.0,1.9,1.6,1.1,26.0,68.0,22.0,6.0,80.0,Matches,372,fr FRA,MF,26,27,1252.0,46.0,36.6,13.9,17,60.0,0,10,24.0,2,2.0,27.0,10.0,17.0,1.22,0.39,21.3,11.5,9.9,0.71,0.26,Matches,306.0,fr FRA,MF,26.0,13.9,936.0,17.0,148.0,483.0,316.0,23.0,936.0,44.0,21.0,47.7,15.0,34.1,607.0,3165.0,1620.0,36.0,36.0,3.0,20.0,19.0,744.0,79.0,Matches,306.0,fr FRA,MF,26.0,13.9,1.0,13.0,6.0,46.2,0.93,0.43,0.08,0.17,21.1,0.0,0.0,0.0,0.9,0.9,0.07,0.1,0.1,Matches,306.0,fr FRA,MF,26.0,27.0,17.0,1252.0,13.9,1.0,3.0,4.0,1.0,0.0,0.0,1.0,0.0,0.9,0.9,1.9,2.9,36.0,80.0,79.0,0.07,0.22,0.29,0.07,0.29,0.07,0.14,0.21,0.07,0.21,Matches,Thomas Lemar,WB/M/AM LC,26,149,165,"France,Guadeloupe",A. Madrid,16,15,15,12,15,16,6,13,2,7,16,14,6,16,9,12,10,13,12,15,12,15,16,10,14,8,14,15,15,16,11,7,13,14,13,9,13,5,15,12,16,3,2,1,1,1,3,3,2,3,2,3,19,15,3,16,15,16,18,16,1,10,1,1,18,1,1,19,17,13,20,18,14,1,170,58,20,8,11379621,7300,7450,6750,Mixed_Race,141,14,1995/11/12,27,4,124516.0,,85093001
694,Sergio León,Valladolid,1989,307.0,es ESP,FW,33.0,14.8,6.0,4.0,0.0,4.0,2.0,3.0,6.0,50.0,3.0,6.0,0.0,6.0,0.0,6.0,4.0,0.0,Matches,307.0,es ESP,FW,33.0,14.8,26.0,1.75,17.0,2.0,2.0,3.0,2.0,0.0,3.0,0.2,2.0,0.0,0.0,1.0,0.0,0.0,Matches,,,,,,,,,,,,,,,,,,,,,,,,,,,,,,,,,,,,,,,,,,,,,,,,,,,,,,,,307.0,es ESP,FW,33.0,14.8,0.0,1.0,0.0,8.0,22.0,20.0,9.0,0.0,4.0,0.0,0.0,0.0,45.0,18.0,47.0,27.7,Matches,307.0,es ESP,FW,33.0,14.8,206.0,172.0,31.0,0.0,0.0,6.0,9.0,2.0,0.0,0.0,0.0,0.0,138.0,3.0,6.0,Matches,307.0,es ESP,FW,33.0,14.8,138.0,206.0,67.0,2143.0,398.0,72.0,92.0,78.3,46.0,65.0,70.8,9.0,20.0,45.0,1.0,1.2,0.6,-0.2,12.0,5.0,6.0,1.0,22.0,Matches,374,es ESP,FW,33,29,1334.0,46.0,39.0,14.8,14,71.0,3,15,23.0,7,1.07,14.0,28.0,-14.0,-0.94,-0.25,14.2,27.3,-13.1,-0.88,-0.3,Matches,307.0,es ESP,FW,33.0,14.8,345.0,5.0,26.0,159.0,170.0,49.0,343.0,30.0,10.0,33.3,17.0,56.7,210.0,1122.0,563.0,21.0,16.0,6.0,45.0,17.0,242.0,75.0,Matches,307.0,es ESP,FW,33.0,14.8,6.0,26.0,15.0,57.7,1.75,1.01,0.19,0.33,16.3,0.0,1.0,2.0,3.9,2.3,0.09,2.1,2.7,Matches,307.0,es ESP,FW,33.0,29.0,14.0,1334.0,14.8,6.0,1.0,7.0,5.0,1.0,2.0,0.0,1.0,3.9,2.3,1.2,3.5,21.0,22.0,75.0,0.4,0.07,0.47,0.34,0.4,0.26,0.08,0.34,0.16,0.23,Matches,Sergio León,S,33,127,140,Spain,Valladolid,6,11,14,15,12,11,12,14,7,6,13,13,6,13,13,13,14,12,12,12,12,15,16,12,15,7,11,15,13,13,12,11,13,14,12,12,12,15,12,8,12,3,2,3,1,3,3,1,1,1,3,2,13,14,12,18,12,13,15,11,1,1,1,1,1,1,1,1,1,1,13,13,13,20,178,73,10,20,935432,6400,6400,4500,Mediterranean_Hispanic,127,3,1989/1/6,0,0,18506.0,,67140149
695,Robert Lewandowski,Barcelona,1988,308.0,pl POL,FW,33.0,31.6,17.0,11.0,2.0,5.0,10.0,7.0,14.0,50.0,7.0,20.0,0.0,20.0,2.0,19.0,14.0,0.0,Matches,308.0,pl POL,FW,33.0,31.6,91.0,2.88,68.0,1.0,6.0,12.0,4.0,0.0,16.0,0.51,10.0,0.0,1.0,5.0,0.0,0.0,Matches,,,,,,,,,,,,,,,,,,,,,,,,,,,,,,,,,,,,,,,,,,,,,,,,,,,,,,,,308.0,pl POL,FW,33.0,31.6,4.0,1.0,1.0,39.0,46.0,22.0,19.0,2.0,11.0,0.0,0.0,0.0,58.0,52.0,45.0,53.6,Matches,308.0,pl POL,FW,33.0,31.6,793.0,767.0,14.0,4.0,16.0,5.0,19.0,0.0,0.0,0.0,0.0,0.0,602.0,12.0,24.0,Matches,308.0,pl POL,FW,33.0,31.6,602.0,793.0,75.9,8306.0,1669.0,369.0,440.0,83.9,165.0,214.0,77.1,30.0,46.0,65.2,7.0,6.3,5.3,0.7,35.0,49.0,31.0,2.0,100.0,Matches,375,pl POL,FW,33,34,2847.0,84.0,83.2,31.6,33,85.0,27,1,34.0,0,2.24,62.0,20.0,42.0,1.33,0.07,66.5,26.1,40.3,1.28,0.96,Matches,308.0,pl POL,FW,33.0,31.6,1155.0,17.0,41.0,432.0,694.0,210.0,1154.0,59.0,30.0,50.8,26.0,44.1,781.0,3757.0,1361.0,52.0,38.0,25.0,94.0,50.0,998.0,248.0,Matches,308.0,pl POL,FW,33.0,31.6,23.0,134.0,56.0,41.8,4.24,1.77,0.17,0.41,13.8,5.0,0.0,1.0,24.3,23.5,0.18,-1.3,-0.5,Matches,308.0,pl POL,FW,33.0,34.0,33.0,2847.0,31.6,23.0,7.0,30.0,23.0,0.0,1.0,4.0,1.0,24.3,23.5,6.3,29.8,52.0,100.0,248.0,0.73,0.22,0.95,0.73,0.95,0.77,0.2,0.97,0.74,0.94,Matches,Robert Lewandowski,S,33,186,190,Poland,Barcelona,3,8,13,19,18,15,17,12,3,7,13,20,7,16,15,19,16,17,17,13,17,20,14,15,19,7,12,12,14,13,19,15,20,14,18,16,18,8,15,2,8,2,2,3,2,3,2,3,3,2,1,1,15,20,15,10,16,18,10,11,1,1,1,1,1,1,1,1,1,1,10,12,8,20,185,81,13,20,347975206,9300,9400,9250,Northern_European,183,3,1988/8/21,132,76,345204.0,,719601
696,Samuel Lino,Valencia,1999,309.0,br BRA,FWMF,22.0,32.1,66.0,43.0,17.0,37.0,12.0,26.0,72.0,36.1,46.0,34.0,0.0,34.0,18.0,84.0,16.0,0.0,Matches,309.0,br BRA,FWMF,22.0,32.1,99.0,3.09,63.0,1.0,16.0,7.0,11.0,1.0,14.0,0.44,8.0,0.0,1.0,3.0,2.0,0.0,Matches,,,,,,,,,,,,,,,,,,,,,,,,,,,,,,,,,,,,,,,,,,,,,,,,,,,,,,,,309.0,br BRA,FWMF,22.0,32.1,4.0,0.0,0.0,35.0,60.0,15.0,82.0,18.0,43.0,2.0,0.0,0.0,170.0,17.0,41.0,29.3,Matches,309.0,br BRA,FWMF,22.0,32.1,1163.0,1121.0,37.0,5.0,5.0,2.0,82.0,22.0,10.0,1.0,2.0,0.0,878.0,5.0,57.0,Matches,309.0,br BRA,FWMF,22.0,32.1,878.0,1163.0,75.5,12024.0,2590.0,538.0,613.0,87.8,256.0,342.0,74.9,36.0,77.0,46.8,1.0,2.1,3.7,-1.1,27.0,46.0,30.0,7.0,93.0,Matches,376,br BRA,FWMF,22,38,2887.0,76.0,84.4,32.1,33,82.0,17,5,37.0,0,1.11,39.0,38.0,1.0,0.03,0.71,42.8,36.0,6.7,0.21,0.37,Matches,309.0,br BRA,FWMF,22.0,32.1,1611.0,15.0,178.0,582.0,881.0,162.0,1611.0,121.0,53.0,43.8,50.0,41.3,1073.0,7128.0,4026.0,144.0,100.0,60.0,85.0,57.0,1165.0,260.0,Matches,309.0,br BRA,FWMF,22.0,32.1,6.0,96.0,33.0,34.4,2.99,1.03,0.06,0.18,17.9,0.0,0.0,0.0,7.8,7.7,0.08,-1.8,-1.7,Matches,309.0,br BRA,FWMF,22.0,38.0,33.0,2887.0,32.1,6.0,1.0,7.0,6.0,0.0,0.0,4.0,0.0,7.8,7.7,2.1,9.8,144.0,93.0,260.0,0.19,0.03,0.22,0.19,0.22,0.24,0.07,0.31,0.24,0.31,Matches,Samuel Lino,AM/S RL,22,139,152,Brazil,A. Madrid,8,9,14,14,14,9,6,13,7,5,13,11,10,14,12,11,13,12,11,13,11,15,14,7,13,8,10,15,15,13,15,12,17,15,14,14,10,10,16,5,13,1,3,2,1,2,3,2,1,3,1,3,16,13,6,12,15,14,11,10,1,1,1,1,1,1,1,13,1,10,20,1,18,18,178,72,12,20,13740001,6950,5331,5226,Mixed_Race,134,12,1999/12/23,0,0,23099.0,Valencia,19320258
697,Marcos Llorente,Atlético Madrid,1995,312.0,es ESP,MFDF,27.0,18.9,32.0,15.0,16.0,10.0,6.0,17.0,30.0,56.7,13.0,26.0,2.0,24.0,17.0,49.0,19.0,0.0,Matches,312.0,es ESP,MFDF,27.0,18.9,60.0,3.17,54.0,1.0,0.0,2.0,1.0,2.0,3.0,0.16,3.0,0.0,0.0,0.0,0.0,0.0,Matches,,,,,,,,,,,,,,,,,,,,,,,,,,,,,,,,,,,,,,,,,,,,,,,,,,,,,,,,312.0,es ESP,MFDF,27.0,18.9,5.0,0.0,0.0,30.0,13.0,3.0,44.0,17.0,15.0,0.0,1.0,0.0,108.0,10.0,19.0,34.5,Matches,312.0,es ESP,MFDF,27.0,18.9,816.0,759.0,53.0,0.0,1.0,4.0,44.0,53.0,0.0,0.0,0.0,0.0,660.0,4.0,26.0,Matches,312.0,es ESP,MFDF,27.0,18.9,660.0,816.0,80.9,9299.0,2473.0,380.0,415.0,91.6,202.0,260.0,77.7,34.0,55.0,61.8,2.0,3.6,3.1,-1.6,29.0,30.0,30.0,3.0,88.0,Matches,380,es ESP,MFDF,27,22,1703.0,77.0,49.8,18.9,21,80.0,11,1,30.0,2,2.0,28.0,11.0,17.0,0.9,-0.15,31.6,16.1,15.5,0.82,0.54,Matches,312.0,es ESP,MFDF,27.0,18.9,997.0,35.0,216.0,378.0,415.0,64.0,997.0,27.0,12.0,44.4,13.0,48.1,558.0,3321.0,1942.0,64.0,45.0,15.0,23.0,11.0,661.0,139.0,Matches,312.0,es ESP,MFDF,27.0,18.9,1.0,24.0,9.0,37.5,1.27,0.48,0.04,0.11,17.9,0.0,0.0,0.0,2.1,2.1,0.09,-1.1,-1.1,Matches,312.0,es ESP,MFDF,27.0,22.0,21.0,1703.0,18.9,1.0,2.0,3.0,1.0,0.0,0.0,5.0,0.0,2.1,2.1,3.6,5.7,64.0,88.0,139.0,0.05,0.11,0.16,0.05,0.16,0.11,0.19,0.3,0.11,0.3,Matches,Marcos Llorente,WB/DM/M/AM RC,27,155,163,Spain,A. Madrid,9,11,12,12,12,8,13,11,7,11,15,11,15,14,13,15,13,15,14,14,14,16,9,12,13,12,16,16,13,11,11,10,18,14,16,15,15,14,13,7,19,3,3,1,3,2,3,1,1,3,3,1,12,15,5,16,16,18,13,12,1,1,12,13,1,18,19,1,20,19,1,18,13,14,184,73,10,20,99928133,7750,7750,7150,Mediterranean_Hispanic,142,6,1995/1/30,16,0,153846.0,,67196198
698,Giovani Lo Celso,Villarreal,1996,313.0,ar ARG,MFFW,26.0,12.5,32.0,28.0,7.0,15.0,10.0,12.0,21.0,57.1,9.0,14.0,2.0,12.0,6.0,38.0,5.0,0.0,Matches,313.0,ar ARG,MFFW,26.0,12.5,60.0,4.79,45.0,4.0,2.0,4.0,5.0,0.0,3.0,0.24,3.0,0.0,0.0,0.0,0.0,0.0,Matches,,,,,,,,,,,,,,,,,,,,,,,,,,,,,,,,,,,,,,,,,,,,,,,,,,,,,,,,313.0,ar ARG,MFFW,26.0,12.5,3.0,0.0,0.0,15.0,31.0,4.0,31.0,6.0,28.0,0.0,0.0,0.0,61.0,2.0,5.0,28.6,Matches,313.0,ar ARG,MFFW,26.0,12.5,694.0,643.0,47.0,8.0,11.0,17.0,31.0,7.0,27.0,17.0,0.0,0.0,578.0,4.0,14.0,Matches,313.0,ar ARG,MFFW,26.0,12.5,578.0,694.0,83.3,9815.0,2691.0,294.0,331.0,88.8,191.0,225.0,84.9,72.0,92.0,78.3,3.0,3.3,3.1,-0.3,31.0,51.0,29.0,1.0,97.0,Matches,381,ar ARG,MFFW,26,22,1126.0,51.0,32.9,12.5,14,69.0,2,8,21.0,1,1.73,21.0,12.0,9.0,0.72,0.33,25.4,14.1,11.4,0.91,0.89,Matches,313.0,ar ARG,MFFW,26.0,12.5,854.0,10.0,113.0,367.0,388.0,42.0,854.0,47.0,22.0,46.8,15.0,31.9,555.0,3286.0,1600.0,35.0,28.0,10.0,31.0,23.0,651.0,70.0,Matches,313.0,ar ARG,MFFW,26.0,12.5,2.0,30.0,7.0,23.3,2.4,0.56,0.07,0.29,19.8,3.0,0.0,0.0,2.4,2.4,0.08,-0.4,-0.4,Matches,313.0,ar ARG,MFFW,26.0,22.0,14.0,1126.0,12.5,2.0,3.0,5.0,2.0,0.0,0.0,3.0,0.0,2.4,2.4,3.3,5.6,35.0,97.0,70.0,0.16,0.24,0.4,0.16,0.4,0.19,0.26,0.45,0.19,0.45,Matches,Giovani Lo Celso,DM/M/AM LC,26,145,151,"Argentina,Italy",Tottenham Hotspur,11,14,16,11,15,13,10,13,8,9,16,14,14,16,12,13,14,15,11,14,14,15,15,10,14,12,16,14,13,14,15,9,11,12,13,11,12,11,13,15,14,1,1,1,1,1,2,2,2,3,3,1,12,13,6,15,13,14,12,14,1,1,1,1,1,1,16,18,20,7,1,20,1,1,176,69,20,8,34710527,7250,7250,6250,Mediterranean_Hispanic,141,5,1996/4/9,39,2,115992.0,Villarreal,14108651
699,David López,Girona,1989,314.0,es ESP,DF,32.0,18.4,31.0,18.0,17.0,13.0,1.0,19.0,27.0,70.4,8.0,29.0,19.0,10.0,14.0,45.0,64.0,1.0,Matches,314.0,es ESP,DF,32.0,18.4,11.0,0.6,10.0,0.0,0.0,0.0,0.0,1.0,2.0,0.11,2.0,0.0,0.0,0.0,0.0,0.0,Matches,,,,,,,,,,,,,,,,,,,,,,,,,,,,,,,,,,,,,,,,,,,,,,,,,,,,,,,,314.0,es ESP,DF,32.0,18.4,5.0,0.0,0.0,16.0,16.0,3.0,0.0,14.0,18.0,0.0,0.0,0.0,106.0,29.0,32.0,47.5,Matches,314.0,es ESP,DF,32.0,18.4,1203.0,1138.0,62.0,48.0,0.0,5.0,0.0,3.0,0.0,0.0,0.0,0.0,1082.0,3.0,5.0,Matches,314.0,es ESP,DF,32.0,18.4,1082.0,1203.0,89.9,20522.0,7606.0,373.0,400.0,93.3,607.0,637.0,95.3,93.0,146.0,63.7,1.0,0.6,0.5,0.4,8.0,57.0,1.0,0.0,54.0,Matches,384,es ESP,DF,32,20,1652.0,83.0,48.3,18.4,19,85.0,14,1,45.0,7,1.15,26.0,24.0,2.0,0.11,0.06,22.6,25.7,-3.1,-0.17,-0.11,Matches,314.0,es ESP,DF,32.0,18.4,1379.0,207.0,795.0,553.0,37.0,16.0,1379.0,6.0,6.0,100.0,0.0,0.0,823.0,4281.0,2574.0,18.0,5.0,0.0,8.0,1.0,959.0,4.0,Matches,314.0,es ESP,DF,32.0,18.4,3.0,11.0,8.0,72.7,0.6,0.44,0.27,0.38,16.9,0.0,0.0,0.0,1.5,1.5,0.14,1.5,1.5,Matches,314.0,es ESP,DF,32.0,20.0,19.0,1652.0,18.4,3.0,1.0,4.0,3.0,0.0,0.0,5.0,0.0,1.5,1.5,0.6,2.1,18.0,54.0,4.0,0.16,0.05,0.22,0.16,0.22,0.08,0.03,0.12,0.08,0.12,Matches,David López,D/DM C,32,141,152,Spain,Girona,7,8,9,8,13,9,14,10,9,14,12,9,14,12,13,13,15,14,14,12,15,9,7,15,10,15,18,16,12,11,12,12,12,12,14,13,14,11,13,11,14,1,1,3,4,2,1,2,3,2,2,1,12,13,5,12,12,13,10,10,1,1,19,12,1,1,20,1,15,1,1,1,1,1,183,83,10,20,3871317,7000,7000,5550,Mediterranean_Hispanic,133,3,1989/10/9,0,0,67077.0,,67155094
700,Unai López,Rayo Vallecano,1995,317.0,es ESP,MF,26.0,13.9,32.0,20.0,10.0,17.0,5.0,13.0,37.0,35.1,24.0,12.0,1.0,11.0,15.0,47.0,6.0,1.0,Matches,317.0,es ESP,MF,26.0,13.9,48.0,3.44,35.0,9.0,0.0,1.0,2.0,1.0,3.0,0.22,3.0,0.0,0.0,0.0,0.0,0.0,Matches,,,,,,,,,,,,,,,,,,,,,,,,,,,,,,,,,,,,,,,,,,,,,,,,,,,,,,,,317.0,es ESP,MF,26.0,13.9,2.0,0.0,0.0,22.0,17.0,2.0,55.0,15.0,20.0,0.0,0.0,0.0,98.0,7.0,17.0,29.2,Matches,317.0,es ESP,MF,26.0,13.9,929.0,835.0,86.0,44.0,0.0,18.0,55.0,7.0,27.0,10.0,8.0,1.0,745.0,8.0,18.0,Matches,317.0,es ESP,MF,26.0,13.9,745.0,929.0,80.2,13818.0,3802.0,332.0,372.0,89.2,283.0,328.0,86.3,110.0,175.0,62.9,2.0,1.4,1.9,0.6,21.0,102.0,14.0,3.0,98.0,Matches,390,es ESP,MF,26,34,1254.0,37.0,36.7,13.9,12,67.0,1,22,20.0,4,1.35,15.0,20.0,-5.0,-0.36,-0.23,16.2,18.4,-2.1,-0.15,0.02,Matches,317.0,es ESP,MF,26.0,13.9,1076.0,9.0,142.0,633.0,311.0,22.0,1076.0,27.0,12.0,44.4,14.0,51.9,635.0,2797.0,1067.0,17.0,18.0,5.0,27.0,19.0,757.0,43.0,Matches,317.0,es ESP,MF,26.0,13.9,1.0,26.0,10.0,38.5,1.87,0.72,0.04,0.1,26.5,2.0,0.0,0.0,1.3,1.3,0.05,-0.3,-0.3,Matches,317.0,es ESP,MF,26.0,34.0,12.0,1254.0,13.9,1.0,2.0,3.0,1.0,0.0,0.0,2.0,0.0,1.3,1.3,1.4,2.7,17.0,98.0,43.0,0.07,0.14,0.22,0.07,0.22,0.09,0.1,0.19,0.09,0.19,Matches,Unai López,M/AM C,26,130,151,"Spain,Pays Basque",Vallecano,12,13,13,12,15,11,7,9,8,7,15,13,8,15,13,15,13,13,13,14,12,12,14,12,14,13,15,14,12,12,13,8,12,12,12,11,13,7,12,12,16,1,2,3,3,1,3,1,2,1,1,3,13,14,8,11,10,10,10,17,1,1,1,1,1,1,12,12,20,14,12,18,14,1,170,67,12,20,3383932,6500,6500,5000,Mediterranean_Hispanic,128,4,1995/10/30,0,0,9724.0,,67145056
701,Anthony Lozano,Cádiz,1993,318.0,hn HON,FW,29.0,16.0,6.0,4.0,1.0,4.0,1.0,1.0,7.0,14.3,6.0,12.0,1.0,11.0,3.0,9.0,17.0,0.0,Matches,318.0,hn HON,FW,29.0,16.0,34.0,2.12,20.0,0.0,7.0,5.0,2.0,0.0,5.0,0.31,2.0,0.0,1.0,1.0,1.0,0.0,Matches,,,,,,,,,,,,,,,,,,,,,,,,,,,,,,,,,,,,,,,,,,,,,,,,,,,,,,,,318.0,hn HON,FW,29.0,16.0,6.0,0.0,0.0,43.0,35.0,8.0,7.0,3.0,4.0,1.0,0.0,0.0,47.0,60.0,79.0,43.2,Matches,318.0,hn HON,FW,29.0,16.0,293.0,283.0,9.0,0.0,1.0,1.0,7.0,1.0,0.0,0.0,0.0,0.0,198.0,1.0,13.0,Matches,318.0,hn HON,FW,29.0,16.0,198.0,293.0,67.6,2420.0,589.0,123.0,159.0,77.4,54.0,80.0,67.5,4.0,12.0,33.3,1.0,0.8,1.0,0.2,11.0,19.0,6.0,1.0,28.0,Matches,391,hn HON,FW,29,28,1443.0,52.0,42.2,16.0,14,75.0,5,14,28.0,5,1.14,14.0,19.0,-5.0,-0.31,0.51,14.9,23.6,-8.7,-0.54,-0.02,Matches,318.0,hn HON,FW,29.0,16.0,495.0,20.0,61.0,246.0,199.0,47.0,495.0,44.0,17.0,38.6,22.0,50.0,313.0,1693.0,658.0,19.0,15.0,7.0,62.0,37.0,397.0,58.0,Matches,318.0,hn HON,FW,29.0,16.0,1.0,30.0,8.0,26.7,1.87,0.5,0.03,0.13,16.7,0.0,0.0,0.0,2.6,2.6,0.09,-1.6,-1.6,Matches,318.0,hn HON,FW,29.0,28.0,14.0,1443.0,16.0,1.0,1.0,2.0,1.0,0.0,0.0,6.0,0.0,2.6,2.6,0.8,3.5,19.0,28.0,58.0,0.06,0.06,0.12,0.06,0.12,0.17,0.05,0.22,0.17,0.22,Matches,Anthony Lozano,S,29,131,137,"Honduras,Spain",Cádiz,7,8,12,13,13,7,13,12,8,6,12,12,7,14,12,15,14,12,12,12,13,14,13,9,14,9,12,15,13,14,13,12,14,14,14,12,10,8,16,12,11,4,3,4,3,1,2,4,2,1,4,2,14,13,6,14,11,14,13,9,1,1,1,1,1,1,1,1,1,1,9,10,12,20,183,74,11,20,3429931,6549,6549,4999,Mixed_Race,130,13,1993/4/25,40,9,15038.0,,87006900
702,José Luis Morales,Villarreal,1987,321.0,es ESP,FWMF,35.0,13.5,7.0,6.0,1.0,2.0,4.0,5.0,17.0,29.4,12.0,12.0,1.0,11.0,2.0,9.0,2.0,0.0,Matches,321.0,es ESP,FWMF,35.0,13.5,29.0,2.16,19.0,0.0,5.0,4.0,1.0,0.0,4.0,0.3,2.0,0.0,0.0,2.0,0.0,0.0,Matches,,,,,,,,,,,,,,,,,,,,,,,,,,,,,,,,,,,,,,,,,,,,,,,,,,,,,,,,321.0,es ESP,FWMF,35.0,13.5,2.0,0.0,0.0,6.0,10.0,11.0,13.0,2.0,6.0,0.0,0.0,0.0,29.0,8.0,16.0,33.3,Matches,321.0,es ESP,FWMF,35.0,13.5,258.0,237.0,18.0,0.0,2.0,1.0,13.0,4.0,0.0,0.0,0.0,0.0,181.0,3.0,14.0,Matches,321.0,es ESP,FWMF,35.0,13.5,181.0,258.0,70.2,2380.0,486.0,121.0,150.0,80.7,46.0,66.0,69.7,7.0,11.0,63.6,0.0,1.6,1.0,-1.6,9.0,4.0,10.0,2.0,15.0,Matches,395,es ESP,FWMF,35,29,1211.0,42.0,35.4,13.5,11,74.0,4,18,22.0,1,1.52,20.0,11.0,9.0,0.67,0.26,20.2,17.3,2.8,0.21,-0.15,Matches,321.0,es ESP,FWMF,35.0,13.5,402.0,2.0,35.0,142.0,233.0,79.0,402.0,51.0,18.0,35.3,27.0,52.9,233.0,1565.0,769.0,40.0,22.0,26.0,24.0,11.0,283.0,92.0,Matches,321.0,es ESP,FWMF,35.0,13.5,7.0,41.0,21.0,51.2,3.05,1.56,0.17,0.33,14.7,0.0,0.0,0.0,6.5,6.5,0.17,0.5,0.5,Matches,321.0,es ESP,FWMF,35.0,29.0,11.0,1211.0,13.5,7.0,0.0,7.0,7.0,0.0,0.0,2.0,0.0,6.5,6.5,1.6,8.2,40.0,15.0,92.0,0.52,0.0,0.52,0.52,0.52,0.49,0.12,0.61,0.49,0.61,Matches,José Luis Morales,M/AM/S RL,35,141,147,Spain,Villarreal,7,12,15,14,13,8,8,13,6,6,13,14,8,14,11,12,10,14,13,13,13,16,15,17,14,9,13,13,14,14,9,9,16,14,14,9,13,7,16,6,16,3,3,3,3,3,1,2,2,4,2,1,13,16,6,19,18,18,17,12,1,1,1,1,5,8,1,17,5,16,20,10,17,18,184,70,12,20,347975206,7100,7100,4750,Mediterranean_Hispanic,134,6,1987/7/23,0,0,27476.0,,67030120
703,Pablo Maffeo,Mallorca,1997,325.0,es ESP,DF,25.0,33.1,75.0,46.0,54.0,16.0,5.0,45.0,78.0,57.7,33.0,38.0,11.0,27.0,26.0,101.0,76.0,0.0,Matches,325.0,es ESP,DF,25.0,33.1,62.0,1.84,43.0,10.0,3.0,1.0,5.0,0.0,6.0,0.18,4.0,0.0,0.0,1.0,1.0,0.0,Matches,,,,,,,,,,,,,,,,,,,,,,,,,,,,,,,,,,,,,,,,,,,,,,,,,,,,,,,,325.0,es ESP,DF,25.0,33.1,6.0,1.0,0.0,32.0,45.0,5.0,123.0,26.0,46.0,0.0,0.0,0.0,161.0,47.0,32.0,59.5,Matches,325.0,es ESP,DF,25.0,33.1,1221.0,967.0,248.0,7.0,2.0,9.0,123.0,241.0,0.0,0.0,0.0,0.0,819.0,6.0,39.0,Matches,325.0,es ESP,DF,25.0,33.1,819.0,1221.0,67.1,14063.0,6175.0,415.0,469.0,88.5,310.0,460.0,67.4,83.0,213.0,39.0,4.0,3.0,2.7,1.0,34.0,53.0,29.0,21.0,61.0,Matches,399,es ESP,DF,25,35,2975.0,85.0,87.0,33.1,34,87.0,30,1,29.0,0,1.26,31.0,40.0,-9.0,-0.27,-0.88,29.4,42.1,-12.7,-0.38,-0.73,Matches,325.0,es ESP,DF,25.0,33.1,1599.0,104.0,462.0,660.0,499.0,56.0,1599.0,85.0,35.0,41.2,35.0,41.2,804.0,4817.0,2118.0,67.0,52.0,14.0,62.0,36.0,860.0,134.0,Matches,325.0,es ESP,DF,25.0,33.1,2.0,21.0,4.0,19.0,0.64,0.12,0.1,0.5,17.4,0.0,0.0,0.0,1.8,1.8,0.08,0.2,0.2,Matches,325.0,es ESP,DF,25.0,35.0,34.0,2975.0,33.1,2.0,4.0,6.0,2.0,0.0,0.0,6.0,1.0,1.8,1.8,3.0,4.8,67.0,61.0,134.0,0.06,0.12,0.18,0.06,0.18,0.05,0.09,0.14,0.05,0.14,Matches,Pablo Maffeo,D/WB R,25,135,151,"Spain,Argentina",Mallorca,6,13,13,7,11,7,9,11,12,12,12,8,15,12,14,12,16,10,10,10,11,17,13,8,13,12,14,17,16,15,15,8,15,14,14,10,14,12,16,6,10,1,1,2,1,3,1,2,1,2,1,4,10,16,13,9,14,8,10,8,1,1,8,20,1,20,1,1,1,12,1,1,12,1,173,68,12,20,7064704,6750,6750,5150,Mediterranean_Hispanic,128,6,1997/7/12,0,0,28845.0,,28095341
704,Nemanja Maksimović,Getafe,1995,328.0,rs SRB,MF,27.0,22.8,41.0,30.0,17.0,18.0,6.0,19.0,32.0,59.4,13.0,36.0,14.0,22.0,34.0,75.0,27.0,0.0,Matches,328.0,rs SRB,MF,27.0,22.8,30.0,1.31,25.0,0.0,0.0,3.0,1.0,1.0,1.0,0.04,1.0,0.0,0.0,0.0,0.0,0.0,Matches,,,,,,,,,,,,,,,,,,,,,,,,,,,,,,,,,,,,,,,,,,,,,,,,,,,,,,,,328.0,rs SRB,MF,27.0,22.8,3.0,0.0,0.0,25.0,8.0,0.0,9.0,34.0,30.0,0.0,0.0,0.0,93.0,45.0,30.0,60.0,Matches,328.0,rs SRB,MF,27.0,22.8,563.0,531.0,32.0,12.0,0.0,0.0,9.0,0.0,1.0,0.0,0.0,0.0,439.0,0.0,10.0,Matches,328.0,rs SRB,MF,27.0,22.8,439.0,563.0,78.0,6546.0,1380.0,226.0,277.0,81.6,169.0,204.0,82.8,20.0,42.0,47.6,0.0,0.6,0.8,-0.6,10.0,28.0,7.0,3.0,42.0,Matches,402,rs SRB,MF,27,29,2053.0,71.0,60.0,22.8,26,75.0,9,3,36.0,7,1.28,19.0,26.0,-7.0,-0.31,-0.04,19.1,26.9,-7.8,-0.34,-0.24,Matches,328.0,rs SRB,MF,27.0,22.8,794.0,44.0,189.0,437.0,174.0,35.0,794.0,9.0,3.0,33.3,6.0,66.7,300.0,1251.0,545.0,13.0,12.0,4.0,17.0,7.0,346.0,29.0,Matches,328.0,rs SRB,MF,27.0,22.8,0.0,18.0,7.0,38.9,0.79,0.31,0.0,0.0,14.2,0.0,0.0,0.0,1.8,1.8,0.1,-1.8,-1.8,Matches,328.0,rs SRB,MF,27.0,29.0,26.0,2053.0,22.8,0.0,0.0,0.0,0.0,0.0,0.0,3.0,0.0,1.8,1.8,0.6,2.3,13.0,42.0,29.0,0.0,0.0,0.0,0.0,0.0,0.08,0.03,0.1,0.08,0.1,Matches,Nemanja Maksimović,DM/M RC,27,140,150,Serbia,Getafe,12,12,12,11,13,10,12,14,9,11,14,5,11,12,14,12,12,13,12,14,13,15,12,13,14,13,15,15,13,12,11,13,14,14,15,15,10,10,15,11,20,3,1,3,3,1,1,1,1,2,3,1,14,15,11,13,14,13,14,13,1,1,1,1,1,1,20,10,18,15,1,12,1,1,184,75,12,20,7812294,7000,6850,6250,Northern_European,134,4,1995/1/26,39,0,23075.0,,62097340
705,Hugo Mallo,Celta Vigo,1991,329.0,es ESP,DF,31.0,24.0,53.0,29.0,34.0,14.0,5.0,28.0,42.0,66.7,14.0,28.0,7.0,21.0,24.0,77.0,73.0,0.0,Matches,329.0,es ESP,DF,31.0,24.0,50.0,2.08,41.0,4.0,1.0,3.0,1.0,0.0,6.0,0.25,5.0,1.0,0.0,0.0,0.0,0.0,Matches,,,,,,,,,,,,,,,,,,,,,,,,,,,,,,,,,,,,,,,,,,,,,,,,,,,,,,,,329.0,es ESP,DF,31.0,24.0,6.0,1.0,1.0,44.0,23.0,6.0,67.0,24.0,29.0,0.0,1.0,0.0,124.0,52.0,46.0,53.1,Matches,329.0,es ESP,DF,31.0,24.0,1427.0,1187.0,234.0,34.0,1.0,10.0,67.0,200.0,0.0,0.0,0.0,0.0,1094.0,6.0,29.0,Matches,329.0,es ESP,DF,31.0,24.0,1094.0,1427.0,76.7,18160.0,7399.0,521.0,578.0,90.1,467.0,588.0,79.4,78.0,173.0,45.1,1.0,2.6,2.6,-1.6,20.0,89.0,23.0,11.0,93.0,Matches,403,es ESP,DF,31,26,2163.0,83.0,63.2,24.0,26,83.0,17,0,,7,1.12,27.0,34.0,-7.0,-0.29,-0.08,28.5,28.0,0.5,0.02,0.26,Matches,329.0,es ESP,DF,31.0,24.0,1694.0,90.0,549.0,744.0,415.0,51.0,1694.0,17.0,5.0,29.4,9.0,52.9,853.0,3500.0,1784.0,27.0,22.0,2.0,19.0,7.0,999.0,108.0,Matches,329.0,es ESP,DF,31.0,24.0,0.0,19.0,7.0,36.8,0.79,0.29,0.0,0.0,13.0,0.0,0.0,0.0,1.4,1.4,0.07,-1.4,-1.4,Matches,329.0,es ESP,DF,31.0,26.0,26.0,2163.0,24.0,0.0,1.0,1.0,0.0,0.0,0.0,6.0,1.0,1.4,1.4,2.6,3.9,27.0,93.0,108.0,0.0,0.04,0.04,0.0,0.04,0.06,0.11,0.16,0.06,0.16,Matches,Hugo Mallo,D/WB RC,31,143,152,Spain,Vigo,4,13,11,11,12,7,10,6,14,13,12,9,15,12,15,14,16,14,16,10,13,15,7,14,13,15,15,16,14,13,12,11,13,14,15,13,13,13,13,7,8,1,3,2,1,1,2,1,1,1,3,3,13,13,3,15,11,11,8,6,1,9,16,20,6,18,1,1,1,8,1,1,1,1,173,69,12,20,9973138,7150,7150,5200,Mediterranean_Hispanic,143,5,1991/6/22,0,0,49863.0,,67086276
706,Giorgi Mamardashvili,Valencia,2000,331.0,ge GEO,GK,21.0,38.0,0.0,0.0,0.0,0.0,0.0,0.0,0.0,,0.0,0.0,0.0,0.0,1.0,1.0,11.0,4.0,Matches,331.0,ge GEO,GK,21.0,38.0,4.0,0.11,1.0,3.0,0.0,0.0,0.0,0.0,1.0,0.03,0.0,1.0,0.0,0.0,0.0,0.0,Matches,26.0,ge GEO,GK,21.0,38.0,45.0,2.0,0.0,7.0,2.0,42.9,0.28,-0.1,0.0,177.0,522.0,33.9,843.0,142.0,40.8,35.1,239.0,74.5,54.2,457.0,35.0,7.7,47.0,1.24,16.3,Matches,26.0,ge GEO,GK,21.0,38.0,38.0,3420.0,38.0,45.0,1.18,148.0,105.0,70.9,11.0,9.0,18.0,7.0,18.4,5.0,2.0,0.0,3.0,0.0,Matches,331.0,ge GEO,GK,21.0,38.0,3.0,0.0,0.0,1.0,3.0,0.0,0.0,1.0,0.0,0.0,1.0,0.0,61.0,8.0,1.0,88.9,Matches,331.0,ge GEO,GK,21.0,38.0,1086.0,740.0,342.0,103.0,0.0,3.0,0.0,0.0,0.0,0.0,0.0,0.0,697.0,4.0,1.0,Matches,331.0,ge GEO,GK,21.0,38.0,697.0,1086.0,64.2,20406.0,15742.0,144.0,144.0,100.0,310.0,318.0,97.5,237.0,613.0,38.7,0.0,0.0,0.0,0.0,0.0,17.0,0.0,0.0,2.0,Matches,405,ge GEO,GK,21,38,3420.0,90.0,100.0,38.0,38,90.0,38,0,,0,1.11,42.0,45.0,-3.0,-0.08,,49.3,43.5,5.8,0.15,,Matches,331.0,ge GEO,GK,21.0,38.0,1180.0,973.0,1153.0,30.0,0.0,0.0,1180.0,0.0,0.0,,0.0,,604.0,3176.0,1830.0,0.0,0.0,0.0,2.0,1.0,470.0,0.0,Matches,331.0,ge GEO,GK,21.0,38.0,0.0,0.0,0.0,,0.0,0.0,,,,0.0,0.0,0.0,0.0,0.0,,0.0,0.0,Matches,331.0,ge GEO,GK,21.0,38.0,38.0,3420.0,38.0,0.0,0.0,0.0,0.0,0.0,0.0,3.0,0.0,0.0,0.0,0.0,0.0,0.0,2.0,0.0,0.0,0.0,0.0,0.0,0.0,0.0,0.0,0.0,0.0,0.0,Matches,Giorgi Mamardashvili,GK,21,138,156,Georgia,Valencia,4,1,1,3,9,6,2,2,2,3,14,4,3,9,11,12,14,11,13,12,10,14,2,3,2,12,13,12,10,12,13,15,13,11,13,14,14,5,12,5,16,15,16,16,12,13,15,12,16,13,10,12,16,14,7,12,10,12,10,10,20,1,1,1,1,1,1,1,1,1,1,1,1,1,199,0,20,8,23467499,6750,6750,4750,Mediterranean_Hispanic,132,5,2000/9/29,3,0,3068.0,,59138294
707,Aïssa Mandi,Villarreal,1991,333.0,dz ALG,DF,30.0,16.2,18.0,10.0,14.0,3.0,1.0,6.0,12.0,50.0,6.0,19.0,14.0,5.0,21.0,39.0,58.0,0.0,Matches,333.0,dz ALG,DF,30.0,16.2,9.0,0.55,8.0,1.0,0.0,0.0,0.0,0.0,2.0,0.12,2.0,0.0,0.0,0.0,0.0,0.0,Matches,,,,,,,,,,,,,,,,,,,,,,,,,,,,,,,,,,,,,,,,,,,,,,,,,,,,,,,,333.0,dz ALG,DF,30.0,16.2,1.0,0.0,0.0,16.0,10.0,4.0,2.0,21.0,10.0,0.0,0.0,0.0,62.0,20.0,19.0,51.3,Matches,333.0,dz ALG,DF,30.0,16.2,911.0,857.0,52.0,24.0,1.0,12.0,2.0,24.0,0.0,0.0,0.0,0.0,826.0,2.0,4.0,Matches,333.0,dz ALG,DF,30.0,16.2,826.0,911.0,90.7,16064.0,5793.0,288.0,303.0,95.0,427.0,462.0,92.4,98.0,120.0,81.7,0.0,0.3,0.4,-0.3,4.0,30.0,3.0,0.0,36.0,Matches,407,dz ALG,DF,30,21,1461.0,70.0,42.7,16.2,16,86.0,13,5,16.0,17,1.95,34.0,17.0,17.0,1.05,0.96,31.8,23.6,8.2,0.51,0.35,Matches,333.0,dz ALG,DF,30.0,16.2,1051.0,143.0,573.0,429.0,51.0,6.0,1051.0,3.0,1.0,33.3,1.0,33.3,614.0,2874.0,1516.0,7.0,7.0,0.0,3.0,2.0,726.0,9.0,Matches,333.0,dz ALG,DF,30.0,16.2,0.0,2.0,2.0,100.0,0.12,0.12,0.0,0.0,19.9,0.0,0.0,0.0,0.1,0.1,0.05,-0.1,-0.1,Matches,333.0,dz ALG,DF,30.0,21.0,16.0,1461.0,16.2,0.0,0.0,0.0,0.0,0.0,0.0,1.0,0.0,0.1,0.1,0.3,0.4,7.0,36.0,9.0,0.0,0.0,0.0,0.0,0.0,0.01,0.02,0.03,0.01,0.03,Matches,Aïssa Mandi,D RLC,30,139,148,"Algeria,France",Villarreal,6,15,11,5,12,6,14,5,12,15,14,6,15,12,15,15,16,12,13,13,12,16,7,12,12,14,14,14,13,13,14,13,15,14,13,14,13,13,14,8,15,1,2,1,1,1,3,3,2,2,3,3,16,13,7,16,13,15,14,14,1,15,20,16,10,13,1,1,1,1,1,1,1,1,184,78,9,20,11709349,6950,7200,6000,North_African__Middle_Eastern,139,11,1991/10/22,76,3,22256.0,,85079680
708,Agustín Marchesín,Celta Vigo,1988,335.0,ar ARG,GK,34.0,19.0,0.0,0.0,0.0,0.0,0.0,0.0,1.0,0.0,1.0,0.0,0.0,0.0,0.0,0.0,7.0,0.0,Matches,335.0,ar ARG,GK,34.0,19.0,2.0,0.11,2.0,0.0,0.0,0.0,0.0,0.0,0.0,0.0,0.0,0.0,0.0,0.0,0.0,0.0,Matches,27.0,ar ARG,GK,34.0,19.0,29.0,2.0,1.0,4.0,1.0,20.7,0.24,-7.3,-0.38,103.0,267.0,38.6,500.0,75.0,39.8,35.3,131.0,51.9,42.9,253.0,14.0,5.5,25.0,1.32,18.1,Matches,27.0,ar ARG,GK,34.0,19.0,19.0,1710.0,19.0,29.0,1.53,72.0,42.0,62.5,5.0,5.0,9.0,6.0,31.6,4.0,2.0,2.0,0.0,50.0,Matches,335.0,ar ARG,GK,34.0,19.0,2.0,0.0,0.0,0.0,4.0,0.0,0.0,0.0,0.0,0.0,0.0,0.0,22.0,3.0,0.0,100.0,Matches,335.0,ar ARG,GK,34.0,19.0,635.0,447.0,184.0,53.0,0.0,1.0,0.0,0.0,0.0,0.0,0.0,0.0,449.0,4.0,0.0,Matches,335.0,ar ARG,GK,34.0,19.0,449.0,635.0,70.7,12898.0,9202.0,81.0,81.0,100.0,206.0,212.0,97.2,161.0,337.0,47.8,0.0,0.0,0.0,0.0,0.0,6.0,0.0,0.0,1.0,Matches,409,ar ARG,GK,34,19,1710.0,90.0,50.0,19.0,19,90.0,19,0,,0,1.05,18.0,29.0,-11.0,-0.58,-0.63,21.2,19.7,1.6,0.08,0.31,Matches,335.0,ar ARG,GK,34.0,19.0,677.0,550.0,673.0,6.0,0.0,0.0,677.0,0.0,0.0,,0.0,,392.0,1729.0,1123.0,0.0,0.0,0.0,0.0,0.0,325.0,0.0,Matches,335.0,ar ARG,GK,34.0,19.0,0.0,0.0,0.0,,0.0,0.0,,,,0.0,0.0,0.0,0.0,0.0,,0.0,0.0,Matches,335.0,ar ARG,GK,34.0,19.0,19.0,1710.0,19.0,0.0,0.0,0.0,0.0,0.0,0.0,2.0,0.0,0.0,0.0,0.0,0.0,0.0,1.0,0.0,0.0,0.0,0.0,0.0,0.0,0.0,0.0,0.0,0.0,0.0,Matches,Agustín Marchesín,GK,34,140,152,"Argentina,Italy",Vigo,7,2,1,3,8,9,8,1,1,3,12,5,1,8,12,12,14,12,14,11,14,15,7,11,2,15,13,13,10,12,14,14,13,11,12,13,15,9,14,11,13,14,12,13,9,13,14,15,17,13,11,14,15,12,12,16,13,15,8,12,20,1,1,1,1,1,1,1,1,1,1,1,1,1,188,83,7,20,347975206,7000,7000,5250,Mediterranean_Hispanic,140,8,1988/3/16,8,0,20593.0,,965309
709,Iván Martín,Girona,1999,348.0,es ESP,MF,23.0,17.6,9.0,7.0,4.0,4.0,1.0,8.0,23.0,34.8,15.0,12.0,0.0,12.0,9.0,18.0,12.0,0.0,Matches,348.0,es ESP,MF,23.0,17.6,34.0,1.93,30.0,0.0,1.0,1.0,2.0,0.0,6.0,0.34,4.0,0.0,0.0,0.0,2.0,0.0,Matches,,,,,,,,,,,,,,,,,,,,,,,,,,,,,,,,,,,,,,,,,,,,,,,,,,,,,,,,348.0,es ESP,MF,23.0,17.6,2.0,0.0,0.0,18.0,13.0,3.0,18.0,9.0,7.0,1.0,0.0,0.0,81.0,12.0,16.0,42.9,Matches,348.0,es ESP,MF,23.0,17.6,672.0,648.0,23.0,8.0,0.0,2.0,18.0,7.0,0.0,0.0,0.0,0.0,565.0,1.0,18.0,Matches,348.0,es ESP,MF,23.0,17.6,565.0,672.0,84.1,8006.0,1764.0,331.0,366.0,90.4,180.0,212.0,84.9,29.0,40.0,72.5,3.0,2.2,2.1,0.8,17.0,38.0,17.0,6.0,56.0,Matches,425,es ESP,MF,23,24,1586.0,66.0,46.4,17.6,18,79.0,5,6,27.0,7,1.63,27.0,25.0,2.0,0.11,0.06,23.1,26.3,-3.2,-0.18,-0.13,Matches,348.0,es ESP,MF,23.0,17.6,822.0,23.0,132.0,425.0,274.0,36.0,822.0,48.0,26.0,54.2,18.0,37.5,540.0,3377.0,1213.0,30.0,19.0,6.0,32.0,37.0,631.0,82.0,Matches,348.0,es ESP,MF,23.0,17.6,3.0,18.0,8.0,44.4,1.02,0.45,0.17,0.38,15.7,0.0,0.0,0.0,2.4,2.4,0.13,0.6,0.6,Matches,348.0,es ESP,MF,23.0,24.0,18.0,1586.0,17.6,3.0,3.0,6.0,3.0,0.0,0.0,2.0,0.0,2.4,2.4,2.2,4.7,30.0,56.0,82.0,0.17,0.17,0.34,0.17,0.34,0.14,0.13,0.27,0.14,0.27,Matches,Iván Martín,M/AM RLC,23,126,144,"Spain,Pays Basque",Villarreal,12,14,15,12,14,12,10,10,8,11,12,12,12,15,10,12,13,12,11,14,13,16,12,11,12,13,8,13,13,12,11,9,12,13,12,12,20,11,9,9,15,3,3,2,1,2,2,2,1,2,1,2,7,11,2,12,10,13,11,19,1,1,1,1,1,1,1,13,19,10,18,20,15,1,178,0,20,8,4372600,6300,6300,3900,Mediterranean_Hispanic,123,5,1999/2/14,0,0,8741.0,Girona,67258832
710,Omar Mascarell,Elche,1993,352.0,gq EQG,MFDF,29.0,27.2,53.0,26.0,32.0,19.0,2.0,31.0,64.0,48.4,33.0,51.0,19.0,32.0,45.0,98.0,54.0,1.0,Matches,352.0,gq EQG,MFDF,29.0,27.2,42.0,1.54,30.0,11.0,1.0,0.0,0.0,0.0,3.0,0.11,1.0,2.0,0.0,0.0,0.0,0.0,Matches,,,,,,,,,,,,,,,,,,,,,,,,,,,,,,,,,,,,,,,,,,,,,,,,,,,,,,,,352.0,gq EQG,MFDF,29.0,27.2,6.0,0.0,0.0,21.0,17.0,0.0,22.0,45.0,26.0,0.0,0.0,0.0,157.0,27.0,21.0,56.3,Matches,352.0,gq EQG,MFDF,29.0,27.2,1270.0,1183.0,83.0,56.0,0.0,20.0,22.0,4.0,19.0,1.0,9.0,3.0,1091.0,4.0,11.0,Matches,352.0,gq EQG,MFDF,29.0,27.2,1091.0,1270.0,85.9,20666.0,6208.0,429.0,469.0,91.5,513.0,560.0,91.6,132.0,201.0,65.7,1.0,1.1,1.2,-0.1,20.0,101.0,4.0,1.0,116.0,Matches,431,gq EQG,MFDF,29,28,2447.0,87.0,71.5,27.2,28,87.0,25,0,,0,0.46,18.0,52.0,-34.0,-1.25,-0.97,24.7,47.4,-22.7,-0.84,0.08,Matches,352.0,gq EQG,MFDF,29.0,27.2,1539.0,112.0,519.0,882.0,150.0,5.0,1539.0,33.0,21.0,63.6,10.0,30.3,839.0,5302.0,2337.0,27.0,21.0,1.0,14.0,11.0,929.0,6.0,Matches,352.0,gq EQG,MFDF,29.0,27.2,0.0,9.0,3.0,33.3,0.33,0.11,0.0,0.0,22.1,1.0,0.0,0.0,0.4,0.4,0.05,-0.4,-0.4,Matches,352.0,gq EQG,MFDF,29.0,28.0,28.0,2447.0,27.2,0.0,1.0,1.0,0.0,0.0,0.0,6.0,0.0,0.4,0.4,1.1,1.5,27.0,116.0,6.0,0.0,0.04,0.04,0.0,0.04,0.02,0.04,0.05,0.02,0.05,Matches,Omar Mascarell,DM/M C,29,133,138,"Spain,Equatorial Guinea",Elche,12,11,11,8,13,10,6,10,8,12,14,13,13,15,10,15,15,15,12,12,15,17,9,15,10,14,16,14,9,13,15,9,13,11,16,13,13,14,13,12,8,1,3,3,3,3,2,2,3,2,1,1,12,16,9,12,14,14,8,11,1,1,1,1,1,1,20,1,20,1,1,12,1,1,181,76,8,20,4135917,6500,6500,4500,North_African__Middle_Eastern,131,8,1993/2/2,0,0,28766.0,,67153634
711,Jordi Masip,Valladolid,1989,353.0,es ESP,GK,33.0,27.9,0.0,0.0,0.0,0.0,0.0,0.0,2.0,0.0,2.0,0.0,0.0,0.0,1.0,1.0,3.0,2.0,Matches,353.0,es ESP,GK,33.0,27.9,4.0,0.14,2.0,2.0,0.0,0.0,0.0,0.0,1.0,0.04,0.0,1.0,0.0,0.0,0.0,0.0,Matches,29.0,es ESP,GK,33.0,27.9,42.0,5.0,0.0,0.0,1.0,45.8,0.27,4.8,0.17,133.0,389.0,34.2,722.0,121.0,36.8,35.9,239.0,51.5,41.9,396.0,15.0,3.8,14.0,0.5,12.7,Matches,29.0,es ESP,GK,33.0,28.0,28.0,2507.0,27.9,42.0,1.51,145.0,101.0,74.5,9.0,5.0,14.0,8.0,28.6,9.0,5.0,3.0,1.0,37.5,Matches,353.0,es ESP,GK,33.0,27.9,4.0,0.0,0.0,0.0,5.0,0.0,0.0,1.0,0.0,0.0,0.0,0.0,31.0,6.0,2.0,75.0,Matches,353.0,es ESP,GK,33.0,27.9,963.0,645.0,316.0,77.0,0.0,1.0,0.0,0.0,0.0,0.0,0.0,0.0,679.0,2.0,1.0,Matches,353.0,es ESP,GK,33.0,27.9,679.0,963.0,70.5,19683.0,14573.0,93.0,93.0,100.0,345.0,348.0,99.1,233.0,511.0,45.6,0.0,0.0,0.0,0.0,0.0,15.0,0.0,0.0,0.0,Matches,432,es ESP,GK,33,28,2507.0,90.0,73.3,27.9,28,90.0,27,0,,6,1.14,26.0,42.0,-16.0,-0.57,0.81,29.5,46.6,-17.1,-0.61,0.33,Matches,353.0,es ESP,GK,33.0,27.9,1025.0,947.0,1025.0,0.0,0.0,0.0,1025.0,0.0,0.0,,0.0,,539.0,2791.0,1785.0,0.0,0.0,0.0,0.0,0.0,427.0,0.0,Matches,353.0,es ESP,GK,33.0,27.9,0.0,0.0,0.0,,0.0,0.0,,,,0.0,0.0,0.0,0.0,0.0,,0.0,0.0,Matches,353.0,es ESP,GK,33.0,28.0,28.0,2507.0,27.9,0.0,0.0,0.0,0.0,0.0,0.0,4.0,0.0,0.0,0.0,0.0,0.0,0.0,0.0,0.0,0.0,0.0,0.0,0.0,0.0,0.0,0.0,0.0,0.0,0.0,Matches,Jordi Masip,GK,33,133,140,Spain,Valladolid,2,3,3,2,14,4,6,1,3,2,14,5,2,13,6,13,11,15,13,11,13,15,8,9,2,10,14,13,12,15,12,10,12,11,12,9,14,9,14,9,1,13,13,12,11,14,11,13,16,15,7,12,8,9,6,11,12,10,11,16,20,1,1,1,1,1,1,1,1,1,1,1,1,1,179,72,11,20,2704381,6600,6600,5000,Mediterranean_Hispanic,132,6,1989/1/3,0,0,5832.0,,67038645
712,Borja Mayoral,Getafe,1997,355.0,es ESP,FW,25.0,30.7,9.0,4.0,7.0,2.0,0.0,5.0,31.0,16.1,26.0,18.0,0.0,18.0,3.0,12.0,10.0,0.0,Matches,355.0,es ESP,FW,25.0,30.7,58.0,1.89,43.0,0.0,4.0,4.0,7.0,0.0,3.0,0.1,2.0,0.0,1.0,0.0,0.0,0.0,Matches,,,,,,,,,,,,,,,,,,,,,,,,,,,,,,,,,,,,,,,,,,,,,,,,,,,,,,,,355.0,es ESP,FW,25.0,30.7,4.0,0.0,0.0,16.0,38.0,11.0,37.0,3.0,4.0,1.0,0.0,0.0,105.0,36.0,84.0,30.0,Matches,355.0,es ESP,FW,25.0,30.7,775.0,737.0,37.0,0.0,2.0,11.0,37.0,3.0,1.0,0.0,0.0,0.0,582.0,1.0,31.0,Matches,355.0,es ESP,FW,25.0,30.7,582.0,775.0,75.1,8629.0,1623.0,332.0,397.0,83.6,161.0,211.0,76.3,51.0,71.0,71.8,2.0,2.7,3.4,-0.7,22.0,35.0,21.0,4.0,64.0,Matches,435,es ESP,FW,25,35,2759.0,79.0,80.7,30.7,33,82.0,14,2,19.0,3,1.0,26.0,40.0,-14.0,-0.46,-0.87,27.0,36.5,-9.5,-0.31,-0.33,Matches,355.0,es ESP,FW,25.0,30.7,1040.0,15.0,106.0,495.0,449.0,118.0,1038.0,70.0,27.0,38.6,35.0,50.0,639.0,3327.0,1531.0,58.0,35.0,25.0,63.0,54.0,763.0,166.0,Matches,355.0,es ESP,FW,25.0,30.7,8.0,50.0,19.0,38.0,1.63,0.62,0.16,0.42,14.6,0.0,0.0,2.0,7.9,6.3,0.13,0.1,1.7,Matches,355.0,es ESP,FW,25.0,35.0,33.0,2759.0,30.7,8.0,2.0,10.0,8.0,0.0,2.0,4.0,0.0,7.9,6.3,2.7,9.0,58.0,64.0,166.0,0.26,0.07,0.33,0.26,0.33,0.26,0.09,0.35,0.2,0.29,Matches,Borja Mayoral,S,25,134,145,Spain,Getafe,6,10,13,16,15,8,12,12,4,5,12,14,6,14,16,15,14,13,14,12,13,16,13,6,16,5,12,13,12,12,14,11,14,13,13,13,14,9,11,6,8,3,2,1,1,2,1,2,3,2,1,2,10,16,7,12,13,14,12,15,1,1,1,1,1,1,1,9,1,7,11,11,12,20,182,74,12,20,6332507,6700,6700,5750,Mediterranean_Hispanic,133,6,1997/4/5,0,0,14096.0,,67211912
713,Gonzalo Melero,Almería,1994,358.0,es ESP,MF,28.0,20.6,32.0,16.0,9.0,18.0,5.0,11.0,39.0,28.2,28.0,23.0,2.0,21.0,7.0,39.0,19.0,1.0,Matches,358.0,es ESP,MF,28.0,20.6,53.0,2.57,45.0,1.0,1.0,5.0,1.0,0.0,6.0,0.29,5.0,0.0,0.0,1.0,0.0,0.0,Matches,,,,,,,,,,,,,,,,,,,,,,,,,,,,,,,,,,,,,,,,,,,,,,,,,,,,,,,,358.0,es ESP,MF,28.0,20.6,5.0,0.0,0.0,24.0,30.0,3.0,2.0,7.0,16.0,0.0,0.0,0.0,96.0,14.0,17.0,45.2,Matches,358.0,es ESP,MF,28.0,20.6,755.0,736.0,17.0,9.0,1.0,4.0,2.0,3.0,0.0,0.0,0.0,0.0,652.0,2.0,15.0,Matches,358.0,es ESP,MF,28.0,20.6,652.0,755.0,86.4,10427.0,2627.0,329.0,365.0,90.1,243.0,276.0,88.0,52.0,63.0,82.5,3.0,1.8,1.3,1.2,19.0,72.0,13.0,0.0,97.0,Matches,438,es ESP,MF,28,27,1855.0,69.0,54.2,20.6,24,74.0,1,3,30.0,2,1.26,34.0,28.0,6.0,0.29,1.56,26.6,29.5,-2.9,-0.14,0.68,Matches,358.0,es ESP,MF,28.0,20.6,943.0,44.0,204.0,526.0,221.0,35.0,942.0,36.0,17.0,47.2,18.0,50.0,573.0,2999.0,1408.0,31.0,28.0,4.0,37.0,19.0,672.0,37.0,Matches,358.0,es ESP,MF,28.0,20.6,4.0,23.0,10.0,43.5,1.12,0.49,0.13,0.3,17.2,0.0,1.0,1.0,3.0,2.3,0.1,1.0,0.7,Matches,358.0,es ESP,MF,28.0,27.0,24.0,1855.0,20.6,4.0,3.0,7.0,3.0,1.0,1.0,5.0,0.0,3.0,2.3,1.8,4.0,31.0,97.0,37.0,0.19,0.15,0.34,0.15,0.29,0.15,0.08,0.23,0.11,0.19,Matches,Gonzalo Melero,M/AM C,28,132,142,Spain,Almería,9,10,12,12,13,11,14,13,7,11,13,13,12,13,14,13,14,13,13,14,13,14,13,11,15,12,14,14,13,12,14,12,14,12,14,12,13,9,13,10,11,1,1,3,2,3,1,1,3,2,2,2,12,14,9,13,14,14,14,12,1,1,1,1,1,1,15,8,20,12,5,16,8,1,183,79,10,20,11166979,6700,6700,4300,Mediterranean_Hispanic,132,4,1994/1/2,0,0,9588.0,,67011235
714,Brais Méndez,Real Sociedad,1997,362.0,es ESP,MF,25.0,26.7,58.0,34.0,18.0,30.0,10.0,24.0,64.0,37.5,40.0,27.0,3.0,24.0,12.0,70.0,14.0,1.0,Matches,362.0,es ESP,MF,25.0,26.7,98.0,3.67,54.0,30.0,6.0,3.0,5.0,0.0,11.0,0.41,6.0,2.0,1.0,2.0,0.0,0.0,Matches,,,,,,,,,,,,,,,,,,,,,,,,,,,,,,,,,,,,,,,,,,,,,,,,,,,,,,,,362.0,es ESP,MF,25.0,26.7,6.0,0.0,0.0,60.0,54.0,2.0,125.0,12.0,34.0,0.0,0.0,0.0,127.0,25.0,29.0,46.3,Matches,362.0,es ESP,MF,25.0,26.7,1312.0,1138.0,169.0,53.0,7.0,15.0,125.0,6.0,103.0,32.0,49.0,0.0,1010.0,5.0,25.0,Matches,362.0,es ESP,MF,25.0,26.7,1010.0,1312.0,77.0,16082.0,4201.0,546.0,618.0,88.3,303.0,383.0,79.1,110.0,206.0,53.4,4.0,3.7,4.8,0.3,48.0,92.0,29.0,3.0,137.0,Matches,442,es ESP,MF,25,34,2407.0,71.0,70.4,26.7,28,78.0,12,6,36.0,1,1.79,40.0,25.0,15.0,0.56,0.47,36.4,21.4,15.0,0.56,0.14,Matches,362.0,es ESP,MF,25.0,26.7,1608.0,25.0,170.0,776.0,675.0,60.0,1608.0,53.0,15.0,28.3,34.0,64.2,886.0,3755.0,1653.0,41.0,44.0,5.0,49.0,29.0,1093.0,138.0,Matches,362.0,es ESP,MF,25.0,26.7,8.0,60.0,21.0,35.0,2.24,0.79,0.13,0.38,21.4,9.0,0.0,0.0,5.6,5.6,0.09,2.4,2.4,Matches,362.0,es ESP,MF,25.0,34.0,28.0,2407.0,26.7,8.0,4.0,12.0,8.0,0.0,0.0,6.0,0.0,5.6,5.6,3.7,9.3,41.0,137.0,138.0,0.3,0.15,0.45,0.3,0.45,0.21,0.14,0.35,0.21,0.35,Matches,Brais Méndez,AM RC,25,148,155,Spain,Real San Sebastián,15,15,13,15,16,13,10,13,10,6,15,11,10,15,9,15,10,16,15,15,15,7,14,11,15,11,16,15,13,15,10,12,13,13,14,11,13,3,12,7,14,2,1,3,2,2,3,3,4,2,3,2,8,12,1,11,13,13,10,11,1,1,1,1,1,1,1,1,15,12,1,18,20,1,187,76,20,9,28370924,7400,7400,3500,Mediterranean_Hispanic,149,4,1997/1/7,4,1,38407.0,,67199158
715,Ferland Mendy,Real Madrid,1995,364.0,fr FRA,DF,27.0,15.0,21.0,12.0,14.0,6.0,1.0,12.0,20.0,60.0,8.0,7.0,2.0,5.0,14.0,35.0,16.0,0.0,Matches,364.0,fr FRA,DF,27.0,15.0,28.0,1.87,25.0,1.0,1.0,0.0,0.0,1.0,2.0,0.13,2.0,0.0,0.0,0.0,0.0,0.0,Matches,,,,,,,,,,,,,,,,,,,,,,,,,,,,,,,,,,,,,,,,,,,,,,,,,,,,,,,,364.0,fr FRA,DF,27.0,15.0,2.0,0.0,0.0,4.0,18.0,0.0,7.0,14.0,12.0,0.0,0.0,0.0,77.0,7.0,8.0,46.7,Matches,364.0,fr FRA,DF,27.0,15.0,862.0,759.0,101.0,20.0,0.0,3.0,7.0,81.0,0.0,0.0,0.0,0.0,794.0,2.0,8.0,Matches,364.0,fr FRA,DF,27.0,15.0,794.0,862.0,92.1,10969.0,2745.0,507.0,532.0,95.3,223.0,246.0,90.7,34.0,38.0,89.5,1.0,0.6,0.6,0.4,13.0,54.0,9.0,0.0,56.0,Matches,445,fr FRA,DF,27,18,1351.0,75.0,39.5,15.0,17,78.0,6,1,29.0,5,2.11,26.0,17.0,9.0,0.6,-0.71,26.7,17.0,9.6,0.64,-0.53,Matches,364.0,fr FRA,DF,27.0,15.0,971.0,42.0,265.0,426.0,287.0,8.0,971.0,29.0,19.0,65.5,8.0,27.6,591.0,3059.0,1427.0,23.0,25.0,2.0,20.0,17.0,697.0,73.0,Matches,364.0,fr FRA,DF,27.0,15.0,0.0,1.0,0.0,0.0,0.07,0.0,0.0,,7.3,0.0,0.0,0.0,0.3,0.3,0.26,-0.3,-0.3,Matches,364.0,fr FRA,DF,27.0,18.0,17.0,1351.0,15.0,0.0,1.0,1.0,0.0,0.0,0.0,2.0,0.0,0.3,0.3,0.6,0.9,23.0,56.0,73.0,0.0,0.07,0.07,0.0,0.07,0.02,0.04,0.06,0.02,0.06,Matches,Ferland Mendy,D/WB L,27,156,160,"France,Senegal,Guinea-Bissau",R. Madrid,5,13,13,7,14,5,9,11,13,13,12,7,12,13,14,15,17,13,12,11,11,15,13,6,13,13,15,17,17,15,16,11,15,16,16,16,13,8,13,7,15,1,1,3,3,1,1,1,2,1,3,1,12,16,9,12,12,14,10,12,1,20,12,12,19,9,1,1,1,1,1,1,1,1,180,73,20,14,51637502,7800,7500,7250,African_Caribbean,149,16,1995/6/8,7,0,178081.0,,85133751
716,Mikel Merino,Real Sociedad,1996,366.0,es ESP,MF,26.0,27.7,77.0,49.0,28.0,33.0,16.0,31.0,62.0,50.0,31.0,38.0,8.0,30.0,20.0,97.0,51.0,1.0,Matches,366.0,es ESP,MF,26.0,27.7,93.0,3.36,81.0,1.0,1.0,3.0,2.0,5.0,13.0,0.47,11.0,0.0,0.0,1.0,0.0,1.0,Matches,,,,,,,,,,,,,,,,,,,,,,,,,,,,,,,,,,,,,,,,,,,,,,,,,,,,,,,,366.0,es ESP,MF,26.0,27.7,5.0,1.0,0.0,74.0,48.0,4.0,25.0,20.0,49.0,0.0,0.0,0.0,218.0,112.0,59.0,65.5,Matches,366.0,es ESP,MF,26.0,27.7,1502.0,1466.0,25.0,21.0,11.0,15.0,25.0,3.0,1.0,0.0,0.0,0.0,1145.0,11.0,32.0,Matches,366.0,es ESP,MF,26.0,27.7,1145.0,1502.0,76.2,18019.0,6014.0,607.0,715.0,84.9,408.0,517.0,78.9,83.0,161.0,51.6,9.0,5.7,5.0,3.3,44.0,154.0,36.0,5.0,172.0,Matches,447,es ESP,MF,26,33,2494.0,76.0,72.9,27.7,28,84.0,18,5,30.0,0,1.85,37.0,31.0,6.0,0.22,-0.76,39.0,26.0,13.0,0.47,-0.19,Matches,366.0,es ESP,MF,26.0,27.7,1861.0,86.0,356.0,1024.0,496.0,79.0,1860.0,42.0,22.0,52.4,16.0,38.1,1020.0,3933.0,1763.0,30.0,42.0,4.0,48.0,37.0,1263.0,107.0,Matches,366.0,es ESP,MF,26.0,27.7,2.0,41.0,16.0,39.0,1.48,0.58,0.05,0.13,18.1,0.0,0.0,1.0,4.4,3.6,0.09,-2.4,-1.6,Matches,366.0,es ESP,MF,26.0,33.0,28.0,2494.0,27.7,2.0,9.0,11.0,2.0,0.0,1.0,5.0,1.0,4.4,3.6,5.7,9.3,30.0,172.0,107.0,0.07,0.32,0.4,0.07,0.4,0.16,0.2,0.36,0.13,0.34,Matches,Mikel Merino,M C,26,153,159,"Spain,Pays Basque",Real San Sebastián,8,11,14,10,14,10,14,12,8,14,16,10,13,15,15,13,15,13,15,16,14,16,13,12,14,14,15,15,12,13,13,14,16,13,17,16,14,9,15,9,15,3,2,2,3,1,1,1,2,1,3,2,11,17,9,12,14,15,12,10,1,1,12,1,1,1,14,8,20,1,8,14,1,1,187,79,20,10,32062500,7650,7650,5500,Mediterranean_Hispanic,152,6,1996/6/22,11,0,47794.0,,67211760
717,Roque Mesa,Valladolid,1989,367.0,es ESP,MF,33.0,18.0,27.0,15.0,16.0,10.0,1.0,12.0,38.0,31.6,26.0,16.0,4.0,12.0,13.0,40.0,18.0,0.0,Matches,367.0,es ESP,MF,33.0,18.0,40.0,2.23,37.0,1.0,0.0,1.0,0.0,1.0,1.0,0.06,1.0,0.0,0.0,0.0,0.0,0.0,Matches,,,,,,,,,,,,,,,,,,,,,,,,,,,,,,,,,,,,,,,,,,,,,,,,,,,,,,,,367.0,es ESP,MF,33.0,18.0,11.0,1.0,1.0,38.0,25.0,1.0,12.0,13.0,15.0,0.0,1.0,0.0,145.0,11.0,23.0,32.4,Matches,367.0,es ESP,MF,33.0,18.0,963.0,900.0,55.0,52.0,4.0,21.0,12.0,0.0,1.0,0.0,0.0,0.0,790.0,8.0,14.0,Matches,367.0,es ESP,MF,33.0,18.0,790.0,963.0,82.0,15512.0,4724.0,301.0,343.0,87.8,342.0,382.0,89.5,121.0,187.0,64.7,1.0,1.0,1.2,0.0,18.0,106.0,18.0,4.0,116.0,Matches,448,es ESP,MF,33,29,1617.0,56.0,47.3,18.0,20,69.0,3,9,26.0,6,1.13,15.0,25.0,-10.0,-0.56,0.44,16.6,28.7,-12.1,-0.67,0.05,Matches,367.0,es ESP,MF,33.0,18.0,1134.0,62.0,286.0,683.0,181.0,9.0,1134.0,31.0,15.0,48.4,14.0,45.2,748.0,4717.0,2201.0,29.0,23.0,3.0,21.0,21.0,772.0,24.0,Matches,367.0,es ESP,MF,33.0,18.0,2.0,26.0,10.0,38.5,1.45,0.56,0.08,0.2,26.5,0.0,0.0,0.0,1.4,1.4,0.05,0.6,0.6,Matches,367.0,es ESP,MF,33.0,29.0,20.0,1617.0,18.0,2.0,1.0,3.0,2.0,0.0,0.0,11.0,1.0,1.4,1.4,1.0,2.4,29.0,116.0,24.0,0.11,0.06,0.17,0.11,0.17,0.08,0.06,0.13,0.08,0.13,Matches,Roque Mesa,DM/M RC,33,132,144,Spain,Valladolid,12,13,12,8,13,9,5,11,11,12,14,12,13,14,14,15,15,13,14,13,13,16,13,14,13,13,15,16,12,12,15,6,13,12,14,11,13,10,13,5,18,2,1,3,1,2,4,3,1,2,3,1,12,15,7,16,13,16,14,11,1,1,1,1,1,1,18,1,20,15,1,14,10,1,171,72,10,20,1569308,6600,6600,5100,Mediterranean_Hispanic,131,6,1989/6/7,0,0,54999.0,,67148546
718,Éder Militão,Real Madrid,1998,368.0,br BRA,DF,24.0,30.0,46.0,32.0,25.0,18.0,3.0,26.0,33.0,78.8,7.0,67.0,39.0,28.0,42.0,88.0,104.0,2.0,Matches,368.0,br BRA,DF,24.0,30.0,22.0,0.73,19.0,2.0,0.0,0.0,1.0,0.0,4.0,0.13,3.0,0.0,0.0,0.0,1.0,0.0,Matches,,,,,,,,,,,,,,,,,,,,,,,,,,,,,,,,,,,,,,,,,,,,,,,,,,,,,,,,368.0,br BRA,DF,24.0,30.0,4.0,0.0,0.0,35.0,38.0,1.0,12.0,42.0,32.0,1.0,1.0,0.0,159.0,64.0,34.0,65.3,Matches,368.0,br BRA,DF,24.0,30.0,1881.0,1756.0,123.0,52.0,2.0,40.0,12.0,25.0,0.0,0.0,0.0,0.0,1660.0,2.0,20.0,Matches,368.0,br BRA,DF,24.0,30.0,1660.0,1881.0,88.3,31882.0,10563.0,648.0,691.0,93.8,794.0,862.0,92.1,188.0,273.0,68.9,0.0,0.6,0.8,-0.6,6.0,138.0,5.0,1.0,98.0,Matches,451,br BRA,DF,24,33,2703.0,82.0,79.0,30.0,30,88.0,28,3,22.0,2,2.0,60.0,29.0,31.0,1.03,0.03,60.7,33.0,27.6,0.92,-0.2,Matches,368.0,br BRA,DF,24.0,30.0,2216.0,314.0,1088.0,984.0,157.0,31.0,2216.0,19.0,11.0,57.9,6.0,31.6,1378.0,7011.0,3877.0,28.0,20.0,1.0,16.0,6.0,1505.0,16.0,Matches,368.0,br BRA,DF,24.0,30.0,5.0,22.0,8.0,36.4,0.73,0.27,0.23,0.63,13.8,0.0,0.0,0.0,2.4,2.4,0.11,2.6,2.6,Matches,368.0,br BRA,DF,24.0,33.0,30.0,2703.0,30.0,5.0,0.0,5.0,5.0,0.0,0.0,4.0,0.0,2.4,2.4,0.6,2.9,28.0,98.0,16.0,0.17,0.0,0.17,0.17,0.17,0.08,0.02,0.1,0.08,0.1,Matches,Éder Militão,D C,24,160,168,Brazil,R. Madrid,9,10,12,8,12,14,15,11,10,16,13,13,15,12,15,16,16,13,12,11,13,15,10,16,12,15,14,15,15,15,15,15,18,15,16,16,13,12,13,4,12,1,1,2,3,3,3,3,2,1,4,3,15,12,6,12,15,14,12,12,1,1,20,14,1,7,10,1,1,1,1,1,1,1,186,79,8,20,128638129,8000,8250,7000,African_Caribbean,161,17,1998/1/18,22,1,178081.0,,19273276
719,Luis Milla,Getafe,1994,369.0,es ESP,MF,27.0,20.6,48.0,30.0,21.0,18.0,9.0,19.0,44.0,43.2,25.0,13.0,1.0,12.0,32.0,80.0,25.0,1.0,Matches,369.0,es ESP,MF,27.0,20.6,47.0,2.28,22.0,20.0,1.0,0.0,3.0,1.0,3.0,0.15,2.0,1.0,0.0,0.0,0.0,0.0,Matches,,,,,,,,,,,,,,,,,,,,,,,,,,,,,,,,,,,,,,,,,,,,,,,,,,,,,,,,369.0,es ESP,MF,27.0,20.6,6.0,1.0,1.0,29.0,22.0,1.0,75.0,32.0,30.0,0.0,1.0,0.0,149.0,17.0,19.0,47.2,Matches,369.0,es ESP,MF,27.0,20.6,974.0,855.0,113.0,65.0,1.0,18.0,75.0,0.0,43.0,17.0,24.0,0.0,756.0,6.0,17.0,Matches,369.0,es ESP,MF,27.0,20.6,756.0,974.0,77.6,13767.0,4551.0,351.0,400.0,87.8,278.0,333.0,83.5,101.0,183.0,55.2,3.0,1.3,1.6,1.7,29.0,99.0,6.0,3.0,104.0,Matches,452,es ESP,MF,27,27,1856.0,69.0,54.3,20.6,22,79.0,12,5,23.0,3,1.15,15.0,21.0,-6.0,-0.29,0.0,14.0,23.2,-9.2,-0.44,-0.43,Matches,369.0,es ESP,MF,27.0,20.6,1132.0,43.0,238.0,704.0,202.0,5.0,1132.0,15.0,12.0,80.0,2.0,13.3,572.0,2604.0,1203.0,15.0,11.0,1.0,20.0,12.0,629.0,7.0,Matches,369.0,es ESP,MF,27.0,20.6,0.0,8.0,1.0,12.5,0.39,0.05,0.0,0.0,27.7,0.0,0.0,0.0,0.3,0.3,0.03,-0.3,-0.3,Matches,369.0,es ESP,MF,27.0,27.0,22.0,1856.0,20.6,0.0,3.0,3.0,0.0,0.0,0.0,6.0,1.0,0.3,0.3,1.3,1.5,15.0,104.0,7.0,0.0,0.15,0.15,0.0,0.15,0.01,0.06,0.07,0.01,0.07,Matches,Luis Milla,M C,27,134,144,Spain,Getafe,14,12,12,11,14,14,7,12,9,10,14,14,11,14,12,13,14,13,14,14,13,16,13,14,13,11,15,15,12,14,13,9,13,13,15,10,15,8,13,6,13,1,1,1,1,1,2,2,1,1,2,2,14,15,7,9,13,14,12,11,1,1,1,1,1,1,15,8,20,12,1,14,1,1,175,68,10,20,6617469,6700,6700,4500,Mediterranean_Hispanic,135,4,1994/10/7,0,0,14096.0,,67191561
720,Pere Milla,Elche,1992,370.0,es ESP,FWMF,29.0,20.5,31.0,20.0,18.0,8.0,5.0,14.0,41.0,34.1,27.0,18.0,3.0,15.0,9.0,40.0,19.0,1.0,Matches,370.0,es ESP,FWMF,29.0,20.5,43.0,2.07,27.0,0.0,3.0,4.0,8.0,1.0,3.0,0.14,2.0,0.0,0.0,0.0,1.0,0.0,Matches,,,,,,,,,,,,,,,,,,,,,,,,,,,,,,,,,,,,,,,,,,,,,,,,,,,,,,,,370.0,es ESP,FWMF,29.0,20.5,7.0,0.0,0.0,19.0,44.0,13.0,14.0,9.0,20.0,1.0,0.0,0.0,97.0,28.0,33.0,45.9,Matches,370.0,es ESP,FWMF,29.0,20.5,585.0,555.0,28.0,4.0,2.0,5.0,14.0,6.0,1.0,0.0,0.0,0.0,410.0,2.0,26.0,Matches,370.0,es ESP,FWMF,29.0,20.5,410.0,585.0,70.1,6190.0,1742.0,224.0,283.0,79.2,127.0,169.0,75.1,34.0,63.0,54.0,1.0,1.2,1.5,-0.2,14.0,53.0,10.0,2.0,65.0,Matches,453,es ESP,FWMF,29,31,1843.0,59.0,53.9,20.5,21,77.0,8,10,23.0,0,0.69,18.0,45.0,-27.0,-1.32,-0.75,21.0,36.6,-15.6,-0.75,0.23,Matches,370.0,es ESP,FWMF,29.0,20.5,822.0,28.0,148.0,445.0,245.0,59.0,819.0,44.0,17.0,38.6,23.0,52.3,482.0,2068.0,963.0,23.0,27.0,5.0,47.0,22.0,558.0,83.0,Matches,370.0,es ESP,FWMF,29.0,20.5,6.0,33.0,7.0,21.2,1.61,0.34,0.09,0.43,15.0,1.0,3.0,3.0,5.4,3.0,0.09,0.6,0.0,Matches,370.0,es ESP,FWMF,29.0,31.0,21.0,1843.0,20.5,6.0,1.0,7.0,3.0,3.0,3.0,7.0,0.0,5.4,3.0,1.2,4.2,23.0,65.0,83.0,0.29,0.05,0.34,0.15,0.2,0.26,0.06,0.32,0.15,0.2,Matches,Pere Milla,AM/S RLC,29,133,136,Spain,Elche,11,13,13,14,14,13,12,11,12,6,12,13,7,12,9,12,11,11,11,13,11,15,11,16,14,7,18,18,12,13,10,10,12,12,16,11,11,9,13,11,13,2,2,2,3,3,3,2,3,4,2,3,14,15,9,10,12,14,15,11,1,1,1,1,1,1,1,1,1,1,15,20,15,20,179,72,20,12,2638543,6250,6250,4750,Mediterranean_Hispanic,128,6,1992/9/23,0,0,6639.0,,67170824
721,Óscar Mingueza,Celta Vigo,1999,372.0,es ESP,DF,23.0,14.3,37.0,21.0,27.0,9.0,1.0,25.0,32.0,78.1,7.0,10.0,4.0,6.0,12.0,49.0,25.0,0.0,Matches,372.0,es ESP,DF,23.0,14.3,24.0,1.68,23.0,0.0,0.0,1.0,0.0,0.0,0.0,0.0,0.0,0.0,0.0,0.0,0.0,0.0,Matches,,,,,,,,,,,,,,,,,,,,,,,,,,,,,,,,,,,,,,,,,,,,,,,,,,,,,,,,372.0,es ESP,DF,23.0,14.3,2.0,0.0,0.0,19.0,8.0,1.0,29.0,12.0,21.0,0.0,2.0,0.0,90.0,8.0,8.0,50.0,Matches,372.0,es ESP,DF,23.0,14.3,908.0,751.0,154.0,26.0,3.0,3.0,29.0,128.0,0.0,0.0,0.0,0.0,721.0,3.0,15.0,Matches,372.0,es ESP,DF,23.0,14.3,721.0,908.0,79.4,12216.0,4925.0,370.0,408.0,90.7,285.0,338.0,84.3,58.0,126.0,46.0,0.0,1.4,1.3,-1.4,11.0,70.0,13.0,4.0,69.0,Matches,455,es ESP,DF,23,21,1284.0,61.0,37.5,14.3,13,84.0,8,8,24.0,6,1.14,15.0,20.0,-5.0,-0.35,-0.14,17.2,16.0,1.2,0.08,0.25,Matches,372.0,es ESP,DF,23.0,14.3,1032.0,50.0,351.0,490.0,209.0,17.0,1032.0,28.0,14.0,50.0,7.0,25.0,596.0,3238.0,1751.0,24.0,19.0,2.0,18.0,11.0,649.0,40.0,Matches,372.0,es ESP,DF,23.0,14.3,0.0,5.0,0.0,0.0,0.35,0.0,0.0,,12.1,0.0,0.0,0.0,0.4,0.4,0.08,-0.4,-0.4,Matches,372.0,es ESP,DF,23.0,21.0,13.0,1284.0,14.3,0.0,0.0,0.0,0.0,0.0,0.0,2.0,0.0,0.4,0.4,1.4,1.7,24.0,69.0,40.0,0.0,0.0,0.0,0.0,0.0,0.03,0.1,0.12,0.03,0.12,Matches,Óscar Mingueza,D RC,23,130,146,Spain,Vigo,5,11,11,8,12,6,14,8,11,13,12,5,14,13,13,14,15,14,11,12,12,15,7,13,10,12,15,16,13,12,14,13,15,14,14,13,14,8,12,7,15,3,3,3,2,1,1,4,2,3,3,3,10,14,5,15,13,15,13,15,1,13,20,19,9,14,10,1,1,1,1,1,1,1,184,75,10,20,5633644,6500,6500,4750,Mediterranean_Hispanic,129,5,1999/5/13,1,0,21766.0,,67245413
722,Rafa Mir,Sevilla,1997,373.0,es ESP,FW,25.0,14.4,8.0,2.0,2.0,4.0,2.0,2.0,5.0,40.0,3.0,5.0,1.0,4.0,4.0,12.0,11.0,0.0,Matches,373.0,es ESP,FW,25.0,14.4,19.0,1.32,14.0,0.0,0.0,4.0,1.0,0.0,0.0,0.0,0.0,0.0,0.0,0.0,0.0,0.0,Matches,,,,,,,,,,,,,,,,,,,,,,,,,,,,,,,,,,,,,,,,,,,,,,,,,,,,,,,,373.0,es ESP,FW,25.0,14.4,1.0,0.0,0.0,23.0,11.0,18.0,6.0,4.0,2.0,0.0,0.0,0.0,42.0,37.0,42.0,46.8,Matches,373.0,es ESP,FW,25.0,14.4,262.0,234.0,26.0,0.0,1.0,0.0,6.0,0.0,0.0,0.0,0.0,0.0,176.0,2.0,9.0,Matches,373.0,es ESP,FW,25.0,14.4,176.0,262.0,67.2,2380.0,325.0,107.0,145.0,73.8,52.0,76.0,68.4,6.0,14.0,42.9,0.0,1.0,0.9,-1.0,9.0,7.0,0.0,0.0,11.0,Matches,456,es ESP,FW,25,26,1298.0,50.0,38.0,14.4,16,71.0,7,10,16.0,12,1.15,18.0,24.0,-6.0,-0.42,-0.37,19.2,21.7,-2.5,-0.17,0.06,Matches,373.0,es ESP,FW,25.0,14.4,396.0,12.0,36.0,170.0,192.0,71.0,396.0,14.0,0.0,0.0,13.0,92.9,188.0,859.0,332.0,12.0,5.0,8.0,24.0,12.0,277.0,54.0,Matches,373.0,es ESP,FW,25.0,14.4,6.0,50.0,15.0,30.0,3.47,1.04,0.12,0.4,12.5,0.0,0.0,0.0,7.4,7.4,0.15,-1.4,-1.4,Matches,373.0,es ESP,FW,25.0,26.0,16.0,1298.0,14.4,6.0,0.0,6.0,6.0,0.0,0.0,1.0,0.0,7.4,7.4,1.0,8.4,12.0,11.0,54.0,0.42,0.0,0.42,0.42,0.42,0.51,0.07,0.58,0.51,0.58,Matches,Rafa Mir,S,25,144,154,Spain,Sevilla,5,10,12,15,14,7,17,14,7,6,11,15,6,12,10,13,14,13,14,10,13,13,12,10,13,12,11,14,14,12,14,15,15,15,14,15,12,8,14,8,11,1,1,4,2,3,3,3,3,2,2,3,12,17,13,9,12,12,12,12,1,1,1,1,1,1,1,1,1,1,5,1,5,20,186,75,12,20,16412929,7200,7200,5700,Mediterranean_Hispanic,144,4,1997/6/18,0,0,32145.0,,67221051
723,Juan Miranda,Betis,2000,374.0,es ESP,DF,22.0,16.4,23.0,16.0,16.0,6.0,1.0,14.0,29.0,48.3,15.0,20.0,7.0,13.0,20.0,43.0,63.0,0.0,Matches,374.0,es ESP,DF,22.0,16.4,38.0,2.32,30.0,7.0,0.0,0.0,1.0,0.0,4.0,0.24,4.0,0.0,0.0,0.0,0.0,0.0,Matches,,,,,,,,,,,,,,,,,,,,,,,,,,,,,,,,,,,,,,,,,,,,,,,,,,,,,,,,374.0,es ESP,DF,22.0,16.4,1.0,1.0,0.0,15.0,20.0,1.0,73.0,20.0,16.0,0.0,1.0,0.0,78.0,21.0,17.0,55.3,Matches,374.0,es ESP,DF,22.0,16.4,830.0,658.0,171.0,26.0,2.0,3.0,73.0,130.0,15.0,2.0,8.0,0.0,588.0,1.0,29.0,Matches,374.0,es ESP,DF,22.0,16.4,588.0,830.0,70.8,9875.0,5120.0,277.0,325.0,85.2,210.0,293.0,71.7,67.0,142.0,47.2,2.0,2.9,2.4,-0.9,21.0,55.0,28.0,9.0,73.0,Matches,457,es ESP,DF,22,21,1472.0,70.0,43.0,16.4,16,85.0,11,5,22.0,16,1.57,20.0,18.0,2.0,0.12,-0.02,23.0,21.5,1.5,0.09,0.1,Matches,374.0,es ESP,DF,22.0,16.4,1014.0,67.0,298.0,418.0,306.0,33.0,1014.0,18.0,9.0,50.0,7.0,38.9,478.0,2263.0,1187.0,26.0,22.0,0.0,17.0,8.0,560.0,87.0,Matches,374.0,es ESP,DF,22.0,16.4,3.0,21.0,8.0,38.1,1.28,0.49,0.14,0.38,18.8,3.0,0.0,0.0,2.4,2.4,0.11,0.6,0.6,Matches,374.0,es ESP,DF,22.0,21.0,16.0,1472.0,16.4,3.0,2.0,5.0,3.0,0.0,0.0,1.0,1.0,2.4,2.4,2.9,5.3,26.0,73.0,87.0,0.18,0.12,0.31,0.18,0.31,0.14,0.18,0.32,0.14,0.32,Matches,Juan Miranda,D/WB/M L,22,130,148,Spain,Real Hispalis,8,12,12,9,14,13,12,8,13,12,13,12,15,13,11,13,14,13,11,11,12,14,12,9,13,13,12,13,13,13,13,13,15,13,14,13,11,8,12,6,13,3,3,3,2,1,1,3,3,3,3,2,14,13,5,11,13,14,13,14,1,20,11,1,19,1,1,17,1,1,14,1,1,1,185,76,20,8,8879999,6500,6500,4250,Mediterranean_Hispanic,128,2,2000/1/19,1,1,7955.0,,67258411
724,Stefan Mitrović,Getafe,1990,375.0,rs SRB,DF,32.0,18.7,14.0,6.0,12.0,2.0,0.0,7.0,11.0,63.6,4.0,12.0,10.0,2.0,17.0,31.0,90.0,2.0,Matches,375.0,rs SRB,DF,32.0,18.7,4.0,0.21,2.0,2.0,0.0,0.0,0.0,0.0,0.0,0.0,0.0,0.0,0.0,0.0,0.0,0.0,Matches,,,,,,,,,,,,,,,,,,,,,,,,,,,,,,,,,,,,,,,,,,,,,,,,,,,,,,,,375.0,rs SRB,DF,32.0,18.7,5.0,0.0,0.0,13.0,3.0,0.0,0.0,17.0,6.0,0.0,0.0,0.0,63.0,38.0,16.0,70.4,Matches,375.0,rs SRB,DF,32.0,18.7,512.0,484.0,26.0,26.0,0.0,5.0,0.0,0.0,0.0,0.0,0.0,0.0,403.0,2.0,2.0,Matches,375.0,rs SRB,DF,32.0,18.7,403.0,512.0,78.7,8685.0,3574.0,106.0,126.0,84.1,228.0,260.0,87.7,63.0,111.0,56.8,0.0,0.0,0.1,0.0,0.0,14.0,0.0,0.0,17.0,Matches,458,rs SRB,DF,32,22,1680.0,76.0,49.1,18.7,18,89.0,16,4,22.0,16,1.36,16.0,17.0,-1.0,-0.05,0.46,16.5,19.6,-3.1,-0.17,0.16,Matches,375.0,rs SRB,DF,32.0,18.7,663.0,110.0,396.0,260.0,11.0,8.0,663.0,1.0,0.0,0.0,1.0,100.0,312.0,1443.0,616.0,1.0,0.0,0.0,2.0,0.0,331.0,1.0,Matches,375.0,rs SRB,DF,32.0,18.7,0.0,1.0,0.0,0.0,0.05,0.0,0.0,,11.7,0.0,0.0,0.0,0.1,0.1,0.1,-0.1,-0.1,Matches,375.0,rs SRB,DF,32.0,22.0,18.0,1680.0,18.7,0.0,0.0,0.0,0.0,0.0,0.0,5.0,0.0,0.1,0.1,0.0,0.1,1.0,17.0,1.0,0.0,0.0,0.0,0.0,0.0,0.01,0.0,0.01,0.01,0.01,Matches,Stefan Mitrović,D C,32,128,136,Serbia,Getafe,6,8,9,6,10,6,15,7,11,14,9,9,14,12,14,14,17,14,14,8,11,14,8,10,9,14,15,15,10,10,15,15,15,10,14,16,14,14,12,7,8,1,2,3,2,2,3,2,3,1,1,1,15,17,10,7,13,14,8,10,1,13,20,1,10,1,1,1,1,1,1,1,1,1,189,84,20,10,1604613,6400,6900,5650,Northern_European,127,5,1990/5/22,32,0,8793.0,,62031623
725,Luka Modrić,Real Madrid,1985,376.0,hr CRO,MF,36.0,19.4,19.0,9.0,6.0,6.0,7.0,10.0,25.0,40.0,15.0,15.0,5.0,10.0,10.0,29.0,7.0,0.0,Matches,376.0,hr CRO,MF,36.0,19.4,85.0,4.39,75.0,6.0,2.0,1.0,1.0,0.0,9.0,0.46,6.0,2.0,0.0,0.0,1.0,0.0,Matches,,,,,,,,,,,,,,,,,,,,,,,,,,,,,,,,,,,,,,,,,,,,,,,,,,,,,,,,376.0,hr CRO,MF,36.0,19.4,7.0,0.0,0.0,21.0,16.0,3.0,62.0,10.0,9.0,0.0,0.0,0.0,86.0,11.0,14.0,44.0,Matches,376.0,hr CRO,MF,36.0,19.4,1521.0,1415.0,104.0,41.0,7.0,22.0,62.0,10.0,44.0,22.0,12.0,0.0,1336.0,2.0,23.0,Matches,376.0,hr CRO,MF,36.0,19.4,1336.0,1521.0,87.8,20964.0,6451.0,740.0,786.0,94.1,414.0,467.0,88.7,127.0,179.0,70.9,3.0,4.5,4.2,-1.5,42.0,153.0,22.0,3.0,182.0,Matches,459,hr CRO,MF,36,33,1744.0,53.0,51.0,19.4,19,76.0,4,14,22.0,1,2.12,41.0,20.0,21.0,1.08,0.12,34.1,20.4,13.7,0.71,-0.52,Matches,376.0,hr CRO,MF,36.0,19.4,1681.0,19.0,213.0,885.0,592.0,47.0,1680.0,47.0,19.0,40.4,21.0,44.7,1132.0,5681.0,2532.0,50.0,49.0,14.0,31.0,19.0,1361.0,87.0,Matches,376.0,hr CRO,MF,36.0,19.4,4.0,29.0,5.0,17.2,1.5,0.26,0.1,0.6,20.2,1.0,1.0,1.0,4.2,3.4,0.12,-0.2,-0.4,Matches,376.0,hr CRO,MF,36.0,33.0,19.0,1744.0,19.4,4.0,3.0,7.0,3.0,1.0,1.0,7.0,0.0,4.2,3.4,4.5,8.0,50.0,182.0,87.0,0.21,0.15,0.36,0.15,0.31,0.22,0.23,0.45,0.18,0.41,Matches,Luka Modrić,M C,36,179,180,Croatia,R. Madrid,16,16,17,9,20,13,8,14,7,8,19,14,11,19,12,17,14,18,18,19,18,17,13,14,15,15,17,16,12,14,13,7,13,13,13,8,15,12,16,11,16,2,2,1,3,3,1,1,2,1,2,1,10,15,5,17,17,20,19,17,1,1,1,1,1,1,14,8,20,5,1,15,1,1,172,67,13,20,30331138,9000,9265,9000,Northern_European,176,5,1985/9/9,152,22,321918.0,,653054
726,Nahuel Molina,Atlético Madrid,1998,379.0,ar ARG,DF,24.0,31.9,69.0,43.0,38.0,18.0,13.0,39.0,91.0,42.9,52.0,38.0,7.0,31.0,18.0,87.0,63.0,1.0,Matches,379.0,ar ARG,DF,24.0,31.9,92.0,2.89,83.0,5.0,2.0,0.0,1.0,1.0,6.0,0.19,5.0,0.0,0.0,0.0,1.0,0.0,Matches,,,,,,,,,,,,,,,,,,,,,,,,,,,,,,,,,,,,,,,,,,,,,,,,,,,,,,,,379.0,ar ARG,DF,24.0,31.9,7.0,1.0,0.0,22.0,16.0,3.0,120.0,18.0,43.0,0.0,0.0,0.0,158.0,22.0,32.0,40.7,Matches,379.0,ar ARG,DF,24.0,31.9,1930.0,1605.0,323.0,16.0,7.0,6.0,120.0,300.0,7.0,4.0,3.0,0.0,1452.0,2.0,61.0,Matches,379.0,ar ARG,DF,24.0,31.9,1452.0,1930.0,75.2,21725.0,8461.0,840.0,930.0,90.3,466.0,653.0,71.4,94.0,205.0,45.9,2.0,3.9,4.0,-1.9,38.0,74.0,49.0,17.0,112.0,Matches,462,ar ARG,DF,24,33,2867.0,87.0,83.8,31.9,33,87.0,28,0,,1,2.03,58.0,28.0,30.0,0.94,-0.2,51.2,35.1,16.1,0.51,-0.25,Matches,379.0,ar ARG,DF,24.0,31.9,2229.0,87.0,696.0,833.0,709.0,47.0,2229.0,51.0,21.0,41.2,24.0,47.1,1080.0,4854.0,2929.0,73.0,43.0,9.0,32.0,10.0,1386.0,249.0,Matches,379.0,ar ARG,DF,24.0,31.9,4.0,21.0,6.0,28.6,0.66,0.19,0.19,0.67,17.0,0.0,0.0,0.0,2.6,2.6,0.13,1.4,1.4,Matches,379.0,ar ARG,DF,24.0,33.0,33.0,2867.0,31.9,4.0,2.0,6.0,4.0,0.0,0.0,7.0,1.0,2.6,2.6,3.9,6.5,73.0,112.0,249.0,0.13,0.06,0.19,0.13,0.19,0.08,0.12,0.2,0.08,0.2,Matches,Nahuel Molina,D/WB/M R,24,140,154,Argentina,A. Madrid,14,14,13,11,13,12,8,12,13,11,14,6,13,14,10,12,13,11,13,13,12,14,12,8,13,12,12,15,15,14,12,8,15,15,13,12,13,10,11,3,13,1,3,2,3,2,3,2,1,1,2,2,14,14,5,9,15,14,13,11,1,1,1,20,1,20,1,1,1,18,1,1,1,1,175,70,11,20,30000000,6900,6750,5400,Native_American,132,11,1998/4/6,17,0,21883.0,,14129337
727,Jon Moncayola,Osasuna,1998,380.0,es ESP,MFDF,24.0,27.2,55.0,39.0,24.0,22.0,9.0,30.0,76.0,39.5,46.0,37.0,5.0,32.0,17.0,72.0,32.0,2.0,Matches,380.0,es ESP,MFDF,24.0,27.2,68.0,2.5,54.0,3.0,0.0,8.0,3.0,0.0,9.0,0.33,5.0,0.0,0.0,3.0,1.0,0.0,Matches,,,,,,,,,,,,,,,,,,,,,,,,,,,,,,,,,,,,,,,,,,,,,,,,,,,,,,,,380.0,es ESP,MFDF,24.0,27.2,6.0,0.0,0.0,35.0,17.0,3.0,78.0,17.0,39.0,1.0,0.0,0.0,186.0,17.0,15.0,53.1,Matches,380.0,es ESP,MFDF,24.0,27.2,1461.0,1313.0,143.0,54.0,2.0,33.0,78.0,64.0,24.0,9.0,10.0,1.0,1136.0,5.0,24.0,Matches,380.0,es ESP,MFDF,24.0,27.2,1136.0,1461.0,77.8,22841.0,7870.0,433.0,490.0,88.4,516.0,609.0,84.7,176.0,315.0,55.9,3.0,1.8,2.2,1.2,27.0,170.0,22.0,10.0,175.0,Matches,463,es ESP,MFDF,24,37,2448.0,66.0,71.6,27.2,25,86.0,16,12,25.0,0,1.43,24.0,36.0,-12.0,-0.44,-1.09,28.9,33.2,-4.3,-0.16,-0.01,Matches,380.0,es ESP,MFDF,24.0,27.2,1698.0,59.0,387.0,949.0,379.0,14.0,1698.0,8.0,4.0,50.0,3.0,37.5,869.0,3900.0,2099.0,34.0,29.0,1.0,26.0,11.0,1060.0,50.0,Matches,380.0,es ESP,MFDF,24.0,27.2,1.0,36.0,9.0,25.0,1.32,0.33,0.03,0.11,25.3,0.0,0.0,0.0,2.0,2.0,0.06,-1.0,-1.0,Matches,380.0,es ESP,MFDF,24.0,37.0,25.0,2448.0,27.2,1.0,3.0,4.0,1.0,0.0,0.0,6.0,0.0,2.0,2.0,1.8,3.8,34.0,175.0,50.0,0.04,0.11,0.15,0.04,0.15,0.07,0.07,0.14,0.07,0.14,Matches,Jon Moncayola,DM/M C,24,136,150,"Spain,Pays Basque",Atlético Pamplona,11,10,9,10,12,9,11,14,6,9,14,12,13,13,14,15,16,11,15,14,12,14,10,13,13,14,16,14,14,12,12,12,14,13,15,13,14,10,13,7,16,1,3,3,3,4,1,3,1,2,1,3,7,11,6,11,12,11,11,15,1,1,1,1,1,1,20,1,20,1,1,1,1,1,180,73,12,20,11787368,6800,6800,3350,Mediterranean_Hispanic,136,6,1998/5/13,0,0,15875.0,,67267210
728,Monchu,Valladolid,1999,381.0,es ESP,MF,22.0,22.6,50.0,29.0,20.0,21.0,9.0,19.0,46.0,41.3,27.0,28.0,11.0,17.0,18.0,68.0,22.0,1.0,Matches,381.0,es ESP,MF,22.0,22.6,73.0,3.24,42.0,19.0,0.0,6.0,4.0,2.0,5.0,0.22,3.0,1.0,0.0,1.0,0.0,0.0,Matches,,,,,,,,,,,,,,,,,,,,,,,,,,,,,,,,,,,,,,,,,,,,,,,,,,,,,,,,381.0,es ESP,MF,22.0,22.6,10.0,0.0,0.0,46.0,28.0,1.0,76.0,18.0,29.0,0.0,1.0,0.0,119.0,18.0,31.0,36.7,Matches,381.0,es ESP,MF,22.0,22.6,1054.0,918.0,128.0,80.0,5.0,23.0,76.0,1.0,46.0,9.0,28.0,1.0,833.0,8.0,10.0,Matches,381.0,es ESP,MF,22.0,22.6,833.0,1054.0,79.0,16192.0,4815.0,369.0,410.0,90.0,303.0,375.0,80.8,144.0,231.0,62.3,2.0,2.0,1.7,0.0,25.0,98.0,5.0,2.0,111.0,Matches,464,es ESP,MF,22,33,2031.0,62.0,59.4,22.6,23,78.0,13,10,24.0,3,0.97,17.0,40.0,-23.0,-1.02,-0.57,23.4,39.3,-15.9,-0.7,-0.01,Matches,381.0,es ESP,MF,22.0,22.6,1276.0,48.0,319.0,693.0,270.0,24.0,1276.0,20.0,10.0,50.0,7.0,35.0,636.0,2794.0,1252.0,17.0,18.0,3.0,34.0,15.0,749.0,25.0,Matches,381.0,es ESP,MF,22.0,22.6,3.0,39.0,10.0,25.6,1.73,0.44,0.08,0.3,24.4,9.0,0.0,0.0,2.4,2.4,0.06,0.6,0.6,Matches,381.0,es ESP,MF,22.0,33.0,23.0,2031.0,22.6,3.0,2.0,5.0,3.0,0.0,0.0,10.0,0.0,2.4,2.4,2.0,4.4,17.0,111.0,25.0,0.13,0.09,0.22,0.13,0.22,0.11,0.09,0.2,0.11,0.2,Matches,Monchu,DM/M C,22,131,150,Spain,Valladolid,15,11,11,9,14,14,6,12,5,10,14,15,11,14,15,15,13,14,14,14,15,15,13,13,11,15,13,12,12,12,12,7,15,13,13,11,15,8,13,6,12,2,2,2,3,2,2,3,3,3,1,2,12,14,5,13,14,15,13,10,1,1,1,1,1,1,19,1,20,1,1,14,1,1,173,68,10,20,7103999,6500,6500,4252,Mediterranean_Hispanic,131,5,1999/9/13,0,0,4293.0,,67246433
729,César Montes,Espanyol,1997,382.0,mx MEX,DF,25.0,17.7,17.0,9.0,10.0,7.0,0.0,10.0,18.0,55.6,8.0,19.0,12.0,7.0,14.0,31.0,101.0,0.0,Matches,382.0,mx MEX,DF,25.0,17.7,10.0,0.57,6.0,1.0,0.0,3.0,0.0,0.0,2.0,0.11,0.0,0.0,0.0,2.0,0.0,0.0,Matches,,,,,,,,,,,,,,,,,,,,,,,,,,,,,,,,,,,,,,,,,,,,,,,,,,,,,,,,382.0,mx MEX,DF,25.0,17.7,6.0,0.0,0.0,18.0,6.0,1.0,1.0,14.0,9.0,0.0,1.0,0.0,91.0,68.0,38.0,64.2,Matches,382.0,mx MEX,DF,25.0,17.7,799.0,733.0,63.0,39.0,1.0,12.0,1.0,7.0,0.0,0.0,0.0,0.0,624.0,3.0,12.0,Matches,382.0,mx MEX,DF,25.0,17.7,624.0,799.0,78.1,12344.0,4658.0,223.0,251.0,88.8,312.0,367.0,85.0,81.0,158.0,51.3,0.0,0.0,0.7,0.0,0.0,46.0,1.0,1.0,41.0,Matches,466,mx MEX,DF,25,20,1590.0,80.0,46.5,17.7,18,87.0,17,2,11.0,0,0.9,26.0,40.0,-14.0,-0.79,-0.64,23.0,32.8,-9.8,-0.55,-0.47,Matches,382.0,mx MEX,DF,25.0,17.7,989.0,154.0,511.0,422.0,66.0,29.0,989.0,5.0,2.0,40.0,3.0,60.0,499.0,2365.0,1487.0,13.0,5.0,0.0,5.0,3.0,551.0,4.0,Matches,382.0,mx MEX,DF,25.0,17.7,3.0,13.0,6.0,46.2,0.74,0.34,0.23,0.5,12.9,0.0,0.0,0.0,0.9,0.9,0.07,2.1,2.1,Matches,382.0,mx MEX,DF,25.0,20.0,18.0,1590.0,17.7,3.0,0.0,3.0,3.0,0.0,0.0,6.0,0.0,0.9,0.9,0.0,0.9,13.0,41.0,4.0,0.17,0.0,0.17,0.17,0.17,0.05,0.0,0.05,0.05,0.05,Matches,César Montes,D C,25,138,148,Mexico,CF Monterrey,8,12,7,6,10,7,15,9,14,15,11,11,12,14,9,13,13,14,13,13,14,13,8,8,7,14,12,14,12,13,14,15,14,14,13,9,12,8,12,13,8,2,2,3,3,2,4,1,1,1,3,1,20,10,8,15,12,15,9,13,1,1,20,1,1,1,1,1,1,1,1,1,1,1,191,70,7,20,4976951,6849,6849,4241,Mediterranean_Hispanic,130,11,1997/2/24,26,1,22392.0,,51055610
730,Gonzalo Montiel,Sevilla,1997,383.0,ar ARG,DF,25.0,16.9,26.0,15.0,12.0,14.0,0.0,15.0,29.0,51.7,14.0,25.0,7.0,18.0,19.0,45.0,38.0,0.0,Matches,383.0,ar ARG,DF,25.0,16.9,41.0,2.42,33.0,6.0,1.0,0.0,0.0,1.0,5.0,0.3,5.0,0.0,0.0,0.0,0.0,0.0,Matches,,,,,,,,,,,,,,,,,,,,,,,,,,,,,,,,,,,,,,,,,,,,,,,,,,,,,,,,383.0,ar ARG,DF,25.0,16.9,8.0,1.0,0.0,19.0,10.0,11.0,39.0,19.0,15.0,0.0,0.0,0.0,100.0,13.0,16.0,44.8,Matches,383.0,ar ARG,DF,25.0,16.9,851.0,707.0,138.0,7.0,3.0,3.0,39.0,128.0,3.0,0.0,2.0,0.0,661.0,6.0,21.0,Matches,383.0,ar ARG,DF,25.0,16.9,661.0,851.0,77.7,10029.0,3892.0,359.0,402.0,89.3,250.0,322.0,77.6,34.0,78.0,43.6,3.0,2.1,2.5,0.9,20.0,53.0,13.0,7.0,57.0,Matches,468,ar ARG,DF,25,28,1524.0,54.0,44.6,16.9,17,74.0,8,11,24.0,6,1.25,18.0,28.0,-10.0,-0.59,-0.73,21.0,26.7,-5.7,-0.34,-0.23,Matches,383.0,ar ARG,DF,25.0,16.9,1023.0,54.0,291.0,433.0,310.0,33.0,1023.0,23.0,10.0,43.5,12.0,52.2,532.0,2769.0,1584.0,34.0,28.0,5.0,23.0,9.0,576.0,87.0,Matches,383.0,ar ARG,DF,25.0,16.9,0.0,8.0,1.0,12.5,0.47,0.06,0.0,0.0,13.7,0.0,0.0,0.0,0.8,0.8,0.09,-0.8,-0.8,Matches,383.0,ar ARG,DF,25.0,28.0,17.0,1524.0,16.9,0.0,3.0,3.0,0.0,0.0,0.0,8.0,1.0,0.8,0.8,2.1,2.9,34.0,57.0,87.0,0.0,0.18,0.18,0.0,0.18,0.04,0.13,0.17,0.04,0.17,Matches,Gonzalo Montiel,D/WB R,25,138,145,"Argentina,Spain",Sevilla,7,11,9,6,12,3,12,5,13,14,12,15,14,9,16,15,16,14,14,8,13,16,7,13,11,15,17,16,14,14,14,10,15,15,16,13,14,14,15,10,13,1,1,3,2,2,4,2,3,1,2,1,19,12,8,15,15,15,12,15,1,1,12,20,1,17,1,1,1,1,1,1,1,1,175,70,7,20,12026818,6900,6650,4500,Mediterranean_Hispanic,138,8,1997/1/1,16,0,21487.0,,14136122
731,Álvaro Morata,Atlético Madrid,1992,385.0,es ESP,FW,29.0,21.1,16.0,11.0,4.0,8.0,4.0,3.0,8.0,37.5,5.0,11.0,3.0,8.0,0.0,16.0,23.0,0.0,Matches,385.0,es ESP,FW,29.0,21.1,48.0,2.27,30.0,0.0,6.0,5.0,7.0,0.0,9.0,0.43,4.0,0.0,3.0,1.0,1.0,0.0,Matches,,,,,,,,,,,,,,,,,,,,,,,,,,,,,,,,,,,,,,,,,,,,,,,,,,,,,,,,385.0,es ESP,FW,29.0,21.1,4.0,0.0,0.0,39.0,56.0,26.0,4.0,0.0,11.0,0.0,0.0,0.0,57.0,53.0,38.0,58.2,Matches,385.0,es ESP,FW,29.0,21.1,422.0,405.0,15.0,0.0,3.0,6.0,4.0,2.0,0.0,0.0,0.0,0.0,270.0,2.0,7.0,Matches,385.0,es ESP,FW,29.0,21.1,270.0,422.0,64.0,3678.0,551.0,169.0,231.0,73.2,69.0,117.0,59.0,17.0,30.0,56.7,2.0,2.0,1.2,0.0,17.0,6.0,5.0,1.0,17.0,Matches,471,es ESP,FW,29,36,1900.0,53.0,55.6,21.1,23,68.0,3,13,25.0,1,2.03,40.0,10.0,30.0,1.42,1.01,34.2,19.5,14.7,0.7,0.34,Matches,385.0,es ESP,FW,29.0,21.1,655.0,29.0,68.0,297.0,299.0,105.0,655.0,41.0,20.0,48.8,16.0,39.0,387.0,2142.0,929.0,33.0,19.0,16.0,55.0,24.0,527.0,102.0,Matches,385.0,es ESP,FW,29.0,21.1,13.0,71.0,32.0,45.1,3.36,1.52,0.18,0.41,12.2,0.0,0.0,0.0,11.9,11.9,0.17,1.1,1.1,Matches,385.0,es ESP,FW,29.0,36.0,23.0,1900.0,21.1,13.0,2.0,15.0,13.0,0.0,0.0,4.0,0.0,11.9,11.9,2.0,13.8,33.0,17.0,102.0,0.62,0.09,0.71,0.62,0.71,0.56,0.09,0.66,0.56,0.66,Matches,Álvaro Morata,S,29,153,166,Spain,A. Madrid,5,11,13,14,14,10,16,14,5,5,14,14,8,15,13,16,13,12,12,13,13,14,14,11,16,5,17,16,15,14,14,14,13,16,15,13,14,14,13,9,11,2,3,1,2,1,2,3,4,1,3,3,17,13,7,16,11,14,10,9,1,1,1,1,1,1,1,1,1,1,14,10,1,20,189,84,12,20,40000001,7700,7700,7400,Mediterranean_Hispanic,153,6,1992/10/23,56,26,181817.0,,67117360
732,Alberto Moreno,Villarreal,1992,387.0,es ESP,DF,30.0,14.4,23.0,12.0,10.0,10.0,3.0,11.0,24.0,45.8,13.0,12.0,1.0,11.0,23.0,46.0,26.0,0.0,Matches,387.0,es ESP,DF,30.0,14.4,28.0,1.94,24.0,2.0,1.0,1.0,0.0,0.0,2.0,0.14,2.0,0.0,0.0,0.0,0.0,0.0,Matches,,,,,,,,,,,,,,,,,,,,,,,,,,,,,,,,,,,,,,,,,,,,,,,,,,,,,,,,387.0,es ESP,DF,30.0,14.4,7.0,0.0,0.0,26.0,9.0,3.0,36.0,23.0,12.0,0.0,0.0,0.0,62.0,12.0,10.0,54.5,Matches,387.0,es ESP,DF,30.0,14.4,730.0,617.0,107.0,15.0,1.0,4.0,36.0,85.0,7.0,3.0,3.0,0.0,605.0,6.0,13.0,Matches,387.0,es ESP,DF,30.0,14.4,605.0,730.0,82.9,9845.0,2768.0,298.0,329.0,90.6,252.0,283.0,89.0,36.0,64.0,56.3,1.0,1.4,1.9,-0.4,12.0,18.0,24.0,6.0,47.0,Matches,473,es ESP,DF,30,24,1296.0,54.0,37.9,14.4,14,78.0,3,10,20.0,6,1.96,24.0,15.0,9.0,0.62,0.2,26.7,15.6,11.1,0.77,0.74,Matches,387.0,es ESP,DF,30.0,14.4,872.0,27.0,247.0,298.0,331.0,28.0,872.0,16.0,6.0,37.5,8.0,50.0,490.0,2569.0,1333.0,41.0,32.0,7.0,17.0,6.0,549.0,97.0,Matches,387.0,es ESP,DF,30.0,14.4,0.0,15.0,3.0,20.0,1.04,0.21,0.0,0.0,20.7,2.0,0.0,0.0,0.9,0.9,0.06,-0.9,-0.9,Matches,387.0,es ESP,DF,30.0,24.0,14.0,1296.0,14.4,0.0,1.0,1.0,0.0,0.0,0.0,7.0,0.0,0.9,0.9,1.4,2.3,41.0,47.0,97.0,0.0,0.07,0.07,0.0,0.07,0.07,0.1,0.16,0.07,0.16,Matches,Alberto Moreno,D/WB/M L,30,140,150,Spain,Villarreal,8,14,13,5,14,9,8,12,9,13,14,9,15,14,14,13,15,13,11,14,12,14,12,7,14,12,15,17,14,15,15,8,15,15,17,12,13,9,14,12,9,3,3,1,3,2,3,2,1,1,1,3,14,13,7,14,13,15,14,13,1,18,1,1,20,1,1,16,1,1,10,1,8,1,171,65,20,5,15033524,7000,7000,6050,Mediterranean_Hispanic,141,4,1992/7/5,4,0,23429.0,,67150301
733,Gerard Moreno,Villarreal,1992,390.0,es ESP,FW,30.0,13.7,11.0,6.0,0.0,6.0,5.0,3.0,6.0,50.0,3.0,6.0,2.0,4.0,5.0,16.0,10.0,0.0,Matches,390.0,es ESP,FW,30.0,13.7,48.0,3.52,35.0,0.0,6.0,4.0,2.0,1.0,5.0,0.37,4.0,0.0,0.0,1.0,0.0,0.0,Matches,,,,,,,,,,,,,,,,,,,,,,,,,,,,,,,,,,,,,,,,,,,,,,,,,,,,,,,,390.0,es ESP,FW,30.0,13.7,4.0,0.0,0.0,11.0,14.0,13.0,8.0,5.0,6.0,0.0,0.0,0.0,38.0,19.0,17.0,52.8,Matches,390.0,es ESP,FW,30.0,13.7,483.0,458.0,18.0,0.0,5.0,6.0,8.0,3.0,0.0,0.0,0.0,0.0,353.0,7.0,18.0,Matches,390.0,es ESP,FW,30.0,13.7,353.0,483.0,73.1,5825.0,1500.0,169.0,216.0,78.2,129.0,167.0,77.2,39.0,48.0,81.3,3.0,2.7,1.4,0.3,19.0,35.0,25.0,1.0,68.0,Matches,478,es ESP,FW,30,21,1230.0,59.0,36.0,13.7,14,78.0,7,7,19.0,1,2.05,21.0,9.0,12.0,0.88,0.59,23.0,17.9,5.1,0.37,0.1,Matches,390.0,es ESP,FW,30.0,13.7,634.0,16.0,57.0,282.0,309.0,67.0,632.0,56.0,29.0,51.8,20.0,35.7,401.0,1986.0,828.0,21.0,20.0,11.0,32.0,19.0,508.0,108.0,Matches,390.0,es ESP,FW,30.0,13.7,7.0,41.0,19.0,46.3,3.0,1.39,0.15,0.32,15.8,0.0,1.0,2.0,9.0,7.5,0.19,-2.0,-1.5,Matches,390.0,es ESP,FW,30.0,21.0,14.0,1230.0,13.7,7.0,3.0,10.0,6.0,1.0,2.0,4.0,0.0,9.0,7.5,2.7,10.1,21.0,68.0,108.0,0.51,0.22,0.73,0.44,0.66,0.66,0.19,0.86,0.55,0.74,Matches,Gerard Moreno,AM/S R,30,154,161,Spain,Villarreal,8,11,13,17,15,9,14,13,8,5,14,15,6,14,13,15,13,15,14,13,14,16,13,12,16,8,15,16,13,13,13,13,12,14,14,14,15,4,17,12,8,3,4,1,1,4,4,2,1,1,1,4,15,13,5,14,12,15,15,16,1,1,1,1,1,1,1,1,1,13,8,9,16,20,180,77,20,13,51480004,7700,7700,5000,Mediterranean_Hispanic,153,6,1992/4/7,17,5,51243.0,,67115823
734,Tete Morente,Elche,1996,391.0,es ESP,MFDF,25.0,23.0,33.0,21.0,18.0,13.0,2.0,15.0,36.0,41.7,21.0,23.0,3.0,20.0,25.0,58.0,28.0,0.0,Matches,391.0,es ESP,MFDF,25.0,23.0,53.0,2.31,32.0,4.0,10.0,3.0,3.0,1.0,2.0,0.09,1.0,0.0,0.0,0.0,1.0,0.0,Matches,,,,,,,,,,,,,,,,,,,,,,,,,,,,,,,,,,,,,,,,,,,,,,,,,,,,,,,,391.0,es ESP,MFDF,25.0,23.0,5.0,0.0,0.0,32.0,21.0,12.0,99.0,25.0,21.0,1.0,1.0,0.0,98.0,35.0,21.0,62.5,Matches,391.0,es ESP,MFDF,25.0,23.0,785.0,717.0,67.0,8.0,0.0,2.0,99.0,54.0,5.0,2.0,1.0,0.0,571.0,1.0,45.0,Matches,391.0,es ESP,MFDF,25.0,23.0,571.0,785.0,72.7,8632.0,2680.0,342.0,395.0,86.6,166.0,228.0,72.8,44.0,87.0,50.6,0.0,1.1,1.6,-1.1,16.0,44.0,19.0,9.0,63.0,Matches,480,es ESP,MFDF,25,32,2068.0,65.0,60.5,23.0,23,81.0,11,9,24.0,4,0.66,20.0,33.0,-13.0,-0.57,1.03,23.3,38.5,-15.2,-0.66,0.49,Matches,391.0,es ESP,MFDF,25.0,23.0,1068.0,40.0,190.0,379.0,509.0,60.0,1068.0,74.0,32.0,43.2,40.0,54.1,640.0,3751.0,1773.0,60.0,39.0,15.0,40.0,21.0,703.0,193.0,Matches,391.0,es ESP,MFDF,25.0,23.0,4.0,46.0,14.0,30.4,2.0,0.61,0.09,0.29,16.1,0.0,0.0,0.0,4.2,4.2,0.09,-0.2,-0.2,Matches,391.0,es ESP,MFDF,25.0,32.0,23.0,2068.0,23.0,4.0,0.0,4.0,4.0,0.0,0.0,5.0,0.0,4.2,4.2,1.1,5.3,60.0,63.0,193.0,0.17,0.0,0.17,0.17,0.17,0.18,0.05,0.23,0.18,0.23,Matches,Tete Morente,M/AM RL,25,129,137,Spain,Elche,8,13,15,13,12,13,11,13,6,8,12,11,5,14,12,11,6,11,9,12,11,13,12,7,12,9,3,14,14,13,9,11,15,15,13,11,13,4,8,10,11,1,1,1,3,3,4,2,3,2,1,1,11,14,9,11,10,14,10,13,1,1,1,1,1,1,1,19,7,15,20,9,16,8,184,78,10,20,2374688,6250,6250,4600,Mediterranean_Hispanic,120,2,1996/12/4,0,0,6639.0,,67211699
735,Ilaix Moriba,Valencia,2003,392.0,gn GUI,MF,19.0,11.2,35.0,16.0,14.0,17.0,4.0,14.0,24.0,58.3,10.0,11.0,1.0,10.0,4.0,39.0,12.0,0.0,Matches,392.0,gn GUI,MF,19.0,11.2,35.0,3.11,28.0,1.0,2.0,1.0,2.0,1.0,3.0,0.27,2.0,0.0,0.0,0.0,0.0,1.0,Matches,,,,,,,,,,,,,,,,,,,,,,,,,,,,,,,,,,,,,,,,,,,,,,,,,,,,,,,,392.0,gn GUI,MF,19.0,11.2,6.0,2.0,1.0,32.0,33.0,0.0,4.0,4.0,16.0,0.0,0.0,0.0,75.0,25.0,26.0,49.0,Matches,392.0,gn GUI,MF,19.0,11.2,501.0,491.0,8.0,4.0,4.0,3.0,4.0,3.0,0.0,0.0,0.0,0.0,403.0,2.0,10.0,Matches,392.0,gn GUI,MF,19.0,11.2,403.0,501.0,80.4,6210.0,1890.0,222.0,259.0,85.7,142.0,169.0,84.0,27.0,39.0,69.2,2.0,1.0,1.1,1.0,12.0,53.0,12.0,2.0,67.0,Matches,481,gn GUI,MF,19,24,1011.0,42.0,29.6,11.2,10,76.0,3,14,18.0,5,1.13,10.0,16.0,-6.0,-0.53,-0.65,14.5,14.3,0.2,0.02,-0.19,Matches,392.0,gn GUI,MF,19.0,11.2,654.0,18.0,123.0,339.0,197.0,15.0,654.0,30.0,12.0,40.0,10.0,33.3,383.0,1895.0,883.0,16.0,13.0,2.0,21.0,13.0,445.0,30.0,Matches,392.0,gn GUI,MF,19.0,11.2,0.0,21.0,5.0,23.8,1.87,0.45,0.0,0.0,22.5,1.0,0.0,0.0,1.2,1.2,0.06,-1.2,-1.2,Matches,392.0,gn GUI,MF,19.0,24.0,10.0,1011.0,11.2,0.0,2.0,2.0,0.0,0.0,0.0,6.0,2.0,1.2,1.2,1.0,2.2,16.0,67.0,30.0,0.0,0.18,0.18,0.0,0.18,0.11,0.09,0.19,0.11,0.19,Matches,Ilaix Moriba,M C,19,133,-9,"Guinea,Spain",RB Leipzig,8,9,14,13,15,10,11,14,3,9,14,11,11,16,13,12,15,12,12,14,13,16,17,11,12,11,11,12,13,14,14,13,15,14,13,12,10,10,15,5,12,4,2,1,1,2,3,1,3,1,3,2,10,18,12,9,15,13,14,9,1,1,1,1,1,1,15,10,20,5,10,15,5,10,185,73,12,20,78784001,6650,6650,4650,African_Caribbean,135,17,2003/1/19,8,0,27999.0,Valencia,67279753
736,Abdul Mumin,Rayo Vallecano,1998,397.0,gh GHA,DF,24.0,10.2,11.0,9.0,5.0,6.0,0.0,3.0,7.0,42.9,4.0,13.0,5.0,8.0,9.0,20.0,36.0,2.0,Matches,397.0,gh GHA,DF,24.0,10.2,6.0,0.59,4.0,0.0,0.0,2.0,0.0,0.0,0.0,0.0,0.0,0.0,0.0,0.0,0.0,0.0,Matches,,,,,,,,,,,,,,,,,,,,,,,,,,,,,,,,,,,,,,,,,,,,,,,,,,,,,,,,397.0,gh GHA,DF,24.0,10.2,2.0,0.0,0.0,7.0,8.0,0.0,3.0,9.0,9.0,0.0,0.0,0.0,54.0,13.0,18.0,41.9,Matches,397.0,gh GHA,DF,24.0,10.2,390.0,370.0,19.0,15.0,0.0,4.0,3.0,4.0,0.0,0.0,0.0,0.0,299.0,1.0,3.0,Matches,397.0,gh GHA,DF,24.0,10.2,299.0,390.0,76.7,6424.0,1975.0,73.0,82.0,89.0,180.0,202.0,89.1,45.0,99.0,45.5,0.0,0.0,0.1,0.0,1.0,18.0,1.0,1.0,19.0,Matches,487,gh GHA,DF,24,16,922.0,58.0,27.0,10.2,9,90.0,9,7,16.0,18,1.25,13.0,17.0,-4.0,-0.39,-0.25,11.1,13.5,-2.3,-0.23,-0.08,Matches,397.0,gh GHA,DF,24.0,10.2,493.0,59.0,248.0,231.0,19.0,8.0,493.0,9.0,5.0,55.6,4.0,44.4,268.0,1328.0,646.0,5.0,6.0,0.0,4.0,5.0,270.0,1.0,Matches,397.0,gh GHA,DF,24.0,10.2,0.0,6.0,1.0,16.7,0.59,0.1,0.0,0.0,11.3,0.0,0.0,0.0,0.4,0.4,0.07,-0.4,-0.4,Matches,397.0,gh GHA,DF,24.0,16.0,9.0,922.0,10.2,0.0,0.0,0.0,0.0,0.0,0.0,2.0,0.0,0.4,0.4,0.0,0.4,5.0,19.0,1.0,0.0,0.0,0.0,0.0,0.0,0.04,0.0,0.04,0.04,0.04,Matches,Abdul Mumin,D C,24,132,140,"Ghana,Nigeria",Vallecano,5,5,11,6,12,5,12,6,10,15,13,6,11,12,13,13,16,13,15,11,12,8,15,4,9,14,13,12,13,14,13,15,15,16,13,14,13,15,10,7,1,3,2,1,1,1,2,2,1,2,2,2,19,14,5,11,14,12,10,9,1,1,20,8,1,1,1,1,1,1,1,1,1,1,188,80,9,20,4630645,6600,6600,5100,African_Caribbean,131,16,1998/6/6,0,0,11664.0,,27128916
737,Iker Muniain,Athletic Club,1992,398.0,es ESP,MFFW,29.0,18.8,21.0,16.0,7.0,11.0,3.0,6.0,17.0,35.3,11.0,10.0,1.0,9.0,4.0,25.0,2.0,0.0,Matches,398.0,es ESP,MFFW,29.0,18.8,108.0,5.75,65.0,31.0,1.0,2.0,9.0,0.0,12.0,0.64,8.0,2.0,0.0,0.0,2.0,0.0,Matches,,,,,,,,,,,,,,,,,,,,,,,,,,,,,,,,,,,,,,,,,,,,,,,,,,,,,,,,398.0,es ESP,MFFW,29.0,18.8,2.0,0.0,0.0,13.0,62.0,1.0,113.0,4.0,16.0,0.0,0.0,0.0,81.0,3.0,13.0,18.8,Matches,398.0,es ESP,MFFW,29.0,18.8,1110.0,944.0,160.0,58.0,6.0,3.0,113.0,9.0,82.0,13.0,54.0,0.0,890.0,6.0,13.0,Matches,398.0,es ESP,MFFW,29.0,18.8,890.0,1110.0,80.2,14031.0,4353.0,480.0,541.0,88.7,304.0,365.0,83.3,73.0,137.0,53.3,3.0,3.9,3.9,-0.9,47.0,89.0,28.0,4.0,154.0,Matches,488,es ESP,MFFW,29,30,1689.0,56.0,49.4,18.8,19,77.0,5,11,21.0,2,1.43,29.0,18.0,11.0,0.59,0.95,28.1,17.2,10.8,0.58,0.24,Matches,398.0,es ESP,MFFW,29.0,18.8,1256.0,5.0,86.0,612.0,575.0,40.0,1256.0,66.0,39.0,59.1,15.0,22.7,823.0,4049.0,1867.0,50.0,55.0,9.0,30.0,30.0,961.0,103.0,Matches,398.0,es ESP,MFFW,29.0,18.8,0.0,28.0,7.0,25.0,1.49,0.37,0.0,0.0,18.1,1.0,0.0,0.0,3.0,3.0,0.11,-3.0,-3.0,Matches,398.0,es ESP,MFFW,29.0,30.0,19.0,1689.0,18.8,0.0,3.0,3.0,0.0,0.0,0.0,2.0,0.0,3.0,3.0,3.9,6.9,50.0,154.0,103.0,0.0,0.16,0.16,0.0,0.16,0.16,0.21,0.37,0.16,0.37,Matches,Iker Muniain,M/AM RLC,29,152,165,"Spain,Pays Basque",A. Bilbao,15,11,14,12,15,14,7,12,7,9,15,13,8,15,12,15,14,11,12,14,11,13,18,15,14,11,12,14,16,15,16,6,13,15,14,10,12,7,14,6,14,1,3,1,3,2,4,2,3,2,2,2,13,13,14,14,11,11,8,8,1,1,1,1,1,1,1,16,16,14,18,20,16,11,170,66,12,20,127050007,7600,7600,6850,Mediterranean_Hispanic,146,4,1992/12/19,2,0,42161.0,,67037570
738,Aihen Muñoz,Real Sociedad,1997,399.0,es ESP,DF,24.0,19.5,38.0,23.0,17.0,17.0,4.0,22.0,47.0,46.8,25.0,26.0,5.0,21.0,9.0,47.0,38.0,0.0,Matches,399.0,es ESP,DF,24.0,19.5,36.0,1.84,25.0,2.0,5.0,3.0,1.0,0.0,2.0,0.1,2.0,0.0,0.0,0.0,0.0,0.0,Matches,,,,,,,,,,,,,,,,,,,,,,,,,,,,,,,,,,,,,,,,,,,,,,,,,,,,,,,,399.0,es ESP,DF,24.0,19.5,2.0,0.0,0.0,29.0,16.0,0.0,54.0,9.0,23.0,0.0,0.0,0.0,102.0,21.0,25.0,45.7,Matches,399.0,es ESP,DF,24.0,19.5,1027.0,824.0,196.0,16.0,0.0,3.0,54.0,180.0,0.0,0.0,0.0,0.0,781.0,7.0,29.0,Matches,399.0,es ESP,DF,24.0,19.5,781.0,1027.0,76.0,13080.0,5178.0,389.0,436.0,89.2,323.0,403.0,80.1,60.0,132.0,45.5,1.0,0.9,1.1,0.1,14.0,48.0,18.0,11.0,57.0,Matches,489,es ESP,DF,24,23,1756.0,76.0,51.3,19.5,20,84.0,17,3,27.0,10,1.74,26.0,21.0,5.0,0.26,-0.34,28.5,17.4,11.1,0.57,0.1,Matches,399.0,es ESP,DF,24.0,19.5,1226.0,39.0,340.0,531.0,366.0,9.0,1226.0,40.0,19.0,47.5,18.0,45.0,624.0,3038.0,1395.0,37.0,32.0,2.0,25.0,18.0,704.0,87.0,Matches,399.0,es ESP,DF,24.0,19.5,0.0,6.0,2.0,33.3,0.31,0.1,0.0,0.0,24.8,0.0,0.0,0.0,0.2,0.2,0.03,-0.2,-0.2,Matches,399.0,es ESP,DF,24.0,23.0,20.0,1756.0,19.5,0.0,1.0,1.0,0.0,0.0,0.0,2.0,0.0,0.2,0.2,0.9,1.1,37.0,57.0,87.0,0.0,0.05,0.05,0.0,0.05,0.01,0.05,0.06,0.01,0.06,Matches,Aihen Muñoz,D L,24,130,147,"Spain,Pays Basque",Real San Sebastián,8,12,13,9,12,10,10,12,12,14,12,9,15,13,15,13,13,13,14,8,13,13,7,11,8,15,14,16,14,13,14,8,13,13,14,12,13,6,13,9,11,4,2,1,2,3,1,1,1,2,1,3,15,12,6,18,13,14,13,11,1,20,1,1,15,1,1,1,1,1,1,1,1,1,175,72,20,8,3446145,6495,6495,3395,Mediterranean_Hispanic,131,1,1997/8/16,0,0,11339.0,,67246383
739,Vedat Muriqi,Mallorca,1994,403.0,xk KVX,FW,28.0,32.6,12.0,7.0,4.0,7.0,1.0,3.0,13.0,23.1,10.0,19.0,7.0,12.0,12.0,24.0,73.0,0.0,Matches,403.0,xk KVX,FW,28.0,32.6,48.0,1.47,32.0,0.0,2.0,7.0,6.0,1.0,5.0,0.15,3.0,0.0,0.0,0.0,1.0,1.0,Matches,,,,,,,,,,,,,,,,,,,,,,,,,,,,,,,,,,,,,,,,,,,,,,,,,,,,,,,,403.0,xk KVX,FW,28.0,32.6,6.0,1.0,0.0,59.0,39.0,29.0,11.0,12.0,7.0,1.0,0.0,0.0,88.0,198.0,156.0,55.9,Matches,403.0,xk KVX,FW,28.0,32.6,827.0,818.0,9.0,0.0,3.0,4.0,11.0,0.0,0.0,0.0,0.0,0.0,472.0,0.0,31.0,Matches,403.0,xk KVX,FW,28.0,32.6,472.0,827.0,57.1,6327.0,1330.0,307.0,426.0,72.1,125.0,257.0,48.6,18.0,49.0,36.7,3.0,2.1,1.7,0.9,21.0,43.0,6.0,0.0,60.0,Matches,494,xk KVX,FW,28,35,2937.0,84.0,85.9,32.6,34,85.0,16,1,36.0,0,1.4,32.0,35.0,-3.0,-0.09,0.47,29.2,39.1,-9.9,-0.3,-0.05,Matches,403.0,xk KVX,FW,28.0,32.6,1194.0,90.0,160.0,592.0,450.0,112.0,1189.0,31.0,12.0,38.7,15.0,48.4,601.0,2558.0,863.0,28.0,28.0,10.0,80.0,46.0,896.0,152.0,Matches,403.0,xk KVX,FW,28.0,32.6,15.0,71.0,25.0,35.2,2.18,0.77,0.15,0.44,15.3,0.0,4.0,5.0,12.5,8.6,0.12,2.5,2.4,Matches,403.0,xk KVX,FW,28.0,35.0,34.0,2937.0,32.6,15.0,3.0,18.0,11.0,4.0,5.0,6.0,1.0,12.5,8.6,2.1,10.6,28.0,60.0,152.0,0.46,0.09,0.55,0.34,0.43,0.38,0.06,0.45,0.26,0.33,Matches,Vedat Muriqi,S,28,131,142,"Kosovo,Albania",Mallorca,4,9,10,12,11,3,17,12,3,9,12,15,7,11,16,15,17,12,15,13,12,17,12,8,15,9,19,19,10,10,16,17,15,11,13,18,13,7,13,7,5,3,3,3,3,1,3,3,2,2,3,1,14,15,5,17,17,15,13,15,1,1,1,1,1,1,1,1,1,1,1,5,1,20,194,92,20,11,13910065,6550,7150,5500,Northern_European,129,1,1994/4/24,42,20,76922.0,,11022221
740,Yunus Musah,Valencia,2002,404.0,us USA,MF,19.0,23.4,48.0,35.0,17.0,23.0,8.0,20.0,30.0,66.7,10.0,20.0,1.0,19.0,11.0,59.0,16.0,2.0,Matches,404.0,us USA,MF,19.0,23.4,47.0,2.01,30.0,2.0,6.0,2.0,6.0,1.0,3.0,0.13,3.0,0.0,0.0,0.0,0.0,0.0,Matches,,,,,,,,,,,,,,,,,,,,,,,,,,,,,,,,,,,,,,,,,,,,,,,,,,,,,,,,404.0,us USA,MF,19.0,23.4,10.0,1.0,0.0,42.0,42.0,3.0,40.0,11.0,35.0,0.0,0.0,0.0,97.0,28.0,36.0,43.8,Matches,404.0,us USA,MF,19.0,23.4,771.0,757.0,12.0,3.0,3.0,11.0,40.0,9.0,0.0,0.0,0.0,0.0,604.0,2.0,29.0,Matches,404.0,us USA,MF,19.0,23.4,604.0,771.0,78.3,10218.0,2277.0,293.0,348.0,84.2,252.0,296.0,85.1,43.0,64.0,67.2,2.0,1.8,1.8,0.2,16.0,52.0,12.0,4.0,93.0,Matches,495,us USA,MF,19,33,2110.0,64.0,61.7,23.4,26,76.0,8,7,20.0,1,1.12,26.0,26.0,0.0,0.0,0.21,27.7,28.1,-0.4,-0.02,-0.45,Matches,404.0,us USA,MF,19.0,23.4,1030.0,27.0,154.0,487.0,405.0,51.0,1030.0,70.0,27.0,38.6,35.0,50.0,646.0,4812.0,2417.0,72.0,62.0,11.0,52.0,22.0,729.0,101.0,Matches,404.0,us USA,MF,19.0,23.4,0.0,22.0,3.0,13.6,0.94,0.13,0.0,0.0,18.4,0.0,0.0,0.0,1.8,1.8,0.08,-1.8,-1.8,Matches,404.0,us USA,MF,19.0,33.0,26.0,2110.0,23.4,0.0,2.0,2.0,0.0,0.0,0.0,10.0,1.0,1.8,1.8,1.8,3.6,72.0,93.0,101.0,0.0,0.09,0.09,0.0,0.09,0.08,0.08,0.15,0.08,0.15,Matches,Yunus Musah,M/AM RC,19,126,-85,"United States,England,Italy",Valencia,11,12,13,11,14,11,11,10,11,11,11,11,12,13,15,13,12,13,13,13,14,16,11,11,12,13,14,13,14,14,13,10,15,13,13,14,14,7,13,5,15,1,1,2,3,1,2,1,2,1,2,1,18,16,6,14,15,16,14,17,1,1,1,1,1,1,12,13,20,15,12,16,16,1,178,71,8,20,65100001,6300,6600,4000,African_Caribbean,129,17,2002/11/29,19,0,10000.0,,28129089
741,Nacho,Real Madrid,1990,406.0,es ESP,DF,32.0,18.2,24.0,16.0,17.0,5.0,2.0,12.0,29.0,41.4,17.0,11.0,6.0,5.0,18.0,42.0,37.0,0.0,Matches,406.0,es ESP,DF,32.0,18.2,32.0,1.76,24.0,0.0,5.0,3.0,0.0,0.0,2.0,0.11,1.0,0.0,1.0,0.0,0.0,0.0,Matches,,,,,,,,,,,,,,,,,,,,,,,,,,,,,,,,,,,,,,,,,,,,,,,,,,,,,,,,406.0,es ESP,DF,32.0,18.2,7.0,0.0,0.0,16.0,14.0,3.0,14.0,18.0,16.0,0.0,0.0,1.0,88.0,36.0,21.0,63.2,Matches,406.0,es ESP,DF,32.0,18.2,1184.0,1072.0,112.0,32.0,0.0,5.0,14.0,76.0,0.0,0.0,0.0,0.0,1085.0,0.0,7.0,Matches,406.0,es ESP,DF,32.0,18.2,1085.0,1184.0,91.6,16750.0,5906.0,577.0,612.0,94.3,427.0,454.0,94.1,53.0,74.0,71.6,1.0,0.9,0.7,0.1,12.0,79.0,8.0,1.0,75.0,Matches,497,es ESP,DF,32,27,1637.0,61.0,47.9,18.2,18,85.0,14,9,13.0,9,2.04,29.0,14.0,15.0,0.82,-0.39,32.5,16.8,15.8,0.87,-0.18,Matches,406.0,es ESP,DF,32.0,18.2,1327.0,95.0,503.0,629.0,205.0,19.0,1327.0,17.0,11.0,64.7,4.0,23.5,762.0,3224.0,1899.0,18.0,10.0,4.0,15.0,9.0,937.0,34.0,Matches,406.0,es ESP,DF,32.0,18.2,1.0,9.0,4.0,44.4,0.49,0.22,0.11,0.25,14.5,0.0,0.0,0.0,0.8,0.8,0.09,0.2,0.2,Matches,406.0,es ESP,DF,32.0,27.0,18.0,1637.0,18.2,1.0,1.0,2.0,1.0,0.0,0.0,7.0,0.0,0.8,0.8,0.9,1.7,18.0,75.0,34.0,0.05,0.05,0.11,0.05,0.11,0.04,0.05,0.09,0.04,0.09,Matches,Nacho,D RLC,32,153,155,Spain,R. Madrid,7,11,10,10,13,8,14,8,13,15,13,7,15,10,15,16,14,13,16,10,15,14,9,13,12,14,17,17,14,13,14,11,15,15,15,15,16,8,16,3,20,3,1,1,3,3,3,2,4,2,3,3,14,10,1,20,13,18,16,16,1,15,20,17,13,13,1,1,1,1,1,1,1,1,180,77,13,20,11695070,7650,7650,6650,Mediterranean_Hispanic,155,5,1990/1/18,22,1,154109.0,,67030696
742,Matija Nastasić,Mallorca,1993,408.0,rs SRB,DF,29.0,10.1,10.0,8.0,7.0,1.0,2.0,3.0,6.0,50.0,3.0,11.0,4.0,7.0,18.0,28.0,43.0,1.0,Matches,408.0,rs SRB,DF,29.0,10.1,6.0,0.6,4.0,0.0,0.0,1.0,0.0,1.0,0.0,0.0,0.0,0.0,0.0,0.0,0.0,0.0,Matches,,,,,,,,,,,,,,,,,,,,,,,,,,,,,,,,,,,,,,,,,,,,,,,,,,,,,,,,408.0,rs SRB,DF,29.0,10.1,3.0,0.0,0.0,12.0,0.0,1.0,1.0,18.0,8.0,0.0,0.0,0.0,31.0,9.0,6.0,60.0,Matches,408.0,rs SRB,DF,29.0,10.1,298.0,285.0,11.0,10.0,0.0,3.0,1.0,1.0,0.0,0.0,0.0,0.0,238.0,2.0,3.0,Matches,408.0,rs SRB,DF,29.0,10.1,238.0,298.0,79.9,5007.0,2120.0,75.0,87.0,86.2,128.0,137.0,93.4,35.0,70.0,50.0,0.0,0.0,0.2,0.0,0.0,24.0,4.0,0.0,25.0,Matches,499,rs SRB,DF,29,14,906.0,65.0,26.5,10.1,10,84.0,8,4,16.0,9,1.21,9.0,13.0,-4.0,-0.4,-0.33,6.9,13.2,-6.3,-0.63,-0.45,Matches,408.0,rs SRB,DF,29.0,10.1,392.0,59.0,219.0,162.0,13.0,6.0,392.0,0.0,0.0,,0.0,,202.0,833.0,432.0,4.0,2.0,0.0,2.0,0.0,221.0,1.0,Matches,408.0,rs SRB,DF,29.0,10.1,1.0,4.0,2.0,50.0,0.4,0.2,0.25,0.5,12.2,0.0,0.0,0.0,0.5,0.5,0.13,0.5,0.5,Matches,408.0,rs SRB,DF,29.0,14.0,10.0,906.0,10.1,1.0,0.0,1.0,1.0,0.0,0.0,3.0,0.0,0.5,0.5,0.0,0.5,4.0,25.0,1.0,0.1,0.0,0.1,0.1,0.1,0.05,0.0,0.05,0.05,0.05,Matches,Matija Nastasić,D C,29,125,146,Serbia,Mallorca,5,7,7,5,11,5,13,6,6,14,12,6,15,11,6,15,15,13,11,8,13,12,8,10,4,14,16,9,11,11,13,15,12,12,12,15,11,10,15,14,7,1,3,1,3,2,1,3,3,1,1,1,15,11,8,10,13,14,12,17,1,14,20,1,10,1,1,1,1,1,1,1,1,1,188,83,20,9,1794209,6250,6400,5500,Northern_European,124,5,1993/3/28,34,0,6639.0,,62055271
743,Jesús Navas,Sevilla,1985,410.0,es ESP,DFFW,36.0,22.0,19.0,12.0,8.0,3.0,8.0,11.0,22.0,50.0,11.0,18.0,7.0,11.0,22.0,41.0,52.0,1.0,Matches,410.0,es ESP,DFFW,36.0,22.0,60.0,2.73,57.0,1.0,0.0,0.0,2.0,0.0,8.0,0.36,6.0,1.0,0.0,0.0,1.0,0.0,Matches,,,,,,,,,,,,,,,,,,,,,,,,,,,,,,,,,,,,,,,,,,,,,,,,,,,,,,,,410.0,es ESP,DFFW,36.0,22.0,5.0,0.0,0.0,7.0,33.0,7.0,135.0,22.0,12.0,0.0,0.0,1.0,130.0,15.0,28.0,34.9,Matches,410.0,es ESP,DFFW,36.0,22.0,1332.0,1128.0,196.0,20.0,2.0,17.0,135.0,176.0,0.0,0.0,0.0,0.0,1000.0,8.0,41.0,Matches,410.0,es ESP,DFFW,36.0,22.0,1000.0,1332.0,75.1,17177.0,4865.0,492.0,549.0,89.6,394.0,517.0,76.2,93.0,177.0,52.5,0.0,2.8,3.2,-2.8,26.0,60.0,46.0,14.0,99.0,Matches,502,es ESP,DFFW,36,32,1981.0,62.0,57.9,22.0,21,78.0,12,11,31.0,4,1.47,32.0,27.0,5.0,0.23,0.98,25.4,27.8,-2.3,-0.11,0.24,Matches,410.0,es ESP,DFFW,36.0,22.0,1506.0,59.0,359.0,537.0,621.0,29.0,1506.0,22.0,11.0,50.0,6.0,27.3,867.0,4515.0,2101.0,46.0,33.0,9.0,17.0,10.0,976.0,207.0,Matches,410.0,es ESP,DFFW,36.0,22.0,0.0,10.0,3.0,30.0,0.45,0.14,0.0,0.0,24.8,0.0,0.0,0.0,0.3,0.3,0.03,-0.3,-0.3,Matches,410.0,es ESP,DFFW,36.0,32.0,21.0,1981.0,22.0,0.0,0.0,0.0,0.0,0.0,0.0,5.0,0.0,0.3,0.3,2.8,3.1,46.0,99.0,207.0,0.0,0.0,0.0,0.0,0.0,0.01,0.13,0.14,0.01,0.14,Matches,Jesús Navas,D/WB/M/AM R,36,145,161,Spain,Sevilla,8,14,14,9,13,7,5,11,4,10,11,7,11,13,9,13,11,12,14,11,13,16,13,13,15,14,15,18,15,15,13,6,16,16,15,8,17,10,14,12,12,3,4,1,1,2,3,2,2,3,3,2,5,14,10,19,11,18,14,13,1,1,1,20,1,19,1,1,1,18,1,1,16,1,170,60,11,20,347975206,7250,7250,6500,Mediterranean_Hispanic,130,7,1985/11/21,46,5,86538.0,,7456721
744,Tanguy Nianzou,Sevilla,2002,412.0,fr FRA,DF,20.0,15.2,20.0,15.0,10.0,9.0,1.0,8.0,11.0,72.7,3.0,8.0,5.0,3.0,16.0,36.0,44.0,3.0,Matches,412.0,fr FRA,DF,20.0,15.2,10.0,0.66,7.0,0.0,0.0,1.0,1.0,1.0,0.0,0.0,0.0,0.0,0.0,0.0,0.0,0.0,Matches,,,,,,,,,,,,,,,,,,,,,,,,,,,,,,,,,,,,,,,,,,,,,,,,,,,,,,,,412.0,fr FRA,DF,20.0,15.2,1.0,1.0,0.0,13.0,14.0,0.0,1.0,16.0,15.0,0.0,0.0,0.0,73.0,32.0,11.0,74.4,Matches,412.0,fr FRA,DF,20.0,15.2,772.0,748.0,22.0,20.0,1.0,3.0,1.0,1.0,0.0,0.0,0.0,0.0,676.0,2.0,5.0,Matches,412.0,fr FRA,DF,20.0,15.2,676.0,772.0,87.6,12120.0,4079.0,255.0,280.0,91.1,378.0,403.0,93.8,39.0,73.0,53.4,0.0,0.0,0.2,0.0,1.0,58.0,0.0,0.0,66.0,Matches,504,fr FRA,DF,20,19,1366.0,72.0,39.9,15.2,16,78.0,11,3,38.0,8,1.21,17.0,27.0,-10.0,-0.66,-0.79,16.8,23.7,-6.9,-0.45,-0.41,Matches,412.0,fr FRA,DF,20.0,15.2,894.0,73.0,368.0,498.0,35.0,11.0,894.0,12.0,10.0,83.3,2.0,16.7,547.0,2428.0,1383.0,4.0,6.0,0.0,4.0,3.0,627.0,0.0,Matches,412.0,fr FRA,DF,20.0,15.2,1.0,6.0,1.0,16.7,0.4,0.07,0.17,1.0,12.0,0.0,0.0,0.0,0.5,0.5,0.08,0.5,0.5,Matches,412.0,fr FRA,DF,20.0,19.0,16.0,1366.0,15.2,1.0,0.0,1.0,1.0,0.0,0.0,1.0,1.0,0.5,0.5,0.0,0.5,4.0,66.0,0.0,0.07,0.0,0.07,0.07,0.07,0.03,0.0,0.03,0.03,0.03,Matches,Tanguy Nianzou,D/DM C,20,134,-85,"France,Ivory Coast",Sevilla,4,7,12,7,12,4,16,7,5,13,14,6,13,13,16,13,14,15,13,13,13,16,12,12,10,14,14,13,12,11,15,16,13,13,13,15,12,13,12,8,14,1,1,2,2,3,4,2,2,1,2,1,10,16,12,12,12,13,12,10,1,1,20,10,1,1,16,1,15,1,1,1,1,1,191,85,9,20,66000000,6700,6400,5700,African_Caribbean,134,17,2002/6/7,0,0,76711.0,,49048365
745,Unai Núñez,Celta Vigo,1997,417.0,es ESP,DF,25.0,35.0,47.0,35.0,29.0,15.0,3.0,18.0,34.0,52.9,16.0,27.0,17.0,10.0,72.0,119.0,135.0,1.0,Matches,417.0,es ESP,DF,25.0,35.0,19.0,0.54,16.0,1.0,1.0,0.0,0.0,1.0,2.0,0.06,1.0,1.0,0.0,0.0,0.0,0.0,Matches,,,,,,,,,,,,,,,,,,,,,,,,,,,,,,,,,,,,,,,,,,,,,,,,,,,,,,,,417.0,es ESP,DF,25.0,35.0,8.0,0.0,0.0,25.0,31.0,1.0,3.0,72.0,35.0,0.0,0.0,1.0,205.0,70.0,53.0,56.9,Matches,417.0,es ESP,DF,25.0,35.0,2023.0,1967.0,53.0,49.0,0.0,34.0,3.0,4.0,0.0,0.0,0.0,0.0,1744.0,3.0,11.0,Matches,417.0,es ESP,DF,25.0,35.0,1744.0,2023.0,86.2,35775.0,12950.0,501.0,553.0,90.6,1032.0,1124.0,91.8,203.0,316.0,64.2,0.0,0.1,0.4,-0.1,5.0,131.0,2.0,1.0,146.0,Matches,510,es ESP,DF,25,36,3151.0,88.0,92.1,35.0,35,90.0,35,1,1.0,1,1.19,41.0,48.0,-7.0,-0.2,0.8,37.8,41.9,-4.1,-0.12,-0.55,Matches,417.0,es ESP,DF,25.0,35.0,2366.0,268.0,1197.0,1100.0,83.0,22.0,2366.0,13.0,11.0,84.6,2.0,15.4,1504.0,8027.0,4468.0,31.0,25.0,1.0,17.0,2.0,1587.0,5.0,Matches,417.0,es ESP,DF,25.0,35.0,0.0,15.0,5.0,33.3,0.43,0.14,0.0,0.0,14.4,0.0,0.0,0.0,1.2,1.2,0.08,-1.2,-1.2,Matches,417.0,es ESP,DF,25.0,36.0,35.0,3151.0,35.0,0.0,0.0,0.0,0.0,0.0,0.0,8.0,0.0,1.2,1.2,0.1,1.3,31.0,146.0,5.0,0.0,0.0,0.0,0.0,0.0,0.03,0.0,0.04,0.03,0.04,Matches,Unai Núñez,D C,25,132,152,"Spain,Pays Basque",A. Bilbao,7,7,7,8,11,8,14,10,10,15,11,9,15,10,14,12,15,12,12,10,13,13,7,11,8,14,15,14,12,12,11,14,14,12,14,14,13,12,10,5,11,3,1,2,1,4,1,3,3,1,1,1,17,13,7,15,14,14,12,12,1,1,20,13,1,10,1,1,1,1,1,1,1,1,186,81,10,20,15628426,6600,6600,5850,Mediterranean_Hispanic,131,4,1997/1/30,1,0,13421.0,Vigo,67214595
746,Jan Oblak,Atlético Madrid,1993,418.0,si SVN,GK,29.0,27.7,0.0,0.0,0.0,0.0,0.0,0.0,0.0,,0.0,0.0,0.0,0.0,1.0,1.0,8.0,0.0,Matches,418.0,si SVN,GK,29.0,27.7,2.0,0.07,2.0,0.0,0.0,0.0,0.0,0.0,0.0,0.0,0.0,0.0,0.0,0.0,0.0,0.0,Matches,30.0,si SVN,GK,29.0,27.7,20.0,1.0,1.0,1.0,0.0,21.9,0.27,1.9,0.07,120.0,374.0,32.1,586.0,115.0,40.4,36.1,228.0,60.1,46.0,358.0,25.0,7.0,19.0,0.69,14.2,Matches,30.0,si SVN,GK,29.0,28.0,28.0,2492.0,27.7,20.0,0.72,79.0,59.0,75.9,17.0,5.0,6.0,11.0,39.3,2.0,1.0,0.0,1.0,0.0,Matches,418.0,si SVN,GK,29.0,27.7,1.0,0.0,0.0,0.0,3.0,0.0,0.0,1.0,0.0,0.0,0.0,0.0,24.0,2.0,0.0,100.0,Matches,418.0,si SVN,GK,29.0,27.7,817.0,522.0,292.0,64.0,0.0,1.0,0.0,0.0,0.0,0.0,0.0,0.0,538.0,3.0,0.0,Matches,418.0,si SVN,GK,29.0,27.7,538.0,817.0,65.9,15674.0,11619.0,99.0,99.0,100.0,239.0,243.0,98.4,197.0,469.0,42.0,0.0,0.0,0.0,0.0,0.0,5.0,0.0,0.0,0.0,Matches,511,si SVN,GK,29,28,2492.0,89.0,72.9,27.7,28,89.0,26,0,,0,2.0,42.0,20.0,22.0,0.79,-0.66,44.0,26.1,18.0,0.65,0.38,Matches,418.0,si SVN,GK,29.0,27.7,861.0,783.0,857.0,4.0,0.0,0.0,861.0,1.0,1.0,100.0,0.0,0.0,416.0,2241.0,1218.0,0.0,1.0,1.0,0.0,0.0,345.0,0.0,Matches,418.0,si SVN,GK,29.0,27.7,0.0,0.0,0.0,,0.0,0.0,,,,0.0,0.0,0.0,0.0,0.0,,0.0,0.0,Matches,418.0,si SVN,GK,29.0,28.0,28.0,2492.0,27.7,0.0,0.0,0.0,0.0,0.0,0.0,1.0,0.0,0.0,0.0,0.0,0.0,0.0,0.0,0.0,0.0,0.0,0.0,0.0,0.0,0.0,0.0,0.0,0.0,0.0,Matches,Jan Oblak,GK,29,172,178,Slovenia,A. Madrid,5,3,1,3,12,9,1,1,1,1,14,12,2,11,8,11,13,17,16,8,16,15,15,11,3,16,13,13,11,13,13,13,9,13,13,13,16,9,15,5,16,15,15,15,4,18,16,16,19,15,9,14,14,19,7,13,16,10,15,14,20,1,1,1,1,1,1,1,1,1,1,1,1,1,189,84,8,20,120000002,8600,8600,8050,Northern_European,168,5,1993/1/7,50,0,356125.0,,64016316
747,Brian Ocampo,Cádiz,1999,419.0,uy URU,MFFW,23.0,12.4,18.0,15.0,12.0,5.0,1.0,8.0,21.0,38.1,13.0,13.0,0.0,13.0,3.0,21.0,3.0,0.0,Matches,419.0,uy URU,MFFW,23.0,12.4,40.0,3.22,29.0,4.0,5.0,0.0,2.0,0.0,5.0,0.4,3.0,0.0,2.0,0.0,0.0,0.0,Matches,,,,,,,,,,,,,,,,,,,,,,,,,,,,,,,,,,,,,,,,,,,,,,,,,,,,,,,,419.0,uy URU,MFFW,23.0,12.4,2.0,0.0,0.0,32.0,27.0,2.0,34.0,3.0,15.0,0.0,0.0,0.0,92.0,7.0,13.0,35.0,Matches,419.0,uy URU,MFFW,23.0,12.4,369.0,338.0,27.0,5.0,0.0,3.0,34.0,5.0,17.0,11.0,3.0,1.0,274.0,4.0,11.0,Matches,419.0,uy URU,MFFW,23.0,12.4,274.0,369.0,74.3,3846.0,1051.0,177.0,207.0,85.5,61.0,86.0,70.9,22.0,41.0,53.7,1.0,1.7,1.7,-0.7,16.0,13.0,15.0,6.0,22.0,Matches,512,uy URU,MFFW,23,18,1119.0,62.0,32.7,12.4,15,69.0,2,3,26.0,1,1.17,10.0,17.0,-7.0,-0.56,0.06,10.2,19.3,-9.1,-0.73,-0.3,Matches,419.0,uy URU,MFFW,23.0,12.4,493.0,12.0,91.0,192.0,228.0,19.0,493.0,45.0,19.0,42.2,18.0,40.0,330.0,2359.0,1302.0,40.0,29.0,10.0,30.0,28.0,349.0,81.0,Matches,419.0,uy URU,MFFW,23.0,12.4,1.0,13.0,2.0,15.4,1.05,0.16,0.08,0.5,21.3,0.0,0.0,0.0,0.5,0.5,0.04,0.5,0.5,Matches,419.0,uy URU,MFFW,23.0,18.0,15.0,1119.0,12.4,1.0,1.0,2.0,1.0,0.0,0.0,2.0,0.0,0.5,0.5,1.7,2.2,40.0,22.0,81.0,0.08,0.08,0.16,0.08,0.16,0.04,0.14,0.18,0.04,0.18,Matches,Brian Ocampo,AM/S RL,23,130,141,Uruguay,Cádiz,14,15,15,13,16,14,14,13,12,5,13,8,4,15,13,12,8,9,6,13,9,11,16,7,13,7,11,10,16,15,9,7,8,14,10,6,6,7,9,12,12,1,2,4,1,2,1,3,3,3,1,2,8,14,10,9,5,9,9,8,1,1,1,1,1,1,1,11,1,14,18,8,20,16,172,67,10,20,3957817,6500,6500,6200,Mixed_Race,123,9,1999/6/25,1,0,9724.0,,78088553
748,Lucas Ocampos,Sevilla,1994,420.0,ar ARG,FWMF,28.0,12.9,22.0,14.0,9.0,9.0,4.0,8.0,31.0,25.8,23.0,17.0,2.0,15.0,8.0,30.0,5.0,0.0,Matches,420.0,ar ARG,FWMF,28.0,12.9,30.0,2.32,25.0,0.0,2.0,0.0,2.0,1.0,2.0,0.15,1.0,0.0,0.0,0.0,1.0,0.0,Matches,,,,,,,,,,,,,,,,,,,,,,,,,,,,,,,,,,,,,,,,,,,,,,,,,,,,,,,,420.0,ar ARG,FWMF,28.0,12.9,7.0,0.0,0.0,15.0,24.0,6.0,26.0,8.0,14.0,1.0,0.0,0.0,74.0,30.0,16.0,65.2,Matches,420.0,ar ARG,FWMF,28.0,12.9,450.0,418.0,27.0,2.0,0.0,2.0,26.0,18.0,1.0,0.0,0.0,0.0,333.0,5.0,13.0,Matches,420.0,ar ARG,FWMF,28.0,12.9,333.0,450.0,74.0,4746.0,848.0,203.0,245.0,82.9,100.0,131.0,76.3,16.0,35.0,45.7,0.0,1.4,1.3,-1.4,13.0,16.0,12.0,4.0,37.0,Matches,513,ar ARG,FWMF,28,19,1165.0,61.0,34.1,12.9,11,84.0,6,8,30.0,3,1.58,20.0,20.0,0.0,0.0,0.28,18.2,15.9,2.2,0.17,0.58,Matches,420.0,ar ARG,FWMF,28.0,12.9,632.0,13.0,64.0,265.0,314.0,64.0,629.0,61.0,25.0,41.0,34.0,55.7,421.0,2416.0,1095.0,33.0,27.0,16.0,40.0,17.0,461.0,113.0,Matches,420.0,ar ARG,FWMF,28.0,12.9,4.0,27.0,6.0,22.2,2.09,0.46,0.04,0.17,16.4,0.0,3.0,3.0,4.5,2.1,0.08,-0.5,-1.1,Matches,420.0,ar ARG,FWMF,28.0,19.0,11.0,1165.0,12.9,4.0,0.0,4.0,1.0,3.0,3.0,7.0,0.0,4.5,2.1,1.4,3.5,33.0,37.0,113.0,0.31,0.0,0.31,0.08,0.08,0.35,0.11,0.45,0.17,0.27,Matches,Lucas Ocampos,AM RL,28,152,155,"Argentina,Spain",Sevilla,10,12,16,15,14,9,13,14,12,4,12,15,7,14,14,13,15,13,12,10,11,16,16,8,16,7,15,16,15,15,13,13,14,16,15,14,13,8,13,5,14,3,1,2,2,3,1,1,2,1,3,3,11,15,6,13,14,13,7,11,1,1,1,1,1,1,1,15,1,15,19,10,20,14,187,84,12,20,49692502,7595,7595,5995,Mediterranean_Hispanic,150,3,1994/7/11,10,2,29897.0,AFC Ajax,14031132
749,Lucas Olaza,Valladolid,1994,423.0,uy URU,DF,28.0,16.6,24.0,14.0,12.0,10.0,2.0,17.0,26.0,65.4,9.0,20.0,8.0,12.0,14.0,38.0,34.0,0.0,Matches,423.0,uy URU,DF,28.0,16.6,29.0,1.75,20.0,7.0,1.0,0.0,1.0,0.0,1.0,0.06,1.0,0.0,0.0,0.0,0.0,0.0,Matches,,,,,,,,,,,,,,,,,,,,,,,,,,,,,,,,,,,,,,,,,,,,,,,,,,,,,,,,423.0,uy URU,DF,28.0,16.6,3.0,0.0,0.0,12.0,20.0,2.0,71.0,14.0,14.0,0.0,0.0,0.0,72.0,27.0,30.0,47.4,Matches,423.0,uy URU,DF,28.0,16.6,797.0,596.0,199.0,27.0,0.0,3.0,71.0,153.0,19.0,1.0,16.0,0.0,606.0,2.0,28.0,Matches,423.0,uy URU,DF,28.0,16.6,606.0,797.0,76.0,10317.0,4171.0,271.0,308.0,88.0,263.0,321.0,81.9,53.0,111.0,47.7,1.0,1.0,1.0,0.0,16.0,34.0,17.0,8.0,66.0,Matches,516,uy URU,DF,28,23,1494.0,65.0,43.7,16.6,16,81.0,10,7,27.0,10,1.0,13.0,27.0,-14.0,-0.84,-0.1,15.0,28.8,-13.8,-0.83,-0.23,Matches,423.0,uy URU,DF,28.0,16.6,929.0,55.0,263.0,404.0,268.0,11.0,929.0,11.0,4.0,36.4,7.0,63.6,413.0,1428.0,707.0,12.0,15.0,1.0,14.0,7.0,480.0,90.0,Matches,423.0,uy URU,DF,28.0,16.6,0.0,5.0,2.0,40.0,0.3,0.12,0.0,0.0,26.4,2.0,0.0,0.0,0.4,0.4,0.08,-0.4,-0.4,Matches,423.0,uy URU,DF,28.0,23.0,16.0,1494.0,16.6,0.0,1.0,1.0,0.0,0.0,0.0,3.0,0.0,0.4,0.4,1.0,1.4,12.0,66.0,90.0,0.0,0.06,0.06,0.0,0.06,0.02,0.06,0.08,0.02,0.08,Matches,Lucas Olaza,D/WB L,28,122,135,Uruguay,Valladolid,13,15,11,10,11,15,9,13,15,13,12,13,13,12,11,14,12,13,13,11,13,11,10,11,13,11,12,12,14,13,12,10,15,13,13,10,12,12,12,8,11,2,3,3,1,3,2,2,1,2,3,3,14,12,5,8,9,11,14,8,1,20,1,1,16,1,1,12,1,1,1,1,1,1,173,68,20,6,1412938,6100,6100,3250,Mediterranean_Hispanic,123,9,1994/7/21,0,0,4790.0,,78048502
750,Cenk Özkacar,Valencia,2000,429.0,tr TUR,DF,21.0,15.2,27.0,20.0,17.0,10.0,0.0,14.0,19.0,73.7,5.0,14.0,2.0,12.0,12.0,39.0,47.0,4.0,Matches,429.0,tr TUR,DF,21.0,15.2,18.0,1.19,15.0,0.0,0.0,3.0,0.0,0.0,0.0,0.0,0.0,0.0,0.0,0.0,0.0,0.0,Matches,,,,,,,,,,,,,,,,,,,,,,,,,,,,,,,,,,,,,,,,,,,,,,,,,,,,,,,,429.0,tr TUR,DF,21.0,15.2,1.0,0.0,0.0,7.0,10.0,0.0,3.0,12.0,20.0,0.0,0.0,0.0,106.0,49.0,34.0,59.0,Matches,429.0,tr TUR,DF,21.0,15.2,769.0,744.0,23.0,18.0,0.0,16.0,3.0,2.0,0.0,0.0,0.0,0.0,646.0,2.0,8.0,Matches,429.0,tr TUR,DF,21.0,15.2,646.0,769.0,84.0,12014.0,4500.0,274.0,315.0,87.0,308.0,341.0,90.3,60.0,91.0,65.9,0.0,0.2,0.3,-0.2,4.0,54.0,3.0,1.0,61.0,Matches,522,tr TUR,DF,21,17,1365.0,80.0,39.9,15.2,14,87.0,13,3,50.0,19,1.24,13.0,18.0,-5.0,-0.33,-0.42,19.3,18.0,1.3,0.08,-0.12,Matches,429.0,tr TUR,DF,21.0,15.2,908.0,85.0,409.0,462.0,45.0,16.0,908.0,10.0,10.0,100.0,0.0,0.0,522.0,3193.0,2132.0,23.0,18.0,0.0,8.0,4.0,549.0,2.0,Matches,429.0,tr TUR,DF,21.0,15.2,0.0,11.0,2.0,18.2,0.73,0.13,0.0,0.0,12.8,0.0,0.0,0.0,0.8,0.8,0.07,-0.8,-0.8,Matches,429.0,tr TUR,DF,21.0,17.0,14.0,1365.0,15.2,0.0,0.0,0.0,0.0,0.0,0.0,1.0,0.0,0.8,0.8,0.2,1.0,23.0,61.0,2.0,0.0,0.0,0.0,0.0,0.0,0.05,0.02,0.07,0.05,0.07,Matches,Cenk Özkacar,D C,21,105,135,Turkey,Olympique Lyonnais,5,5,8,5,12,5,13,5,6,12,11,8,13,11,10,10,14,12,11,9,10,11,7,5,6,10,10,10,13,10,12,16,12,13,13,14,12,10,10,7,15,1,3,2,1,3,2,2,3,3,1,3,8,11,6,11,12,10,11,19,1,12,20,1,1,1,1,1,1,1,1,1,1,1,190,90,20,10,1638749,5250,5250,2000,Mediterranean_Hispanic,103,5,2000/10/6,1,0,11506.0,Valencia,70118933
751,Fernando Pacheco,Espanyol,1992,431.0,es ESP,GK,30.0,16.0,0.0,0.0,0.0,0.0,0.0,0.0,1.0,0.0,1.0,0.0,0.0,0.0,1.0,1.0,11.0,0.0,Matches,431.0,es ESP,GK,30.0,16.0,5.0,0.31,3.0,2.0,0.0,0.0,0.0,0.0,0.0,0.0,0.0,0.0,0.0,0.0,0.0,0.0,Matches,31.0,es ESP,GK,30.0,16.0,33.0,4.0,0.0,3.0,0.0,26.6,0.25,-6.4,-0.4,127.0,272.0,46.7,417.0,56.0,42.4,36.2,137.0,69.3,49.6,242.0,16.0,6.6,19.0,1.19,13.8,Matches,31.0,es ESP,GK,30.0,16.0,16.0,1440.0,16.0,33.0,2.06,88.0,54.0,67.0,4.0,3.0,9.0,3.0,18.8,5.0,4.0,1.0,0.0,20.0,Matches,431.0,es ESP,GK,30.0,16.0,0.0,0.0,0.0,0.0,4.0,0.0,0.0,1.0,0.0,0.0,0.0,0.0,13.0,4.0,1.0,80.0,Matches,431.0,es ESP,GK,30.0,16.0,557.0,367.0,187.0,50.0,0.0,0.0,0.0,0.0,0.0,0.0,0.0,0.0,399.0,3.0,0.0,Matches,431.0,es ESP,GK,30.0,16.0,399.0,557.0,71.6,12946.0,10565.0,54.0,55.0,98.2,174.0,176.0,98.9,171.0,323.0,52.9,0.0,0.2,0.1,-0.2,3.0,22.0,1.0,0.0,2.0,Matches,524,es ESP,GK,30,16,1440.0,90.0,42.1,16.0,16,90.0,16,0,,3,0.94,23.0,33.0,-10.0,-0.62,-0.31,23.1,31.4,-8.3,-0.52,-0.37,Matches,431.0,es ESP,GK,30.0,16.0,598.0,504.0,591.0,7.0,0.0,0.0,598.0,0.0,0.0,,0.0,,317.0,1818.0,1179.0,0.0,0.0,0.0,0.0,0.0,233.0,0.0,Matches,431.0,es ESP,GK,30.0,16.0,0.0,0.0,0.0,,0.0,0.0,,,,0.0,0.0,0.0,0.0,0.0,,0.0,0.0,Matches,431.0,es ESP,GK,30.0,16.0,16.0,1440.0,16.0,0.0,0.0,0.0,0.0,0.0,0.0,0.0,0.0,0.0,0.0,0.2,0.2,0.0,2.0,0.0,0.0,0.0,0.0,0.0,0.0,0.0,0.02,0.02,0.0,0.02,Matches,Fernando Pacheco,GK,30,143,145,Spain,Almería,3,3,3,1,12,6,8,2,1,3,13,3,3,12,8,13,13,12,14,11,12,13,5,11,1,13,14,13,10,14,9,12,11,12,10,14,11,8,13,12,12,12,13,14,10,15,14,14,16,15,14,14,11,12,7,14,11,14,13,13,20,1,1,1,1,1,1,1,1,1,1,1,1,1,186,81,20,10,15027338,7000,7000,5500,Mediterranean_Hispanic,140,6,1992/5/18,0,0,19549.0,,67155103
752,Jon Pacheco,Real Sociedad,2001,432.0,es ESP,DF,21.0,13.3,16.0,10.0,10.0,6.0,0.0,6.0,10.0,60.0,4.0,9.0,6.0,3.0,12.0,28.0,37.0,1.0,Matches,432.0,es ESP,DF,21.0,13.3,4.0,0.3,3.0,1.0,0.0,0.0,0.0,0.0,1.0,0.08,1.0,0.0,0.0,0.0,0.0,0.0,Matches,,,,,,,,,,,,,,,,,,,,,,,,,,,,,,,,,,,,,,,,,,,,,,,,,,,,,,,,432.0,es ESP,DF,21.0,13.3,2.0,0.0,0.0,18.0,11.0,1.0,0.0,12.0,10.0,0.0,1.0,0.0,55.0,30.0,23.0,56.6,Matches,432.0,es ESP,DF,21.0,13.3,907.0,859.0,43.0,32.0,1.0,8.0,0.0,4.0,0.0,0.0,0.0,0.0,812.0,5.0,4.0,Matches,432.0,es ESP,DF,21.0,13.3,812.0,907.0,89.5,15784.0,4590.0,262.0,280.0,93.6,464.0,490.0,94.7,78.0,117.0,66.7,1.0,0.1,0.1,0.9,1.0,51.0,0.0,0.0,48.0,Matches,525,es ESP,DF,21,17,1193.0,70.0,34.9,13.3,12,90.0,12,5,23.0,16,2.29,21.0,13.0,8.0,0.6,0.28,18.9,10.3,8.6,0.65,0.2,Matches,432.0,es ESP,DF,21.0,13.3,994.0,98.0,423.0,561.0,13.0,3.0,994.0,3.0,2.0,66.7,1.0,33.3,641.0,3442.0,2104.0,18.0,4.0,0.0,4.0,2.0,703.0,0.0,Matches,432.0,es ESP,DF,21.0,13.3,0.0,3.0,0.0,0.0,0.23,0.0,0.0,,17.3,0.0,0.0,0.0,0.1,0.1,0.02,-0.1,-0.1,Matches,432.0,es ESP,DF,21.0,17.0,12.0,1193.0,13.3,0.0,1.0,1.0,0.0,0.0,0.0,2.0,0.0,0.1,0.1,0.1,0.2,18.0,48.0,0.0,0.0,0.08,0.08,0.0,0.08,0.01,0.01,0.01,0.01,0.01,Matches,Jon Pacheco,D C,21,124,-75,"Spain,Pays Basque",Real San Sebastián,8,7,6,10,14,11,14,10,9,14,17,7,13,17,14,14,12,14,14,13,12,16,7,11,10,17,12,13,10,13,13,10,13,12,11,10,16,6,12,11,17,3,2,2,3,3,1,1,3,2,2,3,10,9,1,11,12,11,11,13,1,12,20,1,1,1,1,1,1,1,1,1,1,1,184,77,20,12,30000000,6200,6200,4102,Mediterranean_Hispanic,129,1,2001/1/8,0,0,7024.0,,67269422
753,Helibelton Palacios,Elche,1993,434.0,co COL,DF,29.0,21.3,38.0,20.0,21.0,15.0,2.0,19.0,26.0,73.1,7.0,26.0,12.0,14.0,20.0,58.0,55.0,0.0,Matches,434.0,co COL,DF,29.0,21.3,21.0,0.99,18.0,2.0,0.0,0.0,1.0,0.0,0.0,0.0,0.0,0.0,0.0,0.0,0.0,0.0,Matches,,,,,,,,,,,,,,,,,,,,,,,,,,,,,,,,,,,,,,,,,,,,,,,,,,,,,,,,434.0,co COL,DF,29.0,21.3,6.0,0.0,0.0,30.0,19.0,0.0,18.0,20.0,20.0,0.0,0.0,0.0,118.0,21.0,25.0,45.7,Matches,434.0,co COL,DF,29.0,21.3,835.0,672.0,162.0,18.0,0.0,4.0,18.0,144.0,0.0,0.0,0.0,0.0,623.0,1.0,20.0,Matches,434.0,co COL,DF,29.0,21.3,623.0,835.0,74.6,10355.0,5114.0,309.0,344.0,89.8,245.0,320.0,76.6,54.0,126.0,42.9,0.0,0.7,0.9,-0.7,7.0,49.0,7.0,4.0,51.0,Matches,527,co COL,DF,29,24,1915.0,80.0,56.0,21.3,23,81.0,16,1,45.0,2,0.63,15.0,41.0,-26.0,-1.22,-0.56,19.4,40.7,-21.3,-1.0,-0.32,Matches,434.0,co COL,DF,29.0,21.3,1030.0,82.0,427.0,497.0,122.0,9.0,1030.0,28.0,14.0,50.0,10.0,35.7,508.0,2535.0,1514.0,25.0,17.0,0.0,10.0,7.0,516.0,25.0,Matches,434.0,co COL,DF,29.0,21.3,0.0,4.0,3.0,75.0,0.19,0.14,0.0,0.0,13.8,0.0,0.0,0.0,0.4,0.4,0.09,-0.4,-0.4,Matches,434.0,co COL,DF,29.0,24.0,23.0,1915.0,21.3,0.0,0.0,0.0,0.0,0.0,0.0,6.0,0.0,0.4,0.4,0.7,1.1,25.0,51.0,25.0,0.0,0.0,0.0,0.0,0.0,0.02,0.04,0.05,0.02,0.05,Matches,Helibelton Palacios,D/WB R,29,124,130,Colombia,Elche,2,13,11,3,12,4,9,5,13,12,12,5,10,12,4,12,14,11,11,11,12,13,11,14,12,9,12,16,13,12,12,12,13,13,15,14,11,6,10,10,12,3,3,2,1,1,2,1,2,2,3,1,14,11,5,15,12,17,16,12,1,1,1,18,1,20,1,1,1,14,1,1,1,1,180,78,9,20,1088896,6100,6000,4500,African_Caribbean,115,14,1993/6/9,5,0,4790.0,,76022083
754,Gabriel Paulista,Valencia,1990,442.0,br BRA,DF,31.0,16.7,17.0,9.0,13.0,4.0,0.0,13.0,19.0,68.4,6.0,22.0,14.0,8.0,32.0,49.0,79.0,2.0,Matches,442.0,br BRA,DF,31.0,16.7,8.0,0.48,7.0,0.0,0.0,1.0,0.0,0.0,0.0,0.0,0.0,0.0,0.0,0.0,0.0,0.0,Matches,,,,,,,,,,,,,,,,,,,,,,,,,,,,,,,,,,,,,,,,,,,,,,,,,,,,,,,,442.0,br BRA,DF,31.0,16.7,4.0,2.0,1.0,12.0,11.0,0.0,0.0,32.0,9.0,0.0,1.0,0.0,83.0,42.0,30.0,58.3,Matches,442.0,br BRA,DF,31.0,16.7,769.0,705.0,62.0,36.0,0.0,10.0,0.0,6.0,0.0,0.0,0.0,0.0,645.0,2.0,4.0,Matches,442.0,br BRA,DF,31.0,16.7,645.0,769.0,83.9,12734.0,5198.0,221.0,251.0,88.0,329.0,373.0,88.2,87.0,127.0,68.5,0.0,0.3,0.4,-0.3,5.0,53.0,4.0,0.0,61.0,Matches,536,br BRA,DF,31,21,1504.0,72.0,44.0,16.7,18,82.0,13,3,9.0,8,1.24,20.0,24.0,-4.0,-0.24,-0.29,21.5,19.6,2.0,0.12,-0.07,Matches,442.0,br BRA,DF,31.0,16.7,959.0,162.0,475.0,446.0,42.0,20.0,959.0,0.0,0.0,,0.0,,454.0,2724.0,1916.0,12.0,10.0,0.0,5.0,1.0,516.0,1.0,Matches,442.0,br BRA,DF,31.0,16.7,1.0,14.0,2.0,14.3,0.84,0.12,0.07,0.5,17.4,0.0,0.0,0.0,0.7,0.7,0.05,0.3,0.3,Matches,442.0,br BRA,DF,31.0,21.0,18.0,1504.0,16.7,1.0,0.0,1.0,1.0,0.0,0.0,4.0,2.0,0.7,0.7,0.3,0.9,12.0,61.0,1.0,0.06,0.0,0.06,0.06,0.06,0.04,0.02,0.05,0.04,0.05,Matches,Gabriel Paulista,D C,31,150,155,"Brazil,Spain",Valencia,5,10,10,8,12,8,15,10,10,14,12,6,15,12,17,15,16,12,14,10,13,17,6,15,11,14,15,17,15,13,14,15,15,15,15,15,14,15,12,7,14,3,2,2,1,2,1,2,1,3,1,3,14,15,10,10,13,15,9,10,1,12,20,14,8,8,1,1,1,1,1,1,1,1,187,72,10,20,347975206,7250,7000,6000,Mixed_Race,151,4,1990/11/26,0,0,90479.0,,19127830
755,Alfonso Pedraza,Villarreal,1996,443.0,es ESP,DF,26.0,18.1,35.0,26.0,20.0,10.0,5.0,19.0,29.0,65.5,10.0,19.0,1.0,18.0,18.0,53.0,31.0,0.0,Matches,443.0,es ESP,DF,26.0,18.1,39.0,2.15,30.0,0.0,5.0,3.0,0.0,1.0,5.0,0.28,4.0,0.0,1.0,0.0,0.0,0.0,Matches,,,,,,,,,,,,,,,,,,,,,,,,,,,,,,,,,,,,,,,,,,,,,,,,,,,,,,,,443.0,es ESP,DF,26.0,18.1,5.0,0.0,0.0,20.0,15.0,2.0,76.0,18.0,26.0,0.0,0.0,0.0,88.0,12.0,12.0,50.0,Matches,443.0,es ESP,DF,26.0,18.1,832.0,673.0,158.0,8.0,0.0,2.0,76.0,148.0,2.0,1.0,0.0,0.0,641.0,1.0,32.0,Matches,443.0,es ESP,DF,26.0,18.1,641.0,832.0,77.0,9606.0,2553.0,366.0,401.0,91.3,221.0,283.0,78.1,35.0,80.0,43.8,3.0,2.0,1.3,1.0,18.0,22.0,19.0,9.0,31.0,Matches,538,es ESP,DF,26,26,1633.0,63.0,47.7,18.1,20,78.0,11,6,13.0,2,1.92,28.0,15.0,13.0,0.72,0.41,28.4,23.3,5.1,0.28,-0.06,Matches,443.0,es ESP,DF,26.0,18.1,1049.0,44.0,287.0,353.0,423.0,47.0,1049.0,59.0,21.0,35.6,32.0,54.2,555.0,4093.0,2265.0,68.0,46.0,14.0,30.0,14.0,607.0,145.0,Matches,443.0,es ESP,DF,26.0,18.1,0.0,26.0,10.0,38.5,1.43,0.55,0.0,0.0,18.4,0.0,0.0,0.0,1.2,1.2,0.05,-1.2,-1.2,Matches,443.0,es ESP,DF,26.0,26.0,20.0,1633.0,18.1,0.0,3.0,3.0,0.0,0.0,0.0,5.0,0.0,1.2,1.2,2.0,3.2,68.0,31.0,145.0,0.0,0.17,0.17,0.0,0.17,0.07,0.11,0.18,0.07,0.18,Matches,Alfonso Pedraza,D/WB/M/AM L,26,144,148,Spain,Villarreal,12,15,12,11,12,9,12,12,13,12,12,11,12,12,16,14,12,11,14,11,13,13,12,9,15,13,14,14,15,13,12,11,14,16,15,12,14,13,8,5,13,3,1,1,2,3,2,3,3,1,1,1,16,11,6,10,7,10,15,14,1,20,1,1,18,1,1,16,1,11,16,10,11,1,184,73,20,8,21999999,7200,7200,4750,Mediterranean_Hispanic,136,6,1996/4/9,0,0,31542.0,,67212046
756,Pedri,Barcelona,2002,444.0,es ESP,MF,19.0,22.0,39.0,22.0,15.0,17.0,7.0,13.0,45.0,28.9,32.0,27.0,0.0,27.0,13.0,52.0,8.0,1.0,Matches,444.0,es ESP,MF,19.0,22.0,87.0,3.96,74.0,6.0,1.0,2.0,3.0,1.0,11.0,0.5,11.0,0.0,0.0,0.0,0.0,0.0,Matches,,,,,,,,,,,,,,,,,,,,,,,,,,,,,,,,,,,,,,,,,,,,,,,,,,,,,,,,444.0,es ESP,MF,19.0,22.0,2.0,0.0,0.0,8.0,43.0,4.0,25.0,13.0,22.0,0.0,0.0,0.0,134.0,3.0,5.0,37.5,Matches,444.0,es ESP,MF,19.0,22.0,1449.0,1384.0,59.0,22.0,24.0,24.0,25.0,11.0,13.0,1.0,11.0,0.0,1251.0,6.0,25.0,Matches,444.0,es ESP,MF,19.0,22.0,1251.0,1449.0,86.3,22516.0,4967.0,574.0,632.0,90.8,485.0,546.0,88.8,164.0,198.0,82.8,1.0,5.0,5.3,-4.0,42.0,161.0,30.0,2.0,184.0,Matches,539,es ESP,MF,19,26,1976.0,76.0,57.8,22.0,22,83.0,12,4,38.0,0,2.62,47.0,9.0,38.0,1.73,0.98,48.6,17.6,31.0,1.41,0.7,Matches,444.0,es ESP,MF,19.0,22.0,1652.0,13.0,161.0,954.0,556.0,58.0,1652.0,61.0,36.0,59.0,22.0,36.1,1202.0,6987.0,3387.0,67.0,81.0,14.0,32.0,31.0,1334.0,99.0,Matches,444.0,es ESP,MF,19.0,22.0,6.0,22.0,9.0,40.9,1.0,0.41,0.27,0.67,15.9,0.0,0.0,0.0,4.9,4.9,0.22,1.1,1.1,Matches,444.0,es ESP,MF,19.0,26.0,22.0,1976.0,22.0,6.0,1.0,7.0,6.0,0.0,0.0,2.0,0.0,4.9,4.9,5.0,9.9,67.0,184.0,99.0,0.27,0.05,0.32,0.27,0.32,0.22,0.23,0.45,0.22,0.45,Matches,Pedri,M/AM RLC,19,159,176,Spain,Barcelona,9,14,17,11,18,9,7,11,6,6,17,11,9,17,11,17,11,16,15,18,16,14,18,9,13,9,13,15,14,15,13,8,16,13,16,9,15,5,13,5,15,1,1,2,1,2,3,2,2,4,2,3,12,14,3,14,13,15,15,17,1,1,1,1,1,1,1,12,20,14,15,20,16,5,174,65,10,20,96009385,7950,7950,6950,Mediterranean_Hispanic,153,2,2002/11/25,12,0,172603.0,,67293495
757,Rubén Peña,Osasuna,1991,447.0,es ESP,DFMF,31.0,14.2,32.0,18.0,10.0,18.0,4.0,20.0,41.0,48.8,21.0,23.0,8.0,15.0,17.0,49.0,31.0,0.0,Matches,447.0,es ESP,DFMF,31.0,14.2,21.0,1.48,15.0,2.0,4.0,0.0,0.0,0.0,3.0,0.21,2.0,1.0,0.0,0.0,0.0,0.0,Matches,,,,,,,,,,,,,,,,,,,,,,,,,,,,,,,,,,,,,,,,,,,,,,,,,,,,,,,,447.0,es ESP,DFMF,31.0,14.2,2.0,1.0,0.0,26.0,14.0,0.0,54.0,17.0,18.0,0.0,0.0,0.0,94.0,14.0,19.0,42.4,Matches,447.0,es ESP,DFMF,31.0,14.2,620.0,504.0,113.0,4.0,0.0,1.0,54.0,108.0,1.0,0.0,1.0,0.0,432.0,3.0,19.0,Matches,447.0,es ESP,DFMF,31.0,14.2,432.0,620.0,69.7,6862.0,3062.0,233.0,261.0,89.3,156.0,220.0,70.9,34.0,94.0,36.2,1.0,1.0,1.4,0.0,10.0,37.0,12.0,7.0,61.0,Matches,543,es ESP,DFMF,31,20,1277.0,64.0,37.3,14.2,14,79.0,5,6,29.0,2,1.45,22.0,17.0,5.0,0.35,0.77,18.3,17.8,0.4,0.03,0.3,Matches,447.0,es ESP,DFMF,31.0,14.2,814.0,48.0,212.0,360.0,255.0,21.0,814.0,32.0,19.0,59.4,10.0,31.3,407.0,2387.0,1166.0,32.0,28.0,6.0,32.0,14.0,410.0,59.0,Matches,447.0,es ESP,DFMF,31.0,14.2,0.0,12.0,2.0,16.7,0.85,0.14,0.0,0.0,22.6,0.0,0.0,0.0,1.2,1.2,0.1,-1.2,-1.2,Matches,447.0,es ESP,DFMF,31.0,20.0,14.0,1277.0,14.2,0.0,1.0,1.0,0.0,0.0,0.0,2.0,1.0,1.2,1.2,1.0,2.2,32.0,61.0,59.0,0.0,0.07,0.07,0.0,0.07,0.08,0.07,0.15,0.08,0.15,Matches,Rubén Peña,D/WB/M/AM R,31,135,145,Spain,Atlético Pamplona,8,14,14,9,12,8,8,10,13,12,13,10,14,12,10,13,12,12,13,13,14,11,10,7,14,13,12,13,13,13,13,8,12,13,13,10,12,10,10,7,14,2,2,3,1,1,1,2,2,1,1,3,19,8,4,10,12,11,11,15,1,10,1,20,11,18,1,13,1,16,14,14,16,11,170,65,12,20,347975206,6650,6650,3400,Mediterranean_Hispanic,126,6,1991/7/18,0,0,12894.0,,67177699
758,Ayoze Pérez,Betis,1993,449.0,es ESP,FWMF,29.0,15.4,31.0,15.0,9.0,16.0,6.0,10.0,40.0,25.0,30.0,22.0,0.0,22.0,13.0,44.0,5.0,0.0,Matches,449.0,es ESP,FWMF,29.0,15.4,49.0,3.18,33.0,0.0,9.0,3.0,3.0,1.0,4.0,0.26,1.0,0.0,1.0,0.0,2.0,0.0,Matches,,,,,,,,,,,,,,,,,,,,,,,,,,,,,,,,,,,,,,,,,,,,,,,,,,,,,,,,449.0,es ESP,FWMF,29.0,15.4,3.0,0.0,0.0,32.0,29.0,2.0,7.0,13.0,15.0,2.0,0.0,0.0,67.0,8.0,24.0,25.0,Matches,449.0,es ESP,FWMF,29.0,15.4,391.0,372.0,14.0,2.0,2.0,0.0,7.0,5.0,0.0,0.0,0.0,0.0,308.0,5.0,15.0,Matches,449.0,es ESP,FWMF,29.0,15.4,308.0,391.0,78.8,3512.0,1077.0,221.0,255.0,86.7,60.0,79.0,75.9,5.0,6.0,83.3,1.0,2.0,2.0,-1.0,13.0,19.0,14.0,0.0,39.0,Matches,545,es ESP,FWMF,29,19,1386.0,73.0,40.5,15.4,17,79.0,5,2,21.0,0,1.53,18.0,17.0,1.0,0.06,-0.11,21.1,20.2,0.9,0.06,0.04,Matches,449.0,es ESP,FWMF,29.0,15.4,613.0,7.0,83.0,254.0,289.0,75.0,613.0,77.0,42.0,54.5,30.0,39.0,390.0,2600.0,1367.0,51.0,35.0,19.0,39.0,26.0,431.0,102.0,Matches,449.0,es ESP,FWMF,29.0,15.4,3.0,34.0,14.0,41.2,2.21,0.91,0.09,0.21,16.8,0.0,0.0,0.0,4.6,4.6,0.14,-1.6,-1.6,Matches,449.0,es ESP,FWMF,29.0,19.0,17.0,1386.0,15.4,3.0,1.0,4.0,3.0,0.0,0.0,3.0,0.0,4.6,4.6,2.0,6.6,51.0,39.0,102.0,0.19,0.06,0.26,0.19,0.26,0.3,0.13,0.43,0.3,0.43,Matches,Ayoze Pérez,AM/S RC,28,136,142,Spain,Leicester City,7,12,15,14,15,9,11,9,4,5,13,11,10,14,6,14,10,12,12,13,13,13,15,10,15,8,14,16,12,14,13,8,15,13,14,9,11,7,14,8,16,3,2,3,1,2,1,1,3,3,1,3,13,15,5,12,13,13,12,14,1,1,1,1,1,1,1,1,1,15,13,20,19,18,178,72,12,20,16944171,6800,6800,5750,Mediterranean_Hispanic,130,10,1993/7/29,0,0,92793.0,,67172040
759,Carles Pérez,Celta Vigo,1998,450.0,es ESP,MFFW,24.0,23.8,39.0,23.0,12.0,17.0,10.0,22.0,66.0,33.3,44.0,29.0,3.0,26.0,6.0,45.0,9.0,0.0,Matches,450.0,es ESP,MFFW,24.0,23.8,68.0,2.85,45.0,0.0,12.0,6.0,5.0,0.0,9.0,0.38,6.0,0.0,2.0,0.0,1.0,0.0,Matches,,,,,,,,,,,,,,,,,,,,,,,,,,,,,,,,,,,,,,,,,,,,,,,,,,,,,,,,450.0,es ESP,MFFW,24.0,23.8,5.0,0.0,0.0,35.0,37.0,9.0,36.0,6.0,23.0,1.0,0.0,0.0,110.0,6.0,40.0,13.0,Matches,450.0,es ESP,MFFW,24.0,23.8,689.0,679.0,8.0,1.0,4.0,6.0,36.0,4.0,2.0,2.0,0.0,0.0,564.0,2.0,12.0,Matches,450.0,es ESP,MFFW,24.0,23.8,564.0,689.0,81.9,8850.0,1735.0,291.0,330.0,88.2,218.0,259.0,84.2,36.0,61.0,59.0,5.0,2.0,1.7,3.0,23.0,33.0,19.0,3.0,66.0,Matches,546,es ESP,MFFW,24,35,2144.0,61.0,62.7,23.8,23,77.0,8,12,30.0,1,1.14,26.0,26.0,0.0,0.0,0.71,25.3,28.2,-2.9,-0.12,-0.13,Matches,450.0,es ESP,MFFW,24.0,23.8,1003.0,14.0,103.0,366.0,557.0,71.0,1003.0,110.0,44.0,40.0,52.0,47.3,675.0,5637.0,2923.0,93.0,77.0,41.0,56.0,28.0,721.0,185.0,Matches,450.0,es ESP,MFFW,24.0,23.8,3.0,54.0,20.0,37.0,2.27,0.84,0.06,0.15,21.8,0.0,0.0,0.0,2.7,2.7,0.05,0.3,0.3,Matches,450.0,es ESP,MFFW,24.0,35.0,23.0,2144.0,23.8,3.0,5.0,8.0,3.0,0.0,0.0,5.0,0.0,2.7,2.7,2.0,4.7,93.0,66.0,185.0,0.13,0.21,0.34,0.13,0.34,0.12,0.08,0.2,0.12,0.2,Matches,Carles Pérez,AM RLC,24,134,145,Spain,Associazione Sportiva Roma,13,12,16,10,17,9,8,14,6,6,13,9,7,15,12,10,12,10,11,12,10,13,15,5,10,5,11,12,16,17,11,6,13,15,12,9,10,6,10,10,16,1,4,2,1,2,3,2,1,3,2,3,11,12,6,13,12,11,12,13,1,1,1,1,1,1,1,10,15,12,15,15,20,10,173,75,20,8,2829168,6700,6850,5500,Mediterranean_Hispanic,128,5,1998/2/16,0,0,58461.0,Vigo,67215283
760,Luis Pérez,Valladolid,1995,454.0,es ESP,DF,27.0,13.5,44.0,24.0,26.0,12.0,6.0,27.0,38.0,71.1,11.0,13.0,4.0,9.0,16.0,60.0,29.0,0.0,Matches,454.0,es ESP,DF,27.0,13.5,26.0,1.93,23.0,1.0,0.0,0.0,2.0,0.0,1.0,0.07,1.0,0.0,0.0,0.0,0.0,0.0,Matches,,,,,,,,,,,,,,,,,,,,,,,,,,,,,,,,,,,,,,,,,,,,,,,,,,,,,,,,454.0,es ESP,DF,27.0,13.5,2.0,0.0,0.0,12.0,16.0,4.0,54.0,16.0,24.0,0.0,0.0,0.0,55.0,7.0,16.0,30.4,Matches,454.0,es ESP,DF,27.0,13.5,574.0,455.0,113.0,9.0,1.0,4.0,54.0,104.0,0.0,0.0,0.0,0.0,436.0,6.0,19.0,Matches,454.0,es ESP,DF,27.0,13.5,436.0,574.0,76.0,7137.0,2375.0,232.0,253.0,91.7,149.0,204.0,73.0,42.0,70.0,60.0,1.0,0.9,0.9,0.1,13.0,30.0,15.0,13.0,42.0,Matches,552,es ESP,DF,27,18,1213.0,67.0,35.5,13.5,15,74.0,10,3,32.0,6,1.0,9.0,29.0,-20.0,-1.48,-1.08,14.1,25.8,-11.7,-0.87,-0.26,Matches,454.0,es ESP,DF,27.0,13.5,724.0,38.0,206.0,330.0,196.0,4.0,724.0,20.0,8.0,40.0,10.0,50.0,375.0,1920.0,933.0,24.0,16.0,1.0,16.0,5.0,397.0,84.0,Matches,454.0,es ESP,DF,27.0,13.5,0.0,4.0,0.0,0.0,0.3,0.0,0.0,,27.6,0.0,0.0,0.0,0.1,0.1,0.03,-0.1,-0.1,Matches,454.0,es ESP,DF,27.0,18.0,15.0,1213.0,13.5,0.0,1.0,1.0,0.0,0.0,0.0,2.0,0.0,0.1,0.1,0.9,1.0,24.0,42.0,84.0,0.0,0.07,0.07,0.0,0.07,0.01,0.07,0.08,0.01,0.08,Matches,Luis Pérez,D/WB R,27,126,135,Spain,Valladolid,7,11,11,7,12,5,6,7,13,14,10,8,13,12,13,13,15,12,13,10,12,14,11,10,14,13,14,16,14,13,12,9,13,14,15,11,13,6,11,8,8,2,1,1,3,3,2,4,4,2,2,2,11,13,6,13,12,14,11,11,1,1,1,20,1,18,1,1,1,10,1,1,10,1,178,72,10,20,2220334,6300,6300,4250,Mediterranean_Hispanic,124,6,1995/2/4,0,0,7258.0,,67199621
761,Germán Pezzella,Betis,1991,455.0,ar ARG,DF,31.0,27.9,41.0,28.0,32.0,9.0,0.0,26.0,38.0,68.4,12.0,32.0,15.0,17.0,50.0,91.0,129.0,1.0,Matches,455.0,ar ARG,DF,31.0,27.9,15.0,0.54,13.0,0.0,1.0,0.0,0.0,1.0,1.0,0.04,1.0,0.0,0.0,0.0,0.0,0.0,Matches,,,,,,,,,,,,,,,,,,,,,,,,,,,,,,,,,,,,,,,,,,,,,,,,,,,,,,,,455.0,ar ARG,DF,31.0,27.9,4.0,3.0,0.0,27.0,17.0,1.0,2.0,50.0,28.0,0.0,0.0,0.0,108.0,73.0,31.0,70.2,Matches,455.0,ar ARG,DF,31.0,27.9,1312.0,1253.0,55.0,52.0,1.0,8.0,2.0,3.0,0.0,0.0,0.0,0.0,1129.0,4.0,7.0,Matches,455.0,ar ARG,DF,31.0,27.9,1129.0,1312.0,86.1,21195.0,8087.0,408.0,432.0,94.4,608.0,657.0,92.5,101.0,192.0,52.6,0.0,0.2,0.4,-0.2,4.0,45.0,3.0,0.0,54.0,Matches,553,ar ARG,DF,31,31,2511.0,81.0,73.4,27.9,29,83.0,22,2,48.0,2,1.52,33.0,28.0,5.0,0.18,0.18,36.2,36.5,-0.3,-0.01,-0.17,Matches,455.0,ar ARG,DF,31.0,27.9,1606.0,186.0,883.0,691.0,44.0,19.0,1606.0,7.0,4.0,57.1,2.0,28.6,874.0,3664.0,1817.0,8.0,9.0,1.0,12.0,1.0,1012.0,3.0,Matches,455.0,ar ARG,DF,31.0,27.9,0.0,10.0,0.0,0.0,0.36,0.0,0.0,,11.2,0.0,0.0,0.0,0.9,0.9,0.09,-0.9,-0.9,Matches,455.0,ar ARG,DF,31.0,31.0,29.0,2511.0,27.9,0.0,0.0,0.0,0.0,0.0,0.0,4.0,3.0,0.9,0.9,0.2,1.1,8.0,54.0,3.0,0.0,0.0,0.0,0.0,0.0,0.03,0.01,0.04,0.03,0.04,Matches,Germán Pezzella,D C,31,143,150,"Argentina,Italy",Real Hispalis,7,8,7,7,8,7,16,7,8,16,10,7,14,10,15,16,15,15,14,12,14,15,10,16,9,15,14,14,11,11,14,16,13,12,13,14,11,13,13,10,10,1,1,4,3,2,1,4,2,3,1,1,14,12,12,15,12,15,15,14,1,1,20,1,1,1,1,1,1,1,1,1,1,1,187,82,9,20,347975206,7000,7250,7000,Mediterranean_Hispanic,142,3,1991/6/27,29,2,42692.0,,14023371
762,Óscar Plano,Valladolid,1991,459.0,es ESP,FWMF,31.0,22.6,40.0,25.0,9.0,17.0,14.0,12.0,37.0,32.4,25.0,26.0,2.0,24.0,29.0,69.0,23.0,0.0,Matches,459.0,es ESP,FWMF,31.0,22.6,56.0,2.47,46.0,0.0,1.0,4.0,4.0,1.0,7.0,0.31,5.0,0.0,0.0,1.0,1.0,0.0,Matches,,,,,,,,,,,,,,,,,,,,,,,,,,,,,,,,,,,,,,,,,,,,,,,,,,,,,,,,459.0,es ESP,FWMF,31.0,22.6,3.0,0.0,0.0,23.0,49.0,7.0,23.0,29.0,25.0,1.0,0.0,0.0,108.0,34.0,50.0,40.5,Matches,459.0,es ESP,FWMF,31.0,22.6,640.0,614.0,21.0,3.0,5.0,4.0,23.0,3.0,0.0,0.0,0.0,0.0,468.0,5.0,22.0,Matches,459.0,es ESP,FWMF,31.0,22.6,468.0,640.0,73.1,7102.0,1888.0,252.0,326.0,77.3,157.0,195.0,80.5,30.0,49.0,61.2,1.0,1.6,1.4,-0.6,16.0,56.0,17.0,4.0,73.0,Matches,559,es ESP,FWMF,31,33,2038.0,62.0,59.6,22.6,22,77.0,6,11,31.0,5,1.0,18.0,33.0,-15.0,-0.66,0.31,20.9,35.3,-14.4,-0.63,0.17,Matches,459.0,es ESP,FWMF,31.0,22.6,890.0,29.0,151.0,423.0,325.0,46.0,890.0,33.0,13.0,39.4,14.0,42.4,496.0,2410.0,979.0,30.0,30.0,4.0,37.0,23.0,570.0,95.0,Matches,459.0,es ESP,FWMF,31.0,22.6,1.0,30.0,10.0,33.3,1.32,0.44,0.03,0.1,17.3,0.0,0.0,0.0,2.8,2.8,0.09,-1.8,-1.8,Matches,459.0,es ESP,FWMF,31.0,33.0,22.0,2038.0,22.6,1.0,1.0,2.0,1.0,0.0,0.0,3.0,0.0,2.8,2.8,1.6,4.4,30.0,73.0,95.0,0.04,0.04,0.09,0.04,0.09,0.12,0.07,0.19,0.12,0.19,Matches,Óscar Plano,AM/S RLC,31,127,131,Spain,Valladolid,8,11,13,13,12,11,12,12,7,7,12,10,7,13,15,8,10,9,9,11,12,14,16,6,13,8,8,14,16,14,11,10,11,14,11,12,12,10,9,12,9,3,1,3,2,1,3,2,3,2,2,3,17,10,2,8,10,9,11,12,1,1,1,1,1,1,1,8,1,9,16,20,17,19,180,72,20,12,1554916,6350,6350,4200,Mediterranean_Hispanic,117,6,1991/2/11,0,0,3937.0,,67080318
763,Gonzalo Plata,Valladolid,2000,460.0,ec ECU,FW,21.0,25.6,66.0,35.0,31.0,24.0,11.0,23.0,70.0,32.9,47.0,40.0,0.0,40.0,12.0,78.0,10.0,1.0,Matches,460.0,ec ECU,FW,21.0,25.6,93.0,3.64,66.0,7.0,9.0,1.0,8.0,2.0,11.0,0.43,8.0,0.0,1.0,0.0,2.0,0.0,Matches,,,,,,,,,,,,,,,,,,,,,,,,,,,,,,,,,,,,,,,,,,,,,,,,,,,,,,,,460.0,ec ECU,FW,21.0,25.6,1.0,0.0,0.0,22.0,41.0,4.0,54.0,12.0,35.0,3.0,0.0,0.0,123.0,17.0,44.0,27.9,Matches,460.0,ec ECU,FW,21.0,25.6,782.0,712.0,69.0,6.0,3.0,1.0,54.0,34.0,23.0,16.0,2.0,1.0,582.0,1.0,31.0,Matches,460.0,ec ECU,FW,21.0,25.6,582.0,782.0,74.4,7367.0,1681.0,387.0,458.0,84.5,145.0,193.0,75.1,18.0,47.0,38.3,5.0,3.1,2.6,1.9,37.0,28.0,19.0,3.0,54.0,Matches,560,ec ECU,FW,21,34,2302.0,68.0,67.3,25.6,26,79.0,11,8,32.0,0,1.12,26.0,37.0,-11.0,-0.43,1.1,30.1,42.5,-12.4,-0.49,0.66,Matches,460.0,ec ECU,FW,21.0,25.6,1203.0,13.0,183.0,462.0,578.0,102.0,1203.0,172.0,66.0,38.4,86.0,50.0,703.0,5277.0,2466.0,97.0,64.0,45.0,68.0,39.0,763.0,213.0,Matches,460.0,ec ECU,FW,21.0,25.6,1.0,37.0,13.0,35.1,1.45,0.51,0.03,0.08,17.5,1.0,0.0,0.0,3.7,3.7,0.1,-2.7,-2.7,Matches,460.0,ec ECU,FW,21.0,34.0,26.0,2302.0,25.6,1.0,5.0,6.0,1.0,0.0,0.0,1.0,0.0,3.7,3.7,3.1,6.8,97.0,54.0,213.0,0.04,0.2,0.23,0.04,0.23,0.15,0.12,0.27,0.15,0.27,Matches,Gonzalo Plata,AM RLC,21,131,146,Ecuador,Valladolid,15,14,16,13,14,14,9,14,5,6,13,12,5,15,8,10,8,11,9,13,10,9,17,8,12,5,10,13,16,15,13,9,15,15,13,9,9,8,8,8,11,2,3,3,2,2,3,1,3,3,3,3,12,13,11,12,11,5,6,10,1,1,1,1,12,12,1,12,1,12,15,15,20,14,178,66,20,6,13787839,6550,6250,5050,African_Caribbean,129,13,2000/11/1,29,5,8522.0,,86066846
764,Ezequiel Ponce,Elche,1997,461.0,ar ARG,FWMF,25.0,12.5,9.0,7.0,0.0,6.0,3.0,0.0,7.0,0.0,7.0,6.0,1.0,5.0,1.0,10.0,13.0,0.0,Matches,461.0,ar ARG,FWMF,25.0,12.5,25.0,1.99,20.0,0.0,0.0,4.0,1.0,0.0,4.0,0.32,1.0,0.0,0.0,2.0,1.0,0.0,Matches,,,,,,,,,,,,,,,,,,,,,,,,,,,,,,,,,,,,,,,,,,,,,,,,,,,,,,,,461.0,ar ARG,FWMF,25.0,12.5,2.0,1.0,0.0,32.0,9.0,8.0,1.0,1.0,7.0,1.0,0.0,0.0,36.0,35.0,44.0,44.3,Matches,461.0,ar ARG,FWMF,25.0,12.5,292.0,280.0,9.0,0.0,1.0,4.0,1.0,1.0,0.0,0.0,0.0,0.0,218.0,3.0,8.0,Matches,461.0,ar ARG,FWMF,25.0,12.5,218.0,292.0,74.7,2610.0,432.0,148.0,179.0,82.7,34.0,50.0,68.0,12.0,18.0,66.7,0.0,0.7,0.3,-0.7,11.0,21.0,4.0,0.0,19.0,Matches,561,ar ARG,FWMF,25,33,1122.0,34.0,32.8,12.5,8,68.0,1,25,23.0,3,0.58,14.0,17.0,-3.0,-0.24,1.09,16.2,24.4,-8.2,-0.66,0.3,Matches,461.0,ar ARG,FWMF,25.0,12.5,421.0,18.0,42.0,232.0,151.0,47.0,421.0,16.0,5.0,31.3,9.0,56.3,259.0,1019.0,318.0,10.0,4.0,5.0,30.0,29.0,324.0,51.0,Matches,461.0,ar ARG,FWMF,25.0,12.5,4.0,29.0,9.0,31.0,2.33,0.72,0.14,0.44,12.9,0.0,0.0,0.0,3.6,3.6,0.12,0.4,0.4,Matches,461.0,ar ARG,FWMF,25.0,33.0,8.0,1122.0,12.5,4.0,0.0,4.0,4.0,0.0,0.0,2.0,1.0,3.6,3.6,0.7,4.3,10.0,19.0,51.0,0.32,0.0,0.32,0.32,0.32,0.29,0.05,0.34,0.29,0.34,Matches,Ezequiel Ponce,S,25,128,138,"Argentina,Spain,Italy",Elche,7,10,12,15,12,8,14,11,7,6,11,12,7,12,15,13,13,10,13,10,12,14,13,11,13,8,10,12,15,13,13,12,13,13,12,13,12,13,12,9,9,3,3,1,1,2,2,1,1,2,1,3,13,16,8,11,16,10,10,10,1,1,1,1,1,1,1,1,1,1,10,1,1,20,181,75,12,20,1312005,6250,6000,4250,Mediterranean_Hispanic,126,8,1997/3/29,0,0,33062.0,,14092553
765,Portu,Getafe,1992,463.0,es ESP,MFDF,30.0,19.7,28.0,21.0,14.0,10.0,4.0,18.0,42.0,42.9,24.0,23.0,3.0,20.0,17.0,45.0,20.0,1.0,Matches,463.0,es ESP,MFDF,30.0,19.7,53.0,2.69,37.0,4.0,5.0,3.0,4.0,0.0,3.0,0.15,2.0,0.0,1.0,0.0,0.0,0.0,Matches,,,,,,,,,,,,,,,,,,,,,,,,,,,,,,,,,,,,,,,,,,,,,,,,,,,,,,,,463.0,es ESP,MFDF,30.0,19.7,7.0,1.0,1.0,25.0,25.0,10.0,91.0,17.0,21.0,0.0,0.0,0.0,91.0,20.0,34.0,37.0,Matches,463.0,es ESP,MFDF,30.0,19.7,731.0,599.0,123.0,7.0,1.0,2.0,91.0,108.0,8.0,5.0,3.0,0.0,493.0,9.0,44.0,Matches,463.0,es ESP,MFDF,30.0,19.7,493.0,731.0,67.4,7469.0,2863.0,268.0,329.0,81.5,174.0,240.0,72.5,29.0,77.0,37.7,3.0,1.9,2.6,1.1,27.0,30.0,26.0,15.0,40.0,Matches,563,es ESP,MFDF,30,34,1770.0,52.0,51.8,19.7,17,84.0,8,17,21.0,1,1.12,18.0,24.0,-6.0,-0.31,-0.03,19.8,27.8,-8.0,-0.41,-0.33,Matches,463.0,es ESP,MFDF,30.0,19.7,914.0,17.0,179.0,378.0,366.0,35.0,914.0,43.0,13.0,30.2,22.0,51.2,471.0,2660.0,1405.0,42.0,26.0,4.0,29.0,8.0,532.0,130.0,Matches,463.0,es ESP,MFDF,30.0,19.7,0.0,15.0,5.0,33.3,0.76,0.25,0.0,0.0,18.1,0.0,0.0,0.0,1.7,1.7,0.12,-1.7,-1.7,Matches,463.0,es ESP,MFDF,30.0,34.0,17.0,1770.0,19.7,0.0,3.0,3.0,0.0,0.0,0.0,7.0,1.0,1.7,1.7,1.9,3.6,42.0,40.0,130.0,0.0,0.15,0.15,0.0,0.15,0.09,0.09,0.18,0.09,0.18,Matches,Portu,M/AM RC,30,141,154,Spain,Real San Sebastián,10,11,13,12,12,12,8,11,8,9,13,8,11,13,16,12,15,12,13,14,11,17,12,13,14,8,15,16,15,12,13,10,14,15,12,14,12,9,13,6,17,3,2,3,3,1,2,2,3,3,2,3,14,10,6,10,11,16,9,13,1,1,1,14,1,13,12,12,18,18,13,14,20,14,178,71,12,20,13468949,7050,7050,5950,Mediterranean_Hispanic,134,6,1992/5/21,0,0,24633.0,Getafe,67115581
766,Javi Puado,Espanyol,1998,468.0,es ESP,FWMF,24.0,26.0,20.0,11.0,12.0,5.0,3.0,12.0,28.0,42.9,16.0,12.0,2.0,10.0,10.0,30.0,14.0,0.0,Matches,468.0,es ESP,FWMF,24.0,26.0,57.0,2.19,35.0,2.0,8.0,8.0,4.0,0.0,7.0,0.27,3.0,0.0,1.0,2.0,1.0,0.0,Matches,,,,,,,,,,,,,,,,,,,,,,,,,,,,,,,,,,,,,,,,,,,,,,,,,,,,,,,,468.0,es ESP,FWMF,24.0,26.0,4.0,0.0,0.0,16.0,25.0,4.0,36.0,10.0,11.0,1.0,0.0,0.0,135.0,21.0,41.0,33.9,Matches,468.0,es ESP,FWMF,24.0,26.0,590.0,572.0,17.0,2.0,0.0,1.0,36.0,10.0,2.0,0.0,1.0,0.0,450.0,1.0,22.0,Matches,468.0,es ESP,FWMF,24.0,26.0,450.0,590.0,76.3,6618.0,1312.0,250.0,295.0,84.7,146.0,192.0,76.0,26.0,44.0,59.1,2.0,2.6,2.0,-0.6,25.0,15.0,21.0,3.0,58.0,Matches,569,es ESP,FWMF,24,37,2340.0,63.0,68.4,26.0,25,78.0,5,12,33.0,0,0.97,37.0,44.0,-7.0,-0.27,0.56,35.8,42.3,-6.5,-0.25,0.16,Matches,468.0,es ESP,FWMF,24.0,26.0,847.0,23.0,135.0,320.0,417.0,91.0,847.0,56.0,23.0,41.1,26.0,46.4,528.0,3563.0,1490.0,60.0,37.0,21.0,69.0,30.0,577.0,117.0,Matches,468.0,es ESP,FWMF,24.0,26.0,7.0,57.0,23.0,40.4,2.19,0.88,0.12,0.3,14.2,0.0,0.0,0.0,7.8,7.8,0.14,-0.8,-0.8,Matches,468.0,es ESP,FWMF,24.0,37.0,25.0,2340.0,26.0,7.0,2.0,9.0,7.0,0.0,0.0,4.0,0.0,7.8,7.8,2.6,10.4,60.0,58.0,117.0,0.27,0.08,0.35,0.27,0.35,0.3,0.1,0.4,0.3,0.4,Matches,Javi Puado,AM/S RLC,24,127,142,Spain,Espanyol,8,11,13,13,12,8,9,12,5,8,11,12,7,14,9,12,11,14,12,13,13,13,13,9,16,8,13,13,15,15,10,9,13,14,11,11,12,7,11,7,14,1,2,2,2,1,1,2,1,1,1,3,20,10,6,11,11,10,9,19,1,1,1,1,1,1,1,1,1,1,17,17,16,20,179,69,8,20,2374688,6150,6150,4400,Mediterranean_Hispanic,121,6,1998/5/25,1,1,5724.0,,67222737
767,Predrag Rajković,Mallorca,1995,473.0,rs SRB,GK,26.0,36.0,0.0,0.0,0.0,0.0,0.0,0.0,2.0,0.0,2.0,0.0,0.0,0.0,0.0,0.0,16.0,1.0,Matches,473.0,rs SRB,GK,26.0,36.0,11.0,0.31,8.0,3.0,0.0,0.0,0.0,0.0,2.0,0.06,1.0,1.0,0.0,0.0,0.0,0.0,Matches,34.0,rs SRB,GK,26.0,36.0,40.0,6.0,0.0,3.0,0.0,39.2,0.25,-0.8,-0.02,323.0,786.0,41.1,899.0,125.0,61.8,45.4,309.0,74.4,54.0,608.0,32.0,5.3,19.0,0.53,11.7,Matches,34.0,rs SRB,GK,26.0,36.0,36.0,3240.0,36.0,40.0,1.11,133.0,92.0,74.4,13.0,8.0,15.0,12.0,33.3,7.0,6.0,1.0,0.0,14.3,Matches,473.0,rs SRB,GK,26.0,36.0,3.0,0.0,0.0,1.0,3.0,0.0,0.0,0.0,0.0,0.0,1.0,0.0,23.0,5.0,1.0,83.3,Matches,473.0,rs SRB,GK,26.0,36.0,1210.0,750.0,458.0,149.0,0.0,5.0,0.0,0.0,0.0,0.0,0.0,0.0,717.0,2.0,0.0,Matches,473.0,rs SRB,GK,26.0,36.0,717.0,1210.0,59.3,28066.0,23317.0,75.0,76.0,98.7,236.0,239.0,98.7,401.0,888.0,45.2,0.0,0.5,0.1,-0.5,4.0,51.0,1.0,0.0,3.0,Matches,578,rs SRB,GK,26,36,3240.0,90.0,94.7,36.0,36,90.0,36,0,,2,1.31,34.0,40.0,-6.0,-0.17,-0.17,32.9,41.7,-8.8,-0.25,0.95,Matches,473.0,rs SRB,GK,26.0,36.0,1284.0,1022.0,1266.0,18.0,0.0,0.0,1284.0,6.0,5.0,83.3,1.0,16.7,656.0,4514.0,2818.0,0.0,0.0,0.0,2.0,0.0,458.0,0.0,Matches,473.0,rs SRB,GK,26.0,36.0,0.0,0.0,0.0,,0.0,0.0,,,,0.0,0.0,0.0,0.0,0.0,,0.0,0.0,Matches,473.0,rs SRB,GK,26.0,36.0,36.0,3240.0,36.0,0.0,0.0,0.0,0.0,0.0,0.0,3.0,0.0,0.0,0.0,0.5,0.5,0.0,3.0,0.0,0.0,0.0,0.0,0.0,0.0,0.0,0.01,0.01,0.0,0.01,Matches,Predrag Rajković,GK,26,130,145,Serbia,Mallorca,3,3,8,10,10,8,2,6,6,5,9,10,4,7,11,13,16,10,11,10,10,11,5,14,5,15,14,12,10,11,14,14,13,10,13,14,15,9,12,7,8,14,16,14,14,12,12,14,15,13,14,13,9,15,12,11,8,9,7,4,20,1,1,1,1,1,1,1,1,1,1,1,1,1,191,88,12,20,8939683,6500,7000,4250,Northern_European,130,4,1995/10/31,28,0,22807.0,,62076152
768,Largie Ramazani,Almería,2001,475.0,be BEL,FWMF,21.0,15.6,15.0,9.0,6.0,3.0,6.0,8.0,27.0,29.6,19.0,11.0,0.0,11.0,15.0,30.0,10.0,0.0,Matches,475.0,be BEL,FWMF,21.0,15.6,42.0,2.7,24.0,1.0,9.0,4.0,2.0,2.0,4.0,0.26,1.0,0.0,1.0,1.0,1.0,0.0,Matches,,,,,,,,,,,,,,,,,,,,,,,,,,,,,,,,,,,,,,,,,,,,,,,,,,,,,,,,475.0,be BEL,FWMF,21.0,15.6,6.0,0.0,0.0,31.0,15.0,12.0,20.0,15.0,9.0,1.0,1.0,0.0,57.0,5.0,18.0,21.7,Matches,475.0,be BEL,FWMF,21.0,15.6,291.0,266.0,20.0,1.0,3.0,1.0,20.0,7.0,1.0,1.0,0.0,0.0,195.0,5.0,18.0,Matches,475.0,be BEL,FWMF,21.0,15.6,195.0,291.0,67.0,3103.0,857.0,107.0,140.0,76.4,66.0,90.0,73.3,16.0,29.0,55.2,1.0,1.7,1.8,-0.7,13.0,22.0,11.0,1.0,30.0,Matches,580,be BEL,FWMF,21,33,1403.0,43.0,41.0,15.6,13,74.0,2,20,22.0,4,1.03,14.0,31.0,-17.0,-1.09,-1.14,18.8,31.3,-12.5,-0.8,-0.6,Matches,475.0,be BEL,FWMF,21.0,15.6,486.0,11.0,77.0,180.0,241.0,51.0,485.0,68.0,32.0,47.1,32.0,47.1,315.0,2661.0,1328.0,59.0,31.0,24.0,39.0,24.0,332.0,94.0,Matches,475.0,be BEL,FWMF,21.0,15.6,3.0,40.0,18.0,45.0,2.57,1.15,0.08,0.17,19.8,1.0,0.0,1.0,4.2,3.4,0.08,-1.2,-0.4,Matches,475.0,be BEL,FWMF,21.0,33.0,13.0,1403.0,15.6,3.0,1.0,4.0,3.0,0.0,1.0,6.0,0.0,4.2,3.4,1.7,5.1,59.0,30.0,94.0,0.19,0.06,0.26,0.19,0.26,0.27,0.11,0.38,0.22,0.33,Matches,Largie Ramazani,AM RL,21,132,155,"Belgium,Burundi",Almería,4,11,15,14,13,8,4,6,4,4,12,13,4,14,9,8,8,11,9,9,11,14,14,3,13,4,10,12,18,14,8,3,13,17,12,6,11,3,12,10,6,3,3,2,2,2,1,3,1,3,1,3,15,15,7,10,12,11,10,20,1,1,1,1,1,1,1,12,1,10,20,10,17,15,167,68,15,20,11875498,6600,6250,5250,African_Caribbean,121,15,2001/2/27,0,0,11722.0,,28116558
769,Raphinha,Barcelona,1996,477.0,br BRA,FW,25.0,23.0,29.0,19.0,10.0,7.0,12.0,11.0,31.0,35.5,20.0,33.0,1.0,32.0,14.0,43.0,11.0,1.0,Matches,477.0,br BRA,FW,25.0,23.0,117.0,5.08,77.0,22.0,4.0,9.0,4.0,1.0,15.0,0.65,13.0,0.0,1.0,1.0,0.0,0.0,Matches,,,,,,,,,,,,,,,,,,,,,,,,,,,,,,,,,,,,,,,,,,,,,,,,,,,,,,,,477.0,br BRA,FW,25.0,23.0,9.0,0.0,0.0,22.0,37.0,15.0,172.0,14.0,19.0,0.0,0.0,0.0,98.0,14.0,9.0,60.9,Matches,477.0,br BRA,FW,25.0,23.0,1266.0,1072.0,185.0,35.0,12.0,26.0,172.0,42.0,108.0,44.0,35.0,1.0,915.0,9.0,30.0,Matches,477.0,br BRA,FW,25.0,23.0,915.0,1266.0,72.3,15558.0,3922.0,475.0,556.0,85.4,304.0,393.0,77.4,107.0,226.0,47.3,7.0,9.8,9.3,-2.8,57.0,48.0,74.0,20.0,104.0,Matches,585,br BRA,FW,25,36,2072.0,58.0,60.6,23.0,25,72.0,2,11,24.0,1,2.28,34.0,9.0,25.0,1.09,-0.58,44.9,18.1,26.8,1.16,0.13,Matches,477.0,br BRA,FW,25.0,23.0,1596.0,17.0,84.0,547.0,979.0,131.0,1596.0,106.0,45.0,42.5,52.0,49.1,999.0,5616.0,2794.0,97.0,67.0,53.0,55.0,24.0,1148.0,339.0,Matches,477.0,br BRA,FW,25.0,23.0,7.0,79.0,25.0,31.6,3.43,1.09,0.09,0.28,18.5,11.0,0.0,0.0,9.3,9.3,0.12,-2.3,-2.3,Matches,477.0,br BRA,FW,25.0,36.0,25.0,2072.0,23.0,7.0,7.0,14.0,7.0,0.0,0.0,9.0,0.0,9.3,9.3,9.8,19.1,97.0,104.0,339.0,0.3,0.3,0.61,0.3,0.61,0.41,0.43,0.83,0.41,0.83,Matches,Raphinha,M/AM RL,25,155,163,"Brazil,Italy",Barcelona,15,14,17,13,16,14,8,14,11,8,14,14,11,17,14,14,13,15,12,14,14,15,17,6,15,8,12,14,16,16,14,7,11,15,14,7,12,11,13,6,7,3,1,2,1,3,3,3,4,1,2,2,14,14,7,10,15,14,10,12,1,1,1,1,1,1,1,13,1,19,19,1,20,10,176,68,20,9,63083943,7749,8149,7099,Mixed_Race,156,12,1996/12/14,9,3,230768.0,,19242277
770,Pepe Reina,Villarreal,1982,479.0,es ESP,GK,39.0,22.0,0.0,0.0,0.0,0.0,0.0,0.0,1.0,0.0,1.0,0.0,0.0,0.0,1.0,1.0,4.0,4.0,Matches,479.0,es ESP,GK,39.0,22.0,0.0,0.0,0.0,0.0,0.0,0.0,0.0,0.0,0.0,0.0,0.0,0.0,0.0,0.0,0.0,0.0,Matches,35.0,es ESP,GK,39.0,22.0,27.0,4.0,0.0,3.0,1.0,28.9,0.29,2.9,0.13,64.0,207.0,30.9,736.0,112.0,22.1,28.8,118.0,37.3,35.7,315.0,15.0,4.8,20.0,0.91,14.6,Matches,35.0,es ESP,GK,39.0,22.0,22.0,1980.0,22.0,27.0,1.23,87.0,61.0,73.6,13.0,3.0,6.0,5.0,22.7,4.0,4.0,0.0,0.0,0.0,Matches,479.0,es ESP,GK,39.0,22.0,2.0,0.0,0.0,0.0,1.0,0.0,0.0,1.0,0.0,0.0,0.0,0.0,23.0,3.0,0.0,100.0,Matches,479.0,es ESP,GK,39.0,22.0,855.0,678.0,176.0,58.0,0.0,2.0,0.0,0.0,0.0,0.0,0.0,0.0,685.0,1.0,1.0,Matches,479.0,es ESP,GK,39.0,22.0,685.0,855.0,80.1,16159.0,10999.0,142.0,145.0,97.9,400.0,405.0,98.8,143.0,303.0,47.2,0.0,0.7,0.0,-0.7,1.0,5.0,0.0,0.0,0.0,Matches,587,es ESP,GK,39,22,1980.0,90.0,57.9,22.0,22,90.0,22,0,,12,1.91,42.0,27.0,15.0,0.68,0.43,42.1,33.0,9.1,0.41,0.24,Matches,479.0,es ESP,GK,39.0,22.0,900.0,744.0,892.0,8.0,0.0,0.0,900.0,1.0,1.0,100.0,0.0,0.0,541.0,2919.0,1834.0,0.0,0.0,0.0,0.0,0.0,455.0,0.0,Matches,479.0,es ESP,GK,39.0,22.0,0.0,0.0,0.0,,0.0,0.0,,,,0.0,0.0,0.0,0.0,0.0,,0.0,0.0,Matches,479.0,es ESP,GK,39.0,22.0,22.0,1980.0,22.0,0.0,0.0,0.0,0.0,0.0,0.0,2.0,0.0,0.0,0.0,0.7,0.7,0.0,0.0,0.0,0.0,0.0,0.0,0.0,0.0,0.0,0.03,0.03,0.0,0.03,Matches,Pepe Reina,GK,39,129,175,Spain,Villarreal,3,2,2,1,10,8,6,2,2,1,13,4,3,12,10,18,13,16,10,14,12,20,7,17,3,12,14,14,8,8,12,14,20,9,13,13,12,9,13,6,13,11,15,17,13,12,17,12,13,18,13,17,20,20,9,14,14,20,19,12,20,1,1,1,1,1,1,1,1,1,1,1,1,1,188,92,14,20,235490,6450,7259,5717,Mediterranean_Hispanic,131,4,1982/8/31,36,0,10968.0,,6701096
771,Karim Rekik,Sevilla,1994,481.0,nl NED,DF,27.0,13.1,11.0,5.0,8.0,3.0,0.0,4.0,5.0,80.0,1.0,12.0,5.0,7.0,10.0,21.0,24.0,0.0,Matches,481.0,nl NED,DF,27.0,13.1,14.0,1.07,12.0,0.0,0.0,1.0,1.0,0.0,2.0,0.15,2.0,0.0,0.0,0.0,0.0,0.0,Matches,,,,,,,,,,,,,,,,,,,,,,,,,,,,,,,,,,,,,,,,,,,,,,,,,,,,,,,,481.0,nl NED,DF,27.0,13.1,2.0,0.0,0.0,20.0,5.0,0.0,1.0,10.0,5.0,0.0,0.0,1.0,71.0,22.0,10.0,68.8,Matches,481.0,nl NED,DF,27.0,13.1,700.0,671.0,27.0,9.0,0.0,3.0,1.0,18.0,0.0,0.0,0.0,0.0,642.0,2.0,0.0,Matches,481.0,nl NED,DF,27.0,13.1,642.0,700.0,91.7,11249.0,3819.0,262.0,272.0,96.3,333.0,353.0,94.3,38.0,59.0,64.4,1.0,0.1,0.1,0.9,4.0,48.0,2.0,1.0,50.0,Matches,589,nl NED,DF,27,16,1181.0,74.0,34.5,13.1,15,77.0,10,1,24.0,7,1.38,18.0,16.0,2.0,0.15,0.51,17.5,15.2,2.3,0.18,0.59,Matches,481.0,nl NED,DF,27.0,13.1,799.0,56.0,323.0,429.0,52.0,11.0,799.0,6.0,3.0,50.0,3.0,50.0,524.0,2405.0,1309.0,13.0,10.0,1.0,7.0,5.0,569.0,7.0,Matches,481.0,nl NED,DF,27.0,13.1,1.0,8.0,1.0,12.5,0.61,0.08,0.13,1.0,15.6,0.0,0.0,0.0,0.8,0.8,0.1,0.2,0.2,Matches,481.0,nl NED,DF,27.0,16.0,15.0,1181.0,13.1,1.0,1.0,2.0,1.0,0.0,0.0,2.0,0.0,0.8,0.8,0.1,0.9,13.0,50.0,7.0,0.08,0.08,0.15,0.08,0.15,0.06,0.01,0.07,0.06,0.07,Matches,Karim Rekik,D LC,27,139,142,"Holland,Tunisia",Sevilla,4,10,9,7,12,5,13,6,10,14,13,8,15,12,13,12,17,14,12,12,14,15,8,12,8,13,15,13,12,13,17,15,15,13,14,15,13,13,12,7,13,2,3,2,3,3,1,3,1,2,3,2,14,16,10,9,13,14,12,12,1,16,20,1,13,1,1,1,1,1,1,1,1,1,186,79,20,12,22041875,6892,6742,5592,North_African__Middle_Eastern,139,7,1994/12/2,4,0,23077.0,,28068818
772,Álex Remiro,Real Sociedad,1995,482.0,es ESP,GK,27.0,38.0,1.0,1.0,1.0,0.0,0.0,1.0,3.0,33.3,2.0,0.0,0.0,0.0,0.0,1.0,17.0,3.0,Matches,482.0,es ESP,GK,27.0,38.0,6.0,0.16,3.0,3.0,0.0,0.0,0.0,0.0,0.0,0.0,0.0,0.0,0.0,0.0,0.0,0.0,Matches,36.0,es ESP,GK,27.0,38.0,35.0,1.0,1.0,3.0,2.0,32.8,0.24,-0.2,0.0,244.0,572.0,42.7,1090.0,138.0,39.8,35.9,216.0,63.9,51.3,453.0,18.0,4.0,47.0,1.24,15.9,Matches,36.0,es ESP,GK,27.0,38.0,38.0,3420.0,38.0,35.0,0.92,133.0,99.0,74.4,21.0,8.0,9.0,15.0,39.5,2.0,1.0,1.0,0.0,50.0,Matches,482.0,es ESP,GK,27.0,38.0,1.0,0.0,0.0,0.0,4.0,0.0,0.0,0.0,1.0,0.0,0.0,0.0,58.0,7.0,1.0,87.5,Matches,482.0,es ESP,GK,27.0,38.0,1313.0,970.0,336.0,120.0,0.0,3.0,0.0,0.0,0.0,0.0,0.0,0.0,941.0,7.0,0.0,Matches,482.0,es ESP,GK,27.0,38.0,941.0,1313.0,71.7,28583.0,21541.0,142.0,143.0,99.3,442.0,458.0,96.5,357.0,704.0,50.7,0.0,0.0,0.1,0.0,1.0,28.0,0.0,0.0,1.0,Matches,590,es ESP,GK,27,38,3420.0,90.0,100.0,38.0,38,90.0,38,0,,0,1.87,51.0,35.0,16.0,0.42,,52.9,33.0,19.8,0.52,,Matches,482.0,es ESP,GK,27.0,38.0,1390.0,1173.0,1383.0,7.0,0.0,0.0,1390.0,0.0,0.0,,0.0,,805.0,4485.0,2701.0,0.0,0.0,0.0,2.0,0.0,650.0,0.0,Matches,482.0,es ESP,GK,27.0,38.0,0.0,0.0,0.0,,0.0,0.0,,,,0.0,0.0,0.0,0.0,0.0,,0.0,0.0,Matches,482.0,es ESP,GK,27.0,38.0,38.0,3420.0,38.0,0.0,0.0,0.0,0.0,0.0,0.0,1.0,0.0,0.0,0.0,0.0,0.0,0.0,1.0,0.0,0.0,0.0,0.0,0.0,0.0,0.0,0.0,0.0,0.0,0.0,Matches,Álex Remiro,GK,27,150,153,"Spain,Pays Basque",Real San Sebastián,5,2,1,2,11,9,2,3,3,1,17,2,2,16,7,12,12,12,12,12,13,12,5,12,1,13,13,13,13,14,12,15,13,13,11,12,14,6,12,4,16,14,15,13,8,15,15,13,16,14,11,13,11,11,5,14,10,16,14,14,20,1,1,1,1,1,1,1,1,1,1,1,1,1,192,80,10,20,40551639,7493,7493,5493,Mediterranean_Hispanic,147,6,1995/3/24,0,0,42342.0,,67183918
773,Diego Rico,Real Sociedad,1993,486.0,es ESP,DF,29.0,18.3,35.0,21.0,17.0,11.0,7.0,12.0,27.0,44.4,15.0,18.0,5.0,13.0,20.0,55.0,51.0,1.0,Matches,486.0,es ESP,DF,29.0,18.3,33.0,1.81,26.0,2.0,1.0,1.0,1.0,2.0,1.0,0.05,1.0,0.0,0.0,0.0,0.0,0.0,Matches,,,,,,,,,,,,,,,,,,,,,,,,,,,,,,,,,,,,,,,,,,,,,,,,,,,,,,,,486.0,es ESP,DF,29.0,18.3,3.0,0.0,0.0,27.0,26.0,2.0,55.0,20.0,21.0,0.0,0.0,0.0,96.0,18.0,17.0,51.4,Matches,486.0,es ESP,DF,29.0,18.3,985.0,779.0,202.0,21.0,0.0,7.0,55.0,181.0,0.0,0.0,0.0,0.0,746.0,4.0,21.0,Matches,486.0,es ESP,DF,29.0,18.3,746.0,985.0,75.7,12521.0,5657.0,371.0,425.0,87.3,306.0,394.0,77.7,53.0,120.0,44.2,0.0,1.5,1.7,-1.5,10.0,57.0,19.0,10.0,64.0,Matches,595,es ESP,DF,29,20,1646.0,82.0,48.1,18.3,18,85.0,15,2,54.0,11,1.9,25.0,14.0,11.0,0.6,0.35,24.2,15.2,9.0,0.49,-0.06,Matches,486.0,es ESP,DF,29.0,18.3,1186.0,68.0,385.0,514.0,296.0,8.0,1186.0,27.0,13.0,48.1,9.0,33.3,535.0,2659.0,1275.0,32.0,26.0,1.0,24.0,10.0,627.0,72.0,Matches,486.0,es ESP,DF,29.0,18.3,0.0,9.0,3.0,33.3,0.49,0.16,0.0,0.0,27.5,0.0,0.0,0.0,0.2,0.2,0.03,-0.2,-0.2,Matches,486.0,es ESP,DF,29.0,20.0,18.0,1646.0,18.3,0.0,0.0,0.0,0.0,0.0,0.0,3.0,0.0,0.2,0.2,1.5,1.7,32.0,64.0,72.0,0.0,0.0,0.0,0.0,0.0,0.01,0.08,0.09,0.01,0.09,Matches,Diego Rico,D/WB L,29,134,134,Spain,Real San Sebastián,13,14,11,7,12,12,10,13,12,10,12,8,11,12,13,14,12,12,13,10,12,16,13,10,12,11,14,16,14,12,11,12,16,13,16,14,13,11,15,7,14,1,1,3,1,1,1,1,3,2,1,3,15,12,6,14,7,17,13,12,1,20,14,1,20,1,1,12,1,1,1,1,1,1,181,75,20,11,4575237,6700,6700,4250,Mediterranean_Hispanic,128,5,1993/2/23,0,0,15871.0,,67149986
774,Rodrigo Riquelme,Girona,2000,487.0,es ESP,MFFW,22.0,24.2,20.0,8.0,8.0,8.0,4.0,9.0,35.0,25.7,26.0,16.0,0.0,16.0,11.0,31.0,5.0,0.0,Matches,487.0,es ESP,MFFW,22.0,24.2,69.0,2.85,46.0,6.0,10.0,4.0,3.0,0.0,9.0,0.37,3.0,3.0,0.0,2.0,1.0,0.0,Matches,,,,,,,,,,,,,,,,,,,,,,,,,,,,,,,,,,,,,,,,,,,,,,,,,,,,,,,,487.0,es ESP,MFFW,22.0,24.2,1.0,0.0,0.0,27.0,36.0,5.0,78.0,11.0,8.0,0.0,1.0,0.0,111.0,9.0,13.0,40.9,Matches,487.0,es ESP,MFFW,22.0,24.2,715.0,677.0,34.0,13.0,4.0,3.0,78.0,7.0,11.0,6.0,1.0,0.0,497.0,4.0,29.0,Matches,487.0,es ESP,MFFW,22.0,24.2,497.0,715.0,69.5,7275.0,2261.0,286.0,350.0,81.7,162.0,230.0,70.4,26.0,69.0,37.7,4.0,3.7,3.8,0.3,33.0,42.0,28.0,7.0,85.0,Matches,596,es ESP,MFFW,22,34,2179.0,64.0,63.7,24.2,25,77.0,6,9,28.0,1,1.32,37.0,41.0,-4.0,-0.17,-0.67,31.1,39.3,-8.3,-0.34,-0.63,Matches,487.0,es ESP,MFFW,22.0,24.2,1021.0,14.0,136.0,379.0,528.0,89.0,1021.0,143.0,57.0,39.9,71.0,49.7,717.0,6218.0,3354.0,116.0,97.0,42.0,62.0,30.0,764.0,171.0,Matches,487.0,es ESP,MFFW,22.0,24.2,4.0,56.0,22.0,39.3,2.31,0.91,0.07,0.18,20.0,2.0,0.0,0.0,4.0,4.0,0.07,0.0,0.0,Matches,487.0,es ESP,MFFW,22.0,34.0,25.0,2179.0,24.2,4.0,4.0,8.0,4.0,0.0,0.0,1.0,0.0,4.0,4.0,3.7,7.7,116.0,85.0,171.0,0.17,0.17,0.33,0.17,0.33,0.17,0.15,0.32,0.17,0.32,Matches,Rodrigo Riquelme,AM RLC,22,123,148,Spain,A. Madrid,11,11,14,12,14,13,7,11,7,7,12,13,7,15,11,13,10,10,11,14,13,14,15,8,12,7,11,11,14,13,12,8,12,12,10,9,11,8,9,8,14,2,4,1,2,2,3,1,3,4,1,3,14,11,8,12,10,12,14,15,1,1,1,1,1,1,10,15,15,15,18,20,19,13,174,0,12,20,4837499,6149,6149,3999,Mediterranean_Hispanic,118,4,2000/4/2,0,0,6759.0,Girona,67259880
775,Sergi Roberto,Barcelona,1992,488.0,es ESP,DFMF,30.0,14.5,22.0,15.0,12.0,6.0,4.0,7.0,18.0,38.9,11.0,15.0,7.0,8.0,11.0,33.0,16.0,0.0,Matches,488.0,es ESP,DFMF,30.0,14.5,29.0,2.0,24.0,0.0,0.0,4.0,1.0,0.0,3.0,0.21,3.0,0.0,0.0,0.0,0.0,0.0,Matches,,,,,,,,,,,,,,,,,,,,,,,,,,,,,,,,,,,,,,,,,,,,,,,,,,,,,,,,488.0,es ESP,DFMF,30.0,14.5,3.0,0.0,0.0,19.0,12.0,2.0,25.0,11.0,15.0,0.0,0.0,0.0,62.0,7.0,12.0,36.8,Matches,488.0,es ESP,DFMF,30.0,14.5,936.0,842.0,91.0,16.0,1.0,7.0,25.0,75.0,0.0,0.0,0.0,0.0,850.0,3.0,10.0,Matches,488.0,es ESP,DFMF,30.0,14.5,850.0,936.0,90.8,12315.0,2769.0,514.0,535.0,96.1,270.0,303.0,89.1,48.0,64.0,75.0,1.0,0.9,1.3,0.1,10.0,80.0,14.0,6.0,97.0,Matches,598,es ESP,DFMF,30,23,1308.0,57.0,38.2,14.5,15,73.0,5,8,27.0,6,2.13,24.0,10.0,14.0,0.96,-0.57,25.0,11.8,13.2,0.91,-0.32,Matches,488.0,es ESP,DFMF,30.0,14.5,1051.0,30.0,179.0,565.0,312.0,31.0,1051.0,13.0,5.0,38.5,4.0,30.8,658.0,2976.0,1773.0,47.0,32.0,6.0,9.0,3.0,781.0,72.0,Matches,488.0,es ESP,DFMF,30.0,14.5,4.0,18.0,6.0,33.3,1.24,0.41,0.22,0.67,15.6,0.0,0.0,0.0,2.4,2.4,0.13,1.6,1.6,Matches,488.0,es ESP,DFMF,30.0,23.0,15.0,1308.0,14.5,4.0,1.0,5.0,4.0,0.0,0.0,3.0,0.0,2.4,2.4,0.9,3.3,47.0,97.0,72.0,0.28,0.07,0.34,0.28,0.34,0.17,0.06,0.23,0.17,0.23,Matches,Sergi Roberto,DM/M RC,30,145,155,Spain,Barcelona,10,13,13,10,14,8,8,11,10,10,14,12,12,14,11,13,12,14,14,14,14,14,13,13,14,13,16,16,14,12,12,9,15,14,16,11,14,9,13,8,18,3,3,1,2,2,2,3,2,3,2,1,10,13,5,16,12,15,14,14,1,1,1,15,1,15,18,1,20,15,1,8,10,1,178,68,11,20,11344947,7249,7249,6749,Mediterranean_Hispanic,141,5,1992/2/7,11,1,86300.0,,67063007
776,Lucas Robertone,Almería,1997,489.0,ar ARG,MF,25.0,31.6,50.0,28.0,20.0,21.0,9.0,28.0,64.0,43.8,36.0,45.0,7.0,38.0,46.0,96.0,46.0,1.0,Matches,489.0,ar ARG,MF,25.0,31.6,109.0,3.45,74.0,25.0,3.0,2.0,4.0,1.0,11.0,0.35,6.0,4.0,1.0,0.0,0.0,0.0,Matches,,,,,,,,,,,,,,,,,,,,,,,,,,,,,,,,,,,,,,,,,,,,,,,,,,,,,,,,489.0,ar ARG,MF,25.0,31.6,7.0,0.0,0.0,33.0,89.0,3.0,137.0,46.0,28.0,0.0,0.0,0.0,207.0,20.0,36.0,35.7,Matches,489.0,ar ARG,MF,25.0,31.6,1364.0,1211.0,147.0,68.0,10.0,15.0,137.0,12.0,64.0,25.0,34.0,0.0,1051.0,6.0,18.0,Matches,489.0,ar ARG,MF,25.0,31.6,1051.0,1364.0,77.1,18461.0,6242.0,507.0,573.0,88.5,369.0,437.0,84.4,135.0,269.0,50.2,7.0,6.6,4.5,0.4,53.0,115.0,34.0,13.0,155.0,Matches,599,ar ARG,MF,25,37,2843.0,77.0,83.1,31.6,34,81.0,12,3,33.0,0,1.11,44.0,47.0,-3.0,-0.09,1.93,37.3,47.7,-10.3,-0.33,0.72,Matches,489.0,ar ARG,MF,25.0,31.6,1711.0,67.0,345.0,918.0,479.0,38.0,1711.0,68.0,27.0,39.7,30.0,44.1,928.0,4923.0,2510.0,47.0,48.0,7.0,44.0,19.0,1081.0,97.0,Matches,489.0,ar ARG,MF,25.0,31.6,2.0,37.0,7.0,18.9,1.17,0.22,0.05,0.29,25.4,4.0,0.0,0.0,2.6,2.6,0.07,-0.6,-0.6,Matches,489.0,ar ARG,MF,25.0,37.0,34.0,2843.0,31.6,2.0,7.0,9.0,2.0,0.0,0.0,7.0,0.0,2.6,2.6,6.6,9.2,47.0,155.0,97.0,0.06,0.22,0.28,0.06,0.28,0.08,0.21,0.29,0.08,0.29,Matches,Lucas Robertone,M/AM C,25,132,145,"Argentina,Italy",Almería,14,13,10,12,14,15,9,15,5,9,12,12,8,14,13,13,13,14,12,16,13,13,14,8,16,12,14,13,13,13,12,8,13,12,13,11,12,12,13,6,12,2,3,3,3,3,3,2,2,1,2,3,16,12,5,10,13,13,15,8,1,1,1,1,1,1,8,1,19,12,1,20,6,1,173,70,10,20,7291188,6592,6842,4192,Mediterranean_Hispanic,131,9,1997/3/18,0,0,11722.0,,14112088
777,Enzo Roco,Elche,1992,491.0,cl CHI,DF,29.0,18.4,33.0,13.0,23.0,10.0,0.0,15.0,24.0,62.5,9.0,22.0,15.0,7.0,17.0,50.0,63.0,1.0,Matches,491.0,cl CHI,DF,29.0,18.4,12.0,0.65,9.0,0.0,1.0,1.0,0.0,1.0,0.0,0.0,0.0,0.0,0.0,0.0,0.0,0.0,Matches,,,,,,,,,,,,,,,,,,,,,,,,,,,,,,,,,,,,,,,,,,,,,,,,,,,,,,,,491.0,cl CHI,DF,29.0,18.4,7.0,1.0,1.0,34.0,10.0,0.0,1.0,17.0,13.0,0.0,4.0,0.0,83.0,46.0,20.0,69.7,Matches,491.0,cl CHI,DF,29.0,18.4,719.0,676.0,38.0,33.0,1.0,5.0,1.0,4.0,0.0,0.0,0.0,0.0,587.0,5.0,7.0,Matches,491.0,cl CHI,DF,29.0,18.4,587.0,719.0,81.6,11519.0,4677.0,189.0,222.0,85.1,311.0,346.0,89.9,75.0,119.0,63.0,0.0,0.0,0.3,0.0,1.0,43.0,4.0,0.0,42.0,Matches,601,cl CHI,DF,29,22,1652.0,75.0,48.3,18.4,19,80.0,11,3,42.0,12,0.59,16.0,36.0,-20.0,-1.09,-0.22,18.4,36.4,-18.1,-0.98,-0.25,Matches,491.0,cl CHI,DF,29.0,18.4,891.0,113.0,486.0,376.0,37.0,15.0,891.0,5.0,3.0,60.0,2.0,40.0,474.0,2360.0,1228.0,6.0,6.0,0.0,7.0,0.0,494.0,2.0,Matches,491.0,cl CHI,DF,29.0,18.4,0.0,10.0,3.0,30.0,0.54,0.16,0.0,0.0,10.3,0.0,0.0,0.0,0.6,0.6,0.06,-0.6,-0.6,Matches,491.0,cl CHI,DF,29.0,22.0,19.0,1652.0,18.4,0.0,0.0,0.0,0.0,0.0,0.0,7.0,1.0,0.6,0.6,0.0,0.6,6.0,42.0,2.0,0.0,0.0,0.0,0.0,0.0,0.03,0.0,0.03,0.03,0.03,Matches,Enzo Roco,D C,29,125,135,Chile,Elche,5,5,5,5,10,4,16,8,7,15,12,4,16,8,13,13,16,10,14,10,12,13,8,10,8,15,14,14,9,7,16,16,16,10,12,16,10,14,10,4,8,1,4,3,1,3,3,3,3,1,2,1,12,13,8,13,12,13,11,11,1,1,20,1,1,1,1,1,1,1,1,1,1,1,192,86,8,20,1647079,6250,6250,5000,Mediterranean_Hispanic,123,7,1992/8/16,33,1,6639.0,,75015199
778,Dani Rodríguez,Mallorca,1988,495.0,es ESP,MF,34.0,23.3,42.0,23.0,18.0,22.0,2.0,21.0,46.0,45.7,25.0,31.0,8.0,23.0,21.0,63.0,14.0,0.0,Matches,495.0,es ESP,MF,34.0,23.3,54.0,2.31,39.0,4.0,4.0,3.0,3.0,1.0,10.0,0.43,8.0,1.0,0.0,0.0,0.0,1.0,Matches,,,,,,,,,,,,,,,,,,,,,,,,,,,,,,,,,,,,,,,,,,,,,,,,,,,,,,,,495.0,es ESP,MF,34.0,23.3,8.0,0.0,0.0,49.0,33.0,4.0,32.0,21.0,23.0,0.0,0.0,0.0,133.0,11.0,37.0,22.9,Matches,495.0,es ESP,MF,34.0,23.3,685.0,647.0,32.0,9.0,5.0,14.0,32.0,1.0,7.0,2.0,2.0,0.0,537.0,6.0,31.0,Matches,495.0,es ESP,MF,34.0,23.3,537.0,685.0,78.4,8403.0,2192.0,310.0,348.0,89.1,153.0,191.0,80.1,48.0,77.0,62.3,6.0,3.2,2.4,2.8,26.0,50.0,19.0,2.0,76.0,Matches,606,es ESP,MF,34,35,2100.0,60.0,61.4,23.3,26,73.0,3,9,24.0,0,1.23,23.0,26.0,-3.0,-0.13,0.08,19.5,31.6,-12.1,-0.52,-0.58,Matches,495.0,es ESP,MF,34.0,23.3,950.0,27.0,186.0,481.0,299.0,42.0,950.0,55.0,28.0,50.9,24.0,43.6,559.0,3428.0,1525.0,43.0,29.0,8.0,47.0,37.0,604.0,64.0,Matches,495.0,es ESP,MF,34.0,23.3,3.0,25.0,10.0,40.0,1.07,0.43,0.12,0.3,17.9,0.0,0.0,0.0,2.4,2.4,0.1,0.6,0.6,Matches,495.0,es ESP,MF,34.0,35.0,26.0,2100.0,23.3,3.0,6.0,9.0,3.0,0.0,0.0,8.0,0.0,2.4,2.4,3.2,5.6,43.0,76.0,64.0,0.13,0.26,0.39,0.13,0.39,0.1,0.14,0.24,0.1,0.24,Matches,Dani Rodríguez,DM/M/AM RLC,34,128,130,Spain,Mallorca,10,12,14,13,13,11,11,16,3,5,12,10,6,13,13,12,12,13,12,13,14,15,13,13,13,8,14,14,12,13,12,9,12,14,13,10,14,6,11,4,8,3,4,1,1,1,2,3,2,3,2,3,14,10,3,8,13,12,13,14,1,1,1,1,1,1,18,1,20,1,15,16,15,1,178,69,12,20,379939,6350,6350,3750,Mediterranean_Hispanic,121,6,1988/6/6,0,0,7875.0,,1509441
779,Guido Rodríguez,Betis,1994,496.0,ar ARG,MF,28.0,31.9,115.0,75.0,59.0,50.0,6.0,54.0,101.0,53.5,47.0,58.0,14.0,44.0,42.0,157.0,76.0,1.0,Matches,496.0,ar ARG,MF,28.0,31.9,37.0,1.16,32.0,1.0,0.0,2.0,2.0,0.0,2.0,0.06,2.0,0.0,0.0,0.0,0.0,0.0,Matches,,,,,,,,,,,,,,,,,,,,,,,,,,,,,,,,,,,,,,,,,,,,,,,,,,,,,,,,496.0,ar ARG,MF,28.0,31.9,8.0,0.0,0.0,45.0,64.0,1.0,9.0,42.0,75.0,0.0,0.0,1.0,213.0,44.0,46.0,48.9,Matches,496.0,ar ARG,MF,28.0,31.9,1688.0,1596.0,86.0,84.0,3.0,20.0,9.0,2.0,0.0,0.0,0.0,0.0,1464.0,6.0,14.0,Matches,496.0,ar ARG,MF,28.0,31.9,1464.0,1688.0,86.7,23761.0,7863.0,729.0,796.0,91.6,541.0,604.0,89.6,129.0,189.0,68.3,0.0,0.3,0.8,-0.3,11.0,133.0,9.0,1.0,123.0,Matches,608,ar ARG,MF,28,34,2872.0,84.0,84.0,31.9,33,86.0,27,1,45.0,1,1.56,38.0,32.0,6.0,0.19,0.35,41.4,41.2,0.1,0.0,-0.19,Matches,496.0,ar ARG,MF,28.0,31.9,2064.0,118.0,607.0,1248.0,229.0,18.0,2064.0,35.0,22.0,62.9,8.0,22.9,1033.0,3909.0,1738.0,11.0,14.0,3.0,17.0,21.0,1301.0,18.0,Matches,496.0,ar ARG,MF,28.0,31.9,1.0,22.0,6.0,27.3,0.69,0.19,0.05,0.17,24.0,0.0,0.0,0.0,1.2,1.2,0.06,-0.2,-0.2,Matches,496.0,ar ARG,MF,28.0,34.0,33.0,2872.0,31.9,1.0,0.0,1.0,1.0,0.0,0.0,8.0,0.0,1.2,1.2,0.3,1.6,11.0,123.0,18.0,0.03,0.0,0.03,0.03,0.03,0.04,0.01,0.05,0.04,0.05,Matches,Guido Rodríguez,DM/M C,28,155,162,"Argentina,Italy",Real Hispalis,10,11,12,6,15,8,11,10,4,14,14,4,18,12,12,16,12,14,14,13,15,16,12,11,13,18,17,16,12,13,15,10,13,11,13,12,16,10,10,7,12,1,2,2,2,1,2,3,4,3,2,1,14,13,5,10,13,15,14,12,1,1,10,1,1,1,20,1,20,10,1,1,1,1,185,80,12,20,23388425,7250,7250,6050,Mediterranean_Hispanic,148,9,1994/4/12,24,1,31008.0,,14043255
780,Rodrygo,Real Madrid,2001,498.0,br BRA,FWMF,21.0,26.4,17.0,10.0,3.0,7.0,7.0,4.0,23.0,17.4,19.0,23.0,0.0,23.0,8.0,25.0,5.0,0.0,Matches,498.0,br BRA,FWMF,21.0,26.4,133.0,5.03,78.0,5.0,25.0,9.0,15.0,1.0,21.0,0.79,12.0,0.0,6.0,0.0,3.0,0.0,Matches,,,,,,,,,,,,,,,,,,,,,,,,,,,,,,,,,,,,,,,,,,,,,,,,,,,,,,,,498.0,br BRA,FWMF,21.0,26.4,4.0,0.0,0.0,18.0,49.0,10.0,22.0,8.0,10.0,2.0,0.0,0.0,63.0,14.0,23.0,37.8,Matches,498.0,br BRA,FWMF,21.0,26.4,1050.0,991.0,51.0,6.0,2.0,6.0,22.0,9.0,18.0,3.0,2.0,0.0,918.0,8.0,24.0,Matches,498.0,br BRA,FWMF,21.0,26.4,918.0,1050.0,87.4,10744.0,2092.0,650.0,702.0,92.6,162.0,188.0,86.2,33.0,43.0,76.7,8.0,7.0,6.2,1.0,47.0,63.0,28.0,3.0,81.0,Matches,610,br BRA,FWMF,21,34,2379.0,70.0,69.6,26.4,25,86.0,15,9,24.0,0,2.0,54.0,27.0,27.0,1.02,-0.02,56.8,26.6,30.2,1.14,0.59,Matches,498.0,br BRA,FWMF,21.0,26.4,1400.0,3.0,56.0,537.0,823.0,204.0,1399.0,169.0,81.0,47.9,68.0,40.2,1035.0,6613.0,3658.0,146.0,81.0,79.0,64.0,30.0,1198.0,268.0,Matches,498.0,br BRA,FWMF,21.0,26.4,9.0,97.0,31.0,32.0,3.67,1.17,0.08,0.26,16.6,8.0,1.0,1.0,13.7,12.9,0.13,-4.7,-4.9,Matches,498.0,br BRA,FWMF,21.0,34.0,25.0,2379.0,26.4,9.0,8.0,17.0,8.0,1.0,1.0,4.0,0.0,13.7,12.9,7.0,19.9,146.0,81.0,268.0,0.34,0.3,0.64,0.3,0.61,0.52,0.26,0.78,0.49,0.75,Matches,Rodrygo,AM/S RL,21,152,175,Brazil,R. Madrid,7,12,15,17,15,8,12,12,8,5,14,12,6,15,11,13,13,14,14,12,14,14,15,11,15,9,12,14,15,16,14,9,12,15,14,13,13,7,13,9,11,1,3,3,2,2,2,1,3,4,2,1,12,13,5,14,13,15,15,15,1,1,1,1,1,1,1,12,1,14,19,1,20,16,174,64,10,20,55200001,7595,7495,6995,African_Caribbean,148,12,2001/1/9,5,1,154109.0,,19306929
781,Oriol Romeu,Girona,1991,501.0,es ESP,MF,30.0,32.8,70.0,38.0,36.0,26.0,8.0,26.0,51.0,51.0,25.0,48.0,10.0,38.0,37.0,107.0,54.0,0.0,Matches,501.0,es ESP,MF,30.0,32.8,56.0,1.71,49.0,0.0,0.0,4.0,2.0,1.0,3.0,0.09,3.0,0.0,0.0,0.0,0.0,0.0,Matches,,,,,,,,,,,,,,,,,,,,,,,,,,,,,,,,,,,,,,,,,,,,,,,,,,,,,,,,501.0,es ESP,MF,30.0,32.8,10.0,1.0,1.0,59.0,33.0,0.0,13.0,37.0,38.0,0.0,1.0,0.0,195.0,39.0,46.0,45.9,Matches,501.0,es ESP,MF,30.0,32.8,1626.0,1576.0,43.0,41.0,3.0,12.0,13.0,2.0,0.0,0.0,0.0,0.0,1405.0,7.0,19.0,Matches,501.0,es ESP,MF,30.0,32.8,1405.0,1626.0,86.4,24124.0,6512.0,641.0,695.0,92.2,593.0,655.0,90.5,123.0,187.0,65.8,0.0,0.9,1.3,-0.9,20.0,124.0,16.0,3.0,133.0,Matches,616,es ESP,MF,30,33,2950.0,89.0,86.3,32.8,33,89.0,31,0,,0,1.36,52.0,47.0,5.0,0.15,0.54,45.9,46.6,-0.7,-0.02,0.66,Matches,501.0,es ESP,MF,30.0,32.8,1952.0,109.0,589.0,1119.0,259.0,28.0,1952.0,24.0,20.0,83.3,1.0,4.2,1148.0,4448.0,2067.0,15.0,29.0,1.0,26.0,28.0,1318.0,16.0,Matches,501.0,es ESP,MF,30.0,32.8,2.0,24.0,5.0,20.8,0.73,0.15,0.08,0.4,17.8,0.0,0.0,0.0,1.6,1.6,0.07,0.4,0.4,Matches,501.0,es ESP,MF,30.0,33.0,33.0,2950.0,32.8,2.0,0.0,2.0,2.0,0.0,0.0,10.0,1.0,1.6,1.6,0.9,2.5,15.0,133.0,16.0,0.06,0.0,0.06,0.06,0.06,0.05,0.03,0.08,0.05,0.08,Matches,Oriol Romeu,DM/M C,30,142,145,Spain,Girona,7,8,9,9,14,6,12,9,10,14,14,8,17,14,15,16,17,16,15,14,16,12,6,13,7,16,18,17,7,10,13,12,18,7,18,16,16,8,12,11,12,1,3,3,3,3,3,3,2,1,3,1,13,16,8,10,13,14,10,12,1,1,14,8,1,8,20,1,20,1,1,1,1,1,182,79,9,20,12052989,7100,6400,5650,Mediterranean_Hispanic,142,7,1991/9/24,0,0,52196.0,,67043255
782,Antonio Rüdiger,Real Madrid,1993,503.0,de GER,DF,29.0,26.8,18.0,16.0,12.0,5.0,1.0,14.0,23.0,60.9,9.0,23.0,13.0,10.0,19.0,37.0,74.0,0.0,Matches,503.0,de GER,DF,29.0,26.8,18.0,0.67,16.0,0.0,0.0,1.0,1.0,0.0,1.0,0.04,0.0,0.0,0.0,1.0,0.0,0.0,Matches,,,,,,,,,,,,,,,,,,,,,,,,,,,,,,,,,,,,,,,,,,,,,,,,,,,,,,,,503.0,de GER,DF,29.0,26.8,1.0,0.0,0.0,13.0,7.0,2.0,5.0,19.0,16.0,0.0,0.0,0.0,158.0,37.0,22.0,62.7,Matches,503.0,de GER,DF,29.0,26.8,1617.0,1562.0,55.0,25.0,3.0,16.0,5.0,20.0,0.0,0.0,0.0,0.0,1486.0,0.0,14.0,Matches,503.0,de GER,DF,29.0,26.8,1486.0,1617.0,91.9,26566.0,8924.0,595.0,621.0,95.8,768.0,807.0,95.2,109.0,153.0,71.2,0.0,0.1,0.9,-0.1,2.0,75.0,6.0,0.0,59.0,Matches,618,de GER,DF,29,33,2415.0,73.0,70.6,26.8,26,90.0,25,7,12.0,2,2.0,44.0,25.0,19.0,0.71,-1.08,51.1,27.2,23.8,0.89,-0.25,Matches,503.0,de GER,DF,29.0,26.8,1814.0,194.0,907.0,840.0,79.0,25.0,1814.0,4.0,3.0,75.0,1.0,25.0,1216.0,5991.0,3731.0,21.0,11.0,0.0,8.0,2.0,1339.0,10.0,Matches,503.0,de GER,DF,29.0,26.8,1.0,22.0,4.0,18.2,0.82,0.15,0.05,0.25,14.8,0.0,0.0,0.0,1.8,1.8,0.08,-0.8,-0.8,Matches,503.0,de GER,DF,29.0,33.0,26.0,2415.0,26.8,1.0,0.0,1.0,1.0,0.0,0.0,1.0,0.0,1.8,1.8,0.1,1.9,21.0,59.0,10.0,0.04,0.0,0.04,0.04,0.04,0.07,0.0,0.07,0.07,0.07,Matches,Antonio Rüdiger,D C,29,166,166,"Germany,Sierra Leone",R. Madrid,5,10,10,7,10,9,15,8,14,15,12,7,17,11,18,15,18,13,14,10,17,17,9,18,8,14,13,15,17,9,17,15,15,16,16,18,16,14,12,14,13,3,3,1,2,1,4,1,3,3,3,1,15,17,15,9,13,15,9,11,1,10,20,12,1,1,1,1,1,1,1,1,1,1,190,85,10,20,123524990,8300,7700,7000,African_Caribbean,165,17,1993/3/3,53,2,244754.0,,92023410
783,Aitor Ruibal,Betis,1996,504.0,es ESP,DFFW,26.0,16.2,47.0,29.0,35.0,9.0,3.0,31.0,58.0,53.4,27.0,17.0,2.0,15.0,24.0,71.0,41.0,0.0,Matches,504.0,es ESP,DFFW,26.0,16.2,37.0,2.29,26.0,0.0,5.0,4.0,1.0,1.0,1.0,0.06,1.0,0.0,0.0,0.0,0.0,0.0,Matches,,,,,,,,,,,,,,,,,,,,,,,,,,,,,,,,,,,,,,,,,,,,,,,,,,,,,,,,504.0,es ESP,DFFW,26.0,16.2,4.0,1.0,0.0,22.0,18.0,3.0,31.0,24.0,29.0,0.0,0.0,0.0,102.0,14.0,18.0,43.8,Matches,504.0,es ESP,DFFW,26.0,16.2,841.0,691.0,148.0,18.0,1.0,10.0,31.0,130.0,0.0,0.0,0.0,0.0,647.0,2.0,22.0,Matches,504.0,es ESP,DFFW,26.0,16.2,647.0,841.0,76.9,10213.0,3689.0,356.0,394.0,90.4,212.0,281.0,75.4,51.0,100.0,51.0,0.0,2.1,1.1,-2.1,15.0,51.0,12.0,5.0,62.0,Matches,619,es ESP,DFFW,26,26,1454.0,56.0,42.5,16.2,15,83.0,8,11,19.0,10,1.35,15.0,13.0,2.0,0.12,-0.01,20.6,22.0,-1.4,-0.09,-0.21,Matches,504.0,es ESP,DFFW,26.0,16.2,1062.0,44.0,338.0,468.0,278.0,24.0,1062.0,67.0,35.0,52.2,31.0,46.3,559.0,2936.0,1818.0,38.0,27.0,8.0,24.0,13.0,597.0,70.0,Matches,504.0,es ESP,DFFW,26.0,16.2,0.0,15.0,6.0,40.0,0.93,0.37,0.0,0.0,19.8,0.0,0.0,0.0,0.8,0.8,0.06,-0.8,-0.8,Matches,504.0,es ESP,DFFW,26.0,26.0,15.0,1454.0,16.2,0.0,0.0,0.0,0.0,0.0,0.0,4.0,1.0,0.8,0.8,2.1,3.0,38.0,62.0,70.0,0.0,0.0,0.0,0.0,0.0,0.05,0.13,0.18,0.05,0.18,Matches,Aitor Ruibal,D/M/AM/S RL,26,138,143,Spain,Real Hispalis,10,12,12,11,11,8,8,11,9,8,10,11,10,12,12,12,13,12,12,12,13,14,12,10,12,10,13,14,12,12,11,11,14,14,13,13,12,9,11,6,15,2,1,1,2,2,1,3,2,1,4,1,9,13,6,12,12,14,14,12,1,1,1,17,1,14,1,14,1,18,16,1,20,16,180,75,12,20,4452543,6500,6500,4000,Mediterranean_Hispanic,120,3,1996/3/22,0,0,10816.0,,67220941
784,Gerónimo Rulli,Villarreal,1992,506.0,ar ARG,GK,30.0,14.0,0.0,0.0,0.0,0.0,0.0,0.0,0.0,,0.0,1.0,0.0,1.0,1.0,1.0,6.0,2.0,Matches,506.0,ar ARG,GK,30.0,14.0,1.0,0.07,1.0,0.0,0.0,0.0,0.0,0.0,0.0,0.0,0.0,0.0,0.0,0.0,0.0,0.0,Matches,38.0,ar ARG,GK,30.0,14.0,10.0,0.0,0.0,1.0,0.0,12.5,0.23,2.5,0.18,50.0,119.0,42.0,451.0,70.0,19.3,28.8,92.0,34.8,37.9,215.0,20.0,9.3,21.0,1.5,15.5,Matches,38.0,ar ARG,GK,30.0,14.0,14.0,1260.0,14.0,10.0,0.71,56.0,46.0,82.1,6.0,3.0,5.0,7.0,50.0,0.0,0.0,0.0,0.0,,Matches,506.0,ar ARG,GK,30.0,14.0,1.0,0.0,0.0,0.0,1.0,0.0,0.0,1.0,0.0,0.0,0.0,0.0,20.0,3.0,0.0,100.0,Matches,506.0,ar ARG,GK,30.0,14.0,543.0,419.0,124.0,32.0,0.0,0.0,0.0,0.0,0.0,0.0,0.0,0.0,464.0,0.0,2.0,Matches,506.0,ar ARG,GK,30.0,14.0,464.0,543.0,85.5,11876.0,7752.0,82.0,83.0,98.8,270.0,271.0,99.6,109.0,184.0,59.2,0.0,0.0,0.0,0.0,0.0,6.0,0.0,0.0,0.0,Matches,621,ar ARG,GK,30,14,1260.0,90.0,36.8,14.0,14,90.0,14,0,,1,1.5,15.0,10.0,5.0,0.36,-0.23,17.1,14.1,3.1,0.22,-0.14,Matches,506.0,ar ARG,GK,30.0,14.0,579.0,476.0,577.0,3.0,0.0,0.0,579.0,0.0,0.0,,0.0,,335.0,1591.0,1061.0,0.0,0.0,0.0,0.0,0.0,283.0,0.0,Matches,506.0,ar ARG,GK,30.0,14.0,0.0,0.0,0.0,,0.0,0.0,,,,0.0,0.0,0.0,0.0,0.0,,0.0,0.0,Matches,506.0,ar ARG,GK,30.0,14.0,14.0,1260.0,14.0,0.0,0.0,0.0,0.0,0.0,0.0,1.0,0.0,0.0,0.0,0.0,0.0,0.0,0.0,0.0,0.0,0.0,0.0,0.0,0.0,0.0,0.0,0.0,0.0,0.0,Matches,Gerónimo Rulli,GK,30,143,159,"Argentina,Italy",Villarreal,6,2,1,1,12,8,6,3,3,1,12,4,3,13,8,15,15,12,13,10,11,11,1,11,2,13,14,11,12,15,7,14,15,11,13,12,13,8,13,5,14,13,14,12,10,13,15,18,17,14,14,13,15,15,5,18,10,20,13,8,20,1,1,1,1,1,1,1,1,1,1,1,1,1,189,84,8,20,16510627,7150,7150,6000,Mediterranean_Hispanic,142,4,1992/4/10,3,0,45995.0,,14030119
785,Youssouf Sabaly,Betis,1993,508.0,sn SEN,DF,29.0,18.7,45.0,23.0,29.0,14.0,2.0,22.0,33.0,66.7,11.0,35.0,8.0,27.0,19.0,64.0,52.0,1.0,Matches,508.0,sn SEN,DF,29.0,18.7,33.0,1.77,19.0,2.0,7.0,1.0,3.0,1.0,2.0,0.11,0.0,0.0,1.0,1.0,0.0,0.0,Matches,,,,,,,,,,,,,,,,,,,,,,,,,,,,,,,,,,,,,,,,,,,,,,,,,,,,,,,,508.0,sn SEN,DF,29.0,18.7,2.0,0.0,0.0,20.0,33.0,2.0,17.0,19.0,23.0,0.0,0.0,0.0,109.0,5.0,11.0,31.3,Matches,508.0,sn SEN,DF,29.0,18.7,949.0,769.0,176.0,19.0,0.0,1.0,17.0,157.0,0.0,0.0,0.0,0.0,780.0,4.0,25.0,Matches,508.0,sn SEN,DF,29.0,18.7,780.0,949.0,82.2,10707.0,4336.0,468.0,514.0,91.1,249.0,313.0,79.6,25.0,55.0,45.5,1.0,0.7,0.5,0.3,12.0,51.0,9.0,1.0,72.0,Matches,624,sn SEN,DF,29,23,1680.0,73.0,49.1,18.7,19,85.0,14,4,17.0,4,1.65,26.0,18.0,8.0,0.43,0.58,25.4,23.3,2.0,0.11,0.15,Matches,508.0,sn SEN,DF,29.0,18.7,1179.0,83.0,388.0,521.0,284.0,16.0,1179.0,39.0,19.0,48.7,13.0,33.3,619.0,3101.0,1754.0,41.0,36.0,3.0,25.0,25.0,671.0,64.0,Matches,508.0,sn SEN,DF,29.0,18.7,1.0,12.0,3.0,25.0,0.64,0.16,0.08,0.33,22.7,0.0,0.0,0.0,0.5,0.5,0.04,0.5,0.5,Matches,508.0,sn SEN,DF,29.0,23.0,19.0,1680.0,18.7,1.0,1.0,2.0,1.0,0.0,0.0,2.0,0.0,0.5,0.5,0.7,1.2,41.0,72.0,64.0,0.05,0.05,0.11,0.05,0.11,0.02,0.04,0.06,0.02,0.06,Matches,Youssouf Sabaly,D/WB R,29,136,141,"Senegal,France",Real Hispalis,8,14,12,7,12,7,10,10,12,13,12,10,14,12,14,14,12,13,14,10,13,15,12,10,16,10,14,16,14,13,15,10,16,14,15,15,14,12,12,15,12,1,1,1,1,1,2,2,3,2,1,1,14,15,6,15,12,13,12,14,1,14,1,20,12,17,1,1,1,1,1,1,1,1,174,68,10,20,4121075,6450,6550,4500,African_Caribbean,135,17,1993/3/5,24,0,20698.0,,85057304
786,Fede San Emeterio,Cádiz,1997,514.0,es ESP,MF,25.0,20.5,41.0,22.0,23.0,16.0,2.0,22.0,46.0,47.8,24.0,34.0,14.0,20.0,17.0,58.0,28.0,0.0,Matches,514.0,es ESP,MF,25.0,20.5,18.0,0.88,15.0,0.0,0.0,2.0,0.0,1.0,2.0,0.1,1.0,0.0,0.0,1.0,0.0,0.0,Matches,,,,,,,,,,,,,,,,,,,,,,,,,,,,,,,,,,,,,,,,,,,,,,,,,,,,,,,,514.0,es ESP,MF,25.0,20.5,14.0,0.0,0.0,58.0,22.0,0.0,4.0,17.0,22.0,0.0,0.0,0.0,87.0,23.0,30.0,43.4,Matches,514.0,es ESP,MF,25.0,20.5,657.0,640.0,12.0,12.0,2.0,4.0,4.0,0.0,0.0,0.0,0.0,0.0,518.0,5.0,12.0,Matches,514.0,es ESP,MF,25.0,20.5,518.0,657.0,78.8,8578.0,2348.0,274.0,318.0,86.2,188.0,231.0,81.4,43.0,72.0,59.7,1.0,0.8,0.4,0.2,6.0,45.0,5.0,1.0,45.0,Matches,631,es ESP,MF,25,33,1844.0,56.0,53.9,20.5,24,69.0,3,9,22.0,0,1.18,16.0,23.0,-7.0,-0.34,0.57,21.7,31.5,-9.9,-0.48,0.1,Matches,514.0,es ESP,MF,25.0,20.5,834.0,64.0,251.0,498.0,91.0,8.0,834.0,5.0,2.0,40.0,2.0,40.0,392.0,1506.0,605.0,1.0,7.0,1.0,11.0,8.0,436.0,11.0,Matches,514.0,es ESP,MF,25.0,20.5,0.0,6.0,1.0,16.7,0.29,0.05,0.0,0.0,18.3,0.0,0.0,0.0,0.3,0.3,0.05,-0.3,-0.3,Matches,514.0,es ESP,MF,25.0,33.0,24.0,1844.0,20.5,0.0,1.0,1.0,0.0,0.0,0.0,14.0,0.0,0.3,0.3,0.8,1.1,1.0,45.0,11.0,0.0,0.05,0.05,0.0,0.05,0.02,0.04,0.05,0.02,0.05,Matches,Fede San Emeterio,DM/M C,25,128,133,Spain,Cádiz,5,6,9,8,12,5,13,11,7,14,12,5,16,9,15,12,18,10,14,9,12,14,5,16,8,14,17,18,12,12,13,8,13,12,14,14,15,17,10,10,14,2,1,1,3,3,3,2,1,2,2,2,19,13,5,12,11,15,13,13,1,1,1,12,1,1,18,1,20,1,1,1,1,1,174,68,12,20,4887902,6600,1672,7040,Mediterranean_Hispanic,117,6,1997/3/16,0,0,11664.0,,67199082
787,Oihan Sancet,Athletic Club,2000,515.0,es ESP,MF,22.0,28.1,27.0,16.0,2.0,19.0,6.0,11.0,37.0,29.7,26.0,10.0,0.0,10.0,4.0,31.0,9.0,1.0,Matches,515.0,es ESP,MF,22.0,28.1,95.0,3.38,76.0,1.0,7.0,5.0,5.0,1.0,6.0,0.21,4.0,0.0,0.0,1.0,1.0,0.0,Matches,,,,,,,,,,,,,,,,,,,,,,,,,,,,,,,,,,,,,,,,,,,,,,,,,,,,,,,,515.0,es ESP,MF,22.0,28.1,6.0,1.0,0.0,41.0,54.0,2.0,17.0,4.0,16.0,0.0,0.0,0.0,140.0,24.0,22.0,52.2,Matches,515.0,es ESP,MF,22.0,28.1,975.0,936.0,28.0,13.0,9.0,3.0,17.0,1.0,3.0,0.0,2.0,0.0,788.0,11.0,19.0,Matches,515.0,es ESP,MF,22.0,28.1,788.0,975.0,80.8,11658.0,3001.0,453.0,516.0,87.8,271.0,329.0,82.4,41.0,59.0,69.5,2.0,4.2,2.4,-2.2,44.0,88.0,27.0,1.0,159.0,Matches,633,es ESP,MF,22,36,2532.0,70.0,74.0,28.1,32,75.0,6,4,36.0,0,1.39,38.0,29.0,9.0,0.32,0.83,39.3,28.0,11.2,0.4,-0.22,Matches,515.0,es ESP,MF,22.0,28.1,1269.0,17.0,114.0,623.0,561.0,80.0,1267.0,83.0,46.0,55.4,25.0,30.1,847.0,5286.0,2806.0,91.0,71.0,17.0,82.0,61.0,981.0,156.0,Matches,515.0,es ESP,MF,22.0,28.1,10.0,56.0,19.0,33.9,1.99,0.68,0.14,0.42,17.6,0.0,2.0,2.0,7.6,6.0,0.11,2.4,2.0,Matches,515.0,es ESP,MF,22.0,36.0,32.0,2532.0,28.1,10.0,2.0,12.0,8.0,2.0,2.0,6.0,1.0,7.6,6.0,4.2,10.2,91.0,159.0,156.0,0.36,0.07,0.43,0.28,0.36,0.27,0.15,0.42,0.21,0.36,Matches,Oihan Sancet,M/AM C,22,131,162,"Spain,Pays Basque",A. Bilbao,5,8,10,12,15,8,11,8,6,9,15,12,8,15,12,12,9,12,12,15,14,16,16,9,14,11,13,12,13,14,8,14,15,13,14,14,11,8,12,11,8,1,3,1,2,2,1,1,1,1,3,1,9,13,8,18,11,16,11,10,1,1,1,1,1,1,9,1,20,1,1,19,1,1,188,73,12,20,30000000,6550,6550,5050,Mediterranean_Hispanic,130,4,2000/4/25,0,0,12301.0,,67260204
788,Iván Sánchez,Valladolid,1992,517.0,es ESP,MFFW,29.0,12.8,20.0,14.0,8.0,8.0,4.0,10.0,27.0,37.0,17.0,14.0,1.0,13.0,8.0,28.0,4.0,0.0,Matches,517.0,es ESP,MFFW,29.0,12.8,42.0,3.38,31.0,4.0,4.0,2.0,1.0,0.0,2.0,0.16,1.0,1.0,0.0,0.0,0.0,0.0,Matches,,,,,,,,,,,,,,,,,,,,,,,,,,,,,,,,,,,,,,,,,,,,,,,,,,,,,,,,517.0,es ESP,MFFW,29.0,12.8,0.0,0.0,0.0,9.0,43.0,1.0,38.0,8.0,14.0,0.0,0.0,0.0,62.0,2.0,12.0,14.3,Matches,517.0,es ESP,MFFW,29.0,12.8,480.0,460.0,15.0,3.0,1.0,10.0,38.0,2.0,6.0,3.0,1.0,1.0,381.0,5.0,16.0,Matches,517.0,es ESP,MFFW,29.0,12.8,381.0,480.0,79.4,6282.0,1895.0,175.0,201.0,87.1,160.0,183.0,87.4,29.0,53.0,54.7,1.0,1.6,1.7,-0.6,17.0,36.0,16.0,8.0,65.0,Matches,635,es ESP,MFFW,29,25,1154.0,46.0,33.7,12.8,13,66.0,1,12,25.0,11,0.92,11.0,19.0,-8.0,-0.62,0.25,11.0,16.3,-5.2,-0.42,0.42,Matches,517.0,es ESP,MFFW,29.0,12.8,616.0,9.0,99.0,292.0,241.0,26.0,616.0,63.0,36.0,57.1,16.0,25.4,449.0,3611.0,1974.0,58.0,31.0,12.0,21.0,15.0,472.0,61.0,Matches,517.0,es ESP,MFFW,29.0,12.8,1.0,17.0,7.0,41.2,1.33,0.55,0.06,0.14,22.6,0.0,0.0,0.0,0.8,0.8,0.05,0.2,0.2,Matches,517.0,es ESP,MFFW,29.0,25.0,13.0,1154.0,12.8,1.0,1.0,2.0,1.0,0.0,0.0,0.0,0.0,0.8,0.8,1.6,2.4,58.0,65.0,61.0,0.08,0.08,0.16,0.08,0.16,0.06,0.12,0.19,0.06,0.19,Matches,Iván Sánchez,M/AM RLC,29,126,145,Spain,Valladolid,13,14,16,11,15,14,7,8,6,8,13,10,7,15,8,11,11,10,12,15,12,13,12,8,16,8,12,12,14,11,10,9,10,13,11,7,9,3,13,13,10,1,1,2,1,2,3,2,1,1,2,2,12,10,8,10,10,11,11,15,1,1,1,1,1,1,1,17,15,18,17,17,20,1,171,60,20,10,2607408,6299,6299,4249,Mediterranean_Hispanic,121,5,1992/9/23,0,0,7258.0,,67140188
789,Javi Sánchez,Valladolid,1997,518.0,es ESP,DF,25.0,26.6,43.0,26.0,27.0,15.0,1.0,17.0,26.0,65.4,9.0,32.0,22.0,10.0,46.0,89.0,116.0,0.0,Matches,518.0,es ESP,DF,25.0,26.6,16.0,0.6,14.0,0.0,1.0,0.0,1.0,0.0,3.0,0.11,3.0,0.0,0.0,0.0,0.0,0.0,Matches,,,,,,,,,,,,,,,,,,,,,,,,,,,,,,,,,,,,,,,,,,,,,,,,,,,,,,,,518.0,es ESP,DF,25.0,26.6,11.0,0.0,0.0,34.0,9.0,0.0,5.0,46.0,26.0,0.0,2.0,0.0,115.0,46.0,45.0,50.5,Matches,518.0,es ESP,DF,25.0,26.6,1175.0,1119.0,51.0,41.0,1.0,23.0,5.0,4.0,0.0,0.0,0.0,0.0,962.0,5.0,13.0,Matches,518.0,es ESP,DF,25.0,26.6,962.0,1175.0,81.9,19443.0,7131.0,314.0,350.0,89.7,499.0,551.0,90.6,131.0,228.0,57.5,0.0,0.1,0.4,-0.1,3.0,65.0,3.0,0.0,74.0,Matches,636,es ESP,DF,25,32,2392.0,75.0,69.9,26.6,28,81.0,20,4,29.0,2,1.16,21.0,43.0,-22.0,-0.83,-0.13,25.9,45.5,-19.6,-0.74,-0.12,Matches,518.0,es ESP,DF,25.0,26.6,1444.0,219.0,838.0,577.0,41.0,15.0,1444.0,7.0,7.0,100.0,0.0,0.0,800.0,4466.0,2820.0,21.0,9.0,1.0,7.0,4.0,906.0,5.0,Matches,518.0,es ESP,DF,25.0,26.6,1.0,9.0,2.0,22.2,0.34,0.08,0.11,0.5,17.9,1.0,0.0,0.0,0.7,0.7,0.08,0.3,0.3,Matches,518.0,es ESP,DF,25.0,32.0,28.0,2392.0,26.6,1.0,0.0,1.0,1.0,0.0,0.0,11.0,0.0,0.7,0.7,0.1,0.8,21.0,74.0,5.0,0.04,0.0,0.04,0.04,0.04,0.03,0.0,0.03,0.03,0.03,Matches,Javi Sánchez,D C,25,132,142,Spain,Valladolid,6,2,3,6,7,9,16,5,11,13,7,5,14,8,8,11,12,13,14,8,13,11,3,11,8,14,13,14,11,11,13,15,16,13,14,15,13,11,11,11,5,2,3,3,2,1,1,1,2,1,2,3,18,10,8,10,11,11,11,19,1,1,20,1,1,1,1,1,1,1,1,1,1,1,189,76,17,20,4630645,6600,6600,4500,Mediterranean_Hispanic,129,6,1997/3/14,0,0,11664.0,,67216745
790,Manu Sánchez,Osasuna,2000,519.0,es ESP,DF,21.0,23.6,51.0,35.0,35.0,9.0,7.0,33.0,63.0,52.4,30.0,33.0,5.0,28.0,14.0,65.0,51.0,0.0,Matches,519.0,es ESP,DF,21.0,23.6,61.0,2.58,55.0,1.0,2.0,0.0,1.0,2.0,4.0,0.17,3.0,0.0,0.0,0.0,1.0,0.0,Matches,,,,,,,,,,,,,,,,,,,,,,,,,,,,,,,,,,,,,,,,,,,,,,,,,,,,,,,,519.0,es ESP,DF,21.0,23.6,3.0,0.0,0.0,26.0,10.0,2.0,71.0,14.0,35.0,1.0,0.0,0.0,126.0,15.0,22.0,40.5,Matches,519.0,es ESP,DF,21.0,23.6,1144.0,943.0,197.0,11.0,0.0,2.0,71.0,186.0,0.0,0.0,0.0,0.0,916.0,4.0,28.0,Matches,519.0,es ESP,DF,21.0,23.6,916.0,1144.0,80.1,13651.0,4619.0,538.0,603.0,89.2,302.0,375.0,80.5,53.0,106.0,50.0,2.0,2.1,3.1,-0.1,28.0,72.0,35.0,21.0,100.0,Matches,637,es ESP,DF,21,31,2124.0,69.0,62.1,23.6,22,90.0,21,9,16.0,7,1.35,22.0,26.0,-4.0,-0.17,-0.1,23.4,30.5,-7.1,-0.3,-0.38,Matches,519.0,es ESP,DF,21.0,23.6,1385.0,64.0,330.0,619.0,451.0,43.0,1385.0,41.0,16.0,39.0,23.0,56.1,689.0,3461.0,1930.0,42.0,27.0,3.0,27.0,14.0,782.0,105.0,Matches,519.0,es ESP,DF,21.0,23.6,0.0,10.0,3.0,30.0,0.42,0.13,0.0,0.0,20.8,0.0,0.0,0.0,0.8,0.8,0.08,-0.8,-0.8,Matches,519.0,es ESP,DF,21.0,31.0,22.0,2124.0,23.6,0.0,2.0,2.0,0.0,0.0,0.0,3.0,0.0,0.8,0.8,2.1,2.8,42.0,100.0,105.0,0.0,0.08,0.08,0.0,0.08,0.03,0.09,0.12,0.03,0.12,Matches,Manu Sánchez,D/WB L,21,124,149,Spain,A. Madrid,8,13,12,8,12,7,7,9,12,12,14,11,12,14,11,13,13,13,13,13,14,9,13,9,13,11,13,14,14,12,12,8,11,14,14,11,13,11,11,7,12,1,2,1,2,1,2,1,1,3,1,3,9,14,3,10,9,11,9,13,1,20,1,1,16,1,1,1,1,1,1,1,1,1,179,70,20,8,7875000,6050,6050,3500,Mediterranean_Hispanic,123,4,2000/8/24,0,0,5216.0,Atlético Pamplona,67284340
791,Stefan Savić,Atlético Madrid,1991,521.0,me MNE,DF,31.0,21.6,39.0,26.0,29.0,7.0,3.0,26.0,39.0,66.7,13.0,17.0,8.0,9.0,33.0,72.0,67.0,2.0,Matches,521.0,me MNE,DF,31.0,21.6,11.0,0.51,11.0,0.0,0.0,0.0,0.0,0.0,1.0,0.05,1.0,0.0,0.0,0.0,0.0,0.0,Matches,,,,,,,,,,,,,,,,,,,,,,,,,,,,,,,,,,,,,,,,,,,,,,,,,,,,,,,,521.0,me MNE,DF,31.0,21.6,4.0,2.0,0.0,31.0,8.0,1.0,0.0,33.0,26.0,0.0,0.0,0.0,104.0,56.0,30.0,65.1,Matches,521.0,me MNE,DF,31.0,21.6,1141.0,1107.0,29.0,22.0,0.0,4.0,0.0,7.0,0.0,0.0,0.0,0.0,1001.0,5.0,4.0,Matches,521.0,me MNE,DF,31.0,21.6,1001.0,1141.0,87.7,18727.0,7359.0,380.0,404.0,94.1,498.0,553.0,90.1,107.0,150.0,71.3,0.0,0.0,0.2,0.0,1.0,61.0,1.0,0.0,74.0,Matches,640,me MNE,DF,31,22,1943.0,88.0,56.8,21.6,22,88.0,19,0,,1,1.86,33.0,17.0,16.0,0.74,-0.54,31.2,22.8,8.4,0.39,-0.37,Matches,521.0,me MNE,DF,31.0,21.6,1317.0,166.0,647.0,636.0,35.0,6.0,1317.0,5.0,4.0,80.0,0.0,0.0,777.0,3967.0,2536.0,20.0,5.0,1.0,2.0,3.0,892.0,6.0,Matches,521.0,me MNE,DF,31.0,21.6,0.0,2.0,1.0,50.0,0.09,0.05,0.0,0.0,13.0,0.0,0.0,0.0,0.2,0.2,0.09,-0.2,-0.2,Matches,521.0,me MNE,DF,31.0,22.0,22.0,1943.0,21.6,0.0,0.0,0.0,0.0,0.0,0.0,4.0,2.0,0.2,0.2,0.0,0.2,20.0,74.0,6.0,0.0,0.0,0.0,0.0,0.0,0.01,0.0,0.01,0.01,0.01,Matches,Stefan Savić,D C,31,151,155,"Montenegro,Serbia",A. Madrid,7,9,9,9,11,6,14,8,10,16,12,9,14,11,14,17,14,15,15,11,15,15,8,13,8,15,15,15,13,13,10,13,10,14,15,15,14,11,13,13,13,2,3,3,2,3,2,3,2,2,1,1,14,14,7,14,15,14,12,11,1,7,20,13,1,1,1,1,1,1,1,1,1,1,187,80,10,20,347975206,7550,7550,7050,Mediterranean_Hispanic,151,4,1991/1/8,62,5,86312.0,,62012567
792,David Silva,Real Sociedad,1986,525.0,es ESP,MF,36.0,21.5,36.0,21.0,11.0,18.0,7.0,11.0,19.0,57.9,8.0,17.0,2.0,15.0,15.0,51.0,16.0,0.0,Matches,525.0,es ESP,MF,36.0,21.5,77.0,3.58,67.0,0.0,3.0,4.0,1.0,2.0,14.0,0.65,13.0,0.0,0.0,0.0,0.0,1.0,Matches,,,,,,,,,,,,,,,,,,,,,,,,,,,,,,,,,,,,,,,,,,,,,,,,,,,,,,,,525.0,es ESP,MF,36.0,21.5,3.0,0.0,0.0,30.0,33.0,3.0,20.0,15.0,21.0,0.0,0.0,0.0,137.0,10.0,12.0,45.5,Matches,525.0,es ESP,MF,36.0,21.5,1165.0,1120.0,37.0,16.0,9.0,5.0,20.0,6.0,3.0,1.0,2.0,0.0,983.0,8.0,17.0,Matches,525.0,es ESP,MF,36.0,21.5,983.0,1165.0,84.4,15023.0,3274.0,514.0,573.0,89.7,352.0,411.0,85.6,68.0,93.0,73.1,5.0,3.6,3.0,1.4,35.0,93.0,37.0,2.0,162.0,Matches,644,es ESP,MF,36,28,1937.0,69.0,56.6,21.5,25,73.0,1,3,35.0,1,2.11,37.0,21.0,16.0,0.74,0.74,31.5,17.2,14.3,0.66,0.33,Matches,525.0,es ESP,MF,36.0,21.5,1378.0,24.0,136.0,700.0,560.0,78.0,1378.0,47.0,19.0,40.4,19.0,40.4,881.0,4932.0,2318.0,70.0,68.0,19.0,37.0,24.0,1045.0,121.0,Matches,525.0,es ESP,MF,36.0,21.5,2.0,30.0,13.0,43.3,1.39,0.6,0.07,0.15,15.4,1.0,0.0,0.0,3.8,3.8,0.13,-1.8,-1.8,Matches,525.0,es ESP,MF,36.0,28.0,25.0,1937.0,21.5,2.0,5.0,7.0,2.0,0.0,0.0,3.0,0.0,3.8,3.8,3.6,7.3,70.0,162.0,121.0,0.09,0.23,0.33,0.09,0.33,0.17,0.17,0.34,0.17,0.34,Matches,David Silva,M/AM RLC,36,151,179,Spain,Real San Sebastián,13,13,18,11,18,14,9,13,5,8,17,12,9,19,12,14,13,17,15,18,17,15,17,12,18,8,15,14,9,12,14,7,13,9,10,9,16,9,14,13,13,3,2,2,2,3,1,2,1,2,3,3,13,16,7,13,15,13,15,17,1,1,1,1,1,1,4,15,20,15,15,20,15,9,173,67,20,12,3569836,7550,7550,7500,Mediterranean_Hispanic,146,6,1986/1/8,125,35,100000.0,,7458280
793,Rui Silva,Betis,1994,526.0,pt POR,GK,28.0,26.0,4.0,1.0,4.0,0.0,0.0,4.0,4.0,100.0,0.0,0.0,0.0,0.0,0.0,4.0,12.0,1.0,Matches,526.0,pt POR,GK,28.0,26.0,1.0,0.04,1.0,0.0,0.0,0.0,0.0,0.0,0.0,0.0,0.0,0.0,0.0,0.0,0.0,0.0,Matches,39.0,pt POR,GK,28.0,26.0,32.0,2.0,1.0,6.0,1.0,32.9,0.3,1.9,0.07,154.0,410.0,37.6,668.0,107.0,40.7,35.6,214.0,64.5,47.5,369.0,18.0,4.9,37.0,1.42,16.6,Matches,39.0,pt POR,GK,28.0,26.0,26.0,2340.0,26.0,32.0,1.23,104.0,73.0,71.2,12.0,4.0,10.0,9.0,34.6,2.0,2.0,0.0,0.0,0.0,Matches,526.0,pt POR,GK,28.0,26.0,2.0,0.0,0.0,0.0,2.0,0.0,0.0,0.0,1.0,0.0,0.0,0.0,43.0,6.0,1.0,85.7,Matches,526.0,pt POR,GK,28.0,26.0,886.0,562.0,320.0,106.0,1.0,1.0,0.0,0.0,0.0,0.0,0.0,0.0,593.0,4.0,0.0,Matches,526.0,pt POR,GK,28.0,26.0,593.0,886.0,66.9,18170.0,13730.0,98.0,99.0,99.0,248.0,256.0,96.9,245.0,525.0,46.7,0.0,0.0,0.2,0.0,0.0,14.0,1.0,0.0,0.0,Matches,645,pt POR,GK,28,26,2340.0,90.0,68.4,26.0,26,90.0,26,0,,11,1.54,33.0,32.0,1.0,0.04,-0.29,34.5,35.1,-0.6,-0.02,-0.18,Matches,526.0,pt POR,GK,28.0,26.0,936.0,782.0,932.0,5.0,0.0,0.0,936.0,1.0,1.0,100.0,0.0,0.0,462.0,2369.0,1283.0,0.0,0.0,0.0,0.0,0.0,360.0,0.0,Matches,526.0,pt POR,GK,28.0,26.0,0.0,0.0,0.0,,0.0,0.0,,,,0.0,0.0,0.0,0.0,0.0,,0.0,0.0,Matches,526.0,pt POR,GK,28.0,26.0,26.0,2340.0,26.0,0.0,0.0,0.0,0.0,0.0,0.0,2.0,0.0,0.0,0.0,0.0,0.0,0.0,0.0,0.0,0.0,0.0,0.0,0.0,0.0,0.0,0.0,0.0,0.0,0.0,Matches,Rui Silva,GK,28,140,145,Portugal,Real Hispalis,4,2,1,1,9,7,8,2,3,2,9,2,2,9,9,13,13,12,13,9,13,13,1,7,3,13,12,14,11,13,14,10,12,11,13,12,12,7,9,6,12,13,14,14,9,16,13,15,16,14,13,13,13,10,12,12,10,15,14,16,20,1,1,1,1,1,1,1,1,1,1,1,1,1,191,91,20,9,7986750,6850,6750,5500,Mediterranean_Hispanic,137,5,1994/2/7,1,0,18389.0,,55067163
794,Unai Simón,Athletic Club,1997,528.0,es ESP,GK,25.0,30.5,2.0,0.0,2.0,0.0,0.0,1.0,1.0,100.0,0.0,1.0,0.0,1.0,0.0,2.0,9.0,3.0,Matches,528.0,es ESP,GK,25.0,30.5,2.0,0.07,2.0,0.0,0.0,0.0,0.0,0.0,0.0,0.0,0.0,0.0,0.0,0.0,0.0,0.0,Matches,40.0,es ESP,GK,25.0,30.5,37.0,3.0,1.0,1.0,3.0,31.7,0.28,-2.3,-0.08,134.0,351.0,38.2,762.0,154.0,30.6,33.2,186.0,63.4,49.4,355.0,18.0,5.1,40.0,1.31,17.5,Matches,40.0,es ESP,GK,25.0,31.0,31.0,2745.0,30.5,37.0,1.21,104.0,70.0,67.3,13.0,6.0,12.0,9.0,29.0,3.0,3.0,0.0,0.0,0.0,Matches,528.0,es ESP,GK,25.0,30.5,2.0,0.0,0.0,0.0,1.0,0.0,0.0,0.0,0.0,0.0,0.0,0.0,36.0,0.0,0.0,,Matches,528.0,es ESP,GK,25.0,30.5,951.0,703.0,245.0,59.0,0.0,1.0,0.0,0.0,0.0,0.0,0.0,0.0,690.0,3.0,0.0,Matches,528.0,es ESP,GK,25.0,30.5,690.0,951.0,72.6,19697.0,14574.0,94.0,95.0,98.9,383.0,393.0,97.5,212.0,459.0,46.2,0.0,0.0,0.0,0.0,0.0,18.0,0.0,0.0,2.0,Matches,647,es ESP,GK,25,31,2745.0,89.0,80.3,30.5,31,89.0,30,0,,4,1.45,42.0,37.0,5.0,0.16,0.3,44.0,29.9,14.1,0.46,0.03,Matches,528.0,es ESP,GK,25.0,30.5,1007.0,810.0,1001.0,7.0,0.0,0.0,1007.0,0.0,0.0,,0.0,,598.0,3166.0,1823.0,0.0,0.0,0.0,1.0,0.0,480.0,0.0,Matches,528.0,es ESP,GK,25.0,30.5,0.0,0.0,0.0,,0.0,0.0,,,,0.0,0.0,0.0,0.0,0.0,,0.0,0.0,Matches,528.0,es ESP,GK,25.0,31.0,31.0,2745.0,30.5,0.0,0.0,0.0,0.0,0.0,0.0,2.0,0.0,0.0,0.0,0.0,0.0,0.0,2.0,0.0,0.0,0.0,0.0,0.0,0.0,0.0,0.0,0.0,0.0,0.0,Matches,Unai Simón,GK,25,154,168,"Spain,Pays Basque",A. Bilbao,6,2,1,1,13,8,13,1,2,3,12,3,2,13,13,13,12,15,13,14,14,15,3,12,1,15,13,12,13,14,7,15,12,13,12,12,15,5,9,12,14,16,15,15,13,14,13,15,16,13,9,15,11,14,4,9,11,10,10,18,20,1,1,1,1,1,1,1,1,1,1,1,1,1,190,89,10,20,108900010,7700,7700,6950,Mediterranean_Hispanic,153,5,1997/6/11,25,0,48957.0,,67200923
795,Rubén Sobrino,Cádiz,1992,529.0,es ESP,MFFW,30.0,27.4,55.0,37.0,29.0,17.0,9.0,23.0,56.0,41.1,33.0,33.0,3.0,30.0,24.0,79.0,20.0,1.0,Matches,529.0,es ESP,MFFW,30.0,27.4,53.0,1.94,39.0,0.0,1.0,4.0,6.0,3.0,5.0,0.18,5.0,0.0,0.0,0.0,0.0,0.0,Matches,,,,,,,,,,,,,,,,,,,,,,,,,,,,,,,,,,,,,,,,,,,,,,,,,,,,,,,,529.0,es ESP,MFFW,30.0,27.4,11.0,0.0,0.0,50.0,53.0,8.0,12.0,24.0,37.0,0.0,0.0,0.0,164.0,60.0,64.0,48.4,Matches,529.0,es ESP,MFFW,30.0,27.4,618.0,603.0,10.0,1.0,1.0,3.0,12.0,7.0,0.0,0.0,0.0,0.0,444.0,5.0,21.0,Matches,529.0,es ESP,MFFW,30.0,27.4,444.0,618.0,71.8,5754.0,1679.0,269.0,344.0,78.2,132.0,164.0,80.5,13.0,33.0,39.4,2.0,2.3,1.8,-0.3,24.0,28.0,8.0,3.0,46.0,Matches,649,es ESP,MFFW,30,33,2465.0,75.0,72.1,27.4,28,84.0,18,5,22.0,1,1.18,22.0,27.0,-5.0,-0.18,1.51,32.5,39.7,-7.2,-0.26,0.96,Matches,529.0,es ESP,MFFW,30.0,27.4,952.0,37.0,209.0,401.0,359.0,75.0,952.0,75.0,29.0,38.7,36.0,48.0,542.0,3550.0,1609.0,45.0,41.0,12.0,56.0,42.0,579.0,81.0,Matches,529.0,es ESP,MFFW,30.0,27.4,3.0,33.0,12.0,36.4,1.2,0.44,0.09,0.25,13.6,0.0,0.0,0.0,4.9,4.9,0.15,-1.9,-1.9,Matches,529.0,es ESP,MFFW,30.0,33.0,28.0,2465.0,27.4,3.0,2.0,5.0,3.0,0.0,0.0,11.0,0.0,4.9,4.9,2.3,7.2,45.0,46.0,81.0,0.11,0.07,0.18,0.11,0.18,0.18,0.08,0.26,0.18,0.26,Matches,Rubén Sobrino,AM/S RL,30,126,135,Spain,Cádiz,7,8,9,11,13,9,15,12,9,6,10,11,6,12,12,14,17,14,13,10,12,7,12,8,15,10,14,17,12,11,11,13,13,14,13,12,11,8,12,8,15,2,3,3,2,2,3,4,1,2,3,3,20,10,2,9,10,16,10,20,1,1,1,1,1,1,1,1,1,1,17,14,15,20,182,73,11,20,2778387,6400,6400,4600,Mediterranean_Hispanic,123,5,1992/6/1,0,0,10063.0,,67085789
796,David Soria,Getafe,1993,533.0,es ESP,GK,29.0,38.0,0.0,0.0,0.0,0.0,0.0,0.0,1.0,0.0,1.0,0.0,0.0,0.0,1.0,1.0,20.0,4.0,Matches,533.0,es ESP,GK,29.0,38.0,7.0,0.18,6.0,1.0,0.0,0.0,0.0,0.0,0.0,0.0,0.0,0.0,0.0,0.0,0.0,0.0,Matches,41.0,es ESP,GK,29.0,38.0,45.0,4.0,0.0,7.0,2.0,45.5,0.23,2.5,0.07,409.0,904.0,45.2,782.0,99.0,75.1,49.8,347.0,91.4,59.8,586.0,36.0,6.1,46.0,1.21,15.0,Matches,41.0,es ESP,GK,29.0,38.0,38.0,3420.0,38.0,45.0,1.18,166.0,119.0,75.3,10.0,12.0,16.0,13.0,34.2,8.0,4.0,4.0,0.0,50.0,Matches,533.0,es ESP,GK,29.0,38.0,2.0,0.0,0.0,1.0,3.0,0.0,0.0,1.0,0.0,0.0,0.0,0.0,39.0,4.0,0.0,100.0,Matches,533.0,es ESP,GK,29.0,38.0,1136.0,620.0,509.0,162.0,0.0,19.0,0.0,0.0,0.0,0.0,0.0,0.0,610.0,7.0,1.0,Matches,533.0,es ESP,GK,29.0,38.0,610.0,1136.0,53.7,28998.0,25913.0,28.0,30.0,93.3,119.0,126.0,94.4,463.0,972.0,47.6,0.0,0.2,0.2,-0.2,4.0,57.0,3.0,0.0,1.0,Matches,654,es ESP,GK,29,38,3420.0,90.0,100.0,38.0,38,90.0,38,0,,0,1.11,34.0,45.0,-11.0,-0.29,,36.7,46.0,-9.4,-0.25,,Matches,533.0,es ESP,GK,29.0,38.0,1224.0,1011.0,1216.0,11.0,0.0,0.0,1224.0,0.0,0.0,,0.0,,541.0,3493.0,2322.0,0.0,0.0,0.0,0.0,0.0,291.0,0.0,Matches,533.0,es ESP,GK,29.0,38.0,0.0,0.0,0.0,,0.0,0.0,,,,0.0,0.0,0.0,0.0,0.0,,0.0,0.0,Matches,533.0,es ESP,GK,29.0,38.0,38.0,3420.0,38.0,0.0,0.0,0.0,0.0,0.0,0.0,2.0,0.0,0.0,0.0,0.2,0.2,0.0,1.0,0.0,0.0,0.0,0.0,0.0,0.0,0.0,0.01,0.01,0.0,0.01,Matches,David Soria,GK,29,142,150,Spain,Getafe,4,2,3,2,7,7,4,2,1,2,8,4,1,5,11,15,13,12,14,8,15,13,9,11,11,15,13,14,9,12,13,16,11,9,11,14,12,8,9,9,13,15,15,15,8,16,12,13,15,16,10,14,15,12,10,10,9,12,13,13,20,1,1,1,1,1,1,1,1,1,1,1,1,1,192,85,8,20,6167600,7000,7000,5600,Mediterranean_Hispanic,141,5,1993/4/4,0,0,20145.0,,67011248
797,Vinicius Souza,Espanyol,1999,536.0,br BRA,MF,23.0,27.0,99.0,66.0,41.0,45.0,13.0,33.0,59.0,55.9,26.0,31.0,14.0,17.0,48.0,147.0,50.0,1.0,Matches,536.0,br BRA,MF,23.0,27.0,33.0,1.22,25.0,0.0,2.0,2.0,2.0,2.0,3.0,0.11,3.0,0.0,0.0,0.0,0.0,0.0,Matches,,,,,,,,,,,,,,,,,,,,,,,,,,,,,,,,,,,,,,,,,,,,,,,,,,,,,,,,536.0,br BRA,MF,23.0,27.0,10.0,1.0,1.0,65.0,38.0,0.0,4.0,48.0,66.0,0.0,2.0,0.0,151.0,72.0,63.0,53.3,Matches,536.0,br BRA,MF,23.0,27.0,909.0,885.0,24.0,23.0,0.0,9.0,4.0,0.0,0.0,0.0,0.0,0.0,726.0,0.0,16.0,Matches,536.0,br BRA,MF,23.0,27.0,726.0,909.0,79.9,12361.0,3394.0,343.0,396.0,86.6,295.0,353.0,83.6,66.0,106.0,62.3,1.0,0.6,0.7,0.4,11.0,85.0,4.0,1.0,82.0,Matches,657,br BRA,MF,23,34,2428.0,71.0,71.0,27.0,27,84.0,14,7,21.0,2,1.0,34.0,47.0,-13.0,-0.48,-0.12,30.8,39.5,-8.7,-0.32,-0.08,Matches,536.0,br BRA,MF,23.0,27.0,1242.0,79.0,337.0,746.0,164.0,20.0,1242.0,19.0,10.0,52.6,7.0,36.8,543.0,2552.0,972.0,13.0,11.0,2.0,30.0,13.0,614.0,14.0,Matches,536.0,br BRA,MF,23.0,27.0,1.0,10.0,4.0,40.0,0.37,0.15,0.1,0.25,21.9,0.0,0.0,0.0,0.8,0.8,0.08,0.2,0.2,Matches,536.0,br BRA,MF,23.0,34.0,27.0,2428.0,27.0,1.0,1.0,2.0,1.0,0.0,0.0,10.0,1.0,0.8,0.8,0.6,1.4,13.0,82.0,14.0,0.04,0.04,0.07,0.04,0.07,0.03,0.02,0.05,0.03,0.05,Matches,Vinicius Souza,DM/M C,23,125,155,Brazil,Lommel SK,11,11,13,11,13,10,12,11,11,11,14,13,12,12,12,13,13,14,12,13,14,12,13,10,13,8,13,13,13,13,11,14,12,12,14,12,14,12,14,12,12,3,3,1,2,3,2,3,3,3,1,3,14,1,2,9,11,8,10,12,1,1,1,1,1,1,19,1,20,1,1,1,1,1,187,78,9,20,7692188,6250,6250,2508,Mixed_Race,126,13,1999/6/17,0,0,2500.0,Espanyol,19354886
798,Jørgen Strand Larsen,Celta Vigo,2000,537.0,no NOR,FW,22.0,18.9,15.0,7.0,3.0,5.0,7.0,7.0,30.0,23.3,23.0,14.0,5.0,9.0,3.0,18.0,24.0,0.0,Matches,537.0,no NOR,FW,22.0,18.9,29.0,1.53,21.0,0.0,1.0,2.0,4.0,1.0,7.0,0.37,6.0,0.0,1.0,0.0,0.0,0.0,Matches,,,,,,,,,,,,,,,,,,,,,,,,,,,,,,,,,,,,,,,,,,,,,,,,,,,,,,,,537.0,no NOR,FW,22.0,18.9,4.0,0.0,0.0,34.0,43.0,13.0,4.0,3.0,7.0,1.0,0.0,0.0,42.0,42.0,47.0,47.2,Matches,537.0,no NOR,FW,22.0,18.9,339.0,310.0,27.0,3.0,0.0,4.0,4.0,0.0,0.0,0.0,0.0,0.0,232.0,2.0,3.0,Matches,537.0,no NOR,FW,22.0,18.9,232.0,339.0,68.4,3020.0,423.0,139.0,192.0,72.4,53.0,80.0,66.3,12.0,19.0,63.2,4.0,2.0,1.1,2.0,12.0,14.0,3.0,1.0,14.0,Matches,659,no NOR,FW,22,32,1705.0,53.0,49.9,18.9,20,66.0,3,12,32.0,2,1.09,25.0,32.0,-7.0,-0.37,-0.21,21.8,20.4,1.4,0.07,0.29,Matches,537.0,no NOR,FW,22.0,18.9,576.0,29.0,56.0,277.0,248.0,84.0,576.0,31.0,14.0,45.2,15.0,48.4,348.0,1327.0,460.0,17.0,6.0,9.0,74.0,24.0,438.0,73.0,Matches,537.0,no NOR,FW,22.0,18.9,4.0,41.0,15.0,36.6,2.16,0.79,0.1,0.27,12.6,0.0,0.0,0.0,5.6,5.6,0.14,-1.6,-1.6,Matches,537.0,no NOR,FW,22.0,32.0,20.0,1705.0,18.9,4.0,4.0,8.0,4.0,0.0,0.0,4.0,0.0,5.6,5.6,2.0,7.6,17.0,14.0,73.0,0.21,0.21,0.42,0.21,0.42,0.3,0.11,0.4,0.3,0.4,Matches,Jørgen Strand Larsen,S,22,122,140,Norway,Vigo,5,6,11,15,13,6,14,13,6,6,10,12,6,12,10,13,12,13,12,9,11,12,13,10,14,6,12,12,12,12,15,14,13,12,14,17,12,8,11,6,7,2,2,1,3,3,3,1,3,1,3,2,14,17,6,4,6,11,11,13,1,1,1,1,1,1,1,1,1,1,1,1,1,20,193,79,8,20,11924001,6100,6100,4250,Northern_European,122,2,2000/2/6,1,0,5071.0,,53143395
799,Cristhian Stuani,Girona,1986,538.0,uy URU,FW,35.0,12.1,13.0,6.0,2.0,7.0,4.0,5.0,14.0,35.7,9.0,10.0,0.0,10.0,2.0,15.0,5.0,0.0,Matches,538.0,uy URU,FW,35.0,12.1,18.0,1.48,9.0,0.0,0.0,6.0,2.0,1.0,1.0,0.08,0.0,0.0,0.0,0.0,1.0,0.0,Matches,,,,,,,,,,,,,,,,,,,,,,,,,,,,,,,,,,,,,,,,,,,,,,,,,,,,,,,,538.0,uy URU,FW,35.0,12.1,8.0,0.0,0.0,39.0,23.0,7.0,3.0,2.0,6.0,0.0,0.0,0.0,26.0,21.0,24.0,46.7,Matches,538.0,uy URU,FW,35.0,12.1,168.0,148.0,19.0,0.0,0.0,0.0,3.0,0.0,0.0,0.0,0.0,0.0,122.0,1.0,4.0,Matches,538.0,uy URU,FW,35.0,12.1,122.0,168.0,72.6,1464.0,132.0,79.0,95.0,83.2,25.0,44.0,56.8,5.0,7.0,71.4,0.0,1.3,1.2,-1.3,7.0,6.0,3.0,0.0,10.0,Matches,660,uy URU,FW,35,32,1090.0,34.0,31.9,12.1,8,79.0,3,24,19.0,1,1.31,22.0,16.0,6.0,0.5,0.61,19.9,17.2,2.6,0.22,0.48,Matches,538.0,uy URU,FW,35.0,12.1,281.0,5.0,28.0,133.0,121.0,56.0,275.0,4.0,0.0,0.0,3.0,75.0,137.0,406.0,145.0,2.0,1.0,1.0,23.0,6.0,193.0,26.0,Matches,538.0,uy URU,FW,35.0,12.1,9.0,29.0,15.0,51.7,2.39,1.24,0.14,0.27,13.0,0.0,5.0,6.0,9.7,5.0,0.17,-0.7,-1.0,Matches,538.0,uy URU,FW,35.0,32.0,8.0,1090.0,12.1,9.0,0.0,9.0,4.0,5.0,6.0,8.0,0.0,9.7,5.0,1.3,6.2,2.0,10.0,26.0,0.74,0.0,0.74,0.33,0.33,0.8,0.1,0.9,0.41,0.51,Matches,Cristhian Stuani,S R,35,133,150,"Uruguay,Italy",Girona,7,11,12,16,11,8,15,12,6,7,12,15,8,12,12,14,15,15,14,11,14,14,10,12,15,8,13,13,11,10,14,13,13,12,12,14,13,7,14,11,12,2,2,2,3,3,1,1,3,2,3,3,14,13,7,11,12,15,14,13,1,1,1,1,1,1,1,8,1,12,13,10,15,20,183,74,13,20,347975206,6750,6850,5500,Mediterranean_Hispanic,133,4,1986/10/12,50,8,32000.0,,78000806
800,Damián Suárez,Getafe,1988,539.0,uy URU,DFMF,34.0,21.6,49.0,33.0,23.0,19.0,7.0,26.0,48.0,54.2,22.0,40.0,0.0,40.0,15.0,64.0,36.0,0.0,Matches,539.0,uy URU,DFMF,34.0,21.6,47.0,2.17,29.0,16.0,1.0,0.0,1.0,0.0,2.0,0.09,1.0,1.0,0.0,0.0,0.0,0.0,Matches,,,,,,,,,,,,,,,,,,,,,,,,,,,,,,,,,,,,,,,,,,,,,,,,,,,,,,,,539.0,uy URU,DFMF,34.0,21.6,7.0,0.0,0.0,43.0,17.0,2.0,78.0,15.0,33.0,0.0,0.0,0.0,132.0,14.0,16.0,46.7,Matches,539.0,uy URU,DFMF,34.0,21.6,962.0,705.0,255.0,38.0,0.0,25.0,78.0,204.0,13.0,7.0,5.0,0.0,649.0,2.0,28.0,Matches,539.0,uy URU,DFMF,34.0,21.6,649.0,962.0,67.5,11863.0,5603.0,300.0,367.0,81.7,252.0,343.0,73.5,82.0,194.0,42.3,1.0,1.8,1.7,-0.8,26.0,61.0,23.0,14.0,80.0,Matches,661,uy URU,DFMF,34,28,1946.0,70.0,56.9,21.6,26,75.0,12,2,1.0,5,1.36,21.0,20.0,1.0,0.05,0.78,22.9,22.7,0.2,0.01,0.59,Matches,539.0,uy URU,DFMF,34.0,21.6,1169.0,42.0,299.0,580.0,306.0,15.0,1169.0,34.0,13.0,38.2,21.0,61.8,462.0,1781.0,959.0,21.0,23.0,5.0,23.0,6.0,542.0,72.0,Matches,539.0,uy URU,DFMF,34.0,21.6,1.0,6.0,1.0,16.7,0.28,0.05,0.17,1.0,19.0,0.0,0.0,0.0,1.1,1.1,0.18,-0.1,-0.1,Matches,539.0,uy URU,DFMF,34.0,28.0,26.0,1946.0,21.6,1.0,1.0,2.0,1.0,0.0,0.0,7.0,0.0,1.1,1.1,1.8,2.9,21.0,80.0,72.0,0.05,0.05,0.09,0.05,0.09,0.05,0.08,0.13,0.05,0.13,Matches,Damián Suárez,D/WB R,34,135,139,Uruguay,Getafe,14,13,11,7,11,11,7,12,14,13,12,8,14,12,17,13,18,12,15,9,13,15,9,13,13,14,17,18,14,13,14,9,15,13,15,10,15,17,13,4,15,3,3,2,2,3,1,2,3,3,2,4,14,12,5,7,12,12,7,9,1,14,1,20,12,18,8,1,1,10,1,1,1,1,173,74,7,20,801641,6750,6100,5250,Mediterranean_Hispanic,134,11,1988/4/27,6,0,15104.0,,78001192
801,Denis Suárez,Espanyol,1994,540.0,es ESP,MFFW,28.0,10.5,26.0,20.0,12.0,12.0,2.0,13.0,45.0,28.9,32.0,11.0,1.0,10.0,5.0,31.0,4.0,0.0,Matches,540.0,es ESP,MFFW,28.0,10.5,34.0,3.24,22.0,9.0,2.0,0.0,1.0,0.0,1.0,0.1,1.0,0.0,0.0,0.0,0.0,0.0,Matches,,,,,,,,,,,,,,,,,,,,,,,,,,,,,,,,,,,,,,,,,,,,,,,,,,,,,,,,540.0,es ESP,MFFW,28.0,10.5,2.0,0.0,0.0,16.0,14.0,1.0,37.0,5.0,20.0,0.0,0.0,0.0,49.0,4.0,12.0,25.0,Matches,540.0,es ESP,MFFW,28.0,10.5,452.0,402.0,49.0,16.0,2.0,1.0,37.0,4.0,26.0,9.0,11.0,0.0,331.0,1.0,10.0,Matches,540.0,es ESP,MFFW,28.0,10.5,331.0,452.0,73.2,5200.0,1637.0,183.0,228.0,80.3,109.0,133.0,82.0,28.0,66.0,42.4,0.0,1.1,1.5,-1.1,16.0,36.0,14.0,4.0,43.0,Matches,662,es ESP,MFFW,28,18,945.0,53.0,27.6,10.5,11,70.0,2,7,25.0,1,0.94,16.0,23.0,-7.0,-0.67,-0.3,14.1,20.6,-6.6,-0.62,-0.45,Matches,540.0,es ESP,MFFW,28.0,10.5,541.0,9.0,79.0,302.0,167.0,12.0,541.0,28.0,19.0,67.9,9.0,32.1,311.0,2014.0,945.0,26.0,20.0,2.0,13.0,11.0,363.0,34.0,Matches,540.0,es ESP,MFFW,28.0,10.5,0.0,4.0,2.0,50.0,0.38,0.19,0.0,0.0,19.4,0.0,0.0,0.0,0.5,0.5,0.12,-0.5,-0.5,Matches,540.0,es ESP,MFFW,28.0,18.0,11.0,945.0,10.5,0.0,0.0,0.0,0.0,0.0,0.0,2.0,0.0,0.5,0.5,1.1,1.6,26.0,43.0,34.0,0.0,0.0,0.0,0.0,0.0,0.05,0.11,0.15,0.05,0.15,Matches,Denis Suárez,M/AM LC,28,148,156,Spain,Vigo,13,14,15,12,16,13,7,13,9,7,16,12,11,16,9,16,9,14,12,17,13,12,15,8,14,9,16,14,13,14,13,10,12,13,12,11,11,8,16,8,14,1,3,2,1,3,2,2,1,1,3,2,12,13,8,10,11,13,14,13,1,1,1,1,1,1,1,15,17,7,18,20,12,10,178,66,12,20,11072215,7250,7250,6000,Mediterranean_Hispanic,146,6,1994/1/6,1,0,88219.0,,67107819
802,Suso,Sevilla,1993,542.0,es ESP,MFFW,28.0,11.8,16.0,10.0,5.0,7.0,4.0,10.0,22.0,45.5,12.0,7.0,1.0,6.0,2.0,18.0,3.0,0.0,Matches,542.0,es ESP,MFFW,28.0,11.8,64.0,5.41,51.0,6.0,3.0,2.0,1.0,1.0,7.0,0.59,4.0,1.0,2.0,0.0,0.0,0.0,Matches,,,,,,,,,,,,,,,,,,,,,,,,,,,,,,,,,,,,,,,,,,,,,,,,,,,,,,,,542.0,es ESP,MFFW,28.0,11.8,1.0,0.0,0.0,13.0,19.0,7.0,79.0,2.0,10.0,0.0,0.0,0.0,55.0,3.0,7.0,30.0,Matches,542.0,es ESP,MFFW,28.0,11.8,572.0,520.0,47.0,12.0,6.0,17.0,79.0,11.0,21.0,7.0,8.0,1.0,444.0,5.0,14.0,Matches,542.0,es ESP,MFFW,28.0,11.8,444.0,572.0,77.6,8092.0,2148.0,223.0,245.0,91.0,156.0,198.0,78.8,59.0,101.0,58.4,4.0,2.8,3.2,1.2,28.0,40.0,28.0,7.0,86.0,Matches,664,es ESP,MFFW,28,25,1065.0,43.0,31.1,11.8,10,68.0,1,15,25.0,9,1.52,18.0,15.0,3.0,0.25,0.64,17.5,12.6,4.9,0.42,0.91,Matches,542.0,es ESP,MFFW,28.0,11.8,675.0,6.0,59.0,235.0,392.0,23.0,675.0,42.0,25.0,59.5,13.0,31.0,461.0,2714.0,1238.0,27.0,27.0,7.0,17.0,19.0,521.0,96.0,Matches,542.0,es ESP,MFFW,28.0,11.8,2.0,24.0,9.0,37.5,2.03,0.76,0.08,0.22,24.1,2.0,0.0,0.0,1.1,1.1,0.05,0.9,0.9,Matches,542.0,es ESP,MFFW,28.0,25.0,10.0,1065.0,11.8,2.0,4.0,6.0,2.0,0.0,0.0,1.0,0.0,1.1,1.1,2.8,4.0,27.0,86.0,96.0,0.17,0.34,0.51,0.17,0.51,0.1,0.24,0.34,0.1,0.34,Matches,Suso,M/AM RC,28,145,155,Spain,Sevilla,14,15,16,13,16,15,6,16,9,7,15,14,7,17,12,16,11,12,9,15,11,14,15,11,16,10,13,12,15,15,12,8,13,14,12,8,10,8,14,8,6,1,1,1,1,1,1,1,2,1,2,1,17,14,7,13,12,11,13,11,1,1,1,1,1,1,1,9,12,16,14,16,20,12,176,70,20,10,25400963,7250,7250,6000,Mediterranean_Hispanic,144,8,1993/11/19,5,0,34215.0,,67085965
803,Alexander Sørloth,Real Sociedad,1995,544.0,no NOR,FW,26.0,26.5,18.0,9.0,3.0,6.0,9.0,7.0,14.0,50.0,7.0,15.0,1.0,14.0,2.0,20.0,26.0,1.0,Matches,544.0,no NOR,FW,26.0,26.5,58.0,2.19,41.0,0.0,8.0,6.0,2.0,1.0,5.0,0.19,4.0,0.0,1.0,0.0,0.0,0.0,Matches,,,,,,,,,,,,,,,,,,,,,,,,,,,,,,,,,,,,,,,,,,,,,,,,,,,,,,,,544.0,no NOR,FW,26.0,26.5,4.0,0.0,0.0,32.0,16.0,17.0,8.0,2.0,9.0,0.0,0.0,0.0,74.0,60.0,54.0,52.6,Matches,544.0,no NOR,FW,26.0,26.5,481.0,449.0,29.0,0.0,1.0,1.0,8.0,1.0,0.0,0.0,0.0,0.0,329.0,3.0,18.0,Matches,544.0,no NOR,FW,26.0,26.5,329.0,481.0,68.4,4213.0,567.0,210.0,269.0,78.1,88.0,132.0,66.7,9.0,16.0,56.3,3.0,4.2,1.9,-1.2,31.0,11.0,10.0,2.0,20.0,Matches,667,no NOR,FW,26,34,2386.0,70.0,69.8,26.5,28,79.0,8,6,29.0,0,1.91,38.0,20.0,18.0,0.68,0.85,37.3,20.3,17.0,0.64,0.4,Matches,544.0,no NOR,FW,26.0,26.5,807.0,29.0,64.0,331.0,431.0,107.0,807.0,75.0,29.0,38.7,42.0,56.0,458.0,2843.0,1264.0,41.0,30.0,19.0,84.0,61.0,591.0,132.0,Matches,544.0,no NOR,FW,26.0,26.5,12.0,63.0,27.0,42.9,2.38,1.02,0.19,0.44,11.3,0.0,0.0,0.0,12.7,12.7,0.2,-0.7,-0.7,Matches,544.0,no NOR,FW,26.0,34.0,28.0,2386.0,26.5,12.0,3.0,15.0,12.0,0.0,0.0,4.0,0.0,12.7,12.7,4.2,16.9,41.0,20.0,132.0,0.45,0.11,0.57,0.45,0.57,0.48,0.16,0.64,0.48,0.64,Matches,Alexander Sørloth,S,26,142,148,Norway,RB Leipzig,7,7,13,15,13,10,15,12,6,6,11,13,5,13,13,13,14,14,13,13,13,13,10,9,12,5,15,13,13,13,16,16,14,15,14,16,13,11,14,4,10,3,3,3,2,1,2,1,4,1,2,2,12,13,5,14,12,14,10,7,1,1,1,1,1,1,1,1,1,1,8,10,8,20,194,90,20,12,19060367,7100,7100,5750,Northern_European,141,4,1995/12/5,42,15,57692.0,Real San Sebastián,53063430
804,Renato Tapia,Celta Vigo,1995,545.0,pe PER,MFDF,27.0,16.1,47.0,25.0,21.0,21.0,5.0,18.0,37.0,48.6,19.0,29.0,11.0,18.0,19.0,66.0,37.0,0.0,Matches,545.0,pe PER,MFDF,27.0,16.1,24.0,1.49,18.0,1.0,2.0,1.0,0.0,2.0,0.0,0.0,0.0,0.0,0.0,0.0,0.0,0.0,Matches,,,,,,,,,,,,,,,,,,,,,,,,,,,,,,,,,,,,,,,,,,,,,,,,,,,,,,,,545.0,pe PER,MFDF,27.0,16.1,8.0,1.0,1.0,29.0,16.0,0.0,11.0,19.0,25.0,0.0,1.0,0.0,80.0,26.0,18.0,59.1,Matches,545.0,pe PER,MFDF,27.0,16.1,811.0,765.0,43.0,37.0,0.0,20.0,11.0,4.0,1.0,1.0,0.0,0.0,687.0,3.0,4.0,Matches,545.0,pe PER,MFDF,27.0,16.1,687.0,811.0,84.7,13506.0,3634.0,256.0,283.0,90.5,321.0,352.0,91.2,99.0,153.0,64.7,0.0,1.1,0.8,-1.1,9.0,63.0,7.0,1.0,68.0,Matches,668,pe PER,MFDF,27,28,1451.0,52.0,42.4,16.1,16,75.0,6,12,21.0,5,1.14,10.0,28.0,-18.0,-1.12,-1.48,15.5,21.4,-5.9,-0.36,-0.5,Matches,545.0,pe PER,MFDF,27.0,16.1,993.0,65.0,318.0,564.0,120.0,9.0,993.0,19.0,11.0,57.9,7.0,36.8,582.0,2624.0,1231.0,12.0,14.0,1.0,11.0,14.0,648.0,8.0,Matches,545.0,pe PER,MFDF,27.0,16.1,0.0,15.0,3.0,20.0,0.93,0.19,0.0,0.0,19.3,1.0,0.0,0.0,1.0,1.0,0.06,-1.0,-1.0,Matches,545.0,pe PER,MFDF,27.0,28.0,16.0,1451.0,16.1,0.0,0.0,0.0,0.0,0.0,0.0,8.0,1.0,1.0,1.0,1.1,2.0,12.0,68.0,8.0,0.0,0.0,0.0,0.0,0.0,0.06,0.07,0.13,0.06,0.13,Matches,Renato Tapia,DM/M C,26,145,150,Peru,Vigo,9,7,11,8,13,8,13,11,11,14,14,12,15,15,16,14,15,13,15,12,12,14,12,13,12,15,15,17,13,14,14,14,15,13,15,14,11,12,15,9,14,2,2,2,2,3,1,2,1,3,4,1,9,15,7,12,13,15,12,14,1,1,15,1,1,1,20,5,17,5,1,2,1,1,185,80,10,20,7056909,6600,6600,5600,African_Caribbean,144,12,1995/7/28,75,5,12348.0,,77029444
805,Alex Telles,Sevilla,1992,547.0,br BRA,DF,29.0,15.9,21.0,13.0,15.0,6.0,0.0,13.0,25.0,52.0,12.0,17.0,5.0,12.0,20.0,41.0,38.0,0.0,Matches,547.0,br BRA,DF,29.0,15.9,42.0,2.65,31.0,5.0,1.0,2.0,3.0,0.0,4.0,0.25,3.0,0.0,0.0,0.0,1.0,0.0,Matches,,,,,,,,,,,,,,,,,,,,,,,,,,,,,,,,,,,,,,,,,,,,,,,,,,,,,,,,547.0,br BRA,DF,29.0,15.9,6.0,0.0,0.0,25.0,14.0,1.0,83.0,20.0,13.0,1.0,0.0,0.0,78.0,26.0,16.0,61.9,Matches,547.0,br BRA,DF,29.0,15.9,728.0,582.0,143.0,27.0,1.0,4.0,83.0,97.0,19.0,7.0,7.0,0.0,542.0,3.0,11.0,Matches,547.0,br BRA,DF,29.0,15.9,542.0,728.0,74.5,9200.0,3455.0,275.0,308.0,89.3,192.0,254.0,75.6,59.0,125.0,47.2,2.0,1.8,1.2,0.2,19.0,41.0,19.0,14.0,42.0,Matches,670,br BRA,DF,29,27,1427.0,53.0,41.7,15.9,15,76.0,6,12,24.0,3,1.22,17.0,24.0,-7.0,-0.44,-0.44,17.3,24.7,-7.4,-0.46,-0.44,Matches,547.0,br BRA,DF,29.0,15.9,880.0,57.0,287.0,348.0,252.0,11.0,880.0,28.0,14.0,50.0,13.0,46.4,400.0,1946.0,936.0,21.0,11.0,4.0,11.0,1.0,461.0,80.0,Matches,547.0,br BRA,DF,29.0,15.9,0.0,12.0,1.0,8.3,0.76,0.06,0.0,0.0,22.5,1.0,0.0,0.0,0.4,0.4,0.04,-0.4,-0.4,Matches,547.0,br BRA,DF,29.0,27.0,15.0,1427.0,15.9,0.0,2.0,2.0,0.0,0.0,0.0,6.0,0.0,0.4,0.4,1.8,2.2,21.0,42.0,80.0,0.0,0.13,0.13,0.0,0.13,0.03,0.11,0.14,0.03,0.14,Matches,Alex Telles,D/WB L,29,136,155,"Brazil,Italy",Manchester UFC,17,17,13,12,14,15,10,14,12,11,12,18,12,14,15,13,17,13,13,13,12,14,14,14,13,9,13,10,14,14,14,13,14,14,13,11,13,13,15,7,13,2,2,3,1,1,1,4,1,1,3,3,16,16,12,13,16,15,11,10,1,20,1,1,18,1,1,14,1,1,10,1,1,1,181,73,20,8,26620103,7000,7570,6190,Mediterranean_Hispanic,134,4,1992/12/15,6,0,115992.0,Sevilla,19162830
806,Marc-André ter Stegen,Barcelona,1992,548.0,de GER,GK,30.0,37.2,0.0,0.0,0.0,0.0,0.0,0.0,0.0,,0.0,0.0,0.0,0.0,1.0,1.0,7.0,3.0,Matches,548.0,de GER,GK,30.0,37.2,12.0,0.32,11.0,1.0,0.0,0.0,0.0,0.0,1.0,0.03,1.0,0.0,0.0,0.0,0.0,0.0,Matches,42.0,de GER,GK,30.0,37.2,18.0,3.0,0.0,2.0,3.0,23.7,0.21,8.7,0.23,168.0,335.0,50.1,1215.0,185.0,22.1,28.9,197.0,34.0,35.2,368.0,18.0,4.9,41.0,1.1,16.4,Matches,42.0,de GER,GK,30.0,38.0,38.0,3347.0,37.2,18.0,0.48,98.0,83.0,84.7,28.0,4.0,6.0,26.0,68.4,3.0,3.0,0.0,0.0,0.0,Matches,548.0,de GER,GK,30.0,37.2,0.0,0.0,0.0,0.0,2.0,0.0,0.0,1.0,0.0,0.0,0.0,0.0,69.0,6.0,1.0,85.7,Matches,548.0,de GER,GK,30.0,37.2,1412.0,1145.0,267.0,69.0,0.0,6.0,0.0,1.0,0.0,0.0,0.0,0.0,1193.0,0.0,0.0,Matches,548.0,de GER,GK,30.0,37.2,1193.0,1412.0,84.5,30703.0,21527.0,228.0,232.0,98.3,600.0,613.0,97.9,362.0,564.0,64.2,0.0,0.3,0.0,-0.3,3.0,15.0,0.0,0.0,4.0,Matches,672,de GER,GK,30,38,3347.0,88.0,97.9,37.2,38,88.0,36,0,,0,2.32,68.0,18.0,50.0,1.34,1.34,74.3,31.7,42.5,1.14,1.43,Matches,548.0,de GER,GK,30.0,37.2,1457.0,1076.0,1436.0,22.0,0.0,0.0,1457.0,0.0,0.0,,0.0,,963.0,4887.0,3425.0,0.0,0.0,0.0,1.0,1.0,851.0,0.0,Matches,548.0,de GER,GK,30.0,37.2,0.0,0.0,0.0,,0.0,0.0,,,,0.0,0.0,0.0,0.0,0.0,,0.0,0.0,Matches,548.0,de GER,GK,30.0,38.0,38.0,3347.0,37.2,0.0,0.0,0.0,0.0,0.0,0.0,0.0,0.0,0.0,0.0,0.3,0.3,0.0,4.0,0.0,0.0,0.0,0.0,0.0,0.0,0.0,0.01,0.01,0.0,0.01,Matches,Marc-André ter Stegen,GK,30,174,183,Germany,Barcelona,6,3,3,3,13,9,7,1,3,3,17,4,2,14,11,17,15,18,15,9,13,18,5,14,1,12,14,10,14,14,16,16,15,11,13,15,15,6,15,8,14,13,15,15,12,14,19,14,18,18,10,17,16,18,5,14,17,18,14,8,20,1,1,1,1,1,1,1,1,1,1,1,1,1,187,85,16,20,170775003,8700,8250,7950,Northern_European,172,1,1992/4/30,28,0,164999.0,,35017428
807,Pau Torres,Villarreal,1997,556.0,es ESP,DF,25.0,33.9,43.0,25.0,25.0,13.0,5.0,23.0,36.0,63.9,13.0,36.0,27.0,9.0,13.0,56.0,146.0,3.0,Matches,556.0,es ESP,DF,25.0,33.9,41.0,1.21,34.0,0.0,0.0,4.0,3.0,0.0,1.0,0.03,0.0,0.0,0.0,0.0,1.0,0.0,Matches,,,,,,,,,,,,,,,,,,,,,,,,,,,,,,,,,,,,,,,,,,,,,,,,,,,,,,,,556.0,es ESP,DF,25.0,33.9,10.0,0.0,0.0,20.0,17.0,0.0,4.0,13.0,25.0,2.0,0.0,1.0,195.0,59.0,48.0,55.1,Matches,556.0,es ESP,DF,25.0,33.9,2179.0,2034.0,141.0,79.0,8.0,49.0,4.0,8.0,0.0,0.0,0.0,0.0,1855.0,4.0,15.0,Matches,556.0,es ESP,DF,25.0,33.9,1855.0,2179.0,85.1,37186.0,12825.0,632.0,680.0,92.9,934.0,1024.0,91.2,262.0,414.0,63.3,0.0,1.0,1.4,-1.0,14.0,187.0,14.0,1.0,197.0,Matches,680,es ESP,DF,25,34,3054.0,90.0,89.3,33.9,34,90.0,33,0,,1,1.71,55.0,35.0,20.0,0.59,0.84,56.8,43.5,13.3,0.39,0.75,Matches,556.0,es ESP,DF,25.0,33.9,2495.0,361.0,1186.0,1174.0,154.0,32.0,2495.0,35.0,26.0,74.3,7.0,20.0,1573.0,10882.0,7623.0,76.0,48.0,0.0,22.0,4.0,1708.0,12.0,Matches,556.0,es ESP,DF,25.0,33.9,1.0,12.0,5.0,41.7,0.35,0.15,0.08,0.2,9.5,0.0,0.0,0.0,2.4,2.4,0.2,-1.4,-1.4,Matches,556.0,es ESP,DF,25.0,34.0,34.0,3054.0,33.9,1.0,0.0,1.0,1.0,0.0,0.0,10.0,0.0,2.4,2.4,1.0,3.5,76.0,197.0,12.0,0.03,0.0,0.03,0.03,0.03,0.07,0.03,0.1,0.07,0.1,Matches,Pau Torres,D C,25,157,167,Spain,Villarreal,7,8,11,6,14,5,16,7,7,16,14,8,16,14,13,15,14,12,15,11,14,13,5,11,6,16,14,15,15,11,6,17,14,15,16,16,13,6,12,7,14,1,1,1,2,3,2,2,2,1,2,2,17,16,4,17,10,14,14,13,1,1,20,1,1,1,14,1,10,1,1,1,1,1,191,80,20,9,60000001,7850,7850,6500,Mediterranean_Hispanic,155,2,1997/1/16,19,1,56871.0,,67217522
808,Lucas Torró,Osasuna,1994,558.0,es ESP,MF,28.0,27.5,48.0,32.0,28.0,15.0,5.0,18.0,42.0,42.9,24.0,24.0,3.0,21.0,42.0,90.0,64.0,1.0,Matches,558.0,es ESP,MF,28.0,27.5,24.0,0.87,20.0,0.0,0.0,3.0,1.0,0.0,1.0,0.04,1.0,0.0,0.0,0.0,0.0,0.0,Matches,,,,,,,,,,,,,,,,,,,,,,,,,,,,,,,,,,,,,,,,,,,,,,,,,,,,,,,,558.0,es ESP,MF,28.0,27.5,10.0,0.0,0.0,64.0,31.0,0.0,1.0,42.0,32.0,0.0,0.0,0.0,184.0,86.0,50.0,63.2,Matches,558.0,es ESP,MF,28.0,27.5,1166.0,1140.0,26.0,26.0,1.0,16.0,1.0,0.0,0.0,0.0,0.0,0.0,940.0,0.0,22.0,Matches,558.0,es ESP,MF,28.0,27.5,940.0,1166.0,80.6,15141.0,4090.0,496.0,571.0,86.9,350.0,415.0,84.3,68.0,116.0,58.6,0.0,0.3,0.4,-0.3,9.0,80.0,0.0,0.0,98.0,Matches,682,es ESP,MF,28,33,2477.0,75.0,72.4,27.5,31,79.0,17,2,10.0,1,1.3,24.0,25.0,-1.0,-0.04,0.35,29.3,30.1,-0.8,-0.03,0.45,Matches,558.0,es ESP,MF,28.0,27.5,1459.0,91.0,365.0,873.0,233.0,32.0,1459.0,21.0,11.0,52.4,7.0,33.3,631.0,2565.0,962.0,12.0,16.0,1.0,31.0,14.0,770.0,17.0,Matches,558.0,es ESP,MF,28.0,27.5,1.0,28.0,4.0,14.3,1.02,0.15,0.04,0.25,24.9,0.0,0.0,0.0,1.4,1.4,0.05,-0.4,-0.4,Matches,558.0,es ESP,MF,28.0,33.0,31.0,2477.0,27.5,1.0,0.0,1.0,1.0,0.0,0.0,10.0,0.0,1.4,1.4,0.3,1.6,12.0,98.0,17.0,0.04,0.0,0.04,0.04,0.04,0.05,0.01,0.06,0.05,0.06,Matches,Lucas Torró,DM/M C,28,130,135,Spain,Atlético Pamplona,6,8,10,7,13,6,16,9,10,12,13,9,15,12,10,16,17,13,15,9,12,15,6,13,8,16,17,13,10,13,14,16,15,10,14,15,15,13,15,7,9,3,1,3,1,3,1,2,1,2,1,2,12,14,8,12,13,16,10,16,1,1,12,1,1,1,20,1,20,1,1,10,1,1,190,77,10,20,2506616,6250,6250,4150,Mediterranean_Hispanic,129,7,1994/7/19,0,0,6775.0,,67158501
809,Enes Ünal,Getafe,1997,564.0,tr TUR,FW,25.0,33.0,26.0,14.0,5.0,19.0,2.0,7.0,25.0,28.0,18.0,19.0,2.0,17.0,6.0,32.0,35.0,0.0,Matches,564.0,tr TUR,FW,25.0,33.0,68.0,2.06,45.0,0.0,2.0,5.0,15.0,1.0,8.0,0.24,5.0,0.0,0.0,0.0,3.0,0.0,Matches,,,,,,,,,,,,,,,,,,,,,,,,,,,,,,,,,,,,,,,,,,,,,,,,,,,,,,,,564.0,tr TUR,FW,25.0,33.0,6.0,0.0,0.0,61.0,77.0,28.0,17.0,6.0,14.0,2.0,0.0,0.0,87.0,156.0,164.0,48.8,Matches,564.0,tr TUR,FW,25.0,33.0,750.0,728.0,16.0,1.0,6.0,2.0,17.0,1.0,0.0,0.0,0.0,0.0,446.0,6.0,21.0,Matches,564.0,tr TUR,FW,25.0,33.0,446.0,750.0,59.5,5529.0,1253.0,281.0,404.0,69.6,110.0,203.0,54.2,14.0,31.0,45.2,3.0,3.5,1.9,-0.5,27.0,40.0,16.0,3.0,55.0,Matches,688,tr TUR,FW,25,35,2970.0,85.0,86.8,33.0,35,85.0,19,0,,0,1.09,29.0,42.0,-13.0,-0.39,-0.79,31.1,40.8,-9.6,-0.29,-0.35,Matches,564.0,tr TUR,FW,25.0,33.0,1117.0,43.0,91.0,506.0,535.0,138.0,1111.0,43.0,21.0,48.8,19.0,44.2,618.0,2236.0,902.0,29.0,26.0,15.0,88.0,50.0,893.0,148.0,Matches,564.0,tr TUR,FW,25.0,33.0,14.0,82.0,31.0,37.8,2.48,0.94,0.11,0.29,18.8,16.0,5.0,6.0,11.7,7.1,0.09,2.3,1.9,Matches,564.0,tr TUR,FW,25.0,35.0,35.0,2970.0,33.0,14.0,3.0,17.0,9.0,5.0,6.0,6.0,0.0,11.7,7.1,3.5,10.6,29.0,55.0,148.0,0.42,0.09,0.52,0.27,0.36,0.36,0.11,0.46,0.21,0.32,Matches,Enes Ünal,S,25,134,142,Turkey,Getafe,6,9,13,15,14,15,12,13,6,6,10,14,6,15,7,12,11,13,11,11,12,15,14,9,14,7,11,12,13,15,13,10,12,12,12,14,13,4,17,6,11,3,2,2,2,3,1,3,4,2,3,4,8,15,5,12,12,15,12,10,1,1,1,1,1,1,1,1,1,1,5,14,5,20,185,75,16,20,4630645,6600,6500,5950,Mediterranean_Hispanic,133,8,1997/5/10,27,2,12079.0,,70087488
810,Óscar Valentín,Rayo Vallecano,1994,566.0,es ESP,MF,27.0,28.4,92.0,51.0,29.0,50.0,13.0,46.0,121.0,38.0,75.0,60.0,9.0,51.0,44.0,136.0,30.0,0.0,Matches,566.0,es ESP,MF,27.0,28.4,48.0,1.69,41.0,0.0,0.0,1.0,2.0,4.0,2.0,0.07,2.0,0.0,0.0,0.0,0.0,0.0,Matches,,,,,,,,,,,,,,,,,,,,,,,,,,,,,,,,,,,,,,,,,,,,,,,,,,,,,,,,566.0,es ESP,MF,27.0,28.4,11.0,0.0,0.0,75.0,50.0,1.0,3.0,44.0,51.0,0.0,0.0,0.0,204.0,27.0,45.0,37.5,Matches,566.0,es ESP,MF,27.0,28.4,1173.0,1138.0,32.0,32.0,1.0,9.0,3.0,0.0,0.0,0.0,0.0,0.0,957.0,3.0,17.0,Matches,566.0,es ESP,MF,27.0,28.4,957.0,1173.0,81.6,16532.0,5381.0,469.0,528.0,88.8,377.0,440.0,85.7,97.0,159.0,61.0,0.0,0.9,1.2,-0.9,19.0,138.0,5.0,1.0,133.0,Matches,691,es ESP,MF,27,34,2555.0,75.0,74.7,28.4,29,82.0,13,5,34.0,0,1.32,34.0,33.0,1.0,0.04,0.97,30.8,33.9,-3.1,-0.11,0.23,Matches,566.0,es ESP,MF,27.0,28.4,1501.0,67.0,337.0,977.0,200.0,17.0,1501.0,20.0,7.0,35.0,11.0,55.0,762.0,4184.0,2021.0,21.0,24.0,1.0,22.0,13.0,829.0,17.0,Matches,566.0,es ESP,MF,27.0,28.4,0.0,13.0,1.0,7.7,0.46,0.04,0.0,0.0,23.6,0.0,0.0,0.0,0.5,0.5,0.04,-0.5,-0.5,Matches,566.0,es ESP,MF,27.0,34.0,29.0,2555.0,28.4,0.0,0.0,0.0,0.0,0.0,0.0,11.0,0.0,0.5,0.5,0.9,1.4,21.0,133.0,17.0,0.0,0.0,0.0,0.0,0.0,0.02,0.03,0.05,0.02,0.05,Matches,Óscar Valentín,DM/M C,27,132,135,Spain,Vallecano,8,8,12,11,13,10,9,10,6,13,13,10,13,12,13,14,16,13,14,11,13,14,9,14,11,13,17,16,13,12,12,8,11,12,15,11,15,8,7,8,14,3,3,2,3,1,1,1,2,3,1,2,15,13,7,15,11,16,14,14,1,1,10,6,1,1,20,1,19,1,1,1,1,1,177,72,12,20,4062390,6600,6600,4600,Mediterranean_Hispanic,130,4,1994/8/20,0,0,11664.0,,67213714
811,Martin Valjent,Mallorca,1995,567.0,sk SVK,DF,26.0,29.5,35.0,27.0,22.0,12.0,1.0,19.0,28.0,67.9,9.0,39.0,21.0,18.0,29.0,64.0,137.0,0.0,Matches,567.0,sk SVK,DF,26.0,29.5,6.0,0.2,5.0,0.0,0.0,0.0,1.0,0.0,2.0,0.07,1.0,0.0,0.0,0.0,1.0,0.0,Matches,,,,,,,,,,,,,,,,,,,,,,,,,,,,,,,,,,,,,,,,,,,,,,,,,,,,,,,,567.0,sk SVK,DF,26.0,29.5,8.0,0.0,0.0,33.0,11.0,1.0,6.0,29.0,27.0,0.0,1.0,0.0,114.0,34.0,29.0,54.0,Matches,567.0,sk SVK,DF,26.0,29.5,1123.0,1032.0,86.0,45.0,1.0,21.0,6.0,41.0,0.0,0.0,0.0,0.0,885.0,5.0,14.0,Matches,567.0,sk SVK,DF,26.0,29.5,885.0,1123.0,78.8,16962.0,7350.0,359.0,389.0,92.3,414.0,489.0,84.7,105.0,213.0,49.3,0.0,0.4,0.4,-0.4,3.0,59.0,5.0,2.0,57.0,Matches,692,sk SVK,DF,26,30,2656.0,89.0,77.7,29.5,30,89.0,27,0,,2,1.4,29.0,33.0,-4.0,-0.14,0.1,27.5,36.4,-8.9,-0.3,-0.03,Matches,567.0,sk SVK,DF,26.0,29.5,1405.0,206.0,759.0,594.0,62.0,5.0,1405.0,5.0,0.0,0.0,2.0,40.0,719.0,3539.0,1751.0,15.0,16.0,2.0,6.0,1.0,767.0,3.0,Matches,567.0,sk SVK,DF,26.0,29.5,0.0,6.0,2.0,33.3,0.2,0.07,0.0,0.0,21.1,0.0,0.0,0.0,0.3,0.3,0.06,-0.3,-0.3,Matches,567.0,sk SVK,DF,26.0,30.0,30.0,2656.0,29.5,0.0,0.0,0.0,0.0,0.0,0.0,8.0,0.0,0.3,0.3,0.4,0.7,15.0,57.0,3.0,0.0,0.0,0.0,0.0,0.0,0.01,0.01,0.02,0.01,0.02,Matches,Martin Valjent,D RC,26,129,141,Slovakia,Mallorca,4,8,7,7,12,4,15,4,7,14,12,5,14,10,13,13,12,13,13,11,13,10,11,10,9,14,13,13,12,12,13,13,13,13,14,15,14,11,13,5,14,2,1,3,3,4,3,1,2,1,1,2,15,11,5,15,11,13,12,10,1,11,20,15,1,6,14,1,12,5,1,2,3,1,186,70,10,20,3395807,6400,6500,4250,Northern_European,128,1,1995/12/11,13,0,8491.0,,43143925
812,Federico Valverde,Real Madrid,1998,570.0,uy URU,MFFW,24.0,27.8,31.0,20.0,14.0,11.0,6.0,13.0,26.0,50.0,13.0,31.0,4.0,27.0,17.0,48.0,15.0,0.0,Matches,570.0,uy URU,MFFW,24.0,27.8,81.0,2.91,77.0,0.0,2.0,1.0,1.0,0.0,14.0,0.5,13.0,0.0,1.0,0.0,0.0,0.0,Matches,,,,,,,,,,,,,,,,,,,,,,,,,,,,,,,,,,,,,,,,,,,,,,,,,,,,,,,,570.0,uy URU,MFFW,24.0,27.8,2.0,0.0,0.0,11.0,15.0,5.0,27.0,17.0,20.0,0.0,0.0,0.0,132.0,31.0,11.0,73.8,Matches,570.0,uy URU,MFFW,24.0,27.8,1641.0,1611.0,21.0,6.0,3.0,22.0,27.0,14.0,0.0,0.0,0.0,0.0,1427.0,9.0,26.0,Matches,570.0,uy URU,MFFW,24.0,27.8,1427.0,1641.0,87.0,21092.0,4276.0,855.0,915.0,93.4,424.0,489.0,86.7,99.0,136.0,72.8,4.0,6.3,5.1,-2.3,43.0,118.0,45.0,6.0,151.0,Matches,696,uy URU,MFFW,24,34,2502.0,74.0,73.2,27.8,29,82.0,17,5,26.0,4,2.09,51.0,25.0,26.0,0.94,-0.34,52.7,26.7,26.0,0.93,-0.1,Matches,570.0,uy URU,MFFW,24.0,27.8,1870.0,35.0,229.0,857.0,800.0,54.0,1870.0,44.0,31.0,70.5,10.0,22.7,1190.0,6633.0,3349.0,70.0,68.0,8.0,21.0,7.0,1485.0,135.0,Matches,570.0,uy URU,MFFW,24.0,27.8,7.0,63.0,21.0,33.3,2.27,0.76,0.11,0.33,22.7,2.0,0.0,0.0,4.3,4.3,0.07,2.7,2.7,Matches,570.0,uy URU,MFFW,24.0,34.0,29.0,2502.0,27.8,7.0,4.0,11.0,7.0,0.0,0.0,2.0,0.0,4.3,4.3,6.3,10.6,70.0,151.0,135.0,0.25,0.14,0.4,0.25,0.4,0.15,0.23,0.38,0.15,0.38,Matches,Federico Valverde,M/AM RC,24,169,175,"Uruguay,Spain",R. Madrid,13,13,12,11,14,12,12,15,10,13,15,12,13,13,12,14,15,12,14,14,14,15,14,13,15,12,17,17,17,15,15,12,17,17,17,14,15,8,14,6,14,2,3,3,1,3,2,3,3,2,3,2,10,12,7,12,10,14,10,11,1,1,1,10,1,12,13,1,20,17,1,10,16,1,181,74,12,20,99900007,8450,8000,7500,Mediterranean_Hispanic,164,8,1998/7/22,42,4,209790.0,,78074594
813,Lucas Vázquez,Real Madrid,1991,573.0,es ESP,DF,31.0,12.7,34.0,23.0,22.0,10.0,2.0,20.0,28.0,71.4,8.0,10.0,0.0,10.0,7.0,41.0,13.0,0.0,Matches,573.0,es ESP,DF,31.0,12.7,41.0,3.22,32.0,2.0,2.0,1.0,3.0,1.0,2.0,0.16,1.0,0.0,0.0,0.0,1.0,0.0,Matches,,,,,,,,,,,,,,,,,,,,,,,,,,,,,,,,,,,,,,,,,,,,,,,,,,,,,,,,573.0,es ESP,DF,31.0,12.7,2.0,0.0,0.0,23.0,16.0,3.0,41.0,7.0,23.0,1.0,0.0,0.0,63.0,1.0,5.0,16.7,Matches,573.0,es ESP,DF,31.0,12.7,936.0,826.0,106.0,14.0,2.0,5.0,41.0,92.0,0.0,0.0,0.0,0.0,808.0,4.0,14.0,Matches,573.0,es ESP,DF,31.0,12.7,808.0,936.0,86.3,12257.0,2640.0,456.0,495.0,92.1,279.0,319.0,87.5,50.0,74.0,67.6,1.0,1.6,3.1,-0.6,21.0,28.0,30.0,6.0,50.0,Matches,699,es ESP,DF,31,23,1144.0,50.0,33.5,12.7,12,82.0,6,11,14.0,9,1.96,28.0,12.0,16.0,1.26,0.35,28.7,12.3,16.4,1.28,0.48,Matches,573.0,es ESP,DF,31.0,12.7,1059.0,25.0,263.0,422.0,377.0,46.0,1059.0,25.0,14.0,56.0,5.0,20.0,672.0,3060.0,1598.0,31.0,13.0,16.0,20.0,7.0,771.0,145.0,Matches,573.0,es ESP,DF,31.0,12.7,4.0,14.0,7.0,50.0,1.1,0.55,0.29,0.57,18.5,0.0,0.0,0.0,1.9,1.9,0.14,2.1,2.1,Matches,573.0,es ESP,DF,31.0,23.0,12.0,1144.0,12.7,4.0,1.0,5.0,4.0,0.0,0.0,2.0,0.0,1.9,1.9,1.6,3.5,31.0,50.0,145.0,0.31,0.08,0.39,0.31,0.39,0.15,0.13,0.28,0.15,0.28,Matches,Lucas Vázquez,D/WB/M/AM R,31,147,156,Spain,R. Madrid,14,13,12,11,13,11,10,11,8,12,13,12,13,13,15,15,14,11,14,11,14,14,14,11,14,13,15,16,14,15,15,7,14,14,15,11,13,8,13,6,16,2,3,3,2,2,3,1,2,1,2,2,9,10,4,14,13,15,14,16,1,1,1,16,1,18,1,1,1,20,1,1,16,1,173,71,12,20,15126039,7350,7350,6500,Mediterranean_Hispanic,143,6,1991/7/1,9,0,123288.0,,67135344
814,Mikel Vesga,Athletic Club,1993,577.0,es ESP,MF,29.0,28.6,57.0,35.0,21.0,31.0,5.0,25.0,68.0,36.8,43.0,39.0,8.0,31.0,36.0,93.0,39.0,3.0,Matches,577.0,es ESP,MF,29.0,28.6,54.0,1.89,49.0,0.0,0.0,3.0,1.0,1.0,6.0,0.21,3.0,0.0,0.0,1.0,1.0,1.0,Matches,,,,,,,,,,,,,,,,,,,,,,,,,,,,,,,,,,,,,,,,,,,,,,,,,,,,,,,,577.0,es ESP,MF,29.0,28.6,5.0,0.0,0.0,44.0,21.0,0.0,12.0,36.0,35.0,1.0,0.0,1.0,201.0,65.0,48.0,57.5,Matches,577.0,es ESP,MF,29.0,28.6,1510.0,1489.0,13.0,11.0,2.0,19.0,12.0,1.0,0.0,0.0,0.0,0.0,1259.0,8.0,16.0,Matches,577.0,es ESP,MF,29.0,28.6,1259.0,1510.0,83.4,22687.0,6824.0,562.0,655.0,85.8,513.0,582.0,88.1,152.0,197.0,77.2,3.0,1.5,1.8,1.5,20.0,193.0,21.0,4.0,199.0,Matches,703,es ESP,MF,29,36,2575.0,72.0,75.3,28.6,28,86.0,21,8,22.0,0,1.33,32.0,30.0,2.0,0.07,-0.14,40.2,26.5,13.6,0.48,0.09,Matches,577.0,es ESP,MF,29.0,28.6,1800.0,66.0,338.0,1118.0,355.0,32.0,1797.0,18.0,10.0,55.6,8.0,44.4,962.0,4175.0,1995.0,26.0,29.0,4.0,38.0,16.0,1152.0,31.0,Matches,577.0,es ESP,MF,29.0,28.6,3.0,25.0,3.0,12.0,0.87,0.1,0.04,0.33,21.9,0.0,2.0,3.0,3.9,1.5,0.06,-0.9,-0.5,Matches,577.0,es ESP,MF,29.0,36.0,28.0,2575.0,28.6,3.0,3.0,6.0,1.0,2.0,3.0,5.0,0.0,3.9,1.5,1.5,3.0,26.0,199.0,31.0,0.1,0.1,0.21,0.03,0.14,0.14,0.05,0.19,0.05,0.11,Matches,Mikel Vesga,DM/M C,29,135,140,"Spain,Pays Basque",A. Bilbao,7,7,8,8,14,10,14,14,9,14,13,8,14,13,13,13,13,14,13,12,13,13,7,8,12,15,16,17,12,13,10,15,12,13,14,14,13,11,12,8,13,3,2,3,1,2,2,1,1,1,3,2,20,12,7,10,11,9,11,18,1,1,1,1,1,1,20,10,19,10,1,1,1,1,191,84,20,9,27141965,6750,6750,5250,Mediterranean_Hispanic,135,4,1993/4/8,0,0,16783.0,,67195855
815,Aleix Vidal,Espanyol,1989,578.0,es ESP,MFFW,32.0,11.4,11.0,5.0,6.0,3.0,2.0,4.0,22.0,18.2,18.0,21.0,2.0,19.0,15.0,26.0,14.0,0.0,Matches,578.0,es ESP,MFFW,32.0,11.4,25.0,2.2,16.0,5.0,3.0,0.0,0.0,1.0,5.0,0.44,3.0,1.0,0.0,0.0,0.0,1.0,Matches,,,,,,,,,,,,,,,,,,,,,,,,,,,,,,,,,,,,,,,,,,,,,,,,,,,,,,,,578.0,es ESP,MFFW,32.0,11.4,10.0,1.0,1.0,23.0,17.0,1.0,39.0,15.0,5.0,0.0,0.0,0.0,63.0,3.0,7.0,30.0,Matches,578.0,es ESP,MFFW,32.0,11.4,384.0,328.0,54.0,11.0,1.0,3.0,39.0,36.0,6.0,0.0,4.0,0.0,279.0,2.0,17.0,Matches,578.0,es ESP,MFFW,32.0,11.4,279.0,384.0,72.7,4979.0,1379.0,147.0,176.0,83.5,90.0,127.0,70.9,37.0,53.0,69.8,3.0,2.2,1.3,0.8,15.0,19.0,10.0,4.0,23.0,Matches,705,es ESP,MFFW,32,25,1025.0,41.0,30.0,11.4,10,66.0,1,15,25.0,6,1.16,18.0,19.0,-1.0,-0.09,0.51,17.5,15.5,2.0,0.18,0.69,Matches,578.0,es ESP,MFFW,32.0,11.4,489.0,19.0,99.0,205.0,188.0,15.0,489.0,19.0,7.0,36.8,11.0,57.9,238.0,1219.0,457.0,16.0,5.0,3.0,15.0,7.0,250.0,53.0,Matches,578.0,es ESP,MFFW,32.0,11.4,0.0,3.0,2.0,66.7,0.26,0.18,0.0,0.0,17.4,0.0,0.0,0.0,0.1,0.1,0.04,-0.1,-0.1,Matches,578.0,es ESP,MFFW,32.0,25.0,10.0,1025.0,11.4,0.0,3.0,3.0,0.0,0.0,0.0,10.0,1.0,0.1,0.1,2.2,2.4,16.0,23.0,53.0,0.0,0.26,0.26,0.0,0.26,0.01,0.2,0.21,0.01,0.21,Matches,Aleix Vidal,D/WB/M/AM RL,32,135,149,Spain,Espanyol,11,12,13,10,13,8,7,9,12,11,13,11,12,13,12,11,14,11,12,10,13,15,15,9,15,11,13,16,15,12,12,8,15,13,13,9,14,10,12,7,16,2,1,2,3,3,1,1,3,1,3,1,11,14,10,8,13,13,11,9,1,1,1,18,1,18,1,15,1,18,16,1,20,1,177,70,10,20,3505900,6800,6800,6000,Mediterranean_Hispanic,125,5,1989/8/21,1,0,16471.0,,67064771
816,Nacho Vidal,Osasuna,1995,579.0,es ESP,DF,27.0,13.9,27.0,14.0,16.0,6.0,5.0,17.0,32.0,53.1,15.0,17.0,4.0,13.0,19.0,46.0,33.0,1.0,Matches,579.0,es ESP,DF,27.0,13.9,20.0,1.44,12.0,3.0,0.0,3.0,2.0,0.0,0.0,0.0,0.0,0.0,0.0,0.0,0.0,0.0,Matches,,,,,,,,,,,,,,,,,,,,,,,,,,,,,,,,,,,,,,,,,,,,,,,,,,,,,,,,579.0,es ESP,DF,27.0,13.9,4.0,0.0,0.0,28.0,17.0,0.0,31.0,19.0,14.0,0.0,0.0,0.0,61.0,29.0,13.0,69.0,Matches,579.0,es ESP,DF,27.0,13.9,622.0,482.0,138.0,5.0,2.0,2.0,31.0,133.0,0.0,0.0,0.0,0.0,472.0,2.0,12.0,Matches,579.0,es ESP,DF,27.0,13.9,472.0,622.0,75.9,7829.0,3267.0,227.0,257.0,88.3,197.0,248.0,79.4,36.0,82.0,43.9,0.0,0.6,0.6,-0.6,3.0,33.0,8.0,3.0,47.0,Matches,706,es ESP,DF,27,20,1247.0,62.0,36.5,13.9,15,76.0,8,5,23.0,4,1.5,10.0,15.0,-5.0,-0.36,-0.36,14.1,12.6,1.5,0.11,0.41,Matches,579.0,es ESP,DF,27.0,13.9,776.0,58.0,233.0,313.0,234.0,16.0,776.0,27.0,13.0,48.1,12.0,44.4,311.0,1420.0,620.0,20.0,10.0,4.0,18.0,13.0,363.0,52.0,Matches,579.0,es ESP,DF,27.0,13.9,0.0,9.0,2.0,22.2,0.65,0.14,0.0,0.0,19.8,0.0,0.0,0.0,0.6,0.6,0.06,-0.6,-0.6,Matches,579.0,es ESP,DF,27.0,20.0,15.0,1247.0,13.9,0.0,0.0,0.0,0.0,0.0,0.0,4.0,0.0,0.6,0.6,0.6,1.2,20.0,47.0,52.0,0.0,0.0,0.0,0.0,0.0,0.04,0.04,0.08,0.04,0.08,Matches,Nacho Vidal,D/WB R,27,127,138,Spain,Atlético Pamplona,8,13,12,8,10,7,9,8,13,11,11,10,13,12,11,13,13,12,14,10,11,12,12,11,14,13,14,14,14,13,11,10,13,14,15,11,14,12,11,8,13,3,2,2,1,2,4,3,3,1,3,3,17,11,5,14,12,12,12,16,1,1,12,20,1,19,1,1,1,13,1,1,1,1,180,0,11,20,2624031,6400,6400,4400,Mediterranean_Hispanic,124,6,1995/1/24,0,0,8662.0,,67184889
817,Iván Villar,Celta Vigo,1997,584.0,es ESP,GK,25.0,19.0,0.0,0.0,0.0,0.0,0.0,0.0,1.0,0.0,1.0,0.0,0.0,0.0,0.0,0.0,7.0,0.0,Matches,584.0,es ESP,GK,25.0,19.0,5.0,0.26,3.0,2.0,0.0,0.0,0.0,0.0,0.0,0.0,0.0,0.0,0.0,0.0,0.0,0.0,Matches,43.0,es ESP,GK,25.0,19.0,24.0,3.0,0.0,6.0,0.0,22.2,0.31,-1.8,-0.09,81.0,239.0,33.9,435.0,96.0,34.7,33.8,157.0,56.1,44.8,256.0,8.0,3.1,14.0,0.74,14.2,Matches,43.0,es ESP,GK,25.0,19.0,19.0,1710.0,19.0,24.0,1.26,62.0,38.0,66.1,6.0,5.0,8.0,4.0,21.1,4.0,3.0,0.0,1.0,0.0,Matches,584.0,es ESP,GK,25.0,19.0,0.0,0.0,0.0,0.0,2.0,0.0,0.0,0.0,0.0,0.0,0.0,0.0,23.0,2.0,1.0,66.7,Matches,584.0,es ESP,GK,25.0,19.0,599.0,376.0,216.0,59.0,0.0,2.0,0.0,0.0,0.0,0.0,0.0,0.0,414.0,7.0,0.0,Matches,584.0,es ESP,GK,25.0,19.0,414.0,599.0,69.1,11814.0,8420.0,65.0,67.0,97.0,227.0,233.0,97.4,122.0,292.0,41.8,0.0,0.0,0.0,0.0,1.0,6.0,0.0,0.0,1.0,Matches,713,es ESP,GK,25,19,1710.0,90.0,50.0,19.0,19,90.0,19,0,,19,1.21,25.0,24.0,1.0,0.05,0.63,21.4,25.8,-4.4,-0.23,-0.31,Matches,584.0,es ESP,GK,25.0,19.0,630.0,553.0,626.0,5.0,0.0,0.0,630.0,0.0,0.0,,0.0,,318.0,1495.0,898.0,0.0,0.0,0.0,0.0,0.0,250.0,0.0,Matches,584.0,es ESP,GK,25.0,19.0,0.0,0.0,0.0,,0.0,0.0,,,,0.0,0.0,0.0,0.0,0.0,,0.0,0.0,Matches,584.0,es ESP,GK,25.0,19.0,19.0,1710.0,19.0,0.0,0.0,0.0,0.0,0.0,0.0,0.0,0.0,0.0,0.0,0.0,0.0,0.0,1.0,0.0,0.0,0.0,0.0,0.0,0.0,0.0,0.0,0.0,0.0,0.0,Matches,Iván Villar,GK,25,125,141,Spain,Vigo,5,1,1,1,10,7,1,3,1,2,12,3,2,9,10,14,10,13,11,9,11,7,9,9,3,15,11,12,14,14,12,12,13,12,12,11,11,5,10,12,12,13,10,12,5,13,13,14,13,13,10,14,9,13,7,9,11,10,11,17,20,1,1,1,1,1,1,1,1,1,1,1,1,1,189,76,11,20,2186198,6241,6241,4004,Mediterranean_Hispanic,122,3,1997/7/9,0,0,17260.0,,67191440
818,Iñaki Williams,Athletic Club,1994,588.0,gh GHA,FW,28.0,31.5,22.0,16.0,5.0,14.0,3.0,9.0,24.0,37.5,15.0,18.0,3.0,15.0,7.0,29.0,34.0,0.0,Matches,588.0,gh GHA,FW,28.0,31.5,85.0,2.7,62.0,0.0,12.0,6.0,4.0,1.0,9.0,0.29,6.0,0.0,1.0,1.0,1.0,0.0,Matches,,,,,,,,,,,,,,,,,,,,,,,,,,,,,,,,,,,,,,,,,,,,,,,,,,,,,,,,588.0,gh GHA,FW,28.0,31.5,2.0,0.0,0.0,31.0,31.0,22.0,98.0,7.0,16.0,0.0,0.0,0.0,76.0,32.0,36.0,47.1,Matches,588.0,gh GHA,FW,28.0,31.5,827.0,773.0,50.0,1.0,3.0,6.0,98.0,15.0,0.0,0.0,0.0,0.0,531.0,4.0,49.0,Matches,588.0,gh GHA,FW,28.0,31.5,531.0,827.0,64.2,7395.0,1648.0,315.0,403.0,78.2,160.0,260.0,61.5,25.0,57.0,43.9,3.0,4.8,4.1,-1.8,38.0,24.0,27.0,9.0,61.0,Matches,719,gh GHA,FW,28,36,2836.0,79.0,82.9,31.5,34,82.0,15,2,25.0,0,1.33,37.0,35.0,2.0,0.06,-0.24,44.2,28.7,15.5,0.49,0.21,Matches,588.0,gh GHA,FW,28.0,31.5,1182.0,38.0,103.0,389.0,707.0,181.0,1180.0,105.0,47.0,44.8,48.0,45.7,756.0,5180.0,2721.0,127.0,53.0,57.0,73.0,42.0,915.0,341.0,Matches,588.0,gh GHA,FW,28.0,31.5,10.0,83.0,32.0,38.6,2.63,1.02,0.11,0.28,15.1,0.0,1.0,2.0,10.7,9.1,0.11,-0.7,-0.1,Matches,588.0,gh GHA,FW,28.0,36.0,34.0,2836.0,31.5,10.0,3.0,13.0,9.0,1.0,2.0,2.0,0.0,10.7,9.1,4.8,13.9,127.0,61.0,341.0,0.32,0.1,0.41,0.29,0.38,0.34,0.15,0.49,0.29,0.44,Matches,Iñaki Williams,AM/S RLC,28,153,159,"Ghana,Spain,Pays Basque",A. Bilbao,7,12,14,11,14,9,13,10,7,7,10,9,7,14,10,12,15,10,12,12,11,12,11,7,14,11,12,15,16,13,11,12,18,18,14,13,11,11,14,1,13,4,1,1,1,2,3,3,1,4,1,2,14,14,11,14,10,13,10,8,1,1,1,1,1,1,1,15,1,15,19,17,20,19,186,80,10,20,134999997,7650,7650,6900,African_Caribbean,138,17,1994/6/15,0,0,220548.0,,67184349
819,Nico Williams,Athletic Club,2002,589.0,es ESP,FW,20.0,29.5,31.0,16.0,10.0,15.0,6.0,19.0,41.0,46.3,22.0,40.0,2.0,38.0,8.0,39.0,14.0,1.0,Matches,589.0,es ESP,FW,20.0,29.5,105.0,3.56,66.0,12.0,18.0,4.0,4.0,1.0,9.0,0.31,5.0,0.0,2.0,1.0,1.0,0.0,Matches,,,,,,,,,,,,,,,,,,,,,,,,,,,,,,,,,,,,,,,,,,,,,,,,,,,,,,,,589.0,es ESP,FW,20.0,29.5,3.0,0.0,0.0,23.0,35.0,14.0,174.0,8.0,16.0,1.0,0.0,0.0,147.0,20.0,27.0,42.6,Matches,589.0,es ESP,FW,20.0,29.5,951.0,872.0,75.0,5.0,4.0,5.0,174.0,4.0,66.0,17.0,32.0,0.0,634.0,4.0,64.0,Matches,589.0,es ESP,FW,20.0,29.5,634.0,951.0,66.7,9342.0,2394.0,381.0,455.0,83.7,196.0,289.0,67.8,42.0,101.0,41.6,4.0,6.4,4.1,-2.4,46.0,24.0,36.0,12.0,80.0,Matches,720,es ESP,FW,20,36,2656.0,74.0,77.7,29.5,32,79.0,9,4,30.0,0,1.42,43.0,30.0,13.0,0.44,1.5,42.6,26.7,15.9,0.54,0.38,Matches,589.0,es ESP,FW,20.0,29.5,1382.0,11.0,132.0,376.0,898.0,148.0,1382.0,200.0,83.0,41.5,91.0,45.5,891.0,7039.0,3996.0,174.0,69.0,64.0,87.0,45.0,963.0,321.0,Matches,589.0,es ESP,FW,20.0,29.5,6.0,61.0,20.0,32.8,2.07,0.68,0.1,0.3,17.7,1.0,0.0,0.0,4.9,4.9,0.08,1.1,1.1,Matches,589.0,es ESP,FW,20.0,36.0,32.0,2656.0,29.5,6.0,4.0,10.0,6.0,0.0,0.0,3.0,0.0,4.9,4.9,6.4,11.3,174.0,80.0,321.0,0.2,0.14,0.34,0.2,0.34,0.17,0.22,0.38,0.17,0.38,Matches,Nico Williams,M/AM RL,20,139,-9,"Spain,Ghana,Pays Basque",A. Bilbao,7,13,14,13,13,8,12,10,8,9,13,14,9,14,10,13,13,13,12,13,13,15,13,11,15,12,13,13,15,15,11,10,14,14,13,14,12,6,13,13,12,1,3,3,3,2,3,3,1,1,4,3,17,13,6,15,13,13,10,11,1,1,1,1,1,1,1,17,1,19,17,1,20,14,180,0,20,10,50000001,6950,6950,6200,African_Caribbean,138,16,2002/7/12,0,0,21264.0,,67276230
820,Axel Witsel,Atlético Madrid,1989,590.0,be BEL,DFMF,33.0,25.1,36.0,22.0,22.0,11.0,3.0,17.0,31.0,54.8,14.0,20.0,11.0,9.0,23.0,59.0,76.0,0.0,Matches,590.0,be BEL,DFMF,33.0,25.1,23.0,0.92,22.0,0.0,0.0,1.0,0.0,0.0,4.0,0.16,4.0,0.0,0.0,0.0,0.0,0.0,Matches,,,,,,,,,,,,,,,,,,,,,,,,,,,,,,,,,,,,,,,,,,,,,,,,,,,,,,,,590.0,be BEL,DFMF,33.0,25.1,2.0,1.0,0.0,20.0,15.0,0.0,2.0,23.0,22.0,0.0,0.0,0.0,119.0,41.0,36.0,53.2,Matches,590.0,be BEL,DFMF,33.0,25.1,1328.0,1281.0,47.0,45.0,0.0,3.0,2.0,2.0,0.0,0.0,0.0,0.0,1229.0,0.0,8.0,Matches,590.0,be BEL,DFMF,33.0,25.1,1229.0,1328.0,92.5,19963.0,6886.0,568.0,597.0,95.1,565.0,595.0,95.0,59.0,85.0,69.4,0.0,0.6,0.5,-0.6,4.0,84.0,1.0,0.0,82.0,Matches,721,be BEL,DFMF,33,33,2258.0,68.0,66.0,25.1,25,86.0,21,8,14.0,4,2.03,59.0,27.0,32.0,1.28,0.89,45.1,28.8,16.2,0.65,0.3,Matches,590.0,be BEL,DFMF,33.0,25.1,1521.0,168.0,634.0,810.0,82.0,18.0,1521.0,7.0,6.0,85.7,1.0,14.3,949.0,4096.0,1965.0,6.0,9.0,0.0,8.0,3.0,1059.0,11.0,Matches,590.0,be BEL,DFMF,33.0,25.1,0.0,9.0,0.0,0.0,0.36,0.0,0.0,,15.0,0.0,0.0,0.0,0.6,0.6,0.07,-0.6,-0.6,Matches,590.0,be BEL,DFMF,33.0,33.0,25.0,2258.0,25.1,0.0,0.0,0.0,0.0,0.0,0.0,2.0,1.0,0.6,0.6,0.6,1.2,6.0,82.0,11.0,0.0,0.0,0.0,0.0,0.0,0.02,0.02,0.05,0.02,0.05,Matches,Axel Witsel,DM/M C,33,144,160,"Belgium,Martinique",A. Madrid,8,10,13,10,15,8,13,11,9,12,16,14,12,15,11,18,13,18,19,13,14,13,8,13,12,12,18,13,10,11,18,14,18,10,14,14,16,13,18,10,10,2,2,2,2,3,2,2,3,2,1,2,17,8,11,6,18,15,10,14,1,1,15,1,1,1,20,8,20,10,8,12,10,1,186,81,12,20,11817277,7750,7944,7244,Mixed_Race,144,8,1989/1/12,124,12,119999.0,,8169215
821,Igor Zubeldia,Real Sociedad,1997,595.0,es ESP,DF,25.0,28.2,35.0,18.0,28.0,7.0,0.0,25.0,35.0,71.4,10.0,23.0,17.0,6.0,21.0,56.0,93.0,0.0,Matches,595.0,es ESP,DF,25.0,28.2,11.0,0.39,9.0,1.0,0.0,0.0,0.0,1.0,2.0,0.07,2.0,0.0,0.0,0.0,0.0,0.0,Matches,,,,,,,,,,,,,,,,,,,,,,,,,,,,,,,,,,,,,,,,,,,,,,,,,,,,,,,,595.0,es ESP,DF,25.0,28.2,11.0,0.0,0.0,44.0,10.0,1.0,3.0,21.0,18.0,0.0,0.0,1.0,165.0,60.0,53.0,53.1,Matches,595.0,es ESP,DF,25.0,28.2,1557.0,1490.0,62.0,44.0,1.0,12.0,3.0,18.0,0.0,0.0,0.0,0.0,1329.0,5.0,12.0,Matches,595.0,es ESP,DF,25.0,28.2,1329.0,1557.0,85.4,26531.0,9705.0,422.0,474.0,89.0,753.0,824.0,91.4,149.0,231.0,64.5,1.0,0.4,0.6,0.6,3.0,79.0,8.0,1.0,128.0,Matches,726,es ESP,DF,25,31,2542.0,82.0,74.3,28.2,29,86.0,24,2,24.0,4,1.77,35.0,26.0,9.0,0.32,-0.4,38.8,24.8,14.0,0.5,-0.1,Matches,595.0,es ESP,DF,25.0,28.2,1772.0,180.0,820.0,912.0,48.0,10.0,1772.0,8.0,8.0,100.0,0.0,0.0,1080.0,6177.0,3803.0,14.0,3.0,1.0,6.0,1.0,1148.0,4.0,Matches,595.0,es ESP,DF,25.0,28.2,1.0,6.0,1.0,16.7,0.21,0.04,0.17,1.0,14.5,0.0,0.0,0.0,0.9,0.9,0.14,0.1,0.1,Matches,595.0,es ESP,DF,25.0,31.0,29.0,2542.0,28.2,1.0,1.0,2.0,1.0,0.0,0.0,11.0,0.0,0.9,0.9,0.4,1.3,14.0,128.0,4.0,0.04,0.04,0.07,0.04,0.07,0.03,0.01,0.04,0.03,0.04,Matches,Igor Zubeldia,D C,25,139,147,"Spain,Pays Basque",Real San Sebastián,9,11,12,12,12,12,13,12,8,14,14,12,14,14,15,15,13,12,13,12,13,12,9,11,11,14,16,15,12,13,13,11,14,12,15,14,13,14,11,7,14,3,2,2,3,3,4,1,3,3,1,3,12,11,8,15,12,13,12,14,1,1,20,1,1,1,15,1,12,1,1,1,1,1,180,79,12,20,17242702,6949,6949,4849,Mediterranean_Hispanic,139,5,1997/3/30,0,0,21547.0,,67215898
822,Martín Zubimendi,Real Sociedad,1999,596.0,es ESP,MF,23.0,34.5,59.0,33.0,23.0,30.0,6.0,24.0,45.0,53.3,21.0,44.0,17.0,27.0,37.0,96.0,55.0,4.0,Matches,596.0,es ESP,MF,23.0,34.5,52.0,1.51,47.0,0.0,0.0,1.0,3.0,1.0,6.0,0.17,6.0,0.0,0.0,0.0,0.0,0.0,Matches,,,,,,,,,,,,,,,,,,,,,,,,,,,,,,,,,,,,,,,,,,,,,,,,,,,,,,,,596.0,es ESP,MF,23.0,34.5,12.0,0.0,0.0,50.0,31.0,1.0,4.0,37.0,33.0,0.0,1.0,0.0,218.0,58.0,34.0,63.0,Matches,596.0,es ESP,MF,23.0,34.5,1812.0,1748.0,58.0,54.0,6.0,10.0,4.0,2.0,0.0,0.0,0.0,0.0,1545.0,6.0,23.0,Matches,596.0,es ESP,MF,23.0,34.5,1545.0,1812.0,85.3,26783.0,8092.0,692.0,784.0,88.3,702.0,770.0,91.2,125.0,188.0,66.5,3.0,2.0,2.2,1.0,20.0,175.0,23.0,1.0,184.0,Matches,728,es ESP,MF,23,36,3101.0,86.0,90.7,34.5,35,88.0,33,1,26.0,0,1.81,45.0,34.0,11.0,0.32,-1.09,46.7,31.1,15.6,0.45,-0.74,Matches,596.0,es ESP,MF,23.0,34.5,2090.0,108.0,509.0,1350.0,259.0,18.0,2090.0,24.0,9.0,37.5,10.0,41.7,1265.0,6896.0,3678.0,43.0,39.0,3.0,23.0,17.0,1443.0,29.0,Matches,596.0,es ESP,MF,23.0,34.5,1.0,13.0,2.0,15.4,0.38,0.06,0.08,0.5,19.7,0.0,0.0,0.0,1.9,1.9,0.15,-0.9,-0.9,Matches,596.0,es ESP,MF,23.0,36.0,35.0,3101.0,34.5,1.0,3.0,4.0,1.0,0.0,0.0,12.0,0.0,1.9,1.9,2.0,3.9,43.0,184.0,29.0,0.03,0.09,0.12,0.03,0.12,0.06,0.06,0.11,0.06,0.11,Matches,Martín Zubimendi,DM/M C,23,146,153,"Spain,Pays Basque",Real San Sebastián,9,10,13,11,14,8,14,13,9,15,16,12,13,15,14,14,12,13,15,14,14,11,8,12,7,14,16,15,12,13,12,11,15,11,14,14,14,9,14,8,12,2,1,3,2,2,2,3,2,3,1,2,18,11,8,16,15,14,12,13,1,1,1,1,1,1,20,1,20,1,1,1,1,1,181,74,12,20,41233256,7300,7300,5500,Mediterranean_Hispanic,145,1,1999/2/2,1,0,34472.0,,67246385
823,Yunis Abdelhamid,Reims,1987,1.0,ma MAR,DF,34.0,37.0,82.0,50.0,47.0,33.0,2.0,39.0,52.0,75.0,13.0,65.0,27.0,38.0,64.0,146.0,116.0,1.0,Matches,1.0,ma MAR,DF,34.0,37.0,43.0,1.16,34.0,0.0,2.0,5.0,0.0,2.0,7.0,0.19,4.0,0.0,2.0,1.0,0.0,0.0,Matches,,,,,,,,,,,,,,,,,,,,,,,,,,,,,,,,,,,,,,,,,,,,,,,,,,,,,,,,1.0,ma MAR,DF,34.0,37.0,6.0,0.0,0.0,49.0,28.0,2.0,5.0,64.0,50.0,0.0,0.0,0.0,263.0,93.0,51.0,64.6,Matches,1.0,ma MAR,DF,34.0,37.0,2031.0,1882.0,142.0,116.0,0.0,30.0,5.0,10.0,0.0,0.0,0.0,0.0,1679.0,7.0,20.0,Matches,1.0,ma MAR,DF,34.0,37.0,1679.0,2031.0,82.7,32967.0,13407.0,490.0,571.0,85.8,1006.0,1117.0,90.1,155.0,279.0,55.6,2.0,1.0,0.9,1.0,13.0,155.0,5.0,0.0,215.0,Matches,1,ma MAR,DF,34,37,3330.0,90.0,97.4,37.0,37,90.0,37,0,,0,1.38,45.0,42.0,3.0,0.08,3.08,60.5,50.1,10.4,0.28,1.79,Matches,1.0,ma MAR,DF,34.0,37.0,2459.0,241.0,1088.0,1275.0,123.0,39.0,2459.0,37.0,21.0,56.8,14.0,37.8,1723.0,10871.0,6123.0,40.0,21.0,3.0,27.0,23.0,1499.0,10.0,Matches,1.0,ma MAR,DF,34.0,37.0,1.0,32.0,3.0,9.4,0.86,0.08,0.03,0.33,15.0,0.0,0.0,0.0,2.4,2.4,0.07,-1.4,-1.4,Matches,1.0,ma MAR,DF,34.0,37.0,37.0,3330.0,37.0,1.0,2.0,3.0,1.0,0.0,0.0,6.0,0.0,2.4,2.4,1.0,3.4,40.0,215.0,10.0,0.03,0.05,0.08,0.03,0.08,0.06,0.03,0.09,0.06,0.09,Matches,Yunis Abdelhamid,D C,34,131,131,"Morocco,France",Stade de Reims,3,10,4,5,12,4,14,6,5,15,12,7,14,8,15,14,16,12,15,9,13,15,8,12,8,14,13,14,11,11,15,16,16,12,15,16,15,12,11,5,5,3,1,2,3,2,2,2,1,2,1,3,9,14,7,13,12,15,13,12,1,1,20,1,1,1,1,1,1,1,1,1,1,1,190,83,20,5,347975206,6550,6550,3907,North_African__Middle_Eastern,131,11,1987/9/28,10,0,18410.0,,85122308
824,Salis Abdul Samed,Lens,2000,3.0,gh GHA,MF,22.0,32.2,46.0,26.0,18.0,23.0,5.0,29.0,52.0,55.8,23.0,38.0,9.0,29.0,36.0,82.0,26.0,0.0,Matches,3.0,gh GHA,MF,22.0,32.2,50.0,1.55,43.0,0.0,2.0,2.0,2.0,1.0,1.0,0.03,1.0,0.0,0.0,0.0,0.0,0.0,Matches,,,,,,,,,,,,,,,,,,,,,,,,,,,,,,,,,,,,,,,,,,,,,,,,,,,,,,,,3.0,gh GHA,MF,22.0,32.2,6.0,1.0,0.0,71.0,38.0,0.0,10.0,36.0,26.0,0.0,0.0,1.0,213.0,14.0,17.0,45.2,Matches,3.0,gh GHA,MF,22.0,32.2,1981.0,1927.0,45.0,43.0,5.0,5.0,10.0,2.0,0.0,0.0,0.0,0.0,1819.0,9.0,15.0,Matches,3.0,gh GHA,MF,22.0,32.2,1819.0,1981.0,91.8,28679.0,7020.0,897.0,964.0,93.0,769.0,811.0,94.8,92.0,117.0,78.6,1.0,1.6,2.3,-0.6,17.0,182.0,17.0,3.0,165.0,Matches,3,gh GHA,MF,22,33,2894.0,88.0,84.6,32.2,33,88.0,30,0,,0,2.24,59.0,22.0,37.0,1.15,0.81,57.7,35.9,21.8,0.68,0.43,Matches,3.0,gh GHA,MF,22.0,32.2,2224.0,66.0,404.0,1502.0,340.0,16.0,2224.0,49.0,29.0,59.2,13.0,26.5,1849.0,9645.0,3457.0,33.0,56.0,3.0,39.0,32.0,1705.0,44.0,Matches,3.0,gh GHA,MF,22.0,32.2,1.0,13.0,4.0,30.8,0.4,0.12,0.08,0.25,19.1,0.0,0.0,0.0,0.9,0.9,0.07,0.1,0.1,Matches,3.0,gh GHA,MF,22.0,33.0,33.0,2894.0,32.2,1.0,1.0,2.0,1.0,0.0,0.0,6.0,1.0,0.9,0.9,1.6,2.5,33.0,165.0,44.0,0.03,0.03,0.06,0.03,0.06,0.03,0.05,0.08,0.03,0.08,Matches,Salis Abdul Samed,DM/M C,22,121,144,Ghana,RC Lens,8,11,11,6,13,10,11,9,9,14,12,8,13,12,10,13,12,12,12,12,13,11,11,10,10,14,13,14,13,12,11,11,13,13,14,14,12,11,9,10,8,1,1,1,2,1,3,3,3,2,4,3,11,11,10,10,10,12,10,9,1,1,1,1,1,1,20,1,20,1,1,1,1,1,179,69,8,20,5619999,6048,6048,2502,African_Caribbean,122,16,2000/3/26,0,0,7535.0,,49060803
825,Laurent Abergel,Lorient,1993,4.0,fr FRA,MF,29.0,26.0,92.0,52.0,59.0,30.0,3.0,39.0,92.0,42.4,53.0,47.0,8.0,39.0,34.0,126.0,39.0,0.0,Matches,4.0,fr FRA,MF,29.0,26.0,33.0,1.27,27.0,2.0,2.0,1.0,0.0,1.0,1.0,0.04,1.0,0.0,0.0,0.0,0.0,0.0,Matches,,,,,,,,,,,,,,,,,,,,,,,,,,,,,,,,,,,,,,,,,,,,,,,,,,,,,,,,4.0,fr FRA,MF,29.0,26.0,7.0,1.0,1.0,28.0,29.0,0.0,6.0,34.0,52.0,0.0,0.0,0.0,193.0,8.0,15.0,34.8,Matches,4.0,fr FRA,MF,29.0,26.0,1483.0,1431.0,49.0,47.0,10.0,8.0,6.0,1.0,1.0,0.0,0.0,0.0,1308.0,3.0,14.0,Matches,4.0,fr FRA,MF,29.0,26.0,1308.0,1483.0,88.2,22287.0,7579.0,593.0,640.0,92.7,562.0,617.0,91.1,111.0,160.0,69.4,1.0,1.3,1.1,-0.3,14.0,144.0,11.0,0.0,143.0,Matches,4,fr FRA,MF,29,29,2342.0,81.0,68.5,26.0,28,83.0,19,1,26.0,0,1.72,38.0,35.0,3.0,0.12,0.45,31.6,39.7,-8.1,-0.31,0.16,Matches,4.0,fr FRA,MF,29.0,26.0,1779.0,76.0,581.0,1069.0,151.0,4.0,1779.0,41.0,23.0,56.1,14.0,34.1,1384.0,6069.0,2597.0,13.0,29.0,0.0,29.0,19.0,1257.0,14.0,Matches,4.0,fr FRA,MF,29.0,26.0,0.0,13.0,2.0,15.4,0.5,0.08,0.0,0.0,24.0,0.0,0.0,0.0,0.5,0.5,0.04,-0.5,-0.5,Matches,4.0,fr FRA,MF,29.0,29.0,28.0,2342.0,26.0,0.0,1.0,1.0,0.0,0.0,0.0,7.0,1.0,0.5,0.5,1.3,1.8,13.0,143.0,14.0,0.0,0.04,0.04,0.0,0.04,0.02,0.05,0.07,0.02,0.07,Matches,Laurent Abergel,DM/M C,29,130,131,France,FC Lorient,7,10,10,8,12,7,8,13,11,13,13,8,16,13,14,13,15,13,13,12,12,15,8,14,13,14,14,15,12,14,13,6,14,13,16,11,13,11,14,6,12,1,1,2,3,3,1,3,1,3,4,3,10,14,6,14,12,14,16,14,1,10,1,14,10,14,18,1,20,10,1,1,1,1,170,65,8,20,4546420,6495,6495,3895,Northern_European,127,5,1993/2/1,0,0,14468.0,,85057862
826,Lucien Agoume,Troyes,2002,11.0,fr FRA,MF,20.0,12.2,42.0,25.0,18.0,15.0,9.0,17.0,33.0,51.5,16.0,14.0,5.0,9.0,27.0,69.0,24.0,0.0,Matches,11.0,fr FRA,MF,20.0,12.2,27.0,2.22,23.0,3.0,0.0,1.0,0.0,0.0,1.0,0.08,1.0,0.0,0.0,0.0,0.0,0.0,Matches,,,,,,,,,,,,,,,,,,,,,,,,,,,,,,,,,,,,,,,,,,,,,,,,,,,,,,,,11.0,fr FRA,MF,20.0,12.2,5.0,0.0,0.0,30.0,8.0,1.0,9.0,27.0,25.0,0.0,0.0,0.0,84.0,31.0,18.0,63.3,Matches,11.0,fr FRA,MF,20.0,12.2,744.0,720.0,21.0,15.0,3.0,8.0,9.0,2.0,4.0,3.0,0.0,0.0,619.0,3.0,12.0,Matches,11.0,fr FRA,MF,20.0,12.2,619.0,744.0,83.2,10977.0,3466.0,254.0,295.0,86.1,285.0,322.0,88.5,60.0,89.0,67.4,1.0,1.1,1.0,-0.1,12.0,62.0,15.0,2.0,93.0,Matches,12,fr FRA,MF,20,15,1094.0,73.0,32.0,12.2,14,78.0,8,1,9.0,6,0.4,9.0,29.0,-20.0,-1.65,-1.03,11.9,26.0,-14.1,-1.16,-0.2,Matches,11.0,fr FRA,MF,20.0,12.2,893.0,45.0,276.0,480.0,143.0,13.0,893.0,13.0,5.0,38.5,5.0,38.5,646.0,3160.0,1227.0,9.0,10.0,0.0,9.0,11.0,590.0,10.0,Matches,11.0,fr FRA,MF,20.0,12.2,0.0,9.0,3.0,33.3,0.74,0.25,0.0,0.0,15.6,0.0,0.0,0.0,0.8,0.8,0.09,-0.8,-0.8,Matches,11.0,fr FRA,MF,20.0,15.0,14.0,1094.0,12.2,0.0,1.0,1.0,0.0,0.0,0.0,5.0,0.0,0.8,0.8,1.1,1.9,9.0,93.0,10.0,0.0,0.08,0.08,0.0,0.08,0.07,0.09,0.16,0.07,0.16,Matches,Lucien Agoume,DM/M C,20,119,-8,"France,Cameroon",FC Internazionale Milano,10,9,12,9,12,11,11,10,8,10,14,10,12,13,8,11,10,8,12,14,12,12,12,6,13,12,12,12,12,12,14,13,17,12,15,13,12,7,13,6,11,1,2,2,1,2,3,2,3,2,2,3,10,14,10,12,11,14,12,10,1,1,1,1,1,1,18,1,20,1,1,15,1,1,185,72,10,20,59750000,5949,4792,4658,African_Caribbean,118,17,2002/2/9,0,0,7115.0,ESTAC Troyes,49048461
827,Ruben Aguilar,Monaco,1993,12.0,fr FRA,DF,29.0,13.0,19.0,9.0,7.0,7.0,5.0,8.0,22.0,36.4,14.0,13.0,1.0,12.0,18.0,37.0,28.0,1.0,Matches,12.0,fr FRA,DF,29.0,13.0,18.0,1.38,14.0,1.0,0.0,1.0,1.0,1.0,2.0,0.15,2.0,0.0,0.0,0.0,0.0,0.0,Matches,,,,,,,,,,,,,,,,,,,,,,,,,,,,,,,,,,,,,,,,,,,,,,,,,,,,,,,,12.0,fr FRA,DF,29.0,13.0,3.0,0.0,0.0,15.0,14.0,1.0,39.0,18.0,9.0,0.0,0.0,0.0,80.0,12.0,14.0,46.2,Matches,12.0,fr FRA,DF,29.0,13.0,847.0,696.0,149.0,18.0,0.0,3.0,39.0,131.0,0.0,0.0,0.0,0.0,696.0,2.0,22.0,Matches,12.0,fr FRA,DF,29.0,13.0,696.0,847.0,82.2,10933.0,4515.0,352.0,394.0,89.3,291.0,343.0,84.8,36.0,68.0,52.9,0.0,0.9,1.2,-0.9,3.0,72.0,11.0,5.0,102.0,Matches,13,fr FRA,DF,29,20,1172.0,59.0,34.3,13.0,14,76.0,7,6,19.0,5,1.95,16.0,21.0,-5.0,-0.38,-1.06,19.5,18.7,0.8,0.06,-0.27,Matches,12.0,fr FRA,DF,29.0,13.0,975.0,44.0,210.0,463.0,305.0,24.0,975.0,14.0,7.0,50.0,6.0,42.9,637.0,3256.0,1501.0,29.0,23.0,3.0,14.0,4.0,573.0,78.0,Matches,12.0,fr FRA,DF,29.0,13.0,0.0,4.0,2.0,50.0,0.31,0.15,0.0,0.0,17.5,0.0,0.0,0.0,0.2,0.2,0.06,-0.2,-0.2,Matches,12.0,fr FRA,DF,29.0,20.0,14.0,1172.0,13.0,0.0,0.0,0.0,0.0,0.0,0.0,3.0,0.0,0.2,0.2,0.9,1.1,29.0,102.0,78.0,0.0,0.0,0.0,0.0,0.0,0.02,0.07,0.09,0.02,0.09,Matches,Ruben Aguilar,D R,29,134,141,"France,Spain",AS Monaco,6,14,13,7,13,7,9,8,12,12,13,8,13,13,14,14,15,14,13,12,13,16,10,8,14,12,15,15,14,13,14,7,16,14,16,12,14,12,13,10,11,2,4,3,1,1,1,3,3,2,2,2,15,14,6,14,13,15,12,10,1,12,1,20,10,15,1,1,1,13,1,1,1,1,172,71,10,20,10130269,6700,6700,4750,Mediterranean_Hispanic,133,6,1993/4/26,1,0,28013.0,,85046582
828,Jean-Eudes Aholou,Strasbourg,1994,14.0,ci CIV,MF,28.0,14.4,34.0,20.0,10.0,20.0,4.0,12.0,31.0,38.7,19.0,25.0,0.0,25.0,24.0,58.0,15.0,0.0,Matches,14.0,ci CIV,MF,28.0,14.4,28.0,1.94,21.0,1.0,0.0,1.0,2.0,3.0,2.0,0.14,2.0,0.0,0.0,0.0,0.0,0.0,Matches,,,,,,,,,,,,,,,,,,,,,,,,,,,,,,,,,,,,,,,,,,,,,,,,,,,,,,,,14.0,ci CIV,MF,28.0,14.4,4.0,1.0,0.0,39.0,23.0,1.0,5.0,24.0,20.0,0.0,0.0,0.0,91.0,26.0,18.0,59.1,Matches,14.0,ci CIV,MF,28.0,14.4,592.0,576.0,16.0,13.0,3.0,6.0,5.0,1.0,0.0,0.0,0.0,0.0,447.0,0.0,11.0,Matches,14.0,ci CIV,MF,28.0,14.4,447.0,592.0,75.5,7451.0,2109.0,207.0,255.0,81.2,179.0,230.0,77.8,38.0,68.0,55.9,1.0,0.9,1.3,0.1,9.0,53.0,11.0,1.0,50.0,Matches,15,ci CIV,MF,28,30,1300.0,43.0,38.0,14.4,16,67.0,1,14,16.0,5,1.03,17.0,22.0,-5.0,-0.35,-0.22,19.8,19.5,0.3,0.02,0.32,Matches,14.0,ci CIV,MF,28.0,14.4,799.0,26.0,131.0,483.0,194.0,27.0,799.0,34.0,14.0,41.2,14.0,41.2,538.0,2906.0,1220.0,25.0,18.0,9.0,34.0,15.0,477.0,37.0,Matches,14.0,ci CIV,MF,28.0,14.4,3.0,21.0,8.0,38.1,1.45,0.55,0.14,0.38,25.0,0.0,0.0,0.0,1.2,1.2,0.06,1.8,1.8,Matches,14.0,ci CIV,MF,28.0,30.0,16.0,1300.0,14.4,3.0,1.0,4.0,3.0,0.0,0.0,4.0,1.0,1.2,1.2,0.9,2.1,25.0,50.0,37.0,0.21,0.07,0.28,0.21,0.28,0.08,0.07,0.15,0.08,0.15,Matches,Jean-Eudes Aholou,DM/M C,28,130,135,"Ivory Coast,Togo",RC Strasbourg Alsace,6,10,12,8,13,7,13,10,8,13,13,10,14,12,14,13,15,13,12,12,12,14,8,10,12,12,14,16,13,12,14,15,15,13,16,16,11,9,12,7,12,4,1,3,2,2,3,1,3,1,3,2,12,15,7,12,12,13,13,13,1,1,1,1,1,1,20,1,19,1,1,1,1,1,187,80,20,8,3126660,6496,6246,3996,African_Caribbean,130,16,1994/3/20,2,0,18397.0,,13112746
829,Benjamin André,Lille,1990,22.0,fr FRA,MF,31.0,32.4,128.0,74.0,51.0,60.0,17.0,65.0,121.0,53.7,56.0,50.0,8.0,42.0,47.0,175.0,60.0,0.0,Matches,22.0,fr FRA,MF,31.0,32.4,70.0,2.16,62.0,0.0,0.0,3.0,3.0,2.0,6.0,0.19,5.0,0.0,0.0,0.0,1.0,0.0,Matches,,,,,,,,,,,,,,,,,,,,,,,,,,,,,,,,,,,,,,,,,,,,,,,,,,,,,,,,22.0,fr FRA,MF,31.0,32.4,12.0,0.0,0.0,57.0,39.0,1.0,14.0,47.0,74.0,1.0,0.0,0.0,278.0,91.0,61.0,59.9,Matches,22.0,fr FRA,MF,31.0,32.4,2324.0,2262.0,54.0,49.0,8.0,23.0,14.0,5.0,0.0,0.0,0.0,0.0,1942.0,8.0,31.0,Matches,22.0,fr FRA,MF,31.0,32.4,1942.0,2324.0,83.6,35130.0,11527.0,818.0,937.0,87.3,809.0,916.0,88.3,238.0,335.0,71.0,1.0,1.8,2.3,-0.8,21.0,297.0,24.0,0.0,309.0,Matches,25,fr FRA,MF,31,34,2916.0,86.0,85.3,32.4,33,88.0,28,1,23.0,0,1.76,55.0,35.0,20.0,0.62,0.44,58.6,32.6,26.0,0.8,0.41,Matches,22.0,fr FRA,MF,31.0,32.4,2743.0,120.0,626.0,1774.0,363.0,35.0,2743.0,36.0,19.0,52.8,14.0,38.9,2057.0,10561.0,4605.0,41.0,47.0,0.0,38.0,34.0,1892.0,46.0,Matches,22.0,fr FRA,MF,31.0,32.4,1.0,24.0,4.0,16.7,0.74,0.12,0.04,0.25,16.9,0.0,0.0,0.0,1.6,1.6,0.07,-0.6,-0.6,Matches,22.0,fr FRA,MF,31.0,34.0,33.0,2916.0,32.4,1.0,1.0,2.0,1.0,0.0,0.0,12.0,0.0,1.6,1.6,1.8,3.4,41.0,309.0,46.0,0.03,0.03,0.06,0.03,0.06,0.05,0.06,0.11,0.05,0.11,Matches,Benjamin André,DM/M C,31,136,136,France,LOSC Lille,10,12,11,8,14,9,13,13,8,10,13,8,14,14,13,14,15,13,15,13,13,15,10,13,11,12,15,14,14,15,14,11,14,13,15,13,15,13,14,5,16,2,3,3,1,2,2,4,1,4,3,2,9,15,8,16,13,16,12,13,1,1,1,13,1,13,18,1,20,12,1,12,12,1,180,76,8,20,4999447,6800,6550,4500,Northern_European,135,8,1990/8/3,0,0,29918.0,,85028361
830,Mathias Autret,Auxerre,1991,33.0,fr FRA,MFFW,31.0,14.3,22.0,10.0,10.0,10.0,2.0,7.0,16.0,43.8,9.0,14.0,2.0,12.0,12.0,34.0,13.0,0.0,Matches,33.0,fr FRA,MFFW,31.0,14.3,54.0,3.77,35.0,12.0,3.0,3.0,0.0,1.0,7.0,0.49,3.0,2.0,0.0,2.0,0.0,0.0,Matches,,,,,,,,,,,,,,,,,,,,,,,,,,,,,,,,,,,,,,,,,,,,,,,,,,,,,,,,33.0,fr FRA,MFFW,31.0,14.3,0.0,0.0,0.0,7.0,4.0,2.0,65.0,12.0,10.0,0.0,0.0,0.0,73.0,5.0,13.0,27.8,Matches,33.0,fr FRA,MFFW,31.0,14.3,597.0,530.0,64.0,20.0,4.0,18.0,65.0,10.0,24.0,13.0,7.0,0.0,451.0,3.0,15.0,Matches,33.0,fr FRA,MFFW,31.0,14.3,451.0,597.0,75.5,9287.0,2835.0,172.0,204.0,84.3,175.0,219.0,79.9,92.0,140.0,65.7,2.0,2.0,2.0,0.0,27.0,61.0,16.0,4.0,77.0,Matches,37,fr FRA,MFFW,31,23,1290.0,56.0,37.7,14.3,16,72.0,0,7,19.0,12,0.83,15.0,26.0,-11.0,-0.77,-0.05,15.1,20.5,-5.4,-0.37,0.07,Matches,33.0,fr FRA,MFFW,31.0,14.3,722.0,24.0,123.0,366.0,239.0,24.0,721.0,25.0,10.0,40.0,14.0,56.0,512.0,2801.0,950.0,20.0,12.0,3.0,18.0,4.0,471.0,58.0,Matches,33.0,fr FRA,MFFW,31.0,14.3,2.0,23.0,11.0,47.8,1.6,0.77,0.04,0.09,25.4,1.0,1.0,1.0,2.5,1.7,0.07,-0.5,-0.7,Matches,33.0,fr FRA,MFFW,31.0,23.0,16.0,1290.0,14.3,2.0,2.0,4.0,1.0,1.0,1.0,0.0,0.0,2.5,1.7,2.0,3.7,20.0,77.0,58.0,0.14,0.14,0.28,0.07,0.21,0.17,0.14,0.31,0.12,0.26,Matches,Mathias Autret,M/AM LC,31,120,126,France,AJ Auxerre,14,12,13,10,14,12,8,14,5,3,13,13,4,14,7,12,9,14,12,14,13,13,14,12,13,6,13,12,13,14,12,8,14,13,13,10,12,7,15,7,8,2,3,1,2,1,3,2,3,1,3,3,16,14,5,12,8,12,13,12,1,1,1,1,1,1,1,14,17,12,17,20,14,10,179,71,9,20,930142,5999,5999,3599,Northern_European,121,5,1991/3/1,0,0,6898.0,,85031797
831,Leonardo Balerdi,Marseille,1999,43.0,ar ARG,DF,23.0,29.3,57.0,37.0,43.0,12.0,2.0,32.0,45.0,71.1,13.0,48.0,29.0,19.0,63.0,120.0,91.0,1.0,Matches,43.0,ar ARG,DF,23.0,29.3,13.0,0.44,9.0,0.0,1.0,3.0,0.0,0.0,2.0,0.07,1.0,0.0,0.0,1.0,0.0,0.0,Matches,,,,,,,,,,,,,,,,,,,,,,,,,,,,,,,,,,,,,,,,,,,,,,,,,,,,,,,,43.0,ar ARG,DF,23.0,29.3,9.0,1.0,0.0,53.0,21.0,0.0,6.0,63.0,37.0,0.0,1.0,1.0,204.0,70.0,41.0,63.1,Matches,43.0,ar ARG,DF,23.0,29.3,1656.0,1607.0,48.0,36.0,2.0,8.0,6.0,6.0,0.0,0.0,0.0,0.0,1389.0,1.0,16.0,Matches,43.0,ar ARG,DF,23.0,29.3,1389.0,1656.0,83.9,27891.0,8035.0,393.0,449.0,87.5,771.0,872.0,88.4,189.0,262.0,72.1,1.0,0.2,0.4,0.8,5.0,105.0,3.0,1.0,97.0,Matches,48,ar ARG,DF,23,35,2639.0,75.0,77.2,29.3,30,82.0,24,5,36.0,1,1.89,51.0,31.0,20.0,0.68,-0.12,48.4,33.6,14.8,0.51,-0.42,Matches,43.0,ar ARG,DF,23.0,29.3,1997.0,223.0,869.0,1027.0,113.0,16.0,1997.0,14.0,9.0,64.3,4.0,28.6,1413.0,8306.0,4291.0,15.0,19.0,0.0,23.0,3.0,1232.0,19.0,Matches,43.0,ar ARG,DF,23.0,29.3,0.0,11.0,0.0,0.0,0.38,0.0,0.0,,10.2,0.0,0.0,0.0,1.3,1.3,0.12,-1.3,-1.3,Matches,43.0,ar ARG,DF,23.0,35.0,30.0,2639.0,29.3,0.0,1.0,1.0,0.0,0.0,0.0,9.0,1.0,1.3,1.3,0.2,1.4,15.0,97.0,19.0,0.0,0.03,0.03,0.0,0.03,0.04,0.01,0.05,0.04,0.05,Matches,Leonardo Balerdi,D C,23,133,147,"Argentina,Italy",Olympique de Marseille,4,6,7,6,13,4,14,7,5,14,13,8,14,12,13,14,12,15,13,9,14,14,6,9,6,15,14,12,12,12,12,15,13,12,12,13,13,8,16,7,8,1,3,3,2,2,1,1,1,1,1,1,11,15,8,9,16,12,12,14,1,8,20,10,6,8,12,1,1,1,1,1,1,1,187,76,14,20,9944302,6649,6649,4749,Mediterranean_Hispanic,133,7,1999/1/26,2,0,28747.0,,14196664
832,Folarin Balogun,Reims,2001,44.0,us USA,FW,21.0,33.3,9.0,5.0,1.0,5.0,3.0,2.0,20.0,10.0,18.0,20.0,1.0,19.0,3.0,12.0,15.0,0.0,Matches,44.0,us USA,FW,21.0,33.3,80.0,2.4,50.0,1.0,11.0,11.0,6.0,1.0,10.0,0.3,4.0,0.0,2.0,2.0,2.0,0.0,Matches,,,,,,,,,,,,,,,,,,,,,,,,,,,,,,,,,,,,,,,,,,,,,,,,,,,,,,,,44.0,us USA,FW,21.0,33.3,5.0,0.0,0.0,38.0,54.0,29.0,23.0,3.0,5.0,3.0,0.0,0.0,86.0,14.0,57.0,19.7,Matches,44.0,us USA,FW,21.0,33.3,582.0,520.0,55.0,1.0,4.0,3.0,23.0,3.0,0.0,0.0,0.0,0.0,408.0,7.0,21.0,Matches,44.0,us USA,FW,21.0,33.3,408.0,582.0,70.1,5755.0,1189.0,235.0,303.0,77.6,127.0,180.0,70.6,17.0,29.0,58.6,2.0,3.8,3.3,-1.8,36.0,28.0,19.0,1.0,55.0,Matches,49,us USA,FW,21,37,2999.0,81.0,87.7,33.3,34,86.0,19,3,29.0,0,1.35,42.0,37.0,5.0,0.15,1.22,56.9,45.2,11.7,0.35,0.96,Matches,44.0,us USA,FW,21.0,33.3,970.0,16.0,72.0,385.0,525.0,198.0,963.0,87.0,35.0,40.2,44.0,50.6,742.0,4561.0,1697.0,56.0,27.0,45.0,94.0,74.0,743.0,283.0,Matches,44.0,us USA,FW,21.0,33.3,21.0,121.0,50.0,41.3,3.63,1.5,0.12,0.3,15.2,2.0,6.0,7.0,26.6,21.0,0.18,-5.6,-6.0,Matches,44.0,us USA,FW,21.0,37.0,34.0,2999.0,33.3,21.0,2.0,23.0,15.0,6.0,7.0,5.0,0.0,26.6,21.0,3.8,24.8,56.0,55.0,283.0,0.63,0.06,0.69,0.45,0.51,0.8,0.11,0.91,0.63,0.74,Matches,Folarin Balogun,S,21,124,149,"England,Nigeria,United States",Arsenal,5,9,13,14,13,7,9,10,2,5,10,11,5,13,10,10,12,12,9,9,12,13,13,3,14,5,12,12,16,15,12,11,12,15,13,10,13,7,15,7,8,2,1,4,3,1,3,3,2,2,2,1,13,14,10,8,12,13,14,14,1,1,1,1,1,1,1,1,1,1,14,14,14,20,178,0,14,20,15658884,6250,6250,4251,African_Caribbean,121,17,2001/7/3,0,0,34798.0,Stade de Reims,28116305
833,Jonathan Bamba,Lille,1996,46.0,ci CIV,FW,26.0,30.9,37.0,17.0,12.0,14.0,11.0,14.0,45.0,31.1,31.0,36.0,1.0,35.0,22.0,59.0,14.0,0.0,Matches,46.0,ci CIV,FW,26.0,30.9,106.0,3.43,89.0,2.0,5.0,8.0,2.0,0.0,14.0,0.45,11.0,0.0,0.0,3.0,0.0,0.0,Matches,,,,,,,,,,,,,,,,,,,,,,,,,,,,,,,,,,,,,,,,,,,,,,,,,,,,,,,,46.0,ci CIV,FW,26.0,30.9,6.0,0.0,0.0,33.0,59.0,12.0,79.0,22.0,17.0,0.0,1.0,0.0,200.0,20.0,35.0,36.4,Matches,46.0,ci CIV,FW,26.0,30.9,1405.0,1334.0,67.0,18.0,9.0,5.0,79.0,40.0,9.0,2.0,2.0,0.0,1125.0,4.0,56.0,Matches,46.0,ci CIV,FW,26.0,30.9,1125.0,1405.0,80.1,15835.0,4358.0,655.0,755.0,86.8,336.0,407.0,82.6,53.0,95.0,55.8,7.0,6.5,6.4,0.5,46.0,93.0,59.0,9.0,146.0,Matches,51,ci CIV,FW,26,34,2783.0,82.0,81.4,30.9,32,86.0,23,2,24.0,0,1.76,54.0,41.0,13.0,0.42,-0.71,54.6,34.6,20.0,0.65,-0.51,Matches,46.0,ci CIV,FW,26.0,30.9,1803.0,22.0,170.0,799.0,859.0,140.0,1803.0,99.0,35.0,35.4,54.0,54.5,1438.0,8683.0,3476.0,111.0,84.0,29.0,66.0,61.0,1354.0,345.0,Matches,46.0,ci CIV,FW,26.0,30.9,6.0,71.0,28.0,39.4,2.3,0.91,0.08,0.21,15.5,0.0,0.0,0.0,8.2,8.2,0.12,-2.2,-2.2,Matches,46.0,ci CIV,FW,26.0,34.0,32.0,2783.0,30.9,6.0,7.0,13.0,6.0,0.0,0.0,6.0,0.0,8.2,8.2,6.5,14.7,111.0,146.0,345.0,0.19,0.23,0.42,0.19,0.42,0.27,0.21,0.47,0.27,0.47,Matches,Jonathan Bamba,AM RL,26,143,147,"France,Ivory Coast",LOSC Lille,11,12,14,13,13,8,5,11,7,7,11,10,7,14,12,14,11,13,14,10,13,14,12,6,15,7,12,13,16,15,14,6,17,16,14,13,13,6,11,7,12,2,1,3,3,2,1,3,2,1,1,3,8,15,3,13,10,13,12,12,1,1,1,1,1,1,1,12,1,14,20,10,19,15,175,72,8,20,16059908,7147,6547,4497,African_Caribbean,136,16,1996/3/26,0,0,27615.0,,29114989
834,Bradley Barcola,Lyon,2002,47.0,fr FRA,FWMF,19.0,16.0,25.0,16.0,8.0,10.0,7.0,8.0,39.0,20.5,31.0,29.0,0.0,29.0,19.0,44.0,10.0,0.0,Matches,47.0,fr FRA,FWMF,19.0,16.0,39.0,2.44,32.0,0.0,4.0,2.0,0.0,1.0,10.0,0.63,10.0,0.0,0.0,0.0,0.0,0.0,Matches,,,,,,,,,,,,,,,,,,,,,,,,,,,,,,,,,,,,,,,,,,,,,,,,,,,,,,,,47.0,fr FRA,FWMF,19.0,16.0,3.0,0.0,0.0,24.0,7.0,7.0,21.0,19.0,16.0,0.0,0.0,0.0,60.0,16.0,32.0,33.3,Matches,47.0,fr FRA,FWMF,19.0,16.0,466.0,460.0,3.0,0.0,0.0,1.0,21.0,3.0,0.0,0.0,0.0,0.0,324.0,3.0,17.0,Matches,47.0,fr FRA,FWMF,19.0,16.0,324.0,466.0,69.5,4152.0,1140.0,210.0,276.0,76.1,85.0,124.0,68.5,8.0,17.0,47.1,8.0,3.9,4.2,4.1,25.0,21.0,20.0,4.0,39.0,Matches,52,fr FRA,FWMF,19,26,1440.0,55.0,42.1,16.0,15,83.0,8,11,18.0,5,1.69,34.0,18.0,16.0,1.0,0.91,25.2,24.2,1.0,0.06,-0.32,Matches,47.0,fr FRA,FWMF,19.0,16.0,666.0,10.0,81.0,243.0,355.0,108.0,666.0,80.0,40.0,50.0,38.0,47.5,481.0,3202.0,1403.0,51.0,30.0,30.0,36.0,8.0,444.0,156.0,Matches,47.0,fr FRA,FWMF,19.0,16.0,5.0,27.0,13.0,48.1,1.69,0.81,0.19,0.38,13.6,0.0,0.0,0.0,3.4,3.4,0.13,1.6,1.6,Matches,47.0,fr FRA,FWMF,19.0,26.0,15.0,1440.0,16.0,5.0,8.0,13.0,5.0,0.0,0.0,3.0,0.0,3.4,3.4,3.9,7.4,51.0,39.0,156.0,0.31,0.5,0.81,0.31,0.81,0.22,0.25,0.46,0.22,0.46,Matches,Bradley Barcola,AM/S RL,19,110,-8,"France,Togo",Olympique Lyonnais,7,9,12,12,13,7,10,8,4,4,11,8,4,12,10,12,10,11,10,11,9,13,12,6,14,6,13,14,15,13,7,11,14,15,10,7,13,12,13,7,12,1,2,1,2,1,1,4,2,3,3,2,11,10,8,9,13,11,13,19,1,1,1,1,1,1,1,1,1,1,20,1,16,19,182,63,8,20,30465067,5896,5496,1700,African_Caribbean,102,13,2002/9/2,0,0,7019.0,,49056282
835,Melvin Bard,Nice,2000,48.0,fr FRA,DF,21.0,27.3,96.0,60.0,61.0,29.0,6.0,59.0,89.0,66.3,30.0,35.0,4.0,31.0,64.0,160.0,40.0,1.0,Matches,48.0,fr FRA,DF,21.0,27.3,30.0,1.1,27.0,2.0,1.0,0.0,0.0,0.0,0.0,0.0,0.0,0.0,0.0,0.0,0.0,0.0,Matches,,,,,,,,,,,,,,,,,,,,,,,,,,,,,,,,,,,,,,,,,,,,,,,,,,,,,,,,48.0,fr FRA,DF,21.0,27.3,6.0,0.0,0.0,30.0,20.0,2.0,70.0,64.0,60.0,0.0,1.0,0.0,180.0,33.0,23.0,58.9,Matches,48.0,fr FRA,DF,21.0,27.3,1505.0,1278.0,224.0,22.0,1.0,3.0,70.0,202.0,0.0,0.0,0.0,0.0,1201.0,3.0,46.0,Matches,48.0,fr FRA,DF,21.0,27.3,1201.0,1505.0,79.8,18633.0,6326.0,652.0,739.0,88.2,447.0,545.0,82.0,66.0,128.0,51.6,0.0,0.9,1.3,-0.9,10.0,70.0,21.0,7.0,96.0,Matches,53,fr FRA,DF,21,33,2456.0,74.0,71.8,27.3,28,83.0,19,5,28.0,2,1.42,31.0,32.0,-1.0,-0.04,-1.16,39.5,35.8,3.7,0.13,-0.7,Matches,48.0,fr FRA,DF,21.0,27.3,1820.0,93.0,603.0,837.0,409.0,26.0,1820.0,54.0,23.0,42.6,25.0,46.3,1191.0,6786.0,3208.0,61.0,60.0,8.0,23.0,16.0,1050.0,126.0,Matches,48.0,fr FRA,DF,21.0,27.3,0.0,7.0,2.0,28.6,0.26,0.07,0.0,0.0,15.4,0.0,0.0,0.0,0.5,0.5,0.07,-0.5,-0.5,Matches,48.0,fr FRA,DF,21.0,33.0,28.0,2456.0,27.3,0.0,0.0,0.0,0.0,0.0,0.0,6.0,0.0,0.5,0.5,0.9,1.4,61.0,96.0,126.0,0.0,0.0,0.0,0.0,0.0,0.02,0.03,0.05,0.02,0.05,Matches,Melvin Bard,D/WB L,21,122,147,France,OGC Nice,6,15,13,6,13,6,9,8,10,14,14,5,13,14,15,13,15,11,9,13,12,15,13,11,12,12,15,15,14,12,12,8,15,14,11,11,14,14,13,9,18,3,2,3,4,3,4,1,3,3,3,3,13,14,1,13,13,14,14,11,1,20,13,1,20,1,1,15,1,1,12,1,1,1,173,65,20,8,8454999,6100,6100,3252,Northern_European,117,0,2000/11/6,0,0,15341.0,,49041157
836,Ross Barkley,Nice,1993,49.0,eng ENG,MFFW,28.0,10.7,16.0,9.0,7.0,4.0,5.0,7.0,13.0,53.8,6.0,7.0,2.0,5.0,8.0,24.0,6.0,0.0,Matches,49.0,eng ENG,MFFW,28.0,10.7,51.0,4.92,30.0,13.0,6.0,2.0,0.0,0.0,5.0,0.48,2.0,1.0,2.0,0.0,0.0,0.0,Matches,,,,,,,,,,,,,,,,,,,,,,,,,,,,,,,,,,,,,,,,,,,,,,,,,,,,,,,,49.0,eng ENG,MFFW,28.0,10.7,1.0,0.0,0.0,14.0,15.0,1.0,46.0,8.0,9.0,0.0,0.0,0.0,58.0,4.0,12.0,25.0,Matches,49.0,eng ENG,MFFW,28.0,10.7,497.0,441.0,55.0,13.0,1.0,2.0,46.0,4.0,38.0,19.0,14.0,0.0,391.0,1.0,11.0,Matches,49.0,eng ENG,MFFW,28.0,10.7,391.0,497.0,78.7,6687.0,1994.0,185.0,215.0,86.0,148.0,172.0,86.0,43.0,79.0,54.4,2.0,2.4,1.9,-0.4,31.0,36.0,8.0,0.0,48.0,Matches,54,eng ENG,MFFW,28,27,960.0,36.0,28.1,10.7,9,73.0,3,18,17.0,4,1.48,12.0,14.0,-2.0,-0.19,-0.66,16.1,15.0,1.1,0.11,-0.31,Matches,49.0,eng ENG,MFFW,28.0,10.7,606.0,10.0,91.0,296.0,228.0,26.0,606.0,21.0,12.0,57.1,8.0,38.1,457.0,2573.0,1229.0,30.0,30.0,7.0,12.0,24.0,434.0,46.0,Matches,49.0,eng ENG,MFFW,28.0,10.7,4.0,38.0,17.0,44.7,3.56,1.59,0.11,0.24,19.7,3.0,0.0,0.0,4.3,4.3,0.11,-0.3,-0.3,Matches,49.0,eng ENG,MFFW,28.0,27.0,9.0,960.0,10.7,4.0,2.0,6.0,4.0,0.0,0.0,1.0,0.0,4.3,4.3,2.4,6.7,30.0,48.0,46.0,0.37,0.19,0.56,0.37,0.56,0.42,0.23,0.65,0.42,0.65,Matches,Ross Barkley,M/AM C,28,141,159,"England,Nigeria",OGC Nice,11,11,16,12,16,14,12,14,9,6,15,12,8,16,8,14,11,13,11,14,9,12,15,11,11,11,11,11,15,11,14,12,12,14,12,16,8,6,10,12,8,1,1,2,1,2,3,3,3,2,3,3,5,14,12,15,13,14,12,13,1,1,1,1,1,1,12,1,20,1,13,20,13,1,189,76,15,20,11700351,6900,6900,6000,Northern_European,135,2,1993/12/5,33,6,29352.0,,28058224
837,Youcef Belaïli,Ajaccio,1992,56.0,dz ALG,MFFW,30.0,12.8,18.0,10.0,3.0,9.0,6.0,8.0,20.0,40.0,12.0,10.0,1.0,9.0,5.0,23.0,4.0,0.0,Matches,56.0,dz ALG,MFFW,30.0,12.8,47.0,3.68,24.0,9.0,4.0,4.0,6.0,0.0,10.0,0.78,5.0,0.0,2.0,1.0,2.0,0.0,Matches,,,,,,,,,,,,,,,,,,,,,,,,,,,,,,,,,,,,,,,,,,,,,,,,,,,,,,,,56.0,dz ALG,MFFW,30.0,12.8,2.0,0.0,0.0,25.0,24.0,4.0,42.0,5.0,10.0,2.0,0.0,0.0,75.0,7.0,9.0,43.8,Matches,56.0,dz ALG,MFFW,30.0,12.8,458.0,397.0,56.0,22.0,5.0,2.0,42.0,12.0,15.0,4.0,6.0,0.0,328.0,5.0,13.0,Matches,56.0,dz ALG,MFFW,30.0,12.8,328.0,458.0,71.6,5637.0,2159.0,162.0,201.0,80.6,101.0,137.0,73.7,44.0,74.0,59.5,3.0,3.5,3.3,-0.5,21.0,35.0,22.0,6.0,55.0,Matches,65,dz ALG,MFFW,30,17,1150.0,68.0,33.6,12.8,15,74.0,2,2,21.0,0,0.88,12.0,23.0,-11.0,-0.86,0.73,17.3,17.0,0.3,0.02,0.74,Matches,56.0,dz ALG,MFFW,30.0,12.8,631.0,6.0,66.0,320.0,257.0,51.0,625.0,64.0,29.0,45.3,24.0,37.5,476.0,3115.0,1319.0,32.0,24.0,18.0,42.0,27.0,431.0,68.0,Matches,56.0,dz ALG,MFFW,30.0,12.8,6.0,27.0,9.0,33.3,2.11,0.7,0.04,0.11,24.8,4.0,5.0,6.0,6.2,1.8,0.07,-0.2,-0.8,Matches,56.0,dz ALG,MFFW,30.0,17.0,15.0,1150.0,12.8,6.0,3.0,9.0,1.0,5.0,6.0,2.0,0.0,6.2,1.8,3.5,5.3,32.0,55.0,68.0,0.47,0.23,0.7,0.08,0.31,0.48,0.27,0.76,0.14,0.42,Matches,Youcef Belaïli,M/AM L,30,136,145,Algeria,AC Ajaccio,11,13,15,13,15,12,8,14,4,7,14,12,7,15,13,14,11,12,12,13,14,10,12,10,13,11,12,12,14,14,12,9,12,14,13,11,12,10,14,9,12,1,3,1,3,1,3,3,1,2,3,2,18,11,10,12,11,11,11,9,1,1,1,1,1,1,1,17,1,1,20,14,12,14,178,75,10,20,6374837,6800,7000,4750,North_African__Middle_Eastern,136,6,1992/3/14,43,9,22595.0,,12038997
838,Haris Belkebla,Brest,1994,58.0,dz ALG,MF,28.0,29.5,80.0,48.0,35.0,40.0,5.0,44.0,85.0,51.8,41.0,32.0,6.0,26.0,52.0,132.0,21.0,3.0,Matches,58.0,dz ALG,MF,28.0,29.5,39.0,1.32,33.0,0.0,0.0,0.0,4.0,2.0,2.0,0.07,1.0,0.0,0.0,0.0,1.0,0.0,Matches,,,,,,,,,,,,,,,,,,,,,,,,,,,,,,,,,,,,,,,,,,,,,,,,,,,,,,,,58.0,dz ALG,MF,28.0,29.5,3.0,0.0,0.0,33.0,50.0,0.0,11.0,52.0,48.0,0.0,0.0,0.0,197.0,20.0,30.0,40.0,Matches,58.0,dz ALG,MF,28.0,29.5,1222.0,1188.0,30.0,20.0,1.0,11.0,11.0,3.0,0.0,0.0,0.0,0.0,1033.0,4.0,28.0,Matches,58.0,dz ALG,MF,28.0,29.5,1033.0,1222.0,84.5,18238.0,4759.0,430.0,484.0,88.8,471.0,524.0,89.9,100.0,146.0,68.5,0.0,0.6,0.8,-0.6,10.0,107.0,9.0,1.0,129.0,Matches,67,dz ALG,MF,28,38,2656.0,70.0,77.7,29.5,30,84.0,20,8,18.0,0,1.16,31.0,43.0,-12.0,-0.41,-0.64,30.2,45.0,-14.8,-0.5,-0.75,Matches,58.0,dz ALG,MF,28.0,29.5,1524.0,58.0,353.0,979.0,214.0,15.0,1523.0,34.0,11.0,32.4,15.0,44.1,1097.0,5725.0,2432.0,19.0,25.0,4.0,37.0,27.0,946.0,37.0,Matches,58.0,dz ALG,MF,28.0,29.5,2.0,9.0,2.0,22.2,0.3,0.07,0.11,0.5,25.5,0.0,1.0,1.0,1.3,0.5,0.05,0.7,0.5,Matches,58.0,dz ALG,MF,28.0,38.0,30.0,2656.0,29.5,2.0,0.0,2.0,1.0,1.0,1.0,3.0,0.0,1.3,0.5,0.6,1.1,19.0,129.0,37.0,0.07,0.0,0.07,0.03,0.03,0.04,0.02,0.06,0.02,0.04,Matches,Haris Belkebla,DM/M C,28,126,127,"Algeria,France",Stade Brestois 29,10,10,12,10,14,9,8,10,7,11,14,9,14,13,15,14,15,13,14,13,13,14,12,13,12,12,14,16,12,11,15,8,15,11,17,11,13,13,13,6,13,1,2,3,1,3,2,3,1,2,1,2,9,14,7,12,9,12,10,8,1,1,1,1,1,1,19,1,20,1,1,1,1,1,177,68,7,20,2567265,6291,6291,3791,North_African__Middle_Eastern,126,11,1994/1/28,10,0,6898.0,,85099581
839,Jean-Ricner Bellegarde,Strasbourg,1998,59.0,fr FRA,MFFW,24.0,26.9,47.0,25.0,15.0,21.0,11.0,11.0,25.0,44.0,14.0,26.0,3.0,23.0,26.0,73.0,22.0,0.0,Matches,59.0,fr FRA,MFFW,24.0,26.9,102.0,3.79,65.0,22.0,4.0,1.0,10.0,0.0,13.0,0.48,8.0,1.0,0.0,1.0,3.0,0.0,Matches,,,,,,,,,,,,,,,,,,,,,,,,,,,,,,,,,,,,,,,,,,,,,,,,,,,,,,,,59.0,fr FRA,MFFW,24.0,26.9,5.0,0.0,0.0,36.0,73.0,1.0,123.0,26.0,25.0,3.0,1.0,0.0,157.0,20.0,30.0,40.0,Matches,59.0,fr FRA,MFFW,24.0,26.9,1242.0,1114.0,122.0,33.0,6.0,7.0,123.0,23.0,61.0,18.0,35.0,0.0,952.0,6.0,21.0,Matches,59.0,fr FRA,MFFW,24.0,26.9,952.0,1242.0,76.7,16743.0,5003.0,423.0,489.0,86.5,396.0,483.0,82.0,105.0,209.0,50.2,6.0,5.2,5.8,0.8,57.0,93.0,49.0,18.0,153.0,Matches,69,fr FRA,MFFW,24,30,2419.0,81.0,70.7,26.9,29,82.0,18,1,33.0,0,1.07,37.0,45.0,-8.0,-0.3,-0.3,33.5,38.7,-5.2,-0.19,-0.05,Matches,59.0,fr FRA,MFFW,24.0,26.9,1589.0,30.0,219.0,833.0,569.0,45.0,1589.0,111.0,57.0,51.4,32.0,28.8,1129.0,8275.0,4230.0,104.0,97.0,16.0,64.0,44.0,1035.0,110.0,Matches,59.0,fr FRA,MFFW,24.0,26.9,2.0,38.0,13.0,34.2,1.41,0.48,0.05,0.15,22.2,11.0,0.0,0.0,2.6,2.6,0.07,-0.6,-0.6,Matches,59.0,fr FRA,MFFW,24.0,30.0,29.0,2419.0,26.9,2.0,6.0,8.0,2.0,0.0,0.0,5.0,0.0,2.6,2.6,5.2,7.8,104.0,153.0,110.0,0.07,0.22,0.3,0.07,0.3,0.1,0.19,0.29,0.1,0.29,Matches,Jean-Ricner Bellegarde,M/AM RC,24,130,141,"France,Haiti",RC Strasbourg Alsace,9,12,15,9,14,10,8,12,6,8,14,12,9,15,10,13,11,12,11,11,12,14,12,7,12,8,13,14,15,14,12,7,13,15,14,13,11,5,6,11,12,1,3,3,2,3,1,3,2,2,2,2,18,13,5,12,11,12,11,20,1,1,1,1,1,1,10,1,20,1,1,17,16,1,170,66,8,20,4097280,6488,6488,3988,African_Caribbean,122,17,1998/6/27,0,0,15042.0,,48036558
840,Eliesse Ben Seghir,Monaco,2005,61.0,ma MAR,FWMF,17.0,11.7,18.0,10.0,4.0,12.0,2.0,4.0,12.0,33.3,8.0,18.0,1.0,17.0,4.0,22.0,1.0,0.0,Matches,61.0,ma MAR,FWMF,17.0,11.7,29.0,2.48,23.0,0.0,2.0,1.0,3.0,0.0,2.0,0.17,2.0,0.0,0.0,0.0,0.0,0.0,Matches,,,,,,,,,,,,,,,,,,,,,,,,,,,,,,,,,,,,,,,,,,,,,,,,,,,,,,,,61.0,ma MAR,FWMF,17.0,11.7,1.0,0.0,0.0,17.0,34.0,3.0,7.0,4.0,10.0,0.0,0.0,0.0,49.0,9.0,16.0,36.0,Matches,61.0,ma MAR,FWMF,17.0,11.7,436.0,417.0,19.0,1.0,5.0,3.0,7.0,2.0,3.0,2.0,1.0,0.0,342.0,0.0,13.0,Matches,61.0,ma MAR,FWMF,17.0,11.7,342.0,436.0,78.4,4983.0,1280.0,181.0,224.0,80.8,123.0,145.0,84.8,16.0,26.0,61.5,1.0,1.2,1.1,-0.2,14.0,30.0,21.0,0.0,55.0,Matches,72,ma MAR,FWMF,17,19,1052.0,55.0,30.8,11.7,13,67.0,0,6,30.0,2,1.79,21.0,18.0,3.0,0.26,-0.09,16.6,12.3,4.3,0.37,0.2,Matches,61.0,ma MAR,FWMF,17.0,11.7,583.0,2.0,38.0,284.0,272.0,40.0,583.0,36.0,14.0,38.9,14.0,38.9,459.0,2968.0,1211.0,31.0,28.0,8.0,39.0,22.0,440.0,93.0,Matches,61.0,ma MAR,FWMF,17.0,11.7,4.0,21.0,8.0,38.1,1.8,0.68,0.19,0.5,18.6,0.0,0.0,0.0,1.9,1.9,0.09,2.1,2.1,Matches,61.0,ma MAR,FWMF,17.0,19.0,13.0,1052.0,11.7,4.0,1.0,5.0,4.0,0.0,0.0,1.0,0.0,1.9,1.9,1.2,3.2,31.0,55.0,93.0,0.34,0.09,0.43,0.34,0.43,0.17,0.11,0.27,0.17,0.27,Matches,Eliesse Ben Seghir,M/AM C,17,90,-8,"France,Morocco",AS Monaco,8,6,12,10,13,7,5,10,4,6,14,7,10,13,11,4,10,10,7,13,12,5,10,9,11,6,8,8,14,13,9,4,12,14,10,7,12,10,19,10,15,1,2,1,1,2,1,2,2,1,2,1,10,9,4,12,10,11,13,17,1,1,1,1,1,1,1,1,17,1,1,20,1,1,173,0,8,20,14849999,4500,4500,1150,North_African__Middle_Eastern,92,7,2005/2/16,0,0,645.0,,2000104892
841,Wissam Ben Yedder,Monaco,1990,63.0,fr FRA,FW,31.0,23.5,16.0,9.0,2.0,5.0,9.0,4.0,13.0,30.8,9.0,15.0,0.0,15.0,4.0,20.0,0.0,0.0,Matches,63.0,fr FRA,FW,31.0,23.5,56.0,2.38,36.0,1.0,5.0,7.0,5.0,2.0,13.0,0.55,8.0,0.0,0.0,3.0,1.0,1.0,Matches,,,,,,,,,,,,,,,,,,,,,,,,,,,,,,,,,,,,,,,,,,,,,,,,,,,,,,,,63.0,fr FRA,FW,31.0,23.5,4.0,0.0,0.0,18.0,21.0,22.0,17.0,4.0,9.0,2.0,0.0,0.0,58.0,15.0,27.0,35.7,Matches,63.0,fr FRA,FW,31.0,23.5,605.0,548.0,53.0,1.0,1.0,1.0,17.0,2.0,0.0,0.0,0.0,0.0,449.0,4.0,20.0,Matches,63.0,fr FRA,FW,31.0,23.5,449.0,605.0,74.2,6103.0,1335.0,248.0,308.0,80.5,142.0,184.0,77.2,16.0,36.0,44.4,6.0,3.8,3.7,2.2,25.0,32.0,30.0,0.0,75.0,Matches,74,fr FRA,FW,31,32,2114.0,66.0,61.8,23.5,28,72.0,9,4,23.0,4,1.53,48.0,38.0,10.0,0.43,0.29,38.5,33.4,5.1,0.22,-0.05,Matches,63.0,fr FRA,FW,31.0,23.5,799.0,0.0,22.0,325.0,458.0,151.0,793.0,51.0,23.0,45.1,25.0,49.0,610.0,3251.0,1304.0,48.0,32.0,26.0,35.0,32.0,599.0,198.0,Matches,63.0,fr FRA,FW,31.0,23.5,19.0,66.0,36.0,54.5,2.81,1.53,0.21,0.39,14.2,3.0,5.0,6.0,17.4,12.7,0.19,1.6,1.3,Matches,63.0,fr FRA,FW,31.0,32.0,28.0,2114.0,23.5,19.0,6.0,25.0,14.0,5.0,6.0,4.0,0.0,17.4,12.7,3.8,16.5,48.0,75.0,198.0,0.81,0.26,1.06,0.6,0.85,0.74,0.16,0.9,0.54,0.7,Matches,Wissam Ben Yedder,S,31,151,154,"France,Tunisia",AS Monaco,10,12,16,16,16,13,11,12,3,4,14,17,4,17,9,14,10,16,13,14,14,15,15,14,17,8,12,12,14,16,15,8,14,14,13,10,15,7,16,7,12,3,1,2,2,1,3,4,3,3,1,2,14,16,8,13,14,15,16,15,1,1,1,1,1,1,1,1,1,1,10,14,12,20,170,68,14,20,347975206,7550,7550,6800,North_African__Middle_Eastern,151,11,1990/8/12,19,3,149589.0,,85071175
842,Nabil Bentaleb,Angers,1994,64.0,dz ALG,MF,27.0,27.7,74.0,40.0,31.0,35.0,8.0,36.0,61.0,59.0,25.0,33.0,11.0,22.0,44.0,118.0,29.0,3.0,Matches,64.0,dz ALG,MF,27.0,27.7,72.0,2.61,42.0,18.0,6.0,1.0,3.0,2.0,8.0,0.29,6.0,2.0,0.0,0.0,0.0,0.0,Matches,,,,,,,,,,,,,,,,,,,,,,,,,,,,,,,,,,,,,,,,,,,,,,,,,,,,,,,,64.0,dz ALG,MF,27.0,27.7,7.0,1.0,1.0,39.0,54.0,0.0,96.0,44.0,40.0,0.0,0.0,0.0,231.0,29.0,18.0,61.7,Matches,64.0,dz ALG,MF,27.0,27.7,1853.0,1660.0,185.0,123.0,7.0,20.0,96.0,1.0,61.0,49.0,11.0,0.0,1512.0,8.0,22.0,Matches,64.0,dz ALG,MF,27.0,27.7,1512.0,1853.0,81.6,29115.0,9442.0,556.0,641.0,86.7,724.0,825.0,87.8,195.0,315.0,61.9,4.0,2.3,3.6,1.7,33.0,172.0,15.0,0.0,176.0,Matches,75,dz ALG,MF,27,30,2489.0,83.0,72.8,27.7,29,85.0,23,1,15.0,0,0.43,24.0,64.0,-40.0,-1.45,-0.67,26.8,47.4,-20.5,-0.74,-0.72,Matches,64.0,dz ALG,MF,27.0,27.7,2186.0,70.0,511.0,1366.0,358.0,15.0,2184.0,111.0,63.0,56.8,31.0,27.9,1628.0,9116.0,4191.0,46.0,62.0,6.0,45.0,37.0,1471.0,28.0,Matches,64.0,dz ALG,MF,27.0,27.7,4.0,39.0,13.0,33.3,1.41,0.47,0.05,0.15,27.5,8.0,2.0,2.0,3.2,1.6,0.04,0.8,0.4,Matches,64.0,dz ALG,MF,27.0,30.0,29.0,2489.0,27.7,4.0,4.0,8.0,2.0,2.0,2.0,7.0,1.0,3.2,1.6,2.3,3.9,46.0,176.0,28.0,0.14,0.14,0.29,0.07,0.22,0.11,0.08,0.2,0.06,0.14,Matches,Nabil Bentaleb,DM/M C,27,127,136,"Algeria,France",Angers SCO,9,11,13,10,14,10,8,13,9,10,14,17,12,15,14,13,15,13,11,13,11,12,12,10,12,11,10,14,12,12,15,14,14,11,14,12,11,13,13,11,8,1,2,3,3,1,3,1,1,1,3,3,14,14,15,8,13,8,12,8,1,1,1,1,1,1,17,1,20,1,1,12,1,1,187,78,20,12,3730034,6350,6350,5000,North_African__Middle_Eastern,127,8,1994/11/24,35,5,14999.0,,28085752
843,Mitchell van Bergen,Reims,1999,66.0,nl NED,FWDF,22.0,10.1,18.0,8.0,6.0,7.0,5.0,8.0,20.0,40.0,12.0,8.0,2.0,6.0,6.0,24.0,11.0,0.0,Matches,66.0,nl NED,FWDF,22.0,10.1,34.0,3.38,25.0,2.0,2.0,3.0,1.0,1.0,3.0,0.3,1.0,0.0,0.0,1.0,1.0,0.0,Matches,,,,,,,,,,,,,,,,,,,,,,,,,,,,,,,,,,,,,,,,,,,,,,,,,,,,,,,,66.0,nl NED,FWDF,22.0,10.1,1.0,0.0,0.0,10.0,7.0,3.0,59.0,6.0,8.0,1.0,1.0,0.0,56.0,5.0,8.0,38.5,Matches,66.0,nl NED,FWDF,22.0,10.1,303.0,270.0,33.0,10.0,1.0,0.0,59.0,5.0,15.0,5.0,8.0,0.0,205.0,0.0,11.0,Matches,66.0,nl NED,FWDF,22.0,10.1,205.0,303.0,67.7,3177.0,1016.0,110.0,134.0,82.1,63.0,97.0,64.9,19.0,46.0,41.3,1.0,2.7,2.6,-1.7,19.0,11.0,18.0,10.0,21.0,Matches,78,nl NED,FWDF,22,28,905.0,32.0,26.5,10.1,6,74.0,2,22,21.0,2,1.39,13.0,15.0,-2.0,-0.2,-0.27,18.4,13.0,5.4,0.53,0.41,Matches,66.0,nl NED,FWDF,22.0,10.1,437.0,10.0,57.0,158.0,239.0,37.0,437.0,38.0,14.0,36.8,23.0,60.5,314.0,2931.0,1489.0,51.0,44.0,15.0,24.0,11.0,275.0,89.0,Matches,66.0,nl NED,FWDF,22.0,10.1,0.0,25.0,11.0,44.0,2.49,1.09,0.0,0.0,19.2,0.0,0.0,0.0,2.2,2.2,0.09,-2.2,-2.2,Matches,66.0,nl NED,FWDF,22.0,28.0,6.0,905.0,10.1,0.0,1.0,1.0,0.0,0.0,0.0,1.0,0.0,2.2,2.2,2.7,4.8,51.0,21.0,89.0,0.0,0.1,0.1,0.0,0.1,0.22,0.26,0.48,0.22,0.48,Matches,Mitchell van Bergen,M/AM R,22,115,135,Holland,Stade de Reims,10,9,15,9,10,7,5,11,9,4,10,9,4,10,9,10,7,11,11,10,11,12,14,5,13,4,13,11,17,14,8,9,5,16,10,8,11,6,13,14,17,2,2,2,3,1,3,1,4,3,1,2,13,11,6,10,13,13,13,10,1,1,1,1,1,1,1,8,1,17,14,1,20,1,172,62,8,20,2191999,5749,5749,4499,North_African__Middle_Eastern,105,3,1999/8/27,0,0,4999.0,,37059427
844,Paul Bernardoni,Angers,1997,68.0,fr FRA,GK,25.0,27.0,2.0,0.0,2.0,0.0,0.0,2.0,3.0,66.7,1.0,1.0,0.0,1.0,1.0,3.0,12.0,1.0,Matches,68.0,fr FRA,GK,25.0,27.0,1.0,0.04,1.0,0.0,0.0,0.0,0.0,0.0,0.0,0.0,0.0,0.0,0.0,0.0,0.0,0.0,Matches,2.0,fr FRA,GK,25.0,27.0,62.0,8.0,1.0,6.0,3.0,51.4,0.31,-7.6,-0.28,94.0,291.0,32.3,479.0,124.0,39.5,34.6,185.0,55.1,42.6,357.0,21.0,5.9,18.0,0.67,11.4,Matches,2.0,fr FRA,GK,25.0,27.0,27.0,2430.0,27.0,62.0,2.3,143.0,84.0,62.2,1.0,5.0,21.0,3.0,11.1,9.0,8.0,0.0,1.0,0.0,Matches,68.0,fr FRA,GK,25.0,27.0,0.0,0.0,0.0,1.0,2.0,0.0,0.0,1.0,0.0,0.0,1.0,0.0,17.0,6.0,1.0,85.7,Matches,68.0,fr FRA,GK,25.0,27.0,667.0,416.0,248.0,63.0,0.0,0.0,0.0,0.0,0.0,0.0,0.0,0.0,438.0,3.0,1.0,Matches,68.0,fr FRA,GK,25.0,27.0,438.0,667.0,65.7,12371.0,9125.0,77.0,79.0,97.5,218.0,224.0,97.3,141.0,359.0,39.3,0.0,0.0,0.0,0.0,0.0,12.0,0.0,0.0,0.0,Matches,81,fr FRA,GK,25,27,2430.0,90.0,71.1,27.0,27,90.0,27,0,,11,0.3,21.0,62.0,-41.0,-1.52,-0.88,28.1,46.3,-18.2,-0.67,-0.44,Matches,68.0,fr FRA,GK,25.0,27.0,742.0,619.0,739.0,3.0,0.0,0.0,742.0,0.0,0.0,,0.0,,446.0,2140.0,1346.0,0.0,0.0,0.0,0.0,0.0,247.0,0.0,Matches,68.0,fr FRA,GK,25.0,27.0,0.0,0.0,0.0,,0.0,0.0,,,,0.0,0.0,0.0,0.0,0.0,,0.0,0.0,Matches,68.0,fr FRA,GK,25.0,27.0,27.0,2430.0,27.0,0.0,0.0,0.0,0.0,0.0,0.0,0.0,0.0,0.0,0.0,0.0,0.0,0.0,0.0,0.0,0.0,0.0,0.0,0.0,0.0,0.0,0.0,0.0,0.0,0.0,Matches,Paul Bernardoni,GK,25,133,138,France,Angers SCO,1,1,1,2,8,2,8,3,1,2,10,3,1,8,5,13,14,12,15,7,12,14,6,10,14,14,15,13,10,12,15,15,14,10,13,16,13,5,13,5,1,14,13,13,9,13,12,14,15,10,13,10,10,14,3,12,14,15,12,13,20,1,1,1,1,1,1,1,1,1,1,1,1,1,190,78,20,6,4556051,6600,5826,4313,Northern_European,131,1,1997/4/18,0,0,22998.0,,48031584
845,Juan Bernat,Paris S-G,1993,69.0,es ESP,DFMF,29.0,18.3,32.0,16.0,18.0,9.0,5.0,21.0,39.0,53.8,18.0,11.0,2.0,9.0,9.0,41.0,22.0,1.0,Matches,69.0,es ESP,DFMF,29.0,18.3,37.0,2.02,35.0,0.0,2.0,0.0,0.0,0.0,6.0,0.33,6.0,0.0,0.0,0.0,0.0,0.0,Matches,,,,,,,,,,,,,,,,,,,,,,,,,,,,,,,,,,,,,,,,,,,,,,,,,,,,,,,,69.0,es ESP,DFMF,29.0,18.3,1.0,0.0,0.0,7.0,8.0,0.0,16.0,9.0,16.0,0.0,0.0,0.0,86.0,6.0,10.0,37.5,Matches,69.0,es ESP,DFMF,29.0,18.3,1049.0,950.0,98.0,10.0,0.0,2.0,16.0,88.0,0.0,0.0,0.0,0.0,969.0,1.0,12.0,Matches,69.0,es ESP,DFMF,29.0,18.3,969.0,1049.0,92.4,13422.0,3011.0,585.0,626.0,93.5,316.0,337.0,93.8,23.0,29.0,79.3,4.0,3.1,3.0,0.9,21.0,36.0,11.0,3.0,38.0,Matches,82,es ESP,DFMF,29,28,1648.0,59.0,48.2,18.3,18,80.0,10,10,21.0,7,2.36,40.0,19.0,21.0,1.15,-0.28,36.3,23.4,12.8,0.7,-0.17,Matches,69.0,es ESP,DFMF,29.0,18.3,1170.0,43.0,286.0,543.0,348.0,64.0,1170.0,40.0,21.0,52.5,17.0,42.5,912.0,4433.0,1916.0,24.0,21.0,14.0,7.0,9.0,849.0,143.0,Matches,69.0,es ESP,DFMF,29.0,18.3,1.0,7.0,6.0,85.7,0.38,0.33,0.14,0.17,11.4,0.0,0.0,0.0,0.9,0.9,0.12,0.1,0.1,Matches,69.0,es ESP,DFMF,29.0,28.0,18.0,1648.0,18.3,1.0,4.0,5.0,1.0,0.0,0.0,1.0,0.0,0.9,0.9,3.1,3.9,24.0,38.0,143.0,0.05,0.22,0.27,0.05,0.27,0.05,0.17,0.21,0.05,0.21,Matches,Juan Bernat,D/WB L,29,144,151,Spain,Paris Saint-Germain,13,14,15,10,14,10,8,10,13,10,14,12,12,14,17,13,15,15,10,12,13,16,13,9,16,12,15,17,15,16,15,7,12,14,15,9,14,8,14,13,10,2,2,3,3,1,3,3,3,1,3,2,12,15,6,13,12,14,10,11,1,20,1,1,20,1,1,15,1,1,15,1,1,1,177,67,20,8,15373066,7195,7195,6745,Mediterranean_Hispanic,136,6,1993/3/1,11,1,161095.0,,67103536
846,Marco Bizot,Brest,1991,74.0,nl NED,GK,31.0,37.0,0.0,0.0,0.0,0.0,0.0,0.0,1.0,0.0,1.0,1.0,0.0,1.0,0.0,0.0,24.0,4.0,Matches,74.0,nl NED,GK,31.0,37.0,5.0,0.14,4.0,1.0,0.0,0.0,0.0,0.0,0.0,0.0,0.0,0.0,0.0,0.0,0.0,0.0,Matches,3.0,nl NED,GK,31.0,37.0,54.0,7.0,1.0,11.0,2.0,54.9,0.26,2.9,0.08,198.0,477.0,41.5,806.0,163.0,38.2,35.5,289.0,58.5,43.9,520.0,30.0,5.8,25.0,0.68,11.6,Matches,3.0,nl NED,GK,31.0,37.0,37.0,3330.0,37.0,54.0,1.46,176.0,122.0,73.3,11.0,10.0,16.0,8.0,21.6,9.0,7.0,2.0,0.0,22.2,Matches,74.0,nl NED,GK,31.0,37.0,4.0,0.0,0.0,0.0,4.0,0.0,0.0,0.0,0.0,0.0,0.0,0.0,29.0,5.0,1.0,83.3,Matches,74.0,nl NED,GK,31.0,37.0,1096.0,717.0,378.0,89.0,0.0,1.0,0.0,0.0,0.0,0.0,0.0,0.0,799.0,1.0,0.0,Matches,74.0,nl NED,GK,31.0,37.0,799.0,1096.0,72.9,24651.0,17824.0,87.0,87.0,100.0,405.0,411.0,98.5,305.0,595.0,51.3,0.0,0.0,0.1,0.0,0.0,14.0,1.0,0.0,0.0,Matches,88,nl NED,GK,31,37,3330.0,90.0,97.4,37.0,37,90.0,37,0,,0,1.16,44.0,54.0,-10.0,-0.27,-0.27,41.9,55.0,-13.1,-0.35,-0.78,Matches,74.0,nl NED,GK,31.0,37.0,1200.0,1060.0,1199.0,1.0,0.0,0.0,1200.0,0.0,0.0,,0.0,,749.0,4022.0,2027.0,0.0,0.0,0.0,0.0,0.0,472.0,0.0,Matches,74.0,nl NED,GK,31.0,37.0,0.0,0.0,0.0,,0.0,0.0,,,,0.0,0.0,0.0,0.0,0.0,,0.0,0.0,Matches,74.0,nl NED,GK,31.0,37.0,37.0,3330.0,37.0,0.0,0.0,0.0,0.0,0.0,0.0,4.0,0.0,0.0,0.0,0.0,0.0,0.0,0.0,0.0,0.0,0.0,0.0,0.0,0.0,0.0,0.0,0.0,0.0,0.0,Matches,Marco Bizot,GK,31,133,136,Holland,Stade Brestois 29,6,1,6,2,10,9,8,2,2,2,11,3,3,10,9,11,14,13,14,9,12,14,10,13,8,14,12,14,11,13,14,15,13,11,12,14,13,12,13,9,14,15,12,12,5,11,13,13,16,12,19,14,6,12,7,9,15,15,12,10,20,1,1,1,1,1,1,1,1,1,1,1,1,1,193,88,7,20,347975206,6642,6642,5392,Northern_European,133,2,1991/3/10,1,0,14383.0,,37005659
847,Ludovic Blas,Nantes,1997,76.0,fr FRA,MFFW,24.0,31.3,47.0,30.0,17.0,19.0,11.0,17.0,49.0,34.7,32.0,26.0,1.0,25.0,19.0,66.0,8.0,0.0,Matches,76.0,fr FRA,MFFW,24.0,31.3,122.0,3.9,75.0,19.0,16.0,9.0,3.0,0.0,9.0,0.29,3.0,3.0,2.0,1.0,0.0,0.0,Matches,,,,,,,,,,,,,,,,,,,,,,,,,,,,,,,,,,,,,,,,,,,,,,,,,,,,,,,,76.0,fr FRA,MFFW,24.0,31.3,6.0,0.0,0.0,59.0,62.0,4.0,128.0,19.0,30.0,0.0,0.0,0.0,169.0,18.0,34.0,34.6,Matches,76.0,fr FRA,MFFW,24.0,31.3,1186.0,1048.0,131.0,51.0,3.0,25.0,128.0,16.0,50.0,28.0,19.0,0.0,933.0,7.0,20.0,Matches,76.0,fr FRA,MFFW,24.0,31.3,933.0,1186.0,78.7,17210.0,3890.0,392.0,449.0,87.3,393.0,464.0,84.7,117.0,209.0,56.0,5.0,5.8,4.8,-0.8,47.0,87.0,27.0,8.0,147.0,Matches,90,fr FRA,MFFW,24,37,2813.0,76.0,82.3,31.3,30,87.0,20,7,31.0,1,0.97,32.0,36.0,-4.0,-0.13,1.95,38.6,39.7,-1.1,-0.04,1.23,Matches,76.0,fr FRA,MFFW,24.0,31.3,1627.0,10.0,154.0,785.0,723.0,103.0,1623.0,172.0,82.0,47.7,74.0,43.0,1235.0,8989.0,3850.0,122.0,69.0,39.0,90.0,76.0,1128.0,248.0,Matches,76.0,fr FRA,MFFW,24.0,31.3,7.0,95.0,32.0,33.7,3.04,1.02,0.05,0.16,21.5,4.0,2.0,4.0,9.3,6.4,0.07,-2.3,-1.4,Matches,76.0,fr FRA,MFFW,24.0,37.0,30.0,2813.0,31.3,7.0,5.0,12.0,5.0,2.0,4.0,6.0,0.0,9.3,6.4,5.8,12.1,122.0,147.0,248.0,0.22,0.16,0.38,0.16,0.32,0.3,0.18,0.48,0.2,0.39,Matches,Ludovic Blas,M/AM RC,24,138,146,"France,Martinique",FC Nantes,11,12,14,11,15,11,8,13,4,8,16,14,9,15,9,14,12,14,13,15,13,13,15,11,13,10,13,13,13,14,13,9,15,13,14,12,13,6,13,6,16,2,1,3,3,1,2,3,2,1,1,1,12,14,5,14,13,14,15,12,1,1,1,1,1,1,13,10,20,14,14,20,17,1,180,73,20,10,11700351,6900,6900,4008,African_Caribbean,136,12,1997/12/31,0,0,18397.0,,85142865
848,Miha Blažič,Angers,1993,77.0,si SVN,DF,29.0,22.0,8.0,6.0,8.0,0.0,0.0,7.0,15.0,46.7,8.0,25.0,19.0,6.0,22.0,30.0,80.0,1.0,Matches,77.0,si SVN,DF,29.0,22.0,5.0,0.23,5.0,0.0,0.0,0.0,0.0,0.0,1.0,0.05,1.0,0.0,0.0,0.0,0.0,0.0,Matches,,,,,,,,,,,,,,,,,,,,,,,,,,,,,,,,,,,,,,,,,,,,,,,,,,,,,,,,77.0,si SVN,DF,29.0,22.0,4.0,0.0,0.0,12.0,16.0,0.0,1.0,22.0,6.0,0.0,1.0,1.0,113.0,44.0,19.0,69.8,Matches,77.0,si SVN,DF,29.0,22.0,1182.0,1129.0,52.0,48.0,1.0,5.0,1.0,3.0,0.0,0.0,0.0,0.0,1034.0,1.0,1.0,Matches,77.0,si SVN,DF,29.0,22.0,1034.0,1182.0,87.5,21289.0,7678.0,302.0,330.0,91.5,581.0,622.0,93.4,138.0,208.0,66.3,0.0,0.1,0.2,-0.1,1.0,42.0,2.0,0.0,64.0,Matches,91,si SVN,DF,29,24,1979.0,82.0,57.9,22.0,22,87.0,20,2,36.0,9,0.54,15.0,40.0,-25.0,-1.14,0.3,23.3,32.5,-9.3,-0.42,0.3,Matches,77.0,si SVN,DF,29.0,22.0,1346.0,187.0,696.0,640.0,12.0,8.0,1346.0,1.0,0.0,0.0,0.0,0.0,976.0,4491.0,2155.0,0.0,0.0,0.0,3.0,0.0,893.0,0.0,Matches,77.0,si SVN,DF,29.0,22.0,2.0,8.0,4.0,50.0,0.36,0.18,0.25,0.5,10.0,1.0,0.0,0.0,1.6,1.6,0.2,0.4,0.4,Matches,77.0,si SVN,DF,29.0,24.0,22.0,1979.0,22.0,2.0,0.0,2.0,2.0,0.0,0.0,4.0,0.0,1.6,1.6,0.1,1.6,0.0,64.0,0.0,0.09,0.0,0.09,0.09,0.09,0.07,0.0,0.07,0.07,0.07,Matches,Miha Blažič,D RC,29,126,128,Slovenia,Angers SCO,8,10,8,11,13,11,15,8,10,14,10,10,14,5,13,13,12,13,13,11,13,12,3,11,11,13,12,14,12,13,13,13,11,12,12,12,14,10,12,7,8,1,3,1,3,1,2,1,2,3,3,3,11,12,8,13,12,13,12,11,1,1,20,15,1,1,1,1,1,1,1,1,1,1,185,78,8,20,2945774,6295,6295,4745,Northern_European,126,4,1993/5/8,20,0,11502.0,,62082870
849,Neto Borges,Clermont Foot,1996,83.0,br BRA,DF,25.0,31.5,75.0,45.0,45.0,20.0,10.0,46.0,75.0,61.3,29.0,45.0,11.0,34.0,41.0,116.0,62.0,1.0,Matches,83.0,br BRA,DF,25.0,31.5,77.0,2.45,67.0,2.0,3.0,2.0,3.0,0.0,9.0,0.29,6.0,0.0,0.0,1.0,2.0,0.0,Matches,,,,,,,,,,,,,,,,,,,,,,,,,,,,,,,,,,,,,,,,,,,,,,,,,,,,,,,,83.0,br BRA,DF,25.0,31.5,4.0,2.0,1.0,21.0,46.0,5.0,84.0,41.0,45.0,2.0,1.0,0.0,186.0,36.0,23.0,61.0,Matches,83.0,br BRA,DF,25.0,31.5,1496.0,1208.0,284.0,21.0,4.0,1.0,84.0,256.0,0.0,0.0,0.0,0.0,1163.0,4.0,40.0,Matches,83.0,br BRA,DF,25.0,31.5,1163.0,1496.0,77.7,18327.0,6651.0,602.0,687.0,87.6,480.0,610.0,78.7,59.0,119.0,49.6,1.0,2.7,3.5,-1.7,28.0,59.0,43.0,15.0,100.0,Matches,100,br BRA,DF,25,33,2833.0,86.0,82.8,31.5,33,86.0,28,0,,0,1.58,38.0,43.0,-5.0,-0.16,-0.31,40.3,48.5,-8.2,-0.26,0.13,Matches,83.0,br BRA,DF,25.0,31.5,1869.0,104.0,566.0,759.0,576.0,69.0,1869.0,94.0,47.0,50.0,40.0,42.6,1197.0,6987.0,3368.0,69.0,57.0,13.0,44.0,21.0,1050.0,189.0,Matches,83.0,br BRA,DF,25.0,31.5,3.0,23.0,7.0,30.4,0.73,0.22,0.13,0.43,14.6,0.0,0.0,0.0,3.1,3.1,0.13,-0.1,-0.1,Matches,83.0,br BRA,DF,25.0,33.0,33.0,2833.0,31.5,3.0,1.0,4.0,3.0,0.0,0.0,4.0,2.0,3.1,3.1,2.7,5.8,69.0,100.0,189.0,0.1,0.03,0.13,0.1,0.13,0.1,0.09,0.19,0.1,0.18,Matches,Neto Borges,D/WB L,25,121,130,Brazil,Clermont Foot 63,13,15,15,6,13,9,8,10,7,11,13,9,13,13,11,12,10,12,12,14,12,12,12,6,14,11,13,13,13,12,13,12,11,14,13,12,12,10,8,5,5,2,2,1,3,2,2,1,2,2,3,2,15,13,4,9,12,12,13,14,1,20,1,1,20,1,1,14,1,1,10,1,1,1,185,85,20,7,1750560,6035,6035,3985,Mixed_Race,118,10,1996/9/13,0,0,7135.0,,19340170
850,Hicham Boudaoui,Nice,1999,87.0,dz ALG,MF,22.0,20.8,67.0,32.0,31.0,30.0,6.0,35.0,53.0,66.0,18.0,34.0,5.0,29.0,36.0,103.0,16.0,0.0,Matches,87.0,dz ALG,MF,22.0,20.8,54.0,2.59,46.0,0.0,4.0,1.0,1.0,2.0,4.0,0.19,4.0,0.0,0.0,0.0,0.0,0.0,Matches,,,,,,,,,,,,,,,,,,,,,,,,,,,,,,,,,,,,,,,,,,,,,,,,,,,,,,,,87.0,dz ALG,MF,22.0,20.8,5.0,0.0,0.0,31.0,36.0,0.0,23.0,36.0,32.0,0.0,0.0,0.0,152.0,9.0,12.0,42.9,Matches,87.0,dz ALG,MF,22.0,20.8,1226.0,1199.0,25.0,23.0,5.0,0.0,23.0,1.0,1.0,0.0,0.0,0.0,1081.0,2.0,26.0,Matches,87.0,dz ALG,MF,22.0,20.8,1081.0,1226.0,88.2,17025.0,4134.0,533.0,589.0,90.5,422.0,464.0,90.9,66.0,93.0,71.0,2.0,1.9,1.5,0.1,23.0,99.0,16.0,3.0,110.0,Matches,105,dz ALG,MF,22,27,1875.0,69.0,54.8,20.8,22,78.0,11,5,30.0,2,1.78,27.0,14.0,13.0,0.62,0.74,34.9,25.4,9.5,0.46,0.28,Matches,87.0,dz ALG,MF,22.0,20.8,1511.0,48.0,352.0,880.0,297.0,25.0,1511.0,67.0,29.0,43.3,32.0,47.8,1166.0,7025.0,3098.0,39.0,54.0,7.0,27.0,17.0,1070.0,55.0,Matches,87.0,dz ALG,MF,22.0,20.8,1.0,21.0,9.0,42.9,1.01,0.43,0.05,0.11,23.8,0.0,0.0,0.0,0.9,0.9,0.04,0.1,0.1,Matches,87.0,dz ALG,MF,22.0,27.0,22.0,1875.0,20.8,1.0,2.0,3.0,1.0,0.0,0.0,5.0,0.0,0.9,0.9,1.9,2.8,39.0,110.0,55.0,0.05,0.1,0.14,0.05,0.14,0.04,0.09,0.14,0.04,0.14,Matches,Hicham Boudaoui,M RC,22,128,145,Algeria,OGC Nice,9,13,13,9,14,11,11,13,9,12,14,8,13,14,9,12,12,13,11,14,13,15,16,13,12,11,13,12,13,14,12,7,15,13,12,8,14,5,14,9,15,2,2,2,1,1,1,1,3,4,1,1,15,14,8,14,13,15,10,13,1,1,1,1,1,1,12,1,20,18,1,1,15,1,175,61,10,20,6243999,6398,6398,3798,North_African__Middle_Eastern,126,11,1999/9/23,10,0,14483.0,,13227048
851,Benjamin Bourigeaud,Rennes,1994,91.0,fr FRA,MFFW,28.0,34.1,45.0,29.0,16.0,23.0,6.0,21.0,65.0,32.3,44.0,38.0,3.0,35.0,31.0,76.0,32.0,0.0,Matches,91.0,fr FRA,MFFW,28.0,34.1,166.0,4.88,102.0,49.0,4.0,9.0,1.0,1.0,19.0,0.56,16.0,0.0,0.0,3.0,0.0,0.0,Matches,,,,,,,,,,,,,,,,,,,,,,,,,,,,,,,,,,,,,,,,,,,,,,,,,,,,,,,,91.0,fr FRA,MFFW,28.0,34.1,6.0,1.0,1.0,35.0,14.0,2.0,231.0,31.0,29.0,0.0,0.0,0.0,176.0,10.0,32.0,23.8,Matches,91.0,fr FRA,MFFW,28.0,34.1,2007.0,1766.0,230.0,63.0,13.0,23.0,231.0,39.0,128.0,45.0,64.0,0.0,1505.0,11.0,40.0,Matches,91.0,fr FRA,MFFW,28.0,34.1,1505.0,2007.0,75.0,28664.0,9729.0,576.0,692.0,83.2,682.0,843.0,80.9,207.0,382.0,54.2,10.0,11.6,10.3,-1.6,98.0,183.0,96.0,19.0,264.0,Matches,110,fr FRA,MFFW,28,37,3065.0,83.0,89.6,34.1,37,83.0,16,0,,0,1.76,64.0,35.0,29.0,0.85,0.6,55.3,39.1,16.1,0.47,0.19,Matches,91.0,fr FRA,MFFW,28.0,34.1,2305.0,53.0,274.0,1149.0,904.0,80.0,2303.0,33.0,14.0,42.4,17.0,51.5,1716.0,8088.0,3068.0,40.0,72.0,4.0,32.0,18.0,1602.0,250.0,Matches,91.0,fr FRA,MFFW,28.0,34.1,7.0,71.0,19.0,26.8,2.08,0.56,0.07,0.26,20.0,10.0,2.0,2.0,8.7,7.1,0.1,-1.7,-2.1,Matches,91.0,fr FRA,MFFW,28.0,37.0,37.0,3065.0,34.1,7.0,10.0,17.0,5.0,2.0,2.0,6.0,1.0,8.7,7.1,11.6,18.7,40.0,264.0,250.0,0.21,0.29,0.5,0.15,0.44,0.26,0.34,0.6,0.21,0.55,Matches,Benjamin Bourigeaud,M/AM RC,28,137,139,France,Stade Rennais FC,14,14,12,11,14,15,7,14,5,11,15,15,12,13,9,13,14,13,13,15,13,16,8,14,13,12,16,16,13,14,12,9,14,13,14,12,14,9,13,7,15,3,1,2,2,1,2,4,1,4,3,1,13,14,6,15,12,16,14,16,1,1,1,1,1,10,10,1,20,15,12,1,18,1,178,68,8,20,11500212,6850,6850,4007,Northern_European,138,6,1994/1/14,0,0,40197.0,,85117078
852,Lilian Brassier,Brest,1999,93.0,fr FRA,DF,22.0,34.4,42.0,30.0,31.0,8.0,3.0,23.0,32.0,71.9,9.0,42.0,19.0,23.0,53.0,95.0,132.0,1.0,Matches,93.0,fr FRA,DF,22.0,34.4,29.0,0.84,23.0,2.0,0.0,2.0,1.0,1.0,2.0,0.06,0.0,1.0,0.0,0.0,0.0,1.0,Matches,,,,,,,,,,,,,,,,,,,,,,,,,,,,,,,,,,,,,,,,,,,,,,,,,,,,,,,,93.0,fr FRA,DF,22.0,34.4,5.0,0.0,0.0,42.0,16.0,0.0,33.0,53.0,30.0,0.0,0.0,0.0,201.0,61.0,37.0,62.2,Matches,93.0,fr FRA,DF,22.0,34.4,1634.0,1453.0,173.0,73.0,1.0,16.0,33.0,100.0,0.0,0.0,0.0,0.0,1257.0,8.0,23.0,Matches,93.0,fr FRA,DF,22.0,34.4,1257.0,1634.0,76.9,26597.0,11728.0,399.0,457.0,87.3,637.0,741.0,86.0,203.0,382.0,53.1,0.0,0.9,1.4,-0.9,7.0,98.0,15.0,7.0,111.0,Matches,112,fr FRA,DF,22,36,3093.0,86.0,90.4,34.4,35,88.0,33,1,3.0,2,1.22,43.0,49.0,-6.0,-0.17,0.93,40.9,51.5,-10.5,-0.31,0.28,Matches,93.0,fr FRA,DF,22.0,34.4,1973.0,242.0,951.0,869.0,177.0,28.0,1973.0,29.0,13.0,44.8,12.0,41.4,1311.0,7882.0,3805.0,20.0,22.0,0.0,23.0,15.0,1145.0,29.0,Matches,93.0,fr FRA,DF,22.0,34.4,0.0,20.0,3.0,15.0,0.58,0.09,0.0,0.0,16.3,0.0,0.0,0.0,1.1,1.1,0.05,-1.1,-1.1,Matches,93.0,fr FRA,DF,22.0,36.0,35.0,3093.0,34.4,0.0,0.0,0.0,0.0,0.0,0.0,5.0,0.0,1.1,1.1,0.9,2.0,20.0,111.0,29.0,0.0,0.0,0.0,0.0,0.0,0.03,0.03,0.06,0.03,0.06,Matches,Lilian Brassier,D LC,22,120,145,"France,Guadeloupe",Stade Brestois 29,10,12,12,7,12,6,13,12,6,12,13,7,14,12,11,12,13,11,11,13,13,9,10,7,10,12,13,12,13,13,12,12,13,14,13,14,12,12,13,6,8,1,2,4,2,3,1,2,1,1,2,1,9,12,3,14,9,12,9,13,1,15,20,1,1,1,1,1,1,1,1,1,1,1,184,78,20,8,5539998,5984,5984,3801,African_Caribbean,121,15,1999/11/2,0,0,6445.0,,48044279
853,Rémy Cabella,Lille,1990,99.0,fr FRA,MFFW,32.0,28.1,64.0,37.0,21.0,28.0,15.0,29.0,64.0,45.3,35.0,41.0,5.0,36.0,17.0,81.0,7.0,1.0,Matches,99.0,fr FRA,MFFW,32.0,28.1,181.0,6.45,124.0,37.0,6.0,6.0,7.0,1.0,19.0,0.68,15.0,2.0,0.0,1.0,1.0,0.0,Matches,,,,,,,,,,,,,,,,,,,,,,,,,,,,,,,,,,,,,,,,,,,,,,,,,,,,,,,,99.0,fr FRA,MFFW,32.0,28.1,3.0,0.0,0.0,25.0,44.0,2.0,164.0,17.0,37.0,0.0,1.0,0.0,137.0,9.0,15.0,37.5,Matches,99.0,fr FRA,MFFW,32.0,28.1,1764.0,1550.0,205.0,67.0,11.0,3.0,164.0,21.0,100.0,38.0,41.0,1.0,1397.0,9.0,43.0,Matches,99.0,fr FRA,MFFW,32.0,28.1,1397.0,1764.0,79.2,20670.0,6850.0,753.0,851.0,88.5,464.0,583.0,79.6,88.0,171.0,51.5,10.0,10.7,12.1,-0.7,100.0,153.0,76.0,12.0,230.0,Matches,118,fr FRA,MFFW,32,32,2525.0,79.0,73.8,28.1,28,86.0,15,4,31.0,1,1.81,45.0,25.0,20.0,0.71,0.61,52.5,25.0,27.5,0.98,0.91,Matches,99.0,fr FRA,MFFW,32.0,28.1,2030.0,16.0,162.0,922.0,966.0,136.0,2030.0,78.0,40.0,51.3,26.0,33.3,1549.0,9297.0,4108.0,113.0,92.0,22.0,48.0,35.0,1477.0,242.0,Matches,99.0,fr FRA,MFFW,32.0,28.1,7.0,42.0,23.0,54.8,1.5,0.82,0.17,0.3,14.1,8.0,0.0,0.0,8.3,8.3,0.2,-1.3,-1.3,Matches,99.0,fr FRA,MFFW,32.0,32.0,28.0,2525.0,28.1,7.0,10.0,17.0,7.0,0.0,0.0,3.0,0.0,8.3,8.3,10.7,19.0,113.0,230.0,242.0,0.25,0.36,0.61,0.25,0.61,0.3,0.38,0.68,0.3,0.68,Matches,Rémy Cabella,M/AM RLC,32,136,145,France,LOSC Lille,14,13,15,15,15,12,9,12,5,7,15,14,10,15,10,13,12,14,12,15,14,14,15,12,14,7,9,12,14,15,12,6,15,14,13,7,16,10,13,6,12,1,2,3,3,1,1,1,2,3,3,2,7,15,5,15,12,14,12,15,1,1,1,1,1,1,1,11,16,12,15,20,17,10,172,66,10,20,4571484,6800,6550,5500,Mediterranean_Hispanic,137,6,1990/3/8,4,0,26270.0,,34008670
854,Jens Cajuste,Reims,1999,101.0,se SWE,MF,22.0,17.0,46.0,25.0,25.0,14.0,7.0,25.0,48.0,52.1,23.0,30.0,6.0,24.0,18.0,64.0,22.0,0.0,Matches,101.0,se SWE,MF,22.0,17.0,51.0,3.0,40.0,0.0,5.0,1.0,1.0,4.0,3.0,0.18,2.0,0.0,1.0,0.0,0.0,0.0,Matches,,,,,,,,,,,,,,,,,,,,,,,,,,,,,,,,,,,,,,,,,,,,,,,,,,,,,,,,101.0,se SWE,MF,22.0,17.0,8.0,1.0,1.0,33.0,29.0,0.0,7.0,18.0,25.0,0.0,0.0,0.0,101.0,13.0,17.0,43.3,Matches,101.0,se SWE,MF,22.0,17.0,739.0,718.0,20.0,16.0,6.0,8.0,7.0,3.0,1.0,0.0,0.0,0.0,606.0,1.0,19.0,Matches,101.0,se SWE,MF,22.0,17.0,606.0,739.0,82.0,11081.0,3065.0,251.0,297.0,84.5,266.0,312.0,85.3,72.0,98.0,73.5,1.0,1.2,0.9,-0.2,16.0,66.0,15.0,0.0,109.0,Matches,120,se SWE,MF,22,31,1530.0,49.0,44.7,17.0,14,76.0,2,17,28.0,0,1.45,16.0,19.0,-3.0,-0.18,-0.32,26.5,24.9,1.6,0.1,-0.25,Matches,101.0,se SWE,MF,22.0,17.0,969.0,41.0,223.0,533.0,231.0,40.0,969.0,79.0,39.0,49.4,30.0,38.0,728.0,4226.0,2387.0,46.0,36.0,10.0,28.0,23.0,663.0,40.0,Matches,101.0,se SWE,MF,22.0,17.0,3.0,27.0,7.0,25.9,1.59,0.41,0.11,0.43,19.5,0.0,0.0,0.0,1.5,1.5,0.06,1.5,1.5,Matches,101.0,se SWE,MF,22.0,31.0,14.0,1530.0,17.0,3.0,1.0,4.0,3.0,0.0,0.0,8.0,1.0,1.5,1.5,1.2,2.8,46.0,109.0,40.0,0.18,0.06,0.24,0.18,0.24,0.09,0.07,0.16,0.09,0.16,Matches,Jens Cajuste,DM/M RC,22,128,151,"Sweden,United States,Haiti",Stade de Reims,10,7,11,8,11,11,12,8,8,11,13,8,13,13,16,12,11,14,11,12,12,14,13,10,13,11,15,17,12,12,15,13,12,13,14,15,11,5,14,13,11,2,3,4,1,1,1,3,2,1,3,2,15,10,6,13,9,14,14,16,1,1,4,15,1,15,18,8,20,15,8,10,10,9,188,77,12,20,10556708,7000,6500,3400,African_Caribbean,124,13,1999/8/10,13,0,29630.0,,93069729
855,Mahdi Camara,Brest,1998,103.0,fr FRA,MF,24.0,20.2,63.0,36.0,18.0,38.0,7.0,25.0,43.0,58.1,18.0,35.0,4.0,31.0,40.0,103.0,16.0,0.0,Matches,103.0,fr FRA,MF,24.0,20.2,38.0,1.87,25.0,0.0,6.0,3.0,2.0,2.0,2.0,0.1,0.0,0.0,1.0,0.0,1.0,0.0,Matches,,,,,,,,,,,,,,,,,,,,,,,,,,,,,,,,,,,,,,,,,,,,,,,,,,,,,,,,103.0,fr FRA,MF,24.0,20.2,4.0,1.0,0.0,23.0,32.0,0.0,15.0,40.0,36.0,1.0,0.0,0.0,114.0,19.0,24.0,44.2,Matches,103.0,fr FRA,MF,24.0,20.2,703.0,663.0,36.0,6.0,0.0,3.0,15.0,7.0,0.0,0.0,0.0,0.0,578.0,4.0,19.0,Matches,103.0,fr FRA,MF,24.0,20.2,578.0,703.0,82.2,8665.0,2082.0,289.0,331.0,87.3,227.0,272.0,83.5,23.0,35.0,65.7,0.0,0.4,0.5,-0.4,9.0,53.0,7.0,1.0,80.0,Matches,122,fr FRA,MF,24,31,1820.0,59.0,53.2,20.2,20,75.0,4,11,28.0,2,1.13,21.0,28.0,-7.0,-0.35,-0.18,24.8,29.4,-4.6,-0.23,0.23,Matches,103.0,fr FRA,MF,24.0,20.2,955.0,30.0,193.0,569.0,210.0,36.0,955.0,45.0,24.0,53.3,16.0,35.6,633.0,3726.0,1596.0,32.0,25.0,2.0,27.0,17.0,550.0,44.0,Matches,103.0,fr FRA,MF,24.0,20.2,2.0,24.0,7.0,29.2,1.19,0.35,0.08,0.29,16.3,0.0,0.0,0.0,2.5,2.5,0.11,-0.5,-0.5,Matches,103.0,fr FRA,MF,24.0,31.0,20.0,1820.0,20.2,2.0,0.0,2.0,2.0,0.0,0.0,4.0,1.0,2.5,2.5,0.4,3.0,32.0,80.0,44.0,0.1,0.0,0.1,0.1,0.1,0.12,0.02,0.15,0.12,0.15,Matches,Mahdi Camara,M C,24,120,135,"France,The Gambia",AS Saint-Etienne,8,9,10,11,13,8,5,10,4,10,13,9,8,13,12,13,12,13,12,12,13,13,5,12,13,10,13,14,14,14,14,10,13,14,15,13,12,8,8,10,13,2,1,3,2,1,2,2,1,4,4,2,12,11,2,12,10,13,11,12,1,1,1,1,1,1,15,1,20,1,1,1,1,1,178,69,8,20,3779825,6199,6199,3799,African_Caribbean,121,14,1998/6/30,0,0,2300.0,Stade Brestois 29,85145396
856,Mohamed Camara,Monaco,2000,104.0,ml MLI,MF,22.0,24.4,83.0,45.0,38.0,39.0,6.0,48.0,92.0,52.2,44.0,45.0,6.0,39.0,27.0,110.0,14.0,1.0,Matches,104.0,ml MLI,MF,22.0,24.4,44.0,1.81,40.0,0.0,1.0,1.0,2.0,0.0,8.0,0.33,7.0,0.0,0.0,1.0,0.0,0.0,Matches,,,,,,,,,,,,,,,,,,,,,,,,,,,,,,,,,,,,,,,,,,,,,,,,,,,,,,,,104.0,ml MLI,MF,22.0,24.4,6.0,1.0,0.0,45.0,58.0,0.0,4.0,27.0,45.0,0.0,0.0,0.0,195.0,14.0,11.0,56.0,Matches,104.0,ml MLI,MF,22.0,24.4,1284.0,1243.0,36.0,32.0,5.0,20.0,4.0,4.0,0.0,0.0,0.0,0.0,1119.0,5.0,16.0,Matches,104.0,ml MLI,MF,22.0,24.4,1119.0,1284.0,87.1,21268.0,5952.0,435.0,484.0,89.9,501.0,549.0,91.3,153.0,203.0,75.4,3.0,2.2,1.5,0.8,18.0,121.0,15.0,2.0,135.0,Matches,123,ml MLI,MF,22,29,2194.0,76.0,64.2,24.4,25,82.0,16,4,36.0,1,1.79,50.0,40.0,10.0,0.41,0.26,39.8,33.6,6.2,0.25,0.06,Matches,104.0,ml MLI,MF,22.0,24.4,1574.0,44.0,344.0,1028.0,223.0,6.0,1574.0,49.0,23.0,46.9,15.0,30.6,1236.0,6182.0,2831.0,28.0,29.0,1.0,36.0,26.0,1105.0,19.0,Matches,104.0,ml MLI,MF,22.0,24.4,0.0,27.0,6.0,22.2,1.11,0.25,0.0,0.0,28.4,0.0,0.0,0.0,1.0,1.0,0.04,-1.0,-1.0,Matches,104.0,ml MLI,MF,22.0,29.0,25.0,2194.0,24.4,0.0,3.0,3.0,0.0,0.0,0.0,6.0,1.0,1.0,1.0,2.2,3.2,28.0,135.0,19.0,0.0,0.12,0.12,0.0,0.12,0.04,0.09,0.13,0.04,0.13,Matches,Mohamed Camara,DM/M C,22,137,160,Mali,AS Monaco,7,9,10,9,13,8,8,9,5,14,13,10,14,12,12,14,16,12,13,14,13,17,10,8,10,14,14,15,16,14,12,8,14,14,14,13,12,7,10,5,8,1,2,2,4,2,1,2,1,3,2,3,13,12,1,13,13,10,10,11,1,1,1,1,1,1,17,1,20,1,1,1,1,1,174,73,13,20,33919997,6850,6500,4650,African_Caribbean,135,15,2000/1/6,15,3,23363.0,,13193983
857,Pierrick Capelle,Angers,1987,108.0,fr FRA,MFDF,35.0,15.9,36.0,21.0,17.0,15.0,4.0,22.0,55.0,40.0,33.0,24.0,3.0,21.0,15.0,51.0,24.0,0.0,Matches,108.0,fr FRA,MFDF,35.0,15.9,33.0,2.08,22.0,8.0,1.0,2.0,0.0,0.0,5.0,0.32,3.0,1.0,1.0,0.0,0.0,0.0,Matches,,,,,,,,,,,,,,,,,,,,,,,,,,,,,,,,,,,,,,,,,,,,,,,,,,,,,,,,108.0,fr FRA,MFDF,35.0,15.9,8.0,0.0,0.0,32.0,6.0,0.0,46.0,15.0,21.0,0.0,0.0,0.0,107.0,13.0,24.0,35.1,Matches,108.0,fr FRA,MFDF,35.0,15.9,714.0,651.0,63.0,12.0,0.0,4.0,46.0,21.0,29.0,16.0,8.0,0.0,590.0,0.0,10.0,Matches,108.0,fr FRA,MFDF,35.0,15.9,590.0,714.0,82.6,10044.0,2766.0,287.0,321.0,89.4,236.0,274.0,86.1,49.0,88.0,55.7,3.0,1.2,1.2,1.8,13.0,58.0,7.0,5.0,66.0,Matches,128,fr FRA,MFDF,35,26,1428.0,55.0,41.8,15.9,15,79.0,8,11,22.0,3,0.58,8.0,26.0,-18.0,-1.13,0.22,14.6,24.0,-9.4,-0.59,-0.08,Matches,108.0,fr FRA,MFDF,35.0,15.9,898.0,38.0,194.0,485.0,227.0,19.0,898.0,29.0,14.0,48.3,14.0,48.3,608.0,3413.0,1195.0,16.0,24.0,4.0,34.0,20.0,548.0,40.0,Matches,108.0,fr FRA,MFDF,35.0,15.9,0.0,16.0,7.0,43.8,1.01,0.44,0.0,0.0,17.6,0.0,0.0,0.0,1.5,1.5,0.1,-1.5,-1.5,Matches,108.0,fr FRA,MFDF,35.0,26.0,15.0,1428.0,15.9,0.0,3.0,3.0,0.0,0.0,0.0,8.0,0.0,1.5,1.5,1.2,2.7,16.0,66.0,40.0,0.0,0.19,0.19,0.0,0.19,0.1,0.07,0.17,0.1,0.17,Matches,Pierrick Capelle,M/AM LC,35,124,128,France,Angers SCO,10,11,12,9,13,11,9,14,6,11,12,10,11,12,10,11,14,12,12,12,12,14,12,10,14,12,15,15,13,14,12,10,16,13,14,12,12,10,15,7,14,4,3,2,2,2,3,1,3,1,3,2,11,12,6,12,13,14,15,15,1,13,1,1,12,1,1,20,16,1,17,13,1,1,181,73,20,10,198196,6200,6200,3750,Northern_European,124,6,1987/4/15,0,0,9198.0,,85098947
858,Maxence Caqueret,Lyon,2000,109.0,fr FRA,MF,22.0,30.7,87.0,54.0,27.0,38.0,22.0,43.0,109.0,39.4,66.0,45.0,3.0,42.0,39.0,126.0,27.0,0.0,Matches,109.0,fr FRA,MF,22.0,30.7,118.0,3.84,80.0,20.0,7.0,4.0,5.0,2.0,15.0,0.49,11.0,1.0,1.0,1.0,0.0,1.0,Matches,,,,,,,,,,,,,,,,,,,,,,,,,,,,,,,,,,,,,,,,,,,,,,,,,,,,,,,,109.0,fr FRA,MF,22.0,30.7,2.0,0.0,0.0,45.0,31.0,4.0,99.0,39.0,54.0,0.0,0.0,0.0,215.0,16.0,21.0,43.2,Matches,109.0,fr FRA,MF,22.0,30.7,1785.0,1663.0,117.0,39.0,5.0,5.0,99.0,6.0,68.0,24.0,28.0,0.0,1480.0,5.0,43.0,Matches,109.0,fr FRA,MF,22.0,30.7,1480.0,1785.0,82.9,23941.0,7380.0,725.0,828.0,87.6,585.0,653.0,89.6,112.0,189.0,59.3,7.0,5.1,6.1,1.9,60.0,196.0,29.0,8.0,183.0,Matches,129,fr FRA,MF,22,36,2767.0,77.0,80.9,30.7,32,83.0,18,4,29.0,1,1.64,52.0,39.0,13.0,0.42,-0.27,45.6,43.1,2.5,0.08,-0.88,Matches,109.0,fr FRA,MF,22.0,30.7,2162.0,60.0,333.0,1196.0,654.0,73.0,2162.0,87.0,41.0,47.1,38.0,43.7,1650.0,8467.0,3482.0,46.0,81.0,11.0,70.0,48.0,1514.0,114.0,Matches,109.0,fr FRA,MF,22.0,30.7,4.0,26.0,13.0,50.0,0.85,0.42,0.15,0.31,19.1,3.0,0.0,0.0,2.6,2.6,0.1,1.4,1.4,Matches,109.0,fr FRA,MF,22.0,36.0,32.0,2767.0,30.7,4.0,7.0,11.0,4.0,0.0,0.0,2.0,0.0,2.6,2.6,5.1,7.7,46.0,183.0,114.0,0.13,0.23,0.36,0.13,0.36,0.09,0.16,0.25,0.09,0.25,Matches,Maxence Caqueret,DM/M C,22,137,156,France,Olympique Lyonnais,10,6,12,6,15,7,6,8,4,14,15,9,13,15,15,14,14,14,13,15,13,15,13,14,14,15,15,16,12,13,12,7,14,12,16,11,14,10,13,6,15,1,1,1,3,1,2,3,1,2,3,3,17,13,7,14,12,15,13,17,1,1,1,1,1,1,19,1,20,1,1,15,1,1,174,63,10,20,21330001,7000,6850,4500,Mediterranean_Hispanic,136,6,2000/2/15,0,0,57533.0,,48044737
859,Jean-Charles Castelletto,Nantes,1995,113.0,cm CMR,DF,27.0,28.5,43.0,26.0,29.0,12.0,2.0,22.0,36.0,61.1,14.0,35.0,22.0,13.0,58.0,101.0,90.0,0.0,Matches,113.0,cm CMR,DF,27.0,28.5,23.0,0.81,20.0,0.0,1.0,1.0,0.0,1.0,0.0,0.0,0.0,0.0,0.0,0.0,0.0,0.0,Matches,,,,,,,,,,,,,,,,,,,,,,,,,,,,,,,,,,,,,,,,,,,,,,,,,,,,,,,,113.0,cm CMR,DF,27.0,28.5,3.0,0.0,0.0,28.0,18.0,0.0,13.0,58.0,26.0,0.0,2.0,0.0,175.0,77.0,42.0,64.7,Matches,113.0,cm CMR,DF,27.0,28.5,1373.0,1305.0,66.0,34.0,0.0,6.0,13.0,32.0,0.0,0.0,0.0,0.0,1130.0,2.0,6.0,Matches,113.0,cm CMR,DF,27.0,28.5,1130.0,1373.0,82.3,21032.0,8232.0,417.0,484.0,86.2,567.0,638.0,88.9,113.0,199.0,56.8,0.0,0.4,1.1,-0.4,5.0,103.0,9.0,4.0,120.0,Matches,133,cm CMR,DF,27,32,2568.0,80.0,75.1,28.5,30,85.0,27,2,13.0,2,1.03,27.0,41.0,-14.0,-0.49,-0.07,31.0,38.9,-7.9,-0.28,-0.09,Matches,113.0,cm CMR,DF,27.0,28.5,1650.0,164.0,691.0,876.0,89.0,24.0,1650.0,18.0,11.0,61.1,5.0,27.8,1112.0,5790.0,3067.0,19.0,22.0,0.0,20.0,7.0,959.0,20.0,Matches,113.0,cm CMR,DF,27.0,28.5,0.0,9.0,3.0,33.3,0.32,0.11,0.0,0.0,13.4,0.0,0.0,0.0,0.7,0.7,0.08,-0.7,-0.7,Matches,113.0,cm CMR,DF,27.0,32.0,30.0,2568.0,28.5,0.0,0.0,0.0,0.0,0.0,0.0,3.0,0.0,0.7,0.7,0.4,1.2,19.0,120.0,20.0,0.0,0.0,0.0,0.0,0.0,0.03,0.01,0.04,0.03,0.04,Matches,Jean-Charles Castelletto,D RC,27,126,130,"Cameroon,France,Italy",FC Nantes,4,10,10,5,11,5,15,7,7,14,11,6,13,12,13,13,15,13,12,10,12,12,6,12,10,12,13,13,12,13,14,15,13,13,14,14,12,12,7,8,13,2,3,1,2,2,3,3,3,3,1,2,9,13,6,10,10,12,10,19,1,12,20,15,1,13,10,1,1,1,1,1,1,1,185,76,8,20,3712524,6300,6300,3773,African_Caribbean,126,13,1995/1/26,11,0,11947.0,,85068487
860,Fabien Centonze,Nantes,1996,116.0,fr FRA,DF,26.0,18.8,58.0,37.0,30.0,22.0,6.0,30.0,42.0,71.4,12.0,24.0,7.0,17.0,44.0,102.0,55.0,1.0,Matches,116.0,fr FRA,DF,26.0,18.8,35.0,1.86,27.0,3.0,1.0,0.0,4.0,0.0,3.0,0.16,2.0,0.0,0.0,0.0,1.0,0.0,Matches,,,,,,,,,,,,,,,,,,,,,,,,,,,,,,,,,,,,,,,,,,,,,,,,,,,,,,,,116.0,fr FRA,DF,26.0,18.8,4.0,0.0,0.0,14.0,21.0,0.0,67.0,44.0,37.0,1.0,0.0,0.0,108.0,33.0,19.0,63.5,Matches,116.0,fr FRA,DF,26.0,18.8,945.0,794.0,149.0,8.0,2.0,1.0,67.0,141.0,0.0,0.0,0.0,0.0,715.0,2.0,22.0,Matches,116.0,fr FRA,DF,26.0,18.8,715.0,945.0,75.7,11285.0,4732.0,364.0,437.0,83.3,275.0,352.0,78.1,47.0,97.0,48.5,0.0,0.9,0.9,-0.9,12.0,59.0,21.0,12.0,102.0,Matches,136,fr FRA,DF,26,23,1689.0,73.0,49.4,18.8,19,81.0,14,4,36.0,3,0.96,17.0,22.0,-5.0,-0.27,0.41,20.9,22.7,-1.8,-0.1,0.31,Matches,116.0,fr FRA,DF,26.0,18.8,1217.0,87.0,331.0,564.0,332.0,13.0,1217.0,66.0,38.0,57.6,22.0,33.3,757.0,4676.0,2055.0,42.0,39.0,5.0,25.0,11.0,671.0,125.0,Matches,116.0,fr FRA,DF,26.0,18.8,0.0,14.0,0.0,0.0,0.75,0.0,0.0,,23.0,0.0,0.0,0.0,0.7,0.7,0.05,-0.7,-0.7,Matches,116.0,fr FRA,DF,26.0,23.0,19.0,1689.0,18.8,0.0,0.0,0.0,0.0,0.0,0.0,4.0,0.0,0.7,0.7,0.9,1.6,42.0,102.0,125.0,0.0,0.0,0.0,0.0,0.0,0.04,0.05,0.09,0.04,0.09,Matches,Fabien Centonze,D/WB/M R,26,127,133,France,FC Nantes,6,14,11,8,12,6,8,7,7,12,11,10,13,12,10,14,14,14,14,14,13,12,8,9,12,13,14,14,14,12,12,10,14,13,14,12,14,6,12,7,14,1,2,2,3,2,4,2,1,3,3,1,14,13,3,12,15,14,13,12,1,12,1,20,1,17,13,1,1,16,1,1,14,1,182,75,8,20,7957924,6350,6350,3850,Mediterranean_Hispanic,124,6,1996/1/16,0,0,12807.0,,48037272
861,Fares Chaïbi,Toulouse,2002,119.0,dz ALG,FWMF,19.0,26.0,31.0,18.0,8.0,15.0,8.0,17.0,50.0,34.0,33.0,38.0,5.0,33.0,19.0,50.0,36.0,1.0,Matches,119.0,dz ALG,FWMF,19.0,26.0,72.0,2.77,55.0,1.0,5.0,8.0,3.0,0.0,7.0,0.27,5.0,0.0,0.0,2.0,0.0,0.0,Matches,,,,,,,,,,,,,,,,,,,,,,,,,,,,,,,,,,,,,,,,,,,,,,,,,,,,,,,,119.0,dz ALG,FWMF,19.0,26.0,2.0,0.0,0.0,34.0,21.0,8.0,57.0,19.0,18.0,0.0,0.0,0.0,109.0,30.0,50.0,37.5,Matches,119.0,dz ALG,FWMF,19.0,26.0,1018.0,975.0,37.0,8.0,6.0,13.0,57.0,14.0,8.0,1.0,4.0,0.0,742.0,6.0,33.0,Matches,119.0,dz ALG,FWMF,19.0,26.0,742.0,1018.0,72.9,11489.0,3144.0,398.0,486.0,81.9,252.0,324.0,77.8,56.0,121.0,46.3,5.0,4.9,4.5,0.1,30.0,68.0,27.0,5.0,101.0,Matches,140,dz ALG,FWMF,19,36,2340.0,65.0,68.4,26.0,24,81.0,8,12,33.0,0,1.22,39.0,30.0,9.0,0.35,1.6,36.8,37.5,-0.7,-0.03,0.28,Matches,119.0,dz ALG,FWMF,19.0,26.0,1314.0,48.0,194.0,606.0,531.0,86.0,1314.0,36.0,12.0,33.3,21.0,58.3,997.0,5316.0,2412.0,71.0,41.0,18.0,54.0,24.0,970.0,212.0,Matches,119.0,dz ALG,FWMF,19.0,26.0,5.0,63.0,25.0,39.7,2.42,0.96,0.08,0.2,16.8,2.0,0.0,0.0,5.9,5.9,0.09,-0.9,-0.9,Matches,119.0,dz ALG,FWMF,19.0,36.0,24.0,2340.0,26.0,5.0,5.0,10.0,5.0,0.0,0.0,2.0,0.0,5.9,5.9,4.9,10.9,71.0,101.0,212.0,0.19,0.19,0.38,0.19,0.38,0.23,0.19,0.42,0.23,0.42,Matches,Fares Chaïbi,M C,19,110,-8,"Algeria,France",Toulouse FC,10,9,11,11,12,10,10,11,5,8,13,10,11,13,11,12,12,12,10,13,12,15,13,8,12,12,12,12,12,13,11,11,14,13,13,12,12,5,13,7,14,3,1,2,2,1,2,2,2,1,3,3,14,13,7,12,12,13,7,12,1,1,1,1,1,1,10,1,20,1,14,14,13,12,183,79,8,20,27424000,5499,5499,2519,North_African__Middle_Eastern,111,8,2002/11/28,0,0,1942.0,,49060523
862,Muhammed Cham,Clermont Foot,2000,120.0,at AUT,MF,21.0,21.9,30.0,15.0,15.0,4.0,11.0,13.0,35.0,37.1,22.0,13.0,0.0,13.0,7.0,37.0,5.0,0.0,Matches,120.0,at AUT,MF,21.0,21.9,68.0,3.11,49.0,8.0,2.0,5.0,4.0,0.0,7.0,0.32,6.0,0.0,1.0,0.0,0.0,0.0,Matches,,,,,,,,,,,,,,,,,,,,,,,,,,,,,,,,,,,,,,,,,,,,,,,,,,,,,,,,120.0,at AUT,MF,21.0,21.9,2.0,0.0,0.0,17.0,40.0,1.0,73.0,7.0,15.0,0.0,1.0,0.0,106.0,6.0,13.0,31.6,Matches,120.0,at AUT,MF,21.0,21.9,1038.0,941.0,89.0,35.0,11.0,2.0,73.0,7.0,43.0,25.0,10.0,1.0,813.0,8.0,29.0,Matches,120.0,at AUT,MF,21.0,21.9,813.0,1038.0,78.3,12971.0,3167.0,409.0,479.0,85.4,288.0,345.0,83.5,71.0,130.0,54.6,4.0,3.1,4.1,0.9,31.0,62.0,35.0,3.0,106.0,Matches,141,at AUT,MF,21,38,1968.0,52.0,57.5,21.9,23,74.0,3,15,18.0,0,1.55,27.0,32.0,-5.0,-0.23,-0.29,27.9,33.9,-6.0,-0.28,0.02,Matches,120.0,at AUT,MF,21.0,21.9,1268.0,12.0,148.0,614.0,527.0,61.0,1266.0,65.0,31.0,47.7,26.0,40.0,1010.0,6125.0,2895.0,71.0,74.0,11.0,39.0,56.0,967.0,120.0,Matches,120.0,at AUT,MF,21.0,21.9,7.0,51.0,19.0,37.3,2.33,0.87,0.1,0.26,20.6,7.0,2.0,2.0,6.0,4.4,0.09,1.0,0.6,Matches,120.0,at AUT,MF,21.0,38.0,23.0,1968.0,21.9,7.0,4.0,11.0,5.0,2.0,2.0,2.0,0.0,6.0,4.4,3.1,7.5,71.0,106.0,120.0,0.32,0.18,0.5,0.23,0.41,0.27,0.14,0.41,0.2,0.34,Matches,Muhammed Cham,M/AM RC,21,120,143,Austria,Clermont Foot 63,12,11,14,13,13,12,9,13,8,7,13,10,8,14,10,12,12,12,11,12,13,12,11,9,12,10,11,11,14,14,12,9,11,13,13,11,12,8,9,8,10,2,2,2,2,2,1,3,1,1,1,2,10,12,10,10,11,10,10,11,1,1,1,1,1,1,1,11,20,17,10,20,15,1,180,0,20,8,5072000,6000,6000,3002,African_Caribbean,117,17,2000/9/26,0,0,6344.0,,91194543
863,Brendan Chardonnet,Brest,1994,122.0,fr FRA,DF,27.0,27.7,45.0,27.0,27.0,18.0,0.0,20.0,38.0,52.6,18.0,40.0,19.0,21.0,63.0,108.0,86.0,1.0,Matches,122.0,fr FRA,DF,27.0,27.7,20.0,0.72,17.0,1.0,0.0,2.0,0.0,0.0,1.0,0.04,1.0,0.0,0.0,0.0,0.0,0.0,Matches,,,,,,,,,,,,,,,,,,,,,,,,,,,,,,,,,,,,,,,,,,,,,,,,,,,,,,,,122.0,fr FRA,DF,27.0,27.7,6.0,0.0,0.0,39.0,26.0,0.0,6.0,63.0,27.0,0.0,1.0,1.0,149.0,92.0,42.0,68.7,Matches,122.0,fr FRA,DF,27.0,27.7,1318.0,1236.0,78.0,76.0,0.0,23.0,6.0,2.0,0.0,0.0,0.0,0.0,1060.0,4.0,6.0,Matches,122.0,fr FRA,DF,27.0,27.7,1060.0,1318.0,80.4,23796.0,9346.0,292.0,334.0,87.4,546.0,608.0,89.8,201.0,338.0,59.5,0.0,0.4,0.7,-0.4,8.0,96.0,11.0,3.0,80.0,Matches,143,fr FRA,DF,27,30,2491.0,83.0,72.8,27.7,27,90.0,27,3,20.0,2,1.3,31.0,37.0,-6.0,-0.22,0.17,33.6,36.0,-2.4,-0.09,0.9,Matches,122.0,fr FRA,DF,27.0,27.7,1587.0,175.0,836.0,707.0,55.0,27.0,1587.0,3.0,3.0,100.0,0.0,0.0,1072.0,5655.0,3006.0,9.0,5.0,0.0,7.0,4.0,949.0,7.0,Matches,122.0,fr FRA,DF,27.0,27.7,0.0,16.0,3.0,18.8,0.58,0.11,0.0,0.0,11.1,0.0,0.0,0.0,1.2,1.2,0.08,-1.2,-1.2,Matches,122.0,fr FRA,DF,27.0,30.0,27.0,2491.0,27.7,0.0,0.0,0.0,0.0,0.0,0.0,6.0,0.0,1.2,1.2,0.4,1.6,9.0,80.0,7.0,0.0,0.0,0.0,0.0,0.0,0.04,0.02,0.06,0.04,0.06,Matches,Brendan Chardonnet,D C,27,126,127,France,Stade Brestois 29,4,7,10,6,12,6,14,7,6,14,11,9,13,12,11,12,14,13,14,10,13,13,8,12,8,14,14,14,11,12,14,13,14,12,14,15,13,11,13,6,10,4,3,3,4,2,3,4,1,2,3,2,20,12,6,16,12,14,14,15,1,8,20,10,8,10,10,1,1,1,1,1,1,1,183,80,8,20,3267021,6300,6300,3770,Northern_European,126,5,1994/12/22,0,0,11323.0,,85139266
864,Xavier Chavalerin,Troyes,1991,123.0,fr FRA,MF,31.0,27.0,82.0,50.0,39.0,30.0,13.0,27.0,71.0,38.0,44.0,31.0,8.0,23.0,41.0,123.0,24.0,0.0,Matches,123.0,fr FRA,MF,31.0,27.0,41.0,1.52,31.0,4.0,2.0,2.0,0.0,2.0,3.0,0.11,2.0,0.0,0.0,1.0,0.0,0.0,Matches,,,,,,,,,,,,,,,,,,,,,,,,,,,,,,,,,,,,,,,,,,,,,,,,,,,,,,,,123.0,fr FRA,MF,31.0,27.0,3.0,0.0,0.0,31.0,12.0,2.0,29.0,41.0,50.0,0.0,0.0,0.0,139.0,16.0,13.0,55.2,Matches,123.0,fr FRA,MF,31.0,27.0,1068.0,1010.0,51.0,33.0,5.0,8.0,29.0,12.0,6.0,4.0,2.0,0.0,875.0,7.0,31.0,Matches,123.0,fr FRA,MF,31.0,27.0,875.0,1068.0,81.9,14453.0,4866.0,415.0,465.0,89.2,349.0,403.0,86.6,69.0,119.0,58.0,2.0,2.3,2.2,-0.3,22.0,77.0,12.0,5.0,95.0,Matches,144,fr FRA,MF,31,34,2426.0,71.0,70.9,27.0,25,89.0,23,9,23.0,3,0.65,28.0,57.0,-29.0,-1.08,-0.44,25.4,59.8,-34.4,-1.28,-0.86,Matches,123.0,fr FRA,MF,31.0,27.0,1337.0,72.0,427.0,677.0,240.0,38.0,1337.0,17.0,9.0,52.9,5.0,29.4,939.0,4366.0,1543.0,18.0,21.0,5.0,24.0,12.0,840.0,49.0,Matches,123.0,fr FRA,MF,31.0,27.0,4.0,27.0,11.0,40.7,1.0,0.41,0.15,0.36,21.5,0.0,0.0,0.0,1.5,1.5,0.06,2.5,2.5,Matches,123.0,fr FRA,MF,31.0,34.0,25.0,2426.0,27.0,4.0,2.0,6.0,4.0,0.0,0.0,3.0,0.0,1.5,1.5,2.3,3.8,18.0,95.0,49.0,0.15,0.07,0.22,0.15,0.22,0.06,0.08,0.14,0.06,0.14,Matches,Xavier Chavalerin,M C,31,124,131,France,ESTAC Troyes,13,12,12,8,13,11,10,12,7,12,13,11,13,13,13,13,13,13,13,13,12,15,14,12,12,13,14,13,12,12,13,10,14,12,16,12,13,8,13,6,10,3,1,3,1,1,3,2,2,1,2,1,7,13,6,15,12,14,14,14,1,6,1,1,6,1,15,10,20,1,10,12,1,1,179,69,20,8,1736043,6200,6200,3700,Northern_European,125,6,1991/3/7,0,0,11506.0,,85053724
865,Rayan Cherki,Lyon,2003,125.0,fr FRA,MFFW,18.0,20.8,14.0,8.0,2.0,5.0,7.0,8.0,23.0,34.8,15.0,6.0,0.0,6.0,5.0,19.0,1.0,0.0,Matches,125.0,fr FRA,MFFW,18.0,20.8,128.0,6.15,81.0,22.0,19.0,5.0,1.0,0.0,16.0,0.77,12.0,1.0,1.0,2.0,0.0,0.0,Matches,,,,,,,,,,,,,,,,,,,,,,,,,,,,,,,,,,,,,,,,,,,,,,,,,,,,,,,,125.0,fr FRA,MFFW,18.0,20.8,3.0,0.0,0.0,16.0,32.0,4.0,91.0,5.0,8.0,0.0,1.0,0.0,94.0,2.0,9.0,18.2,Matches,125.0,fr FRA,MFFW,18.0,20.8,1094.0,989.0,101.0,19.0,13.0,8.0,91.0,19.0,55.0,18.0,27.0,0.0,844.0,4.0,22.0,Matches,125.0,fr FRA,MFFW,18.0,20.8,844.0,1094.0,77.1,13798.0,3601.0,433.0,505.0,85.7,278.0,353.0,78.8,92.0,159.0,57.9,6.0,7.2,9.0,-1.2,66.0,71.0,60.0,4.0,144.0,Matches,146,fr FRA,MFFW,18,34,1872.0,55.0,54.7,20.8,21,79.0,9,13,16.0,4,1.56,38.0,22.0,16.0,0.77,0.65,36.4,28.0,8.3,0.4,0.33,Matches,125.0,fr FRA,MFFW,18.0,20.8,1364.0,3.0,83.0,552.0,758.0,141.0,1364.0,157.0,79.0,50.3,65.0,41.4,1145.0,8325.0,4182.0,133.0,91.0,61.0,63.0,49.0,1107.0,260.0,Matches,125.0,fr FRA,MFFW,18.0,20.8,4.0,61.0,21.0,34.4,2.93,1.01,0.07,0.19,18.7,3.0,0.0,0.0,4.9,4.9,0.08,-0.9,-0.9,Matches,125.0,fr FRA,MFFW,18.0,34.0,21.0,1872.0,20.8,4.0,6.0,10.0,4.0,0.0,0.0,3.0,0.0,4.9,4.9,7.2,12.1,133.0,144.0,260.0,0.19,0.29,0.48,0.19,0.48,0.24,0.34,0.58,0.24,0.58,Matches,Rayan Cherki,AM RLC,18,118,-9,"France,Algeria",Olympique Lyonnais,12,10,16,12,15,13,4,9,3,3,11,9,3,16,6,8,8,13,7,12,9,13,16,8,11,5,8,7,13,14,11,7,12,13,8,12,10,6,4,7,16,2,3,1,2,1,3,1,3,1,2,2,15,14,6,14,11,12,11,14,1,1,1,1,1,1,1,12,12,1,19,20,17,15,177,71,18,20,51999675,6099,5899,3899,North_African__Middle_Eastern,108,6,2003/8/17,0,0,34520.0,,49056279
866,Lucas Chevalier,Lille,2001,127.0,fr FRA,GK,20.0,32.0,2.0,1.0,2.0,0.0,0.0,2.0,2.0,100.0,0.0,1.0,0.0,1.0,2.0,4.0,7.0,2.0,Matches,127.0,fr FRA,GK,20.0,32.0,5.0,0.16,5.0,0.0,0.0,0.0,0.0,0.0,0.0,0.0,0.0,0.0,0.0,0.0,0.0,0.0,Matches,8.0,fr FRA,GK,20.0,32.0,31.0,2.0,2.0,1.0,3.0,30.5,0.27,2.5,0.08,76.0,282.0,27.0,903.0,121.0,26.2,29.4,105.0,42.9,37.2,317.0,22.0,6.9,25.0,0.78,13.5,Matches,8.0,fr FRA,GK,20.0,32.0,32.0,2880.0,32.0,31.0,0.97,105.0,76.0,72.4,16.0,9.0,7.0,10.0,31.3,3.0,2.0,1.0,0.0,33.3,Matches,127.0,fr FRA,GK,20.0,32.0,1.0,0.0,0.0,0.0,5.0,0.0,0.0,2.0,1.0,0.0,0.0,0.0,55.0,2.0,0.0,100.0,Matches,127.0,fr FRA,GK,20.0,32.0,1010.0,854.0,154.0,49.0,2.0,2.0,0.0,0.0,0.0,0.0,0.0,0.0,779.0,2.0,0.0,Matches,127.0,fr FRA,GK,20.0,32.0,779.0,1010.0,77.1,17580.0,12052.0,223.0,224.0,99.6,401.0,408.0,98.3,146.0,367.0,39.8,0.0,0.6,0.2,-0.6,2.0,19.0,0.0,0.0,0.0,Matches,148,fr FRA,GK,20,32,2880.0,90.0,84.2,32.0,32,90.0,32,0,,6,1.78,52.0,31.0,21.0,0.66,0.66,58.4,31.8,26.5,0.83,0.55,Matches,127.0,fr FRA,GK,20.0,32.0,1060.0,832.0,1057.0,3.0,0.0,0.0,1060.0,0.0,0.0,,0.0,,858.0,4458.0,2988.0,0.0,0.0,0.0,1.0,0.0,638.0,0.0,Matches,127.0,fr FRA,GK,20.0,32.0,0.0,0.0,0.0,,0.0,0.0,,,,0.0,0.0,0.0,0.0,0.0,,0.0,0.0,Matches,127.0,fr FRA,GK,20.0,32.0,32.0,2880.0,32.0,0.0,0.0,0.0,0.0,0.0,0.0,1.0,0.0,0.0,0.0,0.6,0.6,0.0,0.0,0.0,0.0,0.0,0.0,0.0,0.0,0.0,0.02,0.02,0.0,0.02,Matches,Lucas Chevalier,GK,20,117,-85,France,LOSC Lille,6,3,3,3,11,8,1,3,3,1,11,3,1,9,6,15,14,11,11,10,15,14,1,11,2,11,11,10,10,16,7,13,13,10,10,11,12,8,15,5,12,11,12,10,8,11,11,11,12,11,6,10,13,13,7,14,12,15,13,16,20,1,1,1,1,1,1,1,1,1,1,1,1,1,189,84,6,20,32173876,6250,5850,2770,Northern_European,111,4,2001/11/6,0,0,11832.0,,49048357
867,Pedro Chirivella,Nantes,1997,128.0,es ESP,MF,25.0,22.5,33.0,22.0,12.0,15.0,6.0,17.0,44.0,38.6,27.0,24.0,1.0,23.0,20.0,53.0,7.0,0.0,Matches,128.0,es ESP,MF,25.0,22.5,50.0,2.22,46.0,1.0,2.0,0.0,0.0,1.0,3.0,0.13,3.0,0.0,0.0,0.0,0.0,0.0,Matches,,,,,,,,,,,,,,,,,,,,,,,,,,,,,,,,,,,,,,,,,,,,,,,,,,,,,,,,128.0,es ESP,MF,25.0,22.5,1.0,0.0,0.0,20.0,18.0,0.0,13.0,20.0,22.0,0.0,0.0,0.0,126.0,9.0,8.0,52.9,Matches,128.0,es ESP,MF,25.0,22.5,1360.0,1284.0,71.0,49.0,1.0,17.0,13.0,3.0,0.0,0.0,0.0,0.0,1163.0,5.0,15.0,Matches,128.0,es ESP,MF,25.0,22.5,1163.0,1360.0,85.5,21412.0,6260.0,493.0,528.0,93.4,465.0,522.0,89.1,159.0,239.0,66.5,1.0,1.7,0.8,-0.7,24.0,182.0,12.0,1.0,172.0,Matches,149,es ESP,MF,25,26,2028.0,78.0,59.3,22.5,25,80.0,10,1,28.0,2,0.96,20.0,29.0,-9.0,-0.4,0.18,25.7,30.5,-4.7,-0.21,0.11,Matches,128.0,es ESP,MF,25.0,22.5,1494.0,22.0,225.0,1071.0,206.0,10.0,1494.0,15.0,8.0,53.3,6.0,40.0,1196.0,5875.0,2375.0,15.0,18.0,1.0,5.0,6.0,1103.0,22.0,Matches,128.0,es ESP,MF,25.0,22.5,0.0,16.0,5.0,31.3,0.71,0.22,0.0,0.0,22.2,0.0,0.0,0.0,0.8,0.8,0.05,-0.8,-0.8,Matches,128.0,es ESP,MF,25.0,26.0,25.0,2028.0,22.5,0.0,1.0,1.0,0.0,0.0,0.0,1.0,0.0,0.8,0.8,1.7,2.5,15.0,172.0,22.0,0.0,0.04,0.04,0.0,0.04,0.04,0.07,0.11,0.04,0.11,Matches,Pedro Chirivella,DM/M C,25,131,134,Spain,FC Nantes,12,8,12,7,15,10,8,11,4,12,15,9,12,13,12,13,14,15,14,13,14,13,12,7,12,13,14,13,12,14,14,8,11,12,14,12,14,7,12,9,6,2,2,1,3,2,1,2,3,2,1,2,14,13,5,12,11,13,13,11,1,1,10,1,1,1,18,1,20,1,1,11,1,1,178,0,10,20,6406161,6546,6546,3996,Mediterranean_Hispanic,131,5,1997/5/23,0,0,6999.0,,67185037
868,Joris Chotard,Montpellier,2001,129.0,fr FRA,MF,20.0,27.3,64.0,34.0,37.0,23.0,4.0,40.0,78.0,51.3,38.0,40.0,11.0,29.0,40.0,104.0,42.0,1.0,Matches,129.0,fr FRA,MF,20.0,27.3,40.0,1.46,30.0,4.0,1.0,1.0,1.0,3.0,8.0,0.29,8.0,0.0,0.0,0.0,0.0,0.0,Matches,,,,,,,,,,,,,,,,,,,,,,,,,,,,,,,,,,,,,,,,,,,,,,,,,,,,,,,,129.0,fr FRA,MF,20.0,27.3,4.0,0.0,0.0,33.0,18.0,3.0,33.0,40.0,34.0,0.0,0.0,0.0,188.0,12.0,20.0,37.5,Matches,129.0,fr FRA,MF,20.0,27.3,1092.0,1033.0,55.0,40.0,5.0,11.0,33.0,4.0,11.0,4.0,6.0,0.0,867.0,4.0,19.0,Matches,129.0,fr FRA,MF,20.0,27.3,867.0,1092.0,79.4,15720.0,5467.0,354.0,414.0,85.5,364.0,425.0,85.6,110.0,183.0,60.1,6.0,3.5,2.7,2.5,27.0,89.0,19.0,3.0,105.0,Matches,150,fr FRA,MF,20,35,2461.0,70.0,72.0,27.3,26,87.0,17,9,24.0,2,1.4,51.0,44.0,7.0,0.26,0.63,39.6,45.4,-5.8,-0.21,0.18,Matches,129.0,fr FRA,MF,20.0,27.3,1339.0,98.0,409.0,765.0,178.0,14.0,1339.0,26.0,13.0,50.0,9.0,34.6,879.0,4089.0,1539.0,8.0,15.0,2.0,20.0,12.0,754.0,28.0,Matches,129.0,fr FRA,MF,20.0,27.3,0.0,12.0,1.0,8.3,0.44,0.04,0.0,0.0,27.2,0.0,0.0,0.0,0.6,0.6,0.05,-0.6,-0.6,Matches,129.0,fr FRA,MF,20.0,35.0,26.0,2461.0,27.3,0.0,6.0,6.0,0.0,0.0,0.0,4.0,0.0,0.6,0.6,3.5,4.1,8.0,105.0,28.0,0.0,0.22,0.22,0.0,0.22,0.02,0.13,0.15,0.02,0.15,Matches,Joris Chotard,DM/M C,20,123,147,France,Montpellier Hérault SC,8,8,12,8,13,9,10,8,5,11,14,6,13,14,13,13,14,12,13,13,13,13,13,9,12,13,14,14,13,14,14,12,14,12,13,14,14,13,13,8,10,2,2,1,2,3,1,2,3,2,2,3,19,13,8,12,13,15,12,12,1,1,1,1,1,1,20,1,19,1,1,1,1,1,179,70,8,20,9824000,6149,6149,3907,Northern_European,125,5,2001/9/24,0,0,9500.0,,49048599
869,Jonathan Clauss,Marseille,1992,134.0,fr FRA,DF,29.0,28.8,46.0,28.0,21.0,16.0,9.0,23.0,52.0,44.2,29.0,29.0,4.0,25.0,31.0,77.0,40.0,2.0,Matches,134.0,fr FRA,DF,29.0,28.8,101.0,3.51,78.0,3.0,5.0,12.0,0.0,3.0,13.0,0.45,11.0,0.0,0.0,1.0,0.0,1.0,Matches,,,,,,,,,,,,,,,,,,,,,,,,,,,,,,,,,,,,,,,,,,,,,,,,,,,,,,,,134.0,fr FRA,DF,29.0,28.8,1.0,0.0,0.0,25.0,12.0,3.0,110.0,31.0,28.0,0.0,1.0,0.0,180.0,10.0,17.0,37.0,Matches,134.0,fr FRA,DF,29.0,28.8,1461.0,1223.0,233.0,15.0,8.0,6.0,110.0,211.0,7.0,1.0,5.0,0.0,1091.0,5.0,39.0,Matches,134.0,fr FRA,DF,29.0,28.8,1091.0,1461.0,74.7,17647.0,6285.0,553.0,671.0,82.4,426.0,542.0,78.6,74.0,150.0,49.3,9.0,8.4,7.2,0.6,49.0,90.0,54.0,23.0,121.0,Matches,155,fr FRA,DF,29,34,2590.0,76.0,75.7,28.8,32,79.0,16,2,30.0,0,1.94,52.0,27.0,25.0,0.87,0.65,48.3,32.1,16.2,0.56,-0.15,Matches,134.0,fr FRA,DF,29.0,28.8,1757.0,57.0,326.0,737.0,720.0,114.0,1757.0,63.0,32.0,50.8,27.0,42.9,1215.0,6722.0,3314.0,83.0,51.0,22.0,47.0,16.0,1081.0,240.0,Matches,134.0,fr FRA,DF,29.0,28.8,2.0,48.0,12.0,25.0,1.67,0.42,0.04,0.17,17.5,0.0,0.0,0.0,4.2,4.2,0.09,-2.2,-2.2,Matches,134.0,fr FRA,DF,29.0,34.0,32.0,2590.0,28.8,2.0,9.0,11.0,2.0,0.0,0.0,1.0,0.0,4.2,4.2,8.4,12.6,83.0,121.0,240.0,0.07,0.31,0.38,0.07,0.38,0.15,0.29,0.44,0.15,0.44,Matches,Jonathan Clauss,D/WB/M R,29,143,148,France,Olympique de Marseille,12,15,14,10,13,13,6,12,13,13,14,8,13,13,14,11,14,12,12,13,13,15,10,8,13,12,13,14,16,14,12,9,15,16,14,11,15,12,14,6,9,1,1,2,2,1,3,2,2,2,1,2,10,13,9,11,13,12,10,12,1,12,1,20,12,20,1,12,1,16,1,1,1,1,178,67,8,20,22369159,7147,7147,4997,Mediterranean_Hispanic,134,6,1992/9/25,4,0,46720.0,,85045209
870,Abdu Conté,Troyes,1998,137.0,pt POR,DF,24.0,14.6,25.0,17.0,14.0,8.0,3.0,12.0,22.0,54.5,10.0,13.0,6.0,7.0,6.0,31.0,25.0,0.0,Matches,137.0,pt POR,DF,24.0,14.6,24.0,1.64,20.0,2.0,0.0,0.0,2.0,0.0,2.0,0.14,2.0,0.0,0.0,0.0,0.0,0.0,Matches,,,,,,,,,,,,,,,,,,,,,,,,,,,,,,,,,,,,,,,,,,,,,,,,,,,,,,,,137.0,pt POR,DF,24.0,14.6,0.0,0.0,0.0,12.0,12.0,4.0,37.0,6.0,17.0,0.0,2.0,0.0,71.0,16.0,7.0,69.6,Matches,137.0,pt POR,DF,24.0,14.6,754.0,613.0,138.0,12.0,2.0,5.0,37.0,126.0,0.0,0.0,0.0,0.0,591.0,3.0,30.0,Matches,137.0,pt POR,DF,24.0,14.6,591.0,754.0,78.4,10401.0,3886.0,256.0,303.0,84.5,270.0,324.0,83.3,52.0,83.0,62.7,2.0,2.0,1.8,0.0,14.0,41.0,14.0,6.0,56.0,Matches,158,pt POR,DF,24,19,1315.0,69.0,38.5,14.6,15,81.0,9,4,26.0,1,0.68,21.0,26.0,-5.0,-0.34,0.98,13.3,30.1,-16.8,-1.15,-0.2,Matches,137.0,pt POR,DF,24.0,14.6,869.0,48.0,285.0,385.0,206.0,19.0,869.0,17.0,2.0,11.8,14.0,82.4,591.0,3294.0,1623.0,32.0,21.0,6.0,9.0,6.0,542.0,91.0,Matches,137.0,pt POR,DF,24.0,14.6,1.0,4.0,2.0,50.0,0.27,0.14,0.25,0.5,15.3,0.0,0.0,0.0,0.6,0.6,0.14,0.4,0.4,Matches,137.0,pt POR,DF,24.0,19.0,15.0,1315.0,14.6,1.0,2.0,3.0,1.0,0.0,0.0,0.0,0.0,0.6,0.6,2.0,2.6,32.0,56.0,91.0,0.07,0.14,0.21,0.07,0.21,0.04,0.14,0.18,0.04,0.18,Matches,Abdu Conté,D/WB L,24,125,132,"Portugal,Guinea-Bissau",ESTAC Troyes,12,13,11,7,11,7,11,6,12,12,13,8,13,13,12,13,14,13,13,13,13,13,10,12,12,12,13,14,12,11,15,13,16,14,14,15,13,7,8,12,11,3,1,1,3,4,3,1,3,3,2,3,17,12,5,11,8,15,14,12,1,20,14,1,18,1,1,1,1,1,1,1,1,1,183,78,20,7,2833641,6250,6250,4300,African_Caribbean,125,18,1998/3/24,0,0,10343.0,,55082206
871,Benoît Costil,Auxerre,1987,142.0,fr FRA,GK,35.0,19.0,2.0,0.0,2.0,0.0,0.0,2.0,4.0,50.0,2.0,0.0,0.0,0.0,0.0,2.0,5.0,0.0,Matches,142.0,fr FRA,GK,35.0,19.0,4.0,0.21,2.0,2.0,0.0,0.0,0.0,0.0,0.0,0.0,0.0,0.0,0.0,0.0,0.0,0.0,Matches,9.0,fr FRA,GK,35.0,19.0,41.0,3.0,0.0,3.0,0.0,34.0,0.33,-7.0,-0.37,132.0,292.0,45.2,454.0,72.0,41.9,36.8,137.0,74.5,51.7,285.0,3.0,1.1,11.0,0.58,13.1,Matches,9.0,fr FRA,GK,35.0,19.0,19.0,1710.0,19.0,41.0,2.16,96.0,55.0,60.4,3.0,4.0,12.0,2.0,10.5,3.0,3.0,0.0,0.0,0.0,Matches,142.0,fr FRA,GK,35.0,19.0,0.0,0.0,0.0,0.0,0.0,0.0,0.0,0.0,0.0,0.0,0.0,0.0,18.0,2.0,0.0,100.0,Matches,142.0,fr FRA,GK,35.0,19.0,593.0,373.0,218.0,81.0,0.0,3.0,0.0,0.0,0.0,0.0,0.0,0.0,414.0,2.0,0.0,Matches,142.0,fr FRA,GK,35.0,19.0,414.0,593.0,69.8,13801.0,10403.0,54.0,54.0,100.0,173.0,179.0,96.6,186.0,357.0,52.1,0.0,0.0,0.0,0.0,0.0,11.0,0.0,0.0,1.0,Matches,163,fr FRA,GK,35,19,1710.0,90.0,50.0,19.0,19,90.0,19,0,,0,0.68,16.0,41.0,-25.0,-1.32,-1.16,18.6,31.0,-12.4,-0.65,-0.47,Matches,142.0,fr FRA,GK,35.0,19.0,638.0,531.0,635.0,3.0,0.0,0.0,638.0,1.0,1.0,100.0,0.0,0.0,377.0,1899.0,975.0,0.0,0.0,0.0,0.0,0.0,254.0,0.0,Matches,142.0,fr FRA,GK,35.0,19.0,0.0,0.0,0.0,,0.0,0.0,,,,0.0,0.0,0.0,0.0,0.0,,0.0,0.0,Matches,142.0,fr FRA,GK,35.0,19.0,19.0,1710.0,19.0,0.0,0.0,0.0,0.0,0.0,0.0,0.0,0.0,0.0,0.0,0.0,0.0,0.0,1.0,0.0,0.0,0.0,0.0,0.0,0.0,0.0,0.0,0.0,0.0,0.0,Matches,Benoît Costil,GK,35,128,143,France,AJ Auxerre,4,2,2,1,12,7,1,3,3,3,11,4,1,9,8,13,12,13,12,10,12,15,7,14,3,13,13,10,12,14,14,13,15,12,13,14,13,8,14,5,1,12,12,14,8,11,14,14,14,12,12,12,13,15,8,14,12,14,14,15,20,1,1,1,1,1,1,1,1,1,1,1,1,1,187,82,6,20,957141,6400,6400,5000,Northern_European,127,5,1987/7/3,1,0,28396.0,,919964
872,Nicolas Cozza,Montpellier,1999,144.0,fr FRA,DF,23.0,14.2,38.0,21.0,27.0,9.0,2.0,26.0,38.0,68.4,12.0,11.0,5.0,6.0,21.0,59.0,35.0,1.0,Matches,144.0,fr FRA,DF,23.0,14.2,18.0,1.27,15.0,0.0,1.0,1.0,1.0,0.0,2.0,0.14,2.0,0.0,0.0,0.0,0.0,0.0,Matches,,,,,,,,,,,,,,,,,,,,,,,,,,,,,,,,,,,,,,,,,,,,,,,,,,,,,,,,144.0,fr FRA,DF,23.0,14.2,3.0,0.0,0.0,8.0,19.0,3.0,14.0,21.0,21.0,0.0,0.0,0.0,62.0,21.0,23.0,47.7,Matches,144.0,fr FRA,DF,23.0,14.2,592.0,498.0,90.0,8.0,1.0,2.0,14.0,82.0,0.0,0.0,0.0,0.0,429.0,4.0,16.0,Matches,144.0,fr FRA,DF,23.0,14.2,429.0,592.0,72.5,7416.0,3170.0,204.0,248.0,82.3,182.0,235.0,77.4,30.0,70.0,42.9,1.0,0.8,0.8,0.2,7.0,27.0,7.0,3.0,48.0,Matches,168,fr FRA,DF,23,17,1277.0,75.0,37.3,14.2,14,87.0,13,3,18.0,1,0.82,21.0,29.0,-8.0,-0.56,-1.03,17.4,25.7,-8.4,-0.59,-0.52,Matches,144.0,fr FRA,DF,23.0,14.2,747.0,66.0,289.0,329.0,133.0,19.0,747.0,15.0,5.0,33.3,8.0,53.3,447.0,2740.0,1368.0,20.0,16.0,3.0,18.0,4.0,407.0,34.0,Matches,144.0,fr FRA,DF,23.0,14.2,2.0,7.0,4.0,57.1,0.49,0.28,0.29,0.5,10.0,0.0,0.0,0.0,1.4,1.4,0.2,0.6,0.6,Matches,144.0,fr FRA,DF,23.0,17.0,14.0,1277.0,14.2,2.0,1.0,3.0,2.0,0.0,0.0,3.0,0.0,1.4,1.4,0.8,2.1,20.0,48.0,34.0,0.14,0.07,0.21,0.14,0.21,0.1,0.05,0.15,0.1,0.15,Matches,Nicolas Cozza,D LC,23,125,139,France,Montpellier Hérault SC,9,11,11,8,13,7,12,9,10,14,13,8,13,12,10,14,12,13,13,11,12,11,10,10,12,14,14,13,12,12,14,12,13,12,14,13,13,9,14,11,12,2,2,3,3,3,2,3,1,1,2,1,8,13,11,10,12,14,12,15,1,20,20,1,14,1,1,1,1,1,1,1,1,1,178,72,20,8,2298572,6250,6250,3814,Northern_European,125,3,1999/1/8,0,0,8049.0,,49037761
873,Colin Dagba,Strasbourg,1998,147.0,fr FRA,DFMF,23.0,10.6,32.0,20.0,17.0,10.0,5.0,19.0,26.0,73.1,7.0,18.0,2.0,16.0,17.0,49.0,19.0,0.0,Matches,147.0,fr FRA,DFMF,23.0,10.6,23.0,2.16,19.0,2.0,1.0,0.0,1.0,0.0,2.0,0.19,2.0,0.0,0.0,0.0,0.0,0.0,Matches,,,,,,,,,,,,,,,,,,,,,,,,,,,,,,,,,,,,,,,,,,,,,,,,,,,,,,,,147.0,fr FRA,DFMF,23.0,10.6,3.0,0.0,0.0,14.0,6.0,1.0,35.0,17.0,20.0,0.0,0.0,0.0,51.0,3.0,5.0,37.5,Matches,147.0,fr FRA,DFMF,23.0,10.6,496.0,395.0,99.0,5.0,0.0,0.0,35.0,93.0,1.0,0.0,0.0,0.0,401.0,2.0,14.0,Matches,147.0,fr FRA,DFMF,23.0,10.6,401.0,496.0,80.8,5529.0,2050.0,260.0,290.0,89.7,116.0,148.0,78.4,12.0,31.0,38.7,0.0,0.8,0.8,-0.8,12.0,26.0,15.0,8.0,31.0,Matches,172,fr FRA,DFMF,23,21,958.0,46.0,28.0,10.6,12,61.0,0,9,25.0,6,1.33,10.0,13.0,-3.0,-0.28,-0.1,13.5,13.3,0.3,0.03,0.29,Matches,147.0,fr FRA,DFMF,23.0,10.6,617.0,22.0,148.0,258.0,220.0,20.0,617.0,25.0,11.0,44.0,12.0,48.0,402.0,2384.0,1286.0,26.0,21.0,5.0,9.0,10.0,361.0,48.0,Matches,147.0,fr FRA,DFMF,23.0,10.6,0.0,5.0,0.0,0.0,0.47,0.0,0.0,,16.3,0.0,0.0,0.0,0.4,0.4,0.07,-0.4,-0.4,Matches,147.0,fr FRA,DFMF,23.0,21.0,12.0,958.0,10.6,0.0,0.0,0.0,0.0,0.0,0.0,3.0,0.0,0.4,0.4,0.8,1.1,26.0,31.0,48.0,0.0,0.0,0.0,0.0,0.0,0.03,0.07,0.1,0.03,0.1,Matches,Colin Dagba,D RL,23,124,136,"France,Benin",Paris Saint-Germain,9,13,13,7,13,6,10,8,8,11,13,6,11,13,10,11,8,13,14,10,12,12,11,8,14,12,14,14,16,14,10,5,13,15,14,10,12,8,6,12,12,2,1,2,2,3,1,2,1,1,1,1,10,14,6,10,12,14,11,13,1,15,1,20,1,14,1,1,1,1,1,1,1,1,170,62,10,20,438355,6198,6198,3998,African_Caribbean,120,12,1998/9/9,0,0,23014.0,RC Strasbourg Alsace,49034905
874,Thijs Dallinga,Toulouse,2000,148.0,nl NED,FW,21.0,26.1,8.0,6.0,2.0,2.0,4.0,1.0,13.0,7.7,12.0,17.0,3.0,14.0,3.0,11.0,20.0,0.0,Matches,148.0,nl NED,FW,21.0,26.1,42.0,1.61,33.0,0.0,1.0,7.0,1.0,0.0,4.0,0.15,3.0,0.0,0.0,1.0,0.0,0.0,Matches,,,,,,,,,,,,,,,,,,,,,,,,,,,,,,,,,,,,,,,,,,,,,,,,,,,,,,,,148.0,nl NED,FW,21.0,26.1,4.0,0.0,0.0,35.0,19.0,22.0,18.0,3.0,6.0,0.0,0.0,0.0,41.0,56.0,68.0,45.2,Matches,148.0,nl NED,FW,21.0,26.1,522.0,516.0,4.0,0.0,0.0,4.0,18.0,2.0,0.0,0.0,0.0,0.0,327.0,2.0,32.0,Matches,148.0,nl NED,FW,21.0,26.1,327.0,522.0,62.6,4337.0,720.0,200.0,288.0,69.4,89.0,145.0,61.4,12.0,18.0,66.7,1.0,2.0,1.3,-1.0,22.0,19.0,5.0,1.0,30.0,Matches,173,nl NED,FW,21,36,2353.0,65.0,68.8,26.1,28,75.0,5,8,33.0,1,1.22,32.0,36.0,-4.0,-0.15,0.02,35.6,36.6,-1.0,-0.04,0.26,Matches,148.0,nl NED,FW,21.0,26.1,719.0,24.0,43.0,341.0,341.0,110.0,719.0,24.0,10.0,41.7,9.0,37.5,517.0,2700.0,742.0,23.0,21.0,8.0,40.0,18.0,574.0,174.0,Matches,148.0,nl NED,FW,21.0,26.1,12.0,61.0,30.0,49.2,2.33,1.15,0.2,0.4,12.1,0.0,0.0,0.0,9.8,9.8,0.16,2.2,2.2,Matches,148.0,nl NED,FW,21.0,36.0,28.0,2353.0,26.1,12.0,1.0,13.0,12.0,0.0,0.0,4.0,0.0,9.8,9.8,2.0,11.9,23.0,30.0,174.0,0.46,0.04,0.5,0.46,0.5,0.38,0.08,0.46,0.38,0.46,Matches,Thijs Dallinga,S,21,120,135,Holland,Toulouse FC,7,6,12,14,12,8,13,12,5,5,12,13,5,12,5,12,13,14,12,12,13,15,15,13,13,13,12,13,13,13,14,14,16,13,12,12,13,5,14,3,12,3,1,2,1,2,1,1,1,2,2,2,14,9,6,8,11,14,12,13,1,1,1,1,1,1,1,1,1,1,1,1,1,20,180,70,8,20,2767999,5999,5999,3758,Northern_European,122,3,2000/8/3,0,0,2500.0,,37070210
875,Kevin Danso,Lens,1998,151.0,at AUT,DF,23.0,35.9,37.0,19.0,25.0,11.0,1.0,19.0,30.0,63.3,11.0,48.0,34.0,14.0,33.0,70.0,124.0,0.0,Matches,151.0,at AUT,DF,23.0,35.9,41.0,1.14,38.0,0.0,1.0,0.0,2.0,0.0,5.0,0.14,4.0,0.0,0.0,0.0,1.0,0.0,Matches,,,,,,,,,,,,,,,,,,,,,,,,,,,,,,,,,,,,,,,,,,,,,,,,,,,,,,,,151.0,at AUT,DF,23.0,35.9,7.0,1.0,0.0,39.0,57.0,2.0,0.0,33.0,19.0,1.0,2.0,0.0,224.0,82.0,32.0,71.9,Matches,151.0,at AUT,DF,23.0,35.9,2336.0,2230.0,106.0,79.0,1.0,1.0,0.0,7.0,0.0,0.0,0.0,0.0,2103.0,0.0,11.0,Matches,151.0,at AUT,DF,23.0,35.9,2103.0,2336.0,90.0,39503.0,14272.0,709.0,769.0,92.2,1184.0,1267.0,93.4,187.0,257.0,72.8,2.0,1.0,1.3,1.0,10.0,157.0,3.0,0.0,163.0,Matches,177,at AUT,DF,23,37,3232.0,87.0,94.5,35.9,37,87.0,35,0,,0,2.19,62.0,26.0,36.0,1.0,-0.43,63.0,38.4,24.6,0.68,1.34,Matches,151.0,at AUT,DF,23.0,35.9,2686.0,246.0,1036.0,1566.0,105.0,32.0,2686.0,37.0,19.0,51.4,12.0,32.4,2008.0,13114.0,7379.0,34.0,32.0,1.0,17.0,17.0,1820.0,2.0,Matches,151.0,at AUT,DF,23.0,35.9,1.0,24.0,4.0,16.7,0.67,0.11,0.04,0.25,14.9,0.0,0.0,0.0,2.5,2.4,0.1,-1.5,-1.4,Matches,151.0,at AUT,DF,23.0,37.0,37.0,3232.0,35.9,1.0,2.0,3.0,1.0,0.0,0.0,7.0,1.0,2.5,2.4,1.0,3.5,34.0,163.0,2.0,0.03,0.06,0.08,0.03,0.08,0.07,0.03,0.1,0.07,0.1,Matches,Kevin Danso,D C,23,129,142,"Austria,Ghana,England",RC Lens,5,7,8,10,9,5,15,7,14,13,12,10,13,10,13,12,15,11,10,8,11,15,7,10,13,11,12,14,13,12,14,17,16,16,13,15,14,12,13,4,16,3,1,1,3,3,1,4,2,1,2,3,15,17,6,11,13,12,14,10,1,1,20,1,1,1,14,1,10,1,1,1,1,1,190,85,10,20,5612540,6448,6148,4748,African_Caribbean,126,15,1998/9/19,10,0,14999.0,,91144914
876,Dante,Nice,1983,152.0,br BRA,DF,38.0,36.7,70.0,40.0,45.0,21.0,4.0,36.0,59.0,61.0,23.0,52.0,31.0,21.0,47.0,117.0,125.0,2.0,Matches,152.0,br BRA,DF,38.0,36.7,34.0,0.93,30.0,0.0,0.0,3.0,0.0,1.0,3.0,0.08,3.0,0.0,0.0,0.0,0.0,0.0,Matches,,,,,,,,,,,,,,,,,,,,,,,,,,,,,,,,,,,,,,,,,,,,,,,,,,,,,,,,152.0,br BRA,DF,38.0,36.7,6.0,0.0,0.0,38.0,18.0,0.0,2.0,47.0,40.0,0.0,1.0,0.0,261.0,74.0,28.0,72.5,Matches,152.0,br BRA,DF,38.0,36.7,2643.0,2550.0,88.0,69.0,4.0,12.0,2.0,9.0,0.0,0.0,0.0,0.0,2376.0,5.0,14.0,Matches,152.0,br BRA,DF,38.0,36.7,2376.0,2643.0,89.9,45941.0,18236.0,861.0,908.0,94.8,1220.0,1286.0,94.9,257.0,388.0,66.2,2.0,1.7,1.5,0.3,12.0,154.0,9.0,0.0,160.0,Matches,178,br BRA,DF,38,37,3299.0,89.0,96.5,36.7,37,89.0,36,0,,0,1.54,47.0,36.0,11.0,0.3,0.3,55.4,43.4,12.0,0.33,-0.1,Matches,152.0,br BRA,DF,38.0,36.7,2991.0,346.0,1427.0,1505.0,75.0,31.0,2991.0,13.0,8.0,61.5,5.0,38.5,2374.0,11876.0,6155.0,12.0,11.0,0.0,15.0,9.0,2177.0,3.0,Matches,152.0,br BRA,DF,38.0,36.7,1.0,23.0,5.0,21.7,0.63,0.14,0.04,0.2,13.8,0.0,0.0,0.0,1.5,1.5,0.07,-0.5,-0.5,Matches,152.0,br BRA,DF,38.0,37.0,37.0,3299.0,36.7,1.0,2.0,3.0,1.0,0.0,0.0,6.0,0.0,1.5,1.5,1.7,3.2,12.0,160.0,3.0,0.03,0.05,0.08,0.03,0.08,0.04,0.05,0.09,0.04,0.09,Matches,Dante,D C,38,135,160,"Brazil,Belgium",OGC Nice,4,5,12,8,15,4,16,5,8,15,16,5,16,13,15,16,18,16,14,17,15,19,17,18,12,15,16,16,5,7,17,15,16,5,13,17,15,12,18,7,10,4,2,2,3,4,2,1,1,3,2,2,16,15,10,18,18,18,15,15,1,8,20,1,8,1,1,1,1,1,1,1,1,1,188,89,20,11,676927,6750,6750,5000,African_Caribbean,140,14,1983/10/18,13,2,28747.0,,316742
877,Achraf Dari,Brest,1999,153.0,ma MAR,DF,23.0,14.6,21.0,14.0,15.0,5.0,1.0,14.0,20.0,70.0,6.0,16.0,10.0,6.0,19.0,40.0,65.0,2.0,Matches,153.0,ma MAR,DF,23.0,14.6,7.0,0.48,3.0,2.0,0.0,0.0,1.0,1.0,2.0,0.14,1.0,0.0,0.0,0.0,1.0,0.0,Matches,,,,,,,,,,,,,,,,,,,,,,,,,,,,,,,,,,,,,,,,,,,,,,,,,,,,,,,,153.0,ma MAR,DF,23.0,14.6,1.0,0.0,0.0,13.0,13.0,2.0,1.0,19.0,14.0,1.0,1.0,0.0,78.0,35.0,24.0,59.3,Matches,153.0,ma MAR,DF,23.0,14.6,690.0,661.0,27.0,27.0,0.0,7.0,1.0,0.0,0.0,0.0,0.0,0.0,547.0,2.0,4.0,Matches,153.0,ma MAR,DF,23.0,14.6,547.0,690.0,79.3,12287.0,4337.0,123.0,144.0,85.4,308.0,343.0,89.8,106.0,183.0,57.9,0.0,0.0,0.1,0.0,1.0,25.0,0.0,0.0,33.0,Matches,179,ma MAR,DF,23,18,1317.0,73.0,38.5,14.6,15,83.0,12,3,24.0,15,0.72,20.0,30.0,-10.0,-0.68,-0.68,15.8,22.6,-6.8,-0.46,-0.21,Matches,153.0,ma MAR,DF,23.0,14.6,846.0,135.0,480.0,356.0,16.0,9.0,846.0,1.0,1.0,100.0,0.0,0.0,561.0,2954.0,1268.0,3.0,1.0,0.0,4.0,3.0,493.0,1.0,Matches,153.0,ma MAR,DF,23.0,14.6,1.0,4.0,2.0,50.0,0.27,0.14,0.25,0.5,15.4,0.0,0.0,0.0,0.4,0.4,0.09,0.6,0.6,Matches,153.0,ma MAR,DF,23.0,18.0,15.0,1317.0,14.6,1.0,0.0,1.0,1.0,0.0,0.0,1.0,0.0,0.4,0.4,0.0,0.4,3.0,33.0,1.0,0.07,0.0,0.07,0.07,0.07,0.02,0.0,0.03,0.02,0.03,Matches,Achraf Dari,D C,23,123,139,Morocco,Stade Brestois 29,8,8,8,7,11,7,14,9,6,12,11,8,13,11,10,12,17,11,12,9,13,14,10,15,10,12,11,11,13,13,12,14,11,14,13,14,11,10,11,5,7,2,2,3,1,2,3,3,1,1,1,3,17,12,3,18,9,12,7,14,1,1,20,1,1,1,1,1,1,1,1,1,1,1,187,0,8,20,2698054,6150,6150,3000,North_African__Middle_Eastern,123,10,1999/5/6,2,0,8879.0,,13209513
878,Jonathan David,Lille,2000,154.0,ca CAN,FW,22.0,35.2,24.0,17.0,6.0,11.0,7.0,10.0,27.0,37.0,17.0,20.0,2.0,18.0,8.0,32.0,13.0,0.0,Matches,154.0,ca CAN,FW,22.0,35.2,116.0,3.3,84.0,0.0,6.0,13.0,11.0,2.0,13.0,0.37,9.0,0.0,0.0,2.0,2.0,0.0,Matches,,,,,,,,,,,,,,,,,,,,,,,,,,,,,,,,,,,,,,,,,,,,,,,,,,,,,,,,154.0,ca CAN,FW,22.0,35.2,6.0,0.0,0.0,41.0,59.0,23.0,7.0,8.0,17.0,0.0,0.0,0.0,89.0,16.0,64.0,20.0,Matches,154.0,ca CAN,FW,22.0,35.2,875.0,817.0,52.0,1.0,6.0,1.0,7.0,5.0,0.0,0.0,0.0,0.0,716.0,6.0,32.0,Matches,154.0,ca CAN,FW,22.0,35.2,716.0,875.0,81.8,9883.0,2246.0,423.0,495.0,85.5,215.0,255.0,84.3,28.0,30.0,93.3,4.0,6.1,5.7,-2.1,53.0,54.0,34.0,2.0,95.0,Matches,180,ca CAN,FW,22,37,3166.0,86.0,92.6,35.2,36,87.0,22,1,22.0,0,1.78,61.0,42.0,19.0,0.54,-0.17,63.5,37.0,26.5,0.75,0.15,Matches,154.0,ca CAN,FW,22.0,35.2,1224.0,23.0,87.0,529.0,622.0,214.0,1213.0,78.0,29.0,37.2,38.0,48.7,973.0,5196.0,1898.0,67.0,44.0,39.0,87.0,52.0,947.0,297.0,Matches,154.0,ca CAN,FW,22.0,35.2,24.0,95.0,44.0,46.3,2.7,1.25,0.15,0.32,15.8,0.0,10.0,11.0,23.6,15.1,0.16,0.4,-1.1,Matches,154.0,ca CAN,FW,22.0,37.0,36.0,3166.0,35.2,24.0,4.0,28.0,14.0,10.0,11.0,6.0,0.0,23.6,15.1,6.1,21.2,67.0,95.0,297.0,0.68,0.11,0.8,0.4,0.51,0.67,0.17,0.84,0.43,0.6,Matches,Jonathan David,AM/S RLC,22,139,155,"Canada,United States",LOSC Lille,8,10,13,14,14,10,7,11,5,7,13,15,6,13,12,13,12,13,11,12,12,12,12,12,12,4,12,14,16,12,12,9,14,15,12,13,12,8,14,7,14,2,1,3,1,2,1,3,1,2,1,1,11,14,2,9,10,11,13,20,1,1,1,1,1,1,1,1,1,1,18,20,18,19,177,77,12,20,66878046,6950,6900,5750,African_Caribbean,127,16,2000/1/14,32,21,41424.0,,18108540
879,Brecht Dejaegere,Toulouse,1991,156.0,be BEL,MF,31.0,20.1,40.0,23.0,10.0,20.0,10.0,15.0,51.0,29.4,36.0,25.0,5.0,20.0,14.0,54.0,11.0,0.0,Matches,156.0,be BEL,MF,31.0,20.1,48.0,2.39,40.0,0.0,4.0,2.0,2.0,0.0,6.0,0.3,4.0,0.0,1.0,1.0,0.0,0.0,Matches,,,,,,,,,,,,,,,,,,,,,,,,,,,,,,,,,,,,,,,,,,,,,,,,,,,,,,,,156.0,be BEL,MF,31.0,20.1,5.0,0.0,0.0,40.0,37.0,1.0,19.0,14.0,23.0,0.0,1.0,0.0,86.0,8.0,16.0,33.3,Matches,156.0,be BEL,MF,31.0,20.1,664.0,619.0,40.0,2.0,5.0,3.0,19.0,8.0,1.0,1.0,0.0,0.0,518.0,5.0,18.0,Matches,156.0,be BEL,MF,31.0,20.1,518.0,664.0,78.0,8008.0,2371.0,278.0,331.0,84.0,196.0,242.0,81.0,30.0,49.0,61.2,1.0,1.7,2.1,-0.7,17.0,56.0,25.0,0.0,96.0,Matches,183,be BEL,MF,31,30,1809.0,60.0,52.9,20.1,25,67.0,0,5,26.0,3,1.17,33.0,29.0,4.0,0.2,0.76,29.4,29.5,0.0,0.0,0.25,Matches,156.0,be BEL,MF,31.0,20.1,879.0,21.0,114.0,478.0,303.0,43.0,879.0,50.0,19.0,38.0,25.0,50.0,649.0,3832.0,1521.0,36.0,26.0,5.0,35.0,18.0,613.0,96.0,Matches,156.0,be BEL,MF,31.0,20.1,4.0,23.0,7.0,30.4,1.14,0.35,0.17,0.57,14.6,0.0,0.0,0.0,2.6,2.6,0.11,1.4,1.4,Matches,156.0,be BEL,MF,31.0,30.0,25.0,1809.0,20.1,4.0,1.0,5.0,4.0,0.0,0.0,5.0,0.0,2.6,2.6,1.7,4.3,36.0,96.0,96.0,0.2,0.05,0.25,0.2,0.25,0.13,0.08,0.21,0.13,0.21,Matches,Brecht Dejaegere,M C,31,124,128,Belgium,Toulouse FC,12,12,13,12,13,10,6,11,10,6,14,9,10,13,12,12,15,13,14,14,14,15,13,15,14,11,15,15,14,12,12,9,14,14,11,9,13,15,12,13,10,2,2,3,4,2,3,2,2,1,2,2,13,11,11,15,14,15,12,14,1,1,1,1,1,1,15,12,20,12,12,15,12,1,173,71,8,20,1702313,6200,6200,4500,Northern_European,123,2,1991/5/29,0,0,13999.0,,18004488
880,Romain Del Castillo,Brest,1996,157.0,fr FRA,MFFW,26.0,15.8,39.0,24.0,13.0,17.0,9.0,16.0,36.0,44.4,20.0,14.0,1.0,13.0,11.0,50.0,5.0,0.0,Matches,157.0,fr FRA,MFFW,26.0,15.8,68.0,4.31,40.0,18.0,3.0,3.0,2.0,2.0,13.0,0.82,8.0,3.0,1.0,0.0,1.0,0.0,Matches,,,,,,,,,,,,,,,,,,,,,,,,,,,,,,,,,,,,,,,,,,,,,,,,,,,,,,,,157.0,fr FRA,MFFW,26.0,15.8,2.0,0.0,0.0,19.0,24.0,1.0,101.0,11.0,24.0,1.0,0.0,0.0,86.0,18.0,24.0,42.9,Matches,157.0,fr FRA,MFFW,26.0,15.8,673.0,580.0,89.0,24.0,8.0,4.0,101.0,20.0,42.0,19.0,23.0,0.0,448.0,4.0,15.0,Matches,157.0,fr FRA,MFFW,26.0,15.8,448.0,673.0,66.6,7887.0,2950.0,215.0,279.0,77.1,146.0,207.0,70.5,66.0,137.0,48.2,6.0,4.2,4.2,1.8,36.0,44.0,36.0,9.0,75.0,Matches,184,fr FRA,MFFW,26,27,1422.0,53.0,41.6,15.8,16,72.0,0,11,25.0,0,1.22,24.0,23.0,1.0,0.06,0.56,23.1,24.6,-1.5,-0.1,0.41,Matches,157.0,fr FRA,MFFW,26.0,15.8,892.0,6.0,82.0,413.0,416.0,45.0,887.0,70.0,28.0,40.0,32.0,45.7,618.0,3955.0,1603.0,47.0,36.0,12.0,45.0,29.0,586.0,125.0,Matches,157.0,fr FRA,MFFW,26.0,15.8,6.0,31.0,11.0,35.5,1.96,0.7,0.03,0.09,20.7,3.0,5.0,5.0,6.2,2.3,0.07,-0.2,-1.3,Matches,157.0,fr FRA,MFFW,26.0,27.0,16.0,1422.0,15.8,6.0,6.0,12.0,1.0,5.0,5.0,2.0,0.0,6.2,2.3,4.2,6.5,47.0,75.0,125.0,0.38,0.38,0.76,0.06,0.44,0.39,0.27,0.66,0.14,0.41,Matches,Romain Del Castillo,AM RL,26,124,131,France,Stade Brestois 29,12,14,13,11,13,10,7,11,8,5,14,12,5,13,8,12,12,12,11,14,13,14,12,7,13,7,14,13,13,15,14,6,14,13,13,7,12,7,11,7,12,2,1,3,3,1,1,2,4,1,1,2,11,12,7,13,12,14,10,14,1,1,1,1,1,1,1,12,1,13,19,10,20,15,172,65,20,9,2761244,6200,6200,3705,Mediterranean_Hispanic,121,6,1996/3/29,0,0,9693.0,,48036653
881,Thomas Delaine,Strasbourg,1992,158.0,fr FRA,DFMF,30.0,11.9,28.0,14.0,16.0,6.0,6.0,13.0,26.0,50.0,13.0,8.0,3.0,5.0,16.0,44.0,9.0,0.0,Matches,158.0,fr FRA,DFMF,30.0,11.9,23.0,1.94,19.0,0.0,2.0,0.0,0.0,2.0,4.0,0.34,4.0,0.0,0.0,0.0,0.0,0.0,Matches,,,,,,,,,,,,,,,,,,,,,,,,,,,,,,,,,,,,,,,,,,,,,,,,,,,,,,,,158.0,fr FRA,DFMF,30.0,11.9,3.0,0.0,0.0,15.0,12.0,0.0,66.0,16.0,14.0,0.0,2.0,0.0,53.0,11.0,11.0,50.0,Matches,158.0,fr FRA,DFMF,30.0,11.9,537.0,432.0,104.0,4.0,1.0,1.0,66.0,100.0,0.0,0.0,0.0,0.0,356.0,1.0,24.0,Matches,158.0,fr FRA,DFMF,30.0,11.9,356.0,537.0,66.3,5526.0,1983.0,174.0,216.0,80.6,155.0,218.0,71.1,14.0,61.0,23.0,2.0,1.4,2.5,0.6,9.0,14.0,18.0,13.0,21.0,Matches,185,fr FRA,DFMF,30,17,1069.0,63.0,31.3,11.9,13,72.0,2,4,34.0,4,0.94,18.0,19.0,-1.0,-0.08,0.18,15.5,17.7,-2.2,-0.18,0.0,Matches,158.0,fr FRA,DFMF,30.0,11.9,642.0,28.0,148.0,267.0,239.0,20.0,642.0,27.0,12.0,44.4,11.0,40.7,415.0,2770.0,1239.0,38.0,27.0,9.0,18.0,5.0,374.0,92.0,Matches,158.0,fr FRA,DFMF,30.0,11.9,0.0,6.0,4.0,66.7,0.51,0.34,0.0,0.0,18.7,0.0,0.0,0.0,0.4,0.4,0.07,-0.4,-0.4,Matches,158.0,fr FRA,DFMF,30.0,17.0,13.0,1069.0,11.9,0.0,2.0,2.0,0.0,0.0,0.0,3.0,0.0,0.4,0.4,1.4,1.8,38.0,21.0,92.0,0.0,0.17,0.17,0.0,0.17,0.04,0.12,0.15,0.04,0.15,Matches,Thomas Delaine,D/WB RL,30,124,126,France,RC Strasbourg Alsace,6,13,11,10,12,6,8,9,9,10,11,8,11,12,8,11,14,12,12,12,12,15,8,9,13,10,14,15,13,13,13,10,14,13,15,13,13,10,11,7,14,3,1,3,1,1,3,2,2,3,3,3,12,13,5,14,12,15,14,16,1,20,7,16,17,14,1,12,1,12,12,1,10,1,180,72,20,10,1901115,6200,6200,3768,Northern_European,117,4,1992/3/24,0,0,9998.0,,85085647
882,Branco van den Boomen,Toulouse,1995,165.0,nl NED,MF,27.0,32.1,71.0,36.0,26.0,32.0,13.0,36.0,89.0,40.4,53.0,27.0,4.0,23.0,10.0,81.0,27.0,2.0,Matches,165.0,nl NED,MF,27.0,32.1,154.0,4.8,85.0,57.0,0.0,9.0,3.0,0.0,22.0,0.69,16.0,3.0,0.0,3.0,0.0,0.0,Matches,,,,,,,,,,,,,,,,,,,,,,,,,,,,,,,,,,,,,,,,,,,,,,,,,,,,,,,,165.0,nl NED,MF,27.0,32.1,6.0,0.0,0.0,33.0,19.0,2.0,282.0,10.0,36.0,0.0,0.0,0.0,182.0,6.0,12.0,33.3,Matches,165.0,nl NED,MF,27.0,32.1,2214.0,1891.0,310.0,89.0,12.0,70.0,282.0,21.0,169.0,58.0,101.0,0.0,1684.0,13.0,37.0,Matches,165.0,nl NED,MF,27.0,32.1,1684.0,2214.0,76.1,37506.0,12927.0,551.0,625.0,88.2,700.0,852.0,82.2,387.0,636.0,60.8,8.0,8.1,8.1,-0.1,88.0,270.0,51.0,13.0,321.0,Matches,192,nl NED,MF,27,35,2888.0,83.0,84.4,32.1,32,88.0,25,3,29.0,0,1.17,44.0,54.0,-10.0,-0.31,-0.99,44.4,49.6,-5.2,-0.16,-0.28,Matches,165.0,nl NED,MF,27.0,32.1,2457.0,43.0,385.0,1362.0,726.0,38.0,2453.0,38.0,19.0,50.0,14.0,36.8,1758.0,8854.0,3811.0,48.0,54.0,7.0,32.0,12.0,1682.0,102.0,Matches,165.0,nl NED,MF,27.0,32.1,5.0,48.0,20.0,41.7,1.5,0.62,0.02,0.05,25.1,16.0,4.0,4.0,6.0,2.9,0.06,-1.0,-1.9,Matches,165.0,nl NED,MF,27.0,35.0,32.0,2888.0,32.1,5.0,8.0,13.0,1.0,4.0,4.0,6.0,0.0,6.0,2.9,8.1,10.9,48.0,321.0,102.0,0.16,0.25,0.41,0.03,0.28,0.19,0.25,0.44,0.09,0.34,Matches,Branco van den Boomen,M C,27,127,130,Holland,Toulouse FC,16,12,10,12,14,16,9,14,4,10,15,15,11,14,14,12,15,13,13,14,14,17,12,12,13,12,15,13,12,12,12,14,15,11,13,12,14,8,12,5,9,2,1,2,2,1,2,3,2,3,3,2,11,15,8,7,9,15,8,12,1,1,1,1,1,1,14,1,20,1,1,15,1,1,188,75,7,20,2818248,6350,6350,3751,Northern_European,129,2,1995/7/21,0,0,12137.0,,37039831
883,Mikkel Desler,Toulouse,1995,167.0,dk DEN,DF,27.0,25.1,71.0,38.0,36.0,27.0,8.0,43.0,67.0,64.2,24.0,35.0,6.0,29.0,36.0,107.0,48.0,2.0,Matches,167.0,dk DEN,DF,27.0,25.1,49.0,1.96,42.0,1.0,2.0,3.0,1.0,0.0,5.0,0.2,5.0,0.0,0.0,0.0,0.0,0.0,Matches,,,,,,,,,,,,,,,,,,,,,,,,,,,,,,,,,,,,,,,,,,,,,,,,,,,,,,,,167.0,dk DEN,DF,27.0,25.1,5.0,1.0,1.0,28.0,32.0,6.0,42.0,36.0,38.0,0.0,0.0,0.0,165.0,23.0,9.0,71.9,Matches,167.0,dk DEN,DF,27.0,25.1,1573.0,1338.0,230.0,22.0,1.0,2.0,42.0,208.0,0.0,0.0,0.0,0.0,1336.0,5.0,36.0,Matches,167.0,dk DEN,DF,27.0,25.1,1336.0,1573.0,84.9,19956.0,7128.0,737.0,809.0,91.1,490.0,567.0,86.4,63.0,108.0,58.3,2.0,1.9,2.6,0.1,17.0,104.0,19.0,7.0,136.0,Matches,194,dk DEN,DF,27,27,2257.0,84.0,66.0,25.1,26,86.0,18,1,29.0,2,1.37,36.0,35.0,1.0,0.04,0.58,36.1,35.1,1.0,0.04,0.47,Matches,167.0,dk DEN,DF,27.0,25.1,1855.0,94.0,457.0,936.0,477.0,33.0,1855.0,51.0,27.0,52.9,16.0,31.4,1269.0,6952.0,3217.0,59.0,56.0,9.0,40.0,17.0,1146.0,127.0,Matches,167.0,dk DEN,DF,27.0,25.1,1.0,11.0,4.0,36.4,0.44,0.16,0.09,0.25,17.6,0.0,0.0,0.0,0.8,0.8,0.07,0.2,0.2,Matches,167.0,dk DEN,DF,27.0,27.0,26.0,2257.0,25.1,1.0,2.0,3.0,1.0,0.0,0.0,5.0,1.0,0.8,0.8,1.9,2.7,59.0,136.0,127.0,0.04,0.08,0.12,0.04,0.12,0.03,0.08,0.11,0.03,0.11,Matches,Mikkel Desler,D/WB R,27,122,130,Denmark,Toulouse FC,11,13,13,8,13,8,11,6,8,13,13,7,13,13,14,13,13,12,12,12,12,12,9,9,12,12,12,15,12,13,12,13,16,12,14,12,13,6,12,2,14,3,4,3,2,1,1,2,3,2,3,1,12,13,3,9,7,9,10,13,1,1,1,20,1,17,1,1,1,11,1,1,1,1,184,73,10,20,1570047,6100,5750,2790,Northern_European,122,1,1995/2/19,0,0,8064.0,,27053632
884,Bafodé Diakité,Lille,2001,169.0,fr FRA,DF,21.0,29.5,54.0,35.0,23.0,24.0,7.0,32.0,57.0,56.1,25.0,37.0,8.0,29.0,17.0,71.0,58.0,0.0,Matches,169.0,fr FRA,DF,21.0,29.5,36.0,1.22,28.0,2.0,1.0,3.0,1.0,1.0,0.0,0.0,0.0,0.0,0.0,0.0,0.0,0.0,Matches,,,,,,,,,,,,,,,,,,,,,,,,,,,,,,,,,,,,,,,,,,,,,,,,,,,,,,,,169.0,fr FRA,DF,21.0,29.5,6.0,0.0,0.0,45.0,13.0,0.0,19.0,17.0,35.0,0.0,0.0,1.0,159.0,41.0,41.0,50.0,Matches,169.0,fr FRA,DF,21.0,29.5,1944.0,1657.0,285.0,47.0,0.0,5.0,19.0,237.0,0.0,0.0,0.0,0.0,1728.0,2.0,26.0,Matches,169.0,fr FRA,DF,21.0,29.5,1728.0,1944.0,88.9,27426.0,8364.0,820.0,892.0,91.9,785.0,859.0,91.4,80.0,118.0,67.8,0.0,0.7,1.2,-0.7,7.0,139.0,13.0,2.0,179.0,Matches,196,fr FRA,DF,21,33,2653.0,80.0,77.6,29.5,29,87.0,25,4,31.0,1,1.79,48.0,33.0,15.0,0.51,-0.2,52.9,32.7,20.2,0.68,-0.26,Matches,169.0,fr FRA,DF,21.0,29.5,2189.0,84.0,545.0,1252.0,411.0,39.0,2189.0,30.0,19.0,63.3,8.0,26.7,1569.0,7572.0,3718.0,43.0,44.0,7.0,28.0,15.0,1460.0,67.0,Matches,169.0,fr FRA,DF,21.0,29.5,3.0,19.0,6.0,31.6,0.64,0.2,0.16,0.5,11.4,0.0,0.0,0.0,1.7,1.7,0.09,1.3,1.3,Matches,169.0,fr FRA,DF,21.0,33.0,29.0,2653.0,29.5,3.0,0.0,3.0,3.0,0.0,0.0,6.0,0.0,1.7,1.7,0.7,2.4,43.0,179.0,67.0,0.1,0.0,0.1,0.1,0.1,0.06,0.02,0.08,0.06,0.08,Matches,Bafodé Diakité,D RC,21,120,156,"France,Guinea",LOSC Lille,5,12,10,12,11,4,14,8,11,13,11,9,13,8,12,13,13,10,10,9,12,15,11,12,13,11,13,13,13,13,14,14,14,13,12,14,12,10,10,5,13,3,2,4,1,2,1,3,2,1,2,3,8,14,6,14,9,14,12,17,1,12,20,16,1,1,1,1,1,1,1,1,1,1,185,74,8,20,12280000,6000,6000,3500,African_Caribbean,120,17,2001/1/6,0,0,7256.0,,49038967
885,Habib Diallo,Strasbourg,1995,172.0,sn SEN,FW,27.0,32.0,18.0,10.0,8.0,7.0,3.0,6.0,16.0,37.5,10.0,19.0,4.0,15.0,12.0,30.0,26.0,0.0,Matches,172.0,sn SEN,FW,27.0,32.0,63.0,1.97,39.0,0.0,7.0,10.0,7.0,0.0,6.0,0.19,3.0,0.0,1.0,2.0,0.0,0.0,Matches,,,,,,,,,,,,,,,,,,,,,,,,,,,,,,,,,,,,,,,,,,,,,,,,,,,,,,,,172.0,sn SEN,FW,27.0,32.0,4.0,1.0,1.0,37.0,64.0,19.0,7.0,12.0,10.0,1.0,0.0,0.0,76.0,135.0,158.0,46.1,Matches,172.0,sn SEN,FW,27.0,32.0,597.0,575.0,17.0,1.0,7.0,4.0,7.0,0.0,0.0,0.0,0.0,0.0,397.0,5.0,31.0,Matches,172.0,sn SEN,FW,27.0,32.0,397.0,597.0,66.5,5478.0,968.0,245.0,348.0,70.4,109.0,147.0,74.1,16.0,24.0,66.7,1.0,3.5,4.0,-2.5,27.0,26.0,12.0,1.0,41.0,Matches,200,sn SEN,FW,27,37,2879.0,78.0,84.2,32.0,32,87.0,25,5,21.0,0,1.0,43.0,49.0,-6.0,-0.19,0.15,42.2,48.0,-5.8,-0.18,0.0,Matches,172.0,sn SEN,FW,27.0,32.0,1007.0,34.0,90.0,430.0,494.0,192.0,1003.0,71.0,29.0,40.8,39.0,54.9,665.0,3878.0,1285.0,40.0,28.0,20.0,118.0,35.0,768.0,203.0,Matches,172.0,sn SEN,FW,27.0,32.0,20.0,90.0,36.0,40.0,2.81,1.13,0.19,0.47,13.0,1.0,3.0,4.0,17.8,14.5,0.17,2.2,2.5,Matches,172.0,sn SEN,FW,27.0,37.0,32.0,2879.0,32.0,20.0,1.0,21.0,17.0,3.0,4.0,4.0,1.0,17.8,14.5,3.5,18.0,40.0,41.0,203.0,0.63,0.03,0.66,0.53,0.56,0.56,0.11,0.66,0.45,0.56,Matches,Habib Diallo,S,27,131,135,Senegal,RC Strasbourg Alsace,8,7,11,15,11,10,15,10,8,6,11,15,6,13,7,12,15,13,13,12,11,11,13,11,13,10,11,14,14,13,16,14,15,14,14,16,13,7,10,6,8,1,1,1,1,2,1,2,4,1,2,1,14,14,8,13,12,12,10,19,1,1,1,1,1,1,1,1,1,1,1,7,10,20,186,79,8,20,4950033,6550,6550,3810,African_Caribbean,131,15,1995/6/18,14,2,20711.0,,36515158
886,Habib Diarra,Strasbourg,2004,174.0,sn SEN,MFFW,18.0,18.1,24.0,16.0,10.0,11.0,3.0,15.0,29.0,51.7,14.0,17.0,1.0,16.0,11.0,35.0,13.0,0.0,Matches,174.0,sn SEN,MFFW,18.0,18.1,59.0,3.27,42.0,0.0,7.0,4.0,6.0,0.0,7.0,0.39,4.0,0.0,1.0,0.0,2.0,0.0,Matches,,,,,,,,,,,,,,,,,,,,,,,,,,,,,,,,,,,,,,,,,,,,,,,,,,,,,,,,174.0,sn SEN,MFFW,18.0,18.1,4.0,0.0,0.0,23.0,22.0,0.0,48.0,11.0,16.0,1.0,0.0,0.0,99.0,12.0,25.0,32.4,Matches,174.0,sn SEN,MFFW,18.0,18.1,660.0,628.0,32.0,3.0,3.0,3.0,48.0,20.0,1.0,0.0,0.0,0.0,506.0,0.0,13.0,Matches,174.0,sn SEN,MFFW,18.0,18.1,506.0,660.0,76.7,8400.0,1973.0,215.0,258.0,83.3,217.0,264.0,82.2,42.0,79.0,53.2,2.0,2.2,3.1,-0.2,24.0,42.0,21.0,10.0,52.0,Matches,202,sn SEN,MFFW,18,29,1626.0,56.0,47.5,18.1,18,76.0,6,11,24.0,6,1.14,27.0,27.0,0.0,0.0,0.4,24.1,22.2,1.9,0.1,0.54,Matches,174.0,sn SEN,MFFW,18.0,18.1,867.0,12.0,132.0,413.0,336.0,41.0,867.0,62.0,25.0,40.3,25.0,40.3,649.0,4270.0,2145.0,68.0,44.0,18.0,37.0,21.0,574.0,89.0,Matches,174.0,sn SEN,MFFW,18.0,18.1,3.0,23.0,9.0,39.1,1.27,0.5,0.13,0.33,20.1,0.0,0.0,0.0,1.8,1.8,0.08,1.2,1.2,Matches,174.0,sn SEN,MFFW,18.0,29.0,18.0,1626.0,18.1,3.0,2.0,5.0,3.0,0.0,0.0,4.0,0.0,1.8,1.8,2.2,4.1,68.0,52.0,89.0,0.17,0.11,0.28,0.17,0.28,0.1,0.12,0.22,0.1,0.22,Matches,Habib Diarra,M C,18,90,-75,"France,Senegal",RC Strasbourg Alsace,4,10,12,7,13,7,9,10,6,11,12,6,10,12,10,11,12,8,11,10,11,15,12,5,9,11,10,13,10,12,9,9,12,11,10,12,12,7,11,9,8,1,1,2,1,2,3,1,1,4,3,2,12,8,5,12,12,8,9,20,1,1,1,1,1,1,13,1,20,1,1,10,1,1,180,0,10,20,7131200,4498,4498,2250,African_Caribbean,90,16,2004/1/3,0,0,645.0,,2000025485
887,Stéphane Diarra,Lorient,1998,176.0,fr FRA,FWMF,23.0,11.8,25.0,17.0,14.0,9.0,2.0,11.0,29.0,37.9,18.0,13.0,1.0,12.0,22.0,47.0,9.0,0.0,Matches,176.0,fr FRA,FWMF,23.0,11.8,35.0,2.95,20.0,2.0,5.0,2.0,5.0,1.0,5.0,0.42,1.0,0.0,2.0,0.0,1.0,1.0,Matches,,,,,,,,,,,,,,,,,,,,,,,,,,,,,,,,,,,,,,,,,,,,,,,,,,,,,,,,176.0,fr FRA,FWMF,23.0,11.8,1.0,0.0,0.0,7.0,21.0,4.0,15.0,22.0,17.0,0.0,0.0,0.0,94.0,5.0,8.0,38.5,Matches,176.0,fr FRA,FWMF,23.0,11.8,328.0,313.0,15.0,1.0,0.0,0.0,15.0,10.0,4.0,2.0,0.0,0.0,240.0,0.0,15.0,Matches,176.0,fr FRA,FWMF,23.0,11.8,240.0,328.0,73.2,3312.0,1087.0,138.0,180.0,76.7,82.0,107.0,76.6,9.0,15.0,60.0,0.0,1.7,0.8,-1.7,11.0,8.0,12.0,1.0,33.0,Matches,204,fr FRA,FWMF,23,28,1066.0,38.0,31.2,11.8,14,62.0,0,14,14.0,9,1.46,21.0,22.0,-1.0,-0.08,-0.08,14.3,20.8,-6.4,-0.54,-0.26,Matches,176.0,fr FRA,FWMF,23.0,11.8,525.0,19.0,123.0,204.0,218.0,40.0,525.0,78.0,24.0,30.8,45.0,57.7,381.0,2900.0,1516.0,40.0,25.0,20.0,32.0,14.0,306.0,85.0,Matches,176.0,fr FRA,FWMF,23.0,11.8,2.0,20.0,8.0,40.0,1.69,0.68,0.1,0.25,16.2,0.0,0.0,0.0,2.2,2.2,0.11,-0.2,-0.2,Matches,176.0,fr FRA,FWMF,23.0,28.0,14.0,1066.0,11.8,2.0,0.0,2.0,2.0,0.0,0.0,1.0,0.0,2.2,2.2,1.7,4.0,40.0,33.0,85.0,0.17,0.0,0.17,0.17,0.17,0.19,0.15,0.33,0.19,0.33,Matches,Stéphane Diarra,M/AM RL,23,118,135,"Ivory Coast,France",FC Lorient,12,12,14,9,12,6,8,11,6,6,12,11,7,14,12,11,9,10,10,11,10,12,13,7,12,9,12,13,14,15,11,7,12,15,12,6,12,12,11,13,12,1,1,3,2,4,1,3,4,2,3,3,20,13,7,13,12,13,14,19,1,1,1,1,1,1,1,16,10,17,18,13,20,12,173,58,10,20,1648739,5900,5900,3254,African_Caribbean,114,13,1998/12/9,0,0,5757.0,,48042058
888,Krépin Diatta,Monaco,1999,177.0,sn SEN,MFFW,23.0,23.0,30.0,21.0,4.0,17.0,9.0,13.0,32.0,40.6,19.0,29.0,1.0,28.0,17.0,47.0,12.0,0.0,Matches,177.0,sn SEN,MFFW,23.0,23.0,68.0,2.95,44.0,1.0,8.0,7.0,5.0,3.0,7.0,0.3,2.0,0.0,0.0,1.0,3.0,1.0,Matches,,,,,,,,,,,,,,,,,,,,,,,,,,,,,,,,,,,,,,,,,,,,,,,,,,,,,,,,177.0,sn SEN,MFFW,23.0,23.0,3.0,0.0,0.0,20.0,26.0,10.0,54.0,17.0,21.0,2.0,0.0,0.0,94.0,41.0,40.0,50.6,Matches,177.0,sn SEN,MFFW,23.0,23.0,771.0,746.0,19.0,1.0,0.0,2.0,54.0,18.0,0.0,0.0,0.0,0.0,581.0,6.0,21.0,Matches,177.0,sn SEN,MFFW,23.0,23.0,581.0,771.0,75.4,8271.0,2607.0,336.0,404.0,83.2,189.0,258.0,73.3,25.0,48.0,52.1,2.0,3.4,3.9,-1.4,26.0,49.0,35.0,9.0,90.0,Matches,205,sn SEN,MFFW,23,31,2072.0,67.0,60.6,23.0,22,81.0,8,9,32.0,3,1.65,44.0,36.0,8.0,0.35,0.08,39.3,29.1,10.2,0.44,0.53,Matches,177.0,sn SEN,MFFW,23.0,23.0,1011.0,13.0,93.0,367.0,560.0,88.0,1011.0,61.0,32.0,52.5,18.0,29.5,745.0,4532.0,2035.0,80.0,51.0,28.0,45.0,20.0,720.0,229.0,Matches,177.0,sn SEN,MFFW,23.0,23.0,4.0,40.0,18.0,45.0,1.74,0.78,0.1,0.22,15.2,0.0,0.0,0.0,4.6,4.6,0.12,-0.6,-0.6,Matches,177.0,sn SEN,MFFW,23.0,31.0,22.0,2072.0,23.0,4.0,2.0,6.0,4.0,0.0,0.0,3.0,0.0,4.6,4.6,3.4,8.0,80.0,90.0,229.0,0.17,0.09,0.26,0.17,0.26,0.2,0.15,0.35,0.2,0.35,Matches,Krépin Diatta,WB/M/AM RLC,23,129,140,Senegal,AS Monaco,5,10,13,10,13,8,8,11,3,10,13,9,10,14,9,12,15,13,13,12,11,12,13,9,10,8,11,13,14,14,10,8,12,14,10,10,12,9,11,6,15,2,1,1,1,1,1,2,2,1,1,3,12,16,4,13,12,11,11,15,1,1,1,11,14,17,1,14,12,17,20,19,18,12,175,68,10,20,3316642,6450,6450,5000,African_Caribbean,115,17,1999/2/25,24,2,41424.0,,13191636
889,Mory Diaw,Clermont Foot,1993,178.0,sn SEN,GK,29.0,37.0,0.0,0.0,0.0,0.0,0.0,0.0,4.0,0.0,4.0,0.0,0.0,0.0,2.0,2.0,13.0,5.0,Matches,178.0,sn SEN,GK,29.0,37.0,7.0,0.19,6.0,1.0,0.0,0.0,0.0,0.0,0.0,0.0,0.0,0.0,0.0,0.0,0.0,0.0,Matches,11.0,sn SEN,GK,29.0,37.0,47.0,8.0,0.0,5.0,0.0,55.4,0.28,8.4,0.23,235.0,601.0,39.1,1209.0,173.0,40.0,37.0,255.0,45.9,40.4,464.0,34.0,7.3,25.0,0.68,11.5,Matches,11.0,sn SEN,GK,29.0,37.0,37.0,3330.0,37.0,47.0,1.27,161.0,110.0,75.8,17.0,8.0,12.0,10.0,27.0,12.0,8.0,4.0,0.0,33.3,Matches,178.0,sn SEN,GK,29.0,37.0,0.0,0.0,0.0,0.0,6.0,0.0,0.0,2.0,0.0,0.0,0.0,0.0,31.0,5.0,0.0,100.0,Matches,178.0,sn SEN,GK,29.0,37.0,1467.0,1034.0,430.0,175.0,0.0,8.0,0.0,0.0,0.0,0.0,0.0,0.0,1034.0,3.0,1.0,Matches,178.0,sn SEN,GK,29.0,37.0,1034.0,1467.0,70.5,30947.0,21906.0,160.0,163.0,98.2,455.0,467.0,97.4,412.0,826.0,49.9,0.0,0.2,0.1,-0.2,4.0,34.0,3.0,0.0,0.0,Matches,206,sn SEN,GK,29,37,3330.0,90.0,97.4,37.0,37,90.0,37,0,,0,1.59,44.0,47.0,-3.0,-0.08,0.92,46.9,56.9,-10.0,-0.27,0.5,Matches,178.0,sn SEN,GK,29.0,37.0,1561.0,1266.0,1549.0,12.0,0.0,0.0,1561.0,1.0,1.0,100.0,0.0,0.0,1064.0,5707.0,3786.0,0.0,0.0,0.0,0.0,0.0,698.0,0.0,Matches,178.0,sn SEN,GK,29.0,37.0,0.0,0.0,0.0,,0.0,0.0,,,,0.0,0.0,0.0,0.0,0.0,,0.0,0.0,Matches,178.0,sn SEN,GK,29.0,37.0,37.0,3330.0,37.0,0.0,0.0,0.0,0.0,0.0,0.0,0.0,0.0,0.0,0.0,0.2,0.2,0.0,0.0,0.0,0.0,0.0,0.0,0.0,0.0,0.0,0.0,0.0,0.0,0.0,Matches,Mory Diaw,GK,29,123,130,"Senegal,France",Clermont Foot 63,4,3,2,3,9,6,1,10,3,3,11,1,2,8,9,12,14,13,7,12,10,9,11,10,1,12,10,12,11,11,16,16,14,10,12,15,12,6,10,7,14,14,11,12,12,13,18,13,16,14,12,12,12,12,12,8,7,12,11,15,20,1,1,1,1,1,1,1,1,1,1,1,1,1,198,98,8,20,1828481,6140,6140,3503,African_Caribbean,120,16,1993/6/22,0,0,8739.0,,85057316
890,Sofiane Diop,Nice,2000,185.0,fr FRA,MFFW,22.0,13.6,23.0,11.0,12.0,6.0,5.0,7.0,20.0,35.0,13.0,14.0,2.0,12.0,16.0,39.0,5.0,0.0,Matches,185.0,fr FRA,MFFW,22.0,13.6,57.0,4.18,37.0,8.0,5.0,3.0,2.0,2.0,8.0,0.59,5.0,1.0,0.0,2.0,0.0,0.0,Matches,,,,,,,,,,,,,,,,,,,,,,,,,,,,,,,,,,,,,,,,,,,,,,,,,,,,,,,,185.0,fr FRA,MFFW,22.0,13.6,1.0,0.0,0.0,9.0,27.0,2.0,44.0,16.0,11.0,0.0,0.0,0.0,94.0,10.0,6.0,62.5,Matches,185.0,fr FRA,MFFW,22.0,13.6,703.0,655.0,47.0,11.0,6.0,11.0,44.0,7.0,28.0,12.0,8.0,0.0,556.0,1.0,15.0,Matches,185.0,fr FRA,MFFW,22.0,13.6,556.0,703.0,79.1,8948.0,2261.0,283.0,336.0,84.2,199.0,246.0,80.9,46.0,71.0,64.8,4.0,1.9,1.9,2.1,21.0,53.0,18.0,4.0,72.0,Matches,216,fr FRA,MFFW,22,22,1228.0,56.0,35.9,13.6,14,73.0,3,8,26.0,0,1.77,21.0,10.0,11.0,0.81,0.81,22.8,16.7,6.1,0.45,0.19,Matches,185.0,fr FRA,MFFW,22.0,13.6,876.0,14.0,133.0,431.0,324.0,34.0,876.0,49.0,22.0,44.9,24.0,49.0,695.0,4490.0,1888.0,55.0,35.0,10.0,39.0,21.0,638.0,91.0,Matches,185.0,fr FRA,MFFW,22.0,13.6,1.0,28.0,9.0,32.1,2.05,0.66,0.04,0.11,20.0,1.0,0.0,0.0,2.6,2.6,0.09,-1.6,-1.6,Matches,185.0,fr FRA,MFFW,22.0,22.0,14.0,1228.0,13.6,1.0,4.0,5.0,1.0,0.0,0.0,1.0,0.0,2.6,2.6,1.9,4.4,55.0,72.0,91.0,0.07,0.29,0.37,0.07,0.37,0.19,0.14,0.33,0.19,0.33,Matches,Sofiane Diop,M/AM RLC,22,134,152,"France,Morocco,Senegal",OGC Nice,13,12,14,11,14,12,8,10,2,4,14,12,8,15,13,12,13,12,13,13,12,15,15,8,13,6,12,14,15,14,13,6,14,15,14,10,14,7,12,6,15,3,3,3,1,2,2,2,1,3,3,2,11,16,8,12,13,13,13,12,1,1,1,1,1,1,1,17,12,16,15,20,17,1,175,65,9,20,19965200,6700,6700,4500,North_African__Middle_Eastern,128,9,2000/6/9,0,0,19999.0,,49037827
891,Axel Disasi,Monaco,1998,188.0,fr FRA,DF,24.0,37.0,30.0,20.0,13.0,13.0,4.0,13.0,27.0,48.1,14.0,51.0,31.0,20.0,56.0,86.0,112.0,2.0,Matches,188.0,fr FRA,DF,24.0,37.0,26.0,0.7,22.0,1.0,0.0,2.0,0.0,1.0,6.0,0.16,5.0,0.0,0.0,1.0,0.0,0.0,Matches,,,,,,,,,,,,,,,,,,,,,,,,,,,,,,,,,,,,,,,,,,,,,,,,,,,,,,,,188.0,fr FRA,DF,24.0,37.0,3.0,0.0,0.0,31.0,12.0,0.0,14.0,56.0,20.0,0.0,0.0,0.0,236.0,97.0,41.0,70.3,Matches,188.0,fr FRA,DF,24.0,37.0,1957.0,1882.0,71.0,50.0,2.0,25.0,14.0,21.0,0.0,0.0,0.0,0.0,1630.0,4.0,17.0,Matches,188.0,fr FRA,DF,24.0,37.0,1630.0,1957.0,83.3,32964.0,12826.0,524.0,593.0,88.4,873.0,970.0,90.0,203.0,330.0,61.5,3.0,1.2,1.7,1.8,9.0,211.0,12.0,3.0,206.0,Matches,219,fr FRA,DF,24,38,3330.0,88.0,97.4,37.0,37,89.0,36,1,20.0,0,1.71,67.0,56.0,11.0,0.3,-0.7,60.0,52.1,7.9,0.21,-0.72,Matches,188.0,fr FRA,DF,24.0,37.0,2293.0,234.0,832.0,1326.0,161.0,51.0,2292.0,29.0,21.0,72.4,8.0,27.6,1662.0,11330.0,6779.0,64.0,45.0,5.0,18.0,17.0,1484.0,17.0,Matches,188.0,fr FRA,DF,24.0,37.0,3.0,28.0,9.0,32.1,0.76,0.24,0.11,0.33,15.4,0.0,0.0,1.0,3.8,3.0,0.11,-0.8,0.0,Matches,188.0,fr FRA,DF,24.0,38.0,37.0,3330.0,37.0,3.0,3.0,6.0,3.0,0.0,1.0,3.0,0.0,3.8,3.0,1.2,4.2,64.0,206.0,17.0,0.08,0.08,0.16,0.08,0.16,0.1,0.03,0.13,0.08,0.11,Matches,Axel Disasi,D C,24,136,148,France,AS Monaco,5,6,8,6,11,5,16,5,10,14,11,8,14,10,12,13,15,12,12,10,13,13,6,12,10,13,12,14,13,11,14,15,14,14,15,18,14,12,13,8,8,2,2,3,2,4,1,3,3,2,2,3,7,15,7,12,12,14,12,15,1,1,20,10,1,1,1,1,1,1,1,1,1,1,190,86,8,20,15468353,6800,6800,4750,African_Caribbean,135,16,1998/3/11,0,0,17260.0,,48037291
892,Tiago Djaló,Lille,2000,189.0,pt POR,DF,22.0,22.4,31.0,21.0,23.0,7.0,1.0,13.0,20.0,65.0,7.0,17.0,11.0,6.0,23.0,54.0,60.0,1.0,Matches,189.0,pt POR,DF,22.0,22.4,10.0,0.45,8.0,0.0,0.0,1.0,1.0,0.0,3.0,0.13,2.0,0.0,0.0,0.0,1.0,0.0,Matches,,,,,,,,,,,,,,,,,,,,,,,,,,,,,,,,,,,,,,,,,,,,,,,,,,,,,,,,189.0,pt POR,DF,22.0,22.4,7.0,0.0,0.0,19.0,18.0,1.0,3.0,23.0,21.0,1.0,1.0,1.0,167.0,28.0,31.0,47.5,Matches,189.0,pt POR,DF,22.0,22.4,1599.0,1511.0,84.0,36.0,0.0,3.0,3.0,20.0,0.0,0.0,0.0,0.0,1481.0,4.0,11.0,Matches,189.0,pt POR,DF,22.0,22.4,1481.0,1599.0,92.6,25798.0,8970.0,629.0,666.0,94.4,696.0,724.0,96.1,119.0,152.0,78.3,0.0,0.1,0.3,-0.1,2.0,72.0,0.0,0.0,70.0,Matches,220,pt POR,DF,22,25,2017.0,81.0,59.0,22.4,24,83.0,18,1,20.0,0,1.68,41.0,24.0,17.0,0.76,0.5,41.6,22.2,19.4,0.86,0.3,Matches,189.0,pt POR,DF,22.0,22.4,1780.0,173.0,763.0,976.0,57.0,18.0,1780.0,14.0,5.0,35.7,6.0,42.9,1409.0,7349.0,3933.0,9.0,15.0,1.0,5.0,8.0,1272.0,4.0,Matches,189.0,pt POR,DF,22.0,22.4,2.0,15.0,4.0,26.7,0.67,0.18,0.13,0.5,12.7,0.0,0.0,0.0,1.3,1.3,0.08,0.7,0.7,Matches,189.0,pt POR,DF,22.0,25.0,24.0,2017.0,22.4,2.0,0.0,2.0,2.0,0.0,0.0,7.0,0.0,1.3,1.3,0.1,1.4,9.0,70.0,4.0,0.09,0.0,0.09,0.09,0.09,0.06,0.01,0.06,0.06,0.06,Matches,Tiago Djaló,D LC,22,125,150,"Portugal,Guinea-Bissau",LOSC Lille,4,10,10,6,9,4,14,11,11,14,10,7,14,10,14,14,13,10,11,11,10,15,6,11,9,14,11,12,14,10,14,15,15,14,13,15,12,14,9,5,8,1,2,1,2,3,1,2,1,1,3,3,12,14,5,13,14,14,13,14,1,15,20,13,1,1,1,1,1,1,1,1,1,1,190,85,10,20,8454999,6240,6918,3270,African_Caribbean,124,13,2000/4/9,0,0,9204.0,,83169969
893,Alexander Djiku,Strasbourg,1994,190.0,gh GHA,DF,27.0,29.7,53.0,36.0,37.0,16.0,0.0,26.0,46.0,56.5,20.0,45.0,19.0,26.0,66.0,119.0,151.0,3.0,Matches,190.0,gh GHA,DF,27.0,29.7,24.0,0.81,22.0,1.0,0.0,1.0,0.0,0.0,5.0,0.17,5.0,0.0,0.0,0.0,0.0,0.0,Matches,,,,,,,,,,,,,,,,,,,,,,,,,,,,,,,,,,,,,,,,,,,,,,,,,,,,,,,,190.0,gh GHA,DF,27.0,29.7,8.0,1.0,0.0,39.0,26.0,2.0,6.0,66.0,36.0,0.0,0.0,0.0,162.0,92.0,35.0,72.4,Matches,190.0,gh GHA,DF,27.0,29.7,1507.0,1431.0,72.0,56.0,0.0,20.0,6.0,9.0,0.0,0.0,0.0,0.0,1215.0,4.0,13.0,Matches,190.0,gh GHA,DF,27.0,29.7,1215.0,1507.0,80.6,25533.0,10650.0,326.0,384.0,84.9,679.0,778.0,87.3,190.0,303.0,62.7,2.0,0.7,1.2,1.3,11.0,117.0,13.0,4.0,136.0,Matches,221,gh GHA,DF,27,31,2677.0,86.0,78.3,29.7,31,86.0,27,0,,2,1.13,40.0,44.0,-4.0,-0.13,0.35,38.4,43.7,-5.3,-0.18,0.0,Matches,190.0,gh GHA,DF,27.0,29.7,1873.0,241.0,878.0,932.0,74.0,26.0,1873.0,6.0,4.0,66.7,2.0,33.3,1173.0,6156.0,2955.0,4.0,9.0,1.0,8.0,7.0,1035.0,4.0,Matches,190.0,gh GHA,DF,27.0,29.7,1.0,17.0,5.0,29.4,0.57,0.17,0.06,0.2,14.4,1.0,0.0,0.0,1.4,1.4,0.08,-0.4,-0.4,Matches,190.0,gh GHA,DF,27.0,31.0,31.0,2677.0,29.7,1.0,2.0,3.0,1.0,0.0,0.0,8.0,1.0,1.4,1.4,0.7,2.1,4.0,136.0,4.0,0.03,0.07,0.1,0.03,0.1,0.05,0.02,0.07,0.05,0.07,Matches,Alexander Djiku,D C,27,133,136,"Ghana,France",RC Strasbourg Alsace,6,11,10,5,12,6,15,5,11,14,11,8,14,12,15,13,17,13,15,8,13,14,10,10,10,14,13,15,13,12,15,12,15,13,15,14,14,12,11,6,11,1,3,2,3,3,2,3,3,2,4,2,7,14,7,13,12,13,12,12,1,1,20,10,1,1,15,1,1,1,1,1,1,1,182,74,8,20,4097847,6644,6644,4100,African_Caribbean,134,12,1994/8/9,17,1,16097.0,,48036760
894,Gianluigi Donnarumma,Paris S-G,1999,197.0,it ITA,GK,23.0,37.9,1.0,0.0,1.0,0.0,0.0,1.0,2.0,50.0,1.0,0.0,0.0,0.0,0.0,1.0,12.0,4.0,Matches,197.0,it ITA,GK,23.0,37.9,1.0,0.03,1.0,0.0,0.0,0.0,0.0,0.0,0.0,0.0,0.0,0.0,0.0,0.0,0.0,0.0,Matches,14.0,it ITA,GK,23.0,37.9,40.0,2.0,1.0,3.0,1.0,43.3,0.26,4.3,0.11,54.0,148.0,36.5,728.0,167.0,15.0,23.9,207.0,18.8,24.1,436.0,33.0,7.6,27.0,0.71,12.1,Matches,14.0,it ITA,GK,23.0,38.0,38.0,3409.0,37.9,40.0,1.06,160.0,120.0,76.3,27.0,4.0,7.0,13.0,34.2,5.0,2.0,1.0,2.0,33.3,Matches,197.0,it ITA,GK,23.0,37.9,3.0,0.0,0.0,1.0,4.0,0.0,0.0,0.0,0.0,0.0,1.0,0.0,44.0,7.0,1.0,87.5,Matches,197.0,it ITA,GK,23.0,37.9,935.0,681.0,254.0,47.0,0.0,1.0,0.0,0.0,0.0,0.0,0.0,0.0,811.0,0.0,1.0,Matches,197.0,it ITA,GK,23.0,37.9,811.0,935.0,86.7,16498.0,10725.0,259.0,260.0,99.6,413.0,420.0,98.3,126.0,241.0,52.3,0.0,0.0,0.0,0.0,0.0,2.0,0.0,0.0,0.0,Matches,228,it ITA,GK,23,38,3409.0,90.0,99.7,37.9,38,90.0,37,0,,0,2.24,89.0,40.0,49.0,1.29,1.29,78.1,48.3,29.8,0.79,-0.05,Matches,197.0,it ITA,GK,23.0,37.9,1021.0,909.0,1016.0,6.0,0.0,0.0,1021.0,1.0,1.0,100.0,0.0,0.0,695.0,3076.0,1895.0,0.0,0.0,0.0,0.0,0.0,447.0,0.0,Matches,197.0,it ITA,GK,23.0,37.9,0.0,0.0,0.0,,0.0,0.0,,,,0.0,0.0,0.0,0.0,0.0,,0.0,0.0,Matches,197.0,it ITA,GK,23.0,38.0,38.0,3409.0,37.9,0.0,0.0,0.0,0.0,0.0,0.0,3.0,0.0,0.0,0.0,0.0,0.0,0.0,0.0,0.0,0.0,0.0,0.0,0.0,0.0,0.0,0.0,0.0,0.0,0.0,Matches,Gianluigi Donnarumma,GK,23,162,178,Italy,Paris Saint-Germain,1,2,4,3,7,1,7,3,8,3,7,6,7,6,8,16,16,14,14,8,15,15,6,14,2,15,15,13,10,16,16,18,15,12,15,16,17,4,15,4,1,16,14,15,9,15,13,16,18,11,14,12,9,16,5,4,15,13,15,14,20,1,1,1,1,1,1,1,1,1,1,1,1,1,196,90,7,20,138933453,8100,8100,7800,Mediterranean_Hispanic,163,6,1999/2/25,46,0,249315.0,,43252073
895,Désiré Doué,Rennes,2005,201.0,fr FRA,MFFW,17.0,12.4,37.0,18.0,10.0,23.0,4.0,13.0,32.0,40.6,19.0,17.0,1.0,16.0,13.0,50.0,3.0,0.0,Matches,201.0,fr FRA,MFFW,17.0,12.4,35.0,2.82,23.0,3.0,3.0,1.0,3.0,2.0,2.0,0.16,2.0,0.0,0.0,0.0,0.0,0.0,Matches,,,,,,,,,,,,,,,,,,,,,,,,,,,,,,,,,,,,,,,,,,,,,,,,,,,,,,,,201.0,fr FRA,MFFW,17.0,12.4,5.0,0.0,0.0,37.0,28.0,4.0,30.0,13.0,18.0,0.0,0.0,0.0,64.0,10.0,13.0,43.5,Matches,201.0,fr FRA,MFFW,17.0,12.4,453.0,437.0,15.0,1.0,3.0,1.0,30.0,1.0,12.0,6.0,3.0,0.0,351.0,1.0,4.0,Matches,201.0,fr FRA,MFFW,17.0,12.4,351.0,453.0,77.5,6004.0,1339.0,167.0,212.0,78.8,129.0,158.0,81.6,38.0,54.0,70.4,1.0,1.5,1.3,-0.5,15.0,41.0,13.0,1.0,57.0,Matches,232,fr FRA,MFFW,17,26,1115.0,43.0,32.6,12.4,11,68.0,0,15,25.0,3,1.73,22.0,14.0,8.0,0.65,-0.21,17.8,15.5,2.3,0.19,-0.4,Matches,201.0,fr FRA,MFFW,17.0,12.4,651.0,10.0,61.0,351.0,254.0,34.0,651.0,79.0,48.0,60.8,23.0,29.1,502.0,3396.0,1508.0,39.0,33.0,9.0,33.0,32.0,463.0,83.0,Matches,201.0,fr FRA,MFFW,17.0,12.4,3.0,21.0,6.0,28.6,1.7,0.48,0.14,0.5,21.0,0.0,0.0,0.0,1.6,1.6,0.07,1.4,1.4,Matches,201.0,fr FRA,MFFW,17.0,26.0,11.0,1115.0,12.4,3.0,1.0,4.0,3.0,0.0,0.0,5.0,0.0,1.6,1.6,1.5,3.1,39.0,57.0,83.0,0.24,0.08,0.32,0.24,0.32,0.13,0.12,0.25,0.13,0.25,Matches,Désiré Doué,M/AM C,17,109,-9,France,Stade Rennais FC,11,10,14,10,14,10,8,9,4,9,13,10,9,14,5,10,12,11,11,13,11,15,14,7,10,8,11,11,13,14,11,8,13,13,12,11,11,5,9,4,7,1,1,1,2,1,2,3,1,2,1,1,13,15,5,16,10,14,14,18,1,1,1,1,1,1,1,1,20,1,1,16,1,1,181,0,10,20,48164165,5450,5450,3014,African_Caribbean,108,12,2005/6/3,0,0,3470.0,,2000115202
896,Ismaël Doukouré,Strasbourg,2003,203.0,fr FRA,DFMF,19.0,25.5,48.0,24.0,23.0,21.0,4.0,20.0,34.0,58.8,14.0,26.0,8.0,18.0,27.0,75.0,54.0,0.0,Matches,203.0,fr FRA,DFMF,19.0,25.5,20.0,0.78,17.0,0.0,1.0,1.0,1.0,0.0,2.0,0.08,2.0,0.0,0.0,0.0,0.0,0.0,Matches,,,,,,,,,,,,,,,,,,,,,,,,,,,,,,,,,,,,,,,,,,,,,,,,,,,,,,,,203.0,fr FRA,DFMF,19.0,25.5,5.0,0.0,0.0,30.0,27.0,0.0,11.0,27.0,24.0,0.0,0.0,0.0,148.0,29.0,37.0,43.9,Matches,203.0,fr FRA,DFMF,19.0,25.5,1106.0,1010.0,95.0,44.0,3.0,13.0,11.0,50.0,0.0,0.0,0.0,0.0,910.0,1.0,16.0,Matches,203.0,fr FRA,DFMF,19.0,25.5,910.0,1106.0,82.3,17110.0,6266.0,348.0,396.0,87.9,430.0,487.0,88.3,101.0,176.0,57.4,1.0,0.4,0.9,0.6,4.0,99.0,9.0,2.0,99.0,Matches,234,fr FRA,DFMF,19,28,2297.0,82.0,67.2,25.5,25,87.0,20,3,40.0,9,1.11,33.0,34.0,-1.0,-0.04,0.52,30.5,29.9,0.6,0.02,0.62,Matches,203.0,fr FRA,DFMF,19.0,25.5,1340.0,85.0,467.0,784.0,108.0,3.0,1340.0,45.0,29.0,64.4,12.0,26.7,953.0,5737.0,2683.0,27.0,25.0,2.0,21.0,20.0,830.0,20.0,Matches,203.0,fr FRA,DFMF,19.0,25.5,1.0,9.0,2.0,22.2,0.35,0.08,0.11,0.5,25.4,0.0,0.0,0.0,0.3,0.3,0.03,0.7,0.7,Matches,203.0,fr FRA,DFMF,19.0,28.0,25.0,2297.0,25.5,1.0,1.0,2.0,1.0,0.0,0.0,5.0,0.0,0.3,0.3,0.4,0.7,27.0,99.0,20.0,0.04,0.04,0.08,0.04,0.08,0.01,0.02,0.03,0.01,0.03,Matches,Ismaël Doukouré,D C,19,102,-75,"France,Ivory Coast",RC Strasbourg Alsace,8,3,10,4,10,7,13,5,10,11,12,5,12,13,5,12,11,11,12,11,10,5,5,8,9,10,10,11,10,12,13,12,13,10,9,12,11,10,16,9,7,3,3,1,3,2,3,3,1,2,1,2,10,12,7,10,12,13,9,13,1,1,20,1,1,1,1,1,1,1,1,1,1,1,183,80,11,20,20543999,5089,5089,2339,African_Caribbean,93,18,2003/7/24,0,0,1535.0,,2000016808
897,Kamory Doumbia,Reims,2003,204.0,ml MLI,MF,19.0,12.8,31.0,16.0,9.0,14.0,8.0,12.0,37.0,32.4,25.0,17.0,1.0,16.0,13.0,44.0,3.0,0.0,Matches,204.0,ml MLI,MF,19.0,12.8,41.0,3.19,34.0,0.0,2.0,2.0,2.0,1.0,3.0,0.23,3.0,0.0,0.0,0.0,0.0,0.0,Matches,,,,,,,,,,,,,,,,,,,,,,,,,,,,,,,,,,,,,,,,,,,,,,,,,,,,,,,,204.0,ml MLI,MF,19.0,12.8,0.0,0.0,0.0,15.0,9.0,0.0,9.0,13.0,16.0,0.0,0.0,0.0,83.0,7.0,22.0,24.1,Matches,204.0,ml MLI,MF,19.0,12.8,538.0,523.0,9.0,3.0,5.0,1.0,9.0,4.0,1.0,0.0,0.0,0.0,428.0,6.0,14.0,Matches,204.0,ml MLI,MF,19.0,12.8,428.0,538.0,79.6,6994.0,2058.0,202.0,241.0,83.8,179.0,212.0,84.4,31.0,47.0,66.0,2.0,2.9,1.6,-0.9,18.0,66.0,14.0,1.0,85.0,Matches,235,ml MLI,MF,19,26,1155.0,44.0,33.8,12.8,13,66.0,0,13,23.0,9,1.35,17.0,12.0,5.0,0.39,0.59,23.6,16.5,7.1,0.55,0.48,Matches,204.0,ml MLI,MF,19.0,12.8,708.0,14.0,93.0,368.0,254.0,37.0,707.0,36.0,18.0,50.0,16.0,44.4,536.0,3098.0,1318.0,29.0,21.0,3.0,34.0,20.0,486.0,82.0,Matches,204.0,ml MLI,MF,19.0,12.8,2.0,25.0,9.0,36.0,1.95,0.7,0.04,0.11,19.8,0.0,1.0,1.0,3.7,2.9,0.12,-1.7,-1.9,Matches,204.0,ml MLI,MF,19.0,26.0,13.0,1155.0,12.8,2.0,2.0,4.0,1.0,1.0,1.0,0.0,0.0,3.7,2.9,2.9,5.8,29.0,85.0,82.0,0.16,0.16,0.31,0.08,0.23,0.29,0.23,0.51,0.23,0.45,Matches,Kamory Doumbia,M/AM C,19,102,-75,Mali,Stade de Reims,9,9,11,12,13,7,10,10,6,6,12,10,5,12,11,12,13,11,11,12,9,13,12,8,12,7,11,11,12,14,11,10,13,12,12,11,10,8,10,5,11,2,1,1,2,3,3,3,1,1,2,2,11,11,7,13,12,12,14,18,1,1,1,1,1,1,1,1,20,1,1,18,1,15,183,0,10,20,12448000,5099,5099,2261,African_Caribbean,97,17,2003/2/18,0,0,1511.0,,12088460
898,Souleyman Doumbia,Angers,1996,205.0,ci CIV,DFFW,25.0,19.9,45.0,31.0,31.0,13.0,1.0,17.0,31.0,54.8,14.0,20.0,3.0,17.0,27.0,72.0,27.0,1.0,Matches,205.0,ci CIV,DFFW,25.0,19.9,32.0,1.61,25.0,0.0,3.0,0.0,3.0,1.0,0.0,0.0,0.0,0.0,0.0,0.0,0.0,0.0,Matches,,,,,,,,,,,,,,,,,,,,,,,,,,,,,,,,,,,,,,,,,,,,,,,,,,,,,,,,205.0,ci CIV,DFFW,25.0,19.9,2.0,1.0,0.0,27.0,20.0,3.0,48.0,27.0,31.0,0.0,0.0,0.0,118.0,18.0,14.0,56.3,Matches,205.0,ci CIV,DFFW,25.0,19.9,952.0,779.0,173.0,16.0,0.0,0.0,48.0,154.0,3.0,3.0,0.0,0.0,762.0,0.0,26.0,Matches,205.0,ci CIV,DFFW,25.0,19.9,762.0,952.0,80.0,11455.0,3777.0,417.0,478.0,87.2,284.0,350.0,81.1,36.0,75.0,48.0,0.0,1.6,1.7,-1.6,12.0,46.0,16.0,11.0,58.0,Matches,236,ci CIV,DFFW,25,24,1790.0,75.0,52.3,19.9,21,82.0,15,3,25.0,0,0.38,14.0,42.0,-28.0,-1.41,-0.3,22.6,29.4,-6.7,-0.34,0.44,Matches,205.0,ci CIV,DFFW,25.0,19.9,1183.0,52.0,341.0,586.0,276.0,20.0,1183.0,77.0,27.0,35.1,38.0,49.4,786.0,5076.0,2556.0,52.0,43.0,11.0,28.0,10.0,703.0,95.0,Matches,205.0,ci CIV,DFFW,25.0,19.9,0.0,7.0,2.0,28.6,0.35,0.1,0.0,0.0,16.0,0.0,0.0,0.0,1.0,1.0,0.14,-1.0,-1.0,Matches,205.0,ci CIV,DFFW,25.0,24.0,21.0,1790.0,19.9,0.0,0.0,0.0,0.0,0.0,0.0,2.0,1.0,1.0,1.0,1.6,2.6,52.0,58.0,95.0,0.0,0.0,0.0,0.0,0.0,0.05,0.08,0.13,0.05,0.13,Matches,Souleyman Doumbia,D/WB L,25,125,130,"Ivory Coast,France",Angers SCO,8,12,10,5,10,7,9,10,12,13,12,5,13,12,10,11,13,12,11,10,11,12,11,9,13,11,14,13,15,14,13,9,12,16,14,13,14,5,12,2,13,3,4,2,2,1,3,3,2,3,2,3,12,12,8,9,8,12,10,12,1,20,1,1,19,1,1,10,1,1,1,1,1,1,175,64,20,8,1946340,6250,6250,3800,African_Caribbean,119,17,1996/9/24,4,0,13800.0,,48030646
899,Maxime Dupé,Toulouse,1993,207.0,fr FRA,GK,29.0,38.0,0.0,0.0,0.0,0.0,0.0,0.0,0.0,,0.0,0.0,0.0,0.0,0.0,0.0,9.0,3.0,Matches,207.0,fr FRA,GK,29.0,38.0,2.0,0.05,1.0,0.0,0.0,1.0,0.0,0.0,0.0,0.0,0.0,0.0,0.0,0.0,0.0,0.0,Matches,15.0,fr FRA,GK,29.0,38.0,57.0,4.0,2.0,8.0,3.0,54.2,0.28,0.2,0.01,136.0,363.0,37.5,1006.0,176.0,24.4,29.5,264.0,44.7,37.2,517.0,30.0,5.8,21.0,0.55,10.1,Matches,15.0,fr FRA,GK,29.0,38.0,38.0,3420.0,38.0,57.0,1.5,179.0,122.0,70.4,13.0,9.0,16.0,9.0,23.7,7.0,4.0,3.0,0.0,42.9,Matches,207.0,fr FRA,GK,29.0,38.0,2.0,0.0,0.0,1.0,4.0,0.0,0.0,0.0,0.0,0.0,1.0,0.0,27.0,9.0,0.0,100.0,Matches,207.0,fr FRA,GK,29.0,38.0,1271.0,918.0,352.0,88.0,0.0,2.0,0.0,0.0,0.0,0.0,0.0,0.0,994.0,1.0,1.0,Matches,207.0,fr FRA,GK,29.0,38.0,994.0,1271.0,78.2,25377.0,16802.0,169.0,169.0,100.0,560.0,570.0,98.2,258.0,523.0,49.3,0.0,0.0,0.0,0.0,0.0,6.0,0.0,0.0,0.0,Matches,239,fr FRA,GK,29,38,3420.0,90.0,100.0,38.0,38,90.0,38,0,,0,1.26,51.0,57.0,-6.0,-0.16,,52.5,57.0,-4.5,-0.12,,Matches,207.0,fr FRA,GK,29.0,38.0,1372.0,1064.0,1364.0,7.0,1.0,1.0,1372.0,2.0,2.0,100.0,0.0,0.0,941.0,5150.0,3364.0,0.0,0.0,0.0,2.0,0.0,686.0,0.0,Matches,207.0,fr FRA,GK,29.0,38.0,0.0,1.0,0.0,0.0,0.03,0.0,0.0,,13.4,0.0,0.0,0.0,0.0,0.0,0.04,0.0,0.0,Matches,207.0,fr FRA,GK,29.0,38.0,38.0,3420.0,38.0,0.0,0.0,0.0,0.0,0.0,0.0,2.0,0.0,0.0,0.0,0.0,0.0,0.0,0.0,0.0,0.0,0.0,0.0,0.0,0.0,0.0,0.0,0.0,0.0,0.0,Matches,Maxime Dupé,GK,29,124,127,France,Toulouse FC,4,2,1,3,9,7,1,1,3,3,10,2,3,9,7,12,14,12,12,10,13,14,3,11,2,13,12,10,8,13,14,14,14,11,12,15,13,7,5,7,1,13,12,14,7,13,12,12,14,7,13,12,9,13,6,15,9,14,12,18,20,1,1,1,1,1,1,1,1,1,1,1,1,1,188,88,8,20,1540280,6192,6192,3742,Northern_European,124,3,1993/3/4,0,0,9693.0,,85027990
900,Jean-Kevin Duverne,Brest,1997,208.0,ht HAI,DF,25.0,27.9,72.0,38.0,44.0,24.0,4.0,42.0,73.0,57.5,31.0,33.0,5.0,28.0,28.0,100.0,65.0,1.0,Matches,208.0,ht HAI,DF,25.0,27.9,48.0,1.72,32.0,4.0,5.0,0.0,7.0,0.0,4.0,0.14,0.0,0.0,0.0,0.0,4.0,0.0,Matches,,,,,,,,,,,,,,,,,,,,,,,,,,,,,,,,,,,,,,,,,,,,,,,,,,,,,,,,208.0,ht HAI,DF,25.0,27.9,2.0,0.0,0.0,39.0,20.0,4.0,85.0,28.0,38.0,2.0,0.0,0.0,159.0,33.0,22.0,60.0,Matches,208.0,ht HAI,DF,25.0,27.9,1480.0,1188.0,285.0,16.0,0.0,9.0,85.0,269.0,0.0,0.0,0.0,0.0,1059.0,7.0,39.0,Matches,208.0,ht HAI,DF,25.0,27.9,1059.0,1480.0,71.6,18165.0,7953.0,521.0,601.0,86.7,385.0,531.0,72.5,117.0,248.0,47.2,0.0,0.8,1.0,-0.8,10.0,113.0,14.0,8.0,149.0,Matches,240,ht HAI,DF,25,34,2515.0,74.0,73.5,27.9,27,88.0,22,7,20.0,4,1.24,34.0,39.0,-5.0,-0.18,0.32,33.8,38.4,-4.6,-0.16,0.64,Matches,208.0,ht HAI,DF,25.0,27.9,1775.0,96.0,486.0,887.0,434.0,18.0,1775.0,65.0,26.0,40.0,30.0,46.2,1099.0,7192.0,3960.0,80.0,71.0,10.0,39.0,20.0,979.0,134.0,Matches,208.0,ht HAI,DF,25.0,27.9,0.0,5.0,1.0,20.0,0.18,0.04,0.0,0.0,17.2,0.0,0.0,0.0,0.4,0.4,0.08,-0.4,-0.4,Matches,208.0,ht HAI,DF,25.0,34.0,27.0,2515.0,27.9,0.0,0.0,0.0,0.0,0.0,0.0,2.0,0.0,0.4,0.4,0.8,1.2,80.0,149.0,134.0,0.0,0.0,0.0,0.0,0.0,0.01,0.03,0.04,0.01,0.04,Matches,Jean-Kevin Duverne,D RLC,25,128,140,"France,Haiti",Stade Brestois 29,5,10,10,6,12,5,14,6,10,13,13,7,14,12,12,13,15,13,12,10,12,14,10,12,9,13,14,14,12,13,14,14,15,13,15,15,12,8,11,10,11,3,3,3,1,2,1,3,3,1,3,1,9,14,12,10,14,12,13,12,1,19,20,15,1,1,1,1,1,1,1,1,1,1,182,71,8,20,2835154,6391,6391,3802,African_Caribbean,129,14,1997/7/12,0,0,6898.0,,29132976
901,Hugo Ekitike,Paris S-G,2002,209.0,fr FRA,FW,20.0,12.8,12.0,4.0,1.0,10.0,1.0,4.0,12.0,33.3,8.0,12.0,0.0,12.0,9.0,21.0,3.0,0.0,Matches,209.0,fr FRA,FW,20.0,12.8,33.0,2.57,25.0,0.0,3.0,2.0,3.0,0.0,7.0,0.55,6.0,0.0,1.0,0.0,0.0,0.0,Matches,,,,,,,,,,,,,,,,,,,,,,,,,,,,,,,,,,,,,,,,,,,,,,,,,,,,,,,,209.0,fr FRA,FW,20.0,12.8,0.0,0.0,0.0,15.0,13.0,7.0,2.0,9.0,4.0,0.0,0.0,0.0,42.0,8.0,12.0,40.0,Matches,209.0,fr FRA,FW,20.0,12.8,331.0,310.0,20.0,1.0,3.0,1.0,2.0,0.0,0.0,0.0,0.0,0.0,271.0,1.0,6.0,Matches,209.0,fr FRA,FW,20.0,12.8,271.0,331.0,81.9,3321.0,391.0,188.0,221.0,85.1,54.0,71.0,76.1,6.0,9.0,66.7,4.0,1.6,1.6,2.4,11.0,13.0,11.0,0.0,23.0,Matches,241,fr FRA,FW,20,25,1155.0,46.0,33.8,12.8,12,71.0,0,13,24.0,12,2.16,31.0,18.0,13.0,1.01,-0.42,25.5,16.0,9.5,0.74,-0.07,Matches,209.0,fr FRA,FW,20.0,12.8,473.0,5.0,32.0,202.0,250.0,63.0,473.0,39.0,16.0,41.0,18.0,46.2,353.0,2225.0,764.0,23.0,19.0,7.0,28.0,18.0,337.0,84.0,Matches,209.0,fr FRA,FW,20.0,12.8,3.0,34.0,12.0,35.3,2.65,0.94,0.09,0.25,14.8,0.0,0.0,0.0,3.7,3.7,0.11,-0.7,-0.7,Matches,209.0,fr FRA,FW,20.0,25.0,12.0,1155.0,12.8,3.0,4.0,7.0,3.0,0.0,0.0,0.0,0.0,3.7,3.7,1.6,5.3,23.0,23.0,84.0,0.23,0.31,0.55,0.23,0.55,0.29,0.13,0.42,0.29,0.42,Matches,Hugo Ekitike,AM/S R,20,124,155,"France,Cameroon",Stade de Reims,10,11,12,13,12,9,13,11,9,6,12,11,6,12,12,12,13,12,11,11,12,12,12,7,12,6,11,12,14,12,12,14,13,14,12,13,10,6,11,8,12,3,3,3,1,1,2,1,2,3,1,2,11,13,8,9,10,12,10,14,1,1,1,1,1,1,1,11,1,13,14,10,18,20,189,70,12,20,14080000,6200,6200,4000,African_Caribbean,122,9,2002/6/20,0,0,9847.0,Paris Saint-Germain,49062667
902,Breel Embolo,Monaco,1997,211.0,ch SUI,FW,25.0,20.7,15.0,9.0,2.0,7.0,6.0,5.0,10.0,50.0,5.0,14.0,3.0,11.0,5.0,20.0,12.0,0.0,Matches,211.0,ch SUI,FW,25.0,20.7,63.0,3.05,42.0,0.0,6.0,8.0,6.0,1.0,10.0,0.48,5.0,0.0,1.0,3.0,1.0,0.0,Matches,,,,,,,,,,,,,,,,,,,,,,,,,,,,,,,,,,,,,,,,,,,,,,,,,,,,,,,,211.0,ch SUI,FW,25.0,20.7,3.0,0.0,0.0,50.0,56.0,14.0,4.0,5.0,9.0,2.0,1.0,0.0,59.0,33.0,47.0,41.3,Matches,211.0,ch SUI,FW,25.0,20.7,448.0,424.0,16.0,1.0,3.0,3.0,4.0,1.0,0.0,0.0,0.0,0.0,307.0,8.0,21.0,Matches,211.0,ch SUI,FW,25.0,20.7,307.0,448.0,68.5,4498.0,1110.0,168.0,228.0,73.7,91.0,128.0,71.1,21.0,25.0,84.0,2.0,3.2,2.4,-1.2,28.0,27.0,19.0,0.0,52.0,Matches,244,ch SUI,FW,25,32,1859.0,58.0,54.4,20.7,19,80.0,11,13,26.0,0,1.72,39.0,32.0,7.0,0.34,0.05,33.0,29.7,3.3,0.16,-0.16,Matches,211.0,ch SUI,FW,25.0,20.7,708.0,20.0,42.0,299.0,378.0,100.0,707.0,73.0,32.0,43.8,35.0,47.9,522.0,2799.0,906.0,24.0,27.0,13.0,66.0,46.0,553.0,159.0,Matches,211.0,ch SUI,FW,25.0,20.7,12.0,40.0,20.0,50.0,1.94,0.97,0.3,0.6,10.9,0.0,0.0,1.0,8.5,7.6,0.19,3.5,4.4,Matches,211.0,ch SUI,FW,25.0,32.0,19.0,1859.0,20.7,12.0,2.0,14.0,12.0,0.0,1.0,3.0,0.0,8.5,7.6,3.2,10.8,24.0,52.0,159.0,0.58,0.1,0.68,0.58,0.68,0.41,0.16,0.57,0.37,0.52,Matches,Breel Embolo,AM/S RC,25,141,145,"Switzerland,Cameroon",AS Monaco,6,8,14,12,12,7,13,12,6,7,13,12,8,14,16,13,16,11,10,14,11,15,15,6,15,7,15,16,14,13,16,14,12,16,13,17,11,12,14,12,14,1,2,1,1,3,2,2,1,1,1,2,14,14,17,12,11,8,10,9,1,1,1,1,1,1,6,12,10,15,12,17,18,20,187,88,10,20,25187932,7050,7000,6250,African_Caribbean,135,16,1997/2/14,56,9,67122.0,,98029385
903,Maxime Estève,Montpellier,2002,212.0,fr FRA,DF,20.0,18.3,24.0,13.0,17.0,5.0,2.0,12.0,17.0,70.6,5.0,28.0,17.0,11.0,34.0,58.0,90.0,0.0,Matches,212.0,fr FRA,DF,20.0,18.3,7.0,0.38,5.0,1.0,0.0,1.0,0.0,0.0,0.0,0.0,0.0,0.0,0.0,0.0,0.0,0.0,Matches,,,,,,,,,,,,,,,,,,,,,,,,,,,,,,,,,,,,,,,,,,,,,,,,,,,,,,,,212.0,fr FRA,DF,20.0,18.3,3.0,0.0,0.0,18.0,7.0,0.0,1.0,34.0,13.0,0.0,0.0,1.0,96.0,31.0,26.0,54.4,Matches,212.0,fr FRA,DF,20.0,18.3,748.0,712.0,35.0,30.0,0.0,0.0,1.0,4.0,0.0,0.0,0.0,0.0,609.0,1.0,8.0,Matches,212.0,fr FRA,DF,20.0,18.3,609.0,748.0,81.4,11413.0,3907.0,213.0,248.0,85.9,325.0,361.0,90.0,55.0,113.0,48.7,0.0,0.1,0.3,-0.1,1.0,38.0,0.0,0.0,44.0,Matches,245,fr FRA,DF,20,23,1646.0,72.0,48.1,18.3,18,86.0,15,5,21.0,4,1.17,24.0,29.0,-5.0,-0.27,-0.68,23.0,34.8,-11.8,-0.65,-0.74,Matches,212.0,fr FRA,DF,20.0,18.3,944.0,146.0,515.0,408.0,27.0,12.0,944.0,6.0,4.0,66.7,2.0,33.3,607.0,3154.0,1667.0,9.0,4.0,0.0,4.0,4.0,522.0,1.0,Matches,212.0,fr FRA,DF,20.0,18.3,0.0,6.0,0.0,0.0,0.33,0.0,0.0,,9.5,0.0,0.0,0.0,0.6,0.6,0.09,-0.6,-0.6,Matches,212.0,fr FRA,DF,20.0,23.0,18.0,1646.0,18.3,0.0,0.0,0.0,0.0,0.0,0.0,3.0,0.0,0.6,0.6,0.1,0.6,9.0,44.0,1.0,0.0,0.0,0.0,0.0,0.0,0.03,0.0,0.03,0.03,0.03,Matches,Maxime Estève,D C,20,121,-85,France,Montpellier Hérault SC,5,5,6,4,11,4,13,8,5,13,12,11,10,12,12,14,13,14,13,10,13,13,5,10,10,13,13,13,13,10,12,13,12,16,12,15,14,8,14,10,17,2,1,3,1,2,1,3,2,1,1,1,11,13,7,10,15,14,14,14,1,14,20,1,1,1,1,1,1,1,1,1,1,1,193,87,20,8,39665476,6050,6050,3250,Northern_European,120,4,2002/5/26,0,0,5336.0,,49060933
904,Noah Fadiga,Brest,1999,214.0,sn SEN,DF,22.0,14.5,30.0,21.0,18.0,9.0,3.0,14.0,26.0,53.8,12.0,17.0,7.0,10.0,26.0,56.0,18.0,0.0,Matches,214.0,sn SEN,DF,22.0,14.5,15.0,1.03,8.0,0.0,3.0,0.0,3.0,1.0,2.0,0.14,1.0,0.0,1.0,0.0,0.0,0.0,Matches,,,,,,,,,,,,,,,,,,,,,,,,,,,,,,,,,,,,,,,,,,,,,,,,,,,,,,,,214.0,sn SEN,DF,22.0,14.5,2.0,0.0,0.0,22.0,18.0,1.0,10.0,26.0,21.0,1.0,1.0,0.0,80.0,8.0,8.0,50.0,Matches,214.0,sn SEN,DF,22.0,14.5,625.0,504.0,120.0,8.0,0.0,1.0,10.0,112.0,0.0,0.0,0.0,0.0,499.0,1.0,14.0,Matches,214.0,sn SEN,DF,22.0,14.5,499.0,625.0,79.8,7725.0,2860.0,241.0,283.0,85.2,219.0,251.0,87.3,20.0,52.0,38.5,0.0,0.1,0.6,-0.1,2.0,39.0,10.0,3.0,63.0,Matches,247,sn SEN,DF,22,21,1308.0,62.0,38.2,14.5,16,77.0,7,5,15.0,2,0.86,14.0,23.0,-9.0,-0.62,-0.58,16.6,22.5,-5.9,-0.41,-0.12,Matches,214.0,sn SEN,DF,22.0,14.5,790.0,39.0,218.0,403.0,175.0,19.0,790.0,40.0,18.0,45.0,21.0,52.5,488.0,3212.0,1755.0,43.0,30.0,8.0,23.0,6.0,423.0,36.0,Matches,214.0,sn SEN,DF,22.0,14.5,1.0,11.0,3.0,27.3,0.76,0.21,0.09,0.33,18.3,0.0,0.0,0.0,0.7,0.7,0.07,0.3,0.3,Matches,214.0,sn SEN,DF,22.0,21.0,16.0,1308.0,14.5,1.0,0.0,1.0,1.0,0.0,0.0,2.0,0.0,0.7,0.7,0.1,0.8,43.0,63.0,36.0,0.07,0.0,0.07,0.07,0.07,0.05,0.01,0.06,0.05,0.06,Matches,Noah Fadiga,D/WB/M/AM R,22,121,139,"Senegal,Belgium",Stade Brestois 29,7,11,13,9,14,7,4,8,10,8,10,8,9,13,9,11,14,13,10,9,10,5,14,7,8,9,11,13,15,11,7,8,13,15,14,8,12,11,8,5,12,1,3,2,3,1,1,2,3,3,4,2,11,16,9,8,11,12,11,12,1,1,1,20,1,18,1,1,1,16,1,1,16,1,187,77,14,20,3055999,6045,6045,3750,Mixed_Race,100,13,1999/12/3,0,0,3999.0,,18092701
905,Romain Faivre,Lorient,1998,216.0,fr FRA,MFFW,24.0,13.8,13.0,8.0,5.0,4.0,4.0,5.0,25.0,20.0,20.0,11.0,0.0,11.0,1.0,14.0,4.0,0.0,Matches,216.0,fr FRA,MFFW,24.0,13.8,45.0,3.25,27.0,1.0,10.0,3.0,4.0,0.0,9.0,0.65,5.0,0.0,4.0,0.0,0.0,0.0,Matches,,,,,,,,,,,,,,,,,,,,,,,,,,,,,,,,,,,,,,,,,,,,,,,,,,,,,,,,216.0,fr FRA,MFFW,24.0,13.8,0.0,0.0,0.0,12.0,35.0,1.0,26.0,1.0,8.0,1.0,0.0,0.0,62.0,0.0,10.0,0.0,Matches,216.0,fr FRA,MFFW,24.0,13.8,543.0,496.0,44.0,16.0,4.0,2.0,26.0,6.0,19.0,11.0,3.0,0.0,452.0,3.0,11.0,Matches,216.0,fr FRA,MFFW,24.0,13.8,452.0,543.0,83.2,6643.0,1953.0,254.0,290.0,87.6,152.0,178.0,85.4,22.0,37.0,59.5,3.0,2.1,2.6,0.9,17.0,33.0,22.0,2.0,67.0,Matches,250,fr FRA,MFFW,24,16,1246.0,78.0,36.4,13.8,14,83.0,6,2,40.0,0,1.19,14.0,15.0,-1.0,-0.07,-0.07,15.2,17.6,-2.4,-0.17,0.29,Matches,216.0,fr FRA,MFFW,24.0,13.8,688.0,5.0,71.0,342.0,289.0,43.0,688.0,88.0,48.0,54.5,27.0,30.7,557.0,4523.0,2310.0,77.0,56.0,17.0,30.0,9.0,520.0,66.0,Matches,216.0,fr FRA,MFFW,24.0,13.8,5.0,25.0,14.0,56.0,1.81,1.01,0.2,0.36,17.0,0.0,0.0,0.0,2.7,2.7,0.11,2.3,2.3,Matches,216.0,fr FRA,MFFW,24.0,16.0,14.0,1246.0,13.8,5.0,3.0,8.0,5.0,0.0,0.0,0.0,0.0,2.7,2.7,2.1,4.8,77.0,67.0,66.0,0.36,0.22,0.58,0.36,0.58,0.19,0.15,0.34,0.19,0.34,Matches,Romain Faivre,M/AM RLC,24,134,146,France,Olympique Lyonnais,11,11,14,12,14,13,9,12,5,6,13,11,6,14,10,11,11,13,13,13,12,13,12,8,13,8,13,12,14,14,13,12,13,14,14,12,13,7,12,6,13,2,3,3,3,2,1,2,1,1,1,2,14,12,6,13,12,14,14,13,1,1,1,1,1,1,1,13,18,13,17,20,19,1,185,75,20,12,23437930,6700,6700,3900,North_African__Middle_Eastern,130,7,1998/7/14,0,0,24687.0,,49040542
906,Jordan Ferri,Montpellier,1992,221.0,fr FRA,MF,30.0,30.4,55.0,35.0,32.0,19.0,4.0,30.0,89.0,33.7,59.0,22.0,6.0,16.0,26.0,81.0,21.0,0.0,Matches,221.0,fr FRA,MF,30.0,30.4,71.0,2.33,65.0,1.0,2.0,1.0,2.0,0.0,7.0,0.23,6.0,1.0,0.0,0.0,0.0,0.0,Matches,,,,,,,,,,,,,,,,,,,,,,,,,,,,,,,,,,,,,,,,,,,,,,,,,,,,,,,,221.0,fr FRA,MF,30.0,30.4,7.0,1.0,1.0,47.0,61.0,1.0,30.0,26.0,35.0,0.0,2.0,0.0,278.0,17.0,25.0,40.5,Matches,221.0,fr FRA,MF,30.0,30.4,1989.0,1880.0,101.0,83.0,7.0,17.0,30.0,14.0,1.0,0.0,0.0,0.0,1695.0,8.0,25.0,Matches,221.0,fr FRA,MF,30.0,30.4,1695.0,1989.0,85.2,30870.0,9895.0,716.0,793.0,90.3,705.0,785.0,89.8,213.0,310.0,68.7,2.0,3.0,3.3,-1.0,31.0,155.0,28.0,6.0,209.0,Matches,257,fr FRA,MF,30,34,2738.0,81.0,80.1,30.4,32,84.0,20,2,28.0,0,1.26,52.0,50.0,2.0,0.07,-0.07,42.3,45.5,-3.2,-0.11,0.79,Matches,221.0,fr FRA,MF,30.0,30.4,2237.0,59.0,542.0,1401.0,321.0,10.0,2237.0,55.0,20.0,36.4,22.0,40.0,1785.0,9143.0,4174.0,37.0,47.0,2.0,43.0,44.0,1610.0,42.0,Matches,221.0,fr FRA,MF,30.0,30.4,1.0,14.0,2.0,14.3,0.46,0.07,0.07,0.5,24.1,0.0,0.0,0.0,0.8,0.8,0.06,0.2,0.2,Matches,221.0,fr FRA,MF,30.0,34.0,32.0,2738.0,30.4,1.0,2.0,3.0,1.0,0.0,0.0,7.0,1.0,0.8,0.8,3.0,3.8,37.0,209.0,42.0,0.03,0.07,0.1,0.03,0.1,0.03,0.1,0.13,0.03,0.13,Matches,Jordan Ferri,DM/M C,30,134,138,France,Montpellier Hérault SC,12,13,12,8,13,11,7,10,7,11,15,9,14,14,15,14,18,13,12,13,13,15,12,15,13,14,17,16,13,13,15,7,12,12,15,12,15,14,13,4,9,1,1,1,3,4,4,2,3,2,1,2,18,14,8,14,13,14,12,12,1,1,1,1,1,1,18,1,20,1,1,1,1,1,173,73,8,20,6270684,6700,6700,3917,Northern_European,134,6,1992/3/12,0,0,29897.0,,85003943
907,Yahia Fofana,Angers,2000,225.0,ci CIV,GK,21.0,11.0,0.0,0.0,0.0,0.0,0.0,0.0,0.0,,0.0,0.0,0.0,0.0,1.0,1.0,4.0,1.0,Matches,225.0,ci CIV,GK,21.0,11.0,2.0,0.18,2.0,0.0,0.0,0.0,0.0,0.0,1.0,0.09,1.0,0.0,0.0,0.0,0.0,0.0,Matches,16.0,ci CIV,GK,21.0,11.0,19.0,1.0,0.0,3.0,1.0,16.4,0.27,-1.6,-0.14,33.0,125.0,26.4,256.0,70.0,35.2,33.6,69.0,50.7,41.7,143.0,17.0,11.9,9.0,0.82,11.8,Matches,16.0,ci CIV,GK,21.0,11.0,11.0,990.0,11.0,19.0,1.73,54.0,35.0,66.7,3.0,1.0,7.0,1.0,9.1,2.0,1.0,1.0,0.0,50.0,Matches,225.0,ci CIV,GK,21.0,11.0,2.0,0.0,0.0,0.0,1.0,0.0,0.0,1.0,0.0,0.0,0.0,0.0,16.0,5.0,0.0,100.0,Matches,225.0,ci CIV,GK,21.0,11.0,325.0,229.0,96.0,27.0,0.0,0.0,0.0,0.0,0.0,0.0,0.0,0.0,227.0,0.0,0.0,Matches,225.0,ci CIV,GK,21.0,11.0,227.0,325.0,69.8,6001.0,4360.0,42.0,42.0,100.0,112.0,113.0,99.1,71.0,168.0,42.3,0.0,0.0,0.0,0.0,0.0,3.0,0.0,0.0,0.0,Matches,262,ci CIV,GK,21,11,990.0,90.0,28.9,11.0,11,90.0,11,0,,16,0.91,12.0,19.0,-7.0,-0.64,0.88,12.8,15.4,-2.6,-0.23,0.44,Matches,225.0,ci CIV,GK,21.0,11.0,353.0,309.0,351.0,2.0,0.0,0.0,353.0,1.0,1.0,100.0,0.0,0.0,239.0,1386.0,989.0,0.0,1.0,1.0,0.0,0.0,124.0,0.0,Matches,225.0,ci CIV,GK,21.0,11.0,0.0,0.0,0.0,,0.0,0.0,,,,0.0,0.0,0.0,0.0,0.0,,0.0,0.0,Matches,225.0,ci CIV,GK,21.0,11.0,11.0,990.0,11.0,0.0,0.0,0.0,0.0,0.0,0.0,2.0,0.0,0.0,0.0,0.0,0.0,0.0,0.0,0.0,0.0,0.0,0.0,0.0,0.0,0.0,0.0,0.0,0.0,0.0,Matches,Yahia Fofana,GK,21,112,148,France,Angers SCO,2,2,2,1,7,3,7,3,1,3,8,3,2,8,10,12,12,8,11,8,10,13,8,8,6,12,10,8,10,14,10,14,12,10,10,14,12,8,12,7,1,12,11,12,15,12,13,12,15,11,11,11,11,12,10,10,11,10,12,10,20,1,1,1,1,1,1,1,1,1,1,1,1,1,194,89,6,20,4495999,5588,5588,2738,African_Caribbean,106,17,2000/8/21,0,0,3939.0,,48043476
908,Youssouf Fofana,Monaco,1999,226.0,fr FRA,MF,23.0,34.3,81.0,41.0,31.0,42.0,8.0,38.0,74.0,51.4,36.0,50.0,6.0,44.0,56.0,137.0,32.0,1.0,Matches,226.0,fr FRA,MF,23.0,34.3,78.0,2.27,68.0,0.0,6.0,0.0,2.0,2.0,11.0,0.32,9.0,0.0,0.0,0.0,1.0,1.0,Matches,,,,,,,,,,,,,,,,,,,,,,,,,,,,,,,,,,,,,,,,,,,,,,,,,,,,,,,,226.0,fr FRA,MF,23.0,34.3,4.0,2.0,1.0,50.0,39.0,2.0,7.0,56.0,41.0,0.0,0.0,1.0,265.0,23.0,19.0,54.8,Matches,226.0,fr FRA,MF,23.0,34.3,1738.0,1683.0,44.0,30.0,11.0,13.0,7.0,3.0,0.0,0.0,0.0,0.0,1419.0,11.0,21.0,Matches,226.0,fr FRA,MF,23.0,34.3,1419.0,1738.0,81.6,24636.0,7618.0,617.0,748.0,82.5,602.0,688.0,87.5,146.0,211.0,69.2,2.0,4.4,3.0,-2.4,32.0,185.0,34.0,0.0,238.0,Matches,263,fr FRA,MF,23,36,3086.0,86.0,90.2,34.3,35,87.0,32,1,45.0,0,1.78,65.0,48.0,17.0,0.5,1.84,56.5,45.3,11.2,0.33,0.95,Matches,226.0,fr FRA,MF,23.0,34.3,2116.0,59.0,352.0,1340.0,454.0,37.0,2116.0,91.0,46.0,50.5,40.0,44.0,1600.0,9328.0,4753.0,81.0,90.0,9.0,48.0,41.0,1416.0,71.0,Matches,226.0,fr FRA,MF,23.0,34.3,2.0,42.0,10.0,23.8,1.22,0.29,0.05,0.2,22.9,1.0,0.0,0.0,2.8,2.8,0.07,-0.8,-0.8,Matches,226.0,fr FRA,MF,23.0,36.0,35.0,3086.0,34.3,2.0,2.0,4.0,2.0,0.0,0.0,4.0,2.0,2.8,2.8,4.4,7.2,81.0,238.0,71.0,0.06,0.06,0.12,0.06,0.12,0.08,0.13,0.21,0.08,0.21,Matches,Youssouf Fofana,DM/M C,23,139,153,France,AS Monaco,7,9,14,8,14,7,12,10,8,12,14,8,15,12,15,14,14,13,14,13,14,15,10,8,13,13,14,15,13,12,15,9,16,13,16,15,12,9,12,7,10,2,2,3,3,4,1,4,1,2,3,1,16,14,8,14,12,14,14,16,1,1,1,1,1,1,20,1,19,1,1,1,1,1,176,0,10,20,20334671,6945,6945,4995,African_Caribbean,138,17,1999/1/10,0,0,9204.0,,49045776
909,Thomas Foket,Reims,1994,227.0,be BEL,DF,27.0,22.0,35.0,22.0,18.0,11.0,6.0,17.0,46.0,37.0,29.0,21.0,7.0,14.0,33.0,68.0,29.0,2.0,Matches,227.0,be BEL,DF,27.0,22.0,39.0,1.78,37.0,0.0,0.0,0.0,1.0,1.0,2.0,0.09,2.0,0.0,0.0,0.0,0.0,0.0,Matches,,,,,,,,,,,,,,,,,,,,,,,,,,,,,,,,,,,,,,,,,,,,,,,,,,,,,,,,227.0,be BEL,DF,27.0,22.0,0.0,0.0,0.0,27.0,22.0,3.0,57.0,33.0,22.0,0.0,0.0,0.0,148.0,12.0,13.0,48.0,Matches,227.0,be BEL,DF,27.0,22.0,1257.0,1039.0,214.0,14.0,0.0,6.0,57.0,200.0,0.0,0.0,0.0,0.0,1011.0,4.0,32.0,Matches,227.0,be BEL,DF,27.0,22.0,1011.0,1257.0,80.4,16877.0,4625.0,445.0,535.0,83.2,470.0,555.0,84.7,66.0,103.0,64.1,1.0,2.8,2.9,-1.8,23.0,67.0,17.0,9.0,94.0,Matches,264,be BEL,DF,27,24,1976.0,82.0,57.8,22.0,23,85.0,16,1,13.0,0,1.46,28.0,25.0,3.0,0.14,0.32,34.8,30.8,4.0,0.18,-0.12,Matches,227.0,be BEL,DF,27.0,22.0,1442.0,61.0,368.0,657.0,429.0,35.0,1442.0,21.0,9.0,42.9,9.0,42.9,965.0,5402.0,2400.0,56.0,38.0,4.0,29.0,20.0,858.0,154.0,Matches,227.0,be BEL,DF,27.0,22.0,0.0,2.0,1.0,50.0,0.09,0.05,0.0,0.0,11.7,0.0,0.0,0.0,0.1,0.1,0.07,-0.1,-0.1,Matches,227.0,be BEL,DF,27.0,24.0,23.0,1976.0,22.0,0.0,1.0,1.0,0.0,0.0,0.0,0.0,0.0,0.1,0.1,2.8,2.9,56.0,94.0,154.0,0.0,0.05,0.05,0.0,0.05,0.01,0.13,0.13,0.01,0.13,Matches,Thomas Foket,D/WB R,27,124,131,Belgium,Stade de Reims,11,14,11,8,11,9,8,9,8,12,10,8,12,12,8,12,14,13,14,10,12,14,10,8,10,14,15,14,14,12,12,8,15,14,15,12,12,5,11,8,8,3,3,1,1,3,3,1,3,2,2,3,15,14,1,14,12,10,10,12,1,1,1,20,1,19,1,1,1,15,1,1,13,1,178,74,8,20,1773332,6200,6350,5000,Northern_European,121,2,1994/9/25,10,1,13808.0,,18060678
910,José Fonte,Lille,1983,228.0,pt POR,DF,38.0,28.8,23.0,17.0,18.0,4.0,1.0,10.0,21.0,47.6,11.0,27.0,14.0,13.0,25.0,48.0,112.0,2.0,Matches,228.0,pt POR,DF,38.0,28.8,16.0,0.56,13.0,0.0,0.0,2.0,1.0,0.0,2.0,0.07,1.0,0.0,0.0,1.0,0.0,0.0,Matches,,,,,,,,,,,,,,,,,,,,,,,,,,,,,,,,,,,,,,,,,,,,,,,,,,,,,,,,228.0,pt POR,DF,38.0,28.8,7.0,0.0,0.0,26.0,9.0,0.0,3.0,25.0,17.0,0.0,1.0,1.0,138.0,61.0,30.0,67.0,Matches,228.0,pt POR,DF,38.0,28.8,1979.0,1868.0,107.0,78.0,0.0,12.0,3.0,5.0,0.0,0.0,0.0,0.0,1781.0,4.0,7.0,Matches,228.0,pt POR,DF,38.0,28.8,1781.0,1979.0,90.0,33014.0,11617.0,687.0,728.0,94.4,875.0,944.0,92.7,181.0,257.0,70.4,0.0,0.4,0.9,-0.4,4.0,104.0,1.0,0.0,99.0,Matches,265,pt POR,DF,38,31,2592.0,84.0,75.8,28.8,30,86.0,28,1,14.0,2,1.61,41.0,30.0,11.0,0.38,-0.71,50.6,32.7,17.9,0.62,-0.5,Matches,228.0,pt POR,DF,38.0,28.8,2205.0,260.0,977.0,1141.0,95.0,29.0,2205.0,4.0,3.0,75.0,0.0,0.0,1667.0,8544.0,4564.0,7.0,18.0,0.0,8.0,2.0,1572.0,8.0,Matches,228.0,pt POR,DF,38.0,28.8,1.0,14.0,2.0,14.3,0.49,0.07,0.07,0.5,12.3,0.0,0.0,0.0,1.4,1.4,0.11,-0.4,-0.4,Matches,228.0,pt POR,DF,38.0,31.0,30.0,2592.0,28.8,1.0,0.0,1.0,1.0,0.0,0.0,7.0,0.0,1.4,1.4,0.4,1.8,7.0,99.0,8.0,0.03,0.0,0.03,0.03,0.03,0.05,0.01,0.06,0.05,0.06,Matches,José Fonte,D C,38,139,146,Portugal,LOSC Lille,6,9,10,7,11,9,17,8,8,14,14,8,15,12,14,14,14,14,15,12,13,13,10,20,10,15,16,16,9,10,13,16,14,9,14,15,15,10,14,11,10,3,4,2,2,3,2,2,1,2,2,3,12,16,5,10,14,14,13,12,1,1,20,1,1,1,10,1,1,1,1,1,1,5,191,78,10,20,1020628,6950,6750,5300,Mediterranean_Hispanic,140,1,1983/12/22,50,1,32218.0,,742448
911,Przemysław Frankowski,Lens,1995,230.0,pl POL,DFMF,27.0,31.5,77.0,51.0,37.0,31.0,9.0,39.0,80.0,48.8,41.0,38.0,6.0,32.0,41.0,118.0,42.0,2.0,Matches,230.0,pl POL,DFMF,27.0,31.5,123.0,3.91,69.0,44.0,3.0,3.0,2.0,2.0,12.0,0.38,8.0,4.0,0.0,0.0,0.0,0.0,Matches,,,,,,,,,,,,,,,,,,,,,,,,,,,,,,,,,,,,,,,,,,,,,,,,,,,,,,,,230.0,pl POL,DFMF,27.0,31.5,4.0,0.0,0.0,35.0,18.0,6.0,255.0,41.0,51.0,0.0,0.0,0.0,158.0,12.0,21.0,36.4,Matches,230.0,pl POL,DFMF,27.0,31.5,1828.0,1414.0,409.0,64.0,2.0,5.0,255.0,234.0,111.0,43.0,50.0,0.0,1364.0,5.0,33.0,Matches,230.0,pl POL,DFMF,27.0,31.5,1364.0,1828.0,74.6,23200.0,8259.0,652.0,748.0,87.2,553.0,727.0,76.1,124.0,271.0,45.8,3.0,6.8,6.9,-3.8,67.0,92.0,52.0,26.0,132.0,Matches,268,pl POL,DFMF,27,37,2833.0,77.0,82.8,31.5,31,85.0,18,6,32.0,0,2.19,57.0,21.0,36.0,1.14,0.68,52.8,35.6,17.1,0.54,-0.39,Matches,230.0,pl POL,DFMF,27.0,31.5,2129.0,79.0,428.0,815.0,904.0,57.0,2126.0,32.0,13.0,40.6,15.0,46.9,1364.0,7257.0,2684.0,51.0,49.0,10.0,30.0,15.0,1242.0,237.0,Matches,230.0,pl POL,DFMF,27.0,31.5,5.0,28.0,6.0,21.4,0.89,0.19,0.07,0.33,22.1,2.0,3.0,3.0,4.2,1.8,0.06,0.8,0.2,Matches,230.0,pl POL,DFMF,27.0,37.0,31.0,2833.0,31.5,5.0,3.0,8.0,2.0,3.0,3.0,4.0,0.0,4.2,1.8,6.8,8.6,51.0,132.0,237.0,0.16,0.1,0.25,0.06,0.16,0.13,0.22,0.35,0.06,0.27,Matches,Przemysław Frankowski,WB/M RLC,27,125,130,Poland,RC Lens,8,12,13,12,12,8,7,12,11,11,13,5,11,13,7,12,9,12,11,12,11,11,14,7,13,11,15,14,14,12,12,8,12,14,13,9,13,6,11,4,15,2,2,3,1,1,2,2,1,3,3,2,8,13,8,12,10,11,11,8,1,1,1,1,20,20,1,16,16,16,14,14,14,10,173,71,13,20,3363016,6247,6247,4497,Northern_European,119,4,1995/4/12,24,1,10923.0,,96029182
912,Gauthier Gallon,Troyes,1993,232.0,fr FRA,GK,29.0,29.6,2.0,2.0,2.0,0.0,0.0,2.0,4.0,50.0,2.0,0.0,0.0,0.0,2.0,4.0,17.0,0.0,Matches,232.0,fr FRA,GK,29.0,29.6,2.0,0.07,1.0,1.0,0.0,0.0,0.0,0.0,0.0,0.0,0.0,0.0,0.0,0.0,0.0,0.0,Matches,17.0,fr FRA,GK,29.0,29.6,65.0,5.0,0.0,8.0,2.0,54.9,0.29,-8.1,-0.27,107.0,391.0,27.4,707.0,144.0,35.2,33.2,241.0,58.9,44.4,496.0,33.0,6.7,9.0,0.3,8.8,Matches,17.0,fr FRA,GK,29.0,30.0,30.0,2667.0,29.6,65.0,2.19,177.0,114.0,66.1,3.0,9.0,18.0,0.0,0.0,5.0,5.0,0.0,0.0,0.0,Matches,232.0,fr FRA,GK,29.0,29.6,3.0,1.0,0.0,2.0,5.0,0.0,0.0,2.0,2.0,0.0,1.0,0.0,33.0,14.0,0.0,100.0,Matches,232.0,fr FRA,GK,29.0,29.6,951.0,599.0,349.0,108.0,0.0,5.0,0.0,0.0,0.0,0.0,0.0,0.0,633.0,3.0,0.0,Matches,232.0,fr FRA,GK,29.0,29.6,633.0,951.0,66.6,16827.0,12352.0,134.0,135.0,99.3,301.0,306.0,98.4,184.0,492.0,37.4,0.0,0.0,0.0,0.0,1.0,10.0,0.0,0.0,0.0,Matches,270,fr FRA,GK,29,30,2667.0,89.0,78.0,29.6,30,89.0,29,0,,5,0.6,35.0,65.0,-30.0,-1.01,-0.3,33.4,61.8,-28.4,-0.96,0.3,Matches,232.0,fr FRA,GK,29.0,29.6,1055.0,954.0,1053.0,2.0,0.0,0.0,1055.0,0.0,0.0,,0.0,,620.0,3049.0,1706.0,0.0,1.0,1.0,0.0,0.0,386.0,0.0,Matches,232.0,fr FRA,GK,29.0,29.6,0.0,0.0,0.0,,0.0,0.0,,,,0.0,0.0,0.0,0.0,0.0,,0.0,0.0,Matches,232.0,fr FRA,GK,29.0,30.0,30.0,2667.0,29.6,0.0,0.0,0.0,0.0,0.0,0.0,3.0,1.0,0.0,0.0,0.0,0.0,0.0,0.0,0.0,0.0,0.0,0.0,0.0,0.0,0.0,0.0,0.0,0.0,0.0,Matches,Gauthier Gallon,GK,29,125,128,France,ESTAC Troyes,7,2,3,3,10,9,2,3,2,1,11,2,2,10,12,12,15,12,13,10,11,11,8,10,1,11,13,10,9,12,14,12,13,9,13,14,12,7,1,7,1,11,13,15,10,13,15,13,15,13,8,12,7,13,8,15,8,13,10,11,20,1,1,1,1,1,1,1,1,1,1,1,1,1,186,79,6,20,2252769,6245,6245,3495,Northern_European,123,6,1993/4/23,0,0,4499.0,,29114950
913,Ignatius Ganago,Nantes,1999,234.0,cm CMR,FWMF,23.0,16.9,9.0,7.0,2.0,3.0,4.0,4.0,7.0,57.1,3.0,13.0,1.0,12.0,2.0,11.0,12.0,0.0,Matches,234.0,cm CMR,FWMF,23.0,16.9,29.0,1.72,17.0,0.0,0.0,5.0,6.0,1.0,7.0,0.41,4.0,0.0,0.0,1.0,1.0,1.0,Matches,,,,,,,,,,,,,,,,,,,,,,,,,,,,,,,,,,,,,,,,,,,,,,,,,,,,,,,,234.0,cm CMR,FWMF,23.0,16.9,0.0,0.0,0.0,15.0,32.0,8.0,22.0,2.0,7.0,1.0,0.0,0.0,58.0,62.0,64.0,49.2,Matches,234.0,cm CMR,FWMF,23.0,16.9,349.0,335.0,12.0,1.0,1.0,2.0,22.0,1.0,0.0,0.0,0.0,0.0,212.0,2.0,16.0,Matches,234.0,cm CMR,FWMF,23.0,16.9,212.0,349.0,60.7,2964.0,597.0,127.0,180.0,70.6,55.0,94.0,58.5,13.0,30.0,43.3,3.0,1.7,1.6,1.3,10.0,16.0,4.0,0.0,20.0,Matches,272,cm CMR,FWMF,23,28,1520.0,54.0,44.4,16.9,16,77.0,5,12,25.0,1,0.89,20.0,28.0,-8.0,-0.47,0.0,20.6,21.4,-0.8,-0.05,0.37,Matches,234.0,cm CMR,FWMF,23.0,16.9,507.0,13.0,53.0,227.0,237.0,80.0,507.0,30.0,10.0,33.3,18.0,60.0,342.0,2040.0,670.0,27.0,9.0,10.0,40.0,19.0,359.0,101.0,Matches,234.0,cm CMR,FWMF,23.0,16.9,5.0,33.0,14.0,42.4,1.95,0.83,0.15,0.36,13.0,0.0,0.0,0.0,3.7,3.7,0.11,1.3,1.3,Matches,234.0,cm CMR,FWMF,23.0,28.0,16.0,1520.0,16.9,5.0,3.0,8.0,5.0,0.0,0.0,0.0,0.0,3.7,3.7,1.7,5.4,27.0,20.0,101.0,0.3,0.18,0.47,0.3,0.47,0.22,0.1,0.32,0.22,0.32,Matches,Ignatius Ganago,S,23,119,135,Cameroon,FC Nantes,7,9,12,14,12,10,12,11,8,8,11,12,10,12,8,11,13,12,11,8,11,12,12,8,14,6,11,13,15,12,15,11,14,14,12,14,12,6,10,13,6,2,1,1,1,3,3,3,1,2,1,1,13,14,2,9,11,12,11,16,1,1,1,1,1,1,1,1,1,1,10,1,1,20,179,82,8,20,4378602,5950,5950,3900,African_Caribbean,118,17,1999/2/16,11,0,13919.0,,49045927
914,Johan Gastien,Clermont Foot,1988,236.0,fr FRA,MF,34.0,28.9,62.0,34.0,30.0,23.0,9.0,38.0,111.0,34.2,73.0,37.0,7.0,30.0,36.0,98.0,25.0,1.0,Matches,236.0,fr FRA,MF,34.0,28.9,69.0,2.39,44.0,21.0,0.0,2.0,1.0,1.0,9.0,0.31,5.0,4.0,0.0,0.0,0.0,0.0,Matches,,,,,,,,,,,,,,,,,,,,,,,,,,,,,,,,,,,,,,,,,,,,,,,,,,,,,,,,236.0,fr FRA,MF,34.0,28.9,7.0,0.0,0.0,19.0,33.0,0.0,67.0,36.0,34.0,0.0,1.0,0.0,224.0,10.0,10.0,50.0,Matches,236.0,fr FRA,MF,34.0,28.9,2103.0,1900.0,200.0,144.0,3.0,23.0,67.0,10.0,46.0,23.0,12.0,2.0,1743.0,3.0,24.0,Matches,236.0,fr FRA,MF,34.0,28.9,1743.0,2103.0,82.9,34446.0,11716.0,623.0,716.0,87.0,805.0,909.0,88.6,264.0,392.0,67.3,3.0,2.1,3.2,0.9,28.0,193.0,30.0,5.0,219.0,Matches,275,fr FRA,MF,34,31,2603.0,84.0,76.1,28.9,29,88.0,23,2,25.0,0,1.77,40.0,37.0,3.0,0.1,0.87,38.6,44.9,-6.3,-0.22,0.28,Matches,236.0,fr FRA,MF,34.0,28.9,2358.0,80.0,628.0,1426.0,325.0,6.0,2358.0,25.0,9.0,36.0,14.0,56.0,1799.0,8404.0,3491.0,13.0,30.0,1.0,26.0,12.0,1646.0,27.0,Matches,236.0,fr FRA,MF,34.0,28.9,4.0,19.0,9.0,47.4,0.66,0.31,0.21,0.44,24.8,1.0,0.0,0.0,1.2,1.2,0.06,2.8,2.8,Matches,236.0,fr FRA,MF,34.0,31.0,29.0,2603.0,28.9,4.0,3.0,7.0,4.0,0.0,0.0,7.0,0.0,1.2,1.2,2.1,3.3,13.0,219.0,27.0,0.14,0.1,0.24,0.14,0.24,0.04,0.07,0.12,0.04,0.12,Matches,Johan Gastien,DM/M C,34,124,126,France,Clermont Foot 63,12,12,11,7,14,11,9,10,5,11,15,7,11,14,12,14,14,12,13,13,13,14,12,14,13,13,15,15,11,13,13,10,13,13,16,10,13,14,12,6,14,2,3,2,2,3,1,3,2,2,1,2,12,13,5,18,13,16,13,13,1,1,10,1,1,1,17,10,20,10,10,14,10,1,179,69,6,20,347975206,6194,6194,3744,Northern_European,125,5,1988/1/22,0,0,9541.0,,34008270
915,Samuel Gigot,Marseille,1993,242.0,fr FRA,DF,28.0,20.9,46.0,24.0,22.0,21.0,3.0,12.0,15.0,80.0,3.0,24.0,7.0,17.0,45.0,91.0,85.0,1.0,Matches,242.0,fr FRA,DF,28.0,20.9,19.0,0.91,15.0,0.0,0.0,4.0,0.0,0.0,4.0,0.19,4.0,0.0,0.0,0.0,0.0,0.0,Matches,,,,,,,,,,,,,,,,,,,,,,,,,,,,,,,,,,,,,,,,,,,,,,,,,,,,,,,,242.0,fr FRA,DF,28.0,20.9,5.0,2.0,1.0,44.0,14.0,1.0,1.0,45.0,24.0,0.0,1.0,0.0,103.0,56.0,17.0,76.7,Matches,242.0,fr FRA,DF,28.0,20.9,1130.0,1077.0,51.0,32.0,0.0,1.0,1.0,6.0,0.0,0.0,0.0,0.0,985.0,2.0,2.0,Matches,242.0,fr FRA,DF,28.0,20.9,985.0,1130.0,87.2,17488.0,5168.0,353.0,394.0,89.6,535.0,582.0,91.9,66.0,110.0,60.0,2.0,0.4,0.4,1.6,4.0,57.0,2.0,0.0,74.0,Matches,282,fr FRA,DF,28,26,1879.0,72.0,54.9,20.9,24,76.0,14,2,30.0,1,2.04,38.0,20.0,18.0,0.86,0.34,38.3,21.9,16.4,0.79,0.41,Matches,242.0,fr FRA,DF,28.0,20.9,1374.0,159.0,573.0,704.0,107.0,30.0,1374.0,9.0,4.0,44.4,4.0,44.4,938.0,5796.0,3346.0,33.0,29.0,0.0,11.0,3.0,855.0,19.0,Matches,242.0,fr FRA,DF,28.0,20.9,2.0,12.0,3.0,25.0,0.57,0.14,0.17,0.67,8.0,0.0,0.0,0.0,2.6,2.6,0.21,-0.6,-0.6,Matches,242.0,fr FRA,DF,28.0,26.0,24.0,1879.0,20.9,2.0,2.0,4.0,2.0,0.0,0.0,5.0,2.0,2.6,2.6,0.4,3.0,33.0,74.0,19.0,0.1,0.1,0.19,0.1,0.19,0.12,0.02,0.14,0.12,0.14,Matches,Samuel Gigot,D C,28,136,140,"France,Algeria",Olympique de Marseille,1,10,11,9,12,10,15,13,2,16,13,4,12,12,10,14,15,13,12,11,11,18,16,13,10,14,15,12,12,13,13,15,16,14,12,15,13,7,15,11,12,1,3,3,3,4,3,2,1,1,2,3,15,14,5,11,17,17,17,15,1,1,20,1,1,1,9,1,6,1,1,1,1,1,187,83,10,20,5222234,6290,6290,5490,North_African__Middle_Eastern,135,13,1993/10/12,0,0,43499.0,,48031358
916,Andrei Girotto,Nantes,1992,243.0,br BRA,DFMF,30.0,35.0,122.0,73.0,71.0,45.0,6.0,74.0,132.0,56.1,58.0,55.0,24.0,31.0,73.0,195.0,176.0,1.0,Matches,243.0,br BRA,DFMF,30.0,35.0,32.0,0.91,27.0,1.0,0.0,3.0,0.0,1.0,5.0,0.14,3.0,1.0,0.0,1.0,0.0,0.0,Matches,,,,,,,,,,,,,,,,,,,,,,,,,,,,,,,,,,,,,,,,,,,,,,,,,,,,,,,,243.0,br BRA,DFMF,30.0,35.0,7.0,0.0,0.0,54.0,34.0,1.0,9.0,73.0,73.0,0.0,2.0,0.0,163.0,78.0,42.0,65.0,Matches,243.0,br BRA,DFMF,30.0,35.0,1750.0,1702.0,43.0,40.0,1.0,16.0,9.0,3.0,0.0,0.0,0.0,0.0,1445.0,5.0,12.0,Matches,243.0,br BRA,DFMF,30.0,35.0,1445.0,1750.0,82.6,29344.0,9608.0,475.0,538.0,88.3,700.0,795.0,88.1,231.0,351.0,65.8,1.0,1.9,1.1,-0.9,13.0,129.0,6.0,3.0,140.0,Matches,283,br BRA,DFMF,30,36,3149.0,87.0,92.1,35.0,36,87.0,30,0,,1,0.97,34.0,50.0,-16.0,-0.46,0.21,39.1,48.3,-9.2,-0.26,-0.11,Matches,243.0,br BRA,DFMF,30.0,35.0,2260.0,303.0,982.0,1157.0,131.0,31.0,2260.0,10.0,3.0,30.0,6.0,60.0,1474.0,7367.0,3598.0,14.0,13.0,0.0,11.0,6.0,1341.0,7.0,Matches,243.0,br BRA,DFMF,30.0,35.0,1.0,27.0,6.0,22.2,0.77,0.17,0.04,0.17,17.2,2.0,0.0,0.0,1.7,1.7,0.06,-0.7,-0.7,Matches,243.0,br BRA,DFMF,30.0,36.0,36.0,3149.0,35.0,1.0,1.0,2.0,1.0,0.0,0.0,7.0,0.0,1.7,1.7,1.9,3.6,14.0,140.0,7.0,0.03,0.03,0.06,0.03,0.06,0.05,0.06,0.1,0.05,0.1,Matches,Andrei Girotto,D/DM C,30,130,135,Brazil,FC Nantes,8,10,11,10,13,11,13,12,7,14,12,10,14,12,15,13,16,13,13,11,12,14,11,12,12,13,12,13,12,13,10,13,14,12,14,13,14,15,10,4,7,3,1,4,1,3,4,1,2,1,3,1,18,14,8,12,12,13,7,7,1,1,20,1,1,1,19,1,15,1,1,1,1,1,186,79,10,20,4845527,6495,6495,3506,Northern_European,129,8,1992/2/17,0,0,20698.0,,19123383
917,André Gomes,Lille,1993,245.0,pt POR,MF,29.0,18.1,37.0,19.0,12.0,17.0,8.0,19.0,52.0,36.5,33.0,20.0,5.0,15.0,9.0,46.0,16.0,1.0,Matches,245.0,pt POR,MF,29.0,18.1,40.0,2.21,36.0,1.0,1.0,2.0,0.0,0.0,5.0,0.28,4.0,0.0,0.0,1.0,0.0,0.0,Matches,,,,,,,,,,,,,,,,,,,,,,,,,,,,,,,,,,,,,,,,,,,,,,,,,,,,,,,,245.0,pt POR,MF,29.0,18.1,6.0,0.0,0.0,49.0,17.0,1.0,11.0,9.0,19.0,0.0,0.0,0.0,142.0,18.0,12.0,60.0,Matches,245.0,pt POR,MF,29.0,18.1,1334.0,1305.0,25.0,18.0,3.0,13.0,11.0,5.0,2.0,0.0,2.0,0.0,1179.0,4.0,22.0,Matches,245.0,pt POR,MF,29.0,18.1,1179.0,1334.0,88.4,20280.0,5925.0,546.0,595.0,91.8,487.0,515.0,94.6,110.0,158.0,69.6,2.0,1.2,1.6,0.8,14.0,145.0,18.0,1.0,160.0,Matches,285,pt POR,MF,29,26,1629.0,63.0,47.6,18.1,18,82.0,11,8,20.0,0,1.81,35.0,20.0,15.0,0.83,0.53,33.2,17.6,15.6,0.86,0.23,Matches,245.0,pt POR,MF,29.0,18.1,1520.0,37.0,261.0,1010.0,270.0,17.0,1520.0,42.0,29.0,69.0,10.0,23.8,1254.0,5944.0,2291.0,26.0,35.0,4.0,30.0,26.0,1172.0,33.0,Matches,245.0,pt POR,MF,29.0,18.1,3.0,18.0,5.0,27.8,0.99,0.28,0.17,0.6,21.2,0.0,0.0,0.0,1.1,1.1,0.06,1.9,1.9,Matches,245.0,pt POR,MF,29.0,26.0,18.0,1629.0,18.1,3.0,2.0,5.0,3.0,0.0,0.0,6.0,0.0,1.1,1.1,1.2,2.3,26.0,160.0,33.0,0.17,0.11,0.28,0.17,0.28,0.06,0.07,0.13,0.06,0.13,Matches,André Gomes,M C,28,130,161,Portugal,Everton,11,12,11,11,16,13,10,9,9,8,15,14,12,17,10,13,9,16,11,13,15,12,13,9,12,11,14,14,8,10,13,12,13,11,12,14,13,12,14,10,13,2,1,2,4,1,1,2,3,3,2,3,13,12,5,13,11,15,14,12,1,1,1,10,1,12,13,10,20,13,9,14,1,1,188,84,14,20,12530679,6399,6599,5499,Mediterranean_Hispanic,130,5,1993/7/30,29,0,139190.0,LOSC Lille,55027994
918,Angel Gomes,Lille,2000,246.0,eng ENG,MF,21.0,31.3,41.0,19.0,12.0,21.0,8.0,18.0,49.0,36.7,31.0,22.0,2.0,20.0,13.0,54.0,11.0,1.0,Matches,246.0,eng ENG,MF,21.0,31.3,89.0,2.84,62.0,9.0,7.0,2.0,8.0,1.0,15.0,0.48,12.0,1.0,1.0,0.0,1.0,0.0,Matches,,,,,,,,,,,,,,,,,,,,,,,,,,,,,,,,,,,,,,,,,,,,,,,,,,,,,,,,246.0,eng ENG,MF,21.0,31.3,8.0,0.0,0.0,54.0,49.0,0.0,49.0,13.0,19.0,2.0,0.0,0.0,139.0,8.0,30.0,21.1,Matches,246.0,eng ENG,MF,21.0,31.3,1767.0,1699.0,64.0,35.0,8.0,24.0,49.0,1.0,26.0,11.0,10.0,0.0,1517.0,4.0,18.0,Matches,246.0,eng ENG,MF,21.0,31.3,1517.0,1767.0,85.9,26307.0,6952.0,683.0,752.0,90.8,616.0,681.0,90.5,159.0,248.0,64.1,6.0,3.1,3.4,2.9,34.0,159.0,38.0,2.0,166.0,Matches,286,eng ENG,MF,21,36,2816.0,78.0,82.3,31.3,34,81.0,11,2,25.0,0,1.69,52.0,36.0,16.0,0.51,-0.23,55.0,34.0,21.1,0.67,-0.39,Matches,246.0,eng ENG,MF,21.0,31.3,2015.0,29.0,315.0,1185.0,527.0,49.0,2014.0,56.0,30.0,53.6,16.0,28.6,1705.0,8195.0,3493.0,39.0,57.0,10.0,41.0,26.0,1645.0,115.0,Matches,246.0,eng ENG,MF,21.0,31.3,2.0,55.0,17.0,30.9,1.76,0.54,0.02,0.06,23.2,4.0,1.0,1.0,4.6,3.8,0.07,-2.6,-2.8,Matches,246.0,eng ENG,MF,21.0,36.0,34.0,2816.0,31.3,2.0,6.0,8.0,1.0,1.0,1.0,8.0,0.0,4.6,3.8,3.1,6.9,39.0,166.0,115.0,0.06,0.19,0.26,0.03,0.22,0.15,0.1,0.24,0.12,0.22,Matches,Angel Gomes,M/AM RLC,21,124,142,"England,Portugal,Angola",LOSC Lille,11,12,14,12,15,12,6,13,4,6,14,11,7,15,8,10,8,13,9,15,12,14,18,8,12,6,10,8,14,14,10,6,10,14,12,6,12,6,9,11,8,1,3,4,4,2,3,1,2,3,3,1,16,12,5,8,12,13,8,12,1,1,1,1,1,1,1,14,16,13,17,20,16,8,168,58,14,20,6924999,6200,6200,5000,African_Caribbean,123,14,2000/8/31,0,0,11999.0,,28109888
919,Maxime Gonalons,Clermont Foot,1989,247.0,fr FRA,MF,33.0,16.1,52.0,32.0,25.0,21.0,6.0,25.0,53.0,47.2,28.0,21.0,1.0,20.0,20.0,72.0,7.0,1.0,Matches,247.0,fr FRA,MF,33.0,16.1,21.0,1.31,20.0,0.0,1.0,0.0,0.0,0.0,1.0,0.06,1.0,0.0,0.0,0.0,0.0,0.0,Matches,,,,,,,,,,,,,,,,,,,,,,,,,,,,,,,,,,,,,,,,,,,,,,,,,,,,,,,,247.0,fr FRA,MF,33.0,16.1,3.0,0.0,0.0,24.0,22.0,0.0,3.0,20.0,32.0,0.0,0.0,0.0,98.0,15.0,9.0,62.5,Matches,247.0,fr FRA,MF,33.0,16.1,835.0,801.0,31.0,30.0,1.0,21.0,3.0,1.0,0.0,0.0,0.0,0.0,736.0,3.0,12.0,Matches,247.0,fr FRA,MF,33.0,16.1,736.0,835.0,88.1,13744.0,4112.0,275.0,313.0,87.9,350.0,374.0,93.6,82.0,104.0,78.8,0.0,0.5,0.6,-0.5,9.0,80.0,6.0,1.0,99.0,Matches,287,fr FRA,MF,33,25,1449.0,58.0,42.4,16.1,19,72.0,2,6,14.0,0,1.6,22.0,21.0,1.0,0.06,0.29,19.2,26.7,-7.5,-0.47,-0.32,Matches,247.0,fr FRA,MF,33.0,16.1,997.0,27.0,259.0,657.0,97.0,3.0,997.0,28.0,15.0,53.6,11.0,39.3,742.0,3943.0,1651.0,10.0,16.0,0.0,20.0,10.0,667.0,3.0,Matches,247.0,fr FRA,MF,33.0,16.1,1.0,6.0,2.0,33.3,0.37,0.12,0.17,0.5,22.6,0.0,0.0,0.0,0.5,0.5,0.09,0.5,0.5,Matches,247.0,fr FRA,MF,33.0,25.0,19.0,1449.0,16.1,1.0,0.0,1.0,1.0,0.0,0.0,3.0,0.0,0.5,0.5,0.5,1.0,10.0,99.0,3.0,0.06,0.0,0.06,0.06,0.06,0.03,0.03,0.06,0.03,0.06,Matches,Maxime Gonalons,DM/M C,33,128,148,France,Clermont Foot 63,5,6,10,5,13,5,15,8,5,14,14,9,14,13,15,15,14,12,12,12,14,18,8,13,8,14,15,14,12,12,13,15,15,12,14,14,13,13,14,4,12,3,3,3,3,1,2,3,2,3,1,2,9,14,6,18,10,15,13,12,1,1,12,1,1,1,20,1,19,1,1,1,1,1,187,76,10,20,347975206,6397,6397,5997,Northern_European,128,2,1989/3/10,8,0,12749.0,,34001572
920,Amine Gouiri,Rennes,2000,250.0,dz ALG,FWMF,22.0,28.0,42.0,25.0,14.0,16.0,12.0,14.0,33.0,42.4,19.0,21.0,0.0,21.0,12.0,54.0,10.0,0.0,Matches,250.0,dz ALG,FWMF,22.0,28.0,93.0,3.32,72.0,0.0,9.0,9.0,2.0,1.0,11.0,0.39,8.0,0.0,3.0,0.0,0.0,0.0,Matches,,,,,,,,,,,,,,,,,,,,,,,,,,,,,,,,,,,,,,,,,,,,,,,,,,,,,,,,250.0,dz ALG,FWMF,22.0,28.0,4.0,0.0,0.0,39.0,18.0,8.0,10.0,12.0,25.0,0.0,0.0,0.0,97.0,29.0,49.0,37.2,Matches,250.0,dz ALG,FWMF,22.0,28.0,742.0,718.0,22.0,0.0,5.0,2.0,10.0,1.0,0.0,0.0,0.0,0.0,588.0,2.0,26.0,Matches,250.0,dz ALG,FWMF,22.0,28.0,588.0,742.0,79.2,8451.0,1576.0,307.0,376.0,81.6,209.0,252.0,82.9,31.0,41.0,75.6,3.0,4.3,4.9,-1.3,37.0,32.0,31.0,3.0,70.0,Matches,290,dz ALG,FWMF,22,33,2523.0,76.0,73.8,28.0,29,83.0,17,4,27.0,0,1.85,55.0,29.0,26.0,0.93,0.53,46.0,29.0,17.0,0.61,0.58,Matches,250.0,dz ALG,FWMF,22.0,28.0,1071.0,12.0,74.0,439.0,576.0,145.0,1071.0,80.0,33.0,41.3,44.0,55.0,805.0,4749.0,1815.0,63.0,40.0,26.0,72.0,36.0,784.0,205.0,Matches,250.0,dz ALG,FWMF,22.0,28.0,15.0,74.0,30.0,40.5,2.64,1.07,0.2,0.5,13.6,0.0,0.0,0.0,11.1,11.1,0.15,3.9,3.9,Matches,250.0,dz ALG,FWMF,22.0,33.0,29.0,2523.0,28.0,15.0,3.0,18.0,15.0,0.0,0.0,4.0,0.0,11.1,11.1,4.3,15.4,63.0,70.0,205.0,0.54,0.11,0.64,0.54,0.64,0.4,0.15,0.55,0.4,0.55,Matches,Amine Gouiri,AM/S L,22,132,156,"France,Algeria",Stade Rennais FC,6,10,15,14,15,8,11,13,4,4,13,12,4,15,13,12,14,14,13,14,13,16,16,10,15,9,15,14,14,14,15,12,15,14,13,12,13,8,15,7,11,3,2,2,2,2,1,1,2,3,1,4,16,15,8,14,16,16,11,14,1,1,1,1,1,1,1,12,1,1,20,1,1,19,180,72,8,20,32213997,6600,6600,4750,North_African__Middle_Eastern,134,6,2000/2/16,0,0,20106.0,,48044735
921,Jonathan Gradit,Lens,1992,251.0,fr FRA,DF,29.0,31.4,62.0,40.0,30.0,25.0,7.0,31.0,53.0,58.5,22.0,40.0,26.0,14.0,38.0,100.0,83.0,0.0,Matches,251.0,fr FRA,DF,29.0,31.4,49.0,1.56,40.0,1.0,1.0,0.0,4.0,3.0,8.0,0.25,8.0,0.0,0.0,0.0,0.0,0.0,Matches,,,,,,,,,,,,,,,,,,,,,,,,,,,,,,,,,,,,,,,,,,,,,,,,,,,,,,,,251.0,fr FRA,DF,29.0,31.4,7.0,0.0,0.0,31.0,39.0,0.0,15.0,38.0,40.0,0.0,0.0,0.0,140.0,47.0,45.0,51.1,Matches,251.0,fr FRA,DF,29.0,31.4,2093.0,2016.0,71.0,57.0,4.0,14.0,15.0,8.0,0.0,0.0,0.0,0.0,1875.0,6.0,14.0,Matches,251.0,fr FRA,DF,29.0,31.4,1875.0,2093.0,89.6,34040.0,12990.0,727.0,789.0,92.1,942.0,1011.0,93.2,159.0,218.0,72.9,3.0,1.1,1.6,1.9,13.0,221.0,17.0,5.0,233.0,Matches,291,fr FRA,DF,29,33,2823.0,86.0,82.5,31.4,33,86.0,26,0,,0,2.24,61.0,27.0,34.0,1.08,0.33,56.4,34.7,21.7,0.69,0.46,Matches,251.0,fr FRA,DF,29.0,31.4,2369.0,159.0,749.0,1452.0,183.0,7.0,2369.0,26.0,12.0,46.2,12.0,46.2,1860.0,10993.0,6399.0,41.0,68.0,2.0,18.0,9.0,1756.0,9.0,Matches,251.0,fr FRA,DF,29.0,31.4,1.0,5.0,1.0,20.0,0.16,0.03,0.2,1.0,14.1,0.0,0.0,0.0,0.8,0.8,0.16,0.2,0.2,Matches,251.0,fr FRA,DF,29.0,33.0,33.0,2823.0,31.4,1.0,3.0,4.0,1.0,0.0,0.0,7.0,0.0,0.8,0.8,1.1,2.0,41.0,233.0,9.0,0.03,0.1,0.13,0.03,0.13,0.03,0.04,0.06,0.03,0.06,Matches,Jonathan Gradit,D RC,29,126,130,France,RC Lens,5,12,15,5,14,6,12,6,13,13,13,6,14,12,14,13,13,14,13,12,13,14,7,12,13,13,15,16,14,12,13,11,15,13,15,14,13,10,10,12,7,3,1,3,4,1,3,3,2,2,1,1,13,13,5,15,10,14,14,14,1,1,20,15,1,1,1,1,1,1,1,1,1,1,180,75,6,20,4231958,6292,6292,3792,Northern_European,128,5,1992/11/24,0,0,11769.0,,85052254
922,Evann Guessand,Nantes,2001,257.0,fr FRA,FWMF,21.0,14.0,24.0,16.0,8.0,13.0,3.0,6.0,12.0,50.0,6.0,17.0,1.0,16.0,9.0,33.0,6.0,0.0,Matches,257.0,fr FRA,FWMF,21.0,14.0,28.0,2.0,16.0,0.0,6.0,3.0,3.0,0.0,4.0,0.29,3.0,0.0,1.0,0.0,0.0,0.0,Matches,,,,,,,,,,,,,,,,,,,,,,,,,,,,,,,,,,,,,,,,,,,,,,,,,,,,,,,,257.0,fr FRA,FWMF,21.0,14.0,2.0,0.0,0.0,31.0,21.0,6.0,31.0,9.0,16.0,0.0,0.0,0.0,72.0,28.0,27.0,50.9,Matches,257.0,fr FRA,FWMF,21.0,14.0,308.0,300.0,4.0,1.0,2.0,2.0,31.0,1.0,0.0,0.0,0.0,0.0,196.0,4.0,12.0,Matches,257.0,fr FRA,FWMF,21.0,14.0,196.0,308.0,63.6,2835.0,906.0,111.0,155.0,71.6,64.0,102.0,62.7,11.0,28.0,39.3,2.0,1.3,1.0,0.7,13.0,18.0,13.0,2.0,37.0,Matches,298,fr FRA,FWMF,21,30,1260.0,42.0,36.8,14.0,15,69.0,2,15,15.0,2,1.03,12.0,21.0,-9.0,-0.64,-0.27,15.2,18.8,-3.6,-0.26,-0.01,Matches,257.0,fr FRA,FWMF,21.0,14.0,510.0,10.0,73.0,233.0,219.0,48.0,510.0,77.0,37.0,48.1,33.0,42.9,381.0,3091.0,1313.0,46.0,24.0,8.0,49.0,31.0,354.0,97.0,Matches,257.0,fr FRA,FWMF,21.0,14.0,3.0,22.0,12.0,54.5,1.57,0.86,0.14,0.25,12.1,0.0,0.0,0.0,2.6,2.6,0.12,0.4,0.4,Matches,257.0,fr FRA,FWMF,21.0,30.0,15.0,1260.0,14.0,3.0,2.0,5.0,3.0,0.0,0.0,2.0,0.0,2.6,2.6,1.3,3.9,46.0,37.0,97.0,0.21,0.14,0.36,0.21,0.36,0.18,0.1,0.28,0.18,0.28,Matches,Evann Guessand,S,21,116,141,"France,Ivory Coast",OGC Nice,5,8,13,13,13,6,11,9,4,5,11,7,6,13,12,12,14,11,10,12,12,15,14,5,14,8,12,12,13,13,15,14,15,14,14,14,11,7,12,7,7,3,2,3,1,1,1,1,2,2,1,1,15,14,8,10,12,14,11,10,1,1,1,1,1,1,1,1,1,1,9,1,1,20,185,79,8,20,5259999,5794,5794,3308,African_Caribbean,118,17,2001/7/1,0,0,5771.0,FC Nantes,49041006
923,Malo Gusto,Lyon,2003,262.0,fr FRA,DF,19.0,17.7,42.0,26.0,23.0,11.0,8.0,21.0,43.0,48.8,22.0,22.0,5.0,17.0,28.0,70.0,23.0,1.0,Matches,262.0,fr FRA,DF,19.0,17.7,50.0,2.82,42.0,2.0,4.0,0.0,2.0,0.0,2.0,0.11,2.0,0.0,0.0,0.0,0.0,0.0,Matches,,,,,,,,,,,,,,,,,,,,,,,,,,,,,,,,,,,,,,,,,,,,,,,,,,,,,,,,262.0,fr FRA,DF,19.0,17.7,1.0,0.0,0.0,20.0,24.0,2.0,116.0,28.0,26.0,0.0,0.0,1.0,139.0,8.0,15.0,34.8,Matches,262.0,fr FRA,DF,19.0,17.7,1437.0,1229.0,205.0,21.0,1.0,0.0,116.0,183.0,1.0,0.0,0.0,0.0,1171.0,3.0,38.0,Matches,262.0,fr FRA,DF,19.0,17.7,1171.0,1437.0,81.5,18951.0,6105.0,599.0,671.0,89.3,460.0,549.0,83.8,83.0,139.0,59.7,1.0,3.1,4.1,-2.1,24.0,85.0,40.0,29.0,82.0,Matches,303,fr FRA,DF,19,21,1595.0,76.0,46.6,17.7,19,83.0,12,2,10.0,3,1.48,28.0,26.0,2.0,0.11,-0.68,31.7,21.5,10.2,0.57,0.61,Matches,262.0,fr FRA,DF,19.0,17.7,1617.0,49.0,351.0,772.0,513.0,26.0,1617.0,50.0,20.0,40.0,20.0,40.0,1195.0,6746.0,3120.0,66.0,73.0,10.0,17.0,12.0,1074.0,147.0,Matches,262.0,fr FRA,DF,19.0,17.7,0.0,7.0,3.0,42.9,0.39,0.17,0.0,0.0,20.9,0.0,0.0,0.0,0.4,0.4,0.06,-0.4,-0.4,Matches,262.0,fr FRA,DF,19.0,21.0,19.0,1595.0,17.7,0.0,1.0,1.0,0.0,0.0,0.0,1.0,0.0,0.4,0.4,3.1,3.5,66.0,82.0,147.0,0.0,0.06,0.06,0.0,0.06,0.02,0.18,0.2,0.02,0.2,Matches,Malo Gusto,D/WB RC,19,124,-85,France,Olympique Lyonnais,5,12,10,5,12,5,10,9,10,12,12,5,13,13,12,12,13,11,9,11,10,14,12,8,14,11,13,15,15,14,11,10,15,15,15,12,11,12,14,7,17,3,1,2,3,1,3,3,2,2,3,2,19,12,8,10,10,11,13,18,1,1,1,20,1,20,14,1,15,1,1,11,1,1,179,67,6,20,63331488,6600,6200,2000,Mixed_Race,114,10,2003/5/19,0,0,7671.0,,49056280
924,Massadio Haïdara,Lens,1992,264.0,ml MLI,DFMF,29.0,18.6,24.0,16.0,9.0,9.0,6.0,12.0,24.0,50.0,12.0,26.0,9.0,17.0,36.0,60.0,39.0,1.0,Matches,264.0,ml MLI,DFMF,29.0,18.6,18.0,0.97,15.0,0.0,1.0,0.0,1.0,1.0,3.0,0.16,1.0,0.0,0.0,0.0,1.0,1.0,Matches,,,,,,,,,,,,,,,,,,,,,,,,,,,,,,,,,,,,,,,,,,,,,,,,,,,,,,,,264.0,ml MLI,DFMF,29.0,18.6,5.0,0.0,0.0,19.0,26.0,4.0,26.0,36.0,16.0,1.0,1.0,0.0,88.0,38.0,15.0,71.7,Matches,264.0,ml MLI,DFMF,29.0,18.6,996.0,873.0,116.0,28.0,1.0,3.0,26.0,76.0,0.0,0.0,0.0,0.0,843.0,7.0,11.0,Matches,264.0,ml MLI,DFMF,29.0,18.6,843.0,996.0,84.6,13642.0,4334.0,416.0,461.0,90.2,349.0,407.0,85.7,49.0,78.0,62.8,1.0,1.1,1.5,-0.1,8.0,62.0,14.0,5.0,85.0,Matches,305,ml MLI,DFMF,29,36,1671.0,46.0,48.9,18.6,17,80.0,12,19,16.0,0,2.22,24.0,9.0,15.0,0.81,-0.43,32.3,21.7,10.7,0.58,-0.07,Matches,264.0,ml MLI,DFMF,29.0,18.6,1188.0,76.0,345.0,611.0,237.0,29.0,1188.0,20.0,8.0,40.0,6.0,30.0,823.0,4538.0,2253.0,23.0,29.0,5.0,25.0,5.0,751.0,58.0,Matches,264.0,ml MLI,DFMF,29.0,18.6,0.0,13.0,0.0,0.0,0.7,0.0,0.0,,11.6,0.0,0.0,0.0,2.1,2.1,0.16,-2.1,-2.1,Matches,264.0,ml MLI,DFMF,29.0,36.0,17.0,1671.0,18.6,0.0,1.0,1.0,0.0,0.0,0.0,5.0,0.0,2.1,2.1,1.1,3.2,23.0,85.0,58.0,0.0,0.05,0.05,0.0,0.05,0.11,0.06,0.17,0.11,0.17,Matches,Massadio Haïdara,D/WB L,29,121,125,"Mali,France",RC Lens,8,12,12,7,11,6,11,6,10,13,12,8,14,13,12,13,11,13,13,12,13,12,12,8,13,13,15,16,14,13,13,9,12,14,13,12,13,6,13,15,8,3,2,1,2,2,1,1,4,4,3,3,13,11,5,13,12,14,14,14,1,20,14,1,20,1,1,1,1,1,1,1,1,1,176,76,20,5,1399417,6047,6047,3597,African_Caribbean,122,17,1992/12/2,13,1,7535.0,,85078879
925,Achraf Hakimi,Paris S-G,1998,265.0,ma MAR,DFMF,23.0,22.8,54.0,34.0,19.0,20.0,15.0,31.0,59.0,52.5,28.0,34.0,2.0,32.0,16.0,70.0,19.0,0.0,Matches,265.0,ma MAR,DFMF,23.0,22.8,75.0,3.29,64.0,1.0,4.0,2.0,2.0,2.0,9.0,0.39,5.0,0.0,1.0,1.0,1.0,1.0,Matches,,,,,,,,,,,,,,,,,,,,,,,,,,,,,,,,,,,,,,,,,,,,,,,,,,,,,,,,265.0,ma MAR,DFMF,23.0,22.8,7.0,2.0,1.0,29.0,19.0,5.0,42.0,16.0,34.0,1.0,0.0,0.0,129.0,7.0,7.0,50.0,Matches,265.0,ma MAR,DFMF,23.0,22.8,1538.0,1422.0,116.0,12.0,1.0,1.0,42.0,101.0,3.0,0.0,0.0,0.0,1373.0,0.0,35.0,Matches,265.0,ma MAR,DFMF,23.0,22.8,1373.0,1538.0,89.3,17560.0,4800.0,875.0,952.0,91.9,378.0,416.0,90.9,28.0,40.0,70.0,3.0,3.0,5.3,0.0,33.0,49.0,46.0,13.0,99.0,Matches,306,ma MAR,DFMF,23,28,2053.0,73.0,60.0,22.8,23,86.0,19,5,17.0,1,2.14,57.0,19.0,38.0,1.67,0.94,48.9,27.2,21.7,0.95,0.41,Matches,265.0,ma MAR,DFMF,23.0,22.8,1772.0,49.0,361.0,716.0,713.0,82.0,1772.0,74.0,29.0,39.2,32.0,43.2,1414.0,7700.0,4281.0,85.0,66.0,22.0,29.0,23.0,1326.0,229.0,Matches,265.0,ma MAR,DFMF,23.0,22.8,5.0,18.0,9.0,50.0,0.79,0.39,0.28,0.56,14.9,0.0,0.0,0.0,3.8,3.8,0.21,1.2,1.2,Matches,265.0,ma MAR,DFMF,23.0,28.0,23.0,2053.0,22.8,5.0,3.0,8.0,5.0,0.0,0.0,7.0,2.0,3.8,3.8,3.0,6.8,85.0,99.0,229.0,0.22,0.13,0.35,0.22,0.35,0.17,0.13,0.3,0.17,0.3,Matches,Achraf Hakimi,D/WB/M R,23,160,172,"Morocco,Spain",Paris Saint-Germain,7,15,13,14,14,12,8,13,12,10,14,8,13,14,14,13,12,12,10,13,12,15,14,8,18,10,12,14,18,14,14,9,17,20,14,11,14,8,13,4,15,3,2,2,3,2,3,3,1,1,1,2,15,16,10,12,14,14,11,13,1,12,1,20,13,20,1,12,1,17,8,1,10,1,181,73,10,20,164955893,8000,8000,7900,North_African__Middle_Eastern,139,8,1998/11/4,51,8,199067.0,,67228634
926,Romain Hamouma,Ajaccio,1987,268.0,fr FRA,FWMF,35.0,12.0,8.0,3.0,3.0,3.0,2.0,3.0,6.0,50.0,3.0,8.0,0.0,8.0,2.0,10.0,2.0,0.0,Matches,268.0,fr FRA,FWMF,35.0,12.0,35.0,2.92,20.0,6.0,2.0,3.0,4.0,0.0,6.0,0.5,4.0,0.0,0.0,1.0,1.0,0.0,Matches,,,,,,,,,,,,,,,,,,,,,,,,,,,,,,,,,,,,,,,,,,,,,,,,,,,,,,,,268.0,fr FRA,FWMF,35.0,12.0,5.0,2.0,2.0,18.0,15.0,4.0,54.0,2.0,3.0,2.0,0.0,0.0,33.0,12.0,18.0,40.0,Matches,268.0,fr FRA,FWMF,35.0,12.0,364.0,305.0,57.0,13.0,0.0,1.0,54.0,7.0,20.0,4.0,14.0,0.0,263.0,2.0,13.0,Matches,268.0,fr FRA,FWMF,35.0,12.0,263.0,364.0,72.3,3933.0,1204.0,118.0,144.0,81.9,98.0,134.0,73.1,15.0,33.0,45.5,2.0,2.3,1.5,-0.3,13.0,29.0,8.0,1.0,47.0,Matches,310,fr FRA,FWMF,35,19,1079.0,57.0,31.5,12.0,14,69.0,1,5,24.0,1,0.63,12.0,25.0,-13.0,-1.08,0.38,16.9,16.2,0.7,0.06,0.77,Matches,268.0,fr FRA,FWMF,35.0,12.0,490.0,4.0,23.0,229.0,244.0,42.0,490.0,38.0,16.0,42.1,21.0,55.3,360.0,2325.0,918.0,29.0,16.0,11.0,38.0,14.0,355.0,110.0,Matches,268.0,fr FRA,FWMF,35.0,12.0,2.0,16.0,6.0,37.5,1.33,0.5,0.13,0.33,15.3,1.0,0.0,0.0,3.0,3.0,0.19,-1.0,-1.0,Matches,268.0,fr FRA,FWMF,35.0,19.0,14.0,1079.0,12.0,2.0,2.0,4.0,2.0,0.0,0.0,5.0,2.0,3.0,3.0,2.3,5.3,29.0,47.0,110.0,0.17,0.17,0.33,0.17,0.33,0.25,0.19,0.44,0.25,0.44,Matches,Romain Hamouma,M/AM R,35,122,134,"France,Algeria",AC Ajaccio,12,13,14,12,15,11,6,11,4,3,12,8,5,14,9,11,11,12,10,13,12,14,14,10,14,6,10,13,14,14,12,8,13,13,12,12,12,9,14,11,10,3,2,3,3,1,2,1,1,3,1,2,16,13,6,14,14,13,15,15,1,1,1,1,1,1,1,12,1,16,13,10,20,12,177,67,10,20,184711,6100,6100,3900,Northern_European,121,6,1987/3/29,0,0,15548.0,,8443441
927,Christophe Hérelle,Brest,1992,274.0,mq MTQ,DF,29.0,11.8,10.0,4.0,7.0,2.0,1.0,4.0,13.0,30.8,9.0,16.0,11.0,5.0,20.0,30.0,48.0,0.0,Matches,274.0,mq MTQ,DF,29.0,11.8,6.0,0.51,4.0,1.0,0.0,1.0,0.0,0.0,0.0,0.0,0.0,0.0,0.0,0.0,0.0,0.0,Matches,,,,,,,,,,,,,,,,,,,,,,,,,,,,,,,,,,,,,,,,,,,,,,,,,,,,,,,,274.0,mq MTQ,DF,29.0,11.8,2.0,0.0,0.0,13.0,14.0,0.0,2.0,20.0,4.0,0.0,2.0,1.0,58.0,11.0,10.0,52.4,Matches,274.0,mq MTQ,DF,29.0,11.8,440.0,423.0,17.0,10.0,0.0,2.0,2.0,7.0,0.0,0.0,0.0,0.0,377.0,0.0,6.0,Matches,274.0,mq MTQ,DF,29.0,11.8,377.0,440.0,85.7,7609.0,2474.0,107.0,120.0,89.2,207.0,230.0,90.0,53.0,69.0,76.8,0.0,0.1,0.2,-0.1,3.0,9.0,2.0,0.0,24.0,Matches,317,mq MTQ,DF,29,16,1060.0,66.0,31.0,11.8,12,84.0,9,4,13.0,17,0.94,10.0,14.0,-4.0,-0.34,-0.11,10.8,21.5,-10.7,-0.91,-0.83,Matches,274.0,mq MTQ,DF,29.0,11.8,552.0,85.0,323.0,210.0,25.0,5.0,552.0,2.0,1.0,50.0,1.0,50.0,378.0,1879.0,787.0,2.0,2.0,0.0,3.0,1.0,322.0,2.0,Matches,274.0,mq MTQ,DF,29.0,11.8,0.0,3.0,0.0,0.0,0.25,0.0,0.0,,16.4,0.0,0.0,0.0,0.1,0.1,0.04,-0.1,-0.1,Matches,274.0,mq MTQ,DF,29.0,16.0,12.0,1060.0,11.8,0.0,0.0,0.0,0.0,0.0,0.0,2.0,0.0,0.1,0.1,0.1,0.2,2.0,24.0,2.0,0.0,0.0,0.0,0.0,0.0,0.01,0.01,0.02,0.01,0.02,Matches,Christophe Hérelle,D RC,29,120,130,"France,Martinique",Stade Brestois 29,5,10,8,6,11,5,14,10,5,15,12,6,14,12,14,14,15,12,13,8,13,14,5,10,10,14,14,14,11,13,15,14,15,12,14,14,12,10,12,6,12,1,1,3,2,1,3,3,2,2,2,4,9,14,8,12,10,12,10,10,1,1,20,15,1,13,13,1,1,1,1,1,1,1,188,75,6,20,1515316,6000,6450,3909,African_Caribbean,129,15,1992/8/22,0,0,5749.0,,85076637
928,Franck Honorat,Brest,1996,276.0,fr FRA,FWMF,25.0,28.2,41.0,29.0,20.0,8.0,13.0,19.0,34.0,55.9,15.0,22.0,2.0,20.0,21.0,62.0,18.0,0.0,Matches,276.0,fr FRA,FWMF,25.0,28.2,132.0,4.69,80.0,37.0,5.0,7.0,3.0,0.0,11.0,0.39,5.0,4.0,1.0,1.0,0.0,0.0,Matches,,,,,,,,,,,,,,,,,,,,,,,,,,,,,,,,,,,,,,,,,,,,,,,,,,,,,,,,276.0,fr FRA,FWMF,25.0,28.2,1.0,0.0,0.0,23.0,18.0,9.0,214.0,21.0,29.0,0.0,1.0,0.0,134.0,13.0,36.0,26.5,Matches,276.0,fr FRA,FWMF,25.0,28.2,1043.0,904.0,133.0,23.0,1.0,9.0,214.0,12.0,87.0,34.0,41.0,2.0,691.0,6.0,35.0,Matches,276.0,fr FRA,FWMF,25.0,28.2,691.0,1043.0,66.3,11988.0,3679.0,330.0,430.0,76.7,236.0,326.0,72.4,87.0,201.0,43.3,5.0,9.4,7.5,-4.4,89.0,40.0,49.0,26.0,70.0,Matches,319,fr FRA,FWMF,25,33,2535.0,77.0,74.1,28.2,29,84.0,16,4,28.0,0,1.24,33.0,34.0,-1.0,-0.04,0.88,32.4,41.8,-9.4,-0.33,0.0,Matches,276.0,fr FRA,FWMF,25.0,28.2,1317.0,20.0,172.0,466.0,704.0,98.0,1317.0,55.0,15.0,27.3,35.0,63.6,919.0,6109.0,2757.0,98.0,63.0,30.0,56.0,21.0,850.0,261.0,Matches,276.0,fr FRA,FWMF,25.0,28.2,6.0,47.0,17.0,36.2,1.67,0.6,0.13,0.35,18.1,4.0,0.0,0.0,4.8,4.8,0.1,1.2,1.2,Matches,276.0,fr FRA,FWMF,25.0,33.0,29.0,2535.0,28.2,6.0,5.0,11.0,6.0,0.0,0.0,1.0,0.0,4.8,4.8,9.4,14.2,98.0,70.0,261.0,0.21,0.18,0.39,0.21,0.39,0.17,0.33,0.5,0.17,0.5,Matches,Franck Honorat,M/AM RL,25,133,136,France,Stade Brestois 29,9,14,13,11,13,12,12,12,5,5,13,12,6,13,6,11,10,13,12,13,12,12,14,7,12,10,14,13,16,13,12,10,14,15,14,12,13,9,12,7,11,3,1,2,3,2,2,1,3,2,1,1,8,13,7,13,10,13,10,12,1,1,1,1,1,13,1,15,1,17,17,1,20,10,180,70,8,20,6704434,6650,6650,3808,Northern_European,131,5,1996/8/11,0,0,8008.0,,48036785
929,Cédric Hountondji,Angers,1994,277.0,bj BEN,DF,28.0,34.4,50.0,36.0,31.0,17.0,2.0,19.0,29.0,65.5,10.0,44.0,22.0,22.0,59.0,109.0,132.0,1.0,Matches,277.0,bj BEN,DF,28.0,34.4,13.0,0.38,12.0,0.0,0.0,1.0,0.0,0.0,2.0,0.06,1.0,0.0,0.0,1.0,0.0,0.0,Matches,,,,,,,,,,,,,,,,,,,,,,,,,,,,,,,,,,,,,,,,,,,,,,,,,,,,,,,,277.0,bj BEN,DF,28.0,34.4,7.0,0.0,0.0,42.0,11.0,0.0,2.0,59.0,36.0,0.0,3.0,2.0,151.0,63.0,31.0,67.0,Matches,277.0,bj BEN,DF,28.0,34.4,1446.0,1400.0,44.0,38.0,0.0,8.0,2.0,6.0,0.0,0.0,0.0,0.0,1251.0,2.0,6.0,Matches,277.0,bj BEN,DF,28.0,34.4,1251.0,1446.0,86.5,24457.0,8657.0,407.0,444.0,91.7,704.0,768.0,91.7,127.0,202.0,62.9,0.0,0.4,0.7,-0.4,4.0,50.0,3.0,0.0,84.0,Matches,320,bj BEN,DF,28,36,3095.0,86.0,90.5,34.4,35,87.0,32,1,35.0,0,0.5,31.0,73.0,-42.0,-1.22,0.44,39.1,55.9,-16.8,-0.49,0.61,Matches,277.0,bj BEN,DF,28.0,34.4,1774.0,235.0,925.0,814.0,39.0,23.0,1774.0,2.0,1.0,50.0,1.0,50.0,1217.0,6039.0,2978.0,5.0,9.0,2.0,8.0,3.0,1075.0,1.0,Matches,277.0,bj BEN,DF,28.0,34.4,0.0,11.0,4.0,36.4,0.32,0.12,0.0,0.0,8.9,0.0,0.0,0.0,1.1,1.1,0.1,-1.1,-1.1,Matches,277.0,bj BEN,DF,28.0,36.0,35.0,3095.0,34.4,0.0,0.0,0.0,0.0,0.0,0.0,7.0,0.0,1.1,1.1,0.4,1.6,5.0,84.0,1.0,0.0,0.0,0.0,0.0,0.0,0.03,0.01,0.05,0.03,0.05,Matches,Cédric Hountondji,D C,28,124,125,"Benin,France",Angers SCO,3,5,6,5,8,5,14,7,5,13,12,6,15,10,11,13,13,10,14,7,13,11,6,8,8,14,12,12,13,12,16,17,15,12,13,15,12,12,12,5,8,2,3,3,2,2,1,1,1,2,1,3,12,13,6,10,12,10,15,15,1,1,20,1,1,1,12,1,1,1,1,1,1,1,195,85,5,20,1993216,6040,6040,3690,African_Caribbean,123,14,1994/1/19,17,0,7363.0,,85048646
930,Adrien Hunou,Angers,1994,279.0,fr FRA,MFFW,28.0,24.8,39.0,20.0,17.0,16.0,6.0,16.0,45.0,35.6,29.0,35.0,0.0,35.0,7.0,46.0,7.0,0.0,Matches,279.0,fr FRA,MFFW,28.0,24.8,48.0,1.94,36.0,1.0,1.0,3.0,7.0,0.0,6.0,0.24,3.0,0.0,0.0,1.0,2.0,0.0,Matches,,,,,,,,,,,,,,,,,,,,,,,,,,,,,,,,,,,,,,,,,,,,,,,,,,,,,,,,279.0,fr FRA,MFFW,28.0,24.8,2.0,0.0,0.0,14.0,45.0,5.0,16.0,7.0,20.0,2.0,1.0,0.0,108.0,19.0,28.0,40.4,Matches,279.0,fr FRA,MFFW,28.0,24.8,753.0,712.0,34.0,2.0,2.0,1.0,16.0,13.0,4.0,1.0,1.0,0.0,572.0,7.0,17.0,Matches,279.0,fr FRA,MFFW,28.0,24.8,572.0,753.0,76.0,8441.0,2005.0,287.0,363.0,79.1,225.0,268.0,84.0,24.0,47.0,51.1,1.0,2.3,0.9,-1.3,18.0,38.0,12.0,1.0,62.0,Matches,322,fr FRA,MFFW,28,34,2234.0,66.0,65.3,24.8,28,75.0,7,6,23.0,4,0.5,22.0,53.0,-31.0,-1.25,0.04,27.3,40.1,-12.8,-0.52,0.09,Matches,279.0,fr FRA,MFFW,28.0,24.8,1008.0,10.0,138.0,508.0,374.0,69.0,1008.0,34.0,13.0,38.2,16.0,47.1,769.0,4108.0,1515.0,34.0,36.0,10.0,58.0,23.0,717.0,149.0,Matches,279.0,fr FRA,MFFW,28.0,24.8,4.0,45.0,18.0,40.0,1.81,0.73,0.09,0.22,13.2,0.0,0.0,0.0,6.5,6.5,0.14,-2.5,-2.5,Matches,279.0,fr FRA,MFFW,28.0,34.0,28.0,2234.0,24.8,4.0,1.0,5.0,4.0,0.0,0.0,2.0,0.0,6.5,6.5,2.3,8.7,34.0,62.0,149.0,0.16,0.04,0.2,0.16,0.2,0.26,0.09,0.35,0.26,0.35,Matches,Adrien Hunou,AM/S C,28,127,134,France,Angers SCO,8,11,12,14,13,11,14,11,6,8,13,10,10,14,10,17,13,11,12,14,12,14,14,10,12,12,13,14,13,14,12,11,12,13,13,12,11,12,12,11,13,3,1,3,2,1,2,2,2,3,2,1,16,12,7,14,13,14,15,15,1,1,1,1,1,1,1,8,10,12,12,18,14,20,179,70,8,20,3914500,6348,6348,4098,Northern_European,127,5,1994/1/19,0,0,12329.0,,85103859
931,Bonke Innocent,Lorient,1996,282.0,ng NGA,MF,26.0,13.1,28.0,17.0,13.0,14.0,1.0,11.0,36.0,30.6,25.0,22.0,5.0,17.0,26.0,54.0,31.0,0.0,Matches,282.0,ng NGA,MF,26.0,13.1,17.0,1.3,14.0,0.0,0.0,2.0,0.0,1.0,4.0,0.3,4.0,0.0,0.0,0.0,0.0,0.0,Matches,,,,,,,,,,,,,,,,,,,,,,,,,,,,,,,,,,,,,,,,,,,,,,,,,,,,,,,,282.0,ng NGA,MF,26.0,13.1,5.0,0.0,0.0,38.0,11.0,0.0,0.0,26.0,17.0,0.0,1.0,0.0,77.0,9.0,20.0,31.0,Matches,282.0,ng NGA,MF,26.0,13.1,577.0,568.0,9.0,8.0,0.0,4.0,0.0,1.0,0.0,0.0,0.0,0.0,515.0,0.0,5.0,Matches,282.0,ng NGA,MF,26.0,13.1,515.0,577.0,89.3,8110.0,1984.0,245.0,268.0,91.4,211.0,230.0,91.7,31.0,43.0,72.1,1.0,0.3,0.2,0.7,5.0,30.0,1.0,0.0,31.0,Matches,325,ng NGA,MF,26,25,1182.0,47.0,34.6,13.1,14,67.0,2,11,23.0,7,1.6,18.0,19.0,-1.0,-0.08,-0.08,11.3,22.4,-11.1,-0.85,-0.75,Matches,282.0,ng NGA,MF,26.0,13.1,718.0,60.0,252.0,424.0,47.0,2.0,718.0,8.0,6.0,75.0,0.0,0.0,503.0,2178.0,742.0,3.0,8.0,0.0,7.0,4.0,442.0,0.0,Matches,282.0,ng NGA,MF,26.0,13.1,0.0,4.0,0.0,0.0,0.3,0.0,0.0,,26.3,0.0,0.0,0.0,0.1,0.1,0.03,-0.1,-0.1,Matches,282.0,ng NGA,MF,26.0,25.0,14.0,1182.0,13.1,0.0,1.0,1.0,0.0,0.0,0.0,5.0,0.0,0.1,0.1,0.3,0.4,3.0,31.0,0.0,0.0,0.08,0.08,0.0,0.08,0.01,0.02,0.03,0.01,0.03,Matches,Bonke Innocent,DM/M C,26,120,129,Nigeria,FC Lorient,6,11,10,6,13,7,11,8,9,13,13,8,14,12,14,14,14,13,14,11,11,15,11,7,12,13,13,14,13,12,14,10,16,13,14,14,12,14,12,6,11,1,3,3,3,3,3,1,1,3,2,3,10,12,10,13,14,14,10,9,1,1,8,8,1,1,20,1,18,1,1,1,1,1,178,80,8,20,1591822,5996,5496,3246,African_Caribbean,120,16,1996/1/20,4,0,6395.0,,53114974
932,Ismaily,Lille,1990,283.0,br BRA,DF,32.0,19.8,41.0,18.0,16.0,16.0,9.0,17.0,32.0,53.1,15.0,25.0,5.0,20.0,21.0,62.0,39.0,0.0,Matches,283.0,br BRA,DF,32.0,19.8,42.0,2.13,38.0,0.0,0.0,2.0,1.0,1.0,6.0,0.3,4.0,0.0,0.0,1.0,1.0,0.0,Matches,,,,,,,,,,,,,,,,,,,,,,,,,,,,,,,,,,,,,,,,,,,,,,,,,,,,,,,,283.0,br BRA,DF,32.0,19.8,0.0,0.0,0.0,14.0,22.0,2.0,15.0,21.0,18.0,1.0,0.0,0.0,112.0,36.0,22.0,62.1,Matches,283.0,br BRA,DF,32.0,19.8,1153.0,972.0,179.0,21.0,1.0,1.0,15.0,158.0,0.0,0.0,0.0,0.0,938.0,2.0,37.0,Matches,283.0,br BRA,DF,32.0,19.8,938.0,1153.0,81.4,13089.0,4383.0,570.0,650.0,87.7,317.0,376.0,84.3,23.0,54.0,42.6,1.0,2.3,2.2,-1.3,20.0,67.0,14.0,1.0,95.0,Matches,326,br BRA,DF,32,23,1779.0,77.0,52.0,19.8,21,80.0,14,2,45.0,3,1.57,27.0,23.0,4.0,0.2,-0.73,32.2,23.3,8.9,0.45,-0.61,Matches,283.0,br BRA,DF,32.0,19.8,1359.0,53.0,325.0,668.0,379.0,46.0,1359.0,39.0,17.0,43.6,17.0,43.6,901.0,4750.0,2254.0,40.0,45.0,9.0,25.0,29.0,825.0,116.0,Matches,283.0,br BRA,DF,32.0,19.8,2.0,13.0,6.0,46.2,0.66,0.3,0.15,0.33,17.4,0.0,0.0,0.0,1.2,1.2,0.09,0.8,0.8,Matches,283.0,br BRA,DF,32.0,23.0,21.0,1779.0,19.8,2.0,1.0,3.0,2.0,0.0,0.0,0.0,0.0,1.2,1.2,2.3,3.5,40.0,95.0,116.0,0.1,0.05,0.15,0.1,0.15,0.06,0.12,0.18,0.06,0.18,Matches,Ismaily,D/WB L,32,130,165,Brazil,LOSC Lille,11,16,17,9,14,13,11,14,10,11,13,12,13,14,11,13,11,13,12,12,13,15,13,9,15,11,15,17,13,13,14,8,15,14,12,12,18,9,13,7,11,1,4,1,1,2,2,1,1,1,1,3,9,11,6,13,12,15,13,13,1,20,1,1,18,1,1,10,1,1,10,1,1,1,177,86,20,6,4737274,7000,4730,5846,North_African__Middle_Eastern,128,9,1990/1/11,0,0,32845.0,,19108573
933,Ismail Jakobs,Monaco,1999,285.0,sn SEN,DFFW,22.0,12.4,11.0,5.0,7.0,3.0,1.0,5.0,12.0,41.7,7.0,9.0,1.0,8.0,9.0,20.0,18.0,0.0,Matches,285.0,sn SEN,DFFW,22.0,12.4,30.0,2.41,24.0,2.0,1.0,3.0,0.0,0.0,2.0,0.16,2.0,0.0,0.0,0.0,0.0,0.0,Matches,,,,,,,,,,,,,,,,,,,,,,,,,,,,,,,,,,,,,,,,,,,,,,,,,,,,,,,,285.0,sn SEN,DFFW,22.0,12.4,3.0,0.0,0.0,14.0,9.0,1.0,61.0,9.0,5.0,0.0,0.0,0.0,46.0,50.0,26.0,65.8,Matches,285.0,sn SEN,DFFW,22.0,12.4,656.0,560.0,89.0,12.0,1.0,2.0,61.0,74.0,3.0,1.0,0.0,0.0,423.0,7.0,27.0,Matches,285.0,sn SEN,DFFW,22.0,12.4,423.0,656.0,64.5,6246.0,2158.0,231.0,300.0,77.0,138.0,214.0,64.5,26.0,78.0,33.3,2.0,1.5,1.4,0.5,12.0,36.0,18.0,10.0,46.0,Matches,329,sn SEN,DFFW,22,32,1119.0,35.0,32.7,12.4,9,81.0,7,23,17.0,3,1.63,18.0,29.0,-11.0,-0.88,-1.78,19.9,22.3,-2.4,-0.19,-0.64,Matches,285.0,sn SEN,DFFW,22.0,12.4,749.0,24.0,145.0,311.0,299.0,41.0,749.0,12.0,5.0,41.7,6.0,50.0,483.0,2986.0,1332.0,39.0,31.0,8.0,17.0,7.0,493.0,109.0,Matches,285.0,sn SEN,DFFW,22.0,12.4,0.0,14.0,6.0,42.9,1.13,0.48,0.0,0.0,15.2,1.0,0.0,0.0,1.0,1.0,0.07,-1.0,-1.0,Matches,285.0,sn SEN,DFFW,22.0,32.0,9.0,1119.0,12.4,0.0,2.0,2.0,0.0,0.0,0.0,3.0,0.0,1.0,1.0,1.5,2.5,39.0,46.0,109.0,0.0,0.16,0.16,0.0,0.16,0.08,0.12,0.2,0.08,0.2,Matches,Ismail Jakobs,D/WB/M/AM L,22,130,141,"Senegal,Germany",AS Monaco,8,13,12,9,12,8,8,9,9,10,11,9,11,11,16,12,13,9,9,9,10,14,10,6,11,10,12,15,15,11,12,8,12,17,15,10,10,7,10,14,14,3,4,2,1,2,3,3,1,4,1,2,7,14,7,15,15,15,13,13,1,17,1,5,17,8,1,20,1,8,17,5,8,5,184,75,20,10,5259999,6500,6500,4254,African_Caribbean,113,10,1999/8/17,0,0,17224.0,,91184349
934,Jubal,Auxerre,1993,293.0,br BRA,DF,28.0,35.7,41.0,26.0,29.0,11.0,1.0,19.0,38.0,50.0,19.0,57.0,34.0,23.0,53.0,94.0,193.0,0.0,Matches,293.0,br BRA,DF,28.0,35.7,19.0,0.53,13.0,3.0,0.0,2.0,1.0,0.0,2.0,0.06,1.0,0.0,0.0,0.0,1.0,0.0,Matches,,,,,,,,,,,,,,,,,,,,,,,,,,,,,,,,,,,,,,,,,,,,,,,,,,,,,,,,293.0,br BRA,DF,28.0,35.7,7.0,0.0,0.0,38.0,24.0,4.0,4.0,53.0,26.0,1.0,0.0,0.0,178.0,76.0,56.0,57.6,Matches,293.0,br BRA,DF,28.0,35.7,1345.0,1280.0,64.0,63.0,1.0,22.0,4.0,1.0,0.0,0.0,0.0,0.0,1099.0,1.0,5.0,Matches,293.0,br BRA,DF,28.0,35.7,1099.0,1345.0,81.7,24023.0,7984.0,294.0,353.0,83.3,581.0,637.0,91.2,197.0,318.0,61.9,1.0,0.4,0.9,0.6,4.0,65.0,4.0,2.0,73.0,Matches,338,br BRA,DF,28,37,3217.0,87.0,94.1,35.7,35,90.0,35,2,34.0,1,0.95,35.0,58.0,-23.0,-0.64,1.57,40.4,55.0,-14.6,-0.41,0.11,Matches,293.0,br BRA,DF,28.0,35.7,1774.0,305.0,979.0,749.0,57.0,31.0,1773.0,7.0,2.0,28.6,2.0,28.6,1106.0,5884.0,2794.0,7.0,11.0,0.0,23.0,4.0,972.0,1.0,Matches,293.0,br BRA,DF,28.0,35.7,3.0,18.0,5.0,27.8,0.5,0.14,0.11,0.4,11.6,0.0,1.0,1.0,3.1,2.3,0.13,-0.1,-0.3,Matches,293.0,br BRA,DF,28.0,37.0,35.0,3217.0,35.7,3.0,1.0,4.0,2.0,1.0,1.0,7.0,0.0,3.1,2.3,0.4,2.7,7.0,73.0,1.0,0.08,0.03,0.11,0.06,0.08,0.09,0.01,0.1,0.06,0.08,Matches,Jubal,D C,28,120,130,Brazil,AJ Auxerre,5,6,8,7,8,5,14,7,6,13,10,5,13,11,14,14,15,11,15,9,12,14,8,11,10,12,13,13,12,12,13,15,14,13,13,13,13,14,13,6,6,1,1,2,2,2,3,4,1,3,3,1,14,13,12,7,11,7,13,12,1,1,20,5,1,1,1,1,1,1,1,1,1,1,190,82,8,20,1498951,5991,5991,3491,African_Caribbean,119,12,1993/8/29,0,0,6395.0,,19172374
935,Christopher Jullien,Montpellier,1993,294.0,fr FRA,DF,29.0,29.9,46.0,28.0,29.0,14.0,3.0,28.0,51.0,54.9,23.0,35.0,18.0,17.0,43.0,89.0,114.0,1.0,Matches,294.0,fr FRA,DF,29.0,29.9,19.0,0.63,16.0,1.0,0.0,2.0,0.0,0.0,4.0,0.13,3.0,0.0,0.0,1.0,0.0,0.0,Matches,,,,,,,,,,,,,,,,,,,,,,,,,,,,,,,,,,,,,,,,,,,,,,,,,,,,,,,,294.0,fr FRA,DF,29.0,29.9,5.0,0.0,0.0,33.0,6.0,3.0,0.0,43.0,28.0,0.0,2.0,0.0,141.0,86.0,40.0,68.3,Matches,294.0,fr FRA,DF,29.0,29.9,1065.0,1017.0,46.0,40.0,1.0,10.0,0.0,3.0,0.0,0.0,0.0,0.0,884.0,2.0,8.0,Matches,294.0,fr FRA,DF,29.0,29.9,884.0,1065.0,83.0,17736.0,6583.0,284.0,347.0,81.8,456.0,507.0,89.9,122.0,180.0,67.8,2.0,1.1,1.0,0.9,7.0,30.0,1.0,0.0,52.0,Matches,339,fr FRA,DF,29,30,2695.0,90.0,78.8,29.9,30,90.0,29,0,,3,1.37,51.0,45.0,6.0,0.2,0.57,41.4,47.6,-6.2,-0.21,0.26,Matches,294.0,fr FRA,DF,29.0,29.9,1360.0,239.0,746.0,574.0,47.0,32.0,1360.0,5.0,5.0,100.0,0.0,0.0,850.0,4177.0,1890.0,2.0,4.0,1.0,15.0,4.0,755.0,6.0,Matches,294.0,fr FRA,DF,29.0,29.9,0.0,17.0,2.0,11.8,0.57,0.07,0.0,0.0,8.6,0.0,0.0,0.0,2.0,2.0,0.12,-2.0,-2.0,Matches,294.0,fr FRA,DF,29.0,30.0,30.0,2695.0,29.9,0.0,2.0,2.0,0.0,0.0,0.0,5.0,0.0,2.0,2.0,1.1,3.1,2.0,52.0,6.0,0.0,0.07,0.07,0.0,0.07,0.07,0.04,0.1,0.07,0.1,Matches,Christopher Jullien,D C,29,125,135,"France,Guadeloupe",Montpellier Hérault SC,4,7,6,11,10,4,14,7,10,15,12,5,12,10,14,13,14,11,11,10,11,11,5,14,6,12,14,12,13,12,13,17,15,14,14,13,14,12,13,10,10,1,3,1,2,3,3,1,3,1,2,1,7,14,10,12,7,10,14,14,1,1,20,1,1,1,1,1,1,1,1,1,1,1,196,88,8,20,2454812,6250,6250,4500,Mixed_Race,123,12,1993/3/22,0,0,14999.0,,85051582
936,Issa Kaboré,Marseille,2001,296.0,bf BFA,DF,21.0,11.4,33.0,19.0,10.0,18.0,5.0,21.0,32.0,65.6,11.0,11.0,1.0,10.0,12.0,45.0,21.0,1.0,Matches,296.0,bf BFA,DF,21.0,11.4,35.0,3.06,30.0,1.0,3.0,0.0,1.0,0.0,1.0,0.09,1.0,0.0,0.0,0.0,0.0,0.0,Matches,,,,,,,,,,,,,,,,,,,,,,,,,,,,,,,,,,,,,,,,,,,,,,,,,,,,,,,,296.0,bf BFA,DF,21.0,11.4,1.0,0.0,0.0,24.0,19.0,2.0,48.0,12.0,19.0,0.0,0.0,0.0,62.0,3.0,7.0,30.0,Matches,296.0,bf BFA,DF,21.0,11.4,567.0,469.0,97.0,2.0,0.0,2.0,48.0,95.0,0.0,0.0,0.0,0.0,436.0,1.0,24.0,Matches,296.0,bf BFA,DF,21.0,11.4,436.0,567.0,76.9,6207.0,2017.0,252.0,291.0,86.6,138.0,181.0,76.2,22.0,47.0,46.8,0.0,0.9,1.3,-0.9,13.0,23.0,16.0,6.0,54.0,Matches,341,bf BFA,DF,21,22,1028.0,47.0,30.1,11.4,9,78.0,5,13,25.0,13,2.0,20.0,11.0,9.0,0.79,0.11,21.6,9.6,12.1,1.05,0.65,Matches,296.0,bf BFA,DF,21.0,11.4,734.0,29.0,155.0,290.0,299.0,39.0,734.0,54.0,23.0,42.6,23.0,42.6,510.0,3205.0,1531.0,39.0,27.0,10.0,33.0,13.0,464.0,130.0,Matches,296.0,bf BFA,DF,21.0,11.4,1.0,8.0,3.0,37.5,0.7,0.26,0.13,0.33,16.2,0.0,0.0,0.0,0.9,0.9,0.11,0.1,0.1,Matches,296.0,bf BFA,DF,21.0,22.0,9.0,1028.0,11.4,1.0,0.0,1.0,1.0,0.0,0.0,1.0,0.0,0.9,0.9,0.9,1.7,39.0,54.0,130.0,0.09,0.0,0.09,0.09,0.09,0.07,0.08,0.15,0.07,0.15,Matches,Issa Kaboré,D R,21,118,143,Burkina Faso,Manchester City,10,11,12,10,12,7,8,8,8,11,12,10,11,12,14,12,12,12,12,9,12,14,13,8,14,11,10,10,16,13,8,8,12,16,12,12,11,5,11,5,1,2,3,4,2,1,2,1,2,1,3,1,14,18,5,12,9,11,13,12,1,1,1,20,1,15,1,1,1,1,1,1,1,1,180,70,10,20,16192446,5892,5892,3992,African_Caribbean,114,16,2001/5/12,26,1,11599.0,Olympique de Marseille,13196665
937,Arnaud Kalimuendo,Rennes,2002,299.0,fr FRA,FW,20.0,20.5,15.0,8.0,3.0,6.0,6.0,5.0,20.0,25.0,15.0,15.0,2.0,13.0,2.0,17.0,9.0,0.0,Matches,299.0,fr FRA,FW,20.0,20.5,35.0,1.7,24.0,0.0,1.0,6.0,3.0,1.0,6.0,0.29,5.0,0.0,0.0,1.0,0.0,0.0,Matches,,,,,,,,,,,,,,,,,,,,,,,,,,,,,,,,,,,,,,,,,,,,,,,,,,,,,,,,299.0,fr FRA,FW,20.0,20.5,0.0,0.0,0.0,15.0,24.0,7.0,14.0,2.0,8.0,0.0,0.0,0.0,53.0,13.0,66.0,16.5,Matches,299.0,fr FRA,FW,20.0,20.5,442.0,401.0,39.0,0.0,0.0,0.0,14.0,4.0,0.0,0.0,0.0,0.0,359.0,2.0,22.0,Matches,299.0,fr FRA,FW,20.0,20.5,359.0,442.0,81.2,4715.0,790.0,214.0,250.0,85.6,114.0,128.0,89.1,8.0,14.0,57.1,3.0,2.4,2.1,0.6,12.0,19.0,8.0,0.0,32.0,Matches,346,fr FRA,FW,20,30,1849.0,62.0,54.1,20.5,24,73.0,3,6,18.0,0,1.83,32.0,24.0,8.0,0.39,-0.87,31.0,26.0,5.0,0.24,-0.46,Matches,299.0,fr FRA,FW,20.0,20.5,659.0,12.0,48.0,278.0,343.0,104.0,659.0,55.0,25.0,45.5,26.0,47.3,490.0,2803.0,825.0,36.0,21.0,25.0,58.0,37.0,490.0,193.0,Matches,299.0,fr FRA,FW,20.0,20.5,7.0,43.0,21.0,48.8,2.09,1.02,0.16,0.33,14.0,0.0,0.0,0.0,7.5,7.5,0.18,-0.5,-0.5,Matches,299.0,fr FRA,FW,20.0,30.0,24.0,1849.0,20.5,7.0,3.0,10.0,7.0,0.0,0.0,0.0,0.0,7.5,7.5,2.4,9.9,36.0,32.0,193.0,0.34,0.15,0.49,0.34,0.49,0.36,0.12,0.48,0.36,0.48,Matches,Arnaud Kalimuendo,S,20,129,155,"France,Democratic Republic of Congo",Stade Rennais FC,7,9,14,15,13,7,11,11,6,7,12,12,7,14,7,13,13,14,12,13,14,15,14,8,15,6,12,14,15,15,13,8,13,14,13,12,13,8,13,8,10,1,1,1,1,2,1,3,3,1,1,3,12,14,7,8,13,14,13,12,1,1,1,1,1,1,1,1,1,1,1,1,1,20,175,78,8,20,23880000,6450,6450,3900,African_Caribbean,130,16,2002/1/20,0,0,25000.0,,49048445
938,Wahbi Khazri,Montpellier,1991,309.0,tn TUN,FWMF,31.0,18.2,26.0,13.0,13.0,7.0,6.0,6.0,25.0,24.0,19.0,17.0,1.0,16.0,9.0,35.0,20.0,0.0,Matches,309.0,tn TUN,FWMF,31.0,18.2,42.0,2.31,21.0,8.0,3.0,5.0,4.0,1.0,7.0,0.39,3.0,0.0,0.0,3.0,1.0,0.0,Matches,,,,,,,,,,,,,,,,,,,,,,,,,,,,,,,,,,,,,,,,,,,,,,,,,,,,,,,,309.0,tn TUN,FWMF,31.0,18.2,5.0,1.0,0.0,20.0,36.0,13.0,39.0,9.0,13.0,0.0,0.0,0.0,85.0,18.0,31.0,36.7,Matches,309.0,tn TUN,FWMF,31.0,18.2,483.0,421.0,58.0,16.0,3.0,11.0,39.0,11.0,18.0,9.0,9.0,0.0,344.0,4.0,20.0,Matches,309.0,tn TUN,FWMF,31.0,18.2,344.0,483.0,71.2,6049.0,1925.0,159.0,199.0,79.9,110.0,143.0,76.9,53.0,90.0,58.9,1.0,1.6,1.6,-0.6,19.0,41.0,12.0,2.0,49.0,Matches,361,tn TUN,FWMF,31,27,1635.0,61.0,47.8,18.2,20,72.0,5,7,29.0,2,1.33,30.0,28.0,2.0,0.11,0.06,23.6,28.1,-4.4,-0.24,0.03,Matches,309.0,tn TUN,FWMF,31.0,18.2,713.0,23.0,101.0,361.0,271.0,64.0,713.0,61.0,28.0,45.9,24.0,39.3,516.0,3522.0,1530.0,40.0,17.0,22.0,49.0,30.0,472.0,91.0,Matches,309.0,tn TUN,FWMF,31.0,18.2,4.0,38.0,16.0,42.1,2.09,0.88,0.11,0.25,22.2,0.0,0.0,0.0,4.1,4.1,0.11,-0.1,-0.1,Matches,309.0,tn TUN,FWMF,31.0,27.0,20.0,1635.0,18.2,4.0,1.0,5.0,4.0,0.0,0.0,5.0,1.0,4.1,4.1,1.6,5.8,40.0,49.0,91.0,0.22,0.06,0.28,0.22,0.28,0.23,0.09,0.32,0.23,0.32,Matches,Wahbi Khazri,AM LC,31,133,145,"Tunisia,France",Montpellier Hérault SC,16,14,14,13,14,15,7,13,5,4,13,13,5,15,11,12,12,14,12,14,12,13,14,12,14,7,12,12,13,13,14,9,12,14,13,12,12,11,15,5,12,2,2,4,2,3,1,2,1,2,2,1,6,15,7,16,11,13,16,14,1,1,1,1,1,1,1,1,13,1,18,20,1,15,182,76,12,20,3649987,6650,6650,5250,North_African__Middle_Eastern,132,11,1991/2/8,69,24,66739.0,,34011589
939,Sead Kolašinac,Marseille,1993,314.0,ba BIH,DF,29.0,24.6,52.0,36.0,24.0,22.0,6.0,24.0,37.0,64.9,13.0,19.0,2.0,17.0,43.0,95.0,35.0,1.0,Matches,314.0,ba BIH,DF,29.0,24.6,27.0,1.1,24.0,0.0,1.0,2.0,0.0,0.0,5.0,0.2,2.0,0.0,1.0,2.0,0.0,0.0,Matches,,,,,,,,,,,,,,,,,,,,,,,,,,,,,,,,,,,,,,,,,,,,,,,,,,,,,,,,314.0,ba BIH,DF,29.0,24.6,3.0,0.0,0.0,42.0,15.0,4.0,20.0,43.0,36.0,0.0,0.0,0.0,165.0,36.0,37.0,49.3,Matches,314.0,ba BIH,DF,29.0,24.6,1333.0,1261.0,68.0,23.0,1.0,3.0,20.0,45.0,0.0,0.0,0.0,0.0,1135.0,4.0,20.0,Matches,314.0,ba BIH,DF,29.0,24.6,1135.0,1333.0,85.1,17773.0,4570.0,572.0,628.0,91.1,478.0,549.0,87.1,48.0,84.0,57.1,1.0,0.9,1.7,0.1,11.0,93.0,11.0,2.0,109.0,Matches,366,ba BIH,DF,29,33,2214.0,67.0,64.7,24.6,26,80.0,14,7,19.0,0,1.94,49.0,22.0,27.0,1.1,1.1,45.7,24.8,20.9,0.85,0.7,Matches,314.0,ba BIH,DF,29.0,24.6,1547.0,67.0,408.0,831.0,322.0,48.0,1547.0,12.0,3.0,25.0,7.0,58.3,1140.0,6231.0,3393.0,49.0,37.0,6.0,25.0,6.0,994.0,86.0,Matches,314.0,ba BIH,DF,29.0,24.6,4.0,22.0,9.0,40.9,0.89,0.37,0.18,0.44,9.7,0.0,0.0,0.0,4.1,4.1,0.19,-0.1,-0.1,Matches,314.0,ba BIH,DF,29.0,33.0,26.0,2214.0,24.6,4.0,1.0,5.0,4.0,0.0,0.0,3.0,0.0,4.1,4.1,0.9,5.1,49.0,109.0,86.0,0.16,0.04,0.2,0.16,0.2,0.17,0.04,0.21,0.17,0.21,Matches,Sead Kolašinac,D/WB LC,29,132,144,"Bosnia and Herzegovina,Germany",Olympique de Marseille,6,10,11,7,12,6,13,8,13,13,11,8,15,11,17,12,18,10,11,9,11,17,9,9,12,12,15,17,14,13,15,12,18,16,14,17,12,14,14,7,14,2,1,4,1,2,4,1,2,4,1,2,12,16,13,10,15,12,10,10,1,19,16,1,20,1,12,12,10,1,1,1,1,1,183,82,20,8,6313376,6598,6998,6398,Mediterranean_Hispanic,129,7,1993/6/20,49,0,21155.0,,92029805
940,Ibrahima Koné,Lorient,1999,316.0,ml MLI,FW,23.0,17.5,24.0,13.0,3.0,13.0,8.0,5.0,11.0,45.5,6.0,13.0,0.0,13.0,4.0,28.0,18.0,0.0,Matches,316.0,ml MLI,FW,23.0,17.5,37.0,2.11,30.0,0.0,2.0,3.0,0.0,2.0,2.0,0.11,2.0,0.0,0.0,0.0,0.0,0.0,Matches,,,,,,,,,,,,,,,,,,,,,,,,,,,,,,,,,,,,,,,,,,,,,,,,,,,,,,,,316.0,ml MLI,FW,23.0,17.5,3.0,0.0,0.0,29.0,24.0,14.0,1.0,4.0,13.0,0.0,0.0,0.0,44.0,55.0,60.0,47.8,Matches,316.0,ml MLI,FW,23.0,17.5,359.0,351.0,8.0,0.0,2.0,0.0,1.0,1.0,0.0,0.0,0.0,0.0,240.0,0.0,11.0,Matches,316.0,ml MLI,FW,23.0,17.5,240.0,359.0,66.9,2822.0,790.0,151.0,205.0,73.7,59.0,100.0,59.0,3.0,7.0,42.9,1.0,1.0,1.0,0.0,15.0,17.0,3.0,0.0,27.0,Matches,368,ml MLI,FW,23,37,1577.0,43.0,46.1,17.5,15,76.0,5,22,20.0,1,1.46,24.0,23.0,1.0,0.06,0.15,19.0,25.1,-6.2,-0.35,0.01,Matches,316.0,ml MLI,FW,23.0,17.5,565.0,17.0,59.0,262.0,247.0,68.0,562.0,22.0,14.0,63.6,6.0,27.3,380.0,1873.0,577.0,15.0,13.0,10.0,65.0,27.0,421.0,109.0,Matches,316.0,ml MLI,FW,23.0,17.5,7.0,28.0,13.0,46.4,1.6,0.74,0.18,0.38,16.1,0.0,2.0,3.0,5.6,3.2,0.12,1.4,1.8,Matches,316.0,ml MLI,FW,23.0,37.0,15.0,1577.0,17.5,7.0,1.0,8.0,5.0,2.0,3.0,3.0,0.0,5.6,3.2,1.0,4.3,15.0,27.0,109.0,0.4,0.06,0.46,0.29,0.34,0.32,0.06,0.38,0.18,0.24,Matches,Ibrahima Koné,S,23,121,135,Mali,FC Lorient,5,7,10,13,12,7,13,10,6,7,10,12,6,12,10,12,13,12,10,11,10,13,12,8,13,7,14,16,13,11,13,15,13,13,14,16,12,5,10,8,7,1,2,2,3,1,2,2,2,1,1,2,12,13,8,8,7,13,10,9,1,1,1,1,1,1,1,1,1,1,1,1,1,20,190,84,20,12,2902682,6050,5800,3750,African_Caribbean,121,17,1999/6/16,14,11,7193.0,,12078238
941,Youssouf Koné,Ajaccio,1995,317.0,ml MLI,DF,27.0,10.2,28.0,19.0,24.0,4.0,0.0,18.0,25.0,72.0,7.0,9.0,2.0,7.0,12.0,40.0,32.0,1.0,Matches,317.0,ml MLI,DF,27.0,10.2,6.0,0.59,4.0,0.0,0.0,1.0,0.0,1.0,0.0,0.0,0.0,0.0,0.0,0.0,0.0,0.0,Matches,,,,,,,,,,,,,,,,,,,,,,,,,,,,,,,,,,,,,,,,,,,,,,,,,,,,,,,,317.0,ml MLI,DF,27.0,10.2,4.0,0.0,0.0,15.0,17.0,0.0,27.0,12.0,19.0,0.0,0.0,0.0,67.0,4.0,12.0,25.0,Matches,317.0,ml MLI,DF,27.0,10.2,426.0,355.0,70.0,9.0,0.0,2.0,27.0,61.0,0.0,0.0,0.0,0.0,322.0,1.0,7.0,Matches,317.0,ml MLI,DF,27.0,10.2,322.0,426.0,75.6,5724.0,2090.0,157.0,177.0,88.7,117.0,142.0,82.4,43.0,93.0,46.2,0.0,0.1,0.1,-0.1,1.0,22.0,3.0,2.0,23.0,Matches,369,ml MLI,DF,27,13,916.0,70.0,26.8,10.2,12,76.0,6,1,1.0,4,0.77,10.0,15.0,-5.0,-0.49,1.16,11.0,12.7,-1.7,-0.16,0.42,Matches,317.0,ml MLI,DF,27.0,10.2,531.0,52.0,218.0,265.0,54.0,1.0,531.0,19.0,8.0,42.1,4.0,21.1,345.0,1727.0,813.0,14.0,10.0,1.0,14.0,4.0,291.0,16.0,Matches,317.0,ml MLI,DF,27.0,10.2,0.0,1.0,1.0,100.0,0.1,0.1,0.0,0.0,27.6,0.0,0.0,0.0,0.0,0.0,0.04,0.0,0.0,Matches,317.0,ml MLI,DF,27.0,13.0,12.0,916.0,10.2,0.0,0.0,0.0,0.0,0.0,0.0,4.0,0.0,0.0,0.0,0.1,0.1,14.0,23.0,16.0,0.0,0.0,0.0,0.0,0.0,0.0,0.01,0.01,0.0,0.01,Matches,Youssouf Koné,D/WB L,27,120,138,Mali,Olympique Lyonnais,8,13,12,8,12,6,11,9,12,13,12,10,13,12,13,13,14,12,11,9,11,11,11,5,14,10,13,14,14,12,12,9,14,14,15,13,12,13,13,9,12,1,4,2,3,1,2,3,1,3,1,3,8,12,2,11,9,13,14,10,1,20,1,10,20,10,1,12,1,1,12,1,1,1,174,71,20,6,293753,5496,5996,4246,African_Caribbean,116,15,1995/7/5,17,1,30664.0,AC Ajaccio,85137055
942,Rominigue Kouamé,Troyes,1996,318.0,ml MLI,MF,25.0,29.6,44.0,27.0,28.0,14.0,2.0,17.0,41.0,41.5,24.0,32.0,11.0,21.0,49.0,93.0,46.0,1.0,Matches,318.0,ml MLI,MF,25.0,29.6,66.0,2.23,58.0,0.0,5.0,2.0,1.0,0.0,7.0,0.24,6.0,0.0,1.0,0.0,0.0,0.0,Matches,,,,,,,,,,,,,,,,,,,,,,,,,,,,,,,,,,,,,,,,,,,,,,,,,,,,,,,,318.0,ml MLI,MF,25.0,29.6,9.0,0.0,0.0,52.0,48.0,0.0,5.0,49.0,27.0,0.0,0.0,0.0,229.0,21.0,21.0,50.0,Matches,318.0,ml MLI,MF,25.0,29.6,1403.0,1391.0,8.0,8.0,2.0,17.0,5.0,0.0,0.0,0.0,0.0,0.0,1244.0,4.0,17.0,Matches,318.0,ml MLI,MF,25.0,29.6,1244.0,1403.0,88.7,22131.0,5532.0,513.0,558.0,91.9,574.0,636.0,90.3,119.0,144.0,82.6,1.0,2.1,1.5,-1.1,23.0,145.0,13.0,2.0,169.0,Matches,370,ml MLI,MF,25,32,2661.0,83.0,77.8,29.6,31,85.0,22,1,23.0,5,0.72,38.0,61.0,-23.0,-0.78,0.76,31.2,54.3,-23.1,-0.78,1.09,Matches,318.0,ml MLI,MF,25.0,29.6,1698.0,113.0,505.0,1002.0,230.0,19.0,1698.0,71.0,50.0,70.4,15.0,21.1,1340.0,8361.0,3627.0,59.0,47.0,4.0,38.0,25.0,1180.0,36.0,Matches,318.0,ml MLI,MF,25.0,29.6,1.0,24.0,5.0,20.8,0.81,0.17,0.04,0.2,20.3,0.0,0.0,0.0,1.4,1.4,0.06,-0.4,-0.4,Matches,318.0,ml MLI,MF,25.0,32.0,31.0,2661.0,29.6,1.0,1.0,2.0,1.0,0.0,0.0,9.0,0.0,1.4,1.4,2.1,3.5,59.0,169.0,36.0,0.03,0.03,0.07,0.03,0.07,0.05,0.07,0.12,0.05,0.12,Matches,Rominigue Kouamé,DM/M LC,25,120,130,"Mali,Ivory Coast",ESTAC Troyes,7,12,10,8,14,8,12,10,7,10,14,7,12,12,10,11,12,10,11,8,11,11,10,10,10,10,13,13,13,14,12,12,14,13,16,13,12,9,11,6,9,1,3,3,1,3,1,3,2,3,3,1,20,12,3,13,11,12,13,19,1,15,1,1,15,1,20,12,20,1,10,1,1,1,177,68,20,10,1599499,6000,6000,3004,African_Caribbean,112,19,1996/12/17,10,0,6344.0,,13174975
943,Gaëtan Laborde,Nice,1994,323.0,fr FRA,FW,28.0,27.8,45.0,25.0,13.0,17.0,15.0,18.0,40.0,45.0,22.0,27.0,2.0,25.0,9.0,54.0,13.0,0.0,Matches,323.0,fr FRA,FW,28.0,27.8,76.0,2.73,56.0,8.0,6.0,6.0,0.0,0.0,12.0,0.43,6.0,0.0,4.0,2.0,0.0,0.0,Matches,,,,,,,,,,,,,,,,,,,,,,,,,,,,,,,,,,,,,,,,,,,,,,,,,,,,,,,,323.0,fr FRA,FW,28.0,27.8,0.0,0.0,0.0,26.0,28.0,7.0,71.0,9.0,25.0,0.0,0.0,0.0,101.0,48.0,56.0,46.2,Matches,323.0,fr FRA,FW,28.0,27.8,714.0,663.0,47.0,1.0,3.0,2.0,71.0,2.0,24.0,12.0,11.0,0.0,471.0,4.0,29.0,Matches,323.0,fr FRA,FW,28.0,27.8,471.0,714.0,66.0,6581.0,1639.0,292.0,380.0,76.8,132.0,200.0,66.0,24.0,69.0,34.8,3.0,5.8,6.0,-2.8,44.0,25.0,28.0,7.0,53.0,Matches,377,fr FRA,FW,28,33,2506.0,76.0,73.3,27.8,28,85.0,19,5,28.0,0,1.61,38.0,26.0,12.0,0.43,0.53,41.1,33.0,8.1,0.29,-0.15,Matches,323.0,fr FRA,FW,28.0,27.8,1031.0,21.0,109.0,423.0,507.0,153.0,1030.0,55.0,26.0,47.3,27.0,49.1,700.0,4021.0,1723.0,54.0,40.0,21.0,69.0,29.0,696.0,196.0,Matches,323.0,fr FRA,FW,28.0,27.8,13.0,74.0,39.0,52.7,2.66,1.4,0.18,0.33,15.7,1.0,0.0,1.0,11.8,11.0,0.15,1.2,2.0,Matches,323.0,fr FRA,FW,28.0,33.0,28.0,2506.0,27.8,13.0,3.0,16.0,13.0,0.0,1.0,0.0,0.0,11.8,11.0,5.8,16.9,54.0,53.0,196.0,0.47,0.11,0.57,0.47,0.57,0.42,0.21,0.63,0.4,0.61,Matches,Gaëtan Laborde,S R,28,140,145,France,OGC Nice,5,13,13,15,13,10,17,14,5,4,13,12,4,12,13,14,14,13,14,13,12,15,11,8,15,11,17,18,13,13,13,15,15,13,16,14,14,8,14,5,14,2,3,1,4,4,3,3,1,3,2,1,10,14,7,15,8,16,12,15,1,1,1,1,1,1,1,1,1,1,13,10,15,20,181,78,20,8,13890406,7000,7000,4250,Northern_European,142,3,1994/5/3,0,0,40917.0,,85075725
944,Alexandre Lacazette,Lyon,1991,325.0,fr FRA,FW,31.0,32.5,43.0,23.0,7.0,17.0,19.0,10.0,29.0,34.5,19.0,23.0,3.0,20.0,15.0,58.0,4.0,0.0,Matches,325.0,fr FRA,FW,31.0,32.5,113.0,3.47,78.0,2.0,10.0,8.0,13.0,2.0,11.0,0.34,8.0,0.0,0.0,0.0,3.0,0.0,Matches,,,,,,,,,,,,,,,,,,,,,,,,,,,,,,,,,,,,,,,,,,,,,,,,,,,,,,,,325.0,fr FRA,FW,31.0,32.5,3.0,0.0,0.0,64.0,56.0,15.0,35.0,15.0,23.0,3.0,1.0,0.0,88.0,28.0,46.0,37.8,Matches,325.0,fr FRA,FW,31.0,32.5,917.0,845.0,61.0,8.0,8.0,4.0,35.0,1.0,6.0,1.0,4.0,0.0,661.0,11.0,30.0,Matches,325.0,fr FRA,FW,31.0,32.5,661.0,917.0,72.1,9241.0,2675.0,352.0,457.0,77.0,205.0,269.0,76.2,37.0,68.0,54.4,5.0,5.4,5.6,-0.4,48.0,59.0,48.0,1.0,108.0,Matches,379,fr FRA,FW,31,35,2929.0,84.0,85.6,32.5,34,86.0,26,1,19.0,0,1.66,58.0,40.0,18.0,0.55,0.55,54.8,42.5,12.3,0.38,0.89,Matches,325.0,fr FRA,FW,31.0,32.5,1272.0,13.0,81.0,495.0,704.0,210.0,1264.0,76.0,38.0,50.0,28.0,36.8,948.0,4339.0,1466.0,40.0,25.0,18.0,65.0,46.0,929.0,227.0,Matches,325.0,fr FRA,FW,31.0,32.5,27.0,107.0,47.0,43.9,3.29,1.44,0.2,0.45,14.4,8.0,6.0,8.0,24.2,17.9,0.17,2.8,3.1,Matches,325.0,fr FRA,FW,31.0,35.0,34.0,2929.0,32.5,27.0,5.0,32.0,21.0,6.0,8.0,3.0,0.0,24.2,17.9,5.4,23.2,40.0,108.0,227.0,0.83,0.15,0.98,0.65,0.8,0.74,0.16,0.91,0.55,0.71,Matches,Alexandre Lacazette,S,31,140,161,"France,Guadeloupe",Olympique Lyonnais,5,11,14,14,15,11,13,13,3,5,12,14,5,15,10,15,14,14,14,12,14,12,14,15,16,7,15,15,13,14,15,10,14,13,13,12,11,8,13,8,10,2,3,3,1,2,1,3,2,1,1,3,14,13,7,15,12,14,14,14,1,1,1,1,1,1,1,1,1,1,12,1,14,20,175,73,11,20,347975206,7198,6998,6848,African_Caribbean,140,13,1991/5/28,16,3,104393.0,,34011687
945,Alban Lafont,Nantes,1999,327.0,fr FRA,GK,23.0,37.0,0.0,0.0,0.0,0.0,0.0,0.0,1.0,0.0,1.0,0.0,0.0,0.0,0.0,0.0,20.0,4.0,Matches,327.0,fr FRA,GK,23.0,37.0,7.0,0.19,6.0,1.0,0.0,0.0,0.0,0.0,0.0,0.0,0.0,0.0,0.0,0.0,0.0,0.0,Matches,20.0,fr FRA,GK,23.0,37.0,54.0,9.0,1.0,6.0,4.0,54.8,0.26,4.8,0.13,189.0,516.0,36.6,942.0,202.0,37.2,35.5,247.0,67.2,49.3,493.0,42.0,8.5,39.0,1.05,12.3,Matches,20.0,fr FRA,GK,23.0,37.0,37.0,3329.0,37.0,54.0,1.46,179.0,129.0,74.9,7.0,14.0,16.0,11.0,29.7,9.0,9.0,0.0,0.0,0.0,Matches,327.0,fr FRA,GK,23.0,37.0,2.0,1.0,1.0,1.0,3.0,0.0,0.0,0.0,0.0,0.0,1.0,0.0,46.0,7.0,1.0,87.5,Matches,327.0,fr FRA,GK,23.0,37.0,1191.0,840.0,349.0,102.0,0.0,9.0,0.0,0.0,0.0,0.0,0.0,0.0,835.0,2.0,2.0,Matches,327.0,fr FRA,GK,23.0,37.0,835.0,1191.0,70.1,25417.0,19277.0,118.0,119.0,99.2,386.0,395.0,97.7,329.0,672.0,49.0,0.0,0.1,0.1,-0.1,1.0,16.0,1.0,0.0,1.0,Matches,381,fr FRA,GK,23,37,3329.0,90.0,97.3,37.0,37,90.0,36,0,,0,0.95,36.0,54.0,-18.0,-0.49,-0.49,41.0,51.7,-10.7,-0.29,-1.34,Matches,327.0,fr FRA,GK,23.0,37.0,1312.0,1112.0,1309.0,4.0,0.0,0.0,1312.0,3.0,1.0,33.3,2.0,66.7,864.0,4528.0,2496.0,1.0,0.0,0.0,2.0,0.0,547.0,0.0,Matches,327.0,fr FRA,GK,23.0,37.0,0.0,0.0,0.0,,0.0,0.0,,,,0.0,0.0,0.0,0.0,0.0,,0.0,0.0,Matches,327.0,fr FRA,GK,23.0,37.0,37.0,3329.0,37.0,0.0,0.0,0.0,0.0,0.0,0.0,2.0,1.0,0.0,0.0,0.1,0.1,1.0,1.0,0.0,0.0,0.0,0.0,0.0,0.0,0.0,0.0,0.0,0.0,0.0,Matches,Alban Lafont,GK,23,140,160,"France,Burkina Faso",FC Nantes,5,2,1,2,11,9,3,3,2,3,12,2,2,10,7,13,12,12,13,11,12,14,7,13,2,14,11,10,11,14,14,17,15,11,14,13,12,11,13,5,13,14,13,15,7,14,12,14,16,14,12,13,11,14,14,12,12,12,16,16,20,1,1,1,1,1,1,1,1,1,1,1,1,1,193,82,8,20,14843965,6989,6989,4989,Mixed_Race,137,12,1999/1/23,0,0,19547.0,,48036990
946,Julien Laporte,Lorient,1993,330.0,fr FRA,DF,28.0,18.4,22.0,16.0,18.0,3.0,1.0,16.0,22.0,72.7,6.0,33.0,27.0,6.0,18.0,40.0,108.0,2.0,Matches,330.0,fr FRA,DF,28.0,18.4,9.0,0.49,8.0,1.0,0.0,0.0,0.0,0.0,0.0,0.0,0.0,0.0,0.0,0.0,0.0,0.0,Matches,,,,,,,,,,,,,,,,,,,,,,,,,,,,,,,,,,,,,,,,,,,,,,,,,,,,,,,,330.0,fr FRA,DF,28.0,18.4,1.0,0.0,0.0,10.0,16.0,1.0,0.0,18.0,16.0,0.0,0.0,1.0,61.0,31.0,21.0,59.6,Matches,330.0,fr FRA,DF,28.0,18.4,799.0,779.0,18.0,12.0,0.0,10.0,0.0,2.0,0.0,0.0,0.0,0.0,681.0,2.0,6.0,Matches,330.0,fr FRA,DF,28.0,18.4,681.0,799.0,85.2,14120.0,4913.0,196.0,213.0,92.0,377.0,406.0,92.9,96.0,156.0,61.5,0.0,0.0,0.1,0.0,1.0,52.0,1.0,0.0,41.0,Matches,385,fr FRA,DF,28,20,1654.0,83.0,48.4,18.4,19,86.0,17,1,24.0,2,1.7,29.0,26.0,3.0,0.16,0.37,23.3,27.4,-4.1,-0.22,0.27,Matches,330.0,fr FRA,DF,28.0,18.4,1005.0,230.0,578.0,411.0,17.0,6.0,1005.0,1.0,1.0,100.0,0.0,0.0,709.0,3935.0,2026.0,4.0,5.0,0.0,5.0,2.0,671.0,0.0,Matches,330.0,fr FRA,DF,28.0,18.4,0.0,6.0,2.0,33.3,0.33,0.11,0.0,0.0,14.8,0.0,0.0,0.0,0.3,0.3,0.05,-0.3,-0.3,Matches,330.0,fr FRA,DF,28.0,20.0,19.0,1654.0,18.4,0.0,0.0,0.0,0.0,0.0,0.0,1.0,0.0,0.3,0.3,0.0,0.3,4.0,41.0,0.0,0.0,0.0,0.0,0.0,0.0,0.02,0.0,0.02,0.02,0.02,Matches,Julien Laporte,D C,28,124,128,France,FC Lorient,6,6,7,6,11,6,13,10,6,13,12,8,14,12,13,13,13,14,13,12,12,13,10,13,14,13,14,13,13,12,15,12,13,13,14,14,12,12,12,8,6,3,3,3,3,2,1,1,1,1,3,4,7,13,7,15,9,12,12,16,1,1,20,1,1,1,1,1,1,1,1,1,1,1,185,82,8,20,2057350,6198,6148,3598,Northern_European,124,4,1993/11/4,0,0,9618.0,,85121858
947,Yasser Larouci,Troyes,2001,331.0,dz ALG,DFMF,21.0,20.0,23.0,13.0,13.0,8.0,2.0,15.0,24.0,62.5,9.0,15.0,1.0,14.0,26.0,49.0,46.0,0.0,Matches,331.0,dz ALG,DFMF,21.0,20.0,35.0,1.75,23.0,1.0,3.0,2.0,5.0,1.0,1.0,0.05,1.0,0.0,0.0,0.0,0.0,0.0,Matches,,,,,,,,,,,,,,,,,,,,,,,,,,,,,,,,,,,,,,,,,,,,,,,,,,,,,,,,331.0,dz ALG,DFMF,21.0,20.0,1.0,0.0,0.0,14.0,31.0,3.0,50.0,26.0,13.0,0.0,0.0,1.0,123.0,20.0,14.0,58.8,Matches,331.0,dz ALG,DFMF,21.0,20.0,824.0,655.0,166.0,12.0,5.0,0.0,50.0,148.0,5.0,3.0,0.0,0.0,621.0,3.0,20.0,Matches,331.0,dz ALG,DFMF,21.0,20.0,621.0,824.0,75.4,9416.0,3449.0,328.0,390.0,84.1,249.0,325.0,76.6,24.0,64.0,37.5,1.0,1.6,1.3,-0.6,17.0,40.0,17.0,8.0,63.0,Matches,386,dz ALG,DFMF,21,30,1797.0,60.0,52.5,20.0,21,76.0,9,9,21.0,6,0.6,21.0,45.0,-24.0,-1.2,-0.54,21.7,42.5,-20.7,-1.04,-0.03,Matches,331.0,dz ALG,DFMF,21.0,20.0,1073.0,72.0,324.0,485.0,289.0,26.0,1073.0,87.0,38.0,43.7,42.0,48.3,730.0,5119.0,2569.0,72.0,49.0,14.0,43.0,37.0,643.0,113.0,Matches,331.0,dz ALG,DFMF,21.0,20.0,1.0,10.0,4.0,40.0,0.5,0.2,0.1,0.25,20.6,0.0,0.0,0.0,0.5,0.5,0.05,0.5,0.5,Matches,331.0,dz ALG,DFMF,21.0,30.0,21.0,1797.0,20.0,1.0,1.0,2.0,1.0,0.0,0.0,1.0,0.0,0.5,0.5,1.6,2.2,72.0,63.0,113.0,0.05,0.05,0.1,0.05,0.1,0.03,0.08,0.11,0.03,0.11,Matches,Yasser Larouci,D/WB L,21,118,143,"France,Algeria",ESTAC Troyes,7,13,12,7,12,7,10,10,8,10,12,8,10,11,11,11,10,11,11,11,10,12,12,9,13,10,14,14,15,12,12,10,11,15,13,10,11,8,11,7,13,3,2,2,1,2,3,3,2,3,1,3,13,13,8,10,12,12,11,13,1,20,1,1,19,11,1,14,1,11,15,10,13,13,181,0,20,8,3868799,5900,5900,2750,North_African__Middle_Eastern,106,14,2001/1/1,0,0,5710.0,,28117411
948,Jérémy Le Douaron,Brest,1998,335.0,fr FRA,MFFW,24.0,23.0,15.0,9.0,5.0,9.0,1.0,3.0,27.0,11.1,24.0,29.0,2.0,27.0,11.0,26.0,30.0,0.0,Matches,335.0,fr FRA,MFFW,24.0,23.0,46.0,2.0,26.0,0.0,2.0,9.0,6.0,3.0,6.0,0.26,3.0,0.0,0.0,3.0,0.0,0.0,Matches,,,,,,,,,,,,,,,,,,,,,,,,,,,,,,,,,,,,,,,,,,,,,,,,,,,,,,,,335.0,fr FRA,MFFW,24.0,23.0,1.0,0.0,0.0,33.0,36.0,10.0,32.0,11.0,9.0,0.0,0.0,0.0,61.0,61.0,71.0,46.2,Matches,335.0,fr FRA,MFFW,24.0,23.0,390.0,376.0,9.0,0.0,1.0,2.0,32.0,1.0,0.0,0.0,0.0,0.0,264.0,5.0,19.0,Matches,335.0,fr FRA,MFFW,24.0,23.0,264.0,390.0,67.7,3664.0,803.0,159.0,208.0,76.4,78.0,118.0,66.1,10.0,19.0,52.6,3.0,1.7,1.1,1.3,17.0,18.0,14.0,4.0,31.0,Matches,391,fr FRA,MFFW,24,32,2071.0,65.0,60.6,23.0,24,77.0,7,8,29.0,0,1.31,26.0,29.0,-3.0,-0.13,0.34,26.3,30.3,-4.0,-0.17,0.41,Matches,335.0,fr FRA,MFFW,24.0,23.0,718.0,27.0,92.0,300.0,341.0,86.0,718.0,74.0,22.0,29.7,40.0,54.1,490.0,3359.0,976.0,38.0,22.0,13.0,73.0,34.0,512.0,132.0,Matches,335.0,fr FRA,MFFW,24.0,23.0,10.0,55.0,23.0,41.8,2.39,1.0,0.18,0.43,11.1,0.0,0.0,0.0,8.4,8.4,0.16,1.6,1.6,Matches,335.0,fr FRA,MFFW,24.0,32.0,24.0,2071.0,23.0,10.0,3.0,13.0,10.0,0.0,0.0,1.0,0.0,8.4,8.4,1.7,10.2,38.0,31.0,132.0,0.43,0.13,0.56,0.43,0.56,0.37,0.08,0.44,0.37,0.44,Matches,Jérémy Le Douaron,AM/S RL,24,120,126,France,Stade Brestois 29,10,11,12,12,12,10,13,11,8,7,12,11,8,13,10,13,12,12,12,12,11,9,9,7,12,13,13,13,12,13,13,14,13,12,13,12,12,11,11,6,11,3,1,2,1,2,2,3,2,3,3,2,16,12,7,13,11,10,12,17,1,1,1,1,1,1,1,14,10,14,16,12,20,19,189,77,8,20,1144906,6000,6000,3010,Northern_European,113,4,1998/4/21,0,0,6445.0,,50071707
949,Enzo Le Fée,Lorient,2000,336.0,fr FRA,MF,22.0,33.6,108.0,64.0,52.0,40.0,16.0,43.0,113.0,38.1,70.0,50.0,5.0,45.0,34.0,142.0,38.0,1.0,Matches,336.0,fr FRA,MF,22.0,33.6,120.0,3.57,79.0,27.0,5.0,4.0,4.0,1.0,11.0,0.33,5.0,5.0,0.0,1.0,0.0,0.0,Matches,,,,,,,,,,,,,,,,,,,,,,,,,,,,,,,,,,,,,,,,,,,,,,,,,,,,,,,,336.0,fr FRA,MF,22.0,33.6,5.0,0.0,0.0,42.0,64.0,2.0,136.0,34.0,64.0,0.0,0.0,0.0,240.0,11.0,25.0,30.6,Matches,336.0,fr FRA,MF,22.0,33.6,2118.0,1863.0,249.0,103.0,11.0,13.0,136.0,13.0,94.0,39.0,38.0,2.0,1708.0,6.0,48.0,Matches,336.0,fr FRA,MF,22.0,33.6,1708.0,2118.0,80.6,28806.0,9189.0,773.0,868.0,89.1,645.0,777.0,83.0,184.0,307.0,59.9,6.0,6.8,4.7,-0.8,67.0,170.0,37.0,5.0,218.0,Matches,392,fr FRA,MF,22,35,3028.0,87.0,88.5,33.6,35,87.0,22,0,,0,1.54,49.0,47.0,2.0,0.06,0.75,40.2,51.7,-11.5,-0.34,0.15,Matches,336.0,fr FRA,MF,22.0,33.6,2611.0,89.0,558.0,1422.0,675.0,35.0,2611.0,155.0,68.0,43.9,67.0,43.2,1970.0,12115.0,5413.0,96.0,90.0,13.0,74.0,55.0,1798.0,105.0,Matches,336.0,fr FRA,MF,22.0,33.6,5.0,45.0,18.0,40.0,1.34,0.54,0.11,0.28,23.4,8.0,0.0,0.0,3.5,3.5,0.08,1.5,1.5,Matches,336.0,fr FRA,MF,22.0,35.0,35.0,3028.0,33.6,5.0,6.0,11.0,5.0,0.0,0.0,5.0,0.0,3.5,3.5,6.8,10.3,96.0,218.0,105.0,0.15,0.18,0.33,0.15,0.33,0.11,0.2,0.31,0.11,0.31,Matches,Enzo Le Fée,M/AM C,22,126,150,France,FC Lorient,13,13,14,9,14,13,6,11,5,11,14,12,9,15,7,13,8,13,12,15,13,14,14,11,12,10,14,13,13,15,13,5,13,14,14,7,12,8,12,7,12,2,1,3,2,2,3,2,2,3,3,3,18,12,7,15,12,13,14,12,1,1,1,1,1,1,12,12,20,14,12,19,14,1,170,58,8,20,7375999,6300,6300,3756,Northern_European,126,4,2000/2/3,0,0,11234.0,,49040114
950,Vincent Le Goff,Lorient,1989,337.0,fr FRA,DF,32.0,37.0,75.0,32.0,56.0,16.0,3.0,45.0,62.0,72.6,17.0,29.0,9.0,20.0,41.0,116.0,105.0,1.0,Matches,337.0,fr FRA,DF,32.0,37.0,38.0,1.03,32.0,3.0,1.0,1.0,0.0,1.0,2.0,0.05,2.0,0.0,0.0,0.0,0.0,0.0,Matches,,,,,,,,,,,,,,,,,,,,,,,,,,,,,,,,,,,,,,,,,,,,,,,,,,,,,,,,337.0,fr FRA,DF,32.0,37.0,1.0,0.0,0.0,19.0,19.0,3.0,39.0,41.0,32.0,0.0,0.0,0.0,205.0,30.0,29.0,50.8,Matches,337.0,fr FRA,DF,32.0,37.0,2044.0,1716.0,322.0,63.0,2.0,2.0,39.0,259.0,0.0,0.0,0.0,0.0,1702.0,6.0,36.0,Matches,337.0,fr FRA,DF,32.0,37.0,1702.0,2044.0,83.3,26725.0,11113.0,867.0,967.0,89.7,690.0,791.0,87.2,93.0,189.0,49.2,0.0,0.7,1.7,-0.7,14.0,135.0,28.0,9.0,178.0,Matches,393,fr FRA,DF,32,37,3330.0,90.0,97.4,37.0,37,90.0,37,0,,1,1.49,52.0,52.0,0.0,0.0,1.0,43.4,57.2,-13.8,-0.37,-0.49,Matches,337.0,fr FRA,DF,32.0,37.0,2358.0,173.0,848.0,1158.0,371.0,31.0,2358.0,32.0,12.0,37.5,14.0,43.8,1584.0,8872.0,4688.0,69.0,57.0,4.0,18.0,12.0,1423.0,84.0,Matches,337.0,fr FRA,DF,32.0,37.0,0.0,17.0,6.0,35.3,0.46,0.16,0.0,0.0,18.3,0.0,0.0,0.0,1.2,1.2,0.07,-1.2,-1.2,Matches,337.0,fr FRA,DF,32.0,37.0,37.0,3330.0,37.0,0.0,0.0,0.0,0.0,0.0,0.0,1.0,0.0,1.2,1.2,0.7,1.8,69.0,178.0,84.0,0.0,0.0,0.0,0.0,0.0,0.03,0.02,0.05,0.03,0.05,Matches,Vincent Le Goff,D/WB L,32,122,125,France,FC Lorient,13,14,12,8,13,11,8,10,8,11,13,10,12,13,7,12,10,13,12,14,13,14,11,13,14,11,15,15,13,14,12,8,15,13,15,8,12,7,14,6,12,3,1,3,3,3,2,1,2,3,3,3,10,12,5,16,12,15,16,16,1,20,12,1,17,1,7,15,10,1,13,1,1,1,177,69,20,6,711385,6096,6096,3496,Northern_European,120,5,1989/10/15,0,0,8000.0,,34009242
951,Maxime Le Marchand,Strasbourg,1989,338.0,fr FRA,DF,32.0,22.4,39.0,24.0,23.0,14.0,2.0,19.0,31.0,61.3,12.0,22.0,14.0,8.0,37.0,76.0,74.0,0.0,Matches,338.0,fr FRA,DF,32.0,22.4,19.0,0.85,13.0,1.0,2.0,0.0,1.0,2.0,3.0,0.13,1.0,0.0,0.0,0.0,1.0,1.0,Matches,,,,,,,,,,,,,,,,,,,,,,,,,,,,,,,,,,,,,,,,,,,,,,,,,,,,,,,,338.0,fr FRA,DF,32.0,22.4,6.0,1.0,1.0,31.0,9.0,0.0,11.0,37.0,24.0,0.0,2.0,0.0,144.0,59.0,29.0,67.0,Matches,338.0,fr FRA,DF,32.0,22.4,1208.0,1130.0,76.0,44.0,0.0,14.0,11.0,16.0,0.0,0.0,0.0,0.0,958.0,2.0,12.0,Matches,338.0,fr FRA,DF,32.0,22.4,958.0,1208.0,79.3,18366.0,7641.0,364.0,412.0,88.3,461.0,527.0,87.5,111.0,231.0,48.1,0.0,0.3,0.5,-0.3,2.0,85.0,9.0,3.0,90.0,Matches,394,fr FRA,DF,32,26,2015.0,78.0,58.9,22.4,23,84.0,18,3,28.0,1,1.19,27.0,31.0,-4.0,-0.18,0.08,28.1,34.6,-6.5,-0.29,-0.27,Matches,338.0,fr FRA,DF,32.0,22.4,1405.0,177.0,627.0,720.0,74.0,12.0,1405.0,17.0,15.0,88.2,1.0,5.9,969.0,5240.0,2725.0,10.0,19.0,0.0,11.0,4.0,854.0,4.0,Matches,338.0,fr FRA,DF,32.0,22.4,0.0,8.0,0.0,0.0,0.36,0.0,0.0,,19.1,0.0,0.0,0.0,0.6,0.6,0.08,-0.6,-0.6,Matches,338.0,fr FRA,DF,32.0,26.0,23.0,2015.0,22.4,0.0,0.0,0.0,0.0,0.0,0.0,6.0,1.0,0.6,0.6,0.3,0.9,10.0,90.0,4.0,0.0,0.0,0.0,0.0,0.0,0.03,0.01,0.04,0.03,0.04,Matches,Maxime Le Marchand,D LC,32,120,131,France,RC Strasbourg Alsace,7,12,9,6,10,7,13,5,11,13,13,6,14,12,14,12,15,12,13,8,12,15,7,8,8,13,14,15,11,12,14,14,12,13,15,14,15,12,14,13,12,2,3,2,3,3,1,2,1,1,1,1,14,14,2,16,12,16,14,15,1,18,20,1,10,1,12,1,1,1,1,1,1,1,185,77,20,7,286384,5999,5999,4499,Northern_European,121,5,1989/10/11,0,0,6647.0,,34009617
952,Pierre Lees-Melou,Brest,1993,342.0,fr FRA,MF,29.0,30.7,97.0,55.0,55.0,37.0,5.0,57.0,123.0,46.3,66.0,48.0,13.0,35.0,52.0,149.0,46.0,1.0,Matches,342.0,fr FRA,MF,29.0,30.7,56.0,1.82,42.0,2.0,2.0,6.0,1.0,3.0,7.0,0.23,5.0,0.0,0.0,1.0,0.0,1.0,Matches,,,,,,,,,,,,,,,,,,,,,,,,,,,,,,,,,,,,,,,,,,,,,,,,,,,,,,,,342.0,fr FRA,MF,29.0,30.7,10.0,1.0,0.0,43.0,47.0,1.0,41.0,52.0,55.0,0.0,2.0,0.0,278.0,18.0,10.0,64.3,Matches,342.0,fr FRA,MF,29.0,30.7,1461.0,1398.0,61.0,55.0,8.0,37.0,41.0,5.0,1.0,1.0,0.0,0.0,1198.0,2.0,24.0,Matches,342.0,fr FRA,MF,29.0,30.7,1198.0,1461.0,82.0,24298.0,8391.0,455.0,520.0,87.5,482.0,551.0,87.5,222.0,322.0,68.9,5.0,2.3,2.4,2.7,16.0,150.0,14.0,5.0,179.0,Matches,399,fr FRA,MF,29,32,2767.0,86.0,80.9,30.7,32,86.0,26,0,,0,1.22,39.0,41.0,-2.0,-0.07,1.04,36.3,44.3,-8.0,-0.26,0.39,Matches,342.0,fr FRA,MF,29.0,30.7,1840.0,116.0,576.0,1000.0,300.0,19.0,1840.0,44.0,22.0,50.0,12.0,27.3,1309.0,7903.0,3555.0,33.0,44.0,7.0,30.0,20.0,1089.0,45.0,Matches,342.0,fr FRA,MF,29.0,30.7,5.0,43.0,13.0,30.2,1.4,0.42,0.12,0.38,23.8,2.0,0.0,0.0,2.1,2.1,0.05,2.9,2.9,Matches,342.0,fr FRA,MF,29.0,32.0,32.0,2767.0,30.7,5.0,5.0,10.0,5.0,0.0,0.0,10.0,1.0,2.1,2.1,2.3,4.4,33.0,179.0,45.0,0.16,0.16,0.33,0.16,0.33,0.07,0.08,0.14,0.07,0.14,Matches,Pierre Lees-Melou,M C,29,129,135,France,Stade Brestois 29,13,11,13,10,13,12,5,14,5,7,16,11,10,14,12,12,13,14,13,14,12,17,12,14,13,13,14,16,12,12,12,7,15,12,15,12,13,10,13,10,9,1,2,4,3,2,1,1,2,3,1,1,13,14,6,13,13,14,14,12,1,1,1,1,1,1,13,1,20,1,11,14,12,1,185,69,10,20,4293058,6450,6450,5000,Mediterranean_Hispanic,129,6,1993/5/25,0,0,40597.0,,48034511
953,Johann Lepenant,Lyon,2002,346.0,fr FRA,MF,19.0,21.5,58.0,34.0,24.0,27.0,7.0,32.0,86.0,37.2,54.0,29.0,5.0,24.0,28.0,86.0,17.0,3.0,Matches,346.0,fr FRA,MF,19.0,21.5,35.0,1.63,26.0,0.0,0.0,4.0,3.0,2.0,4.0,0.19,2.0,0.0,0.0,1.0,1.0,0.0,Matches,,,,,,,,,,,,,,,,,,,,,,,,,,,,,,,,,,,,,,,,,,,,,,,,,,,,,,,,346.0,fr FRA,MF,19.0,21.5,4.0,0.0,0.0,35.0,24.0,0.0,9.0,28.0,34.0,0.0,0.0,0.0,164.0,16.0,17.0,48.5,Matches,346.0,fr FRA,MF,19.0,21.5,1301.0,1284.0,17.0,12.0,3.0,4.0,9.0,5.0,0.0,0.0,0.0,0.0,1163.0,0.0,24.0,Matches,346.0,fr FRA,MF,19.0,21.5,1163.0,1301.0,89.4,19634.0,4333.0,504.0,570.0,88.4,524.0,554.0,94.6,90.0,103.0,87.4,2.0,1.2,1.3,0.8,10.0,115.0,6.0,1.0,125.0,Matches,405,fr FRA,MF,19,31,1933.0,62.0,56.5,21.5,21,80.0,11,10,25.0,6,1.71,30.0,25.0,5.0,0.23,-0.55,32.4,28.0,4.4,0.21,-0.1,Matches,346.0,fr FRA,MF,19.0,21.5,1543.0,35.0,315.0,932.0,309.0,18.0,1543.0,48.0,21.0,43.8,21.0,43.8,1226.0,5661.0,2144.0,20.0,37.0,2.0,40.0,28.0,1107.0,44.0,Matches,346.0,fr FRA,MF,19.0,21.5,1.0,19.0,1.0,5.3,0.88,0.05,0.05,1.0,23.8,0.0,0.0,0.0,0.9,0.9,0.05,0.1,0.1,Matches,346.0,fr FRA,MF,19.0,31.0,21.0,1933.0,21.5,1.0,2.0,3.0,1.0,0.0,0.0,4.0,0.0,0.9,0.9,1.2,2.0,20.0,125.0,44.0,0.05,0.09,0.14,0.05,0.14,0.04,0.05,0.09,0.04,0.09,Matches,Johann Lepenant,DM/M C,19,118,-8,France,Olympique Lyonnais,11,11,10,12,12,11,8,11,5,15,13,9,12,14,12,12,13,10,13,12,12,14,10,8,12,16,13,15,12,13,12,8,14,12,14,8,12,11,6,7,8,2,2,1,2,2,3,4,1,2,1,1,13,12,8,13,10,10,11,17,1,1,1,1,1,1,19,1,20,1,1,1,1,1,176,71,10,20,38857217,6300,5900,2500,Northern_European,119,4,2002/10/22,0,0,13696.0,,49056191
954,Anthony Lopes,Lyon,1990,355.0,pt POR,GK,31.0,31.3,1.0,0.0,1.0,0.0,0.0,1.0,4.0,25.0,3.0,0.0,0.0,0.0,3.0,4.0,10.0,0.0,Matches,355.0,pt POR,GK,31.0,31.3,1.0,0.03,1.0,0.0,0.0,0.0,0.0,0.0,1.0,0.03,1.0,0.0,0.0,0.0,0.0,0.0,Matches,27.0,pt POR,GK,31.0,31.3,39.0,7.0,2.0,5.0,2.0,41.4,0.27,4.4,0.14,114.0,317.0,36.0,838.0,134.0,31.3,31.9,183.0,30.1,31.8,358.0,19.0,5.3,25.0,0.8,13.9,Matches,27.0,pt POR,GK,31.0,32.0,32.0,2816.0,31.3,39.0,1.25,131.0,94.0,75.6,16.0,4.0,12.0,7.0,21.9,7.0,7.0,0.0,0.0,0.0,Matches,355.0,pt POR,GK,31.0,31.3,2.0,1.0,0.0,2.0,6.0,0.0,0.0,3.0,0.0,0.0,2.0,0.0,31.0,3.0,0.0,100.0,Matches,355.0,pt POR,GK,31.0,31.3,1026.0,741.0,280.0,97.0,0.0,1.0,0.0,0.0,0.0,0.0,0.0,0.0,792.0,5.0,0.0,Matches,355.0,pt POR,GK,31.0,31.3,792.0,1026.0,77.2,20368.0,14374.0,173.0,173.0,100.0,392.0,396.0,99.0,223.0,447.0,49.9,0.0,0.0,0.0,0.0,0.0,9.0,0.0,0.0,0.0,Matches,417,pt POR,GK,31,32,2816.0,88.0,82.3,31.3,32,88.0,31,0,,0,1.63,54.0,39.0,15.0,0.48,0.03,50.1,43.1,7.0,0.22,-0.15,Matches,355.0,pt POR,GK,31.0,31.3,1098.0,923.0,1092.0,7.0,0.0,0.0,1098.0,2.0,0.0,0.0,2.0,100.0,764.0,4021.0,2558.0,0.0,0.0,0.0,1.0,0.0,528.0,0.0,Matches,355.0,pt POR,GK,31.0,31.3,0.0,0.0,0.0,,0.0,0.0,,,,0.0,0.0,0.0,0.0,0.0,,0.0,0.0,Matches,355.0,pt POR,GK,31.0,32.0,32.0,2816.0,31.3,0.0,0.0,0.0,0.0,0.0,0.0,2.0,1.0,0.0,0.0,0.0,0.0,0.0,0.0,0.0,0.0,0.0,0.0,0.0,0.0,0.0,0.0,0.0,0.0,0.0,Matches,Anthony Lopes,GK,31,142,154,"Portugal,France",Olympique Lyonnais,2,2,2,3,10,4,6,1,1,3,9,1,3,10,13,14,18,11,12,8,11,15,9,17,5,13,10,10,13,16,14,13,15,13,15,14,14,12,15,6,1,11,14,13,12,14,10,16,16,14,11,13,13,14,8,18,12,17,12,8,20,1,1,1,1,1,1,1,1,1,1,1,1,1,184,81,20,6,347975206,7100,7100,6250,Mediterranean_Hispanic,140,6,1990/10/1,14,0,72876.0,,85003956
955,Rony Lopes,Troyes,1995,356.0,pt POR,MFFW,26.0,26.1,24.0,12.0,6.0,15.0,3.0,7.0,31.0,22.6,24.0,14.0,2.0,12.0,9.0,33.0,10.0,0.0,Matches,356.0,pt POR,MFFW,26.0,26.1,94.0,3.61,47.0,27.0,8.0,10.0,2.0,0.0,8.0,0.31,4.0,2.0,0.0,2.0,0.0,0.0,Matches,,,,,,,,,,,,,,,,,,,,,,,,,,,,,,,,,,,,,,,,,,,,,,,,,,,,,,,,356.0,pt POR,MFFW,26.0,26.1,2.0,0.0,0.0,19.0,32.0,1.0,109.0,9.0,12.0,0.0,0.0,0.0,113.0,19.0,26.0,42.2,Matches,356.0,pt POR,MFFW,26.0,26.1,872.0,747.0,118.0,36.0,5.0,12.0,109.0,3.0,65.0,27.0,23.0,0.0,603.0,7.0,32.0,Matches,356.0,pt POR,MFFW,26.0,26.1,603.0,872.0,69.2,10507.0,3108.0,286.0,358.0,79.9,211.0,287.0,73.5,76.0,157.0,48.4,5.0,4.9,4.1,0.1,50.0,68.0,29.0,10.0,97.0,Matches,418,pt POR,MFFW,26,32,2346.0,73.0,68.6,26.1,29,79.0,13,3,23.0,1,0.69,29.0,52.0,-23.0,-0.88,0.21,22.8,53.3,-30.4,-1.17,-0.46,Matches,356.0,pt POR,MFFW,26.0,26.1,1124.0,19.0,154.0,538.0,454.0,57.0,1124.0,85.0,45.0,52.9,33.0,38.8,805.0,5307.0,2266.0,61.0,49.0,13.0,46.0,37.0,755.0,117.0,Matches,356.0,pt POR,MFFW,26.0,26.1,7.0,57.0,20.0,35.1,2.19,0.77,0.12,0.35,19.3,5.0,0.0,0.0,4.9,4.9,0.09,2.1,2.1,Matches,356.0,pt POR,MFFW,26.0,32.0,29.0,2346.0,26.1,7.0,5.0,12.0,7.0,0.0,0.0,2.0,0.0,4.9,4.9,4.9,9.8,61.0,97.0,117.0,0.27,0.19,0.46,0.27,0.46,0.19,0.19,0.38,0.19,0.38,Matches,Rony Lopes,M/AM RLC,26,120,145,"Portugal,Brazil",Sevilla,15,13,15,12,15,14,6,13,3,5,12,14,5,16,9,12,9,11,8,14,11,12,15,8,13,6,12,13,13,14,15,6,12,12,11,8,9,12,13,9,13,2,4,2,2,2,1,3,3,3,2,3,8,13,7,12,12,12,15,14,1,1,1,1,1,1,1,6,7,16,19,16,20,1,174,68,20,10,680249,6000,6250,5000,Mediterranean_Hispanic,119,8,1995/12/28,2,0,42192.0,ESTAC Troyes,55038681
956,Pau López,Marseille,1994,357.0,es ESP,GK,27.0,32.5,0.0,0.0,0.0,0.0,0.0,0.0,1.0,0.0,1.0,0.0,0.0,0.0,0.0,0.0,5.0,1.0,Matches,357.0,es ESP,GK,27.0,32.5,6.0,0.18,4.0,2.0,0.0,0.0,0.0,0.0,2.0,0.06,1.0,1.0,0.0,0.0,0.0,0.0,Matches,28.0,es ESP,GK,27.0,32.5,34.0,5.0,0.0,6.0,1.0,33.8,0.24,0.8,0.02,112.0,324.0,34.6,941.0,132.0,25.1,31.0,172.0,51.2,40.4,370.0,22.0,5.9,37.0,1.14,15.4,Matches,28.0,es ESP,GK,27.0,33.0,32.0,2925.0,32.5,34.0,1.05,123.0,90.0,76.4,21.0,4.0,7.0,10.0,31.3,5.0,5.0,0.0,0.0,0.0,Matches,357.0,es ESP,GK,27.0,32.5,3.0,0.0,0.0,2.0,6.0,0.0,0.0,0.0,0.0,0.0,2.0,0.0,46.0,5.0,2.0,71.4,Matches,357.0,es ESP,GK,27.0,32.5,1116.0,870.0,243.0,71.0,1.0,3.0,0.0,0.0,0.0,0.0,0.0,0.0,877.0,3.0,2.0,Matches,357.0,es ESP,GK,27.0,32.5,877.0,1116.0,78.6,23244.0,14324.0,143.0,145.0,98.6,461.0,468.0,98.5,269.0,495.0,54.3,2.0,0.4,0.3,1.6,3.0,17.0,1.0,0.0,2.0,Matches,419,es ESP,GK,27,33,2925.0,89.0,85.5,32.5,32,90.0,32,1,45.0,2,2.03,59.0,34.0,25.0,0.77,0.41,56.9,36.8,20.1,0.62,0.12,Matches,357.0,es ESP,GK,27.0,32.5,1174.0,750.0,1137.0,37.0,0.0,0.0,1174.0,0.0,0.0,,0.0,,880.0,4606.0,2729.0,0.0,0.0,0.0,0.0,0.0,635.0,0.0,Matches,357.0,es ESP,GK,27.0,32.5,0.0,0.0,0.0,,0.0,0.0,,,,0.0,0.0,0.0,0.0,0.0,,0.0,0.0,Matches,357.0,es ESP,GK,27.0,33.0,32.0,2925.0,32.5,0.0,2.0,2.0,0.0,0.0,0.0,3.0,0.0,0.0,0.0,0.4,0.4,0.0,2.0,0.0,0.0,0.06,0.06,0.0,0.06,0.0,0.01,0.01,0.0,0.01,Matches,Pau López,GK,27,140,143,Spain,Olympique de Marseille,3,2,2,1,11,8,8,3,6,2,14,2,2,10,6,13,15,13,15,8,13,10,5,8,5,15,14,12,13,15,13,13,13,13,12,12,13,9,13,6,14,10,10,8,7,15,14,15,16,14,9,14,14,13,5,12,7,15,15,16,20,1,1,1,1,1,1,1,1,1,1,1,1,1,189,77,20,9,13420353,6992,6992,5992,Northern_European,140,4,1994/12/13,2,0,74794.0,,67178152
957,Dion Lopy,Reims,2002,358.0,sn SEN,MF,20.0,15.3,45.0,24.0,22.0,16.0,7.0,23.0,62.0,37.1,39.0,27.0,3.0,24.0,22.0,67.0,18.0,0.0,Matches,358.0,sn SEN,MF,20.0,15.3,36.0,2.35,26.0,2.0,1.0,3.0,4.0,0.0,4.0,0.26,2.0,0.0,0.0,0.0,2.0,0.0,Matches,,,,,,,,,,,,,,,,,,,,,,,,,,,,,,,,,,,,,,,,,,,,,,,,,,,,,,,,358.0,sn SEN,MF,20.0,15.3,6.0,2.0,1.0,31.0,25.0,0.0,6.0,22.0,24.0,1.0,0.0,0.0,128.0,15.0,7.0,68.2,Matches,358.0,sn SEN,MF,20.0,15.3,741.0,727.0,12.0,10.0,0.0,11.0,6.0,1.0,1.0,0.0,0.0,0.0,627.0,2.0,8.0,Matches,358.0,sn SEN,MF,20.0,15.3,627.0,741.0,84.6,12141.0,3116.0,229.0,274.0,83.6,279.0,318.0,87.7,97.0,118.0,82.2,1.0,1.6,0.7,-0.6,15.0,82.0,4.0,0.0,101.0,Matches,420,sn SEN,MF,20,29,1379.0,48.0,40.3,15.3,16,70.0,4,13,20.0,3,1.34,15.0,16.0,-1.0,-0.07,-0.11,23.1,18.7,4.3,0.28,0.08,Matches,358.0,sn SEN,MF,20.0,15.3,935.0,41.0,209.0,533.0,211.0,12.0,935.0,36.0,16.0,44.4,15.0,41.7,696.0,4238.0,1717.0,17.0,22.0,1.0,30.0,17.0,612.0,38.0,Matches,358.0,sn SEN,MF,20.0,15.3,0.0,18.0,4.0,22.2,1.17,0.26,0.0,0.0,23.3,0.0,0.0,0.0,0.9,0.9,0.05,-0.9,-0.9,Matches,358.0,sn SEN,MF,20.0,29.0,16.0,1379.0,15.3,0.0,1.0,1.0,0.0,0.0,0.0,6.0,2.0,0.9,0.9,1.6,2.5,17.0,101.0,38.0,0.0,0.07,0.07,0.0,0.07,0.06,0.1,0.16,0.06,0.16,Matches,Dion Lopy,DM/M C,20,110,140,Senegal,Stade de Reims,12,14,12,9,13,7,11,9,9,10,14,12,10,15,9,9,12,11,13,12,12,4,12,12,13,13,10,12,10,9,12,10,13,10,13,14,12,6,11,11,7,3,3,1,3,1,3,1,2,1,2,3,19,11,7,10,10,11,10,17,1,1,1,1,1,1,17,1,20,1,1,1,1,1,186,0,10,20,3305599,5498,5498,2498,African_Caribbean,109,17,2002/2/2,1,0,3288.0,,12079003
958,Jordan Lotomba,Nice,1998,359.0,ch SUI,DF,23.0,27.3,65.0,38.0,33.0,24.0,8.0,31.0,48.0,64.6,17.0,38.0,11.0,27.0,32.0,97.0,53.0,0.0,Matches,359.0,ch SUI,DF,23.0,27.3,55.0,2.02,44.0,4.0,1.0,2.0,2.0,2.0,5.0,0.18,5.0,0.0,0.0,0.0,0.0,0.0,Matches,,,,,,,,,,,,,,,,,,,,,,,,,,,,,,,,,,,,,,,,,,,,,,,,,,,,,,,,359.0,ch SUI,DF,23.0,27.3,4.0,0.0,0.0,23.0,31.0,0.0,48.0,32.0,38.0,0.0,1.0,0.0,131.0,25.0,22.0,53.2,Matches,359.0,ch SUI,DF,23.0,27.3,1412.0,1173.0,237.0,19.0,2.0,0.0,48.0,218.0,0.0,0.0,0.0,0.0,1183.0,2.0,38.0,Matches,359.0,ch SUI,DF,23.0,27.3,1183.0,1412.0,83.8,17087.0,5822.0,700.0,775.0,90.3,408.0,484.0,84.3,38.0,69.0,55.1,2.0,0.9,1.4,1.1,16.0,70.0,22.0,10.0,106.0,Matches,422,ch SUI,DF,23,33,2453.0,74.0,71.7,27.3,27,83.0,18,6,34.0,1,1.61,37.0,26.0,11.0,0.4,0.4,41.0,33.3,7.6,0.28,-0.18,Matches,359.0,ch SUI,DF,23.0,27.3,1720.0,93.0,506.0,857.0,385.0,20.0,1720.0,73.0,38.0,52.1,26.0,35.6,1131.0,7852.0,4210.0,82.0,72.0,6.0,40.0,24.0,1034.0,99.0,Matches,359.0,ch SUI,DF,23.0,27.3,0.0,13.0,5.0,38.5,0.48,0.18,0.0,0.0,19.8,0.0,0.0,0.0,0.9,0.9,0.07,-0.9,-0.9,Matches,359.0,ch SUI,DF,23.0,33.0,27.0,2453.0,27.3,0.0,2.0,2.0,0.0,0.0,0.0,4.0,0.0,0.9,0.9,0.9,1.8,82.0,106.0,99.0,0.0,0.07,0.07,0.0,0.07,0.03,0.03,0.07,0.03,0.07,Matches,Jordan Lotomba,D/WB/M RL,23,126,138,"Switzerland,Democratic Republic of Congo",OGC Nice,8,11,14,8,14,7,7,6,13,12,11,7,13,13,14,13,12,12,12,9,10,13,14,7,12,12,15,14,14,14,8,9,15,13,14,8,12,8,12,10,18,1,1,2,1,3,2,3,3,3,1,4,13,14,6,12,11,14,11,13,1,15,1,20,13,18,1,10,1,16,1,1,12,1,177,67,14,20,3226354,6295,6295,4545,African_Caribbean,116,16,1998/9/29,7,1,12660.0,,98034811
959,Dejan Lovren,Lyon,1989,360.0,hr CRO,DF,33.0,16.2,25.0,19.0,20.0,5.0,0.0,20.0,29.0,69.0,9.0,20.0,10.0,10.0,26.0,51.0,70.0,1.0,Matches,360.0,hr CRO,DF,33.0,16.2,10.0,0.62,6.0,0.0,0.0,4.0,0.0,0.0,0.0,0.0,0.0,0.0,0.0,0.0,0.0,0.0,Matches,,,,,,,,,,,,,,,,,,,,,,,,,,,,,,,,,,,,,,,,,,,,,,,,,,,,,,,,360.0,hr CRO,DF,33.0,16.2,2.0,0.0,0.0,10.0,14.0,0.0,6.0,26.0,19.0,0.0,1.0,0.0,103.0,47.0,21.0,69.1,Matches,360.0,hr CRO,DF,33.0,16.2,1096.0,1064.0,32.0,31.0,1.0,4.0,6.0,1.0,0.0,0.0,0.0,0.0,961.0,0.0,7.0,Matches,360.0,hr CRO,DF,33.0,16.2,961.0,1096.0,87.7,18828.0,6015.0,322.0,355.0,90.7,522.0,560.0,93.2,109.0,161.0,67.7,0.0,0.5,0.4,-0.5,2.0,65.0,0.0,0.0,64.0,Matches,426,hr CRO,DF,33,17,1459.0,86.0,42.7,16.2,17,86.0,14,0,,0,1.71,27.0,20.0,7.0,0.43,-0.07,25.3,23.3,2.1,0.13,-0.22,Matches,360.0,hr CRO,DF,33.0,16.2,1273.0,138.0,536.0,695.0,48.0,17.0,1273.0,2.0,1.0,50.0,1.0,50.0,940.0,5613.0,3091.0,12.0,13.0,1.0,5.0,3.0,850.0,1.0,Matches,360.0,hr CRO,DF,33.0,16.2,1.0,13.0,3.0,23.1,0.8,0.19,0.08,0.33,12.5,1.0,0.0,0.0,0.8,0.8,0.06,0.2,0.2,Matches,360.0,hr CRO,DF,33.0,17.0,17.0,1459.0,16.2,1.0,0.0,1.0,1.0,0.0,0.0,2.0,0.0,0.8,0.8,0.5,1.3,12.0,64.0,1.0,0.06,0.0,0.06,0.06,0.06,0.05,0.03,0.08,0.05,0.08,Matches,Dejan Lovren,D C,33,136,153,"Croatia,Bosnia and Herzegovina",Zenit St. Petersburg,7,7,9,8,12,7,15,7,10,14,14,8,14,13,14,16,15,13,11,10,12,15,9,14,9,15,13,12,12,11,14,15,12,13,13,14,11,14,13,10,5,1,2,3,3,2,2,1,3,1,1,3,15,14,12,14,12,14,10,13,1,10,20,10,1,1,1,1,1,1,1,1,1,1,190,84,10,20,3519976,6769,7450,6499,Northern_European,136,6,1989/7/5,70,4,115992.0,,24000971
960,Castello Lukeba,Lyon,2002,362.0,fr FRA,DF,19.0,33.2,39.0,23.0,27.0,8.0,4.0,21.0,31.0,67.7,10.0,42.0,24.0,18.0,75.0,114.0,105.0,1.0,Matches,362.0,fr FRA,DF,19.0,33.2,17.0,0.51,17.0,0.0,0.0,0.0,0.0,0.0,3.0,0.09,3.0,0.0,0.0,0.0,0.0,0.0,Matches,,,,,,,,,,,,,,,,,,,,,,,,,,,,,,,,,,,,,,,,,,,,,,,,,,,,,,,,362.0,fr FRA,DF,19.0,33.2,9.0,1.0,1.0,38.0,21.0,1.0,3.0,75.0,23.0,0.0,2.0,1.0,209.0,36.0,30.0,54.5,Matches,362.0,fr FRA,DF,19.0,33.2,2257.0,2202.0,49.0,41.0,1.0,9.0,3.0,6.0,0.0,0.0,0.0,0.0,2034.0,6.0,17.0,Matches,362.0,fr FRA,DF,19.0,33.2,2034.0,2257.0,90.1,37132.0,14125.0,761.0,812.0,93.7,1110.0,1182.0,93.9,138.0,207.0,66.7,0.0,0.3,0.8,-0.3,3.0,133.0,5.0,0.0,166.0,Matches,428,fr FRA,DF,19,34,2986.0,88.0,87.3,33.2,33,90.0,32,1,17.0,1,1.62,56.0,41.0,15.0,0.45,-0.17,53.1,43.6,9.5,0.29,0.29,Matches,362.0,fr FRA,DF,19.0,33.2,2580.0,234.0,1115.0,1399.0,85.0,28.0,2580.0,17.0,11.0,64.7,5.0,29.4,2066.0,11163.0,6047.0,24.0,29.0,3.0,20.0,8.0,1885.0,9.0,Matches,362.0,fr FRA,DF,19.0,33.2,2.0,13.0,5.0,38.5,0.39,0.15,0.15,0.4,10.2,0.0,0.0,0.0,1.2,1.2,0.09,0.8,0.8,Matches,362.0,fr FRA,DF,19.0,34.0,33.0,2986.0,33.2,2.0,0.0,2.0,2.0,0.0,0.0,9.0,1.0,1.2,1.2,0.3,1.4,24.0,166.0,9.0,0.06,0.0,0.06,0.06,0.06,0.03,0.01,0.04,0.03,0.04,Matches,Castello Lukeba,D C,19,124,-85,"France,Angola",Olympique Lyonnais,7,7,10,7,12,7,13,7,7,14,13,7,13,13,10,15,14,16,11,13,12,13,11,11,11,14,14,14,12,12,12,11,13,12,14,13,12,7,11,8,10,1,2,2,4,1,2,1,3,1,3,3,14,12,7,10,10,11,11,15,1,13,20,1,1,1,1,1,1,1,1,1,1,1,184,73,20,8,63210856,6700,6200,2012,African_Caribbean,124,15,2002/12/17,0,0,7671.0,,49056273
961,Youssouf M'Changama,Auxerre,1990,363.0,km COM,MF,31.0,12.0,22.0,11.0,7.0,12.0,3.0,7.0,13.0,53.8,6.0,6.0,0.0,6.0,15.0,37.0,6.0,1.0,Matches,363.0,km COM,MF,31.0,12.0,29.0,2.42,19.0,5.0,0.0,0.0,5.0,0.0,2.0,0.17,1.0,0.0,0.0,0.0,1.0,0.0,Matches,,,,,,,,,,,,,,,,,,,,,,,,,,,,,,,,,,,,,,,,,,,,,,,,,,,,,,,,363.0,km COM,MF,31.0,12.0,1.0,0.0,0.0,12.0,18.0,0.0,35.0,15.0,11.0,1.0,0.0,0.0,62.0,12.0,6.0,66.7,Matches,363.0,km COM,MF,31.0,12.0,489.0,463.0,26.0,13.0,2.0,11.0,35.0,2.0,10.0,4.0,6.0,0.0,384.0,0.0,12.0,Matches,363.0,km COM,MF,31.0,12.0,384.0,489.0,78.5,6630.0,1857.0,175.0,207.0,84.5,150.0,170.0,88.2,40.0,82.0,48.8,0.0,0.9,1.2,-0.9,11.0,35.0,8.0,3.0,49.0,Matches,429,km COM,MF,31,26,1081.0,42.0,31.6,12.0,11,74.0,3,15,18.0,8,0.77,12.0,23.0,-11.0,-0.92,-0.26,13.4,20.1,-6.7,-0.56,-0.21,Matches,363.0,km COM,MF,31.0,12.0,621.0,19.0,144.0,323.0,159.0,15.0,621.0,23.0,10.0,43.5,11.0,47.8,436.0,2174.0,811.0,17.0,11.0,1.0,18.0,9.0,401.0,35.0,Matches,363.0,km COM,MF,31.0,12.0,0.0,18.0,2.0,11.1,1.5,0.17,0.0,0.0,30.3,7.0,0.0,0.0,0.6,0.6,0.03,-0.6,-0.6,Matches,363.0,km COM,MF,31.0,26.0,11.0,1081.0,12.0,0.0,0.0,0.0,0.0,0.0,0.0,1.0,0.0,0.6,0.6,0.9,1.5,17.0,49.0,35.0,0.0,0.0,0.0,0.0,0.0,0.05,0.08,0.12,0.05,0.12,Matches,Youssouf M'Changama,M/AM C,31,123,125,"Comoros,France",AJ Auxerre,14,12,12,9,13,14,6,15,1,7,14,11,8,14,9,13,11,12,10,13,13,13,14,12,12,9,14,14,13,14,12,7,16,13,16,10,14,6,13,4,11,2,4,2,2,4,3,2,3,3,3,3,10,14,5,12,11,15,13,14,1,1,1,1,1,1,13,10,18,7,1,20,1,1,175,69,8,20,347975206,6150,6150,3800,African_Caribbean,124,14,1990/8/29,52,11,8808.0,,85059267
962,Deiver Machado,Lens,1993,364.0,co COL,DFMF,28.0,24.3,45.0,26.0,18.0,20.0,7.0,21.0,34.0,61.8,13.0,21.0,4.0,17.0,21.0,66.0,27.0,0.0,Matches,364.0,co COL,DFMF,28.0,24.3,42.0,1.73,26.0,4.0,2.0,0.0,8.0,2.0,6.0,0.25,3.0,2.0,0.0,0.0,0.0,1.0,Matches,,,,,,,,,,,,,,,,,,,,,,,,,,,,,,,,,,,,,,,,,,,,,,,,,,,,,,,,364.0,co COL,DFMF,28.0,24.3,5.0,1.0,0.0,42.0,46.0,6.0,60.0,21.0,26.0,1.0,0.0,0.0,116.0,15.0,29.0,34.1,Matches,364.0,co COL,DFMF,28.0,24.3,875.0,718.0,156.0,10.0,0.0,2.0,60.0,145.0,1.0,1.0,0.0,0.0,719.0,1.0,26.0,Matches,364.0,co COL,DFMF,28.0,24.3,719.0,875.0,82.2,11319.0,3207.0,371.0,429.0,86.5,268.0,311.0,86.2,50.0,85.0,58.8,3.0,2.8,2.6,0.2,20.0,33.0,21.0,13.0,54.0,Matches,430,co COL,DFMF,28,33,2184.0,66.0,63.9,24.3,26,77.0,1,7,26.0,2,2.15,44.0,23.0,21.0,0.87,-0.45,42.7,26.8,15.9,0.65,0.12,Matches,364.0,co COL,DFMF,28.0,24.3,1105.0,46.0,269.0,484.0,364.0,30.0,1105.0,54.0,17.0,31.5,23.0,42.6,737.0,4668.0,2043.0,59.0,41.0,10.0,30.0,11.0,649.0,131.0,Matches,364.0,co COL,DFMF,28.0,24.3,4.0,18.0,7.0,38.9,0.74,0.29,0.22,0.57,19.3,1.0,0.0,0.0,1.3,1.3,0.07,2.7,2.7,Matches,364.0,co COL,DFMF,28.0,33.0,26.0,2184.0,24.3,4.0,3.0,7.0,4.0,0.0,0.0,5.0,1.0,1.3,1.3,2.8,4.1,59.0,54.0,131.0,0.16,0.12,0.29,0.16,0.29,0.05,0.12,0.17,0.05,0.17,Matches,Deiver Machado,D/WB/M L,28,124,135,Colombia,RC Lens,8,13,12,8,12,7,8,10,12,11,11,10,11,12,9,12,12,12,12,12,12,13,11,10,12,12,12,12,15,13,12,8,14,14,14,12,11,9,11,7,14,2,3,2,1,4,3,1,1,1,4,1,16,9,9,12,11,12,11,10,1,18,1,1,20,1,1,18,1,1,12,1,1,1,180,75,20,8,2996360,6186,6186,3736,African_Caribbean,121,17,1993/9/2,3,0,10075.0,,76038733
963,Hugo Magnetti,Brest,1998,366.0,fr FRA,MF,24.0,18.8,43.0,27.0,18.0,23.0,2.0,23.0,63.0,36.5,40.0,21.0,1.0,20.0,25.0,68.0,12.0,0.0,Matches,366.0,fr FRA,MF,24.0,18.8,34.0,1.81,29.0,0.0,2.0,2.0,0.0,1.0,5.0,0.27,3.0,0.0,0.0,1.0,0.0,1.0,Matches,,,,,,,,,,,,,,,,,,,,,,,,,,,,,,,,,,,,,,,,,,,,,,,,,,,,,,,,366.0,fr FRA,MF,24.0,18.8,2.0,0.0,0.0,17.0,26.0,0.0,20.0,25.0,27.0,0.0,0.0,0.0,127.0,7.0,18.0,28.0,Matches,366.0,fr FRA,MF,24.0,18.8,762.0,709.0,50.0,26.0,0.0,12.0,20.0,9.0,1.0,0.0,1.0,0.0,634.0,3.0,18.0,Matches,366.0,fr FRA,MF,24.0,18.8,634.0,762.0,83.2,11461.0,2712.0,268.0,313.0,85.6,278.0,311.0,89.4,69.0,101.0,68.3,2.0,0.6,0.8,1.4,12.0,64.0,8.0,4.0,70.0,Matches,432,fr FRA,MF,24,32,1688.0,53.0,49.4,18.8,19,76.0,6,13,18.0,5,1.03,20.0,31.0,-11.0,-0.59,-0.64,19.4,28.6,-9.2,-0.49,-0.31,Matches,366.0,fr FRA,MF,24.0,18.8,931.0,29.0,215.0,541.0,186.0,10.0,931.0,35.0,23.0,65.7,11.0,31.4,658.0,4099.0,1767.0,32.0,35.0,1.0,21.0,15.0,567.0,27.0,Matches,366.0,fr FRA,MF,24.0,18.8,1.0,17.0,6.0,35.3,0.91,0.32,0.06,0.17,24.7,0.0,0.0,0.0,0.8,0.8,0.05,0.2,0.2,Matches,366.0,fr FRA,MF,24.0,32.0,19.0,1688.0,18.8,1.0,2.0,3.0,1.0,0.0,0.0,2.0,0.0,0.8,0.8,0.6,1.5,32.0,70.0,27.0,0.05,0.11,0.16,0.05,0.16,0.05,0.03,0.08,0.05,0.08,Matches,Hugo Magnetti,DM/M C,24,122,130,France,Stade Brestois 29,11,11,13,10,14,10,8,10,8,11,14,11,13,13,13,12,13,12,12,12,12,10,11,7,9,12,13,13,12,14,13,8,11,12,13,14,11,13,11,6,8,1,2,2,2,2,3,2,2,2,1,3,8,12,2,12,12,13,10,10,1,1,1,1,1,1,18,1,20,1,1,12,1,1,172,74,10,20,2080628,6094,6094,3244,Northern_European,121,5,1998/5/30,0,0,8064.0,,48044237
964,Yohann Magnin,Clermont Foot,1997,367.0,fr FRA,MF,25.0,26.7,89.0,54.0,37.0,45.0,7.0,54.0,106.0,50.9,52.0,50.0,12.0,38.0,25.0,114.0,46.0,0.0,Matches,367.0,fr FRA,MF,25.0,26.7,47.0,1.76,39.0,0.0,1.0,1.0,2.0,4.0,3.0,0.11,3.0,0.0,0.0,0.0,0.0,0.0,Matches,,,,,,,,,,,,,,,,,,,,,,,,,,,,,,,,,,,,,,,,,,,,,,,,,,,,,,,,367.0,fr FRA,MF,25.0,26.7,6.0,0.0,0.0,48.0,48.0,3.0,14.0,25.0,54.0,0.0,3.0,0.0,149.0,27.0,47.0,36.5,Matches,367.0,fr FRA,MF,25.0,26.7,1337.0,1304.0,31.0,18.0,2.0,8.0,14.0,12.0,1.0,0.0,0.0,0.0,1121.0,2.0,25.0,Matches,367.0,fr FRA,MF,25.0,26.7,1121.0,1337.0,83.8,18526.0,5540.0,507.0,577.0,87.9,463.0,531.0,87.2,93.0,141.0,66.0,0.0,2.3,1.8,-2.3,21.0,88.0,9.0,2.0,121.0,Matches,433,fr FRA,MF,25,38,2399.0,63.0,70.1,26.7,25,86.0,20,13,19.0,0,1.55,26.0,35.0,-9.0,-0.34,-0.78,30.0,39.0,-9.1,-0.34,-0.19,Matches,367.0,fr FRA,MF,25.0,26.7,1643.0,60.0,430.0,999.0,226.0,28.0,1643.0,32.0,7.0,21.9,19.0,59.4,1168.0,5308.0,2152.0,14.0,28.0,2.0,20.0,11.0,1071.0,56.0,Matches,367.0,fr FRA,MF,25.0,26.7,0.0,17.0,1.0,5.9,0.64,0.04,0.0,0.0,19.8,0.0,0.0,0.0,1.1,1.1,0.06,-1.1,-1.1,Matches,367.0,fr FRA,MF,25.0,38.0,25.0,2399.0,26.7,0.0,0.0,0.0,0.0,0.0,0.0,6.0,0.0,1.1,1.1,2.3,3.3,14.0,121.0,56.0,0.0,0.0,0.0,0.0,0.0,0.04,0.09,0.13,0.04,0.13,Matches,Yohann Magnin,DM/M C,25,122,128,France,Clermont Foot 63,10,10,9,9,12,10,10,11,11,12,13,10,13,12,11,13,13,11,14,12,13,12,12,13,10,14,15,14,12,12,10,12,12,12,14,13,12,12,10,7,10,1,3,2,2,3,2,3,2,1,2,3,10,12,6,16,12,12,13,13,1,1,15,1,1,1,20,1,20,1,1,1,1,1,183,71,8,20,2316843,6099,6099,3511,Northern_European,122,5,1997/6/21,0,0,7937.0,,48042634
965,Lovro Majer,Rennes,1998,368.0,hr CRO,MFFW,24.0,18.5,34.0,23.0,16.0,13.0,5.0,8.0,29.0,27.6,21.0,21.0,1.0,20.0,21.0,55.0,5.0,1.0,Matches,368.0,hr CRO,MFFW,24.0,18.5,79.0,4.26,53.0,8.0,3.0,6.0,8.0,1.0,6.0,0.32,3.0,2.0,0.0,0.0,1.0,0.0,Matches,,,,,,,,,,,,,,,,,,,,,,,,,,,,,,,,,,,,,,,,,,,,,,,,,,,,,,,,368.0,hr CRO,MFFW,24.0,18.5,3.0,0.0,0.0,48.0,30.0,3.0,67.0,21.0,23.0,1.0,0.0,0.0,143.0,7.0,8.0,46.7,Matches,368.0,hr CRO,MFFW,24.0,18.5,976.0,909.0,60.0,22.0,6.0,4.0,67.0,7.0,31.0,12.0,11.0,0.0,758.0,7.0,45.0,Matches,368.0,hr CRO,MFFW,24.0,18.5,758.0,976.0,77.7,13129.0,3666.0,316.0,387.0,81.7,334.0,388.0,86.1,75.0,130.0,57.7,5.0,4.4,4.5,0.6,36.0,90.0,36.0,9.0,134.0,Matches,434,hr CRO,MFFW,24,32,1668.0,52.0,48.8,18.5,18,74.0,6,14,23.0,1,1.84,34.0,16.0,18.0,0.97,0.35,30.4,20.4,10.0,0.54,0.16,Matches,368.0,hr CRO,MFFW,24.0,18.5,1187.0,18.0,142.0,572.0,493.0,62.0,1186.0,45.0,28.0,62.2,13.0,28.9,929.0,6297.0,3028.0,66.0,64.0,8.0,46.0,31.0,842.0,115.0,Matches,368.0,hr CRO,MFFW,24.0,18.5,2.0,33.0,11.0,33.3,1.78,0.59,0.03,0.09,20.4,5.0,1.0,1.0,3.3,2.5,0.08,-1.3,-1.5,Matches,368.0,hr CRO,MFFW,24.0,32.0,18.0,1668.0,18.5,2.0,5.0,7.0,1.0,1.0,1.0,3.0,0.0,3.3,2.5,4.4,7.0,66.0,134.0,115.0,0.11,0.27,0.38,0.05,0.32,0.18,0.24,0.42,0.14,0.38,Matches,Lovro Majer,M/AM C,24,137,144,Croatia,Stade Rennais FC,15,16,16,12,14,14,10,13,5,9,15,15,11,17,12,16,10,13,14,15,13,13,15,8,13,11,13,15,13,16,11,8,13,9,16,7,13,9,11,9,10,1,3,3,2,3,3,3,1,3,2,3,10,14,8,12,12,14,11,11,1,1,1,1,1,1,1,1,17,12,8,20,13,1,176,75,20,9,18601140,6900,6900,5250,Northern_European,139,4,1998/1/17,8,2,30178.0,,24053458
966,Jean-Victor Makengo,Lorient,1998,369.0,fr FRA,MF,24.0,11.8,16.0,8.0,5.0,10.0,1.0,6.0,20.0,30.0,14.0,8.0,5.0,3.0,10.0,26.0,13.0,1.0,Matches,369.0,fr FRA,MF,24.0,11.8,24.0,2.03,17.0,0.0,3.0,1.0,2.0,1.0,1.0,0.08,1.0,0.0,0.0,0.0,0.0,0.0,Matches,,,,,,,,,,,,,,,,,,,,,,,,,,,,,,,,,,,,,,,,,,,,,,,,,,,,,,,,369.0,fr FRA,MF,24.0,11.8,2.0,1.0,1.0,18.0,27.0,0.0,1.0,10.0,8.0,0.0,0.0,0.0,79.0,4.0,4.0,50.0,Matches,369.0,fr FRA,MF,24.0,11.8,540.0,525.0,12.0,9.0,2.0,1.0,1.0,2.0,0.0,0.0,0.0,0.0,475.0,3.0,5.0,Matches,369.0,fr FRA,MF,24.0,11.8,475.0,540.0,88.0,6908.0,1677.0,261.0,288.0,90.6,168.0,185.0,90.8,19.0,28.0,67.9,0.0,0.5,0.7,-0.5,8.0,33.0,3.0,0.0,42.0,Matches,435,fr FRA,MF,24,15,1064.0,71.0,31.1,11.8,12,80.0,7,3,35.0,0,1.07,9.0,14.0,-5.0,-0.42,-0.58,12.6,16.0,-3.4,-0.29,0.1,Matches,369.0,fr FRA,MF,24.0,11.8,652.0,27.0,152.0,405.0,109.0,6.0,652.0,35.0,21.0,60.0,8.0,22.9,546.0,3480.0,1530.0,23.0,25.0,1.0,16.0,23.0,497.0,30.0,Matches,369.0,fr FRA,MF,24.0,11.8,0.0,5.0,2.0,40.0,0.42,0.17,0.0,0.0,26.9,0.0,0.0,0.0,0.1,0.1,0.03,-0.1,-0.1,Matches,369.0,fr FRA,MF,24.0,15.0,12.0,1064.0,11.8,0.0,0.0,0.0,0.0,0.0,0.0,2.0,1.0,0.1,0.1,0.5,0.7,23.0,42.0,30.0,0.0,0.0,0.0,0.0,0.0,0.01,0.04,0.06,0.01,0.06,Matches,Jean-Victor Makengo,DM/M C,24,130,143,"France,Democratic Republic of Congo",Udinese Calcio,6,8,13,9,12,7,6,12,6,12,13,8,13,14,15,13,14,14,14,12,12,15,12,8,13,13,14,14,14,15,13,9,14,13,15,14,12,8,12,4,12,3,1,1,1,2,1,1,3,2,2,3,14,14,5,13,12,14,11,16,1,1,1,1,1,1,17,1,20,1,1,14,1,1,177,75,20,10,3531649,6498,6198,5048,African_Caribbean,130,15,1998/6/12,0,0,7307.0,,85144993
967,Ruslan Malinovskyi,Marseille,1993,371.0,ua UKR,MFFW,29.0,13.6,21.0,11.0,3.0,12.0,6.0,10.0,26.0,38.5,16.0,13.0,1.0,12.0,3.0,24.0,9.0,0.0,Matches,371.0,ua UKR,MFFW,29.0,13.6,57.0,4.18,30.0,9.0,4.0,6.0,7.0,1.0,5.0,0.37,2.0,0.0,0.0,3.0,0.0,0.0,Matches,,,,,,,,,,,,,,,,,,,,,,,,,,,,,,,,,,,,,,,,,,,,,,,,,,,,,,,,371.0,ua UKR,MFFW,29.0,13.6,4.0,0.0,0.0,29.0,18.0,1.0,38.0,3.0,11.0,0.0,0.0,0.0,73.0,15.0,24.0,38.5,Matches,371.0,ua UKR,MFFW,29.0,13.6,543.0,504.0,34.0,11.0,3.0,4.0,38.0,6.0,17.0,7.0,7.0,0.0,411.0,5.0,14.0,Matches,371.0,ua UKR,MFFW,29.0,13.6,411.0,543.0,75.7,6846.0,1959.0,201.0,247.0,81.4,155.0,191.0,81.2,38.0,63.0,60.3,1.0,2.4,2.1,-1.4,19.0,53.0,18.0,5.0,64.0,Matches,438,ua UKR,MFFW,29,20,1227.0,61.0,35.9,13.6,13,78.0,3,7,31.0,0,1.7,22.0,17.0,5.0,0.37,-0.54,23.5,14.4,9.0,0.66,0.1,Matches,371.0,ua UKR,MFFW,29.0,13.6,698.0,12.0,80.0,311.0,323.0,26.0,698.0,42.0,27.0,64.3,13.0,31.0,533.0,3349.0,1583.0,35.0,30.0,5.0,30.0,20.0,509.0,81.0,Matches,371.0,ua UKR,MFFW,29.0,13.6,1.0,35.0,7.0,20.0,2.57,0.51,0.03,0.14,24.3,6.0,0.0,0.0,2.3,2.3,0.06,-1.3,-1.3,Matches,371.0,ua UKR,MFFW,29.0,20.0,13.0,1227.0,13.6,1.0,1.0,2.0,1.0,0.0,0.0,4.0,0.0,2.3,2.3,2.4,4.6,35.0,64.0,81.0,0.07,0.07,0.15,0.07,0.15,0.17,0.17,0.34,0.17,0.34,Matches,Ruslan Malinovskyi,M/AM C,29,146,155,Ukraine,Atalanta,17,14,15,12,16,17,4,19,4,6,15,14,11,17,15,12,12,13,12,14,13,14,16,8,13,6,11,15,14,15,16,9,16,12,11,15,13,12,13,6,12,2,2,3,4,3,3,2,4,2,2,2,15,14,6,14,13,16,14,11,1,1,1,1,1,1,11,1,18,1,10,20,10,14,181,79,20,12,20240319,7300,7050,6300,Northern_European,145,4,1993/5/4,49,7,24615.0,,71048716
968,Steve Mandanda,Rennes,1985,373.0,fr FRA,GK,37.0,33.5,0.0,0.0,0.0,0.0,0.0,0.0,2.0,0.0,2.0,0.0,0.0,0.0,0.0,0.0,9.0,3.0,Matches,373.0,fr FRA,GK,37.0,33.5,5.0,0.15,5.0,0.0,0.0,0.0,0.0,0.0,2.0,0.06,2.0,0.0,0.0,0.0,0.0,0.0,Matches,29.0,fr FRA,GK,37.0,33.5,31.0,2.0,0.0,5.0,1.0,32.4,0.28,2.4,0.07,163.0,420.0,38.8,1022.0,166.0,30.6,31.5,192.0,55.7,41.5,382.0,35.0,9.2,51.0,1.52,16.7,Matches,29.0,fr FRA,GK,37.0,34.0,34.0,3014.0,33.5,31.0,0.93,110.0,79.0,73.6,19.0,5.0,10.0,12.0,35.3,3.0,2.0,1.0,0.0,33.3,Matches,373.0,fr FRA,GK,37.0,33.5,1.0,0.0,0.0,2.0,3.0,0.0,0.0,0.0,0.0,0.0,2.0,0.0,55.0,6.0,1.0,85.7,Matches,373.0,fr FRA,GK,37.0,33.5,1216.0,917.0,297.0,105.0,0.0,0.0,0.0,0.0,0.0,0.0,0.0,0.0,919.0,2.0,0.0,Matches,373.0,fr FRA,GK,37.0,33.5,919.0,1216.0,75.6,25001.0,17025.0,156.0,158.0,98.7,468.0,478.0,97.9,291.0,573.0,50.8,1.0,0.1,0.0,0.9,1.0,15.0,0.0,0.0,1.0,Matches,440,fr FRA,GK,37,34,3014.0,89.0,88.1,33.5,34,89.0,32,0,,1,1.82,62.0,31.0,31.0,0.93,1.15,55.3,38.1,17.2,0.51,0.5,Matches,373.0,fr FRA,GK,37.0,33.5,1267.0,922.0,1251.0,17.0,0.0,0.0,1267.0,1.0,1.0,100.0,0.0,0.0,916.0,4101.0,2479.0,0.0,0.0,0.0,2.0,0.0,649.0,0.0,Matches,373.0,fr FRA,GK,37.0,33.5,0.0,0.0,0.0,,0.0,0.0,,,,0.0,0.0,0.0,0.0,0.0,,0.0,0.0,Matches,373.0,fr FRA,GK,37.0,34.0,34.0,3014.0,33.5,0.0,1.0,1.0,0.0,0.0,0.0,1.0,0.0,0.0,0.0,0.1,0.1,0.0,1.0,0.0,0.0,0.03,0.03,0.0,0.03,0.0,0.0,0.0,0.0,0.0,Matches,Steve Mandanda,GK,37,135,154,"France,Democratic Republic of Congo",Stade Rennais FC,7,3,8,5,9,9,8,12,2,1,9,7,2,10,6,14,14,15,12,8,13,14,8,15,2,13,13,8,10,13,13,14,12,10,10,14,13,6,15,3,1,14,13,13,6,15,12,14,14,14,10,13,8,16,7,15,13,17,16,16,20,1,1,1,1,1,1,1,1,1,1,1,1,1,185,82,10,20,347975206,6750,6750,5500,African_Caribbean,134,17,1985/3/28,34,0,59835.0,,8428461
969,Thomas Mangani,Ajaccio,1987,374.0,fr FRA,MF,35.0,14.8,32.0,17.0,14.0,15.0,3.0,18.0,47.0,38.3,29.0,22.0,3.0,19.0,24.0,56.0,22.0,1.0,Matches,374.0,fr FRA,MF,35.0,14.8,42.0,2.84,16.0,24.0,0.0,1.0,1.0,0.0,1.0,0.07,1.0,0.0,0.0,0.0,0.0,0.0,Matches,,,,,,,,,,,,,,,,,,,,,,,,,,,,,,,,,,,,,,,,,,,,,,,,,,,,,,,,374.0,fr FRA,MF,35.0,14.8,4.0,1.0,0.0,24.0,13.0,0.0,79.0,24.0,17.0,0.0,0.0,0.0,94.0,20.0,24.0,45.5,Matches,374.0,fr FRA,MF,35.0,14.8,910.0,783.0,122.0,74.0,2.0,9.0,79.0,3.0,45.0,22.0,17.0,0.0,634.0,5.0,19.0,Matches,374.0,fr FRA,MF,35.0,14.8,634.0,910.0,69.7,12908.0,4783.0,224.0,294.0,76.2,271.0,355.0,76.3,120.0,222.0,54.1,1.0,1.9,2.1,-0.9,26.0,78.0,12.0,4.0,92.0,Matches,441,fr FRA,MF,35,26,1332.0,51.0,38.9,14.8,14,83.0,6,12,14.0,3,0.77,8.0,36.0,-28.0,-1.89,-0.9,12.1,24.1,-12.1,-0.82,-0.57,Matches,374.0,fr FRA,MF,35.0,14.8,1052.0,51.0,232.0,648.0,175.0,3.0,1050.0,6.0,4.0,66.7,1.0,16.7,640.0,3045.0,1283.0,9.0,17.0,1.0,9.0,3.0,585.0,15.0,Matches,374.0,fr FRA,MF,35.0,14.8,1.0,9.0,0.0,0.0,0.61,0.0,0.0,,27.1,2.0,1.0,2.0,2.0,0.4,0.05,-1.0,-0.4,Matches,374.0,fr FRA,MF,35.0,26.0,14.0,1332.0,14.8,1.0,1.0,2.0,0.0,1.0,2.0,4.0,1.0,2.0,0.4,1.9,2.3,9.0,92.0,15.0,0.07,0.07,0.14,0.0,0.07,0.14,0.13,0.26,0.03,0.16,Matches,Thomas Mangani,DM C,35,126,129,"France,Italy",AC Ajaccio,13,8,10,6,12,15,13,10,12,11,12,14,13,12,12,15,13,13,13,11,13,15,6,12,10,13,16,17,12,11,14,12,14,11,15,14,14,12,14,6,12,3,3,2,2,2,2,1,3,3,3,2,11,12,5,13,12,15,15,15,1,12,12,1,14,1,20,12,15,1,1,1,1,1,183,79,20,8,347975206,6300,6300,3901,Northern_European,126,6,1987/4/29,0,0,10967.0,,919962
970,Faitout Maouassa,Montpellier,1998,377.0,fr FRA,FWDF,24.0,21.4,52.0,32.0,26.0,20.0,6.0,18.0,41.0,43.9,23.0,31.0,3.0,28.0,20.0,72.0,23.0,0.0,Matches,377.0,fr FRA,FWDF,24.0,21.4,57.0,2.66,39.0,6.0,5.0,4.0,2.0,1.0,10.0,0.47,10.0,0.0,0.0,0.0,0.0,0.0,Matches,,,,,,,,,,,,,,,,,,,,,,,,,,,,,,,,,,,,,,,,,,,,,,,,,,,,,,,,377.0,fr FRA,FWDF,24.0,21.4,0.0,0.0,0.0,32.0,31.0,2.0,81.0,20.0,32.0,0.0,0.0,0.0,83.0,13.0,12.0,52.0,Matches,377.0,fr FRA,FWDF,24.0,21.4,651.0,528.0,117.0,7.0,1.0,5.0,81.0,92.0,18.0,10.0,6.0,0.0,436.0,6.0,29.0,Matches,377.0,fr FRA,FWDF,24.0,21.4,436.0,651.0,67.0,7095.0,2881.0,246.0,309.0,79.6,131.0,177.0,74.0,43.0,109.0,39.4,5.0,2.2,1.9,2.8,23.0,30.0,13.0,8.0,51.0,Matches,445,fr FRA,FWDF,24,33,1923.0,58.0,56.2,21.4,23,71.0,4,10,28.0,0,1.3,39.0,37.0,2.0,0.09,0.03,28.9,36.9,-8.0,-0.37,-0.26,Matches,377.0,fr FRA,FWDF,24.0,21.4,924.0,31.0,223.0,383.0,334.0,41.0,924.0,62.0,25.0,40.3,32.0,51.6,562.0,3630.0,1723.0,37.0,41.0,12.0,32.0,22.0,513.0,108.0,Matches,377.0,fr FRA,FWDF,24.0,21.4,5.0,34.0,12.0,35.3,1.59,0.56,0.15,0.42,20.1,1.0,0.0,0.0,3.3,3.3,0.1,1.7,1.7,Matches,377.0,fr FRA,FWDF,24.0,33.0,23.0,1923.0,21.4,5.0,5.0,10.0,5.0,0.0,0.0,0.0,0.0,3.3,3.3,2.2,5.6,37.0,51.0,108.0,0.23,0.23,0.47,0.23,0.47,0.16,0.1,0.26,0.16,0.26,Matches,Faitout Maouassa,D/WB L,24,132,141,"France,Congo",Club Brugge KV,13,14,14,12,13,12,5,13,8,12,12,11,13,14,12,11,13,11,13,13,13,12,14,8,13,13,13,12,15,14,13,6,14,14,13,12,14,12,12,12,14,3,2,2,3,1,1,1,1,2,3,2,12,16,6,12,13,14,11,16,1,20,1,1,18,1,1,14,1,10,13,1,1,1,170,73,20,8,3997935,6000,6750,4200,African_Caribbean,127,14,1998/7/6,0,0,7499.0,Montpellier Hérault SC,48031025
971,Guillermo Maripán,Monaco,1994,379.0,cl CHI,DF,28.0,24.0,46.0,26.0,26.0,20.0,0.0,17.0,33.0,51.5,16.0,39.0,27.0,12.0,38.0,84.0,87.0,0.0,Matches,379.0,cl CHI,DF,28.0,24.0,13.0,0.54,11.0,0.0,0.0,2.0,0.0,0.0,4.0,0.17,2.0,0.0,0.0,2.0,0.0,0.0,Matches,,,,,,,,,,,,,,,,,,,,,,,,,,,,,,,,,,,,,,,,,,,,,,,,,,,,,,,,379.0,cl CHI,DF,28.0,24.0,6.0,1.0,1.0,26.0,7.0,0.0,1.0,38.0,26.0,0.0,3.0,1.0,131.0,48.0,40.0,54.5,Matches,379.0,cl CHI,DF,28.0,24.0,1162.0,1120.0,41.0,36.0,0.0,7.0,1.0,0.0,0.0,0.0,0.0,0.0,1015.0,1.0,9.0,Matches,379.0,cl CHI,DF,28.0,24.0,1015.0,1162.0,87.3,21435.0,7180.0,264.0,293.0,90.1,600.0,655.0,91.6,135.0,180.0,75.0,0.0,0.1,0.3,-0.1,2.0,62.0,2.0,0.0,68.0,Matches,448,cl CHI,DF,28,26,2157.0,83.0,63.1,24.0,25,85.0,21,1,25.0,5,1.85,48.0,32.0,16.0,0.67,0.95,40.8,33.5,7.2,0.3,0.19,Matches,379.0,cl CHI,DF,28.0,24.0,1418.0,183.0,658.0,734.0,37.0,25.0,1418.0,6.0,1.0,16.7,4.0,66.7,1000.0,4754.0,2312.0,6.0,6.0,0.0,9.0,6.0,888.0,0.0,Matches,379.0,cl CHI,DF,28.0,24.0,3.0,16.0,6.0,37.5,0.67,0.25,0.19,0.5,10.7,0.0,0.0,0.0,1.6,1.6,0.1,1.4,1.4,Matches,379.0,cl CHI,DF,28.0,26.0,25.0,2157.0,24.0,3.0,0.0,3.0,3.0,0.0,0.0,6.0,1.0,1.6,1.6,0.1,1.7,6.0,68.0,0.0,0.13,0.0,0.13,0.13,0.13,0.06,0.01,0.07,0.06,0.07,Matches,Guillermo Maripán,D C,28,131,140,Chile,AS Monaco,6,5,7,7,10,6,15,8,7,14,12,4,15,10,14,14,15,12,13,9,12,14,5,10,7,15,14,13,11,11,13,16,15,11,15,15,12,12,13,4,8,1,1,3,1,1,2,1,2,1,1,3,11,13,6,14,12,13,9,9,1,1,20,1,1,1,8,1,1,1,1,1,1,1,193,83,9,20,4942356,6544,6544,4994,Mediterranean_Hispanic,129,7,1994/5/6,38,2,8054.0,,75030680
972,Marquinhos,Paris S-G,1994,380.0,br BRA,DF,28.0,30.2,33.0,25.0,18.0,12.0,3.0,18.0,26.0,69.2,8.0,43.0,27.0,16.0,23.0,56.0,83.0,2.0,Matches,380.0,br BRA,DF,28.0,30.2,19.0,0.63,15.0,1.0,0.0,3.0,0.0,0.0,2.0,0.07,2.0,0.0,0.0,0.0,0.0,0.0,Matches,,,,,,,,,,,,,,,,,,,,,,,,,,,,,,,,,,,,,,,,,,,,,,,,,,,,,,,,380.0,br BRA,DF,28.0,30.2,4.0,0.0,0.0,14.0,10.0,0.0,1.0,23.0,25.0,0.0,0.0,1.0,155.0,35.0,27.0,56.5,Matches,380.0,br BRA,DF,28.0,30.2,2175.0,2114.0,57.0,34.0,4.0,7.0,1.0,17.0,0.0,0.0,0.0,0.0,2068.0,4.0,11.0,Matches,380.0,br BRA,DF,28.0,30.2,2068.0,2175.0,95.1,35716.0,12062.0,835.0,864.0,96.6,1045.0,1077.0,97.0,136.0,164.0,82.9,0.0,0.5,1.3,-0.5,9.0,104.0,3.0,0.0,99.0,Matches,449,br BRA,DF,28,33,2717.0,82.0,79.4,30.2,30,89.0,26,3,16.0,0,2.27,71.0,28.0,43.0,1.42,0.66,62.7,36.1,26.6,0.88,0.46,Matches,380.0,br BRA,DF,28.0,30.2,2411.0,294.0,946.0,1359.0,117.0,39.0,2411.0,2.0,0.0,0.0,2.0,100.0,1974.0,9280.0,4747.0,4.0,18.0,2.0,12.0,6.0,1869.0,15.0,Matches,380.0,br BRA,DF,28.0,30.2,2.0,18.0,4.0,22.2,0.6,0.13,0.11,0.5,9.2,0.0,0.0,0.0,2.1,2.1,0.11,-0.1,-0.1,Matches,380.0,br BRA,DF,28.0,33.0,30.0,2717.0,30.2,2.0,0.0,2.0,2.0,0.0,0.0,4.0,0.0,2.1,2.1,0.5,2.6,4.0,99.0,15.0,0.07,0.0,0.07,0.07,0.07,0.07,0.02,0.09,0.07,0.09,Matches,Marquinhos,D/DM C,28,164,165,"Brazil,Portugal",Paris Saint-Germain,4,11,10,8,14,4,15,10,7,16,14,8,16,14,14,17,15,17,17,13,16,17,10,15,8,16,17,15,13,13,16,13,15,14,16,14,15,8,15,8,15,1,1,3,1,3,3,3,1,1,1,3,15,16,7,15,14,18,15,16,1,1,20,14,1,1,16,1,1,1,1,1,1,1,183,75,10,20,191688462,8195,8595,7645,Mixed_Race,164,12,1994/5/14,69,4,276164.0,,19163495
973,Han-Noah Massengo,Auxerre,2001,383.0,fr FRA,MF,21.0,12.4,27.0,15.0,10.0,15.0,2.0,7.0,16.0,43.8,9.0,12.0,3.0,9.0,14.0,41.0,7.0,0.0,Matches,383.0,fr FRA,MF,21.0,12.4,28.0,2.26,21.0,0.0,1.0,1.0,2.0,3.0,1.0,0.08,0.0,0.0,0.0,0.0,1.0,0.0,Matches,,,,,,,,,,,,,,,,,,,,,,,,,,,,,,,,,,,,,,,,,,,,,,,,,,,,,,,,383.0,fr FRA,MF,21.0,12.4,3.0,0.0,0.0,16.0,23.0,1.0,2.0,14.0,15.0,1.0,0.0,0.0,59.0,6.0,16.0,27.3,Matches,383.0,fr FRA,MF,21.0,12.4,453.0,435.0,12.0,8.0,5.0,3.0,2.0,1.0,0.0,0.0,0.0,0.0,385.0,6.0,9.0,Matches,383.0,fr FRA,MF,21.0,12.4,385.0,453.0,85.0,6593.0,1849.0,165.0,187.0,88.2,168.0,188.0,89.4,36.0,43.0,83.7,0.0,0.6,1.1,-0.6,11.0,43.0,12.0,2.0,48.0,Matches,452,fr FRA,MF,21,14,1116.0,80.0,32.6,12.4,13,84.0,8,1,22.0,0,1.07,11.0,13.0,-2.0,-0.16,0.85,14.5,18.5,-4.0,-0.32,0.14,Matches,383.0,fr FRA,MF,21.0,12.4,588.0,11.0,107.0,358.0,134.0,20.0,588.0,38.0,17.0,44.7,14.0,36.8,446.0,2726.0,1184.0,21.0,26.0,6.0,19.0,8.0,403.0,29.0,Matches,383.0,fr FRA,MF,21.0,12.4,0.0,13.0,1.0,7.7,1.05,0.08,0.0,0.0,18.9,0.0,0.0,0.0,1.4,1.4,0.11,-1.4,-1.4,Matches,383.0,fr FRA,MF,21.0,14.0,13.0,1116.0,12.4,0.0,0.0,0.0,0.0,0.0,0.0,3.0,0.0,1.4,1.4,0.6,2.0,21.0,48.0,29.0,0.0,0.0,0.0,0.0,0.0,0.11,0.05,0.16,0.11,0.16,Matches,Han-Noah Massengo,DM/M C,21,121,-8,"France,Congo,Belgium",Bristol City,9,10,13,7,13,9,10,7,4,11,14,11,14,14,12,11,13,14,12,13,12,13,13,10,12,13,12,13,12,14,14,9,16,13,15,12,11,6,14,6,11,2,1,1,1,2,1,3,4,1,1,3,13,13,7,10,12,13,10,10,1,1,1,1,1,1,18,1,20,1,1,12,1,1,177,66,9,20,44401636,6050,5600,3500,Mixed_Race,123,11,2001/7/7,0,0,5800.0,,49047253
974,Eliot Matazo,Monaco,2002,385.0,be BEL,MF,20.0,13.1,26.0,12.0,11.0,13.0,2.0,11.0,26.0,42.3,15.0,18.0,4.0,14.0,15.0,41.0,11.0,1.0,Matches,385.0,be BEL,MF,20.0,13.1,11.0,0.84,9.0,0.0,0.0,0.0,1.0,1.0,0.0,0.0,0.0,0.0,0.0,0.0,0.0,0.0,Matches,,,,,,,,,,,,,,,,,,,,,,,,,,,,,,,,,,,,,,,,,,,,,,,,,,,,,,,,385.0,be BEL,MF,20.0,13.1,2.0,0.0,0.0,18.0,12.0,0.0,2.0,15.0,12.0,0.0,1.0,0.0,86.0,10.0,18.0,35.7,Matches,385.0,be BEL,MF,20.0,13.1,493.0,483.0,7.0,6.0,0.0,7.0,2.0,0.0,0.0,0.0,0.0,0.0,399.0,3.0,8.0,Matches,385.0,be BEL,MF,20.0,13.1,399.0,493.0,80.9,7648.0,1822.0,156.0,186.0,83.9,183.0,213.0,85.9,54.0,73.0,74.0,0.0,0.1,0.3,-0.1,2.0,50.0,3.0,0.0,60.0,Matches,454,be BEL,MF,20,23,1175.0,51.0,34.4,13.1,13,75.0,7,10,20.0,11,1.65,20.0,21.0,-1.0,-0.08,-0.6,19.6,19.5,0.1,0.01,-0.35,Matches,385.0,be BEL,MF,20.0,13.1,606.0,30.0,134.0,399.0,81.0,1.0,606.0,16.0,4.0,25.0,9.0,56.3,431.0,2218.0,889.0,5.0,13.0,0.0,9.0,12.0,363.0,10.0,Matches,385.0,be BEL,MF,20.0,13.1,1.0,4.0,3.0,75.0,0.31,0.23,0.25,0.33,22.9,0.0,0.0,0.0,0.2,0.2,0.05,0.8,0.8,Matches,385.0,be BEL,MF,20.0,23.0,13.0,1175.0,13.1,1.0,0.0,1.0,1.0,0.0,0.0,2.0,0.0,0.2,0.2,0.1,0.3,5.0,60.0,10.0,0.08,0.0,0.08,0.08,0.08,0.02,0.01,0.03,0.02,0.03,Matches,Eliot Matazo,DM/M RC,20,115,-8,"Belgium,Democratic Republic of Congo",AS Monaco,8,9,13,10,13,9,9,10,2,12,13,8,12,13,14,12,13,10,12,12,12,14,12,12,9,11,14,14,13,14,13,9,14,13,13,13,11,11,10,8,12,1,2,3,3,3,1,3,3,1,1,3,13,18,4,8,8,12,11,13,1,1,1,1,1,1,16,1,20,15,1,1,1,1,174,67,8,20,48403351,5749,5749,2999,African_Caribbean,116,17,2002/2/15,0,0,5717.0,,18107444
975,Azor Matusiwa,Reims,1998,389.0,nl NED,MF,24.0,27.6,66.0,41.0,30.0,29.0,7.0,36.0,61.0,59.0,25.0,37.0,11.0,26.0,46.0,112.0,52.0,0.0,Matches,389.0,nl NED,MF,24.0,27.6,68.0,2.46,64.0,0.0,0.0,2.0,1.0,1.0,3.0,0.11,3.0,0.0,0.0,0.0,0.0,0.0,Matches,,,,,,,,,,,,,,,,,,,,,,,,,,,,,,,,,,,,,,,,,,,,,,,,,,,,,,,,389.0,nl NED,MF,24.0,27.6,4.0,0.0,0.0,43.0,33.0,0.0,4.0,46.0,41.0,0.0,0.0,0.0,235.0,32.0,35.0,47.8,Matches,389.0,nl NED,MF,24.0,27.6,1617.0,1576.0,33.0,26.0,1.0,24.0,4.0,6.0,0.0,0.0,0.0,0.0,1376.0,8.0,27.0,Matches,389.0,nl NED,MF,24.0,27.6,1376.0,1617.0,85.1,26423.0,8698.0,508.0,605.0,84.0,636.0,702.0,90.6,192.0,234.0,82.1,0.0,1.2,1.3,-1.2,24.0,148.0,13.0,0.0,213.0,Matches,458,nl NED,MF,24,30,2484.0,83.0,72.6,27.6,29,85.0,19,1,28.0,0,1.47,34.0,29.0,5.0,0.18,0.66,48.3,36.7,11.6,0.42,0.69,Matches,389.0,nl NED,MF,24.0,27.6,1915.0,100.0,541.0,1138.0,260.0,2.0,1915.0,23.0,16.0,69.6,5.0,21.7,1383.0,6842.0,3122.0,15.0,26.0,0.0,24.0,12.0,1203.0,18.0,Matches,389.0,nl NED,MF,24.0,27.6,0.0,11.0,4.0,36.4,0.4,0.14,0.0,0.0,26.2,0.0,0.0,0.0,0.4,0.4,0.04,-0.4,-0.4,Matches,389.0,nl NED,MF,24.0,30.0,29.0,2484.0,27.6,0.0,0.0,0.0,0.0,0.0,0.0,4.0,0.0,0.4,0.4,1.2,1.7,15.0,213.0,18.0,0.0,0.0,0.0,0.0,0.0,0.02,0.04,0.06,0.02,0.06,Matches,Azor Matusiwa,D/WB/DM/M RC,24,124,136,"Holland,Angola",Stade de Reims,6,8,9,4,14,8,8,7,8,13,13,6,13,13,13,13,14,12,11,14,12,15,8,14,13,13,14,17,12,11,14,8,13,12,12,13,13,13,11,8,10,2,1,1,3,3,3,3,3,1,3,3,18,12,8,12,14,12,14,14,1,1,12,17,1,17,20,1,18,16,1,1,1,1,173,65,10,20,4636222,6200,6200,4500,African_Caribbean,118,16,1998/4/28,0,0,9847.0,,37053977
976,Stephy Mavididi,Montpellier,1998,391.0,eng ENG,FW,24.0,14.3,24.0,19.0,12.0,8.0,4.0,13.0,27.0,48.1,14.0,21.0,1.0,20.0,4.0,28.0,10.0,0.0,Matches,391.0,eng ENG,FW,24.0,14.3,44.0,3.08,22.0,0.0,8.0,7.0,5.0,2.0,4.0,0.28,3.0,0.0,1.0,0.0,0.0,0.0,Matches,,,,,,,,,,,,,,,,,,,,,,,,,,,,,,,,,,,,,,,,,,,,,,,,,,,,,,,,391.0,eng ENG,FW,24.0,14.3,1.0,1.0,0.0,20.0,18.0,3.0,10.0,4.0,19.0,0.0,0.0,0.0,59.0,10.0,22.0,31.3,Matches,391.0,eng ENG,FW,24.0,14.3,318.0,305.0,12.0,1.0,1.0,1.0,10.0,8.0,0.0,0.0,0.0,0.0,236.0,1.0,12.0,Matches,391.0,eng ENG,FW,24.0,14.3,236.0,318.0,74.2,3260.0,618.0,127.0,164.0,77.4,68.0,82.0,82.9,16.0,24.0,66.7,2.0,1.4,1.0,0.6,13.0,11.0,6.0,1.0,22.0,Matches,460,eng ENG,FW,24,26,1288.0,50.0,37.7,14.3,14,70.0,2,12,26.0,1,1.31,23.0,24.0,-1.0,-0.07,-0.24,20.5,25.0,-4.4,-0.31,-0.08,Matches,391.0,eng ENG,FW,24.0,14.3,530.0,15.0,78.0,231.0,244.0,51.0,530.0,74.0,32.0,43.2,37.0,50.0,392.0,2852.0,1175.0,34.0,37.0,11.0,39.0,32.0,356.0,91.0,Matches,391.0,eng ENG,FW,24.0,14.3,4.0,37.0,15.0,40.5,2.59,1.05,0.11,0.27,16.8,0.0,0.0,0.0,4.3,4.3,0.12,-0.3,-0.3,Matches,391.0,eng ENG,FW,24.0,26.0,14.0,1288.0,14.3,4.0,2.0,6.0,4.0,0.0,0.0,1.0,1.0,4.3,4.3,1.4,5.7,34.0,22.0,91.0,0.28,0.14,0.42,0.28,0.42,0.3,0.1,0.4,0.3,0.4,Matches,Stephy Mavididi,S L,24,129,140,"England,Democratic Republic of Congo",Montpellier Hérault SC,4,7,14,14,12,4,14,11,1,3,11,9,5,13,12,13,12,13,12,10,12,13,9,5,14,8,13,14,15,12,14,14,13,15,15,14,13,6,13,10,7,2,4,3,1,1,4,1,1,2,3,2,7,14,9,8,12,12,12,12,1,1,1,1,1,1,1,1,1,1,15,10,12,20,182,71,8,20,4108191,6450,6050,4256,African_Caribbean,128,14,1998/5/31,0,0,6898.0,,28099981
977,Kylian Mbappé,Paris S-G,1998,395.0,fr FRA,FW,23.0,31.3,10.0,4.0,0.0,5.0,5.0,5.0,16.0,31.3,11.0,5.0,0.0,5.0,5.0,15.0,6.0,0.0,Matches,395.0,fr FRA,FW,23.0,31.3,143.0,4.57,96.0,3.0,19.0,15.0,10.0,0.0,23.0,0.73,12.0,0.0,4.0,5.0,2.0,0.0,Matches,,,,,,,,,,,,,,,,,,,,,,,,,,,,,,,,,,,,,,,,,,,,,,,,,,,,,,,,395.0,fr FRA,FW,23.0,31.3,6.0,0.0,0.0,19.0,40.0,33.0,47.0,5.0,4.0,1.0,0.0,0.0,54.0,8.0,5.0,61.5,Matches,395.0,fr FRA,FW,23.0,31.3,1355.0,1291.0,59.0,2.0,8.0,2.0,47.0,13.0,17.0,3.0,0.0,0.0,1096.0,5.0,27.0,Matches,395.0,fr FRA,FW,23.0,31.3,1096.0,1355.0,80.9,14622.0,3137.0,677.0,789.0,85.8,299.0,371.0,80.6,42.0,65.0,64.6,5.0,7.4,9.4,-2.4,55.0,81.0,76.0,10.0,128.0,Matches,464,fr FRA,FW,23,34,2818.0,83.0,82.4,31.3,32,86.0,26,2,34.0,0,2.24,73.0,33.0,40.0,1.28,-0.07,65.2,42.1,23.0,0.74,-0.29,Matches,395.0,fr FRA,FW,23.0,31.3,1771.0,10.0,46.0,594.0,1149.0,302.0,1766.0,201.0,74.0,36.8,109.0,54.2,1583.0,9810.0,4725.0,165.0,126.0,86.0,63.0,42.0,1575.0,468.0,Matches,395.0,fr FRA,FW,23.0,31.3,29.0,144.0,73.0,50.7,4.6,2.33,0.18,0.36,15.9,1.0,3.0,5.0,26.3,22.2,0.15,2.7,3.8,Matches,395.0,fr FRA,FW,23.0,34.0,32.0,2818.0,31.3,29.0,5.0,34.0,26.0,3.0,5.0,6.0,0.0,26.3,22.2,7.4,29.5,165.0,128.0,468.0,0.93,0.16,1.09,0.83,0.99,0.84,0.23,1.07,0.71,0.94,Matches,Kylian Mbappé,AM/S RL,23,188,197,France,Paris Saint-Germain,13,13,18,17,18,12,7,13,4,4,15,18,4,17,6,17,12,18,14,15,15,15,18,13,18,3,10,10,20,16,15,8,15,20,14,11,15,7,16,7,14,2,2,2,1,1,2,1,3,2,1,2,15,20,8,14,16,16,12,13,1,1,1,1,1,1,1,10,1,10,19,1,17,20,178,73,10,20,347975206,9398,9398,9248,African_Caribbean,172,13,1998/12/20,57,27,1035616.0,,85139014
978,Chancel Mbemba,Marseille,1994,396.0,cd COD,DF,27.0,31.7,43.0,26.0,24.0,17.0,2.0,22.0,31.0,71.0,9.0,25.0,12.0,13.0,42.0,85.0,89.0,0.0,Matches,396.0,cd COD,DF,27.0,31.7,36.0,1.14,32.0,0.0,0.0,3.0,1.0,0.0,1.0,0.03,1.0,0.0,0.0,0.0,0.0,0.0,Matches,,,,,,,,,,,,,,,,,,,,,,,,,,,,,,,,,,,,,,,,,,,,,,,,,,,,,,,,396.0,cd COD,DF,27.0,31.7,2.0,0.0,0.0,19.0,19.0,0.0,40.0,42.0,26.0,1.0,0.0,0.0,165.0,72.0,35.0,67.3,Matches,396.0,cd COD,DF,27.0,31.7,1742.0,1643.0,91.0,45.0,1.0,7.0,40.0,31.0,0.0,0.0,0.0,0.0,1441.0,8.0,23.0,Matches,396.0,cd COD,DF,27.0,31.7,1441.0,1742.0,82.7,26456.0,7943.0,537.0,597.0,89.9,744.0,853.0,87.2,126.0,211.0,59.7,0.0,0.5,1.3,-0.5,5.0,127.0,23.0,6.0,183.0,Matches,465,cd COD,DF,27,36,2849.0,79.0,83.3,31.7,32,86.0,27,4,26.0,1,1.94,55.0,33.0,22.0,0.69,-0.09,52.8,36.3,16.5,0.52,-0.46,Matches,396.0,cd COD,DF,27.0,31.7,2042.0,171.0,669.0,1043.0,339.0,45.0,2042.0,24.0,14.0,58.3,5.0,20.8,1496.0,8249.0,4441.0,47.0,66.0,10.0,24.0,10.0,1374.0,49.0,Matches,396.0,cd COD,DF,27.0,31.7,5.0,27.0,9.0,33.3,0.85,0.28,0.19,0.56,11.0,0.0,0.0,0.0,3.1,3.1,0.11,1.9,1.9,Matches,396.0,cd COD,DF,27.0,36.0,32.0,2849.0,31.7,5.0,0.0,5.0,5.0,0.0,0.0,2.0,0.0,3.1,3.1,0.5,3.5,47.0,183.0,49.0,0.16,0.0,0.16,0.16,0.16,0.1,0.01,0.11,0.1,0.11,Matches,Chancel Mbemba,D RC,27,142,145,"Democratic Republic of Congo,Belgium",Olympique de Marseille,4,9,11,6,12,4,15,10,4,15,12,7,13,12,11,14,16,11,14,11,13,15,10,13,11,12,16,16,15,13,16,13,14,15,15,14,14,8,16,13,14,1,3,1,3,2,1,2,3,2,1,2,14,14,5,9,17,16,13,16,1,10,20,15,1,13,13,1,1,1,1,1,1,1,182,80,12,20,21552434,7100,7100,5650,African_Caribbean,142,17,1994/8/8,66,4,52999.0,,18057323
979,Facundo Medina,Lens,1999,399.0,ar ARG,DF,23.0,30.9,31.0,20.0,16.0,15.0,0.0,13.0,35.0,37.1,22.0,25.0,9.0,16.0,26.0,57.0,62.0,1.0,Matches,399.0,ar ARG,DF,23.0,30.9,46.0,1.49,40.0,2.0,0.0,4.0,0.0,0.0,6.0,0.19,4.0,1.0,0.0,1.0,0.0,0.0,Matches,,,,,,,,,,,,,,,,,,,,,,,,,,,,,,,,,,,,,,,,,,,,,,,,,,,,,,,,399.0,ar ARG,DF,23.0,30.9,7.0,0.0,0.0,34.0,18.0,0.0,22.0,26.0,20.0,0.0,0.0,0.0,212.0,37.0,43.0,46.3,Matches,399.0,ar ARG,DF,23.0,30.9,2506.0,2358.0,144.0,115.0,4.0,20.0,22.0,22.0,0.0,0.0,0.0,0.0,2260.0,4.0,20.0,Matches,399.0,ar ARG,DF,23.0,30.9,2260.0,2506.0,90.2,37270.0,14504.0,1045.0,1099.0,95.1,953.0,1032.0,92.3,162.0,246.0,65.9,4.0,1.8,1.8,2.2,15.0,239.0,17.0,8.0,238.0,Matches,469,ar ARG,DF,23,32,2779.0,87.0,81.3,30.9,32,87.0,27,0,,2,2.19,52.0,25.0,27.0,0.87,-0.81,52.8,33.8,19.0,0.62,0.02,Matches,399.0,ar ARG,DF,23.0,30.9,2728.0,164.0,806.0,1714.0,237.0,23.0,2728.0,38.0,24.0,63.2,9.0,23.7,2278.0,14430.0,8259.0,81.0,63.0,1.0,22.0,21.0,2100.0,30.0,Matches,399.0,ar ARG,DF,23.0,30.9,2.0,18.0,4.0,22.2,0.58,0.13,0.11,0.5,13.9,0.0,0.0,0.0,2.6,2.6,0.14,-0.6,-0.6,Matches,399.0,ar ARG,DF,23.0,32.0,32.0,2779.0,30.9,2.0,4.0,6.0,2.0,0.0,0.0,7.0,0.0,2.6,2.6,1.8,4.3,81.0,238.0,30.0,0.06,0.13,0.19,0.06,0.19,0.08,0.06,0.14,0.08,0.14,Matches,Facundo Medina,D C,23,126,142,Argentina,RC Lens,6,10,12,9,13,8,12,8,14,14,13,8,13,12,14,13,14,11,12,13,12,15,9,12,13,13,13,12,13,12,14,12,13,13,14,14,13,12,11,8,11,2,3,3,3,1,3,1,2,3,1,2,9,12,1,11,12,12,10,10,1,12,20,1,12,1,1,1,1,1,1,1,1,1,184,78,20,8,4905482,6300,6300,3900,Mediterranean_Hispanic,126,8,1999/5/28,2,0,11769.0,,14185869
980,Birger Meling,Rennes,1994,402.0,no NOR,DF,27.0,13.4,24.0,15.0,9.0,12.0,3.0,12.0,25.0,48.0,13.0,18.0,2.0,16.0,23.0,47.0,26.0,0.0,Matches,402.0,no NOR,DF,27.0,13.4,18.0,1.34,16.0,2.0,0.0,0.0,0.0,0.0,3.0,0.22,3.0,0.0,0.0,0.0,0.0,0.0,Matches,,,,,,,,,,,,,,,,,,,,,,,,,,,,,,,,,,,,,,,,,,,,,,,,,,,,,,,,402.0,no NOR,DF,27.0,13.4,3.0,1.0,0.0,20.0,16.0,2.0,18.0,23.0,15.0,0.0,0.0,0.0,71.0,12.0,16.0,42.9,Matches,402.0,no NOR,DF,27.0,13.4,787.0,651.0,133.0,10.0,2.0,2.0,18.0,123.0,0.0,0.0,0.0,0.0,671.0,3.0,16.0,Matches,402.0,no NOR,DF,27.0,13.4,671.0,787.0,85.3,11341.0,3382.0,304.0,345.0,88.1,307.0,345.0,89.0,47.0,65.0,72.3,1.0,0.9,1.8,0.1,7.0,57.0,15.0,4.0,91.0,Matches,472,no NOR,DF,27,27,1209.0,45.0,35.4,13.4,10,85.0,6,17,21.0,4,1.89,25.0,14.0,11.0,0.82,0.05,20.1,14.8,5.3,0.4,-0.09,Matches,402.0,no NOR,DF,27.0,13.4,925.0,37.0,196.0,480.0,253.0,20.0,925.0,22.0,5.0,22.7,15.0,68.2,629.0,4173.0,2046.0,37.0,27.0,4.0,11.0,9.0,566.0,74.0,Matches,402.0,no NOR,DF,27.0,13.4,0.0,0.0,0.0,,0.0,0.0,,,,0.0,0.0,0.0,0.0,0.0,,0.0,0.0,Matches,402.0,no NOR,DF,27.0,27.0,10.0,1209.0,13.4,0.0,1.0,1.0,0.0,0.0,0.0,3.0,1.0,0.0,0.0,0.9,0.9,37.0,91.0,74.0,0.0,0.07,0.07,0.0,0.07,0.0,0.07,0.07,0.0,0.07,Matches,Birger Meling,D/WB L,27,131,135,Norway,Stade Rennais FC,14,13,11,6,12,6,10,8,12,12,13,7,12,12,14,14,13,13,13,11,13,17,8,13,13,13,16,16,14,15,13,9,14,13,15,10,13,6,14,9,13,3,3,2,4,4,1,3,3,2,2,3,18,15,4,12,14,18,16,12,1,20,5,1,19,1,12,15,13,1,14,1,1,1,173,64,20,6,5522380,6550,6550,5250,Northern_European,128,1,1994/12/17,22,0,23014.0,,29126536
981,Nuno Mendes,Paris S-G,2002,403.0,pt POR,DF,20.0,17.2,45.0,30.0,29.0,12.0,4.0,30.0,41.0,73.2,11.0,19.0,3.0,16.0,17.0,62.0,18.0,0.0,Matches,403.0,pt POR,DF,20.0,17.2,45.0,2.62,39.0,0.0,4.0,1.0,0.0,1.0,7.0,0.41,7.0,0.0,0.0,0.0,0.0,0.0,Matches,,,,,,,,,,,,,,,,,,,,,,,,,,,,,,,,,,,,,,,,,,,,,,,,,,,,,,,,403.0,pt POR,DF,20.0,17.2,2.0,0.0,0.0,25.0,34.0,5.0,30.0,17.0,30.0,0.0,0.0,0.0,98.0,10.0,6.0,62.5,Matches,403.0,pt POR,DF,20.0,17.2,932.0,844.0,86.0,12.0,2.0,4.0,30.0,74.0,0.0,0.0,0.0,0.0,793.0,2.0,32.0,Matches,403.0,pt POR,DF,20.0,17.2,793.0,932.0,85.1,11300.0,3442.0,450.0,500.0,90.0,266.0,303.0,87.8,30.0,43.0,69.8,6.0,2.8,3.6,3.2,24.0,56.0,18.0,6.0,77.0,Matches,473,pt POR,DF,20,23,1548.0,67.0,45.3,17.2,18,79.0,8,5,26.0,1,2.52,45.0,16.0,29.0,1.69,0.72,38.0,19.5,18.5,1.08,0.53,Matches,403.0,pt POR,DF,20.0,17.2,1139.0,47.0,242.0,417.0,495.0,58.0,1139.0,66.0,27.0,40.9,34.0,51.5,876.0,4893.0,2466.0,51.0,35.0,19.0,30.0,17.0,794.0,195.0,Matches,403.0,pt POR,DF,20.0,17.2,1.0,10.0,7.0,70.0,0.58,0.41,0.1,0.14,13.7,0.0,0.0,0.0,1.0,1.0,0.1,0.0,0.0,Matches,403.0,pt POR,DF,20.0,23.0,18.0,1548.0,17.2,1.0,6.0,7.0,1.0,0.0,0.0,2.0,0.0,1.0,1.0,2.8,3.9,51.0,77.0,195.0,0.06,0.35,0.41,0.06,0.41,0.06,0.17,0.23,0.06,0.23,Matches,Nuno Mendes,D/WB L,20,149,-9,"Portugal,Cape Verde Islands",Paris Saint-Germain,13,14,14,10,14,7,9,10,11,11,13,9,14,14,12,15,12,13,14,13,13,14,12,8,11,11,12,13,15,14,13,10,16,16,15,13,13,6,15,11,14,2,2,2,1,1,4,2,2,4,1,3,16,15,6,15,17,14,14,15,1,20,13,1,20,1,1,14,1,1,1,1,1,1,176,70,20,12,98592975,7447,7747,5497,African_Caribbean,141,14,2002/6/19,15,0,40102.0,,83261910
982,Thiago Mendes,Lyon,1992,405.0,br BRA,MFDF,30.0,22.9,48.0,27.0,24.0,21.0,3.0,30.0,40.0,75.0,10.0,28.0,8.0,20.0,47.0,95.0,51.0,4.0,Matches,405.0,br BRA,MFDF,30.0,22.9,28.0,1.22,26.0,0.0,0.0,2.0,0.0,0.0,5.0,0.22,5.0,0.0,0.0,0.0,0.0,0.0,Matches,,,,,,,,,,,,,,,,,,,,,,,,,,,,,,,,,,,,,,,,,,,,,,,,,,,,,,,,405.0,br BRA,MFDF,30.0,22.9,3.0,0.0,0.0,24.0,24.0,0.0,6.0,47.0,27.0,0.0,1.0,0.0,145.0,34.0,20.0,63.0,Matches,405.0,br BRA,MFDF,30.0,22.9,1672.0,1610.0,57.0,48.0,6.0,15.0,6.0,8.0,0.0,0.0,0.0,0.0,1445.0,5.0,16.0,Matches,405.0,br BRA,MFDF,30.0,22.9,1445.0,1672.0,86.4,26348.0,9319.0,568.0,619.0,91.8,658.0,709.0,92.8,163.0,263.0,62.0,1.0,0.6,1.8,0.4,10.0,156.0,13.0,0.0,170.0,Matches,475,br BRA,MFDF,30,31,2063.0,67.0,60.3,22.9,22,84.0,14,9,23.0,6,1.55,32.0,25.0,7.0,0.31,-0.42,32.4,29.5,2.9,0.13,-0.32,Matches,405.0,br BRA,MFDF,30.0,22.9,1913.0,112.0,502.0,1225.0,188.0,9.0,1913.0,11.0,6.0,54.5,5.0,45.5,1500.0,7166.0,3378.0,10.0,22.0,2.0,25.0,16.0,1383.0,20.0,Matches,405.0,br BRA,MFDF,30.0,22.9,1.0,14.0,4.0,28.6,0.61,0.17,0.07,0.25,25.1,2.0,0.0,0.0,0.7,0.7,0.05,0.3,0.3,Matches,405.0,br BRA,MFDF,30.0,31.0,22.0,2063.0,22.9,1.0,1.0,2.0,1.0,0.0,0.0,3.0,0.0,0.7,0.7,0.6,1.4,10.0,170.0,20.0,0.04,0.04,0.09,0.04,0.09,0.03,0.03,0.06,0.03,0.06,Matches,Thiago Mendes,D/DM/M C,30,132,144,Brazil,Olympique Lyonnais,11,10,10,5,13,12,12,12,7,14,14,10,14,13,11,15,13,12,9,13,12,12,10,11,8,14,15,13,12,12,14,11,14,12,16,14,11,13,11,7,10,3,3,1,3,2,2,1,2,3,3,3,8,12,9,12,11,11,6,11,1,1,16,1,1,1,20,1,18,1,1,1,1,1,177,75,12,20,8764704,6600,6600,5300,African_Caribbean,131,15,1992/3/15,0,0,65205.0,,19175014
983,Batista Mendy,Angers,2000,408.0,fr FRA,MFDF,22.0,31.8,70.0,30.0,34.0,28.0,8.0,37.0,53.0,69.8,16.0,38.0,6.0,32.0,21.0,91.0,29.0,2.0,Matches,408.0,fr FRA,MFDF,22.0,31.8,40.0,1.26,36.0,0.0,3.0,1.0,0.0,0.0,0.0,0.0,0.0,0.0,0.0,0.0,0.0,0.0,Matches,,,,,,,,,,,,,,,,,,,,,,,,,,,,,,,,,,,,,,,,,,,,,,,,,,,,,,,,408.0,fr FRA,MFDF,22.0,31.8,8.0,1.0,1.0,67.0,42.0,1.0,9.0,21.0,30.0,0.0,1.0,0.0,193.0,27.0,13.0,67.5,Matches,408.0,fr FRA,MFDF,22.0,31.8,1432.0,1399.0,29.0,27.0,4.0,13.0,9.0,2.0,0.0,0.0,0.0,0.0,1234.0,4.0,18.0,Matches,408.0,fr FRA,MFDF,22.0,31.8,1234.0,1432.0,86.2,22322.0,7144.0,471.0,532.0,88.5,608.0,670.0,90.7,112.0,161.0,69.6,0.0,1.2,1.8,-1.2,17.0,159.0,22.0,2.0,195.0,Matches,478,fr FRA,MFDF,22,35,2859.0,82.0,83.6,31.8,35,82.0,22,0,,0,0.51,25.0,71.0,-46.0,-1.45,-1.13,32.9,51.5,-18.6,-0.59,-0.24,Matches,408.0,fr FRA,MFDF,22.0,31.8,1700.0,69.0,414.0,1033.0,277.0,16.0,1700.0,61.0,38.0,62.3,18.0,29.5,1324.0,7161.0,3195.0,27.0,42.0,2.0,24.0,27.0,1201.0,49.0,Matches,408.0,fr FRA,MFDF,22.0,31.8,0.0,15.0,2.0,13.3,0.47,0.06,0.0,0.0,24.0,0.0,0.0,0.0,0.9,0.9,0.06,-0.9,-0.9,Matches,408.0,fr FRA,MFDF,22.0,35.0,35.0,2859.0,31.8,0.0,0.0,0.0,0.0,0.0,0.0,8.0,1.0,0.9,0.9,1.2,2.1,27.0,195.0,49.0,0.0,0.0,0.0,0.0,0.0,0.03,0.04,0.07,0.03,0.07,Matches,Batista Mendy,DM/M C,22,124,147,France,Angers SCO,8,9,12,8,13,8,14,7,4,12,13,6,12,13,7,13,14,12,12,13,12,15,11,9,14,13,13,15,12,13,14,14,13,12,15,14,11,7,11,5,15,2,2,2,2,1,2,2,3,2,3,1,11,13,10,12,10,14,14,11,1,1,14,1,1,1,20,1,18,1,1,1,1,1,191,82,10,20,5539998,6200,6200,3028,North_African__Middle_Eastern,123,14,2000/1/12,0,0,9847.0,,48043868
984,Gideon Mensah,Auxerre,1998,409.0,gh GHA,DF,24.0,25.1,80.0,44.0,43.0,32.0,5.0,44.0,77.0,57.1,33.0,33.0,10.0,23.0,38.0,118.0,41.0,0.0,Matches,409.0,gh GHA,DF,24.0,25.1,50.0,1.99,42.0,4.0,0.0,1.0,1.0,2.0,0.0,0.0,0.0,0.0,0.0,0.0,0.0,0.0,Matches,,,,,,,,,,,,,,,,,,,,,,,,,,,,,,,,,,,,,,,,,,,,,,,,,,,,,,,,409.0,gh GHA,DF,24.0,25.1,5.0,0.0,0.0,29.0,18.0,1.0,67.0,38.0,44.0,0.0,1.0,0.0,246.0,21.0,20.0,51.2,Matches,409.0,gh GHA,DF,24.0,25.1,1457.0,1192.0,260.0,25.0,2.0,8.0,67.0,235.0,0.0,0.0,0.0,0.0,1126.0,5.0,40.0,Matches,409.0,gh GHA,DF,24.0,25.1,1126.0,1457.0,77.3,19117.0,7266.0,558.0,635.0,87.9,454.0,558.0,81.4,89.0,193.0,46.1,0.0,2.1,2.1,-2.1,25.0,97.0,20.0,12.0,116.0,Matches,479,gh GHA,DF,24,26,2262.0,87.0,66.1,25.1,26,87.0,24,0,,2,0.77,18.0,45.0,-27.0,-1.07,-1.0,30.1,38.5,-8.4,-0.33,0.24,Matches,409.0,gh GHA,DF,24.0,25.1,1734.0,90.0,531.0,852.0,384.0,9.0,1734.0,59.0,26.0,44.1,28.0,47.5,1140.0,7390.0,3334.0,56.0,63.0,1.0,44.0,13.0,945.0,110.0,Matches,409.0,gh GHA,DF,24.0,25.1,0.0,5.0,1.0,20.0,0.2,0.04,0.0,0.0,25.3,0.0,0.0,0.0,0.1,0.1,0.01,-0.1,-0.1,Matches,409.0,gh GHA,DF,24.0,26.0,26.0,2262.0,25.1,0.0,0.0,0.0,0.0,0.0,0.0,5.0,0.0,0.1,0.1,2.1,2.1,56.0,116.0,110.0,0.0,0.0,0.0,0.0,0.0,0.0,0.08,0.09,0.0,0.09,Matches,Gideon Mensah,D L,24,123,135,Ghana,AJ Auxerre,9,9,13,4,12,9,11,8,7,12,12,8,14,12,12,13,13,12,13,12,11,12,13,8,10,9,13,15,16,15,8,10,12,17,13,12,13,7,10,7,3,4,1,2,2,3,1,2,2,4,2,2,12,11,6,10,11,13,12,13,1,20,1,1,15,1,1,1,1,1,1,1,1,1,178,64,20,9,2329883,6150,6150,4700,African_Caribbean,123,15,1998/7/18,11,0,6730.0,,16199712
985,Quentin Merlin,Nantes,2002,410.0,fr FRA,DF,20.0,19.9,31.0,19.0,19.0,8.0,4.0,18.0,38.0,47.4,20.0,27.0,4.0,23.0,24.0,55.0,30.0,0.0,Matches,410.0,fr FRA,DF,20.0,19.9,58.0,2.92,33.0,17.0,3.0,3.0,2.0,0.0,3.0,0.15,2.0,1.0,0.0,0.0,0.0,0.0,Matches,,,,,,,,,,,,,,,,,,,,,,,,,,,,,,,,,,,,,,,,,,,,,,,,,,,,,,,,410.0,fr FRA,DF,20.0,19.9,2.0,0.0,0.0,12.0,14.0,0.0,113.0,24.0,19.0,0.0,0.0,0.0,112.0,16.0,15.0,51.6,Matches,410.0,fr FRA,DF,20.0,19.9,1169.0,941.0,227.0,26.0,1.0,12.0,113.0,159.0,41.0,5.0,27.0,0.0,857.0,1.0,25.0,Matches,410.0,fr FRA,DF,20.0,19.9,857.0,1169.0,73.3,16268.0,5919.0,345.0,409.0,84.4,382.0,495.0,77.2,111.0,221.0,50.2,2.0,3.3,3.3,-1.3,34.0,73.0,23.0,13.0,94.0,Matches,480,fr FRA,DF,20,24,1791.0,75.0,52.4,19.9,22,81.0,8,2,10.0,1,0.96,19.0,28.0,-9.0,-0.45,0.04,24.3,26.7,-2.3,-0.12,0.29,Matches,410.0,fr FRA,DF,20.0,19.9,1356.0,54.0,326.0,664.0,387.0,16.0,1356.0,39.0,22.0,56.4,14.0,35.9,886.0,5051.0,2457.0,43.0,40.0,7.0,25.0,10.0,793.0,96.0,Matches,410.0,fr FRA,DF,20.0,19.9,1.0,15.0,4.0,26.7,0.75,0.2,0.07,0.25,22.8,1.0,0.0,0.0,0.8,0.8,0.05,0.2,0.2,Matches,410.0,fr FRA,DF,20.0,24.0,22.0,1791.0,19.9,1.0,2.0,3.0,1.0,0.0,0.0,2.0,0.0,0.8,0.8,3.3,4.1,43.0,94.0,96.0,0.05,0.1,0.15,0.05,0.15,0.04,0.16,0.2,0.04,0.2,Matches,Quentin Merlin,D/WB/M/AM L,20,123,-8,France,FC Nantes,15,15,12,11,13,11,8,13,6,12,13,11,11,13,8,12,12,13,12,13,11,15,11,10,11,11,12,12,12,12,11,8,11,12,13,10,13,7,10,5,12,3,2,3,3,2,2,3,1,1,1,1,12,12,10,13,13,14,13,10,1,20,1,1,19,1,1,18,13,1,17,13,1,12,174,64,20,9,56265190,6142,6142,2242,Northern_European,111,4,2002/5/16,0,0,9367.0,,49048372
986,Lionel Messi,Paris S-G,1987,411.0,ar ARG,FWMF,35.0,31.5,26.0,18.0,1.0,13.0,12.0,11.0,27.0,40.7,16.0,11.0,0.0,11.0,2.0,28.0,0.0,0.0,Matches,411.0,ar ARG,FWMF,35.0,31.5,197.0,6.25,128.0,30.0,18.0,10.0,9.0,2.0,35.0,1.11,27.0,2.0,3.0,1.0,2.0,0.0,Matches,,,,,,,,,,,,,,,,,,,,,,,,,,,,,,,,,,,,,,,,,,,,,,,,,,,,,,,,411.0,ar ARG,FWMF,35.0,31.5,0.0,0.0,0.0,8.0,36.0,6.0,91.0,2.0,18.0,0.0,0.0,0.0,75.0,1.0,3.0,25.0,Matches,411.0,ar ARG,FWMF,35.0,31.5,2050.0,1867.0,157.0,38.0,58.0,11.0,91.0,2.0,96.0,33.0,37.0,0.0,1641.0,26.0,63.0,Matches,411.0,ar ARG,FWMF,35.0,31.5,1641.0,2050.0,80.0,25475.0,8767.0,908.0,1034.0,87.8,495.0,597.0,82.9,154.0,235.0,65.5,16.0,13.4,16.2,2.6,93.0,223.0,120.0,2.0,300.0,Matches,481,ar ARG,FWMF,35,32,2837.0,89.0,83.0,31.5,32,89.0,27,0,,0,2.34,77.0,31.0,46.0,1.46,1.0,64.7,38.9,25.9,0.82,0.19,Matches,411.0,ar ARG,FWMF,35.0,31.5,2401.0,5.0,98.0,1201.0,1132.0,159.0,2401.0,184.0,102.0,55.4,71.0,38.6,2053.0,11482.0,5063.0,114.0,126.0,42.0,52.0,77.0,2042.0,220.0,Matches,411.0,ar ARG,FWMF,35.0,31.5,16.0,129.0,55.0,42.6,4.09,1.74,0.12,0.29,18.3,20.0,0.0,0.0,15.5,15.5,0.12,0.5,0.5,Matches,411.0,ar ARG,FWMF,35.0,32.0,32.0,2837.0,31.5,16.0,16.0,32.0,16.0,0.0,0.0,0.0,0.0,15.5,15.5,13.4,28.9,114.0,300.0,220.0,0.51,0.51,1.02,0.51,1.02,0.49,0.43,0.92,0.49,0.92,Matches,Lionel Messi,AM/S RC,35,180,200,"Argentina,Spain",Paris Saint-Germain,15,15,20,17,19,18,10,16,4,4,19,17,7,20,7,17,10,16,11,20,18,20,20,14,13,5,12,7,15,15,18,6,14,15,12,9,16,9,18,6,12,2,2,3,2,2,2,2,1,3,1,3,17,18,5,17,19,17,15,14,1,1,1,1,1,1,1,8,12,8,11,19,20,19,169,67,20,12,43973205,9374,9359,9267,Mediterranean_Hispanic,172,3,1987/6/24,162,86,776712.0,,7458500
987,Terem Moffi,Nice,1999,415.0,ng NGA,FW,23.0,14.8,12.0,6.0,0.0,6.0,6.0,2.0,12.0,16.7,10.0,3.0,0.0,3.0,2.0,14.0,5.0,0.0,Matches,415.0,ng NGA,FW,23.0,14.8,51.0,3.46,37.0,0.0,6.0,6.0,1.0,1.0,4.0,0.27,3.0,0.0,1.0,0.0,0.0,0.0,Matches,,,,,,,,,,,,,,,,,,,,,,,,,,,,,,,,,,,,,,,,,,,,,,,,,,,,,,,,415.0,ng NGA,FW,23.0,14.8,2.0,0.0,0.0,13.0,10.0,5.0,1.0,2.0,6.0,0.0,0.0,0.0,28.0,19.0,27.0,41.3,Matches,415.0,ng NGA,FW,23.0,14.8,232.0,198.0,32.0,1.0,2.0,1.0,1.0,0.0,0.0,0.0,0.0,0.0,186.0,2.0,6.0,Matches,415.0,ng NGA,FW,23.0,14.8,186.0,232.0,80.2,2484.0,375.0,111.0,134.0,82.8,58.0,65.0,89.2,4.0,5.0,80.0,3.0,2.9,1.1,0.1,27.0,7.0,7.0,1.0,20.0,Matches,486,ng NGA,FW,23,16,1328.0,83.0,38.8,14.8,15,86.0,9,1,45.0,0,1.63,22.0,15.0,7.0,0.47,0.3,24.9,19.0,5.9,0.4,0.11,Matches,415.0,ng NGA,FW,23.0,14.8,355.0,5.0,16.0,147.0,204.0,73.0,355.0,42.0,25.0,59.5,14.0,33.3,234.0,1552.0,632.0,25.0,15.0,14.0,25.0,20.0,240.0,77.0,Matches,415.0,ng NGA,FW,23.0,14.8,6.0,44.0,18.0,40.9,2.98,1.22,0.14,0.33,14.9,0.0,0.0,0.0,8.3,8.3,0.19,-2.3,-2.3,Matches,415.0,ng NGA,FW,23.0,16.0,15.0,1328.0,14.8,6.0,3.0,9.0,6.0,0.0,0.0,2.0,0.0,8.3,8.3,2.9,11.1,25.0,20.0,77.0,0.41,0.2,0.61,0.41,0.61,0.56,0.19,0.75,0.56,0.75,Matches,Terem Moffi,S,23,133,150,Nigeria,FC Lorient,7,8,13,13,12,9,13,9,7,8,12,13,8,13,12,13,14,12,12,12,11,13,12,7,13,10,12,13,16,13,16,14,14,15,13,17,13,12,14,7,10,1,1,1,4,1,2,2,1,4,2,3,13,12,7,12,11,14,14,18,1,1,1,1,1,1,1,1,1,1,1,1,1,20,188,89,20,8,7346217,6650,6400,4272,African_Caribbean,132,14,1999/5/25,7,2,18801.0,,47079007
988,Mostafa Mohamed,Nantes,1997,417.0,eg EGY,FW,24.0,21.5,18.0,13.0,5.0,7.0,6.0,9.0,20.0,45.0,11.0,23.0,1.0,22.0,10.0,28.0,33.0,0.0,Matches,417.0,eg EGY,FW,24.0,21.5,37.0,1.72,22.0,0.0,3.0,8.0,4.0,0.0,6.0,0.28,4.0,0.0,0.0,1.0,1.0,0.0,Matches,,,,,,,,,,,,,,,,,,,,,,,,,,,,,,,,,,,,,,,,,,,,,,,,,,,,,,,,417.0,eg EGY,FW,24.0,21.5,1.0,0.0,0.0,43.0,28.0,13.0,10.0,10.0,13.0,1.0,0.0,0.0,48.0,76.0,87.0,46.6,Matches,417.0,eg EGY,FW,24.0,21.5,351.0,328.0,23.0,0.0,1.0,1.0,10.0,1.0,0.0,0.0,0.0,0.0,215.0,0.0,20.0,Matches,417.0,eg EGY,FW,24.0,21.5,215.0,351.0,61.3,3003.0,648.0,116.0,183.0,63.4,65.0,95.0,68.4,15.0,24.0,62.5,2.0,1.7,1.1,0.3,15.0,17.0,5.0,1.0,22.0,Matches,488,eg EGY,FW,24,36,1939.0,54.0,56.7,21.5,18,77.0,6,18,31.0,1,0.89,27.0,33.0,-6.0,-0.28,0.45,24.6,32.7,-8.1,-0.38,-0.28,Matches,417.0,eg EGY,FW,24.0,21.5,607.0,37.0,64.0,259.0,288.0,107.0,607.0,39.0,21.0,53.8,15.0,38.5,355.0,1972.0,552.0,13.0,13.0,11.0,53.0,23.0,408.0,109.0,Matches,417.0,eg EGY,FW,24.0,21.5,8.0,58.0,24.0,41.4,2.69,1.11,0.14,0.33,14.2,0.0,0.0,0.0,7.3,7.3,0.13,0.7,0.7,Matches,417.0,eg EGY,FW,24.0,36.0,18.0,1939.0,21.5,8.0,2.0,10.0,8.0,0.0,0.0,1.0,0.0,7.3,7.3,1.7,9.0,13.0,22.0,109.0,0.37,0.09,0.46,0.37,0.46,0.34,0.08,0.42,0.34,0.42,Matches,Mostafa Mohamed,S,24,125,140,Egypt,Galatasaray A.Ş.,6,8,9,14,11,7,16,12,8,6,11,13,6,11,12,14,16,14,10,10,10,12,10,7,11,8,12,14,12,13,16,15,18,13,11,16,12,6,14,5,6,3,2,4,3,1,1,2,1,3,1,3,4,15,4,8,6,8,14,13,1,1,1,1,1,1,1,1,1,1,1,1,1,20,185,80,11,20,5055540,6346,5996,5246,North_African__Middle_Eastern,122,8,1997/11/28,21,4,24236.0,FC Nantes,13231887
989,Florent Mollet,Nantes,1991,418.0,fr FRA,MF,30.0,12.1,14.0,6.0,5.0,4.0,5.0,7.0,24.0,29.2,17.0,12.0,1.0,11.0,10.0,24.0,11.0,0.0,Matches,418.0,fr FRA,MF,30.0,12.1,49.0,4.05,26.0,13.0,1.0,4.0,5.0,0.0,3.0,0.25,2.0,1.0,0.0,0.0,0.0,0.0,Matches,,,,,,,,,,,,,,,,,,,,,,,,,,,,,,,,,,,,,,,,,,,,,,,,,,,,,,,,418.0,fr FRA,MF,30.0,12.1,3.0,0.0,0.0,18.0,20.0,3.0,76.0,10.0,6.0,0.0,0.0,0.0,57.0,8.0,16.0,33.3,Matches,418.0,fr FRA,MF,30.0,12.1,565.0,473.0,88.0,19.0,0.0,2.0,76.0,4.0,50.0,24.0,22.0,0.0,444.0,4.0,13.0,Matches,418.0,fr FRA,MF,30.0,12.1,444.0,565.0,78.6,7342.0,2315.0,201.0,225.0,89.3,178.0,210.0,84.8,43.0,90.0,47.8,2.0,2.8,2.2,-0.8,23.0,41.0,11.0,4.0,73.0,Matches,489,fr FRA,MF,30,19,1089.0,57.0,31.8,12.1,11,79.0,5,8,28.0,0,0.79,9.0,21.0,-12.0,-0.99,-0.76,12.5,16.9,-4.4,-0.36,-0.16,Matches,418.0,fr FRA,MF,30.0,12.1,690.0,14.0,100.0,345.0,251.0,20.0,690.0,27.0,10.0,37.0,13.0,48.1,484.0,2836.0,1151.0,25.0,11.0,2.0,19.0,13.0,449.0,67.0,Matches,418.0,fr FRA,MF,30.0,12.1,1.0,22.0,9.0,40.9,1.82,0.74,0.05,0.11,23.2,5.0,0.0,0.0,1.2,1.2,0.06,-0.2,-0.2,Matches,418.0,fr FRA,MF,30.0,19.0,11.0,1089.0,12.1,1.0,2.0,3.0,1.0,0.0,0.0,3.0,0.0,1.2,1.2,2.8,4.0,25.0,73.0,67.0,0.08,0.17,0.25,0.08,0.25,0.1,0.23,0.33,0.1,0.33,Matches,Florent Mollet,M/AM RLC,30,126,135,France,FC Schalke 04,15,14,11,12,14,16,7,16,6,8,14,12,9,14,13,12,11,14,11,14,13,13,13,8,13,9,12,11,12,12,13,6,14,12,13,9,10,13,13,6,12,2,3,3,2,1,1,2,2,2,3,2,6,12,13,14,12,15,13,8,1,1,1,1,1,1,1,12,16,15,15,20,18,10,170,67,13,20,1600872,6300,6600,4800,Northern_European,126,5,1991/11/19,0,0,25889.0,,85084448
990,Steve Mounié,Brest,1994,421.0,bj BEN,FW,27.0,18.4,13.0,5.0,1.0,7.0,5.0,5.0,14.0,35.7,9.0,18.0,7.0,11.0,3.0,16.0,20.0,0.0,Matches,421.0,bj BEN,FW,27.0,18.4,37.0,2.01,24.0,0.0,0.0,10.0,1.0,2.0,4.0,0.22,2.0,0.0,0.0,2.0,0.0,0.0,Matches,,,,,,,,,,,,,,,,,,,,,,,,,,,,,,,,,,,,,,,,,,,,,,,,,,,,,,,,421.0,bj BEN,FW,27.0,18.4,2.0,0.0,0.0,37.0,25.0,10.0,9.0,3.0,5.0,0.0,0.0,0.0,49.0,151.0,105.0,59.0,Matches,421.0,bj BEN,FW,27.0,18.4,458.0,454.0,2.0,0.0,0.0,1.0,9.0,2.0,0.0,0.0,0.0,0.0,253.0,2.0,14.0,Matches,421.0,bj BEN,FW,27.0,18.4,253.0,458.0,55.2,3503.0,841.0,139.0,238.0,58.4,89.0,147.0,60.5,5.0,15.0,33.3,0.0,0.8,1.3,-0.8,13.0,26.0,3.0,0.0,32.0,Matches,493,bj BEN,FW,27,23,1655.0,72.0,48.4,18.4,20,79.0,10,3,22.0,1,1.48,26.0,18.0,8.0,0.44,1.35,23.1,24.5,-1.3,-0.07,0.51,Matches,421.0,bj BEN,FW,27.0,18.4,675.0,29.0,67.0,325.0,290.0,95.0,674.0,21.0,10.0,47.6,9.0,42.9,414.0,2224.0,716.0,23.0,9.0,9.0,54.0,28.0,532.0,89.0,Matches,421.0,bj BEN,FW,27.0,18.4,6.0,58.0,19.0,32.8,3.15,1.03,0.09,0.26,14.9,0.0,1.0,1.0,7.3,6.5,0.12,-1.3,-1.5,Matches,421.0,bj BEN,FW,27.0,23.0,20.0,1655.0,18.4,6.0,0.0,6.0,5.0,1.0,1.0,2.0,0.0,7.3,6.5,0.8,7.3,23.0,32.0,89.0,0.33,0.0,0.33,0.27,0.27,0.4,0.04,0.44,0.35,0.4,Matches,Steve Mounié,S,27,124,141,"Benin,France",Stade Brestois 29,8,7,11,12,13,6,17,11,5,8,12,12,7,12,9,12,13,12,12,12,11,11,11,11,12,12,11,13,12,13,14,17,12,12,13,16,12,8,10,8,8,2,3,2,4,3,3,1,2,2,3,3,12,15,7,14,11,14,13,12,1,1,1,1,1,1,1,1,1,1,10,1,1,20,190,83,8,20,2761244,6200,6200,4500,African_Caribbean,123,13,1994/9/29,42,13,9693.0,,36514846
991,Samuel Moutoussamy,Nantes,1996,423.0,cd COD,MF,25.0,26.7,64.0,34.0,27.0,28.0,9.0,26.0,76.0,34.2,50.0,23.0,2.0,21.0,24.0,88.0,15.0,0.0,Matches,423.0,cd COD,MF,25.0,26.7,52.0,1.95,46.0,0.0,2.0,0.0,2.0,2.0,5.0,0.19,4.0,0.0,0.0,0.0,1.0,0.0,Matches,,,,,,,,,,,,,,,,,,,,,,,,,,,,,,,,,,,,,,,,,,,,,,,,,,,,,,,,423.0,cd COD,MF,25.0,26.7,8.0,0.0,0.0,33.0,15.0,0.0,9.0,24.0,34.0,0.0,0.0,0.0,167.0,21.0,45.0,31.8,Matches,423.0,cd COD,MF,25.0,26.7,1226.0,1206.0,17.0,14.0,2.0,10.0,9.0,3.0,0.0,0.0,0.0,0.0,1053.0,3.0,24.0,Matches,423.0,cd COD,MF,25.0,26.7,1053.0,1226.0,85.9,17981.0,5126.0,457.0,509.0,89.8,456.0,506.0,90.1,94.0,130.0,72.3,2.0,1.0,1.6,1.0,18.0,124.0,13.0,1.0,156.0,Matches,495,cd COD,MF,25,35,2399.0,69.0,70.1,26.7,27,83.0,17,8,21.0,0,1.0,25.0,39.0,-14.0,-0.53,-0.17,29.3,36.6,-7.3,-0.27,-0.06,Matches,423.0,cd COD,MF,25.0,26.7,1459.0,43.0,275.0,950.0,254.0,33.0,1459.0,29.0,16.0,55.2,11.0,37.9,1079.0,5649.0,2735.0,41.0,29.0,4.0,24.0,19.0,967.0,45.0,Matches,423.0,cd COD,MF,25.0,26.7,0.0,22.0,5.0,22.7,0.83,0.19,0.0,0.0,16.8,0.0,0.0,0.0,1.7,1.7,0.08,-1.7,-1.7,Matches,423.0,cd COD,MF,25.0,35.0,27.0,2399.0,26.7,0.0,2.0,2.0,0.0,0.0,0.0,8.0,0.0,1.7,1.7,1.0,2.7,41.0,156.0,45.0,0.0,0.08,0.08,0.0,0.08,0.07,0.04,0.1,0.07,0.1,Matches,Samuel Moutoussamy,M C,25,124,127,"Democratic Republic of Congo,France,Réunion",FC Nantes,5,10,12,7,13,6,11,9,5,13,13,7,12,12,11,13,13,12,11,13,12,13,9,10,15,13,15,15,12,13,15,11,15,12,15,13,13,11,10,6,13,1,3,3,2,1,3,2,3,3,1,3,11,13,8,13,10,14,14,12,1,13,1,1,7,1,15,13,20,13,13,1,13,1,176,72,20,10,2951078,6200,6200,3002,African_Caribbean,123,14,1996/8/12,15,0,10228.0,,85125689
992,Nordi Mukiele,Paris S-G,1997,425.0,fr FRA,DF,24.0,12.6,31.0,23.0,16.0,6.0,9.0,19.0,29.0,65.5,10.0,22.0,9.0,13.0,14.0,45.0,16.0,0.0,Matches,425.0,fr FRA,DF,24.0,12.6,20.0,1.58,16.0,0.0,1.0,2.0,1.0,0.0,5.0,0.4,4.0,0.0,0.0,1.0,0.0,0.0,Matches,,,,,,,,,,,,,,,,,,,,,,,,,,,,,,,,,,,,,,,,,,,,,,,,,,,,,,,,425.0,fr FRA,DF,24.0,12.6,0.0,0.0,0.0,16.0,14.0,2.0,16.0,14.0,23.0,0.0,0.0,0.0,61.0,21.0,10.0,67.7,Matches,425.0,fr FRA,DF,24.0,12.6,674.0,609.0,63.0,9.0,0.0,2.0,16.0,54.0,0.0,0.0,0.0,0.0,585.0,2.0,11.0,Matches,425.0,fr FRA,DF,24.0,12.6,585.0,674.0,86.8,8570.0,2494.0,320.0,342.0,93.6,220.0,253.0,87.0,19.0,29.0,65.5,3.0,2.1,1.4,0.9,10.0,17.0,9.0,2.0,26.0,Matches,498,fr FRA,DF,24,19,1137.0,60.0,33.2,12.6,12,83.0,9,7,20.0,2,2.47,33.0,11.0,22.0,1.74,0.68,24.9,12.7,12.2,0.96,0.26,Matches,425.0,fr FRA,DF,24.0,12.6,801.0,50.0,236.0,387.0,189.0,29.0,801.0,24.0,6.0,25.0,12.0,50.0,588.0,3067.0,1363.0,19.0,10.0,3.0,12.0,12.0,548.0,57.0,Matches,425.0,fr FRA,DF,24.0,12.6,0.0,11.0,2.0,18.2,0.87,0.16,0.0,0.0,11.6,0.0,0.0,0.0,1.0,1.0,0.09,-1.0,-1.0,Matches,425.0,fr FRA,DF,24.0,19.0,12.0,1137.0,12.6,0.0,3.0,3.0,0.0,0.0,0.0,0.0,0.0,1.0,1.0,2.1,3.1,19.0,26.0,57.0,0.0,0.24,0.24,0.0,0.24,0.08,0.17,0.25,0.08,0.25,Matches,Nordi Mukiele,D/WB RC,24,140,152,"France,Democratic Republic of Congo",Paris Saint-Germain,7,12,12,6,11,6,13,6,13,14,13,9,15,13,13,15,17,13,11,12,11,15,8,9,8,12,15,14,14,13,15,15,16,16,15,14,13,7,15,4,15,3,3,2,3,3,1,3,2,2,3,2,11,17,6,12,12,10,14,14,1,1,20,18,1,18,10,1,10,14,1,1,1,1,187,84,10,20,9962507,7000,6400,5750,African_Caribbean,137,14,1997/11/1,1,0,57533.0,,48034615
993,Marshall Munetsi,Reims,1996,426.0,zw ZIM,MF,26.0,30.0,58.0,27.0,13.0,31.0,14.0,20.0,48.0,41.7,28.0,37.0,11.0,26.0,26.0,84.0,41.0,1.0,Matches,426.0,zw ZIM,MF,26.0,30.0,75.0,2.5,60.0,0.0,3.0,5.0,6.0,1.0,5.0,0.17,3.0,0.0,1.0,0.0,1.0,0.0,Matches,,,,,,,,,,,,,,,,,,,,,,,,,,,,,,,,,,,,,,,,,,,,,,,,,,,,,,,,426.0,zw ZIM,MF,26.0,30.0,6.0,0.0,0.0,64.0,38.0,2.0,23.0,26.0,27.0,1.0,0.0,0.0,157.0,58.0,49.0,54.2,Matches,426.0,zw ZIM,MF,26.0,30.0,886.0,878.0,6.0,6.0,4.0,5.0,23.0,0.0,0.0,0.0,0.0,0.0,651.0,2.0,27.0,Matches,426.0,zw ZIM,MF,26.0,30.0,651.0,886.0,73.5,10519.0,3417.0,306.0,394.0,77.7,248.0,313.0,79.2,56.0,109.0,51.4,3.0,3.1,2.1,-0.1,31.0,71.0,11.0,2.0,95.0,Matches,499,zw ZIM,MF,26,34,2700.0,79.0,78.9,30.0,31,84.0,21,3,31.0,0,1.32,35.0,39.0,-4.0,-0.13,-0.63,46.3,43.3,3.1,0.1,-0.62,Matches,426.0,zw ZIM,MF,26.0,30.0,1243.0,73.0,256.0,642.0,364.0,94.0,1243.0,44.0,20.0,45.5,18.0,40.9,818.0,4165.0,1792.0,33.0,17.0,9.0,53.0,16.0,732.0,87.0,Matches,426.0,zw ZIM,MF,26.0,30.0,7.0,68.0,23.0,33.8,2.27,0.77,0.1,0.3,16.1,0.0,0.0,0.0,9.4,9.4,0.14,-2.4,-2.4,Matches,426.0,zw ZIM,MF,26.0,34.0,31.0,2700.0,30.0,7.0,3.0,10.0,7.0,0.0,0.0,6.0,0.0,9.4,9.4,3.1,12.5,33.0,95.0,87.0,0.23,0.1,0.33,0.23,0.33,0.31,0.1,0.42,0.31,0.42,Matches,Marshall Munetsi,DM C,26,120,127,Zimbabwe,Stade de Reims,6,8,12,10,14,8,9,11,8,12,13,10,13,13,12,12,13,11,11,11,12,4,11,11,12,12,12,14,12,11,12,12,11,11,15,15,10,11,11,11,11,1,3,2,2,1,2,3,2,2,4,2,14,11,2,9,12,11,11,17,1,1,10,1,1,1,20,1,15,1,1,1,1,1,187,83,11,20,1432639,5996,5996,2996,African_Caribbean,120,13,1996/6/22,22,1,6547.0,,13167102
994,Yvon Mvogo,Lorient,1994,427.0,ch SUI,GK,28.0,20.1,0.0,0.0,0.0,0.0,0.0,0.0,0.0,,0.0,0.0,0.0,0.0,2.0,2.0,6.0,3.0,Matches,427.0,ch SUI,GK,28.0,20.1,0.0,0.0,0.0,0.0,0.0,0.0,0.0,0.0,0.0,0.0,0.0,0.0,0.0,0.0,0.0,0.0,Matches,31.0,ch SUI,GK,28.0,20.1,29.0,1.0,0.0,4.0,1.0,27.1,0.27,-0.9,-0.04,86.0,228.0,37.7,473.0,85.0,34.0,32.1,145.0,46.2,36.6,381.0,21.0,5.5,7.0,0.35,8.5,Matches,31.0,ch SUI,GK,28.0,21.0,21.0,1812.0,20.1,29.0,1.44,98.0,70.0,71.4,11.0,4.0,6.0,3.0,14.3,1.0,1.0,0.0,0.0,0.0,Matches,427.0,ch SUI,GK,28.0,20.1,0.0,0.0,0.0,0.0,3.0,0.0,0.0,2.0,0.0,0.0,0.0,0.0,13.0,5.0,0.0,100.0,Matches,427.0,ch SUI,GK,28.0,20.1,622.0,417.0,201.0,56.0,0.0,2.0,0.0,0.0,0.0,0.0,0.0,0.0,466.0,4.0,1.0,Matches,427.0,ch SUI,GK,28.0,20.1,466.0,622.0,74.9,12098.0,8637.0,114.0,114.0,100.0,211.0,211.0,100.0,136.0,287.0,47.4,0.0,0.0,0.0,0.0,0.0,5.0,0.0,0.0,0.0,Matches,500,ch SUI,GK,28,21,1812.0,86.0,53.0,20.1,21,86.0,20,0,,1,1.76,33.0,29.0,4.0,0.2,0.48,26.9,29.5,-2.6,-0.13,0.49,Matches,427.0,ch SUI,GK,28.0,20.1,661.0,601.0,659.0,2.0,0.0,0.0,661.0,1.0,1.0,100.0,0.0,0.0,451.0,2490.0,1670.0,0.0,0.0,0.0,1.0,0.0,274.0,0.0,Matches,427.0,ch SUI,GK,28.0,20.1,0.0,0.0,0.0,,0.0,0.0,,,,0.0,0.0,0.0,0.0,0.0,,0.0,0.0,Matches,427.0,ch SUI,GK,28.0,21.0,21.0,1812.0,20.1,0.0,0.0,0.0,0.0,0.0,0.0,0.0,0.0,0.0,0.0,0.0,0.0,0.0,0.0,0.0,0.0,0.0,0.0,0.0,0.0,0.0,0.0,0.0,0.0,0.0,Matches,Yvon Mvogo,GK,28,127,134,"Switzerland,Cameroon",FC Lorient,2,1,1,2,10,5,7,2,2,1,8,2,3,10,12,15,16,13,8,9,9,13,12,13,2,8,13,12,14,16,13,15,14,13,12,15,13,6,11,5,9,15,10,11,15,12,16,14,15,18,12,13,12,17,6,13,10,16,12,10,20,1,1,1,1,1,1,1,1,1,1,1,1,1,189,90,7,20,2860311,6331,6331,5231,African_Caribbean,127,16,1994/6/6,4,0,13846.0,,98010645
995,Neymar,Paris S-G,1992,431.0,br BRA,MFFW,30.0,17.2,22.0,14.0,6.0,9.0,7.0,9.0,19.0,47.4,10.0,7.0,1.0,6.0,4.0,26.0,1.0,1.0,Matches,431.0,br BRA,MFFW,30.0,17.2,105.0,6.11,75.0,12.0,2.0,6.0,10.0,0.0,16.0,0.93,11.0,3.0,0.0,1.0,1.0,0.0,Matches,,,,,,,,,,,,,,,,,,,,,,,,,,,,,,,,,,,,,,,,,,,,,,,,,,,,,,,,431.0,br BRA,MFFW,30.0,17.2,6.0,1.0,1.0,25.0,65.0,5.0,54.0,4.0,14.0,1.0,0.0,0.0,63.0,1.0,2.0,33.3,Matches,431.0,br BRA,MFFW,30.0,17.2,1262.0,1147.0,106.0,33.0,25.0,8.0,54.0,12.0,52.0,26.0,8.0,0.0,1011.0,9.0,27.0,Matches,431.0,br BRA,MFFW,30.0,17.2,1011.0,1262.0,80.1,14702.0,5435.0,568.0,659.0,86.2,297.0,359.0,82.7,71.0,124.0,57.3,11.0,8.8,7.4,2.2,49.0,135.0,48.0,2.0,161.0,Matches,512,br BRA,MFFW,30,20,1545.0,77.0,45.2,17.2,18,82.0,9,2,31.0,0,2.4,42.0,14.0,28.0,1.63,0.62,36.0,20.4,15.5,0.9,0.21,Matches,431.0,br BRA,MFFW,30.0,17.2,1470.0,3.0,124.0,774.0,591.0,73.0,1468.0,96.0,38.0,39.6,46.0,47.9,1289.0,7565.0,3392.0,69.0,77.0,12.0,50.0,37.0,1260.0,127.0,Matches,431.0,br BRA,MFFW,30.0,17.2,13.0,36.0,18.0,50.0,2.1,1.05,0.31,0.61,16.8,6.0,2.0,2.0,8.1,6.5,0.18,4.9,4.5,Matches,431.0,br BRA,MFFW,30.0,20.0,18.0,1545.0,17.2,13.0,11.0,24.0,11.0,2.0,2.0,6.0,1.0,8.1,6.5,8.8,15.3,69.0,161.0,127.0,0.76,0.64,1.4,0.64,1.28,0.47,0.51,0.98,0.38,0.89,Matches,Neymar,M/AM LC,30,177,190,Brazil,Paris Saint-Germain,16,16,20,16,18,17,8,15,4,4,17,20,5,20,10,15,14,17,10,17,14,16,20,14,16,4,8,9,15,16,14,6,14,15,13,11,12,12,15,12,12,1,1,1,1,2,2,3,1,1,3,2,16,19,12,11,14,13,6,8,1,1,1,1,1,1,1,18,1,12,20,18,14,15,175,68,14,20,347975206,9000,9104,8750,Mixed_Race,169,11,1992/2/5,119,74,939648.0,,19024412
996,Ibrahima Niane,Angers,1999,432.0,sn SEN,FW,23.0,12.6,6.0,2.0,1.0,4.0,1.0,1.0,6.0,16.7,5.0,8.0,2.0,6.0,1.0,7.0,9.0,0.0,Matches,432.0,sn SEN,FW,23.0,12.6,20.0,1.58,12.0,1.0,1.0,0.0,6.0,0.0,3.0,0.24,2.0,1.0,0.0,0.0,0.0,0.0,Matches,,,,,,,,,,,,,,,,,,,,,,,,,,,,,,,,,,,,,,,,,,,,,,,,,,,,,,,,432.0,sn SEN,FW,23.0,12.6,4.0,0.0,0.0,12.0,27.0,2.0,7.0,1.0,2.0,0.0,0.0,0.0,35.0,23.0,50.0,31.5,Matches,432.0,sn SEN,FW,23.0,12.6,232.0,206.0,25.0,1.0,2.0,3.0,7.0,2.0,0.0,0.0,0.0,0.0,175.0,1.0,6.0,Matches,432.0,sn SEN,FW,23.0,12.6,175.0,232.0,75.4,2553.0,471.0,93.0,119.0,78.2,55.0,72.0,76.4,10.0,13.0,76.9,0.0,0.5,0.6,-0.5,8.0,17.0,4.0,0.0,24.0,Matches,515,sn SEN,FW,23,16,1136.0,71.0,33.2,12.6,15,74.0,4,1,27.0,0,0.63,11.0,26.0,-15.0,-1.19,0.11,11.4,22.0,-10.6,-0.84,-0.43,Matches,432.0,sn SEN,FW,23.0,12.6,367.0,14.0,29.0,190.0,151.0,40.0,367.0,29.0,8.0,27.6,18.0,62.1,259.0,1376.0,435.0,11.0,11.0,4.0,36.0,21.0,269.0,57.0,Matches,432.0,sn SEN,FW,23.0,12.6,2.0,26.0,11.0,42.3,2.06,0.87,0.08,0.18,13.7,0.0,0.0,0.0,3.4,3.4,0.13,-1.4,-1.4,Matches,432.0,sn SEN,FW,23.0,16.0,15.0,1136.0,12.6,2.0,0.0,2.0,2.0,0.0,0.0,4.0,0.0,3.4,3.4,0.5,3.9,11.0,24.0,57.0,0.16,0.0,0.16,0.16,0.16,0.27,0.04,0.31,0.27,0.31,Matches,Ibrahima Niane,S,23,120,129,Senegal,FC Metz,7,8,11,13,10,11,13,13,8,8,8,12,7,11,10,12,14,13,12,14,11,12,8,11,14,7,12,13,13,12,15,15,12,14,12,14,11,10,11,10,8,1,1,2,3,2,1,3,3,4,2,2,12,9,5,13,11,12,10,12,1,1,1,1,1,1,1,1,1,1,12,8,12,20,187,73,9,20,2144803,6000,6000,3655,African_Caribbean,120,17,1999/3/11,0,0,7536.0,,13181735
997,Rasmus Nicolaisen,Toulouse,1997,434.0,dk DEN,DF,25.0,33.3,48.0,21.0,34.0,14.0,0.0,29.0,46.0,63.0,17.0,58.0,45.0,13.0,50.0,98.0,152.0,0.0,Matches,434.0,dk DEN,DF,25.0,33.3,12.0,0.36,11.0,0.0,0.0,1.0,0.0,0.0,3.0,0.09,3.0,0.0,0.0,0.0,0.0,0.0,Matches,,,,,,,,,,,,,,,,,,,,,,,,,,,,,,,,,,,,,,,,,,,,,,,,,,,,,,,,434.0,dk DEN,DF,25.0,33.3,7.0,1.0,1.0,30.0,28.0,1.0,0.0,50.0,21.0,0.0,1.0,1.0,188.0,116.0,41.0,73.9,Matches,434.0,dk DEN,DF,25.0,33.3,1763.0,1721.0,40.0,37.0,0.0,20.0,0.0,3.0,0.0,0.0,0.0,0.0,1484.0,2.0,10.0,Matches,434.0,dk DEN,DF,25.0,33.3,1484.0,1763.0,84.2,29502.0,11304.0,479.0,556.0,86.2,790.0,870.0,90.8,188.0,289.0,65.1,2.0,0.8,0.7,1.2,5.0,81.0,3.0,0.0,114.0,Matches,517,dk DEN,DF,25,34,2995.0,88.0,87.6,33.3,34,88.0,32,0,,1,1.32,48.0,47.0,1.0,0.03,1.51,46.9,46.7,0.2,0.01,1.01,Matches,434.0,dk DEN,DF,25.0,33.3,2130.0,328.0,1123.0,960.0,55.0,33.0,2130.0,15.0,9.0,60.0,3.0,20.0,1500.0,8417.0,4790.0,21.0,9.0,2.0,7.0,6.0,1353.0,4.0,Matches,434.0,dk DEN,DF,25.0,33.3,0.0,13.0,7.0,53.8,0.39,0.21,0.0,0.0,11.5,0.0,0.0,0.0,1.2,1.2,0.09,-1.2,-1.2,Matches,434.0,dk DEN,DF,25.0,34.0,34.0,2995.0,33.3,0.0,2.0,2.0,0.0,0.0,0.0,7.0,1.0,1.2,1.2,0.8,2.0,21.0,114.0,4.0,0.0,0.06,0.06,0.0,0.06,0.04,0.02,0.06,0.04,0.06,Matches,Rasmus Nicolaisen,D C,25,122,130,Denmark,Toulouse FC,5,8,9,7,11,8,15,7,6,13,12,9,13,11,13,12,13,12,13,11,11,14,9,11,11,13,11,11,12,12,12,15,12,12,12,14,12,6,12,15,11,3,2,1,4,3,2,1,2,1,4,1,13,12,5,15,9,12,11,7,1,1,20,1,1,1,1,1,1,1,1,1,1,1,191,81,20,11,2000217,6100,5900,3750,Northern_European,121,2,1997/3/16,0,0,8064.0,,27100972
998,Arnaud Nordin,Montpellier,1998,435.0,fr FRA,FW,24.0,26.7,26.0,14.0,10.0,12.0,4.0,12.0,28.0,42.9,16.0,19.0,1.0,18.0,14.0,40.0,7.0,0.0,Matches,435.0,fr FRA,FW,24.0,26.7,63.0,2.36,41.0,1.0,3.0,6.0,11.0,1.0,10.0,0.37,7.0,0.0,1.0,0.0,2.0,0.0,Matches,,,,,,,,,,,,,,,,,,,,,,,,,,,,,,,,,,,,,,,,,,,,,,,,,,,,,,,,435.0,fr FRA,FW,24.0,26.7,4.0,0.0,0.0,21.0,82.0,4.0,49.0,14.0,14.0,2.0,0.0,0.0,120.0,21.0,59.0,26.3,Matches,435.0,fr FRA,FW,24.0,26.7,661.0,631.0,28.0,4.0,2.0,2.0,49.0,13.0,4.0,1.0,2.0,0.0,485.0,2.0,24.0,Matches,435.0,fr FRA,FW,24.0,26.7,485.0,661.0,73.4,7015.0,1948.0,268.0,334.0,80.2,156.0,213.0,73.2,26.0,44.0,59.1,3.0,2.9,2.0,0.1,20.0,28.0,19.0,3.0,63.0,Matches,518,fr FRA,FW,24,36,2401.0,67.0,70.2,26.7,30,75.0,7,6,25.0,1,1.31,50.0,41.0,9.0,0.34,0.87,36.9,38.8,-1.9,-0.07,0.64,Matches,435.0,fr FRA,FW,24.0,26.7,954.0,14.0,123.0,389.0,464.0,109.0,954.0,98.0,38.0,38.8,30.0,30.6,741.0,5545.0,2781.0,109.0,63.0,37.0,62.0,42.0,688.0,181.0,Matches,435.0,fr FRA,FW,24.0,26.7,9.0,59.0,24.0,40.7,2.21,0.9,0.15,0.38,16.1,0.0,0.0,0.0,6.5,6.5,0.11,2.5,2.5,Matches,435.0,fr FRA,FW,24.0,36.0,30.0,2401.0,26.7,9.0,3.0,12.0,9.0,0.0,0.0,4.0,0.0,6.5,6.5,2.9,9.4,109.0,63.0,181.0,0.34,0.11,0.45,0.34,0.45,0.24,0.11,0.35,0.24,0.35,Matches,Arnaud Nordin,AM L,24,127,136,"France,Martinique",Montpellier Hérault SC,6,11,14,12,13,6,6,12,5,3,12,11,4,13,8,11,12,12,9,10,10,12,13,10,13,10,12,12,15,14,12,6,12,14,14,11,11,8,8,10,12,2,2,2,3,1,2,2,2,3,2,1,16,14,7,10,11,10,10,15,1,1,1,1,1,1,1,15,1,1,20,1,12,1,170,70,20,8,3569411,6350,6250,3806,African_Caribbean,116,14,1998/6/17,0,0,12520.0,,85145157
999,Riad Nouri,Ajaccio,1985,436.0,fr FRA,MFFW,37.0,18.8,21.0,12.0,7.0,10.0,4.0,12.0,29.0,41.4,17.0,8.0,1.0,7.0,15.0,36.0,11.0,0.0,Matches,436.0,fr FRA,MFFW,37.0,18.8,40.0,2.13,22.0,11.0,0.0,5.0,2.0,0.0,1.0,0.05,1.0,0.0,0.0,0.0,0.0,0.0,Matches,,,,,,,,,,,,,,,,,,,,,,,,,,,,,,,,,,,,,,,,,,,,,,,,,,,,,,,,436.0,fr FRA,MFFW,37.0,18.8,3.0,0.0,0.0,16.0,15.0,7.0,86.0,15.0,12.0,0.0,0.0,0.0,84.0,13.0,17.0,43.3,Matches,436.0,fr FRA,MFFW,37.0,18.8,627.0,577.0,45.0,19.0,0.0,3.0,86.0,11.0,15.0,1.0,12.0,0.0,425.0,5.0,27.0,Matches,436.0,fr FRA,MFFW,37.0,18.8,425.0,627.0,67.8,6625.0,2227.0,225.0,288.0,78.1,150.0,208.0,72.1,31.0,82.0,37.8,1.0,2.2,2.2,-1.2,25.0,33.0,14.0,12.0,39.0,Matches,519,fr FRA,MFFW,37,33,1693.0,51.0,49.5,18.8,16,75.0,2,17,29.0,3,0.76,17.0,38.0,-21.0,-1.12,0.45,19.8,28.8,-9.0,-0.48,-0.02,Matches,436.0,fr FRA,MFFW,37.0,18.8,781.0,17.0,105.0,379.0,305.0,26.0,780.0,38.0,13.0,34.2,22.0,57.9,573.0,3379.0,1223.0,33.0,29.0,6.0,30.0,18.0,525.0,144.0,Matches,436.0,fr FRA,MFFW,37.0,18.8,1.0,16.0,4.0,25.0,0.85,0.21,0.06,0.25,16.4,0.0,0.0,1.0,2.4,1.6,0.1,-1.4,-0.6,Matches,436.0,fr FRA,MFFW,37.0,33.0,16.0,1693.0,18.8,1.0,1.0,2.0,1.0,0.0,1.0,3.0,0.0,2.4,1.6,2.2,3.8,33.0,39.0,144.0,0.05,0.05,0.11,0.05,0.11,0.13,0.12,0.24,0.08,0.2,Matches,Riad Nouri,AM RL,37,121,125,"France,Algeria",AC Ajaccio,10,13,14,12,14,11,6,13,5,5,13,15,5,14,8,13,12,13,11,12,12,15,13,14,13,6,11,12,13,15,12,8,14,13,12,11,12,8,14,6,8,1,2,1,1,3,1,3,2,1,4,1,19,14,7,12,13,13,12,14,1,1,1,1,1,1,1,10,10,15,19,12,20,13,178,73,8,20,146753,6048,6048,3748,North_African__Middle_Eastern,122,8,1985/6/7,0,0,7021.0,,85063748
1000,Alexander Nübel,Monaco,1996,437.0,de GER,GK,25.0,38.0,0.0,0.0,0.0,0.0,0.0,0.0,1.0,0.0,1.0,0.0,0.0,0.0,1.0,1.0,10.0,3.0,Matches,437.0,de GER,GK,25.0,38.0,8.0,0.21,6.0,2.0,0.0,0.0,0.0,0.0,1.0,0.03,1.0,0.0,0.0,0.0,0.0,0.0,Matches,32.0,de GER,GK,25.0,38.0,58.0,5.0,1.0,4.0,3.0,49.5,0.24,-5.5,-0.14,189.0,445.0,42.5,875.0,203.0,32.2,32.8,266.0,61.3,45.6,454.0,36.0,7.9,33.0,0.87,12.7,Matches,32.0,de GER,GK,25.0,38.0,38.0,3420.0,38.0,58.0,1.53,195.0,140.0,72.8,19.0,8.0,11.0,9.0,23.7,5.0,5.0,0.0,0.0,0.0,Matches,437.0,de GER,GK,25.0,38.0,2.0,0.0,0.0,0.0,2.0,0.0,0.0,1.0,0.0,0.0,0.0,0.0,43.0,7.0,1.0,87.5,Matches,437.0,de GER,GK,25.0,38.0,1141.0,786.0,355.0,89.0,1.0,2.0,0.0,0.0,0.0,0.0,0.0,0.0,851.0,0.0,0.0,Matches,437.0,de GER,GK,25.0,38.0,851.0,1141.0,74.6,25434.0,18986.0,120.0,121.0,99.2,358.0,367.0,97.5,369.0,649.0,56.9,0.0,0.0,0.3,0.0,1.0,4.0,0.0,0.0,1.0,Matches,520,de GER,GK,25,38,3420.0,90.0,100.0,38.0,38,90.0,38,0,,0,1.71,70.0,58.0,12.0,0.32,,62.1,53.2,8.9,0.23,,Matches,437.0,de GER,GK,25.0,38.0,1215.0,1033.0,1208.0,8.0,0.0,0.0,1215.0,0.0,0.0,,0.0,,846.0,4110.0,2509.0,0.0,0.0,0.0,1.0,0.0,483.0,0.0,Matches,437.0,de GER,GK,25.0,38.0,0.0,0.0,0.0,,0.0,0.0,,,,0.0,0.0,0.0,0.0,0.0,,0.0,0.0,Matches,437.0,de GER,GK,25.0,38.0,38.0,3420.0,38.0,0.0,0.0,0.0,0.0,0.0,0.0,2.0,0.0,0.0,0.0,0.0,0.0,0.0,1.0,0.0,0.0,0.0,0.0,0.0,0.0,0.0,0.0,0.0,0.0,0.0,Matches,Alexander Nübel,GK,25,137,155,Germany,FC Bayern München,4,1,2,2,11,8,7,3,2,1,12,3,1,11,13,13,13,15,12,9,12,12,2,11,1,10,15,12,13,15,12,15,14,11,10,13,12,8,15,5,13,14,15,9,12,11,14,15,16,17,10,14,11,16,15,6,13,15,7,11,20,1,1,1,1,1,1,1,1,1,1,1,1,1,193,88,14,20,3576621,6840,6740,5240,Northern_European,137,2,1996/9/30,0,0,105768.0,AS Monaco,92071707
1001,Gerzino Nyamsi,Strasbourg,1997,438.0,fr FRA,DF,25.0,17.5,28.0,20.0,14.0,12.0,2.0,10.0,12.0,83.3,2.0,19.0,11.0,8.0,10.0,38.0,63.0,1.0,Matches,438.0,fr FRA,DF,25.0,17.5,13.0,0.74,10.0,1.0,1.0,1.0,0.0,0.0,4.0,0.23,3.0,0.0,1.0,0.0,0.0,0.0,Matches,,,,,,,,,,,,,,,,,,,,,,,,,,,,,,,,,,,,,,,,,,,,,,,,,,,,,,,,438.0,fr FRA,DF,25.0,17.5,4.0,1.0,0.0,37.0,3.0,0.0,1.0,10.0,20.0,0.0,2.0,0.0,108.0,37.0,20.0,64.9,Matches,438.0,fr FRA,DF,25.0,17.5,841.0,810.0,31.0,30.0,0.0,4.0,1.0,1.0,0.0,0.0,0.0,0.0,710.0,0.0,6.0,Matches,438.0,fr FRA,DF,25.0,17.5,710.0,841.0,84.4,14214.0,5117.0,207.0,234.0,88.5,421.0,460.0,91.5,74.0,131.0,56.5,1.0,0.1,0.3,0.9,3.0,55.0,6.0,0.0,68.0,Matches,522,fr FRA,DF,25,20,1578.0,79.0,46.1,17.5,19,82.0,16,1,15.0,1,0.7,24.0,34.0,-10.0,-0.57,-0.67,22.3,28.5,-6.2,-0.35,-0.32,Matches,438.0,fr FRA,DF,25.0,17.5,1008.0,128.0,472.0,503.0,43.0,18.0,1008.0,15.0,10.0,66.7,4.0,26.7,719.0,4492.0,2479.0,13.0,9.0,0.0,11.0,2.0,634.0,3.0,Matches,438.0,fr FRA,DF,25.0,17.5,1.0,14.0,7.0,50.0,0.8,0.4,0.07,0.14,10.8,0.0,0.0,0.0,1.5,1.5,0.11,-0.5,-0.5,Matches,438.0,fr FRA,DF,25.0,20.0,19.0,1578.0,17.5,1.0,1.0,2.0,1.0,0.0,0.0,4.0,1.0,1.5,1.5,0.1,1.6,13.0,68.0,3.0,0.06,0.06,0.11,0.06,0.11,0.09,0.01,0.09,0.09,0.09,Matches,Gerzino Nyamsi,D RC,25,128,135,"France,Cameroon",RC Strasbourg Alsace,4,7,8,7,10,5,15,6,10,15,9,8,14,10,15,9,14,12,12,8,11,15,7,13,12,13,12,12,13,10,15,17,16,12,12,18,13,4,13,13,13,3,3,3,2,1,2,1,2,1,3,1,15,12,5,16,14,14,15,13,1,1,20,15,1,1,1,1,1,1,1,1,1,1,194,91,8,20,790994,5650,5703,3276,African_Caribbean,125,15,1997/1/22,0,0,6956.0,,48036582
1002,Wilson Odobert,Troyes,2004,439.0,fr FRA,MFFW,17.0,19.6,20.0,14.0,10.0,7.0,3.0,9.0,25.0,36.0,16.0,11.0,0.0,11.0,15.0,35.0,5.0,0.0,Matches,439.0,fr FRA,MFFW,17.0,19.6,62.0,3.16,46.0,4.0,6.0,2.0,1.0,3.0,8.0,0.41,6.0,0.0,0.0,2.0,0.0,0.0,Matches,,,,,,,,,,,,,,,,,,,,,,,,,,,,,,,,,,,,,,,,,,,,,,,,,,,,,,,,439.0,fr FRA,MFFW,17.0,19.6,0.0,0.0,0.0,9.0,16.0,2.0,34.0,15.0,14.0,0.0,0.0,0.0,74.0,7.0,21.0,25.0,Matches,439.0,fr FRA,MFFW,17.0,19.6,538.0,508.0,26.0,2.0,3.0,3.0,34.0,6.0,16.0,9.0,0.0,0.0,408.0,4.0,21.0,Matches,439.0,fr FRA,MFFW,17.0,19.6,408.0,538.0,75.8,6175.0,1444.0,226.0,281.0,80.4,134.0,175.0,76.6,26.0,37.0,70.3,2.0,1.8,1.4,0.2,23.0,27.0,13.0,5.0,47.0,Matches,523,fr FRA,MFFW,17,32,1764.0,55.0,51.6,19.6,19,76.0,6,13,25.0,3,0.69,24.0,48.0,-24.0,-1.22,-0.57,21.0,45.6,-24.6,-1.25,-0.47,Matches,439.0,fr FRA,MFFW,17.0,19.6,765.0,11.0,112.0,325.0,353.0,52.0,765.0,95.0,33.0,34.7,57.0,60.0,610.0,5160.0,2530.0,72.0,49.0,25.0,47.0,27.0,564.0,132.0,Matches,439.0,fr FRA,MFFW,17.0,19.6,4.0,27.0,14.0,51.9,1.38,0.71,0.15,0.29,18.0,0.0,0.0,0.0,2.6,2.6,0.1,1.4,1.4,Matches,439.0,fr FRA,MFFW,17.0,32.0,19.0,1764.0,19.6,4.0,2.0,6.0,4.0,0.0,0.0,0.0,0.0,2.6,2.6,1.8,4.4,72.0,47.0,132.0,0.2,0.1,0.31,0.2,0.31,0.13,0.09,0.23,0.13,0.23,Matches,Wilson Odobert,AM L,17,98,-75,France,ESTAC Troyes,7,8,12,12,12,9,10,10,5,6,12,10,6,13,9,11,10,12,11,11,10,14,12,7,11,7,10,12,14,11,11,10,12,13,11,6,11,8,11,6,11,1,1,3,2,2,1,1,3,3,2,2,13,13,5,13,12,14,14,14,1,1,1,1,1,1,1,12,1,1,20,1,1,1,180,75,8,20,21536002,4900,4900,1658,African_Caribbean,96,14,2004/11/28,0,0,924.0,,2000102722
1003,Warmed Omari,Rennes,2000,441.0,fr FRA,DF,22.0,15.1,20.0,11.0,14.0,6.0,0.0,14.0,28.0,50.0,14.0,13.0,7.0,6.0,17.0,37.0,43.0,1.0,Matches,441.0,fr FRA,DF,22.0,15.1,13.0,0.86,10.0,0.0,0.0,1.0,1.0,1.0,1.0,0.07,1.0,0.0,0.0,0.0,0.0,0.0,Matches,,,,,,,,,,,,,,,,,,,,,,,,,,,,,,,,,,,,,,,,,,,,,,,,,,,,,,,,441.0,fr FRA,DF,22.0,15.1,2.0,1.0,0.0,8.0,6.0,3.0,0.0,17.0,11.0,0.0,0.0,0.0,69.0,37.0,19.0,66.1,Matches,441.0,fr FRA,DF,22.0,15.1,982.0,956.0,25.0,23.0,4.0,0.0,0.0,0.0,0.0,0.0,0.0,0.0,911.0,1.0,1.0,Matches,441.0,fr FRA,DF,22.0,15.1,911.0,982.0,92.8,19205.0,5888.0,203.0,223.0,91.0,573.0,592.0,96.8,125.0,147.0,85.0,0.0,0.4,0.6,-0.4,5.0,42.0,2.0,0.0,58.0,Matches,527,fr FRA,DF,22,16,1363.0,85.0,39.9,15.1,15,89.0,14,1,21.0,4,1.5,25.0,13.0,12.0,0.79,0.0,25.2,18.0,7.3,0.48,0.04,Matches,441.0,fr FRA,DF,22.0,15.1,1106.0,88.0,475.0,613.0,27.0,8.0,1106.0,4.0,3.0,75.0,0.0,0.0,867.0,5133.0,2601.0,4.0,9.0,0.0,7.0,4.0,820.0,0.0,Matches,441.0,fr FRA,DF,22.0,15.1,0.0,3.0,1.0,33.3,0.2,0.07,0.0,0.0,7.1,0.0,0.0,0.0,0.6,0.6,0.19,-0.6,-0.6,Matches,441.0,fr FRA,DF,22.0,16.0,15.0,1363.0,15.1,0.0,0.0,0.0,0.0,0.0,0.0,2.0,1.0,0.6,0.6,0.4,1.0,4.0,58.0,0.0,0.0,0.0,0.0,0.0,0.0,0.04,0.03,0.06,0.04,0.06,Matches,Warmed Omari,D C,22,119,144,"France,Mayotte,Comoros",Stade Rennais FC,9,10,7,8,12,10,12,5,4,13,14,6,11,13,9,12,12,14,12,14,13,9,13,9,11,13,12,12,13,13,12,11,11,12,14,13,12,5,11,8,13,2,1,3,2,1,3,2,1,1,2,3,11,9,1,9,14,10,12,15,1,1,20,1,1,1,15,1,1,1,1,1,1,1,185,73,10,20,5619999,5950,5950,3000,African_Caribbean,119,13,2000/4/23,0,0,7040.0,,49037825
1004,Azzedine Ounahi,Angers,2000,449.0,ma MAR,MFFW,22.0,12.5,19.0,8.0,5.0,13.0,1.0,10.0,20.0,50.0,10.0,8.0,0.0,8.0,15.0,34.0,4.0,1.0,Matches,449.0,ma MAR,MFFW,22.0,12.5,43.0,3.42,34.0,1.0,4.0,3.0,1.0,0.0,3.0,0.24,2.0,0.0,0.0,1.0,0.0,0.0,Matches,,,,,,,,,,,,,,,,,,,,,,,,,,,,,,,,,,,,,,,,,,,,,,,,,,,,,,,,449.0,ma MAR,MFFW,22.0,12.5,1.0,0.0,0.0,11.0,24.0,1.0,17.0,15.0,8.0,0.0,0.0,0.0,70.0,5.0,12.0,29.4,Matches,449.0,ma MAR,MFFW,22.0,12.5,630.0,603.0,24.0,13.0,2.0,7.0,17.0,4.0,5.0,4.0,0.0,0.0,542.0,3.0,11.0,Matches,449.0,ma MAR,MFFW,22.0,12.5,542.0,630.0,86.0,8826.0,2723.0,286.0,314.0,91.1,184.0,210.0,87.6,50.0,70.0,71.4,0.0,1.6,1.8,-1.6,17.0,70.0,12.0,1.0,87.0,Matches,535,ma MAR,MFFW,22,15,1129.0,75.0,33.0,12.5,13,83.0,6,2,27.0,0,0.53,13.0,29.0,-16.0,-1.28,-0.02,14.2,20.5,-6.3,-0.5,0.07,Matches,449.0,ma MAR,MFFW,22.0,12.5,787.0,7.0,106.0,457.0,240.0,42.0,787.0,74.0,40.0,54.1,28.0,37.8,648.0,4480.0,2149.0,53.0,45.0,17.0,26.0,12.0,615.0,77.0,Matches,449.0,ma MAR,MFFW,22.0,12.5,0.0,23.0,6.0,26.1,1.83,0.48,0.0,0.0,19.8,1.0,0.0,0.0,1.8,1.8,0.08,-1.8,-1.8,Matches,449.0,ma MAR,MFFW,22.0,15.0,13.0,1129.0,12.5,0.0,0.0,0.0,0.0,0.0,0.0,1.0,0.0,1.8,1.8,1.6,3.4,53.0,87.0,77.0,0.0,0.0,0.0,0.0,0.0,0.14,0.12,0.27,0.14,0.27,Matches,Azzedine Ounahi,DM/M C,22,125,148,Morocco,Angers SCO,9,10,13,7,14,8,11,8,4,12,14,9,11,14,10,12,13,13,11,14,11,9,14,8,12,12,12,13,13,15,11,11,12,13,15,12,12,11,11,13,11,3,1,2,2,1,2,2,2,2,2,3,15,12,5,9,12,13,9,13,1,1,1,1,1,1,17,13,20,1,14,14,1,1,182,62,10,20,6151999,6249,6249,2505,North_African__Middle_Eastern,124,8,2000/4/19,7,2,10674.0,,49052370
1005,Adam Ounas,Lille,1996,450.0,dz ALG,FWMF,25.0,11.8,20.0,11.0,4.0,10.0,6.0,8.0,13.0,61.5,5.0,16.0,0.0,16.0,7.0,27.0,5.0,0.0,Matches,450.0,dz ALG,FWMF,25.0,11.8,56.0,4.74,36.0,11.0,4.0,3.0,2.0,0.0,6.0,0.51,3.0,1.0,0.0,1.0,1.0,0.0,Matches,,,,,,,,,,,,,,,,,,,,,,,,,,,,,,,,,,,,,,,,,,,,,,,,,,,,,,,,450.0,dz ALG,FWMF,25.0,11.8,2.0,0.0,0.0,15.0,29.0,2.0,75.0,7.0,11.0,1.0,0.0,0.0,60.0,5.0,10.0,33.3,Matches,450.0,dz ALG,FWMF,25.0,11.8,569.0,510.0,54.0,11.0,5.0,5.0,75.0,7.0,36.0,15.0,8.0,0.0,403.0,5.0,19.0,Matches,450.0,dz ALG,FWMF,25.0,11.8,403.0,569.0,70.8,7134.0,2189.0,190.0,234.0,81.2,153.0,218.0,70.2,48.0,83.0,57.8,1.0,2.8,2.9,-1.8,26.0,34.0,32.0,4.0,66.0,Matches,536,dz ALG,FWMF,25,21,1064.0,51.0,31.1,11.8,12,67.0,2,9,30.0,0,2.0,18.0,14.0,4.0,0.34,-0.31,21.6,12.3,9.4,0.79,0.07,Matches,450.0,dz ALG,FWMF,25.0,11.8,727.0,6.0,56.0,270.0,420.0,37.0,727.0,82.0,37.0,45.1,31.0,37.8,564.0,4043.0,2014.0,55.0,43.0,11.0,25.0,25.0,532.0,125.0,Matches,450.0,dz ALG,FWMF,25.0,11.8,1.0,26.0,9.0,34.6,2.2,0.76,0.04,0.11,19.1,3.0,0.0,0.0,2.3,2.3,0.09,-1.3,-1.3,Matches,450.0,dz ALG,FWMF,25.0,21.0,12.0,1064.0,11.8,1.0,1.0,2.0,1.0,0.0,0.0,2.0,0.0,2.3,2.3,2.8,5.1,55.0,66.0,125.0,0.08,0.08,0.17,0.08,0.17,0.2,0.23,0.43,0.2,0.43,Matches,Adam Ounas,AM/S RLC,25,131,139,"Algeria,France",LOSC Lille,11,12,17,12,14,7,5,11,4,4,13,10,4,14,8,11,8,12,9,12,10,12,16,8,14,5,10,11,16,15,10,6,14,15,11,7,11,10,14,11,13,2,1,1,1,1,3,4,2,1,3,3,11,14,10,9,11,10,11,10,1,1,1,1,1,1,1,10,1,10,17,17,20,18,172,65,20,10,6496919,6550,6700,5500,North_African__Middle_Eastern,120,11,1996/11/11,19,5,41396.0,,48034668
1006,Nicolas Pallois,Nantes,1987,452.0,fr FRA,DF,34.0,24.6,69.0,44.0,51.0,16.0,2.0,42.0,70.0,60.0,28.0,35.0,18.0,17.0,30.0,99.0,131.0,2.0,Matches,452.0,fr FRA,DF,34.0,24.6,10.0,0.41,7.0,0.0,1.0,1.0,0.0,1.0,0.0,0.0,0.0,0.0,0.0,0.0,0.0,0.0,Matches,,,,,,,,,,,,,,,,,,,,,,,,,,,,,,,,,,,,,,,,,,,,,,,,,,,,,,,,452.0,fr FRA,DF,34.0,24.6,4.0,1.0,1.0,20.0,6.0,1.0,7.0,30.0,44.0,0.0,1.0,1.0,174.0,35.0,25.0,58.3,Matches,452.0,fr FRA,DF,34.0,24.6,1171.0,1139.0,30.0,24.0,0.0,8.0,7.0,6.0,0.0,0.0,0.0,0.0,977.0,2.0,10.0,Matches,452.0,fr FRA,DF,34.0,24.6,977.0,1171.0,83.4,20669.0,7510.0,281.0,313.0,89.8,522.0,577.0,90.5,163.0,256.0,63.7,0.0,0.4,1.2,-0.4,4.0,88.0,8.0,2.0,86.0,Matches,540,fr FRA,DF,34,26,2213.0,85.0,64.7,24.6,26,85.0,22,0,,3,0.77,24.0,40.0,-16.0,-0.65,-0.5,29.3,33.7,-4.4,-0.18,0.21,Matches,452.0,fr FRA,DF,34.0,24.6,1475.0,182.0,688.0,771.0,35.0,14.0,1475.0,9.0,7.0,77.8,2.0,22.2,1005.0,5025.0,2486.0,8.0,8.0,1.0,18.0,9.0,847.0,3.0,Matches,452.0,fr FRA,DF,34.0,24.6,1.0,9.0,3.0,33.3,0.37,0.12,0.11,0.33,12.9,0.0,0.0,0.0,1.2,1.2,0.13,-0.2,-0.2,Matches,452.0,fr FRA,DF,34.0,26.0,26.0,2213.0,24.6,1.0,0.0,1.0,1.0,0.0,0.0,4.0,1.0,1.2,1.2,0.4,1.5,8.0,86.0,3.0,0.04,0.0,0.04,0.04,0.04,0.05,0.01,0.06,0.05,0.06,Matches,Nicolas Pallois,D C,34,130,133,France,FC Nantes,5,8,8,7,7,7,15,11,9,15,9,6,15,9,18,14,17,11,14,10,11,15,6,14,7,14,14,15,11,11,16,13,14,13,15,16,14,15,14,9,8,2,4,3,3,1,2,2,1,3,1,4,12,14,12,14,8,14,13,9,1,12,20,1,10,1,1,1,1,1,1,1,1,1,189,89,20,8,347975206,6500,6500,4007,Northern_European,130,1,1987/9/19,0,0,25298.0,,85074521
1007,Erik Palmer-Brown,Troyes,1997,453.0,us USA,DF,25.0,35.5,42.0,27.0,31.0,10.0,1.0,18.0,33.0,54.5,15.0,56.0,29.0,27.0,26.0,68.0,166.0,1.0,Matches,453.0,us USA,DF,25.0,35.5,21.0,0.59,17.0,1.0,0.0,1.0,0.0,2.0,3.0,0.08,3.0,0.0,0.0,0.0,0.0,0.0,Matches,,,,,,,,,,,,,,,,,,,,,,,,,,,,,,,,,,,,,,,,,,,,,,,,,,,,,,,,453.0,us USA,DF,25.0,35.5,5.0,0.0,0.0,29.0,12.0,1.0,2.0,26.0,27.0,0.0,1.0,1.0,178.0,56.0,32.0,63.6,Matches,453.0,us USA,DF,25.0,35.5,1435.0,1388.0,43.0,38.0,0.0,11.0,2.0,3.0,0.0,0.0,0.0,0.0,1212.0,4.0,12.0,Matches,453.0,us USA,DF,25.0,35.5,1212.0,1435.0,84.5,22021.0,9290.0,489.0,533.0,91.7,601.0,669.0,89.8,95.0,185.0,51.4,0.0,0.4,1.3,-0.4,7.0,64.0,8.0,1.0,75.0,Matches,541,us USA,DF,25,38,3191.0,84.0,93.3,35.5,36,87.0,32,2,27.0,0,0.63,42.0,78.0,-36.0,-1.02,-1.02,35.9,70.6,-34.7,-0.98,0.69,Matches,453.0,us USA,DF,25.0,35.5,1784.0,375.0,1073.0,684.0,40.0,16.0,1784.0,15.0,7.0,46.7,4.0,26.7,1256.0,6680.0,3173.0,6.0,7.0,2.0,12.0,15.0,1097.0,0.0,Matches,453.0,us USA,DF,25.0,35.5,0.0,12.0,2.0,16.7,0.34,0.06,0.0,0.0,11.7,0.0,0.0,0.0,1.1,1.1,0.09,-1.1,-1.1,Matches,453.0,us USA,DF,25.0,38.0,36.0,3191.0,35.5,0.0,0.0,0.0,0.0,0.0,0.0,5.0,0.0,1.1,1.1,0.4,1.5,6.0,75.0,0.0,0.0,0.0,0.0,0.0,0.0,0.03,0.01,0.04,0.03,0.04,Matches,Erik Palmer-Brown,D/DM C,25,126,134,United States,ESTAC Troyes,5,6,8,6,10,10,13,9,6,13,11,7,14,12,14,12,12,12,12,9,11,14,7,9,8,14,13,13,13,11,13,15,15,13,14,16,12,10,10,10,8,1,3,1,2,3,3,2,1,3,1,1,7,15,6,8,8,9,10,7,1,12,20,14,1,1,16,1,1,1,1,1,1,1,187,88,11,20,3240351,6295,6295,4010,African_Caribbean,124,14,1997/4/24,4,0,11999.0,,72040029
1008,Nicolas Pépé,Nice,1995,460.0,ci CIV,FWMF,27.0,16.6,25.0,13.0,14.0,5.0,6.0,11.0,25.0,44.0,14.0,17.0,0.0,17.0,3.0,28.0,1.0,0.0,Matches,460.0,ci CIV,FWMF,27.0,16.6,56.0,3.31,34.0,12.0,2.0,4.0,4.0,0.0,6.0,0.35,0.0,2.0,1.0,1.0,2.0,0.0,Matches,,,,,,,,,,,,,,,,,,,,,,,,,,,,,,,,,,,,,,,,,,,,,,,,,,,,,,,,460.0,ci CIV,FWMF,27.0,16.6,2.0,0.0,0.0,13.0,33.0,6.0,42.0,3.0,13.0,2.0,0.0,0.0,76.0,8.0,13.0,38.1,Matches,460.0,ci CIV,FWMF,27.0,16.6,694.0,641.0,51.0,15.0,2.0,3.0,42.0,10.0,24.0,11.0,5.0,0.0,558.0,2.0,19.0,Matches,460.0,ci CIV,FWMF,27.0,16.6,558.0,694.0,80.4,8009.0,1739.0,327.0,376.0,87.0,159.0,198.0,80.3,35.0,54.0,64.8,0.0,2.6,3.1,-2.6,28.0,29.0,19.0,4.0,53.0,Matches,551,ci CIV,FWMF,27,18,1495.0,83.0,43.7,16.6,17,85.0,10,1,51.0,1,1.39,17.0,16.0,1.0,0.06,-0.41,22.8,19.2,3.6,0.21,-0.22,Matches,460.0,ci CIV,FWMF,27.0,16.6,918.0,3.0,88.0,392.0,455.0,90.0,915.0,76.0,34.0,44.7,33.0,43.4,752.0,4476.0,1872.0,48.0,29.0,26.0,45.0,52.0,724.0,151.0,Matches,460.0,ci CIV,FWMF,27.0,16.6,6.0,46.0,17.0,37.0,2.77,1.02,0.07,0.18,17.6,2.0,3.0,3.0,8.1,5.8,0.13,-2.1,-2.8,Matches,460.0,ci CIV,FWMF,27.0,18.0,17.0,1495.0,16.6,6.0,0.0,6.0,3.0,3.0,3.0,2.0,0.0,8.1,5.8,2.6,8.3,48.0,53.0,151.0,0.36,0.0,0.36,0.18,0.18,0.48,0.15,0.63,0.34,0.49,Matches,Nicolas Pépé,AM RL,27,146,159,"Ivory Coast,France",Arsenal,12,12,17,13,14,14,8,16,2,4,12,15,4,16,6,12,8,13,8,12,11,8,18,7,16,6,11,11,17,18,13,9,14,16,13,10,8,7,11,7,7,1,1,3,1,2,4,2,2,1,2,1,9,11,5,14,12,13,12,14,1,1,1,1,1,1,1,12,1,12,16,1,20,12,183,73,20,8,54284132,7300,7500,6500,African_Caribbean,140,15,1995/5/29,32,9,121791.0,OGC Nice,85136376
1009,Danilo Pereira,Paris S-G,1991,462.0,pt POR,DFMF,30.0,26.8,32.0,17.0,15.0,14.0,3.0,19.0,26.0,73.1,7.0,26.0,19.0,7.0,36.0,68.0,59.0,1.0,Matches,462.0,pt POR,DFMF,30.0,26.8,23.0,0.86,19.0,0.0,0.0,2.0,1.0,1.0,2.0,0.07,2.0,0.0,0.0,0.0,0.0,0.0,Matches,,,,,,,,,,,,,,,,,,,,,,,,,,,,,,,,,,,,,,,,,,,,,,,,,,,,,,,,462.0,pt POR,DFMF,30.0,26.8,3.0,0.0,0.0,17.0,14.0,1.0,3.0,36.0,17.0,0.0,0.0,0.0,184.0,34.0,22.0,60.7,Matches,462.0,pt POR,DFMF,30.0,26.8,2068.0,1989.0,74.0,36.0,1.0,6.0,3.0,21.0,0.0,0.0,0.0,0.0,1950.0,5.0,8.0,Matches,462.0,pt POR,DFMF,30.0,26.8,1950.0,2068.0,94.3,32419.0,10970.0,909.0,946.0,96.1,859.0,899.0,95.6,136.0,164.0,82.9,0.0,0.5,0.9,-0.5,4.0,200.0,7.0,0.0,154.0,Matches,553,pt POR,DFMF,30,33,2410.0,73.0,70.5,26.8,27,83.0,19,6,27.0,3,2.12,57.0,27.0,30.0,1.12,-0.57,52.9,33.0,19.9,0.74,-0.15,Matches,462.0,pt POR,DFMF,30.0,26.8,2277.0,193.0,695.0,1442.0,162.0,29.0,2277.0,15.0,10.0,66.7,5.0,33.3,1888.0,9953.0,5205.0,26.0,35.0,2.0,14.0,10.0,1748.0,11.0,Matches,462.0,pt POR,DFMF,30.0,26.8,2.0,22.0,5.0,22.7,0.82,0.19,0.09,0.4,12.7,0.0,0.0,0.0,2.3,2.3,0.11,-0.3,-0.3,Matches,462.0,pt POR,DFMF,30.0,33.0,27.0,2410.0,26.8,2.0,0.0,2.0,2.0,0.0,0.0,3.0,0.0,2.3,2.3,0.5,2.8,26.0,154.0,11.0,0.07,0.0,0.07,0.07,0.07,0.09,0.02,0.1,0.09,0.1,Matches,Danilo Pereira,D/DM C,30,150,153,"Portugal,Guinea-Bissau",Paris Saint-Germain,6,8,11,8,11,7,14,12,8,14,13,12,15,12,12,14,14,13,15,12,13,14,9,14,12,15,15,14,13,13,14,15,17,13,15,16,15,9,13,6,11,2,1,3,2,3,3,2,2,2,3,3,14,15,9,14,14,18,17,18,1,1,19,1,1,1,20,1,15,1,1,1,1,1,188,83,12,20,25055013,7500,7500,6250,African_Caribbean,142,18,1991/9/9,61,2,86300.0,,55013032
1010,Mathias Pereira Lage,Brest,1996,463.0,pt POR,MFFW,25.0,14.0,20.0,7.0,5.0,14.0,1.0,11.0,29.0,37.9,18.0,10.0,1.0,9.0,14.0,34.0,12.0,0.0,Matches,463.0,pt POR,MFFW,25.0,14.0,28.0,1.99,19.0,3.0,2.0,1.0,3.0,0.0,3.0,0.21,2.0,0.0,0.0,0.0,1.0,0.0,Matches,,,,,,,,,,,,,,,,,,,,,,,,,,,,,,,,,,,,,,,,,,,,,,,,,,,,,,,,463.0,pt POR,MFFW,25.0,14.0,2.0,0.0,0.0,23.0,27.0,1.0,34.0,14.0,7.0,1.0,0.0,0.0,69.0,21.0,28.0,42.9,Matches,463.0,pt POR,MFFW,25.0,14.0,387.0,366.0,19.0,6.0,1.0,7.0,34.0,3.0,9.0,9.0,0.0,0.0,257.0,2.0,14.0,Matches,463.0,pt POR,MFFW,25.0,14.0,257.0,387.0,66.4,4010.0,1256.0,135.0,169.0,79.9,77.0,114.0,67.5,27.0,63.0,42.9,1.0,1.6,1.3,-0.6,14.0,25.0,3.0,2.0,30.0,Matches,554,pt POR,MFFW,25,24,1264.0,53.0,37.0,14.0,16,70.0,2,8,18.0,3,1.13,17.0,25.0,-8.0,-0.57,-0.49,14.2,20.1,-5.9,-0.42,-0.14,Matches,463.0,pt POR,MFFW,25.0,14.0,539.0,16.0,81.0,263.0,203.0,41.0,539.0,26.0,9.0,34.6,13.0,50.0,386.0,2296.0,911.0,20.0,13.0,7.0,24.0,18.0,360.0,98.0,Matches,463.0,pt POR,MFFW,25.0,14.0,2.0,21.0,9.0,42.9,1.5,0.64,0.1,0.22,18.8,1.0,0.0,0.0,1.4,1.4,0.07,0.6,0.6,Matches,463.0,pt POR,MFFW,25.0,24.0,16.0,1264.0,14.0,2.0,1.0,3.0,2.0,0.0,0.0,2.0,0.0,1.4,1.4,1.6,3.0,20.0,30.0,98.0,0.14,0.07,0.21,0.14,0.21,0.1,0.11,0.21,0.1,0.21,Matches,Mathias Pereira Lage,M/AM LC,25,124,127,"Portugal,France",Stade Brestois 29,12,12,13,10,13,14,11,14,11,8,13,12,9,13,10,12,11,12,12,13,13,14,13,10,13,11,13,12,13,13,11,11,14,13,13,11,13,9,10,6,14,2,3,1,2,3,1,1,2,2,3,3,10,13,6,15,12,14,12,13,1,1,1,1,1,10,1,1,20,10,17,17,1,1,180,67,10,20,1691758,6196,6196,3796,Northern_European,122,6,1996/11/30,0,0,9693.0,,48039548
1011,Julien Ponceau,Lorient,2000,467.0,fr FRA,MF,21.0,18.4,28.0,19.0,10.0,14.0,4.0,10.0,32.0,31.3,22.0,27.0,3.0,24.0,14.0,42.0,12.0,0.0,Matches,467.0,fr FRA,MF,21.0,18.4,50.0,2.72,45.0,1.0,2.0,0.0,2.0,0.0,4.0,0.22,4.0,0.0,0.0,0.0,0.0,0.0,Matches,,,,,,,,,,,,,,,,,,,,,,,,,,,,,,,,,,,,,,,,,,,,,,,,,,,,,,,,467.0,fr FRA,MF,21.0,18.4,1.0,0.0,0.0,21.0,25.0,4.0,12.0,14.0,19.0,0.0,0.0,0.0,105.0,8.0,27.0,22.9,Matches,467.0,fr FRA,MF,21.0,18.4,840.0,786.0,50.0,12.0,2.0,2.0,12.0,9.0,2.0,0.0,0.0,0.0,691.0,4.0,23.0,Matches,467.0,fr FRA,MF,21.0,18.4,691.0,840.0,82.3,10711.0,3196.0,352.0,407.0,86.5,260.0,302.0,86.1,42.0,59.0,71.2,4.0,3.0,2.0,1.0,26.0,75.0,12.0,1.0,101.0,Matches,561,fr FRA,MF,21,31,1655.0,53.0,48.4,18.4,20,72.0,3,11,19.0,6,1.29,29.0,29.0,0.0,0.0,0.05,22.1,29.1,-7.0,-0.38,-0.04,Matches,467.0,fr FRA,MF,21.0,18.4,1014.0,32.0,168.0,534.0,328.0,43.0,1014.0,30.0,10.0,33.3,17.0,56.7,781.0,4815.0,2245.0,53.0,53.0,7.0,39.0,18.0,707.0,103.0,Matches,467.0,fr FRA,MF,21.0,18.4,1.0,14.0,4.0,28.6,0.76,0.22,0.07,0.25,18.5,0.0,0.0,0.0,1.8,1.8,0.13,-0.8,-0.8,Matches,467.0,fr FRA,MF,21.0,31.0,20.0,1655.0,18.4,1.0,4.0,5.0,1.0,0.0,0.0,1.0,0.0,1.8,1.8,3.0,4.8,53.0,101.0,103.0,0.05,0.22,0.27,0.05,0.27,0.1,0.16,0.26,0.1,0.26,Matches,Julien Ponceau,M/AM C,21,118,150,"France,Angola",FC Lorient,11,11,13,8,13,11,5,10,7,12,13,10,8,14,8,13,11,12,12,14,12,13,12,8,14,11,14,15,12,15,12,5,13,13,15,7,12,8,12,6,8,1,1,3,2,1,1,3,1,1,2,2,12,11,12,13,11,14,14,12,1,1,1,1,1,1,12,12,20,13,12,17,13,1,170,60,8,20,7375999,5899,5899,2763,African_Caribbean,118,12,2000/11/28,0,0,5757.0,,49040111
1012,Jackson Porozo,Troyes,2000,469.0,ec ECU,DF,21.0,18.0,32.0,20.0,24.0,7.0,1.0,13.0,31.0,41.9,18.0,24.0,17.0,7.0,33.0,65.0,75.0,0.0,Matches,469.0,ec ECU,DF,21.0,18.0,9.0,0.5,8.0,0.0,0.0,1.0,0.0,0.0,0.0,0.0,0.0,0.0,0.0,0.0,0.0,0.0,Matches,,,,,,,,,,,,,,,,,,,,,,,,,,,,,,,,,,,,,,,,,,,,,,,,,,,,,,,,469.0,ec ECU,DF,21.0,18.0,3.0,0.0,0.0,29.0,18.0,1.0,3.0,33.0,20.0,0.0,0.0,0.0,75.0,47.0,25.0,65.3,Matches,469.0,ec ECU,DF,21.0,18.0,629.0,599.0,30.0,24.0,0.0,4.0,3.0,6.0,0.0,0.0,0.0,0.0,512.0,0.0,8.0,Matches,469.0,ec ECU,DF,21.0,18.0,512.0,629.0,81.4,9099.0,2992.0,215.0,250.0,86.0,249.0,284.0,87.7,35.0,73.0,47.9,0.0,0.2,0.5,-0.2,2.0,21.0,1.0,0.0,26.0,Matches,563,ec ECU,DF,21,22,1617.0,74.0,47.3,18.0,17,88.0,15,5,26.0,12,0.64,26.0,40.0,-14.0,-0.78,0.32,21.8,36.9,-15.1,-0.84,0.35,Matches,469.0,ec ECU,DF,21.0,18.0,851.0,118.0,463.0,348.0,47.0,22.0,851.0,11.0,7.0,63.6,4.0,36.4,545.0,2845.0,1222.0,6.0,5.0,1.0,10.0,7.0,484.0,4.0,Matches,469.0,ec ECU,DF,21.0,18.0,2.0,22.0,9.0,40.9,1.22,0.5,0.09,0.22,12.7,0.0,0.0,0.0,2.8,2.8,0.13,-0.8,-0.8,Matches,469.0,ec ECU,DF,21.0,22.0,17.0,1617.0,18.0,2.0,0.0,2.0,2.0,0.0,0.0,3.0,0.0,2.8,2.8,0.2,3.0,6.0,26.0,4.0,0.11,0.0,0.11,0.11,0.11,0.16,0.01,0.17,0.16,0.17,Matches,Jackson Porozo,D C,21,127,138,Ecuador,ESTAC Troyes,5,6,10,8,11,5,16,6,10,14,9,8,14,11,18,16,15,8,7,9,9,15,6,11,9,12,13,13,14,13,13,16,16,16,15,14,11,15,9,3,10,3,2,3,3,1,2,2,2,3,2,2,14,14,8,13,12,12,13,10,1,1,20,1,1,1,1,1,1,1,1,1,1,1,193,85,20,11,5539998,6332,5982,3982,African_Caribbean,127,17,2000/8/4,5,0,11947.0,,19354849
1013,Sergio Ramos,Paris S-G,1986,476.0,es ESP,DF,36.0,30.0,34.0,26.0,14.0,18.0,2.0,23.0,44.0,52.3,21.0,29.0,13.0,16.0,34.0,68.0,93.0,3.0,Matches,476.0,es ESP,DF,36.0,30.0,21.0,0.7,16.0,0.0,0.0,2.0,3.0,0.0,1.0,0.03,1.0,0.0,0.0,0.0,0.0,0.0,Matches,,,,,,,,,,,,,,,,,,,,,,,,,,,,,,,,,,,,,,,,,,,,,,,,,,,,,,,,476.0,es ESP,DF,36.0,30.0,3.0,1.0,0.0,36.0,24.0,4.0,13.0,34.0,26.0,1.0,0.0,0.0,173.0,55.0,34.0,61.8,Matches,476.0,es ESP,DF,36.0,30.0,2535.0,2453.0,80.0,47.0,2.0,38.0,13.0,27.0,0.0,0.0,0.0,0.0,2394.0,2.0,13.0,Matches,476.0,es ESP,DF,36.0,30.0,2394.0,2535.0,94.4,46077.0,15119.0,815.0,860.0,94.8,1231.0,1263.0,97.5,283.0,327.0,86.5,1.0,0.2,0.8,0.8,4.0,215.0,6.0,2.0,163.0,Matches,570,es ESP,DF,36,33,2704.0,82.0,79.1,30.0,31,85.0,26,2,37.0,0,2.3,72.0,32.0,40.0,1.33,0.2,59.5,38.7,20.8,0.69,-0.46,Matches,476.0,es ESP,DF,36.0,30.0,2774.0,310.0,1061.0,1566.0,159.0,30.0,2774.0,14.0,5.0,35.7,6.0,42.9,2313.0,11550.0,5696.0,15.0,20.0,3.0,8.0,6.0,2186.0,10.0,Matches,476.0,es ESP,DF,36.0,30.0,2.0,19.0,7.0,36.8,0.63,0.23,0.11,0.29,14.6,1.0,0.0,0.0,1.7,1.7,0.09,0.3,0.3,Matches,476.0,es ESP,DF,36.0,33.0,31.0,2704.0,30.0,2.0,1.0,3.0,2.0,0.0,0.0,3.0,1.0,1.7,1.7,0.2,1.9,15.0,163.0,10.0,0.07,0.03,0.1,0.07,0.1,0.06,0.01,0.06,0.06,0.06,Matches,Sergio Ramos,D C,36,161,174,Spain,Paris Saint-Germain,9,11,13,13,14,14,20,13,12,16,15,17,16,14,18,15,16,13,10,13,11,20,14,18,12,13,13,14,12,14,15,16,15,13,15,16,13,18,19,13,14,3,2,1,1,3,2,2,2,1,3,2,10,18,14,17,18,17,6,7,1,1,20,12,1,10,8,1,1,1,1,1,1,1,184,82,13,20,17015106,8039,8039,7989,Mediterranean_Hispanic,161,4,1986/3/30,180,23,261204.0,,7458272
1014,Aaron Ramsey,Nice,1990,477.0,wls WAL,MF,31.0,17.6,47.0,25.0,18.0,19.0,10.0,16.0,39.0,41.0,23.0,25.0,4.0,21.0,17.0,64.0,18.0,1.0,Matches,477.0,wls WAL,MF,31.0,17.6,62.0,3.52,42.0,14.0,0.0,5.0,1.0,0.0,4.0,0.23,2.0,1.0,0.0,0.0,1.0,0.0,Matches,,,,,,,,,,,,,,,,,,,,,,,,,,,,,,,,,,,,,,,,,,,,,,,,,,,,,,,,477.0,wls WAL,MF,31.0,17.6,3.0,0.0,0.0,23.0,18.0,3.0,62.0,17.0,25.0,1.0,0.0,0.0,115.0,6.0,12.0,33.3,Matches,477.0,wls WAL,MF,31.0,17.6,1088.0,998.0,88.0,37.0,5.0,11.0,62.0,6.0,45.0,16.0,18.0,0.0,915.0,2.0,10.0,Matches,477.0,wls WAL,MF,31.0,17.6,915.0,1088.0,84.1,16069.0,3809.0,398.0,431.0,92.3,382.0,444.0,86.0,100.0,159.0,62.9,1.0,1.8,2.0,-0.8,28.0,88.0,20.0,3.0,126.0,Matches,571,wls WAL,MF,31,27,1584.0,59.0,46.3,17.6,18,74.0,6,9,27.0,0,1.59,25.0,10.0,15.0,0.85,1.05,28.2,17.2,11.0,0.63,0.55,Matches,477.0,wls WAL,MF,31.0,17.6,1279.0,43.0,208.0,723.0,361.0,50.0,1279.0,24.0,14.0,58.3,5.0,20.8,980.0,4866.0,1934.0,29.0,34.0,8.0,24.0,32.0,902.0,84.0,Matches,477.0,wls WAL,MF,31.0,17.6,1.0,22.0,6.0,27.3,1.25,0.34,0.05,0.17,15.3,1.0,0.0,0.0,2.5,2.5,0.11,-1.5,-1.5,Matches,477.0,wls WAL,MF,31.0,27.0,18.0,1584.0,17.6,1.0,1.0,2.0,1.0,0.0,0.0,3.0,0.0,2.5,2.5,1.8,4.3,29.0,126.0,84.0,0.06,0.06,0.11,0.06,0.11,0.14,0.1,0.24,0.14,0.24,Matches,Aaron Ramsey,M/AM RC,31,137,161,Wales,OGC Nice,11,13,14,10,16,8,6,14,4,9,15,10,11,16,10,15,12,13,14,14,15,12,14,12,16,11,14,11,12,14,14,8,8,12,12,10,12,6,15,16,16,1,3,1,1,3,1,2,1,2,2,2,6,8,6,16,14,12,13,14,1,1,1,1,1,1,12,14,20,14,14,19,16,1,178,76,10,20,3834769,7000,7150,6000,Northern_European,135,2,1990/12/26,75,20,144614.0,,29000737
1015,Elba Rashani,Clermont Foot,1993,479.0,xk KVX,MFFW,29.0,24.0,39.0,26.0,13.0,19.0,7.0,13.0,39.0,33.3,26.0,27.0,2.0,25.0,21.0,60.0,19.0,0.0,Matches,479.0,xk KVX,MFFW,29.0,24.0,46.0,1.92,37.0,0.0,1.0,5.0,2.0,1.0,7.0,0.29,5.0,0.0,0.0,2.0,0.0,0.0,Matches,,,,,,,,,,,,,,,,,,,,,,,,,,,,,,,,,,,,,,,,,,,,,,,,,,,,,,,,479.0,xk KVX,MFFW,29.0,24.0,3.0,0.0,0.0,36.0,29.0,4.0,58.0,21.0,26.0,1.0,0.0,0.0,101.0,16.0,42.0,27.6,Matches,479.0,xk KVX,MFFW,29.0,24.0,729.0,702.0,24.0,5.0,2.0,2.0,58.0,18.0,1.0,0.0,0.0,0.0,543.0,3.0,40.0,Matches,479.0,xk KVX,MFFW,29.0,24.0,543.0,729.0,74.5,7569.0,1657.0,316.0,375.0,84.3,179.0,229.0,78.2,18.0,46.0,39.1,3.0,3.6,2.8,-0.6,20.0,34.0,15.0,5.0,54.0,Matches,573,xk KVX,MFFW,29,32,2162.0,68.0,63.2,24.0,26,78.0,7,6,24.0,0,1.66,33.0,31.0,2.0,0.08,0.51,32.7,32.8,0.0,0.0,0.76,Matches,479.0,xk KVX,MFFW,29.0,24.0,994.0,28.0,169.0,436.0,406.0,93.0,994.0,56.0,22.0,39.3,26.0,46.4,712.0,4389.0,1714.0,55.0,39.0,22.0,49.0,25.0,664.0,172.0,Matches,479.0,xk KVX,MFFW,29.0,24.0,3.0,35.0,13.0,37.1,1.46,0.54,0.09,0.23,14.4,0.0,0.0,0.0,4.7,4.7,0.13,-1.7,-1.7,Matches,479.0,xk KVX,MFFW,29.0,32.0,26.0,2162.0,24.0,3.0,3.0,6.0,3.0,0.0,0.0,3.0,0.0,4.7,4.7,3.6,8.3,55.0,54.0,172.0,0.12,0.12,0.25,0.12,0.25,0.2,0.15,0.34,0.2,0.34,Matches,Elba Rashani,M/AM RL,29,120,126,"Kosovo,Norway,Albania",Clermont Foot 63,12,12,13,13,14,13,5,12,5,4,12,9,4,14,5,13,6,13,8,14,13,13,16,5,14,5,13,13,13,14,12,10,10,13,13,11,12,10,11,10,8,3,2,4,2,1,2,2,2,2,3,4,10,12,1,13,11,11,13,4,1,1,1,1,1,1,1,17,5,15,20,10,17,6,181,71,20,10,1683685,6000,6000,4000,Northern_European,120,4,1993/5/9,22,4,6344.0,,53052272
1016,Rafael Ratão,Toulouse,1995,480.0,br BRA,FWMF,26.0,20.6,52.0,36.0,29.0,16.0,7.0,27.0,73.0,37.0,46.0,34.0,0.0,34.0,21.0,73.0,7.0,0.0,Matches,480.0,br BRA,FWMF,26.0,20.6,58.0,2.82,47.0,0.0,2.0,7.0,1.0,1.0,4.0,0.19,4.0,0.0,0.0,0.0,0.0,0.0,Matches,,,,,,,,,,,,,,,,,,,,,,,,,,,,,,,,,,,,,,,,,,,,,,,,,,,,,,,,480.0,br BRA,FWMF,26.0,20.6,2.0,0.0,0.0,28.0,33.0,2.0,52.0,21.0,36.0,0.0,0.0,0.0,116.0,10.0,13.0,43.5,Matches,480.0,br BRA,FWMF,26.0,20.6,800.0,777.0,18.0,1.0,5.0,3.0,52.0,16.0,0.0,0.0,0.0,0.0,590.0,5.0,25.0,Matches,480.0,br BRA,FWMF,26.0,20.6,590.0,800.0,73.8,8370.0,2341.0,338.0,423.0,79.9,183.0,243.0,75.3,31.0,58.0,53.4,4.0,4.1,3.8,-0.1,30.0,46.0,33.0,9.0,83.0,Matches,574,br BRA,FWMF,26,30,1851.0,62.0,54.1,20.6,25,68.0,1,5,30.0,1,1.3,34.0,33.0,1.0,0.05,0.45,31.5,28.7,2.8,0.14,0.55,Matches,480.0,br BRA,FWMF,26.0,20.6,1084.0,17.0,160.0,478.0,464.0,72.0,1084.0,85.0,38.0,44.7,37.0,43.5,856.0,5513.0,2196.0,61.0,40.0,16.0,57.0,31.0,783.0,216.0,Matches,480.0,br BRA,FWMF,26.0,20.6,5.0,31.0,11.0,35.5,1.51,0.53,0.16,0.45,12.4,0.0,0.0,0.0,5.1,5.1,0.17,-0.1,-0.1,Matches,480.0,br BRA,FWMF,26.0,30.0,25.0,1851.0,20.6,5.0,4.0,9.0,5.0,0.0,0.0,2.0,0.0,5.1,5.1,4.1,9.2,61.0,83.0,216.0,0.24,0.19,0.44,0.24,0.44,0.25,0.2,0.45,0.25,0.45,Matches,Rafael Ratão,AM/S L,26,120,130,Brazil,Toulouse FC,8,11,15,13,14,8,12,12,8,7,13,11,7,14,12,12,12,12,12,12,12,15,15,7,13,13,14,11,14,14,12,7,15,14,12,12,12,6,13,8,12,4,2,1,1,3,3,1,2,1,1,2,13,15,8,12,12,13,8,13,1,1,1,1,1,1,1,1,1,1,20,1,13,19,183,75,5,20,1675603,5996,5996,2752,Mixed_Race,121,12,1995/11/30,0,0,6445.0,,19222848
1017,Alexsandro Ribeiro,Lille,1999,484.0,br BRA,DF,22.0,17.9,32.0,18.0,24.0,7.0,1.0,19.0,28.0,67.9,9.0,11.0,2.0,9.0,25.0,57.0,59.0,1.0,Matches,484.0,br BRA,DF,22.0,17.9,11.0,0.61,9.0,0.0,0.0,2.0,0.0,0.0,0.0,0.0,0.0,0.0,0.0,0.0,0.0,0.0,Matches,,,,,,,,,,,,,,,,,,,,,,,,,,,,,,,,,,,,,,,,,,,,,,,,,,,,,,,,484.0,br BRA,DF,22.0,17.9,4.0,0.0,0.0,18.0,20.0,2.0,4.0,25.0,18.0,0.0,0.0,0.0,113.0,32.0,28.0,53.3,Matches,484.0,br BRA,DF,22.0,17.9,1271.0,1202.0,66.0,48.0,1.0,9.0,4.0,1.0,0.0,0.0,0.0,0.0,1148.0,3.0,7.0,Matches,484.0,br BRA,DF,22.0,17.9,1148.0,1271.0,90.3,20522.0,8054.0,462.0,490.0,94.3,575.0,618.0,93.0,82.0,120.0,68.3,0.0,0.1,0.4,-0.1,2.0,77.0,2.0,1.0,90.0,Matches,578,br BRA,DF,22,21,1612.0,77.0,47.1,17.9,16,89.0,15,5,38.0,15,1.76,31.0,25.0,6.0,0.33,-0.41,33.0,19.4,13.6,0.76,0.03,Matches,484.0,br BRA,DF,22.0,17.9,1449.0,150.0,643.0,770.0,44.0,23.0,1449.0,20.0,14.0,70.0,6.0,30.0,1090.0,5798.0,2890.0,9.0,5.0,0.0,11.0,5.0,1009.0,7.0,Matches,484.0,br BRA,DF,22.0,17.9,3.0,17.0,7.0,41.2,0.95,0.39,0.18,0.43,9.5,0.0,0.0,0.0,1.8,1.8,0.11,1.2,1.2,Matches,484.0,br BRA,DF,22.0,21.0,16.0,1612.0,17.9,3.0,0.0,3.0,3.0,0.0,0.0,4.0,0.0,1.8,1.8,0.1,1.9,9.0,90.0,7.0,0.17,0.0,0.17,0.17,0.17,0.1,0.01,0.11,0.1,0.11,Matches,Alexsandro Ribeiro,D C,22,125,138,Brazil,LOSC Lille,4,5,8,8,10,5,14,7,7,14,10,8,13,10,15,14,15,10,12,8,13,13,8,8,7,13,12,13,10,9,14,16,17,13,14,15,16,11,12,7,2,2,1,2,2,2,3,3,1,1,3,2,13,13,5,7,16,17,13,13,1,1,20,1,1,1,10,1,1,1,1,1,1,1,192,88,20,12,4899999,6250,5369,4612,Native_American,123,9,1999/8/9,0,0,11832.0,,83282675
1018,Renaud Ripart,Troyes,1993,486.0,fr FRA,FWMF,29.0,14.7,40.0,23.0,14.0,20.0,6.0,19.0,52.0,36.5,33.0,29.0,2.0,27.0,7.0,47.0,5.0,0.0,Matches,486.0,fr FRA,FWMF,29.0,14.7,40.0,2.73,29.0,0.0,2.0,5.0,4.0,0.0,7.0,0.48,2.0,0.0,1.0,2.0,2.0,0.0,Matches,,,,,,,,,,,,,,,,,,,,,,,,,,,,,,,,,,,,,,,,,,,,,,,,,,,,,,,,486.0,fr FRA,FWMF,29.0,14.7,4.0,0.0,0.0,25.0,25.0,6.0,21.0,7.0,23.0,0.0,0.0,0.0,54.0,56.0,78.0,41.8,Matches,486.0,fr FRA,FWMF,29.0,14.7,468.0,441.0,26.0,1.0,1.0,1.0,21.0,13.0,0.0,0.0,0.0,0.0,317.0,1.0,14.0,Matches,486.0,fr FRA,FWMF,29.0,14.7,317.0,468.0,67.7,4449.0,1022.0,176.0,234.0,75.2,108.0,158.0,68.4,11.0,28.0,39.3,1.0,1.9,0.7,-0.9,21.0,27.0,10.0,1.0,47.0,Matches,581,fr FRA,FWMF,29,26,1320.0,51.0,38.6,14.7,15,72.0,4,11,22.0,2,0.73,19.0,28.0,-9.0,-0.61,0.54,15.8,24.1,-8.3,-0.57,0.75,Matches,486.0,fr FRA,FWMF,29.0,14.7,689.0,13.0,85.0,336.0,278.0,55.0,689.0,42.0,11.0,26.2,26.0,61.9,471.0,2766.0,1121.0,28.0,17.0,8.0,31.0,20.0,481.0,104.0,Matches,486.0,fr FRA,FWMF,29.0,14.7,4.0,39.0,14.0,35.9,2.66,0.95,0.1,0.29,16.0,0.0,0.0,0.0,3.5,3.5,0.09,0.5,0.5,Matches,486.0,fr FRA,FWMF,29.0,26.0,15.0,1320.0,14.7,4.0,1.0,5.0,4.0,0.0,0.0,4.0,0.0,3.5,3.5,1.9,5.4,28.0,47.0,104.0,0.27,0.07,0.34,0.27,0.34,0.24,0.13,0.37,0.24,0.37,Matches,Renaud Ripart,AM/S RL,29,125,130,France,ESTAC Troyes,5,11,11,13,13,7,14,12,4,7,10,12,5,12,11,12,13,13,13,8,12,17,10,13,12,8,16,15,12,12,15,12,15,12,16,14,12,5,12,7,13,1,2,2,1,2,3,2,1,2,3,3,10,13,5,16,10,14,14,12,1,7,1,12,1,5,1,15,1,15,19,1,17,20,181,73,8,20,3309989,6246,6246,3758,Northern_European,119,6,1993/3/14,0,0,12657.0,,29114948
1019,Joe Rodon,Rennes,1997,487.0,wls WAL,DF,24.0,15.7,11.0,7.0,9.0,2.0,0.0,4.0,10.0,40.0,6.0,16.0,12.0,4.0,9.0,20.0,54.0,1.0,Matches,487.0,wls WAL,DF,24.0,15.7,3.0,0.19,3.0,0.0,0.0,0.0,0.0,0.0,0.0,0.0,0.0,0.0,0.0,0.0,0.0,0.0,Matches,,,,,,,,,,,,,,,,,,,,,,,,,,,,,,,,,,,,,,,,,,,,,,,,,,,,,,,,487.0,wls WAL,DF,24.0,15.7,2.0,1.0,0.0,11.0,18.0,0.0,1.0,9.0,7.0,0.0,0.0,0.0,76.0,44.0,30.0,59.5,Matches,487.0,wls WAL,DF,24.0,15.7,1051.0,1040.0,10.0,10.0,0.0,3.0,1.0,0.0,0.0,0.0,0.0,0.0,945.0,1.0,3.0,Matches,487.0,wls WAL,DF,24.0,15.7,945.0,1051.0,89.9,19753.0,5513.0,181.0,214.0,84.6,661.0,697.0,94.8,90.0,118.0,76.3,0.0,0.0,0.2,0.0,1.0,39.0,0.0,0.0,49.0,Matches,584,wls WAL,DF,24,16,1417.0,89.0,41.4,15.7,16,89.0,14,0,,17,1.69,32.0,17.0,15.0,0.95,0.28,25.4,17.5,7.9,0.5,0.08,Matches,487.0,wls WAL,DF,24.0,15.7,1175.0,96.0,487.0,667.0,25.0,13.0,1175.0,3.0,3.0,100.0,0.0,0.0,920.0,4658.0,2308.0,5.0,3.0,0.0,5.0,2.0,863.0,0.0,Matches,487.0,wls WAL,DF,24.0,15.7,1.0,7.0,2.0,28.6,0.44,0.13,0.14,0.5,6.9,0.0,0.0,0.0,0.9,0.9,0.13,0.1,0.1,Matches,487.0,wls WAL,DF,24.0,16.0,16.0,1417.0,15.7,1.0,0.0,1.0,1.0,0.0,0.0,2.0,1.0,0.9,0.9,0.0,0.9,5.0,49.0,0.0,0.06,0.0,0.06,0.06,0.06,0.06,0.0,0.06,0.06,0.06,Matches,Joe Rodon,D C,24,135,144,Wales,Tottenham Hotspur,4,7,9,5,11,3,14,4,10,13,11,5,14,12,13,14,16,12,12,10,13,15,9,13,9,13,14,14,13,13,11,16,12,14,13,15,14,6,12,14,5,2,3,1,1,2,1,2,3,1,3,3,8,15,8,10,8,14,11,10,1,1,20,5,1,1,1,1,1,1,1,1,1,1,193,76,13,20,11563463,6750,7250,5400,Northern_European,135,1,1997/10/22,28,0,27838.0,Stade Rennais FC,28100477
1020,Valentin Rongier,Marseille,1994,488.0,fr FRA,MF,27.0,33.7,93.0,59.0,33.0,47.0,13.0,41.0,77.0,53.2,36.0,50.0,11.0,39.0,54.0,147.0,38.0,1.0,Matches,488.0,fr FRA,MF,27.0,33.7,72.0,2.14,64.0,0.0,3.0,1.0,1.0,3.0,5.0,0.15,4.0,0.0,0.0,0.0,0.0,1.0,Matches,,,,,,,,,,,,,,,,,,,,,,,,,,,,,,,,,,,,,,,,,,,,,,,,,,,,,,,,488.0,fr FRA,MF,27.0,33.7,8.0,0.0,0.0,52.0,29.0,0.0,8.0,54.0,59.0,0.0,0.0,0.0,267.0,43.0,30.0,58.9,Matches,488.0,fr FRA,MF,27.0,33.7,2109.0,2055.0,47.0,40.0,6.0,16.0,8.0,7.0,0.0,0.0,0.0,0.0,1855.0,7.0,22.0,Matches,488.0,fr FRA,MF,27.0,33.7,1855.0,2109.0,88.0,31535.0,9032.0,808.0,898.0,90.0,821.0,888.0,92.5,147.0,197.0,74.6,2.0,2.7,3.1,-0.7,32.0,224.0,34.0,2.0,238.0,Matches,585,fr FRA,MF,27,36,3032.0,84.0,88.7,33.7,34,87.0,29,2,35.0,0,1.94,56.0,37.0,19.0,0.56,-1.29,55.8,39.3,16.4,0.49,-0.99,Matches,488.0,fr FRA,MF,27.0,33.7,2455.0,86.0,506.0,1464.0,505.0,41.0,2455.0,45.0,29.0,64.4,15.0,33.3,1889.0,11394.0,5460.0,57.0,52.0,9.0,31.0,30.0,1709.0,72.0,Matches,488.0,fr FRA,MF,27.0,33.7,1.0,22.0,4.0,18.2,0.65,0.12,0.05,0.25,20.0,0.0,0.0,0.0,1.7,1.7,0.08,-0.7,-0.7,Matches,488.0,fr FRA,MF,27.0,36.0,34.0,3032.0,33.7,1.0,2.0,3.0,1.0,0.0,0.0,8.0,0.0,1.7,1.7,2.7,4.4,57.0,238.0,72.0,0.03,0.06,0.09,0.03,0.09,0.05,0.08,0.13,0.05,0.13,Matches,Valentin Rongier,DM/M C,27,137,143,France,Olympique de Marseille,11,10,13,9,14,11,8,10,7,13,15,10,15,13,11,15,14,14,14,14,13,16,11,14,14,13,16,17,12,13,16,8,12,13,15,12,14,10,12,8,13,2,3,3,1,1,4,3,4,3,2,1,12,15,8,14,12,14,14,12,1,1,1,12,1,12,16,1,20,12,1,13,10,1,172,70,8,20,14141150,6845,6845,4995,Northern_European,139,5,1994/12/7,0,0,55630.0,,85085142
1021,Pablo Rosario,Nice,1997,489.0,nl NED,MFDF,25.0,19.6,46.0,26.0,22.0,20.0,4.0,18.0,34.0,52.9,16.0,15.0,5.0,10.0,23.0,69.0,32.0,1.0,Matches,489.0,nl NED,MFDF,25.0,19.6,42.0,2.14,34.0,3.0,3.0,1.0,1.0,0.0,2.0,0.1,1.0,0.0,0.0,1.0,0.0,0.0,Matches,,,,,,,,,,,,,,,,,,,,,,,,,,,,,,,,,,,,,,,,,,,,,,,,,,,,,,,,489.0,nl NED,MFDF,25.0,19.6,6.0,0.0,0.0,18.0,13.0,0.0,11.0,23.0,26.0,0.0,0.0,0.0,97.0,16.0,22.0,42.1,Matches,489.0,nl NED,MFDF,25.0,19.6,1049.0,1022.0,25.0,17.0,1.0,3.0,11.0,8.0,0.0,0.0,0.0,0.0,930.0,2.0,9.0,Matches,489.0,nl NED,MFDF,25.0,19.6,930.0,1049.0,88.7,16595.0,5260.0,377.0,412.0,91.5,431.0,470.0,91.7,95.0,124.0,76.6,1.0,1.8,1.0,-0.8,19.0,84.0,15.0,3.0,112.0,Matches,586,nl NED,MFDF,25,31,1767.0,57.0,51.7,19.6,17,83.0,11,14,26.0,6,1.58,22.0,26.0,-4.0,-0.2,-1.02,28.2,23.5,4.7,0.24,-0.19,Matches,489.0,nl NED,MFDF,25.0,19.6,1227.0,71.0,357.0,693.0,184.0,16.0,1227.0,19.0,7.0,36.8,10.0,52.6,940.0,4523.0,2232.0,18.0,19.0,0.0,22.0,11.0,885.0,42.0,Matches,489.0,nl NED,MFDF,25.0,19.6,0.0,10.0,2.0,20.0,0.51,0.1,0.0,0.0,16.3,0.0,0.0,0.0,0.9,0.9,0.09,-0.9,-0.9,Matches,489.0,nl NED,MFDF,25.0,31.0,17.0,1767.0,19.6,0.0,1.0,1.0,0.0,0.0,0.0,6.0,0.0,0.9,0.9,1.8,2.7,18.0,112.0,42.0,0.0,0.05,0.05,0.0,0.05,0.05,0.09,0.14,0.05,0.14,Matches,Pablo Rosario,DM/M C,25,138,145,"Holland,Dominican Republic",OGC Nice,10,8,11,7,12,10,13,8,9,14,13,8,13,13,15,12,16,13,15,14,13,14,11,14,14,13,16,16,12,13,15,13,16,12,15,14,15,13,14,7,16,3,1,2,2,1,1,3,3,1,3,1,13,11,4,14,16,14,14,13,1,1,15,11,1,1,18,10,20,11,1,1,1,1,188,83,12,20,10204817,6800,6800,5100,African_Caribbean,135,13,1997/1/7,1,0,26087.0,,37057370
1022,Anthony Rouault,Toulouse,2001,490.0,fr FRA,DF,21.0,36.8,66.0,37.0,54.0,10.0,2.0,30.0,58.0,51.7,28.0,52.0,26.0,26.0,56.0,122.0,126.0,4.0,Matches,490.0,fr FRA,DF,21.0,36.8,13.0,0.35,10.0,0.0,0.0,2.0,0.0,1.0,1.0,0.03,0.0,0.0,0.0,1.0,0.0,0.0,Matches,,,,,,,,,,,,,,,,,,,,,,,,,,,,,,,,,,,,,,,,,,,,,,,,,,,,,,,,490.0,fr FRA,DF,21.0,36.8,4.0,1.0,1.0,21.0,17.0,1.0,0.0,56.0,37.0,0.0,0.0,1.0,213.0,86.0,64.0,57.3,Matches,490.0,fr FRA,DF,21.0,36.8,2063.0,1923.0,138.0,67.0,1.0,23.0,0.0,12.0,0.0,0.0,0.0,0.0,1802.0,2.0,14.0,Matches,490.0,fr FRA,DF,21.0,36.8,1802.0,2063.0,87.3,34985.0,13356.0,621.0,677.0,91.7,941.0,1003.0,93.8,208.0,329.0,63.2,1.0,0.8,0.5,0.2,6.0,113.0,6.0,0.0,136.0,Matches,587,fr FRA,DF,21,37,3314.0,90.0,96.9,36.8,37,90.0,35,0,,1,1.27,51.0,55.0,-4.0,-0.11,1.59,51.7,54.0,-2.4,-0.06,1.75,Matches,490.0,fr FRA,DF,21.0,36.8,2451.0,369.0,1282.0,1113.0,69.0,33.0,2451.0,10.0,3.0,30.0,5.0,50.0,1683.0,8531.0,4632.0,10.0,8.0,1.0,23.0,5.0,1513.0,6.0,Matches,490.0,fr FRA,DF,21.0,36.8,2.0,19.0,10.0,52.6,0.52,0.27,0.11,0.2,9.0,0.0,0.0,0.0,3.3,3.3,0.17,-1.3,-1.3,Matches,490.0,fr FRA,DF,21.0,37.0,37.0,3314.0,36.8,2.0,1.0,3.0,2.0,0.0,0.0,4.0,1.0,3.3,3.3,0.8,4.1,10.0,136.0,6.0,0.05,0.03,0.08,0.05,0.08,0.09,0.02,0.11,0.09,0.11,Matches,Anthony Rouault,D C,21,120,156,France,Toulouse FC,4,6,10,5,12,4,14,5,4,13,13,12,13,13,11,13,12,11,12,11,12,15,12,12,12,13,13,12,12,13,12,15,14,13,13,12,13,4,14,6,10,3,3,1,1,3,1,2,4,1,4,1,13,15,3,14,11,15,14,20,1,1,20,1,1,1,1,1,1,1,1,1,1,1,186,77,8,20,7987999,6000,6000,3018,Northern_European,120,2,2001/5/29,0,0,2749.0,,49047179
1023,Falaye Sacko,Montpellier,1995,494.0,ml MLI,DF,27.0,28.7,46.0,25.0,25.0,15.0,6.0,32.0,51.0,62.7,19.0,43.0,14.0,29.0,33.0,79.0,75.0,1.0,Matches,494.0,ml MLI,DF,27.0,28.7,38.0,1.33,33.0,2.0,2.0,0.0,0.0,1.0,7.0,0.24,6.0,0.0,0.0,0.0,0.0,1.0,Matches,,,,,,,,,,,,,,,,,,,,,,,,,,,,,,,,,,,,,,,,,,,,,,,,,,,,,,,,494.0,ml MLI,DF,27.0,28.7,3.0,0.0,0.0,26.0,19.0,5.0,36.0,33.0,25.0,0.0,3.0,1.0,179.0,17.0,18.0,48.6,Matches,494.0,ml MLI,DF,27.0,28.7,1240.0,1033.0,204.0,23.0,2.0,1.0,36.0,180.0,1.0,0.0,0.0,0.0,999.0,3.0,27.0,Matches,494.0,ml MLI,DF,27.0,28.7,999.0,1240.0,80.6,15965.0,5374.0,499.0,565.0,88.3,392.0,467.0,83.9,72.0,142.0,50.7,3.0,1.1,1.2,1.9,19.0,57.0,11.0,4.0,76.0,Matches,592,ml MLI,DF,27,35,2580.0,74.0,75.4,28.7,29,86.0,23,6,15.0,3,1.34,57.0,45.0,12.0,0.42,1.38,41.7,49.6,-7.9,-0.28,-0.06,Matches,494.0,ml MLI,DF,27.0,28.7,1503.0,135.0,519.0,692.0,315.0,29.0,1503.0,36.0,17.0,47.2,15.0,41.7,962.0,6066.0,2873.0,50.0,36.0,6.0,33.0,13.0,820.0,70.0,Matches,494.0,ml MLI,DF,27.0,28.7,1.0,6.0,2.0,33.3,0.21,0.07,0.17,0.5,16.7,0.0,0.0,0.0,0.8,0.8,0.13,0.2,0.2,Matches,494.0,ml MLI,DF,27.0,35.0,29.0,2580.0,28.7,1.0,3.0,4.0,1.0,0.0,0.0,3.0,0.0,0.8,0.8,1.1,1.9,50.0,76.0,70.0,0.03,0.1,0.14,0.03,0.14,0.03,0.04,0.07,0.03,0.07,Matches,Falaye Sacko,D/WB R,27,130,136,Mali,Vitória Sport Clube,10,12,13,8,12,9,8,10,9,11,13,9,13,14,12,15,11,12,13,13,11,12,13,7,13,10,11,13,17,15,12,10,15,16,14,7,12,9,8,9,12,3,1,2,3,2,3,1,2,1,2,3,12,12,5,13,8,14,12,11,1,1,12,20,1,16,1,1,1,1,1,1,1,1,179,67,9,20,2356198,6500,6500,5000,African_Caribbean,125,16,1995/5/1,28,1,3015.0,Montpellier Hérault SC,13162801
1024,Hamza Sakhi,Auxerre,1996,497.0,fr FRA,MF,26.0,18.4,44.0,22.0,22.0,17.0,5.0,22.0,42.0,52.4,20.0,16.0,1.0,15.0,25.0,69.0,9.0,0.0,Matches,497.0,fr FRA,MF,26.0,18.4,71.0,3.86,57.0,8.0,1.0,3.0,2.0,0.0,3.0,0.16,3.0,0.0,0.0,0.0,0.0,0.0,Matches,,,,,,,,,,,,,,,,,,,,,,,,,,,,,,,,,,,,,,,,,,,,,,,,,,,,,,,,497.0,fr FRA,MF,26.0,18.4,1.0,0.0,0.0,13.0,21.0,5.0,88.0,25.0,22.0,0.0,0.0,0.0,106.0,6.0,3.0,66.7,Matches,497.0,fr FRA,MF,26.0,18.4,947.0,866.0,73.0,33.0,4.0,23.0,88.0,1.0,37.0,12.0,20.0,0.0,756.0,8.0,14.0,Matches,497.0,fr FRA,MF,26.0,18.4,756.0,947.0,79.8,14936.0,4518.0,281.0,316.0,88.9,296.0,351.0,84.3,141.0,216.0,65.3,2.0,3.2,3.3,-1.2,37.0,102.0,22.0,7.0,135.0,Matches,597,fr FRA,MF,26,27,1658.0,61.0,48.5,18.4,18,83.0,8,9,19.0,7,0.63,16.0,40.0,-24.0,-1.3,-1.1,21.6,25.7,-4.0,-0.22,0.38,Matches,497.0,fr FRA,MF,26.0,18.4,1112.0,20.0,171.0,614.0,342.0,28.0,1112.0,27.0,15.0,55.6,6.0,22.2,834.0,5023.0,2110.0,43.0,37.0,3.0,20.0,13.0,779.0,75.0,Matches,497.0,fr FRA,MF,26.0,18.4,1.0,30.0,9.0,30.0,1.63,0.49,0.03,0.11,24.1,2.0,0.0,0.0,1.7,1.7,0.06,-0.7,-0.7,Matches,497.0,fr FRA,MF,26.0,27.0,18.0,1658.0,18.4,1.0,2.0,3.0,1.0,0.0,0.0,1.0,0.0,1.7,1.7,3.2,4.9,43.0,135.0,75.0,0.05,0.11,0.16,0.05,0.16,0.09,0.17,0.27,0.09,0.27,Matches,Hamza Sakhi,M/AM C,26,121,127,"Morocco,France",AJ Auxerre,13,12,14,12,14,13,6,12,5,7,15,12,8,15,10,12,12,13,12,13,12,10,13,8,13,10,14,12,13,14,12,7,12,13,13,9,12,6,11,10,14,4,1,3,2,2,2,3,3,1,2,3,8,12,7,13,10,12,5,12,1,1,1,1,1,1,1,1,17,1,14,20,14,10,176,69,8,20,2148380,6050,6050,3600,North_African__Middle_Eastern,123,9,1996/6/7,0,0,4315.0,,85121620
1025,Amine Salama,Angers,2000,500.0,fr FRA,FWMF,22.0,13.9,11.0,9.0,3.0,7.0,1.0,2.0,12.0,16.7,10.0,8.0,2.0,6.0,10.0,21.0,2.0,0.0,Matches,500.0,fr FRA,FWMF,22.0,13.9,27.0,1.94,18.0,0.0,4.0,3.0,2.0,0.0,1.0,0.07,1.0,0.0,0.0,0.0,0.0,0.0,Matches,,,,,,,,,,,,,,,,,,,,,,,,,,,,,,,,,,,,,,,,,,,,,,,,,,,,,,,,500.0,fr FRA,FWMF,22.0,13.9,1.0,0.0,0.0,7.0,9.0,6.0,12.0,10.0,9.0,0.0,0.0,0.0,51.0,8.0,19.0,29.6,Matches,500.0,fr FRA,FWMF,22.0,13.9,321.0,303.0,16.0,0.0,2.0,0.0,12.0,0.0,0.0,0.0,0.0,0.0,236.0,2.0,10.0,Matches,500.0,fr FRA,FWMF,22.0,13.9,236.0,321.0,73.5,3246.0,780.0,133.0,171.0,77.8,72.0,99.0,72.7,8.0,11.0,72.7,1.0,1.5,1.9,-0.5,9.0,17.0,12.0,2.0,21.0,Matches,600,fr FRA,FWMF,22,25,1249.0,50.0,36.5,13.9,12,78.0,4,13,24.0,2,0.16,10.0,28.0,-18.0,-1.3,-0.05,17.5,20.7,-3.2,-0.23,0.5,Matches,500.0,fr FRA,FWMF,22.0,13.9,484.0,6.0,51.0,232.0,215.0,48.0,484.0,56.0,22.0,39.3,31.0,55.4,360.0,2756.0,1060.0,35.0,19.0,16.0,48.0,19.0,351.0,94.0,Matches,500.0,fr FRA,FWMF,22.0,13.9,3.0,25.0,11.0,44.0,1.8,0.79,0.12,0.27,15.2,1.0,0.0,0.0,3.0,3.0,0.12,0.0,0.0,Matches,500.0,fr FRA,FWMF,22.0,25.0,12.0,1249.0,13.9,3.0,1.0,4.0,3.0,0.0,0.0,1.0,0.0,3.0,3.0,1.5,4.5,35.0,21.0,94.0,0.22,0.07,0.29,0.22,0.29,0.22,0.11,0.33,0.22,0.33,Matches,Amine Salama,S,22,109,135,"France,Morocco",Angers SCO,11,10,13,11,13,10,15,10,5,5,12,10,6,13,5,10,11,10,11,13,10,15,13,7,12,7,10,10,13,11,12,16,12,13,11,12,10,5,10,5,12,2,1,4,1,1,2,2,2,2,3,2,18,14,6,11,13,12,12,10,1,1,1,1,1,1,1,1,1,1,14,1,14,20,192,0,8,20,1327999,5449,5449,2999,North_African__Middle_Eastern,108,8,2000/7/18,0,0,3066.0,,2000180911
1026,Yoann Salmier,Troyes,1992,501.0,gf GUF,DF,29.0,29.4,51.0,29.0,34.0,12.0,5.0,21.0,35.0,60.0,14.0,34.0,19.0,15.0,39.0,90.0,124.0,0.0,Matches,501.0,gf GUF,DF,29.0,29.4,22.0,0.75,18.0,0.0,0.0,2.0,1.0,1.0,5.0,0.17,4.0,0.0,0.0,0.0,1.0,0.0,Matches,,,,,,,,,,,,,,,,,,,,,,,,,,,,,,,,,,,,,,,,,,,,,,,,,,,,,,,,501.0,gf GUF,DF,29.0,29.4,5.0,1.0,0.0,30.0,28.0,0.0,7.0,39.0,29.0,1.0,2.0,0.0,181.0,54.0,32.0,62.8,Matches,501.0,gf GUF,DF,29.0,29.4,1456.0,1398.0,53.0,42.0,1.0,16.0,7.0,7.0,0.0,0.0,0.0,0.0,1198.0,5.0,13.0,Matches,501.0,gf GUF,DF,29.0,29.4,1198.0,1456.0,82.3,21721.0,8653.0,485.0,543.0,89.3,552.0,620.0,89.0,121.0,235.0,51.5,0.0,0.4,0.4,-0.4,5.0,108.0,1.0,0.0,121.0,Matches,602,gf GUF,DF,29,32,2646.0,83.0,77.4,29.4,31,85.0,25,1,8.0,2,0.72,39.0,65.0,-26.0,-0.88,0.28,32.0,55.7,-23.7,-0.81,0.97,Matches,501.0,gf GUF,DF,29.0,29.4,1764.0,252.0,871.0,821.0,89.0,20.0,1764.0,13.0,6.0,46.2,5.0,38.5,1235.0,7197.0,3568.0,24.0,23.0,3.0,9.0,7.0,1082.0,9.0,Matches,501.0,gf GUF,DF,29.0,29.4,1.0,14.0,3.0,21.4,0.48,0.1,0.07,0.33,16.6,0.0,0.0,0.0,1.2,1.2,0.08,-0.2,-0.2,Matches,501.0,gf GUF,DF,29.0,32.0,31.0,2646.0,29.4,1.0,0.0,1.0,1.0,0.0,0.0,5.0,1.0,1.2,1.2,0.4,1.6,24.0,121.0,9.0,0.03,0.0,0.03,0.03,0.03,0.04,0.02,0.05,0.04,0.05,Matches,Yoann Salmier,D C,29,124,130,"French Guiana,France",ESTAC Troyes,4,9,9,7,12,6,14,8,9,13,11,8,13,11,14,13,13,11,13,10,12,13,8,10,9,13,13,13,11,12,14,14,15,12,14,17,12,10,12,7,10,1,4,2,1,2,2,2,2,1,2,3,10,12,9,14,12,12,11,11,1,1,20,12,1,1,1,1,1,1,1,1,1,1,188,85,8,20,2733631,6200,6200,3509,African_Caribbean,124,14,1992/11/21,2,0,9541.0,,49031215
1027,Brice Samba,Lens,1994,503.0,fr FRA,GK,28.0,37.0,1.0,0.0,1.0,0.0,0.0,1.0,2.0,50.0,1.0,1.0,0.0,1.0,0.0,1.0,12.0,2.0,Matches,503.0,fr FRA,GK,28.0,37.0,3.0,0.08,3.0,0.0,0.0,0.0,0.0,0.0,0.0,0.0,0.0,0.0,0.0,0.0,0.0,0.0,Matches,38.0,fr FRA,GK,28.0,37.0,28.0,3.0,0.0,6.0,1.0,32.4,0.24,5.4,0.15,174.0,435.0,40.0,1075.0,140.0,35.5,33.3,160.0,33.1,32.7,384.0,34.0,8.9,41.0,1.11,15.4,Matches,38.0,fr FRA,GK,28.0,37.0,37.0,3330.0,37.0,28.0,0.76,125.0,98.0,80.0,24.0,9.0,4.0,15.0,40.5,3.0,3.0,0.0,0.0,0.0,Matches,503.0,fr FRA,GK,28.0,37.0,3.0,0.0,0.0,0.0,6.0,0.0,0.0,0.0,0.0,0.0,0.0,0.0,42.0,8.0,2.0,80.0,Matches,503.0,fr FRA,GK,28.0,37.0,1237.0,985.0,250.0,90.0,0.0,12.0,0.0,0.0,0.0,0.0,0.0,0.0,938.0,2.0,1.0,Matches,503.0,fr FRA,GK,28.0,37.0,938.0,1237.0,75.8,25038.0,16717.0,208.0,209.0,99.5,395.0,402.0,98.3,320.0,607.0,52.7,0.0,0.1,0.0,-0.1,1.0,17.0,1.0,0.0,1.0,Matches,604,fr FRA,GK,28,37,3330.0,90.0,97.4,37.0,37,90.0,37,0,,1,2.19,65.0,28.0,37.0,1.0,-1.0,64.0,40.2,23.7,0.64,1.14,Matches,503.0,fr FRA,GK,28.0,37.0,1307.0,942.0,1291.0,18.0,0.0,0.0,1307.0,1.0,1.0,100.0,0.0,0.0,987.0,5296.0,3117.0,0.0,0.0,0.0,1.0,0.0,712.0,0.0,Matches,503.0,fr FRA,GK,28.0,37.0,0.0,0.0,0.0,,0.0,0.0,,,,0.0,0.0,0.0,0.0,0.0,,0.0,0.0,Matches,503.0,fr FRA,GK,28.0,37.0,37.0,3330.0,37.0,0.0,0.0,0.0,0.0,0.0,0.0,3.0,0.0,0.0,0.0,0.1,0.1,0.0,1.0,0.0,0.0,0.0,0.0,0.0,0.0,0.0,0.0,0.0,0.0,0.0,Matches,Brice Samba,GK,28,130,131,"France,Congo",RC Lens,4,2,1,6,10,6,2,11,1,2,12,8,1,10,8,12,14,13,13,11,11,12,6,9,3,12,13,8,10,14,15,15,15,10,14,15,11,8,10,5,1,14,12,12,12,13,13,14,15,8,10,11,11,13,6,10,12,10,15,15,20,1,1,1,1,1,1,1,1,1,1,1,1,1,187,90,20,9,9787271,6490,6490,3791,African_Caribbean,128,15,1994/4/25,0,0,19999.0,,85073883
1028,Alexis Sánchez,Marseille,1988,505.0,cl CHI,FWMF,33.0,29.8,27.0,17.0,5.0,16.0,6.0,3.0,24.0,12.5,21.0,14.0,0.0,14.0,5.0,32.0,6.0,0.0,Matches,505.0,cl CHI,FWMF,33.0,29.8,116.0,3.9,87.0,2.0,5.0,10.0,11.0,1.0,11.0,0.37,5.0,0.0,1.0,3.0,2.0,0.0,Matches,,,,,,,,,,,,,,,,,,,,,,,,,,,,,,,,,,,,,,,,,,,,,,,,,,,,,,,,505.0,cl CHI,FWMF,33.0,29.8,3.0,0.0,0.0,44.0,46.0,28.0,37.0,5.0,17.0,1.0,0.0,0.0,83.0,35.0,70.0,33.3,Matches,505.0,cl CHI,FWMF,33.0,29.8,934.0,865.0,59.0,6.0,14.0,19.0,37.0,1.0,11.0,6.0,0.0,0.0,681.0,10.0,26.0,Matches,505.0,cl CHI,FWMF,33.0,29.8,681.0,934.0,72.9,11500.0,2775.0,320.0,426.0,75.1,238.0,306.0,77.8,76.0,105.0,72.4,3.0,5.8,5.1,-2.8,55.0,65.0,64.0,5.0,127.0,Matches,606,cl CHI,FWMF,33,35,2679.0,77.0,78.3,29.8,32,80.0,11,3,41.0,2,1.89,51.0,27.0,24.0,0.81,0.44,51.8,32.3,19.5,0.65,0.25,Matches,505.0,cl CHI,FWMF,33.0,29.8,1234.0,7.0,69.0,513.0,663.0,145.0,1231.0,82.0,43.0,52.4,32.0,39.0,950.0,4916.0,1398.0,42.0,24.0,20.0,85.0,62.0,961.0,232.0,Matches,505.0,cl CHI,FWMF,33.0,29.8,14.0,63.0,29.0,46.0,2.12,0.97,0.19,0.41,15.2,5.0,2.0,3.0,12.6,10.2,0.17,1.4,1.8,Matches,505.0,cl CHI,FWMF,33.0,35.0,32.0,2679.0,29.8,14.0,3.0,17.0,12.0,2.0,3.0,3.0,0.0,12.6,10.2,5.8,16.0,42.0,127.0,232.0,0.47,0.1,0.57,0.4,0.5,0.42,0.2,0.62,0.34,0.54,Matches,Alexis Sánchez,S,33,140,175,Chile,Olympique de Marseille,12,13,15,13,17,14,14,13,3,3,15,13,4,17,13,13,15,12,12,15,14,14,16,12,16,5,12,15,15,16,12,10,15,15,11,8,14,8,15,14,12,3,2,3,1,1,3,3,2,1,2,4,18,17,6,8,15,13,13,13,1,1,1,1,1,1,1,8,1,8,12,13,12,20,169,70,10,20,3999591,7000,8420,6266,Mediterranean_Hispanic,141,11,1988/12/19,148,48,35281.0,,75000261
1029,Morgan Sanson,Strasbourg,1994,506.0,fr FRA,MF,27.0,15.8,36.0,25.0,10.0,16.0,10.0,17.0,56.0,30.4,39.0,21.0,1.0,20.0,22.0,58.0,9.0,0.0,Matches,506.0,fr FRA,MF,27.0,15.8,48.0,3.05,34.0,3.0,1.0,6.0,2.0,2.0,5.0,0.32,3.0,0.0,0.0,1.0,0.0,1.0,Matches,,,,,,,,,,,,,,,,,,,,,,,,,,,,,,,,,,,,,,,,,,,,,,,,,,,,,,,,506.0,fr FRA,MF,27.0,15.8,1.0,0.0,0.0,21.0,34.0,0.0,35.0,22.0,25.0,0.0,0.0,0.0,104.0,14.0,13.0,51.9,Matches,506.0,fr FRA,MF,27.0,15.8,620.0,578.0,36.0,22.0,6.0,4.0,35.0,3.0,10.0,2.0,5.0,0.0,480.0,6.0,16.0,Matches,506.0,fr FRA,MF,27.0,15.8,480.0,620.0,77.4,8228.0,2377.0,221.0,259.0,85.3,185.0,230.0,80.4,52.0,89.0,58.4,2.0,2.1,2.2,-0.1,18.0,67.0,16.0,3.0,60.0,Matches,607,fr FRA,MF,27,18,1419.0,79.0,41.5,15.8,18,79.0,6,0,,0,1.39,25.0,22.0,3.0,0.19,0.69,22.1,14.8,7.4,0.47,1.1,Matches,506.0,fr FRA,MF,27.0,15.8,843.0,11.0,115.0,479.0,265.0,36.0,843.0,46.0,17.0,37.0,19.0,41.3,641.0,4176.0,1880.0,43.0,49.0,12.0,34.0,23.0,585.0,70.0,Matches,506.0,fr FRA,MF,27.0,15.8,1.0,32.0,8.0,25.0,2.03,0.51,0.03,0.13,19.7,1.0,0.0,0.0,3.1,3.1,0.1,-2.1,-2.1,Matches,506.0,fr FRA,MF,27.0,18.0,18.0,1419.0,15.8,1.0,2.0,3.0,1.0,0.0,0.0,1.0,0.0,3.1,3.1,2.1,5.3,43.0,60.0,70.0,0.06,0.13,0.19,0.06,0.19,0.2,0.14,0.34,0.2,0.34,Matches,Morgan Sanson,M/AM C,27,136,145,France,Aston Villa,12,13,14,11,15,13,8,13,5,8,15,10,11,14,13,14,12,14,12,15,13,14,14,10,13,10,16,15,14,14,15,8,14,14,14,12,10,8,11,14,11,1,3,1,2,2,2,3,3,2,2,2,7,15,9,16,14,15,14,15,1,1,1,1,1,1,13,13,20,13,13,17,13,1,180,73,8,20,21278174,6799,6949,5499,Northern_European,137,6,1994/8/18,0,0,69595.0,,85046988
1030,Baptiste Santamaria,Rennes,1995,507.0,fr FRA,MF,27.0,20.1,41.0,22.0,13.0,23.0,5.0,21.0,41.0,51.2,20.0,21.0,5.0,16.0,21.0,62.0,23.0,0.0,Matches,507.0,fr FRA,MF,27.0,20.1,37.0,1.84,35.0,0.0,0.0,2.0,0.0,0.0,1.0,0.05,1.0,0.0,0.0,0.0,0.0,0.0,Matches,,,,,,,,,,,,,,,,,,,,,,,,,,,,,,,,,,,,,,,,,,,,,,,,,,,,,,,,507.0,fr FRA,MF,27.0,20.1,2.0,0.0,0.0,23.0,20.0,1.0,7.0,21.0,22.0,0.0,0.0,0.0,173.0,60.0,40.0,60.0,Matches,507.0,fr FRA,MF,27.0,20.1,1317.0,1280.0,35.0,35.0,1.0,12.0,7.0,0.0,0.0,0.0,0.0,0.0,1119.0,2.0,19.0,Matches,507.0,fr FRA,MF,27.0,20.1,1119.0,1317.0,85.0,21674.0,5252.0,410.0,476.0,86.1,515.0,583.0,88.3,162.0,204.0,79.4,0.0,0.7,1.3,-0.7,12.0,125.0,8.0,0.0,141.0,Matches,608,fr FRA,MF,27,25,1813.0,73.0,53.0,20.1,20,84.0,16,5,25.0,1,1.68,36.0,21.0,15.0,0.74,-0.1,32.1,22.8,9.3,0.46,0.02,Matches,507.0,fr FRA,MF,27.0,20.1,1499.0,41.0,271.0,1023.0,218.0,16.0,1499.0,17.0,9.0,52.9,7.0,41.2,1122.0,5728.0,2726.0,17.0,37.0,1.0,30.0,11.0,1024.0,21.0,Matches,507.0,fr FRA,MF,27.0,20.1,2.0,19.0,8.0,42.1,0.94,0.4,0.11,0.25,23.2,0.0,0.0,0.0,1.1,1.1,0.06,0.9,0.9,Matches,507.0,fr FRA,MF,27.0,25.0,20.0,1813.0,20.1,2.0,0.0,2.0,2.0,0.0,0.0,2.0,0.0,1.1,1.1,0.7,1.8,17.0,141.0,21.0,0.1,0.0,0.1,0.1,0.1,0.06,0.03,0.09,0.06,0.09,Matches,Baptiste Santamaria,DM/M C,27,138,142,France,Stade Rennais FC,11,11,13,10,14,10,12,10,5,11,14,9,12,13,15,13,13,12,13,15,13,15,14,13,14,10,15,13,14,14,14,11,15,13,16,13,13,10,12,6,15,3,1,3,3,3,1,1,2,4,3,1,12,15,8,13,12,16,13,11,1,1,1,1,1,1,19,12,20,12,12,15,14,1,183,81,8,20,17223332,6900,6900,4255,Northern_European,134,5,1995/3/9,0,0,14999.0,,211515
1031,Téji Savanier,Montpellier,1991,512.0,fr FRA,MF,30.0,28.3,46.0,30.0,16.0,19.0,11.0,23.0,70.0,32.9,47.0,30.0,2.0,28.0,30.0,76.0,12.0,1.0,Matches,512.0,fr FRA,MF,30.0,28.3,130.0,4.6,63.0,41.0,11.0,1.0,14.0,0.0,11.0,0.39,6.0,4.0,0.0,0.0,1.0,0.0,Matches,,,,,,,,,,,,,,,,,,,,,,,,,,,,,,,,,,,,,,,,,,,,,,,,,,,,,,,,512.0,fr FRA,MF,30.0,28.3,4.0,3.0,0.0,58.0,97.0,0.0,235.0,30.0,30.0,0.0,0.0,0.0,210.0,12.0,22.0,35.3,Matches,512.0,fr FRA,MF,30.0,28.3,1695.0,1394.0,290.0,114.0,6.0,35.0,235.0,29.0,137.0,58.0,63.0,2.0,1185.0,11.0,33.0,Matches,512.0,fr FRA,MF,30.0,28.3,1185.0,1695.0,69.9,22639.0,8622.0,530.0,631.0,84.0,362.0,486.0,74.5,227.0,456.0,49.8,4.0,5.8,5.8,-1.8,56.0,172.0,48.0,11.0,205.0,Matches,613,fr FRA,MF,30,30,2546.0,85.0,74.4,28.3,30,85.0,19,0,,0,1.3,40.0,48.0,-8.0,-0.28,-1.42,37.4,48.5,-11.2,-0.4,-0.52,Matches,512.0,fr FRA,MF,30.0,28.3,2067.0,41.0,289.0,1138.0,677.0,34.0,2061.0,138.0,72.0,52.2,42.0,30.4,1493.0,8500.0,3547.0,48.0,63.0,4.0,71.0,50.0,1379.0,117.0,Matches,512.0,fr FRA,MF,30.0,28.3,12.0,58.0,24.0,41.4,2.05,0.85,0.1,0.25,27.0,19.0,6.0,6.0,8.6,3.8,0.07,3.4,2.2,Matches,512.0,fr FRA,MF,30.0,30.0,30.0,2546.0,28.3,12.0,4.0,16.0,6.0,6.0,6.0,4.0,3.0,8.6,3.8,5.8,9.6,48.0,205.0,117.0,0.42,0.14,0.57,0.21,0.35,0.3,0.21,0.51,0.14,0.34,Matches,Téji Savanier,M/AM C,30,145,150,France,Montpellier Hérault SC,16,14,16,12,15,16,5,16,4,6,16,14,11,17,14,13,12,13,13,15,14,14,17,16,12,8,14,16,12,16,12,6,12,10,13,8,14,14,17,11,5,1,2,2,1,2,4,2,1,1,1,3,5,12,8,15,12,12,10,8,1,1,1,1,1,1,13,1,17,1,1,20,1,1,172,69,15,20,18916151,7250,7250,4750,Northern_European,145,6,1991/12/22,0,0,39230.0,,85059749
1032,Kasper Schmeichel,Nice,1986,513.0,dk DEN,GK,35.0,36.0,1.0,0.0,1.0,0.0,0.0,1.0,4.0,25.0,3.0,1.0,0.0,1.0,1.0,2.0,11.0,1.0,Matches,513.0,dk DEN,GK,35.0,36.0,10.0,0.28,7.0,3.0,0.0,0.0,0.0,0.0,1.0,0.03,0.0,1.0,0.0,0.0,0.0,0.0,Matches,39.0,dk DEN,GK,35.0,36.0,35.0,3.0,2.0,5.0,0.0,35.9,0.23,0.9,0.02,170.0,388.0,43.8,909.0,119.0,30.7,32.7,278.0,39.2,35.7,455.0,24.0,5.3,23.0,0.64,12.9,Matches,39.0,dk DEN,GK,35.0,36.0,36.0,3240.0,36.0,35.0,0.97,141.0,105.0,77.3,15.0,12.0,9.0,11.0,30.6,5.0,3.0,1.0,1.0,25.0,Matches,513.0,dk DEN,GK,35.0,36.0,0.0,0.0,0.0,0.0,0.0,0.0,0.0,1.0,0.0,0.0,0.0,0.0,25.0,3.0,0.0,100.0,Matches,513.0,dk DEN,GK,35.0,36.0,1188.0,834.0,353.0,75.0,0.0,4.0,0.0,0.0,0.0,0.0,0.0,0.0,918.0,1.0,1.0,Matches,513.0,dk DEN,GK,35.0,36.0,918.0,1188.0,77.3,25553.0,18698.0,162.0,162.0,100.0,419.0,430.0,97.4,332.0,589.0,56.4,0.0,0.4,0.0,-0.4,2.0,8.0,0.0,0.0,0.0,Matches,614,dk DEN,GK,35,36,3240.0,90.0,94.7,36.0,36,90.0,36,0,,2,1.58,47.0,35.0,12.0,0.33,0.83,54.6,42.3,12.4,0.34,0.24,Matches,513.0,dk DEN,GK,35.0,36.0,1258.0,1119.0,1253.0,5.0,0.0,0.0,1258.0,0.0,0.0,,0.0,,860.0,3975.0,2015.0,0.0,0.0,0.0,2.0,0.0,604.0,0.0,Matches,513.0,dk DEN,GK,35.0,36.0,0.0,0.0,0.0,,0.0,0.0,,,,0.0,0.0,0.0,0.0,0.0,,0.0,0.0,Matches,513.0,dk DEN,GK,35.0,36.0,36.0,3240.0,36.0,0.0,0.0,0.0,0.0,0.0,0.0,0.0,0.0,0.0,0.0,0.4,0.4,0.0,0.0,0.0,0.0,0.0,0.0,0.0,0.0,0.0,0.01,0.01,0.0,0.01,Matches,Kasper Schmeichel,GK,35,144,150,"Denmark,England,Poland",OGC Nice,3,3,1,1,8,7,13,3,1,3,8,4,3,10,17,13,15,12,12,13,13,16,2,16,3,13,14,14,12,14,8,12,15,11,12,10,12,10,12,4,15,12,14,14,16,15,14,16,15,16,16,16,16,17,13,14,12,14,13,6,20,1,1,1,1,1,1,1,1,1,1,1,1,1,189,84,14,20,347975206,7200,7850,6000,Northern_European,144,4,1986/11/5,84,0,74999.0,,5114022
1033,Alidu Seidu,Clermont Foot,2000,514.0,gh GHA,DF,22.0,27.3,52.0,31.0,35.0,14.0,3.0,31.0,51.0,60.8,20.0,28.0,14.0,14.0,52.0,104.0,50.0,2.0,Matches,514.0,gh GHA,DF,22.0,27.3,23.0,0.84,15.0,0.0,1.0,1.0,4.0,2.0,1.0,0.04,1.0,0.0,0.0,0.0,0.0,0.0,Matches,,,,,,,,,,,,,,,,,,,,,,,,,,,,,,,,,,,,,,,,,,,,,,,,,,,,,,,,514.0,gh GHA,DF,22.0,27.3,10.0,1.0,0.0,33.0,70.0,1.0,22.0,52.0,31.0,0.0,1.0,0.0,203.0,26.0,9.0,74.3,Matches,514.0,gh GHA,DF,22.0,27.3,1375.0,1219.0,154.0,27.0,0.0,3.0,22.0,127.0,0.0,0.0,0.0,0.0,1152.0,2.0,26.0,Matches,514.0,gh GHA,DF,22.0,27.3,1152.0,1375.0,83.8,20609.0,6267.0,470.0,517.0,90.9,537.0,612.0,87.7,110.0,184.0,59.8,0.0,0.5,0.6,-0.5,7.0,52.0,11.0,6.0,65.0,Matches,615,gh GHA,DF,22,28,2458.0,88.0,71.9,27.3,28,88.0,23,0,,0,1.71,37.0,33.0,4.0,0.15,0.89,35.8,39.4,-3.6,-0.13,0.53,Matches,514.0,gh GHA,DF,22.0,27.3,1646.0,109.0,710.0,805.0,158.0,3.0,1646.0,61.0,31.0,50.8,9.0,14.8,1168.0,7389.0,3574.0,27.0,34.0,2.0,34.0,15.0,970.0,35.0,Matches,514.0,gh GHA,DF,22.0,27.3,0.0,6.0,2.0,33.3,0.22,0.07,0.0,0.0,32.6,0.0,0.0,0.0,0.1,0.1,0.02,-0.1,-0.1,Matches,514.0,gh GHA,DF,22.0,28.0,28.0,2458.0,27.3,0.0,0.0,0.0,0.0,0.0,0.0,10.0,1.0,0.1,0.1,0.5,0.7,27.0,65.0,35.0,0.0,0.0,0.0,0.0,0.0,0.01,0.02,0.02,0.01,0.02,Matches,Alidu Seidu,D/WB RLC,22,124,142,Ghana,Clermont Foot 63,10,11,10,6,11,8,11,9,12,13,10,9,13,11,11,11,15,10,13,11,12,14,11,10,10,12,12,12,14,11,14,11,15,12,14,15,12,9,10,8,10,2,1,3,2,3,3,2,1,1,3,1,11,11,8,10,11,13,12,14,1,16,20,20,1,16,1,1,1,1,1,1,1,1,173,68,10,20,4495999,6200,6200,2802,African_Caribbean,118,16,2000/6/4,2,0,9541.0,,49063222
1034,Matz Sels,Strasbourg,1992,515.0,be BEL,GK,30.0,38.0,4.0,3.0,4.0,0.0,0.0,4.0,4.0,100.0,0.0,0.0,0.0,0.0,4.0,8.0,23.0,0.0,Matches,515.0,be BEL,GK,30.0,38.0,4.0,0.11,3.0,1.0,0.0,0.0,0.0,0.0,0.0,0.0,0.0,0.0,0.0,0.0,0.0,0.0,Matches,40.0,be BEL,GK,30.0,38.0,59.0,10.0,1.0,6.0,0.0,56.5,0.27,-2.5,-0.06,159.0,455.0,34.9,775.0,130.0,44.8,36.9,196.0,55.1,43.9,504.0,31.0,6.2,32.0,0.84,12.8,Matches,40.0,be BEL,GK,30.0,38.0,38.0,3420.0,38.0,59.0,1.55,174.0,115.0,71.8,9.0,13.0,16.0,6.0,15.8,11.0,10.0,0.0,1.0,0.0,Matches,515.0,be BEL,GK,30.0,38.0,2.0,0.0,0.0,0.0,3.0,0.0,0.0,4.0,3.0,0.0,0.0,0.0,29.0,9.0,0.0,100.0,Matches,515.0,be BEL,GK,30.0,38.0,973.0,679.0,292.0,95.0,0.0,0.0,0.0,1.0,0.0,0.0,0.0,0.0,636.0,2.0,0.0,Matches,515.0,be BEL,GK,30.0,38.0,636.0,973.0,65.4,18508.0,14417.0,123.0,125.0,98.4,269.0,275.0,97.8,239.0,566.0,42.2,0.0,0.3,0.0,-0.3,1.0,17.0,0.0,0.0,0.0,Matches,616,be BEL,GK,30,38,3420.0,90.0,100.0,38.0,38,90.0,38,0,,0,1.05,51.0,59.0,-8.0,-0.21,,48.5,55.4,-6.8,-0.18,,Matches,515.0,be BEL,GK,30.0,38.0,1082.0,936.0,1076.0,8.0,0.0,0.0,1082.0,0.0,0.0,,0.0,,685.0,3758.0,2281.0,0.0,0.0,0.0,1.0,0.0,432.0,0.0,Matches,515.0,be BEL,GK,30.0,38.0,0.0,0.0,0.0,,0.0,0.0,,,,0.0,0.0,0.0,0.0,0.0,,0.0,0.0,Matches,515.0,be BEL,GK,30.0,38.0,38.0,3420.0,38.0,0.0,0.0,0.0,0.0,0.0,0.0,2.0,0.0,0.0,0.0,0.3,0.3,0.0,0.0,0.0,0.0,0.0,0.0,0.0,0.0,0.0,0.01,0.01,0.0,0.01,Matches,Matz Sels,GK,30,131,135,Belgium,RC Strasbourg Alsace,5,2,3,2,11,6,9,1,2,2,11,3,2,10,7,13,14,13,14,8,12,15,1,10,3,13,12,10,12,12,15,15,12,13,15,14,14,9,15,6,13,11,12,11,13,10,14,15,17,11,14,12,12,15,7,14,12,12,10,11,20,1,1,1,1,1,1,1,1,1,1,1,1,1,191,75,9,20,3669590,6545,6745,5245,Northern_European,130,3,1992/2/26,2,0,20698.0,,18018791
1035,Abdallah Sima,Angers,2001,520.0,sn SEN,FW,21.0,20.4,22.0,13.0,4.0,15.0,3.0,7.0,19.0,36.8,12.0,8.0,0.0,8.0,4.0,26.0,19.0,0.0,Matches,520.0,sn SEN,FW,21.0,20.4,34.0,1.67,24.0,0.0,1.0,4.0,5.0,0.0,7.0,0.34,2.0,0.0,1.0,1.0,3.0,0.0,Matches,,,,,,,,,,,,,,,,,,,,,,,,,,,,,,,,,,,,,,,,,,,,,,,,,,,,,,,,520.0,sn SEN,FW,21.0,20.4,0.0,0.0,0.0,32.0,24.0,12.0,16.0,4.0,13.0,1.0,1.0,1.0,52.0,43.0,63.0,40.6,Matches,520.0,sn SEN,FW,21.0,20.4,374.0,334.0,39.0,0.0,1.0,1.0,16.0,6.0,0.0,0.0,0.0,0.0,274.0,1.0,15.0,Matches,520.0,sn SEN,FW,21.0,20.4,274.0,374.0,73.3,3603.0,688.0,142.0,182.0,78.0,84.0,116.0,72.4,8.0,17.0,47.1,1.0,2.2,1.3,-1.2,16.0,18.0,6.0,1.0,21.0,Matches,621,sn SEN,FW,21,34,1836.0,54.0,53.7,20.4,19,79.0,9,15,23.0,0,0.47,20.0,44.0,-24.0,-1.18,0.19,21.9,32.3,-10.4,-0.51,0.08,Matches,520.0,sn SEN,FW,21.0,20.4,589.0,23.0,54.0,271.0,281.0,78.0,589.0,50.0,21.0,42.0,25.0,50.0,404.0,2855.0,915.0,38.0,25.0,17.0,60.0,31.0,424.0,140.0,Matches,520.0,sn SEN,FW,21.0,20.4,5.0,39.0,10.0,25.6,1.91,0.49,0.13,0.5,12.7,0.0,0.0,0.0,4.8,4.8,0.12,0.2,0.2,Matches,520.0,sn SEN,FW,21.0,34.0,19.0,1836.0,20.4,5.0,1.0,6.0,5.0,0.0,0.0,0.0,0.0,4.8,4.8,2.2,7.0,38.0,21.0,140.0,0.25,0.05,0.29,0.25,0.29,0.24,0.11,0.34,0.24,0.34,Matches,Abdallah Sima,AM R,21,121,144,Senegal,Brighton & Hove Albion,4,7,14,15,11,6,15,6,3,11,8,6,10,11,10,10,11,13,9,10,15,7,13,13,13,7,13,10,16,12,12,16,7,15,11,13,12,8,1,14,14,1,1,1,3,2,1,3,1,2,3,4,14,13,2,14,12,8,13,11,1,1,1,1,1,1,1,6,1,12,14,1,20,15,188,74,8,20,15171719,6050,6050,4500,African_Caribbean,114,17,2001/6/17,4,0,9279.0,Angers SCO,2000052135
1036,Moses Simon,Nantes,1995,521.0,ng NGA,FWMF,27.0,26.1,18.0,9.0,6.0,7.0,5.0,7.0,15.0,46.7,8.0,14.0,1.0,13.0,11.0,29.0,3.0,0.0,Matches,521.0,ng NGA,FWMF,27.0,26.1,85.0,3.26,58.0,10.0,7.0,7.0,3.0,0.0,4.0,0.15,4.0,0.0,0.0,0.0,0.0,0.0,Matches,,,,,,,,,,,,,,,,,,,,,,,,,,,,,,,,,,,,,,,,,,,,,,,,,,,,,,,,521.0,ng NGA,FWMF,27.0,26.1,3.0,0.0,0.0,11.0,32.0,4.0,140.0,11.0,9.0,0.0,0.0,0.0,114.0,11.0,39.0,22.0,Matches,521.0,ng NGA,FWMF,27.0,26.1,725.0,657.0,63.0,13.0,3.0,2.0,140.0,9.0,40.0,19.0,10.0,0.0,463.0,5.0,36.0,Matches,521.0,ng NGA,FWMF,27.0,26.1,463.0,725.0,63.9,7630.0,2088.0,232.0,296.0,78.4,173.0,264.0,65.5,41.0,104.0,39.4,4.0,3.5,4.0,0.5,43.0,34.0,31.0,18.0,62.0,Matches,622,ng NGA,FWMF,27,34,2346.0,69.0,68.6,26.1,28,80.0,10,6,18.0,0,0.85,24.0,38.0,-14.0,-0.54,-0.2,28.5,36.8,-8.3,-0.32,-0.21,Matches,521.0,ng NGA,FWMF,27.0,26.1,967.0,5.0,103.0,321.0,567.0,104.0,966.0,95.0,34.0,35.8,50.0,52.6,729.0,6355.0,3150.0,138.0,61.0,43.0,49.0,36.0,669.0,218.0,Matches,521.0,ng NGA,FWMF,27.0,26.1,5.0,32.0,9.0,28.1,1.23,0.35,0.13,0.44,18.3,1.0,1.0,1.0,4.6,3.6,0.11,0.4,0.4,Matches,521.0,ng NGA,FWMF,27.0,34.0,28.0,2346.0,26.1,5.0,4.0,9.0,4.0,1.0,1.0,3.0,0.0,4.6,3.6,3.5,7.1,138.0,62.0,218.0,0.19,0.15,0.35,0.15,0.31,0.18,0.14,0.31,0.14,0.27,Matches,Moses Simon,M/AM RL,27,135,138,Nigeria,FC Nantes,11,13,15,12,14,10,6,11,4,5,14,11,6,15,8,11,15,11,12,13,11,12,16,9,17,10,11,11,16,14,11,5,12,16,13,10,12,8,9,11,10,2,2,3,1,4,3,1,1,1,3,1,12,14,9,12,12,13,13,11,1,1,1,1,1,1,1,17,7,12,20,12,18,12,168,66,9,20,9954790,6750,6750,4700,African_Caribbean,133,17,1995/7/12,53,7,34496.0,,13139098
1037,Ibrahima Sissoko,Strasbourg,1997,523.0,ml MLI,MF,24.0,14.6,40.0,22.0,18.0,17.0,5.0,22.0,42.0,52.4,20.0,20.0,6.0,14.0,10.0,50.0,19.0,0.0,Matches,523.0,ml MLI,MF,24.0,14.6,32.0,2.2,25.0,0.0,0.0,2.0,4.0,1.0,2.0,0.14,2.0,0.0,0.0,0.0,0.0,0.0,Matches,,,,,,,,,,,,,,,,,,,,,,,,,,,,,,,,,,,,,,,,,,,,,,,,,,,,,,,,523.0,ml MLI,MF,24.0,14.6,1.0,0.0,0.0,41.0,15.0,2.0,10.0,10.0,22.0,0.0,1.0,0.0,121.0,30.0,23.0,56.6,Matches,523.0,ml MLI,MF,24.0,14.6,636.0,617.0,18.0,15.0,2.0,6.0,10.0,3.0,0.0,0.0,0.0,0.0,489.0,1.0,23.0,Matches,523.0,ml MLI,MF,24.0,14.6,489.0,636.0,76.9,8178.0,2320.0,232.0,287.0,80.8,199.0,245.0,81.2,41.0,59.0,69.5,2.0,0.9,1.2,1.1,11.0,50.0,15.0,3.0,67.0,Matches,624,ml MLI,MF,24,26,1310.0,50.0,38.3,14.6,13,74.0,5,13,27.0,2,1.15,18.0,21.0,-3.0,-0.21,0.01,17.6,20.4,-2.8,-0.19,-0.02,Matches,523.0,ml MLI,MF,24.0,14.6,803.0,40.0,177.0,464.0,176.0,28.0,803.0,17.0,8.0,47.1,8.0,47.1,543.0,2796.0,1159.0,18.0,23.0,1.0,22.0,19.0,480.0,41.0,Matches,523.0,ml MLI,MF,24.0,14.6,0.0,13.0,3.0,23.1,0.89,0.21,0.0,0.0,18.0,0.0,0.0,0.0,0.7,0.7,0.05,-0.7,-0.7,Matches,523.0,ml MLI,MF,24.0,26.0,13.0,1310.0,14.6,0.0,2.0,2.0,0.0,0.0,0.0,1.0,0.0,0.7,0.7,0.9,1.6,18.0,67.0,41.0,0.0,0.14,0.14,0.0,0.14,0.05,0.06,0.11,0.05,0.11,Matches,Ibrahima Sissoko,DM/M C,24,127,137,"France,Mali",RC Strasbourg Alsace,8,9,13,10,13,8,16,12,8,12,13,7,14,11,14,12,15,12,13,8,12,13,10,8,11,13,15,16,13,12,14,16,16,13,15,16,12,11,12,7,12,2,1,3,1,2,1,1,1,2,2,2,11,14,7,11,9,13,10,16,1,1,12,1,1,1,20,1,20,1,1,1,1,1,193,88,8,20,3051845,6350,6350,3803,African_Caribbean,128,15,1997/10/27,0,0,4598.0,,48037152
1038,Moussa Sissoko,Nantes,1989,524.0,fr FRA,MF,32.0,21.3,26.0,16.0,16.0,7.0,3.0,12.0,18.0,66.7,6.0,22.0,5.0,17.0,16.0,42.0,17.0,0.0,Matches,524.0,fr FRA,MF,32.0,21.3,35.0,1.64,32.0,0.0,0.0,3.0,0.0,0.0,1.0,0.05,1.0,0.0,0.0,0.0,0.0,0.0,Matches,,,,,,,,,,,,,,,,,,,,,,,,,,,,,,,,,,,,,,,,,,,,,,,,,,,,,,,,524.0,fr FRA,MF,32.0,21.3,3.0,0.0,0.0,27.0,14.0,3.0,23.0,16.0,16.0,0.0,1.0,0.0,153.0,24.0,23.0,51.1,Matches,524.0,fr FRA,MF,32.0,21.3,787.0,753.0,34.0,21.0,0.0,2.0,23.0,11.0,0.0,0.0,0.0,0.0,628.0,0.0,22.0,Matches,524.0,fr FRA,MF,32.0,21.3,628.0,787.0,79.8,10251.0,3230.0,292.0,356.0,82.0,257.0,299.0,86.0,45.0,71.0,63.4,0.0,0.9,1.0,-0.9,17.0,80.0,10.0,6.0,105.0,Matches,625,fr FRA,MF,32,30,1918.0,64.0,56.1,21.3,22,82.0,9,8,15.0,2,0.9,21.0,35.0,-14.0,-0.66,-0.42,20.5,30.5,-10.0,-0.47,-0.49,Matches,524.0,fr FRA,MF,32.0,21.3,963.0,32.0,189.0,562.0,240.0,25.0,963.0,36.0,15.0,41.7,19.0,52.8,700.0,4357.0,2141.0,33.0,30.0,4.0,29.0,18.0,618.0,70.0,Matches,524.0,fr FRA,MF,32.0,21.3,2.0,17.0,4.0,23.5,0.8,0.19,0.12,0.5,16.3,0.0,0.0,0.0,2.4,2.4,0.14,-0.4,-0.4,Matches,524.0,fr FRA,MF,32.0,30.0,22.0,1918.0,21.3,2.0,0.0,2.0,2.0,0.0,0.0,3.0,0.0,2.4,2.4,0.9,3.3,33.0,105.0,70.0,0.09,0.0,0.09,0.09,0.09,0.11,0.04,0.16,0.11,0.16,Matches,Moussa Sissoko,M RC,32,135,150,"France,Mali",FC Nantes,9,11,14,10,12,10,13,8,5,12,12,13,13,11,11,14,15,11,15,12,12,13,12,12,12,12,17,17,14,12,17,13,19,14,18,15,13,6,13,5,15,1,1,3,1,1,1,1,1,3,2,2,14,15,12,10,13,15,14,14,1,1,1,8,1,12,14,1,20,16,10,12,15,1,187,91,8,20,347975206,6750,7000,6000,African_Caribbean,133,17,1989/8/16,71,2,28708.0,,8448722
1039,Islam Slimani,Brest,1988,526.0,dz ALG,FW,34.0,11.0,5.0,3.0,2.0,2.0,1.0,0.0,3.0,0.0,3.0,2.0,0.0,2.0,1.0,6.0,11.0,0.0,Matches,526.0,dz ALG,FW,34.0,11.0,23.0,2.1,22.0,0.0,0.0,1.0,0.0,0.0,3.0,0.27,3.0,0.0,0.0,0.0,0.0,0.0,Matches,,,,,,,,,,,,,,,,,,,,,,,,,,,,,,,,,,,,,,,,,,,,,,,,,,,,,,,,526.0,dz ALG,FW,34.0,11.0,5.0,0.0,0.0,18.0,14.0,10.0,9.0,1.0,3.0,0.0,0.0,0.0,16.0,22.0,25.0,46.8,Matches,526.0,dz ALG,FW,34.0,11.0,367.0,347.0,20.0,3.0,4.0,1.0,9.0,1.0,0.0,0.0,0.0,0.0,261.0,0.0,12.0,Matches,526.0,dz ALG,FW,34.0,11.0,261.0,367.0,71.1,3733.0,663.0,143.0,192.0,74.5,87.0,117.0,74.4,13.0,21.0,61.9,1.0,1.2,1.5,-0.2,13.0,22.0,4.0,0.0,26.0,Matches,627,dz ALG,FW,34,16,986.0,62.0,28.8,11.0,11,78.0,4,5,26.0,0,0.88,11.0,15.0,-4.0,-0.37,-0.14,10.6,15.8,-5.2,-0.47,-0.2,Matches,526.0,dz ALG,FW,34.0,11.0,467.0,13.0,30.0,269.0,170.0,45.0,466.0,13.0,4.0,30.8,8.0,61.5,357.0,1546.0,467.0,11.0,11.0,2.0,36.0,17.0,377.0,61.0,Matches,526.0,dz ALG,FW,34.0,11.0,1.0,14.0,2.0,14.3,1.28,0.18,0.07,0.5,14.1,0.0,0.0,1.0,2.5,1.7,0.12,-1.5,-0.7,Matches,526.0,dz ALG,FW,34.0,16.0,11.0,986.0,11.0,1.0,1.0,2.0,1.0,0.0,1.0,5.0,0.0,2.5,1.7,1.2,2.9,11.0,26.0,61.0,0.09,0.09,0.18,0.09,0.18,0.23,0.11,0.33,0.16,0.26,Matches,Islam Slimani,S,34,129,156,Algeria,Stade Brestois 29,8,10,11,14,12,9,16,8,5,5,14,13,8,12,17,16,18,14,12,13,14,16,13,12,14,8,15,15,10,11,15,15,12,11,11,15,13,16,14,8,5,2,3,3,2,3,2,3,2,2,2,3,12,14,15,14,14,12,7,7,1,1,1,1,1,1,1,1,1,1,10,1,1,20,188,83,11,20,656680,6450,7050,6000,North_African__Middle_Eastern,129,9,1988/6/18,88,41,13768.0,,12031625
1040,Carlos Soler,Paris S-G,1997,528.0,es ESP,MF,25.0,13.2,20.0,12.0,6.0,10.0,4.0,10.0,19.0,52.6,9.0,12.0,4.0,8.0,4.0,24.0,6.0,0.0,Matches,528.0,es ESP,MF,25.0,13.2,34.0,2.58,26.0,2.0,0.0,2.0,4.0,0.0,8.0,0.61,7.0,0.0,0.0,0.0,1.0,0.0,Matches,,,,,,,,,,,,,,,,,,,,,,,,,,,,,,,,,,,,,,,,,,,,,,,,,,,,,,,,528.0,es ESP,MF,25.0,13.2,0.0,0.0,0.0,18.0,14.0,0.0,22.0,4.0,12.0,1.0,0.0,0.0,67.0,1.0,6.0,14.3,Matches,528.0,es ESP,MF,25.0,13.2,641.0,619.0,20.0,5.0,3.0,1.0,22.0,5.0,10.0,5.0,3.0,0.0,544.0,2.0,15.0,Matches,528.0,es ESP,MF,25.0,13.2,544.0,641.0,84.9,7564.0,1756.0,313.0,352.0,88.9,165.0,188.0,87.8,27.0,46.0,58.7,2.0,1.4,1.4,0.6,13.0,40.0,5.0,1.0,53.0,Matches,629,es ESP,MF,25,26,1187.0,46.0,34.7,13.2,14,73.0,3,12,14.0,5,2.19,31.0,16.0,15.0,1.14,-0.23,25.4,17.4,8.1,0.61,-0.27,Matches,528.0,es ESP,MF,25.0,13.2,749.0,14.0,105.0,359.0,290.0,25.0,749.0,12.0,5.0,41.7,4.0,33.3,626.0,2884.0,1120.0,18.0,28.0,2.0,20.0,13.0,594.0,67.0,Matches,528.0,es ESP,MF,25.0,13.2,3.0,10.0,6.0,60.0,0.76,0.45,0.3,0.5,15.2,0.0,0.0,0.0,1.6,1.6,0.16,1.4,1.4,Matches,528.0,es ESP,MF,25.0,26.0,14.0,1187.0,13.2,3.0,2.0,5.0,3.0,0.0,0.0,0.0,0.0,1.6,1.6,1.4,3.0,18.0,53.0,67.0,0.23,0.15,0.38,0.23,0.38,0.12,0.11,0.23,0.12,0.23,Matches,Carlos Soler,WB/DM/M/AM RC,25,155,163,Spain,Paris Saint-Germain,13,15,13,13,14,12,12,15,9,10,15,16,10,14,13,15,12,13,13,14,14,15,14,15,14,12,13,14,14,13,13,10,14,14,14,13,14,11,14,8,15,2,3,3,1,2,3,2,1,3,3,2,12,14,4,18,14,16,13,12,1,1,1,1,1,16,16,14,20,20,13,19,19,1,180,76,10,20,40747461,7750,7750,6250,Mediterranean_Hispanic,145,1,1997/1/2,9,3,108102.0,,67196204
1041,Florian Sotoca,Lens,1990,530.0,fr FRA,MFFW,31.0,33.9,39.0,19.0,11.0,17.0,11.0,15.0,40.0,37.5,25.0,41.0,2.0,39.0,29.0,68.0,51.0,0.0,Matches,530.0,fr FRA,MFFW,31.0,33.9,135.0,3.98,110.0,0.0,3.0,13.0,6.0,3.0,21.0,0.62,19.0,0.0,0.0,1.0,1.0,0.0,Matches,,,,,,,,,,,,,,,,,,,,,,,,,,,,,,,,,,,,,,,,,,,,,,,,,,,,,,,,530.0,fr FRA,MFFW,31.0,33.9,4.0,0.0,0.0,37.0,44.0,9.0,99.0,29.0,19.0,1.0,0.0,0.0,124.0,56.0,45.0,55.4,Matches,530.0,fr FRA,MFFW,31.0,33.9,1536.0,1472.0,58.0,12.0,10.0,21.0,99.0,39.0,1.0,0.0,0.0,0.0,1172.0,6.0,48.0,Matches,530.0,fr FRA,MFFW,31.0,33.9,1172.0,1536.0,76.3,20095.0,5544.0,549.0,655.0,83.8,445.0,585.0,76.1,122.0,187.0,65.2,9.0,8.1,6.1,0.9,59.0,122.0,56.0,17.0,186.0,Matches,631,fr FRA,MFFW,31,38,3054.0,80.0,89.3,33.9,34,86.0,20,4,33.0,0,2.21,65.0,22.0,43.0,1.27,2.25,60.6,35.9,24.7,0.73,1.09,Matches,530.0,fr FRA,MFFW,31.0,33.9,1887.0,55.0,212.0,915.0,775.0,140.0,1884.0,40.0,16.0,40.0,18.0,45.0,1446.0,7373.0,2546.0,53.0,61.0,16.0,44.0,25.0,1434.0,302.0,Matches,530.0,fr FRA,MFFW,31.0,33.9,7.0,86.0,29.0,33.7,2.53,0.85,0.07,0.21,15.6,0.0,1.0,3.0,10.5,8.1,0.09,-3.5,-2.1,Matches,530.0,fr FRA,MFFW,31.0,38.0,34.0,3054.0,33.9,7.0,9.0,16.0,6.0,1.0,3.0,4.0,0.0,10.5,8.1,8.1,16.2,53.0,186.0,302.0,0.21,0.27,0.47,0.18,0.44,0.31,0.24,0.55,0.24,0.48,Matches,Florian Sotoca,AM/S R,31,125,125,France,RC Lens,6,12,13,12,12,8,13,10,5,5,13,12,8,12,12,12,14,14,13,13,13,16,13,8,14,9,15,18,14,12,12,14,15,13,14,13,13,8,14,7,11,1,1,2,3,1,1,2,2,1,1,3,12,13,8,14,13,12,14,14,1,1,1,1,1,1,1,1,1,14,7,1,16,20,187,77,8,20,347975206,6250,6250,3750,Northern_European,127,5,1990/10/25,0,0,9343.0,,48032631
1042,Stijn Spierings,Toulouse,1996,535.0,nl NED,MF,26.0,34.7,95.0,67.0,37.0,49.0,9.0,43.0,101.0,42.6,58.0,49.0,11.0,38.0,53.0,148.0,44.0,0.0,Matches,535.0,nl NED,MF,26.0,34.7,60.0,1.73,48.0,0.0,2.0,3.0,3.0,4.0,6.0,0.17,4.0,0.0,1.0,0.0,1.0,0.0,Matches,,,,,,,,,,,,,,,,,,,,,,,,,,,,,,,,,,,,,,,,,,,,,,,,,,,,,,,,535.0,nl NED,MF,26.0,34.7,6.0,0.0,0.0,55.0,50.0,0.0,21.0,53.0,67.0,1.0,1.0,0.0,336.0,20.0,20.0,50.0,Matches,535.0,nl NED,MF,26.0,34.7,2085.0,2005.0,75.0,68.0,1.0,35.0,21.0,7.0,0.0,0.0,0.0,0.0,1778.0,5.0,40.0,Matches,535.0,nl NED,MF,26.0,34.7,1778.0,2085.0,85.3,32238.0,10001.0,781.0,875.0,89.3,730.0,809.0,90.2,210.0,298.0,70.5,0.0,2.1,1.7,-2.1,22.0,192.0,22.0,5.0,231.0,Matches,636,nl NED,MF,26,36,3120.0,87.0,91.2,34.7,35,89.0,31,1,22.0,1,1.25,48.0,53.0,-5.0,-0.14,0.16,48.0,50.7,-2.8,-0.08,0.44,Matches,535.0,nl NED,MF,26.0,34.7,2428.0,96.0,582.0,1532.0,340.0,20.0,2428.0,40.0,16.0,40.0,13.0,32.5,1843.0,8655.0,3759.0,31.0,41.0,4.0,27.0,25.0,1616.0,30.0,Matches,535.0,nl NED,MF,26.0,34.7,2.0,24.0,5.0,20.8,0.69,0.14,0.08,0.4,20.2,0.0,0.0,0.0,1.8,1.8,0.07,0.2,0.2,Matches,535.0,nl NED,MF,26.0,36.0,35.0,3120.0,34.7,2.0,0.0,2.0,2.0,0.0,0.0,6.0,0.0,1.8,1.8,2.1,3.9,31.0,231.0,30.0,0.06,0.0,0.06,0.06,0.06,0.05,0.06,0.11,0.05,0.11,Matches,Stijn Spierings,DM/M C,26,124,130,Holland,Toulouse FC,12,9,10,12,14,12,11,13,8,9,13,15,11,14,12,13,10,15,13,14,13,13,14,9,12,14,12,12,11,10,13,14,14,11,13,14,13,8,12,5,12,3,3,3,3,4,1,3,1,2,1,2,13,13,7,11,14,13,14,13,1,1,6,1,1,1,20,10,16,10,12,14,10,10,188,83,12,20,2175899,6199,6199,3856,Northern_European,124,2,1996/3/12,0,0,4999.0,,37047790
1043,Issiaga Sylla,Montpellier,1994,541.0,gn GUI,DF,28.0,14.5,28.0,16.0,19.0,8.0,1.0,15.0,31.0,48.4,16.0,19.0,3.0,16.0,32.0,60.0,35.0,0.0,Matches,541.0,gn GUI,DF,28.0,14.5,42.0,2.9,37.0,2.0,1.0,2.0,0.0,0.0,4.0,0.28,3.0,0.0,0.0,1.0,0.0,0.0,Matches,,,,,,,,,,,,,,,,,,,,,,,,,,,,,,,,,,,,,,,,,,,,,,,,,,,,,,,,541.0,gn GUI,DF,28.0,14.5,0.0,0.0,0.0,8.0,9.0,2.0,35.0,32.0,16.0,0.0,0.0,0.0,100.0,27.0,15.0,64.3,Matches,541.0,gn GUI,DF,28.0,14.5,817.0,677.0,136.0,13.0,0.0,6.0,35.0,123.0,0.0,0.0,0.0,0.0,647.0,4.0,19.0,Matches,541.0,gn GUI,DF,28.0,14.5,647.0,817.0,79.2,10539.0,3906.0,326.0,378.0,86.2,251.0,310.0,81.0,51.0,82.0,62.2,3.0,2.0,0.8,1.0,17.0,50.0,12.0,4.0,82.0,Matches,642,gn GUI,DF,28,15,1305.0,87.0,38.2,14.5,15,87.0,14,0,,1,1.8,27.0,11.0,16.0,1.1,1.66,22.6,16.2,6.4,0.44,1.13,Matches,541.0,gn GUI,DF,28.0,14.5,984.0,64.0,282.0,473.0,239.0,14.0,984.0,29.0,9.0,31.0,17.0,58.6,629.0,3648.0,1842.0,28.0,33.0,3.0,17.0,9.0,536.0,65.0,Matches,541.0,gn GUI,DF,28.0,14.5,1.0,10.0,1.0,10.0,0.69,0.07,0.1,1.0,14.8,0.0,0.0,0.0,0.8,0.8,0.08,0.2,0.2,Matches,541.0,gn GUI,DF,28.0,15.0,15.0,1305.0,14.5,1.0,3.0,4.0,1.0,0.0,0.0,0.0,0.0,0.8,0.8,2.0,2.8,28.0,82.0,65.0,0.07,0.21,0.28,0.07,0.28,0.05,0.14,0.19,0.05,0.19,Matches,Issiaga Sylla,D/WB L,28,122,130,Guinea,Toulouse FC,9,10,12,10,11,9,14,9,13,13,11,7,13,11,13,12,14,7,10,9,11,12,8,6,11,12,14,15,15,14,13,13,14,14,15,13,11,13,11,7,19,1,1,2,3,1,1,1,2,2,2,2,14,12,5,9,12,14,14,20,1,20,10,1,17,1,1,14,1,1,1,1,1,1,180,75,20,5,1259670,6092,6492,3742,African_Caribbean,120,15,1994/1/1,68,3,4838.0,,85125565
1044,Nicolás Tagliafico,Lyon,1992,543.0,ar ARG,DF,29.0,33.2,91.0,53.0,36.0,41.0,14.0,50.0,78.0,64.1,28.0,45.0,11.0,34.0,57.0,148.0,47.0,0.0,Matches,543.0,ar ARG,DF,29.0,33.2,59.0,1.78,46.0,7.0,0.0,3.0,2.0,1.0,5.0,0.15,4.0,1.0,0.0,0.0,0.0,0.0,Matches,,,,,,,,,,,,,,,,,,,,,,,,,,,,,,,,,,,,,,,,,,,,,,,,,,,,,,,,543.0,ar ARG,DF,29.0,33.2,5.0,0.0,0.0,40.0,59.0,2.0,68.0,57.0,53.0,0.0,2.0,0.0,166.0,42.0,37.0,53.2,Matches,543.0,ar ARG,DF,29.0,33.2,1883.0,1602.0,276.0,19.0,0.0,1.0,68.0,256.0,1.0,0.0,0.0,0.0,1587.0,5.0,41.0,Matches,543.0,ar ARG,DF,29.0,33.2,1587.0,1883.0,84.3,24353.0,7754.0,816.0,906.0,90.1,642.0,751.0,85.5,69.0,122.0,56.6,3.0,4.2,3.8,-1.2,24.0,123.0,36.0,7.0,156.0,Matches,645,ar ARG,DF,29,34,2991.0,88.0,87.5,33.2,34,88.0,30,0,,0,1.56,53.0,39.0,14.0,0.42,-0.42,51.4,43.8,7.6,0.23,-0.18,Matches,543.0,ar ARG,DF,29.0,33.2,2237.0,86.0,527.0,1118.0,610.0,48.0,2237.0,38.0,10.0,26.3,19.0,50.0,1539.0,7465.0,3182.0,38.0,44.0,5.0,46.0,16.0,1405.0,171.0,Matches,543.0,ar ARG,DF,29.0,33.2,1.0,23.0,5.0,21.7,0.69,0.15,0.04,0.2,16.8,0.0,0.0,0.0,2.4,1.9,0.08,-1.4,-0.9,Matches,543.0,ar ARG,DF,29.0,34.0,34.0,2991.0,33.2,1.0,3.0,4.0,1.0,0.0,0.0,5.0,0.0,2.4,1.9,4.2,6.1,38.0,156.0,171.0,0.03,0.09,0.12,0.03,0.12,0.07,0.13,0.2,0.06,0.18,Matches,Nicolás Tagliafico,D/WB/M L,29,144,155,"Argentina,Italy",Olympique Lyonnais,8,12,12,7,13,11,15,8,13,15,13,4,16,12,19,14,17,12,14,12,12,15,12,16,13,14,15,17,13,14,14,13,13,13,16,13,15,16,18,5,12,3,2,4,3,4,3,2,2,2,3,1,16,16,5,16,15,18,10,5,1,20,13,1,18,1,12,16,1,1,10,1,1,1,172,67,20,8,27914253,7200,7200,6500,Mediterranean_Hispanic,143,6,1992/8/31,40,0,47944.0,,14008030
1045,Flavien Tait,Rennes,1993,545.0,fr FRA,MF,29.0,18.7,30.0,15.0,8.0,17.0,5.0,19.0,42.0,45.2,23.0,16.0,4.0,12.0,20.0,50.0,12.0,0.0,Matches,545.0,fr FRA,MF,29.0,18.7,59.0,3.16,45.0,0.0,6.0,3.0,1.0,4.0,7.0,0.37,5.0,0.0,2.0,0.0,0.0,0.0,Matches,,,,,,,,,,,,,,,,,,,,,,,,,,,,,,,,,,,,,,,,,,,,,,,,,,,,,,,,545.0,fr FRA,MF,29.0,18.7,2.0,0.0,0.0,25.0,29.0,0.0,7.0,20.0,15.0,0.0,0.0,0.0,128.0,7.0,10.0,41.2,Matches,545.0,fr FRA,MF,29.0,18.7,1087.0,1052.0,32.0,25.0,4.0,8.0,7.0,4.0,3.0,0.0,0.0,0.0,933.0,3.0,23.0,Matches,545.0,fr FRA,MF,29.0,18.7,933.0,1087.0,85.8,16420.0,4480.0,410.0,467.0,87.8,375.0,416.0,90.1,111.0,139.0,79.9,2.0,2.2,2.5,-0.2,22.0,119.0,29.0,1.0,154.0,Matches,647,fr FRA,MF,29,30,1680.0,56.0,49.1,18.7,19,74.0,7,11,24.0,5,1.77,37.0,20.0,17.0,0.91,0.24,32.5,18.2,14.3,0.77,0.61,Matches,545.0,fr FRA,MF,29.0,18.7,1268.0,29.0,143.0,803.0,336.0,44.0,1268.0,45.0,22.0,48.9,17.0,37.8,1056.0,6119.0,2800.0,52.0,46.0,13.0,25.0,29.0,962.0,56.0,Matches,545.0,fr FRA,MF,29.0,18.7,2.0,25.0,6.0,24.0,1.34,0.32,0.08,0.33,18.4,0.0,0.0,0.0,2.3,2.3,0.09,-0.3,-0.3,Matches,545.0,fr FRA,MF,29.0,30.0,19.0,1680.0,18.7,2.0,2.0,4.0,2.0,0.0,0.0,2.0,0.0,2.3,2.3,2.2,4.5,52.0,154.0,56.0,0.11,0.11,0.21,0.11,0.21,0.13,0.12,0.24,0.13,0.24,Matches,Flavien Tait,M/AM LC,29,133,135,France,Stade Rennais FC,11,12,13,9,13,10,7,13,5,10,15,10,10,13,7,13,14,13,14,15,13,13,12,10,14,13,14,14,13,14,13,8,14,13,15,12,12,9,11,10,14,3,2,1,2,1,3,2,3,3,1,3,12,12,7,14,12,14,8,13,1,1,1,1,1,1,1,12,18,10,20,14,14,1,175,70,9,20,7999608,6650,6650,3809,Northern_European,132,5,1993/2/2,0,0,27598.0,,85121618
1046,Montassar Talbi,Lorient,1998,546.0,tn TUN,DF,24.0,38.0,53.0,25.0,40.0,13.0,0.0,22.0,35.0,62.9,13.0,55.0,34.0,21.0,40.0,93.0,190.0,3.0,Matches,546.0,tn TUN,DF,24.0,38.0,11.0,0.29,9.0,1.0,0.0,1.0,0.0,0.0,2.0,0.05,2.0,0.0,0.0,0.0,0.0,0.0,Matches,,,,,,,,,,,,,,,,,,,,,,,,,,,,,,,,,,,,,,,,,,,,,,,,,,,,,,,,546.0,tn TUN,DF,24.0,38.0,0.0,0.0,0.0,16.0,26.0,0.0,2.0,40.0,25.0,0.0,0.0,0.0,164.0,90.0,47.0,65.7,Matches,546.0,tn TUN,DF,24.0,38.0,1970.0,1821.0,147.0,56.0,0.0,1.0,2.0,3.0,0.0,0.0,0.0,0.0,1753.0,2.0,10.0,Matches,546.0,tn TUN,DF,24.0,38.0,1753.0,1970.0,89.0,31264.0,10740.0,614.0,653.0,94.0,970.0,1030.0,94.2,113.0,218.0,51.8,2.0,0.5,0.6,1.5,5.0,40.0,2.0,1.0,61.0,Matches,648,tn TUN,DF,24,38,3420.0,90.0,100.0,38.0,38,90.0,38,0,,0,1.45,52.0,53.0,-1.0,-0.03,,44.5,58.2,-13.6,-0.36,,Matches,546.0,tn TUN,DF,24.0,38.0,2365.0,481.0,1500.0,847.0,28.0,16.0,2365.0,11.0,7.0,63.6,4.0,36.4,1681.0,10840.0,5959.0,13.0,7.0,0.0,14.0,8.0,1547.0,0.0,Matches,546.0,tn TUN,DF,24.0,38.0,1.0,9.0,6.0,66.7,0.24,0.16,0.11,0.17,11.8,0.0,0.0,0.0,0.7,0.7,0.08,0.3,0.3,Matches,546.0,tn TUN,DF,24.0,38.0,38.0,3420.0,38.0,1.0,2.0,3.0,1.0,0.0,0.0,0.0,0.0,0.7,0.7,0.5,1.2,13.0,61.0,0.0,0.03,0.05,0.08,0.03,0.08,0.02,0.01,0.03,0.02,0.03,Matches,Montassar Talbi,D C,24,125,134,"Tunisia,France",FC Lorient,6,8,9,8,11,7,14,7,8,13,12,2,14,11,12,12,16,13,13,10,11,14,7,12,8,14,13,13,12,11,14,15,14,14,13,13,12,16,1,7,8,3,3,3,1,2,1,3,4,1,1,1,14,14,6,10,13,14,14,6,1,1,20,1,1,1,1,1,1,1,1,1,1,1,190,81,8,20,2698475,6244,6294,3998,North_African__Middle_Eastern,123,8,1998/5/26,20,0,10425.0,,13198535
1047,Florian Tardieu,Troyes,1992,548.0,fr FRA,MF,30.0,11.2,31.0,20.0,19.0,12.0,0.0,12.0,31.0,38.7,19.0,19.0,4.0,15.0,23.0,54.0,15.0,0.0,Matches,548.0,fr FRA,MF,30.0,11.2,45.0,4.01,35.0,9.0,0.0,1.0,0.0,0.0,4.0,0.36,3.0,1.0,0.0,0.0,0.0,0.0,Matches,,,,,,,,,,,,,,,,,,,,,,,,,,,,,,,,,,,,,,,,,,,,,,,,,,,,,,,,548.0,fr FRA,MF,30.0,11.2,2.0,0.0,0.0,11.0,20.0,0.0,43.0,23.0,20.0,0.0,0.0,0.0,87.0,7.0,8.0,46.7,Matches,548.0,fr FRA,MF,30.0,11.2,755.0,678.0,76.0,40.0,0.0,15.0,43.0,4.0,32.0,20.0,7.0,0.0,655.0,1.0,4.0,Matches,548.0,fr FRA,MF,30.0,11.2,655.0,755.0,86.8,11723.0,4194.0,302.0,325.0,92.9,242.0,267.0,90.6,84.0,127.0,66.1,0.0,1.0,1.2,-1.0,17.0,68.0,8.0,2.0,83.0,Matches,650,fr FRA,MF,30,15,1009.0,67.0,29.5,11.2,11,87.0,7,4,12.0,1,1.07,17.0,26.0,-9.0,-0.8,0.21,14.2,21.4,-7.2,-0.65,0.54,Matches,548.0,fr FRA,MF,30.0,11.2,870.0,36.0,218.0,503.0,158.0,11.0,867.0,12.0,7.0,58.3,3.0,25.0,650.0,3120.0,1385.0,20.0,22.0,4.0,12.0,12.0,584.0,17.0,Matches,548.0,fr FRA,MF,30.0,11.2,3.0,10.0,2.0,20.0,0.89,0.18,0.0,0.0,29.8,1.0,3.0,3.0,2.9,0.5,0.05,0.1,-0.5,Matches,548.0,fr FRA,MF,30.0,15.0,11.0,1009.0,11.2,3.0,0.0,3.0,0.0,3.0,3.0,2.0,0.0,2.9,0.5,1.0,1.5,20.0,83.0,17.0,0.27,0.0,0.27,0.0,0.0,0.26,0.09,0.35,0.05,0.14,Matches,Florian Tardieu,DM/M C,30,125,130,"France,Spain",ESTAC Troyes,12,11,11,10,14,12,12,12,6,12,15,14,11,12,13,13,14,12,13,12,13,14,9,13,9,13,15,17,10,11,13,12,14,10,15,12,12,13,13,7,6,1,1,1,3,1,1,2,3,1,3,1,11,13,7,14,13,12,12,11,1,1,1,1,1,1,20,1,19,1,1,1,1,1,184,72,10,20,2845242,6249,6249,3499,Mediterranean_Hispanic,124,6,1992/4/22,0,0,4999.0,,85116899
1048,Nuno Tavares,Marseille,2000,549.0,pt POR,DFMF,22.0,26.1,56.0,30.0,19.0,24.0,13.0,28.0,55.0,50.9,27.0,32.0,4.0,28.0,15.0,71.0,25.0,0.0,Matches,549.0,pt POR,DFMF,22.0,26.1,66.0,2.53,47.0,1.0,7.0,9.0,2.0,0.0,5.0,0.19,0.0,0.0,2.0,3.0,0.0,0.0,Matches,,,,,,,,,,,,,,,,,,,,,,,,,,,,,,,,,,,,,,,,,,,,,,,,,,,,,,,,549.0,pt POR,DFMF,22.0,26.1,6.0,1.0,0.0,37.0,38.0,6.0,96.0,15.0,30.0,0.0,0.0,0.0,173.0,23.0,31.0,42.6,Matches,549.0,pt POR,DFMF,22.0,26.1,1367.0,1105.0,257.0,15.0,3.0,16.0,96.0,241.0,1.0,0.0,0.0,0.0,1058.0,5.0,41.0,Matches,549.0,pt POR,DFMF,22.0,26.1,1058.0,1367.0,77.4,16121.0,5639.0,623.0,710.0,87.7,343.0,460.0,74.6,61.0,113.0,54.0,0.0,2.6,3.9,-2.6,24.0,70.0,47.0,14.0,115.0,Matches,651,pt POR,DFMF,22,31,2349.0,76.0,68.7,26.1,23,88.0,18,8,41.0,1,1.77,42.0,31.0,11.0,0.42,-0.92,42.3,31.6,10.7,0.41,-0.61,Matches,549.0,pt POR,DFMF,22.0,26.1,1779.0,45.0,361.0,685.0,765.0,88.0,1779.0,138.0,54.0,39.1,74.0,53.6,1213.0,8076.0,3913.0,96.0,68.0,19.0,75.0,67.0,1114.0,245.0,Matches,549.0,pt POR,DFMF,22.0,26.1,6.0,65.0,17.0,26.2,2.49,0.65,0.09,0.35,19.4,0.0,0.0,0.0,4.5,4.5,0.07,1.5,1.5,Matches,549.0,pt POR,DFMF,22.0,31.0,23.0,2349.0,26.1,6.0,0.0,6.0,6.0,0.0,0.0,6.0,1.0,4.5,4.5,2.6,7.1,96.0,115.0,245.0,0.23,0.0,0.23,0.23,0.23,0.17,0.1,0.27,0.17,0.27,Matches,Nuno Tavares,D/WB/M L,22,136,154,"Portugal,Cape Verde Islands",Arsenal,11,12,13,8,13,8,9,11,11,10,12,7,13,13,12,10,13,10,8,13,10,12,12,6,13,9,13,13,17,14,12,12,16,16,14,13,10,9,10,6,12,1,2,2,3,1,4,2,2,2,3,1,16,15,16,7,8,9,9,11,1,20,1,14,18,14,1,16,1,1,13,1,1,1,183,75,20,11,32361694,6800,6800,5000,African_Caribbean,122,13,2000/1/26,0,0,34798.0,Olympique de Marseille,83169864
1049,Martin Terrier,Rennes,1997,551.0,fr FRA,FWMF,25.0,14.7,25.0,11.0,7.0,9.0,9.0,13.0,24.0,54.2,11.0,15.0,2.0,13.0,14.0,39.0,6.0,0.0,Matches,551.0,fr FRA,FWMF,25.0,14.7,56.0,3.82,43.0,0.0,3.0,8.0,1.0,1.0,9.0,0.61,6.0,0.0,1.0,1.0,1.0,0.0,Matches,,,,,,,,,,,,,,,,,,,,,,,,,,,,,,,,,,,,,,,,,,,,,,,,,,,,,,,,551.0,fr FRA,FWMF,25.0,14.7,0.0,0.0,0.0,12.0,24.0,6.0,13.0,14.0,11.0,0.0,0.0,0.0,58.0,63.0,37.0,63.0,Matches,551.0,fr FRA,FWMF,25.0,14.7,603.0,593.0,9.0,2.0,5.0,5.0,13.0,1.0,0.0,0.0,0.0,0.0,447.0,1.0,17.0,Matches,551.0,fr FRA,FWMF,25.0,14.7,447.0,603.0,74.1,6794.0,1561.0,230.0,302.0,76.2,146.0,187.0,78.1,38.0,52.0,73.1,4.0,3.4,2.2,0.6,26.0,39.0,15.0,3.0,60.0,Matches,654,fr FRA,FWMF,25,16,1319.0,82.0,38.6,14.7,16,82.0,7,0,,0,2.06,29.0,17.0,12.0,0.82,0.05,25.0,16.0,9.1,0.62,0.27,Matches,551.0,fr FRA,FWMF,25.0,14.7,782.0,12.0,65.0,361.0,362.0,85.0,782.0,26.0,9.0,34.6,14.0,53.8,580.0,3282.0,1254.0,34.0,33.0,9.0,26.0,15.0,591.0,137.0,Matches,551.0,fr FRA,FWMF,25.0,14.7,9.0,47.0,27.0,57.4,3.21,1.84,0.19,0.33,15.2,0.0,0.0,0.0,5.6,5.6,0.12,3.4,3.4,Matches,551.0,fr FRA,FWMF,25.0,16.0,16.0,1319.0,14.7,9.0,4.0,13.0,9.0,0.0,0.0,0.0,0.0,5.6,5.6,3.4,9.0,34.0,60.0,137.0,0.61,0.27,0.89,0.61,0.89,0.38,0.23,0.61,0.38,0.61,Matches,Martin Terrier,AM/S RLC,25,147,151,France,Stade Rennais FC,12,11,13,15,16,12,13,12,4,5,14,11,5,16,10,13,11,13,12,13,13,15,15,8,14,8,14,13,15,13,13,12,14,14,14,12,13,7,12,8,16,1,2,1,1,1,1,2,2,3,1,3,19,14,6,13,12,16,9,14,1,1,1,1,1,1,1,13,11,13,20,18,16,19,184,73,10,20,36540000,7350,7350,4750,Northern_European,137,5,1997/3/4,0,0,59999.0,,48042204
1050,Tetê,Lyon,2000,552.0,br BRA,FWMF,22.0,12.3,21.0,10.0,8.0,5.0,8.0,10.0,19.0,52.6,9.0,9.0,0.0,9.0,13.0,34.0,2.0,0.0,Matches,552.0,br BRA,FWMF,22.0,12.3,30.0,2.44,20.0,4.0,2.0,3.0,1.0,0.0,7.0,0.57,4.0,0.0,1.0,1.0,1.0,0.0,Matches,,,,,,,,,,,,,,,,,,,,,,,,,,,,,,,,,,,,,,,,,,,,,,,,,,,,,,,,552.0,br BRA,FWMF,22.0,12.3,3.0,0.0,0.0,10.0,19.0,5.0,45.0,13.0,10.0,1.0,0.0,0.0,48.0,4.0,12.0,25.0,Matches,552.0,br BRA,FWMF,22.0,12.3,499.0,466.0,33.0,5.0,1.0,1.0,45.0,1.0,27.0,15.0,3.0,0.0,378.0,0.0,14.0,Matches,552.0,br BRA,FWMF,22.0,12.3,378.0,499.0,75.8,5666.0,1276.0,203.0,234.0,86.8,138.0,180.0,76.7,18.0,49.0,36.7,2.0,1.3,2.3,0.7,10.0,25.0,18.0,3.0,52.0,Matches,655,br BRA,FWMF,22,17,1107.0,65.0,32.4,12.3,14,77.0,2,3,11.0,2,1.12,18.0,14.0,4.0,0.33,-0.22,18.1,15.4,2.6,0.21,-0.05,Matches,552.0,br BRA,FWMF,22.0,12.3,649.0,3.0,58.0,252.0,351.0,60.0,649.0,54.0,21.0,38.9,28.0,51.9,506.0,3173.0,1322.0,49.0,28.0,27.0,31.0,15.0,482.0,130.0,Matches,552.0,br BRA,FWMF,22.0,12.3,6.0,30.0,13.0,43.3,2.44,1.06,0.2,0.46,16.5,1.0,0.0,0.0,4.2,4.2,0.14,1.8,1.8,Matches,552.0,br BRA,FWMF,22.0,17.0,14.0,1107.0,12.3,6.0,2.0,8.0,6.0,0.0,0.0,3.0,0.0,4.2,4.2,1.3,5.5,49.0,52.0,130.0,0.49,0.16,0.65,0.49,0.65,0.35,0.1,0.45,0.35,0.45,Matches,Tetê,M/AM R,22,137,156,Brazil,Shakhtar Donetsk,11,12,14,13,16,11,7,8,5,3,12,13,8,17,7,12,11,13,14,13,12,13,14,8,14,9,11,11,16,15,13,9,13,16,13,12,13,7,11,9,13,1,3,1,3,4,1,2,3,1,1,1,16,16,3,6,12,13,14,12,1,1,1,1,1,1,1,1,1,17,1,13,20,1,175,73,20,5,65175826,7500,7000,6000,Mixed_Race,135,15,2000/2/15,0,0,28236.0,Olympique Lyonnais,19348859
1051,Arthur Theate,Rennes,2000,553.0,be BEL,DF,22.0,34.7,29.0,19.0,17.0,8.0,4.0,17.0,30.0,56.7,13.0,26.0,14.0,12.0,30.0,59.0,114.0,3.0,Matches,553.0,be BEL,DF,22.0,34.7,23.0,0.66,22.0,0.0,0.0,0.0,0.0,1.0,2.0,0.06,2.0,0.0,0.0,0.0,0.0,0.0,Matches,,,,,,,,,,,,,,,,,,,,,,,,,,,,,,,,,,,,,,,,,,,,,,,,,,,,,,,,553.0,be BEL,DF,22.0,34.7,5.0,0.0,0.0,24.0,13.0,0.0,1.0,30.0,19.0,0.0,1.0,1.0,182.0,70.0,38.0,64.8,Matches,553.0,be BEL,DF,22.0,34.7,2568.0,2501.0,62.0,53.0,0.0,12.0,1.0,6.0,0.0,0.0,0.0,0.0,2296.0,5.0,12.0,Matches,553.0,be BEL,DF,22.0,34.7,2296.0,2568.0,89.4,46250.0,15551.0,631.0,684.0,92.3,1361.0,1449.0,93.9,266.0,366.0,72.7,0.0,0.6,0.8,-0.6,9.0,216.0,4.0,0.0,248.0,Matches,656,be BEL,DF,22,35,3127.0,89.0,91.4,34.7,35,89.0,33,0,,1,1.69,59.0,38.0,21.0,0.6,-2.16,55.4,41.3,14.1,0.41,-0.57,Matches,553.0,be BEL,DF,22.0,34.7,2856.0,222.0,1081.0,1644.0,141.0,40.0,2856.0,14.0,7.0,50.0,7.0,50.0,2313.0,14175.0,8082.0,37.0,35.0,0.0,15.0,5.0,2163.0,4.0,Matches,553.0,be BEL,DF,22.0,34.7,4.0,31.0,10.0,32.3,0.89,0.29,0.13,0.4,11.9,0.0,0.0,0.0,4.5,4.5,0.15,-0.5,-0.5,Matches,553.0,be BEL,DF,22.0,35.0,35.0,3127.0,34.7,4.0,0.0,4.0,4.0,0.0,0.0,5.0,0.0,4.5,4.5,0.6,5.1,37.0,248.0,4.0,0.12,0.0,0.12,0.12,0.12,0.13,0.02,0.15,0.13,0.15,Matches,Arthur Theate,D C,22,134,162,Belgium,Stade Rennais FC,5,9,11,9,11,6,16,9,8,14,12,7,14,12,15,16,15,11,12,11,11,17,13,13,11,14,14,14,14,13,12,14,13,13,14,14,13,13,14,5,11,1,2,2,3,3,2,1,3,2,1,1,15,16,12,11,12,15,10,10,1,13,20,1,1,1,10,1,1,1,1,1,1,1,186,76,20,8,28937999,6700,5806,5452,Mixed_Race,135,3,2000/5/25,3,0,23464.0,,18105815
1052,Sada Thioub,Angers,1995,554.0,sn SEN,DFFW,27.0,11.8,19.0,10.0,9.0,8.0,2.0,8.0,17.0,47.1,9.0,13.0,0.0,13.0,7.0,26.0,5.0,1.0,Matches,554.0,sn SEN,DFFW,27.0,11.8,37.0,3.14,27.0,4.0,4.0,1.0,0.0,1.0,4.0,0.34,4.0,0.0,0.0,0.0,0.0,0.0,Matches,,,,,,,,,,,,,,,,,,,,,,,,,,,,,,,,,,,,,,,,,,,,,,,,,,,,,,,,554.0,sn SEN,DFFW,27.0,11.8,3.0,0.0,0.0,14.0,6.0,0.0,37.0,7.0,10.0,0.0,0.0,0.0,63.0,4.0,14.0,22.2,Matches,554.0,sn SEN,DFFW,27.0,11.8,533.0,479.0,52.0,4.0,2.0,4.0,37.0,38.0,10.0,3.0,7.0,0.0,427.0,2.0,9.0,Matches,554.0,sn SEN,DFFW,27.0,11.8,427.0,533.0,80.1,6580.0,2287.0,230.0,263.0,87.5,153.0,188.0,81.4,24.0,43.0,55.8,2.0,1.9,1.9,0.1,15.0,46.0,19.0,8.0,57.0,Matches,657,sn SEN,DFFW,27,27,1060.0,39.0,31.0,11.8,11,73.0,2,16,16.0,10,0.48,15.0,27.0,-12.0,-1.02,0.35,13.3,20.1,-6.8,-0.57,-0.04,Matches,554.0,sn SEN,DFFW,27.0,11.8,640.0,14.0,116.0,301.0,234.0,21.0,640.0,35.0,16.0,45.7,16.0,45.7,474.0,2899.0,1288.0,23.0,22.0,5.0,15.0,20.0,447.0,78.0,Matches,554.0,sn SEN,DFFW,27.0,11.8,1.0,9.0,1.0,11.1,0.76,0.08,0.11,1.0,14.0,0.0,0.0,0.0,1.4,1.4,0.15,-0.4,-0.4,Matches,554.0,sn SEN,DFFW,27.0,27.0,11.0,1060.0,11.8,1.0,2.0,3.0,1.0,0.0,0.0,3.0,0.0,1.4,1.4,1.9,3.3,23.0,57.0,78.0,0.08,0.17,0.25,0.08,0.25,0.11,0.16,0.28,0.11,0.28,Matches,Sada Thioub,M/AM/S RL,27,125,130,"Senegal,France",Angers SCO,5,11,14,12,12,7,9,11,5,2,11,11,2,13,6,11,12,10,10,10,11,12,12,5,14,7,10,11,15,14,13,11,15,15,13,14,12,7,12,6,11,3,1,1,2,3,1,2,2,3,2,3,15,14,9,10,14,12,11,13,1,1,1,1,1,1,1,11,1,18,17,1,20,17,179,75,10,20,884377,5746,5746,3807,African_Caribbean,117,17,1995/6/1,7,0,6498.0,,85100069
1053,Adrien Thomasson,Strasbourg,1993,555.0,fr FRA,MF,28.0,10.4,19.0,9.0,8.0,6.0,5.0,9.0,30.0,30.0,21.0,18.0,0.0,18.0,3.0,22.0,2.0,0.0,Matches,555.0,fr FRA,MF,28.0,10.4,38.0,3.65,32.0,1.0,2.0,2.0,0.0,1.0,3.0,0.29,2.0,0.0,0.0,1.0,0.0,0.0,Matches,,,,,,,,,,,,,,,,,,,,,,,,,,,,,,,,,,,,,,,,,,,,,,,,,,,,,,,,555.0,fr FRA,MF,28.0,10.4,2.0,0.0,0.0,16.0,20.0,4.0,8.0,3.0,9.0,0.0,0.0,0.0,80.0,7.0,6.0,53.8,Matches,555.0,fr FRA,MF,28.0,10.4,524.0,502.0,21.0,11.0,2.0,3.0,8.0,3.0,1.0,0.0,0.0,0.0,429.0,1.0,13.0,Matches,555.0,fr FRA,MF,28.0,10.4,429.0,524.0,81.9,6717.0,1586.0,214.0,251.0,85.3,161.0,191.0,84.3,29.0,41.0,70.7,2.0,1.9,1.9,0.1,17.0,25.0,13.0,2.0,41.0,Matches,658,fr FRA,MF,28,15,937.0,62.0,27.4,10.4,10,81.0,6,5,25.0,0,0.73,7.0,18.0,-11.0,-1.06,-1.17,12.1,18.3,-6.2,-0.6,-0.57,Matches,555.0,fr FRA,MF,28.0,10.4,640.0,9.0,88.0,305.0,249.0,50.0,640.0,16.0,8.0,50.0,6.0,37.5,481.0,2357.0,930.0,15.0,17.0,3.0,21.0,18.0,453.0,73.0,Matches,555.0,fr FRA,MF,28.0,10.4,0.0,17.0,5.0,29.4,1.63,0.48,0.0,0.0,12.1,0.0,0.0,0.0,1.5,1.5,0.09,-1.5,-1.5,Matches,555.0,fr FRA,MF,28.0,15.0,10.0,937.0,10.4,0.0,2.0,2.0,0.0,0.0,0.0,2.0,0.0,1.5,1.5,1.9,3.4,15.0,41.0,73.0,0.0,0.19,0.19,0.0,0.19,0.15,0.18,0.33,0.15,0.33,Matches,Adrien Thomasson,M LC,28,132,134,"France,Croatia",RC Strasbourg Alsace,12,12,13,12,12,10,12,13,12,10,13,11,11,13,11,12,12,12,9,14,12,14,12,11,14,11,13,17,15,13,12,9,15,14,14,13,12,14,12,13,12,1,1,1,2,2,1,2,3,2,1,2,12,13,7,14,12,11,9,13,1,1,1,1,1,1,13,18,20,12,12,13,14,1,177,72,8,20,5770998,6600,6600,4268,Northern_European,129,6,1993/12/10,0,0,13798.0,,85128018
1054,Jean-Clair Todibo,Nice,1999,559.0,fr FRA,DF,22.0,31.9,76.0,48.0,54.0,19.0,3.0,41.0,56.0,73.2,15.0,41.0,19.0,22.0,41.0,117.0,110.0,2.0,Matches,559.0,fr FRA,DF,22.0,31.9,22.0,0.69,17.0,0.0,1.0,4.0,0.0,0.0,1.0,0.03,1.0,0.0,0.0,0.0,0.0,0.0,Matches,,,,,,,,,,,,,,,,,,,,,,,,,,,,,,,,,,,,,,,,,,,,,,,,,,,,,,,,559.0,fr FRA,DF,22.0,31.9,4.0,2.0,1.0,21.0,15.0,1.0,5.0,41.0,48.0,0.0,2.0,0.0,248.0,39.0,29.0,57.4,Matches,559.0,fr FRA,DF,22.0,31.9,2181.0,2113.0,63.0,60.0,2.0,10.0,5.0,1.0,0.0,0.0,0.0,0.0,1931.0,5.0,18.0,Matches,559.0,fr FRA,DF,22.0,31.9,1931.0,2181.0,88.5,37579.0,14089.0,614.0,646.0,95.0,1134.0,1198.0,94.7,161.0,289.0,55.7,0.0,0.2,0.6,-0.2,5.0,137.0,6.0,1.0,153.0,Matches,662,fr FRA,DF,22,34,2870.0,84.0,83.9,31.9,33,86.0,30,1,31.0,0,1.53,43.0,29.0,14.0,0.44,0.93,47.5,37.1,10.4,0.33,-0.03,Matches,559.0,fr FRA,DF,22.0,31.9,2514.0,304.0,1267.0,1222.0,57.0,24.0,2514.0,28.0,20.0,71.4,6.0,21.4,1980.0,11039.0,5931.0,21.0,13.0,0.0,23.0,10.0,1760.0,6.0,Matches,559.0,fr FRA,DF,22.0,31.9,0.0,14.0,4.0,28.6,0.44,0.13,0.0,0.0,13.4,0.0,0.0,0.0,0.8,0.8,0.06,-0.8,-0.8,Matches,559.0,fr FRA,DF,22.0,34.0,33.0,2870.0,31.9,0.0,0.0,0.0,0.0,0.0,0.0,4.0,2.0,0.8,0.8,0.2,1.0,21.0,153.0,6.0,0.0,0.0,0.0,0.0,0.0,0.03,0.01,0.03,0.03,0.03,Matches,Jean-Clair Todibo,D C,22,140,162,"France,French Guiana",OGC Nice,3,5,14,8,13,4,14,8,7,15,14,5,16,14,14,14,14,15,11,13,12,16,14,9,8,12,14,12,13,14,13,16,16,16,13,15,16,8,16,8,12,1,2,1,2,1,1,2,2,1,3,1,14,15,10,14,16,15,13,12,1,1,20,1,1,1,1,1,1,1,1,1,1,1,190,88,10,20,48974267,6750,6750,5000,Mixed_Race,139,15,1999/12/30,0,0,24051.0,,48044499
1055,Karl Toko Ekambi,Rennes,1992,560.0,cm CMR,FWMF,29.0,10.8,3.0,1.0,1.0,1.0,1.0,3.0,9.0,33.3,6.0,5.0,0.0,5.0,9.0,12.0,3.0,0.0,Matches,560.0,cm CMR,FWMF,29.0,10.8,25.0,2.32,18.0,0.0,2.0,2.0,2.0,1.0,6.0,0.56,3.0,0.0,1.0,1.0,0.0,1.0,Matches,,,,,,,,,,,,,,,,,,,,,,,,,,,,,,,,,,,,,,,,,,,,,,,,,,,,,,,,560.0,cm CMR,FWMF,29.0,10.8,0.0,0.0,0.0,7.0,8.0,8.0,6.0,9.0,1.0,0.0,0.0,0.0,28.0,18.0,26.0,40.9,Matches,560.0,cm CMR,FWMF,29.0,10.8,288.0,278.0,10.0,0.0,0.0,1.0,6.0,3.0,0.0,0.0,0.0,0.0,208.0,0.0,7.0,Matches,560.0,cm CMR,FWMF,29.0,10.8,208.0,288.0,72.2,2928.0,599.0,116.0,146.0,79.5,77.0,107.0,72.0,5.0,8.0,62.5,2.0,1.4,0.9,0.6,12.0,10.0,8.0,2.0,21.0,Matches,663,cm CMR,FWMF,29,17,972.0,57.0,28.4,10.8,11,77.0,2,6,21.0,0,1.82,23.0,6.0,17.0,1.57,1.1,17.8,11.9,5.8,0.54,0.12,Matches,560.0,cm CMR,FWMF,29.0,10.8,378.0,5.0,23.0,183.0,176.0,51.0,378.0,19.0,12.0,63.2,7.0,36.8,295.0,1905.0,764.0,30.0,23.0,16.0,18.0,15.0,295.0,87.0,Matches,560.0,cm CMR,FWMF,29.0,10.8,3.0,22.0,7.0,31.8,2.04,0.65,0.14,0.43,13.4,0.0,0.0,0.0,3.6,3.6,0.16,-0.6,-0.6,Matches,560.0,cm CMR,FWMF,29.0,17.0,11.0,972.0,10.8,3.0,2.0,5.0,3.0,0.0,0.0,0.0,0.0,3.6,3.6,1.4,5.0,30.0,21.0,87.0,0.28,0.19,0.46,0.28,0.46,0.33,0.13,0.47,0.33,0.47,Matches,Karl Toko Ekambi,AM/S RL,29,135,151,"Cameroon,France",Olympique Lyonnais,9,11,12,14,12,10,15,12,6,5,11,12,7,12,8,12,11,11,13,11,11,13,13,10,15,8,11,13,16,12,13,12,14,16,15,14,11,7,15,7,8,2,2,3,1,3,1,1,3,1,3,3,8,14,7,13,10,12,13,14,1,1,1,1,1,1,1,1,1,1,20,1,16,18,185,74,8,20,8119068,6748,6748,5248,African_Caribbean,129,17,1992/9/14,50,12,46027.0,,85085653
1056,Corentin Tolisso,Lyon,1994,562.0,fr FRA,MF,27.0,22.6,44.0,27.0,16.0,23.0,5.0,25.0,66.0,37.9,41.0,25.0,5.0,20.0,24.0,68.0,23.0,1.0,Matches,562.0,fr FRA,MF,27.0,22.6,83.0,3.67,67.0,4.0,0.0,7.0,4.0,1.0,8.0,0.35,6.0,0.0,0.0,2.0,0.0,0.0,Matches,,,,,,,,,,,,,,,,,,,,,,,,,,,,,,,,,,,,,,,,,,,,,,,,,,,,,,,,562.0,fr FRA,MF,27.0,22.6,3.0,0.0,0.0,28.0,38.0,0.0,37.0,24.0,27.0,0.0,0.0,0.0,199.0,35.0,24.0,59.3,Matches,562.0,fr FRA,MF,27.0,22.6,1950.0,1859.0,90.0,82.0,11.0,33.0,37.0,4.0,2.0,0.0,1.0,0.0,1710.0,1.0,25.0,Matches,562.0,fr FRA,MF,27.0,22.6,1710.0,1950.0,87.7,31063.0,9727.0,741.0,814.0,91.0,701.0,775.0,90.5,215.0,268.0,80.2,2.0,4.4,5.3,-2.4,32.0,208.0,38.0,9.0,230.0,Matches,665,fr FRA,MF,27,30,2036.0,68.0,59.5,22.6,25,76.0,11,5,27.0,0,1.63,45.0,31.0,14.0,0.62,0.36,37.9,32.0,5.9,0.26,0.03,Matches,562.0,fr FRA,MF,27.0,22.6,2164.0,70.0,409.0,1370.0,400.0,23.0,2164.0,18.0,7.0,38.9,7.0,38.9,1748.0,8599.0,3431.0,32.0,43.0,2.0,21.0,17.0,1636.0,52.0,Matches,562.0,fr FRA,MF,27.0,22.6,1.0,30.0,9.0,30.0,1.33,0.4,0.03,0.11,23.0,0.0,0.0,0.0,1.7,1.7,0.06,-0.7,-0.7,Matches,562.0,fr FRA,MF,27.0,30.0,25.0,2036.0,22.6,1.0,2.0,3.0,1.0,0.0,0.0,3.0,0.0,1.7,1.7,4.4,6.2,32.0,230.0,52.0,0.04,0.09,0.13,0.04,0.13,0.08,0.2,0.27,0.08,0.27,Matches,Corentin Tolisso,DM/M C,27,143,145,"France,Togo",Olympique Lyonnais,12,10,10,14,13,8,15,16,8,12,14,12,12,14,16,13,15,13,12,14,12,16,12,12,16,12,15,16,12,12,15,13,9,13,15,14,13,11,14,17,16,1,2,4,1,3,1,1,1,4,1,1,8,12,12,15,12,15,10,10,1,12,1,13,10,10,20,12,19,13,11,15,11,1,181,81,10,20,26111602,7150,7100,6650,African_Caribbean,137,12,1994/8/3,28,2,95889.0,,29114971
1057,Birama Touré,Auxerre,1992,563.0,ml MLI,MF,30.0,37.8,80.0,47.0,35.0,35.0,10.0,34.0,93.0,36.6,59.0,54.0,9.0,45.0,67.0,147.0,49.0,0.0,Matches,563.0,ml MLI,MF,30.0,37.8,34.0,0.9,27.0,1.0,0.0,0.0,1.0,5.0,1.0,0.03,1.0,0.0,0.0,0.0,0.0,0.0,Matches,,,,,,,,,,,,,,,,,,,,,,,,,,,,,,,,,,,,,,,,,,,,,,,,,,,,,,,,563.0,ml MLI,MF,30.0,37.8,3.0,0.0,0.0,50.0,22.0,0.0,14.0,67.0,47.0,0.0,1.0,0.0,242.0,56.0,60.0,48.3,Matches,563.0,ml MLI,MF,30.0,37.8,1538.0,1508.0,28.0,23.0,1.0,25.0,14.0,4.0,1.0,0.0,0.0,0.0,1236.0,2.0,24.0,Matches,563.0,ml MLI,MF,30.0,37.8,1236.0,1538.0,80.4,23867.0,7341.0,466.0,545.0,85.5,516.0,597.0,86.4,199.0,291.0,68.4,0.0,0.2,0.9,-0.2,5.0,121.0,11.0,0.0,138.0,Matches,666,ml MLI,MF,30,38,3400.0,89.0,99.4,37.8,38,89.0,34,0,,0,0.92,34.0,61.0,-27.0,-0.71,3.79,42.2,58.2,-16.0,-0.42,-1.65,Matches,563.0,ml MLI,MF,30.0,37.8,1904.0,94.0,514.0,1188.0,214.0,14.0,1903.0,23.0,11.0,47.8,8.0,34.8,1280.0,6052.0,2210.0,10.0,21.0,1.0,39.0,15.0,1118.0,25.0,Matches,563.0,ml MLI,MF,30.0,37.8,2.0,25.0,7.0,28.0,0.66,0.19,0.08,0.29,26.1,0.0,0.0,1.0,1.9,1.1,0.04,0.1,0.9,Matches,563.0,ml MLI,MF,30.0,38.0,38.0,3400.0,37.8,2.0,0.0,2.0,2.0,0.0,1.0,3.0,0.0,1.9,1.1,0.2,1.3,10.0,138.0,25.0,0.05,0.0,0.05,0.05,0.05,0.05,0.01,0.06,0.03,0.04,Matches,Birama Touré,DM/M C,30,124,129,"Mali,France",AJ Auxerre,8,11,11,8,12,9,13,12,6,13,12,10,13,14,13,13,13,13,12,12,11,12,7,14,13,12,16,13,13,13,13,12,15,13,16,13,12,11,14,6,8,4,1,2,3,2,4,3,1,3,4,1,7,13,6,15,12,13,14,14,1,1,8,1,1,1,20,1,17,10,1,1,1,1,183,76,8,20,1962139,6200,6200,3502,African_Caribbean,124,14,1992/6/6,10,0,5771.0,,85083759
1058,Hamari Traoré,Rennes,1992,569.0,ml MLI,DF,30.0,28.1,48.0,32.0,26.0,15.0,7.0,28.0,52.0,53.8,24.0,33.0,7.0,26.0,38.0,86.0,64.0,0.0,Matches,569.0,ml MLI,DF,30.0,28.1,64.0,2.28,57.0,0.0,1.0,5.0,0.0,1.0,11.0,0.39,10.0,0.0,1.0,0.0,0.0,0.0,Matches,,,,,,,,,,,,,,,,,,,,,,,,,,,,,,,,,,,,,,,,,,,,,,,,,,,,,,,,569.0,ml MLI,DF,30.0,28.1,5.0,0.0,0.0,33.0,6.0,3.0,63.0,38.0,32.0,0.0,2.0,0.0,155.0,33.0,34.0,49.3,Matches,569.0,ml MLI,DF,30.0,28.1,1826.0,1624.0,200.0,26.0,4.0,10.0,63.0,174.0,0.0,0.0,0.0,0.0,1541.0,2.0,28.0,Matches,569.0,ml MLI,DF,30.0,28.1,1541.0,1826.0,84.4,27185.0,8228.0,633.0,709.0,89.3,759.0,868.0,87.4,124.0,194.0,63.9,4.0,2.6,3.6,1.4,22.0,132.0,34.0,13.0,159.0,Matches,674,ml MLI,DF,30,31,2528.0,82.0,73.9,28.1,28,89.0,22,3,16.0,0,1.81,55.0,29.0,26.0,0.93,0.52,47.2,31.0,16.2,0.58,0.47,Matches,569.0,ml MLI,DF,30.0,28.1,2083.0,90.0,426.0,1130.0,537.0,64.0,2083.0,18.0,9.0,50.0,9.0,50.0,1512.0,7652.0,3415.0,55.0,63.0,8.0,26.0,9.0,1399.0,162.0,Matches,569.0,ml MLI,DF,30.0,28.1,1.0,30.0,9.0,30.0,1.07,0.32,0.03,0.11,15.5,0.0,0.0,0.0,1.9,1.9,0.06,-0.9,-0.9,Matches,569.0,ml MLI,DF,30.0,31.0,28.0,2528.0,28.1,1.0,4.0,5.0,1.0,0.0,0.0,5.0,0.0,1.9,1.9,2.6,4.4,55.0,159.0,162.0,0.04,0.14,0.18,0.04,0.18,0.07,0.09,0.16,0.07,0.16,Matches,Hamari Traoré,D R,30,136,138,Mali,Stade Rennais FC,10,13,11,7,12,8,12,7,15,13,12,5,12,12,15,13,13,11,12,11,13,12,12,9,13,13,14,16,15,13,12,10,16,15,17,12,15,13,12,5,13,1,3,1,1,2,3,2,2,2,2,2,14,10,8,12,13,14,13,18,1,1,1,20,1,15,1,1,1,10,1,1,10,1,175,71,10,20,6519267,6800,6800,4500,African_Caribbean,134,15,1992/1/27,42,1,14564.0,,30035411
1059,Adrien Truffert,Rennes,2001,571.0,fr FRA,DF,20.0,21.7,62.0,32.0,36.0,17.0,9.0,31.0,46.0,67.4,15.0,32.0,8.0,24.0,22.0,84.0,55.0,0.0,Matches,571.0,fr FRA,DF,20.0,21.7,51.0,2.35,40.0,3.0,3.0,3.0,2.0,0.0,8.0,0.37,7.0,1.0,0.0,0.0,0.0,0.0,Matches,,,,,,,,,,,,,,,,,,,,,,,,,,,,,,,,,,,,,,,,,,,,,,,,,,,,,,,,571.0,fr FRA,DF,20.0,21.7,1.0,0.0,0.0,20.0,25.0,3.0,35.0,22.0,32.0,0.0,0.0,0.0,126.0,34.0,26.0,56.7,Matches,571.0,fr FRA,DF,20.0,21.7,1395.0,1153.0,239.0,17.0,0.0,2.0,35.0,222.0,0.0,0.0,0.0,0.0,1106.0,3.0,36.0,Matches,571.0,fr FRA,DF,20.0,21.7,1106.0,1395.0,79.3,17515.0,5252.0,544.0,621.0,87.6,487.0,625.0,77.9,52.0,87.0,59.8,6.0,1.5,1.6,4.5,22.0,71.0,17.0,10.0,89.0,Matches,676,fr FRA,DF,20,28,1954.0,70.0,57.1,21.7,24,79.0,13,4,13.0,0,1.79,35.0,25.0,10.0,0.46,-0.77,33.6,28.2,5.3,0.25,-0.49,Matches,571.0,fr FRA,DF,20.0,21.7,1656.0,65.0,410.0,790.0,467.0,30.0,1656.0,46.0,21.0,45.7,19.0,41.3,1071.0,5984.0,2659.0,55.0,53.0,9.0,27.0,14.0,979.0,166.0,Matches,571.0,fr FRA,DF,20.0,21.7,0.0,10.0,3.0,30.0,0.46,0.14,0.0,0.0,21.3,0.0,0.0,0.0,0.6,0.6,0.06,-0.6,-0.6,Matches,571.0,fr FRA,DF,20.0,28.0,24.0,1954.0,21.7,0.0,6.0,6.0,0.0,0.0,0.0,1.0,0.0,0.6,0.6,1.5,2.2,55.0,89.0,166.0,0.0,0.28,0.28,0.0,0.28,0.03,0.07,0.1,0.03,0.1,Matches,Adrien Truffert,D L,20,122,-8,France,Stade Rennais FC,7,14,11,12,13,5,7,12,6,12,14,5,13,13,13,12,13,12,12,13,13,12,13,7,14,13,14,13,14,13,12,7,12,14,14,12,13,12,12,5,12,2,3,3,1,1,1,1,2,3,2,2,15,8,5,11,12,13,9,18,1,20,1,1,13,1,1,15,1,1,12,1,1,1,173,63,20,8,63331488,6093,6093,4993,Northern_European,123,4,2001/11/20,0,0,9270.0,,49050736
1060,Lesley Ugochukwu,Rennes,2004,574.0,fr FRA,MF,18.0,14.8,36.0,19.0,13.0,20.0,3.0,16.0,24.0,66.7,8.0,24.0,10.0,14.0,21.0,57.0,16.0,0.0,Matches,574.0,fr FRA,MF,18.0,14.8,13.0,0.88,10.0,0.0,2.0,0.0,0.0,1.0,2.0,0.14,2.0,0.0,0.0,0.0,0.0,0.0,Matches,,,,,,,,,,,,,,,,,,,,,,,,,,,,,,,,,,,,,,,,,,,,,,,,,,,,,,,,574.0,fr FRA,MF,18.0,14.8,3.0,1.0,0.0,29.0,12.0,0.0,2.0,21.0,19.0,0.0,0.0,0.0,71.0,16.0,7.0,69.6,Matches,574.0,fr FRA,MF,18.0,14.8,648.0,634.0,14.0,14.0,0.0,3.0,2.0,0.0,0.0,0.0,0.0,0.0,566.0,0.0,8.0,Matches,574.0,fr FRA,MF,18.0,14.8,566.0,648.0,87.3,10531.0,2415.0,213.0,249.0,85.5,276.0,297.0,92.9,64.0,77.0,83.1,1.0,0.8,0.6,0.2,3.0,43.0,3.0,0.0,50.0,Matches,680,fr FRA,MF,18,26,1330.0,51.0,38.9,14.8,14,78.0,5,12,20.0,11,1.92,23.0,17.0,6.0,0.41,-0.63,22.4,19.5,2.9,0.2,-0.42,Matches,574.0,fr FRA,MF,18.0,14.8,790.0,36.0,172.0,546.0,80.0,7.0,790.0,22.0,14.0,63.6,6.0,27.3,611.0,3424.0,1453.0,11.0,16.0,4.0,6.0,11.0,557.0,11.0,Matches,574.0,fr FRA,MF,18.0,14.8,0.0,6.0,1.0,16.7,0.41,0.07,0.0,0.0,18.4,0.0,0.0,0.0,0.9,0.9,0.15,-0.9,-0.9,Matches,574.0,fr FRA,MF,18.0,26.0,14.0,1330.0,14.8,0.0,1.0,1.0,0.0,0.0,0.0,3.0,1.0,0.9,0.9,0.8,1.8,11.0,50.0,11.0,0.0,0.07,0.07,0.0,0.07,0.06,0.06,0.12,0.06,0.12,Matches,Lesley Ugochukwu,M C,18,105,-8,"France,Nigeria",Stade Rennais FC,10,9,10,9,12,7,12,11,5,12,12,8,11,10,11,10,12,10,11,11,11,7,5,6,11,12,11,12,11,9,12,12,11,12,13,15,10,5,8,8,12,2,3,1,1,1,2,2,1,3,3,1,14,11,1,12,9,12,11,13,1,1,1,1,1,1,15,1,20,1,1,1,1,1,188,0,10,20,44417441,5249,5249,1999,African_Caribbean,100,15,2004/3/26,0,0,2465.0,,2000006186
1061,Cengiz Ünder,Marseille,1997,575.0,tr TUR,MFDF,25.0,27.7,37.0,19.0,15.0,13.0,9.0,13.0,34.0,38.2,21.0,18.0,2.0,16.0,18.0,55.0,13.0,0.0,Matches,575.0,tr TUR,MFDF,25.0,27.7,117.0,4.23,73.0,22.0,9.0,7.0,3.0,3.0,9.0,0.33,6.0,1.0,0.0,1.0,1.0,0.0,Matches,,,,,,,,,,,,,,,,,,,,,,,,,,,,,,,,,,,,,,,,,,,,,,,,,,,,,,,,575.0,tr TUR,MFDF,25.0,27.7,3.0,0.0,0.0,29.0,31.0,8.0,157.0,18.0,19.0,0.0,0.0,0.0,133.0,11.0,19.0,36.7,Matches,575.0,tr TUR,MFDF,25.0,27.7,1114.0,984.0,128.0,21.0,9.0,14.0,157.0,35.0,67.0,40.0,9.0,0.0,778.0,2.0,39.0,Matches,575.0,tr TUR,MFDF,25.0,27.7,778.0,1114.0,69.8,13245.0,4270.0,405.0,484.0,83.7,255.0,366.0,69.7,89.0,182.0,48.9,4.0,7.9,7.4,-3.9,55.0,71.0,50.0,18.0,115.0,Matches,681,tr TUR,MFDF,25,37,2490.0,67.0,72.8,27.7,28,82.0,14,9,22.0,1,1.89,51.0,27.0,24.0,0.87,0.58,46.8,27.0,19.9,0.72,0.43,Matches,575.0,tr TUR,MFDF,25.0,27.7,1440.0,18.0,139.0,528.0,792.0,130.0,1439.0,96.0,39.0,40.6,50.0,52.1,1070.0,6465.0,2493.0,69.0,47.0,30.0,60.0,31.0,985.0,262.0,Matches,575.0,tr TUR,MFDF,25.0,27.7,5.0,70.0,23.0,32.9,2.53,0.83,0.06,0.17,17.1,2.0,1.0,1.0,8.3,7.5,0.11,-3.3,-3.5,Matches,575.0,tr TUR,MFDF,25.0,37.0,28.0,2490.0,27.7,5.0,4.0,9.0,4.0,1.0,1.0,3.0,0.0,8.3,7.5,7.9,15.5,69.0,115.0,262.0,0.18,0.14,0.33,0.14,0.29,0.3,0.29,0.59,0.27,0.56,Matches,Cengiz Ünder,M/AM RLC,25,138,144,Turkey,Olympique de Marseille,13,14,15,12,14,14,7,14,3,3,12,9,4,15,7,11,8,13,12,12,11,12,15,5,13,4,11,11,17,16,13,7,12,16,11,9,13,10,14,12,13,2,2,3,1,2,2,2,2,3,2,1,12,14,5,13,12,13,11,12,1,1,1,1,1,1,1,14,1,18,15,15,20,10,173,66,20,10,16011006,6900,6900,5000,Mediterranean_Hispanic,133,6,1997/7/14,42,13,60941.0,,70096289
1062,Vanderson,Monaco,2001,578.0,br BRA,DFMF,21.0,24.6,84.0,48.0,36.0,34.0,14.0,44.0,75.0,58.7,31.0,36.0,9.0,27.0,48.0,132.0,36.0,1.0,Matches,578.0,br BRA,DFMF,21.0,24.6,62.0,2.52,48.0,5.0,5.0,2.0,0.0,2.0,8.0,0.33,6.0,0.0,2.0,0.0,0.0,0.0,Matches,,,,,,,,,,,,,,,,,,,,,,,,,,,,,,,,,,,,,,,,,,,,,,,,,,,,,,,,578.0,br BRA,DFMF,21.0,24.6,4.0,1.0,1.0,36.0,18.0,3.0,98.0,48.0,48.0,0.0,0.0,0.0,167.0,27.0,27.0,50.0,Matches,578.0,br BRA,DFMF,21.0,24.6,1382.0,1170.0,203.0,15.0,1.0,14.0,98.0,184.0,4.0,0.0,3.0,0.0,1039.0,9.0,36.0,Matches,578.0,br BRA,DFMF,21.0,24.6,1039.0,1382.0,75.2,17816.0,6391.0,492.0,590.0,83.4,405.0,516.0,78.5,103.0,192.0,53.6,4.0,3.5,3.1,0.5,27.0,85.0,31.0,14.0,108.0,Matches,684,br BRA,DFMF,21,31,2214.0,71.0,64.7,24.6,24,83.0,14,7,33.0,1,1.74,52.0,35.0,17.0,0.69,1.06,39.1,34.6,4.4,0.18,-0.15,Matches,578.0,br BRA,DFMF,21.0,24.6,1689.0,60.0,350.0,766.0,583.0,51.0,1689.0,67.0,27.0,40.3,32.0,47.8,1098.0,6082.0,2745.0,50.0,37.0,9.0,37.0,21.0,966.0,175.0,Matches,578.0,br BRA,DFMF,21.0,24.6,1.0,26.0,8.0,30.8,1.06,0.33,0.04,0.13,19.5,0.0,0.0,0.0,2.4,2.4,0.09,-1.4,-1.4,Matches,578.0,br BRA,DFMF,21.0,31.0,24.0,2214.0,24.6,1.0,4.0,5.0,1.0,0.0,0.0,4.0,1.0,2.4,2.4,3.5,5.9,50.0,108.0,175.0,0.04,0.16,0.2,0.04,0.2,0.1,0.14,0.24,0.1,0.24,Matches,Vanderson,D/WB/M R,21,133,158,Brazil,AS Monaco,9,14,14,10,14,12,10,9,8,11,13,11,13,14,13,13,14,13,11,14,14,15,13,9,15,10,14,13,14,14,13,8,16,14,15,9,15,8,14,4,13,1,2,2,3,2,1,1,1,3,3,2,14,13,5,13,13,14,13,12,1,1,1,20,1,18,1,1,10,16,1,1,12,1,180,74,7,20,31039996,6646,6646,3503,African_Caribbean,128,12,2001/6/21,0,0,22382.0,,19409448
1063,Jordan Veretout,Marseille,1993,579.0,fr FRA,MF,29.0,31.8,56.0,35.0,17.0,32.0,7.0,25.0,53.0,47.2,28.0,22.0,7.0,15.0,36.0,92.0,40.0,2.0,Matches,579.0,fr FRA,MF,29.0,31.8,82.0,2.58,51.0,16.0,3.0,7.0,0.0,5.0,9.0,0.28,2.0,4.0,1.0,1.0,0.0,1.0,Matches,,,,,,,,,,,,,,,,,,,,,,,,,,,,,,,,,,,,,,,,,,,,,,,,,,,,,,,,579.0,fr FRA,MF,29.0,31.8,4.0,0.0,0.0,35.0,24.0,2.0,83.0,36.0,35.0,0.0,0.0,1.0,243.0,20.0,26.0,43.5,Matches,579.0,fr FRA,MF,29.0,31.8,2148.0,2023.0,119.0,53.0,7.0,30.0,83.0,8.0,58.0,35.0,11.0,0.0,1834.0,6.0,22.0,Matches,579.0,fr FRA,MF,29.0,31.8,1834.0,2148.0,85.4,35304.0,9959.0,676.0,757.0,89.3,858.0,958.0,89.6,243.0,339.0,71.7,3.0,3.8,3.8,-0.8,36.0,274.0,25.0,7.0,248.0,Matches,685,fr FRA,MF,29,38,2863.0,75.0,83.7,31.8,31,86.0,24,7,27.0,0,1.92,55.0,31.0,24.0,0.75,0.27,54.5,34.1,20.4,0.64,0.25,Matches,579.0,fr FRA,MF,29.0,31.8,2376.0,89.0,399.0,1489.0,511.0,33.0,2375.0,18.0,12.0,66.7,5.0,27.8,1860.0,10525.0,4999.0,59.0,62.0,6.0,28.0,13.0,1702.0,73.0,Matches,579.0,fr FRA,MF,29.0,31.8,4.0,30.0,9.0,30.0,0.94,0.28,0.1,0.33,20.5,1.0,1.0,1.0,3.9,3.1,0.1,0.1,-0.1,Matches,579.0,fr FRA,MF,29.0,38.0,31.0,2863.0,31.8,4.0,3.0,7.0,3.0,1.0,1.0,4.0,0.0,3.9,3.1,3.8,6.9,59.0,248.0,73.0,0.13,0.09,0.22,0.09,0.19,0.12,0.12,0.24,0.1,0.22,Matches,Jordan Veretout,DM/M C,29,145,154,France,Olympique de Marseille,13,15,12,13,13,12,8,14,6,10,16,17,11,14,12,15,11,15,11,14,14,12,11,6,16,9,15,15,13,14,16,9,12,14,16,12,13,12,10,11,12,3,2,2,3,2,1,3,3,2,1,3,12,15,12,11,14,14,12,13,1,1,1,1,1,1,17,10,20,1,1,10,1,1,177,75,10,20,29933934,7250,6505,6505,Northern_European,145,3,1993/3/1,5,0,106731.0,,85052016
1064,Marco Verratti,Paris S-G,1992,580.0,it ITA,MF,29.0,24.4,76.0,49.0,34.0,36.0,6.0,38.0,89.0,42.7,51.0,42.0,6.0,36.0,27.0,103.0,11.0,3.0,Matches,580.0,it ITA,MF,29.0,24.4,83.0,3.41,78.0,2.0,1.0,1.0,0.0,1.0,9.0,0.37,8.0,0.0,0.0,0.0,0.0,1.0,Matches,,,,,,,,,,,,,,,,,,,,,,,,,,,,,,,,,,,,,,,,,,,,,,,,,,,,,,,,580.0,it ITA,MF,29.0,24.4,10.0,1.0,0.0,36.0,53.0,0.0,7.0,27.0,49.0,0.0,1.0,0.0,175.0,11.0,13.0,45.8,Matches,580.0,it ITA,MF,29.0,24.4,2573.0,2444.0,123.0,99.0,17.0,2.0,7.0,23.0,1.0,0.0,0.0,0.0,2383.0,6.0,17.0,Matches,580.0,it ITA,MF,29.0,24.4,2383.0,2573.0,92.6,36470.0,12516.0,1265.0,1333.0,94.9,848.0,896.0,94.6,153.0,195.0,78.5,0.0,2.5,4.9,-2.5,33.0,222.0,55.0,3.0,262.0,Matches,686,it ITA,MF,29,29,2194.0,76.0,64.2,24.4,27,80.0,14,2,21.0,0,2.21,59.0,26.0,33.0,1.35,0.18,55.0,31.1,23.9,0.98,0.54,Matches,580.0,it ITA,MF,29.0,24.4,2783.0,69.0,527.0,1743.0,538.0,26.0,2783.0,53.0,29.0,54.7,14.0,26.4,2376.0,11182.0,5529.0,40.0,79.0,5.0,17.0,33.0,2274.0,52.0,Matches,580.0,it ITA,MF,29.0,24.4,0.0,8.0,4.0,50.0,0.33,0.16,0.0,0.0,17.8,0.0,0.0,0.0,0.8,0.8,0.1,-0.8,-0.8,Matches,580.0,it ITA,MF,29.0,29.0,27.0,2194.0,24.4,0.0,0.0,0.0,0.0,0.0,0.0,10.0,1.0,0.8,0.8,2.5,3.3,40.0,262.0,52.0,0.0,0.0,0.0,0.0,0.0,0.03,0.1,0.14,0.03,0.14,Matches,Marco Verratti,DM/M C,29,164,165,Italy,Paris Saint-Germain,14,17,16,10,18,13,6,13,6,12,18,15,15,17,14,17,16,18,14,18,15,14,18,12,14,13,17,13,12,16,16,6,12,12,12,9,14,12,14,13,12,3,1,2,2,2,4,3,4,3,3,2,12,17,10,14,14,13,7,8,1,1,1,1,1,1,18,1,20,1,1,12,1,1,165,60,10,20,157373875,8195,8195,7245,Mediterranean_Hispanic,163,4,1992/11/5,49,3,276164.0,,43026579
1065,Clément Vidal,Ajaccio,2000,582.0,fr FRA,DFMF,22.0,21.1,25.0,15.0,14.0,11.0,0.0,18.0,38.0,47.4,20.0,27.0,16.0,11.0,27.0,52.0,73.0,1.0,Matches,582.0,fr FRA,DFMF,22.0,21.1,6.0,0.28,5.0,0.0,0.0,1.0,0.0,0.0,0.0,0.0,0.0,0.0,0.0,0.0,0.0,0.0,Matches,,,,,,,,,,,,,,,,,,,,,,,,,,,,,,,,,,,,,,,,,,,,,,,,,,,,,,,,582.0,fr FRA,DFMF,22.0,21.1,5.0,1.0,0.0,22.0,18.0,1.0,3.0,27.0,15.0,0.0,1.0,0.0,92.0,50.0,26.0,65.8,Matches,582.0,fr FRA,DFMF,22.0,21.1,785.0,749.0,35.0,21.0,0.0,1.0,3.0,14.0,0.0,0.0,0.0,0.0,604.0,1.0,10.0,Matches,582.0,fr FRA,DFMF,22.0,21.1,604.0,785.0,76.9,12836.0,5788.0,164.0,207.0,79.2,318.0,376.0,84.6,109.0,177.0,61.6,0.0,0.2,0.6,-0.2,1.0,52.0,2.0,1.0,61.0,Matches,689,fr FRA,DFMF,22,26,1901.0,73.0,55.6,21.1,21,88.0,17,5,11.0,8,0.65,11.0,47.0,-36.0,-1.7,-0.82,17.8,32.8,-15.0,-0.71,-0.55,Matches,582.0,fr FRA,DFMF,22.0,21.1,970.0,130.0,498.0,450.0,33.0,16.0,970.0,1.0,1.0,100.0,0.0,0.0,624.0,3541.0,1945.0,3.0,3.0,0.0,5.0,5.0,556.0,3.0,Matches,582.0,fr FRA,DFMF,22.0,21.1,1.0,12.0,2.0,16.7,0.57,0.09,0.08,0.5,10.8,0.0,0.0,0.0,0.8,0.8,0.06,0.2,0.2,Matches,582.0,fr FRA,DFMF,22.0,26.0,21.0,1901.0,21.1,1.0,0.0,1.0,1.0,0.0,0.0,5.0,1.0,0.8,0.8,0.2,1.0,3.0,61.0,3.0,0.05,0.0,0.05,0.05,0.05,0.04,0.01,0.05,0.04,0.05,Matches,Clément Vidal,D C,22,110,135,France,AC Ajaccio,8,9,8,8,10,7,12,10,8,13,10,8,12,11,11,12,13,12,13,9,11,9,5,13,10,12,12,12,11,12,13,12,14,11,13,14,11,10,11,8,7,2,2,2,2,3,3,1,1,1,2,1,8,10,8,13,10,14,11,16,1,1,20,1,1,1,1,1,1,1,1,1,1,1,181,75,8,20,1747999,5496,5496,2496,Northern_European,110,5,2000/6/18,0,0,3135.0,,49038417
1066,Vitinha,Paris S-G,2000,586.0,pt POR,MF,22.0,27.2,58.0,25.0,21.0,27.0,10.0,27.0,83.0,32.5,56.0,27.0,4.0,23.0,25.0,83.0,15.0,0.0,Matches,586.0,pt POR,MF,22.0,27.2,73.0,2.69,63.0,2.0,0.0,4.0,2.0,2.0,10.0,0.37,8.0,0.0,0.0,1.0,1.0,0.0,Matches,,,,,,,,,,,,,,,,,,,,,,,,,,,,,,,,,,,,,,,,,,,,,,,,,,,,,,,,586.0,pt POR,MF,22.0,27.2,3.0,0.0,0.0,31.0,19.0,0.0,13.0,25.0,25.0,0.0,0.0,0.0,164.0,5.0,4.0,55.6,Matches,586.0,pt POR,MF,22.0,27.2,1945.0,1923.0,18.0,9.0,7.0,6.0,13.0,3.0,6.0,2.0,3.0,0.0,1786.0,4.0,26.0,Matches,586.0,pt POR,MF,22.0,27.2,1786.0,1945.0,91.8,26148.0,5772.0,960.0,1018.0,94.3,613.0,657.0,93.3,95.0,113.0,84.1,3.0,3.0,3.4,0.0,27.0,170.0,24.0,1.0,137.0,Matches,693,pt POR,MF,22,36,2446.0,68.0,71.5,27.2,29,77.0,8,7,31.0,1,2.25,58.0,28.0,30.0,1.1,-0.65,54.0,34.2,19.8,0.73,-0.21,Matches,586.0,pt POR,MF,22.0,27.2,2189.0,41.0,325.0,1299.0,584.0,38.0,2189.0,53.0,31.0,58.5,17.0,32.1,1872.0,9931.0,4552.0,50.0,74.0,5.0,33.0,33.0,1786.0,94.0,Matches,586.0,pt POR,MF,22.0,27.2,2.0,31.0,11.0,35.5,1.14,0.4,0.06,0.18,20.5,0.0,0.0,0.0,3.0,3.0,0.1,-1.0,-1.0,Matches,586.0,pt POR,MF,22.0,36.0,29.0,2446.0,27.2,2.0,3.0,5.0,2.0,0.0,0.0,3.0,0.0,3.0,3.0,3.0,6.1,50.0,137.0,94.0,0.07,0.11,0.18,0.07,0.18,0.11,0.11,0.22,0.11,0.22,Matches,Vitinha,DM/M C,22,150,173,Portugal,Paris Saint-Germain,12,11,15,9,15,10,6,13,9,12,16,10,12,16,12,15,15,15,13,16,15,14,13,12,14,13,16,15,13,16,14,6,14,13,14,9,15,5,13,5,10,2,2,1,3,1,1,1,1,1,2,1,15,14,5,16,16,16,14,14,1,1,1,1,1,1,19,1,20,1,1,13,1,1,172,66,10,20,82354132,7600,7300,5550,Mediterranean_Hispanic,150,5,2000/2/13,3,0,91246.0,,83174762
1067,Elye Wahi,Montpellier,2003,588.0,fr FRA,FW,19.0,27.9,9.0,3.0,2.0,3.0,4.0,5.0,14.0,35.7,9.0,14.0,2.0,12.0,3.0,12.0,5.0,0.0,Matches,588.0,fr FRA,FW,19.0,27.9,51.0,1.83,29.0,0.0,5.0,8.0,8.0,1.0,12.0,0.43,4.0,0.0,2.0,4.0,2.0,0.0,Matches,,,,,,,,,,,,,,,,,,,,,,,,,,,,,,,,,,,,,,,,,,,,,,,,,,,,,,,,588.0,fr FRA,FW,19.0,27.9,8.0,1.0,0.0,32.0,40.0,26.0,19.0,3.0,3.0,2.0,0.0,0.0,47.0,20.0,78.0,20.4,Matches,588.0,fr FRA,FW,19.0,27.9,440.0,385.0,53.0,0.0,1.0,2.0,19.0,3.0,0.0,0.0,0.0,0.0,299.0,2.0,24.0,Matches,588.0,fr FRA,FW,19.0,27.9,299.0,440.0,68.0,3580.0,635.0,166.0,233.0,71.2,71.0,103.0,68.9,8.0,14.0,57.1,5.0,3.6,2.0,1.4,22.0,17.0,6.0,0.0,25.0,Matches,697,fr FRA,FW,19,33,2513.0,76.0,73.5,27.9,29,81.0,9,4,43.0,0,1.3,46.0,43.0,3.0,0.11,0.11,36.3,41.9,-5.6,-0.2,0.24,Matches,588.0,fr FRA,FW,19.0,27.9,717.0,5.0,36.0,307.0,383.0,125.0,716.0,76.0,29.0,38.2,37.0,48.7,535.0,3721.0,1442.0,57.0,40.0,36.0,87.0,46.0,545.0,190.0,Matches,588.0,fr FRA,FW,19.0,27.9,19.0,62.0,36.0,58.1,2.22,1.29,0.29,0.5,14.5,1.0,1.0,1.0,12.2,11.4,0.18,6.8,6.6,Matches,588.0,fr FRA,FW,19.0,33.0,29.0,2513.0,27.9,19.0,5.0,24.0,18.0,1.0,1.0,8.0,1.0,12.2,11.4,3.6,15.0,57.0,25.0,190.0,0.68,0.18,0.86,0.64,0.82,0.44,0.13,0.56,0.41,0.54,Matches,Elye Wahi,S L,19,122,-85,France,Montpellier Hérault SC,8,9,13,14,13,11,13,12,6,6,11,12,6,14,11,12,11,12,12,8,12,13,13,8,13,8,13,13,15,13,12,8,12,15,13,13,13,9,12,8,12,1,1,2,2,2,1,1,2,3,3,2,12,14,13,14,15,13,9,10,1,1,1,1,1,1,1,1,1,1,15,1,12,20,184,74,8,20,52836555,6097,6097,3801,African_Caribbean,122,14,2003/1/2,0,0,9279.0,,49061868
1068,Timothy Weah,Lille,2000,589.0,us USA,DFFW,22.0,19.4,24.0,14.0,13.0,9.0,2.0,16.0,29.0,55.2,13.0,17.0,3.0,14.0,23.0,47.0,18.0,0.0,Matches,589.0,us USA,DFFW,22.0,19.4,44.0,2.26,34.0,0.0,3.0,5.0,2.0,0.0,3.0,0.15,2.0,0.0,0.0,1.0,0.0,0.0,Matches,,,,,,,,,,,,,,,,,,,,,,,,,,,,,,,,,,,,,,,,,,,,,,,,,,,,,,,,589.0,us USA,DFFW,22.0,19.4,2.0,0.0,0.0,17.0,18.0,4.0,51.0,23.0,14.0,0.0,0.0,0.0,84.0,13.0,20.0,39.4,Matches,589.0,us USA,DFFW,22.0,19.4,1003.0,902.0,98.0,12.0,0.0,5.0,51.0,85.0,1.0,0.0,0.0,0.0,824.0,3.0,29.0,Matches,589.0,us USA,DFFW,22.0,19.4,824.0,1003.0,82.2,13165.0,3454.0,412.0,466.0,88.4,328.0,378.0,86.8,53.0,93.0,57.0,2.0,1.6,2.2,0.4,16.0,53.0,25.0,10.0,79.0,Matches,698,us USA,DFFW,22,29,1748.0,60.0,51.1,19.4,18,82.0,9,11,25.0,1,1.86,30.0,18.0,12.0,0.62,0.13,33.8,17.1,16.6,0.86,0.23,Matches,589.0,us USA,DFFW,22.0,19.4,1183.0,24.0,225.0,571.0,404.0,38.0,1183.0,37.0,20.0,54.1,13.0,35.1,878.0,5599.0,2724.0,69.0,48.0,13.0,24.0,10.0,825.0,169.0,Matches,589.0,us USA,DFFW,22.0,19.4,0.0,30.0,11.0,36.7,1.54,0.57,0.0,0.0,21.6,0.0,0.0,0.0,2.5,2.5,0.08,-2.5,-2.5,Matches,589.0,us USA,DFFW,22.0,29.0,18.0,1748.0,19.4,0.0,2.0,2.0,0.0,0.0,0.0,2.0,0.0,2.5,2.5,1.6,4.1,69.0,79.0,169.0,0.0,0.1,0.1,0.0,0.1,0.13,0.08,0.21,0.13,0.21,Matches,Timothy Weah,AM/S RLC,22,127,150,"United States,France,Liberia",LOSC Lille,11,9,14,13,12,11,8,11,7,4,10,14,5,13,9,11,10,12,12,11,11,10,13,7,12,7,11,13,16,14,12,10,14,14,12,9,11,6,9,11,11,3,1,3,2,1,3,2,1,1,1,2,11,13,7,13,10,12,9,13,1,1,1,1,1,1,1,1,1,1,20,15,20,18,185,66,8,20,9219999,6344,6344,4244,African_Caribbean,116,16,2000/2/22,25,3,13808.0,,48042432
1069,Mateusz Wieteska,Clermont Foot,1997,590.0,pl POL,DF,25.0,34.6,41.0,23.0,28.0,13.0,0.0,19.0,33.0,57.6,14.0,44.0,28.0,16.0,56.0,97.0,97.0,4.0,Matches,590.0,pl POL,DF,25.0,34.6,20.0,0.58,15.0,0.0,1.0,3.0,1.0,0.0,3.0,0.09,0.0,0.0,0.0,2.0,1.0,0.0,Matches,,,,,,,,,,,,,,,,,,,,,,,,,,,,,,,,,,,,,,,,,,,,,,,,,,,,,,,,590.0,pl POL,DF,25.0,34.6,7.0,1.0,0.0,29.0,30.0,0.0,1.0,56.0,23.0,1.0,1.0,0.0,185.0,78.0,41.0,65.5,Matches,590.0,pl POL,DF,25.0,34.6,1631.0,1550.0,75.0,49.0,2.0,6.0,1.0,22.0,0.0,0.0,0.0,0.0,1344.0,6.0,12.0,Matches,590.0,pl POL,DF,25.0,34.6,1344.0,1631.0,82.4,25000.0,10745.0,518.0,587.0,88.2,670.0,756.0,88.6,128.0,239.0,53.6,1.0,0.3,0.6,0.7,3.0,80.0,5.0,0.0,99.0,Matches,699,pl POL,DF,25,35,3117.0,89.0,91.1,34.6,35,89.0,32,0,,0,1.49,40.0,47.0,-7.0,-0.2,-1.09,42.5,53.9,-11.4,-0.33,-0.53,Matches,590.0,pl POL,DF,25.0,34.6,1925.0,256.0,1017.0,868.0,57.0,31.0,1925.0,13.0,11.0,84.6,0.0,0.0,1358.0,8189.0,4515.0,15.0,10.0,0.0,11.0,6.0,1211.0,8.0,Matches,590.0,pl POL,DF,25.0,34.6,0.0,16.0,5.0,31.3,0.46,0.14,0.0,0.0,8.6,0.0,0.0,0.0,2.1,2.1,0.13,-2.1,-2.1,Matches,590.0,pl POL,DF,25.0,35.0,35.0,3117.0,34.6,0.0,1.0,1.0,0.0,0.0,0.0,7.0,1.0,2.1,2.1,0.3,2.4,15.0,99.0,8.0,0.0,0.03,0.03,0.0,0.03,0.06,0.01,0.07,0.06,0.07,Matches,Mateusz Wieteska,D C,25,122,126,Poland,Clermont Foot 63,7,10,9,8,12,8,15,8,12,14,12,12,14,10,14,12,13,12,10,11,13,13,11,14,11,13,12,12,11,9,13,14,13,11,13,14,11,8,12,5,10,1,1,2,4,2,1,4,1,3,2,3,12,13,3,12,11,14,12,13,1,7,20,14,1,1,13,1,1,1,1,1,1,1,187,77,9,20,2200238,6100,6100,3500,Northern_European,123,3,1997/2/11,1,0,7937.0,,96059426
1070,Christopher Wooh,Rennes,2001,591.0,cm CMR,DF,20.0,11.2,16.0,7.0,8.0,8.0,0.0,9.0,11.0,81.8,2.0,11.0,5.0,6.0,6.0,22.0,49.0,0.0,Matches,591.0,cm CMR,DF,20.0,11.2,4.0,0.36,2.0,0.0,0.0,1.0,1.0,0.0,2.0,0.18,1.0,0.0,0.0,0.0,1.0,0.0,Matches,,,,,,,,,,,,,,,,,,,,,,,,,,,,,,,,,,,,,,,,,,,,,,,,,,,,,,,,591.0,cm CMR,DF,20.0,11.2,4.0,0.0,0.0,17.0,10.0,0.0,1.0,6.0,7.0,1.0,0.0,0.0,34.0,21.0,12.0,63.6,Matches,591.0,cm CMR,DF,20.0,11.2,618.0,605.0,12.0,12.0,0.0,4.0,1.0,0.0,0.0,0.0,0.0,0.0,569.0,1.0,2.0,Matches,591.0,cm CMR,DF,20.0,11.2,569.0,618.0,92.1,12081.0,3249.0,119.0,130.0,91.5,382.0,398.0,96.0,65.0,85.0,76.5,0.0,0.2,0.1,-0.2,1.0,24.0,0.0,0.0,38.0,Matches,700,cm CMR,DF,20,13,1006.0,77.0,29.4,11.2,12,83.0,10,1,6.0,11,2.0,20.0,12.0,8.0,0.72,-0.1,16.1,13.9,2.2,0.2,-0.36,Matches,591.0,cm CMR,DF,20.0,11.2,722.0,70.0,290.0,419.0,15.0,8.0,722.0,2.0,2.0,100.0,0.0,0.0,572.0,3208.0,1774.0,6.0,2.0,0.0,7.0,1.0,541.0,0.0,Matches,591.0,cm CMR,DF,20.0,11.2,0.0,5.0,0.0,0.0,0.45,0.0,0.0,,8.9,0.0,0.0,0.0,0.7,0.7,0.13,-0.7,-0.7,Matches,591.0,cm CMR,DF,20.0,13.0,12.0,1006.0,11.2,0.0,0.0,0.0,0.0,0.0,0.0,4.0,0.0,0.7,0.7,0.2,0.9,6.0,38.0,0.0,0.0,0.0,0.0,0.0,0.0,0.06,0.02,0.08,0.06,0.08,Matches,Christopher Wooh,D C,20,110,135,"Cameroon,France",Stade Rennais FC,6,5,11,7,10,2,13,11,9,12,11,9,13,11,13,12,11,12,12,11,11,4,8,8,10,12,12,13,11,12,12,15,13,13,12,13,12,11,11,8,19,3,1,1,1,3,2,1,3,1,2,2,15,14,8,12,13,9,11,20,1,13,20,1,1,1,1,1,1,1,1,1,1,1,191,90,5,20,9924521,5500,5500,2500,African_Caribbean,108,16,2001/9/18,1,0,3722.0,,49048590
1071,Warren Zaïre-Emery,Paris S-G,2006,598.0,fr FRA,MFDF,16.0,10.3,17.0,10.0,5.0,10.0,2.0,8.0,29.0,27.6,21.0,11.0,0.0,11.0,12.0,29.0,17.0,0.0,Matches,598.0,fr FRA,MFDF,16.0,10.3,21.0,2.03,19.0,0.0,0.0,1.0,0.0,1.0,1.0,0.1,1.0,0.0,0.0,0.0,0.0,0.0,Matches,,,,,,,,,,,,,,,,,,,,,,,,,,,,,,,,,,,,,,,,,,,,,,,,,,,,,,,,598.0,fr FRA,MFDF,16.0,10.3,1.0,0.0,0.0,9.0,5.0,2.0,4.0,12.0,10.0,0.0,1.0,0.0,54.0,3.0,11.0,21.4,Matches,598.0,fr FRA,MFDF,16.0,10.3,624.0,589.0,34.0,6.0,0.0,0.0,4.0,28.0,0.0,0.0,0.0,0.0,571.0,1.0,11.0,Matches,598.0,fr FRA,MFDF,16.0,10.3,571.0,624.0,91.5,7791.0,1610.0,340.0,367.0,92.6,190.0,196.0,96.9,11.0,16.0,68.8,0.0,0.4,0.6,-0.4,6.0,37.0,5.0,0.0,32.0,Matches,707,fr FRA,MFDF,16,26,929.0,36.0,27.2,10.3,8,87.0,5,18,13.0,9,2.04,19.0,17.0,2.0,0.19,-1.5,20.4,16.4,4.0,0.39,-0.55,Matches,598.0,fr FRA,MFDF,16.0,10.3,726.0,26.0,123.0,426.0,192.0,21.0,726.0,29.0,16.0,55.2,11.0,37.9,584.0,3412.0,1522.0,23.0,22.0,4.0,11.0,14.0,545.0,54.0,Matches,598.0,fr FRA,MFDF,16.0,10.3,2.0,9.0,4.0,44.4,0.87,0.39,0.22,0.5,17.1,0.0,0.0,0.0,1.4,1.4,0.16,0.6,0.6,Matches,598.0,fr FRA,MFDF,16.0,26.0,8.0,929.0,10.3,2.0,0.0,2.0,2.0,0.0,0.0,1.0,0.0,1.4,1.4,0.4,1.9,23.0,32.0,54.0,0.19,0.0,0.19,0.19,0.19,0.14,0.04,0.18,0.14,0.18,Matches,Warren Zaïre-Emery,DM/M C,16,100,-95,France,Paris Saint-Germain,11,10,12,8,12,8,8,8,4,12,12,10,11,13,6,12,12,10,11,13,10,15,12,7,10,11,11,11,12,12,11,8,12,12,11,11,10,6,10,4,9,2,2,3,2,1,2,2,2,1,2,3,12,13,3,14,13,14,13,12,1,1,1,1,1,1,20,1,18,1,1,1,1,1,178,0,10,20,42290922,4989,4989,1639,African_Caribbean,99,12,2006/3/8,0,0,1388.0,,2000179712
1072,Akim Zedadka,Auxerre,1995,600.0,dz ALG,DF,27.0,17.8,35.0,21.0,21.0,10.0,4.0,18.0,32.0,56.3,14.0,17.0,3.0,14.0,23.0,58.0,51.0,1.0,Matches,600.0,dz ALG,DF,27.0,17.8,30.0,1.69,24.0,3.0,2.0,0.0,0.0,1.0,2.0,0.11,1.0,1.0,0.0,0.0,0.0,0.0,Matches,,,,,,,,,,,,,,,,,,,,,,,,,,,,,,,,,,,,,,,,,,,,,,,,,,,,,,,,600.0,dz ALG,DF,27.0,17.8,5.0,0.0,0.0,23.0,27.0,0.0,38.0,23.0,21.0,0.0,2.0,0.0,95.0,24.0,23.0,51.1,Matches,600.0,dz ALG,DF,27.0,17.8,707.0,555.0,150.0,14.0,1.0,1.0,38.0,136.0,0.0,0.0,0.0,0.0,543.0,2.0,22.0,Matches,600.0,dz ALG,DF,27.0,17.8,543.0,707.0,76.8,8466.0,2865.0,273.0,326.0,83.7,222.0,283.0,78.4,28.0,58.0,48.3,0.0,1.3,1.3,-1.3,14.0,35.0,15.0,9.0,51.0,Matches,709,dz ALG,DF,27,20,1599.0,80.0,46.8,17.8,19,84.0,15,1,6.0,1,0.95,18.0,24.0,-6.0,-0.34,0.75,18.4,26.4,-8.0,-0.45,-0.06,Matches,600.0,dz ALG,DF,27.0,17.8,921.0,70.0,298.0,398.0,232.0,21.0,921.0,35.0,9.0,25.7,22.0,62.9,547.0,3288.0,1350.0,25.0,16.0,4.0,27.0,17.0,472.0,71.0,Matches,600.0,dz ALG,DF,27.0,17.8,0.0,9.0,0.0,0.0,0.51,0.0,0.0,,19.6,0.0,0.0,0.0,0.4,0.4,0.04,-0.4,-0.4,Matches,600.0,dz ALG,DF,27.0,20.0,19.0,1599.0,17.8,0.0,0.0,0.0,0.0,0.0,0.0,5.0,0.0,0.4,0.4,1.3,1.6,25.0,51.0,71.0,0.0,0.0,0.0,0.0,0.0,0.02,0.07,0.09,0.02,0.09,Matches,Akim Zedadka,D/WB/M RL,27,125,129,"France,Algeria",LOSC Lille,11,14,13,8,13,10,10,11,10,13,12,11,9,13,8,11,11,12,11,12,12,8,12,6,12,12,11,13,13,13,12,8,13,14,14,13,13,10,11,8,13,3,1,1,2,1,3,1,1,4,2,3,11,12,10,11,9,11,12,12,1,17,1,20,1,18,1,1,1,17,1,1,14,1,173,72,8,20,2856825,6242,6242,3742,North_African__Middle_Eastern,116,7,1995/5/30,0,0,11832.0,,49030855
1073,Arber Zeneli,Reims,1995,603.0,xk KVX,FWMF,27.0,11.1,9.0,3.0,3.0,3.0,3.0,5.0,12.0,41.7,7.0,8.0,0.0,8.0,2.0,11.0,2.0,0.0,Matches,603.0,xk KVX,FWMF,27.0,11.1,47.0,4.23,28.0,8.0,6.0,3.0,2.0,0.0,7.0,0.63,5.0,0.0,0.0,1.0,1.0,0.0,Matches,,,,,,,,,,,,,,,,,,,,,,,,,,,,,,,,,,,,,,,,,,,,,,,,,,,,,,,,603.0,xk KVX,FWMF,27.0,11.1,0.0,0.0,0.0,7.0,12.0,3.0,50.0,2.0,3.0,1.0,0.0,0.0,58.0,4.0,8.0,33.3,Matches,603.0,xk KVX,FWMF,27.0,11.1,430.0,358.0,70.0,14.0,4.0,0.0,50.0,15.0,36.0,18.0,11.0,0.0,302.0,2.0,15.0,Matches,603.0,xk KVX,FWMF,27.0,11.1,302.0,430.0,70.2,4497.0,1514.0,180.0,219.0,82.2,90.0,130.0,69.2,19.0,49.0,38.8,2.0,3.1,2.3,-1.1,22.0,24.0,19.0,1.0,51.0,Matches,712,xk KVX,FWMF,27,23,1000.0,43.0,29.2,11.1,12,64.0,0,11,21.0,14,1.48,12.0,7.0,5.0,0.45,0.64,17.2,15.2,2.0,0.18,-0.08,Matches,603.0,xk KVX,FWMF,27.0,11.1,602.0,7.0,55.0,220.0,339.0,56.0,602.0,60.0,17.0,28.3,38.0,63.3,430.0,3137.0,1348.0,45.0,28.0,29.0,47.0,23.0,398.0,118.0,Matches,603.0,xk KVX,FWMF,27.0,11.1,0.0,31.0,6.0,19.4,2.79,0.54,0.0,0.0,20.8,5.0,0.0,0.0,2.1,2.1,0.07,-2.1,-2.1,Matches,603.0,xk KVX,FWMF,27.0,23.0,12.0,1000.0,11.1,0.0,2.0,2.0,0.0,0.0,0.0,0.0,0.0,2.1,2.1,3.1,5.2,45.0,51.0,118.0,0.0,0.18,0.18,0.0,0.18,0.19,0.28,0.47,0.19,0.47,Matches,Arber Zeneli,AM RLC,27,127,133,"Kosovo,Sweden,Albania",Stade de Reims,11,13,15,11,13,8,7,7,5,5,14,8,5,14,10,10,10,12,12,12,11,11,14,5,14,9,12,11,16,16,11,9,12,15,12,9,12,7,8,11,7,1,2,1,1,2,2,1,2,2,3,2,10,14,5,10,11,12,12,12,1,1,1,1,1,1,1,14,1,14,20,15,18,1,176,71,8,20,3896719,6345,6345,4995,Mediterranean_Hispanic,123,5,1995/2/25,29,9,13347.0,,93031731
1074,Edon Zhegrova,Lille,1999,605.0,xk KVX,FWMF,23.0,11.7,18.0,12.0,6.0,7.0,5.0,12.0,20.0,60.0,8.0,9.0,0.0,9.0,2.0,20.0,2.0,0.0,Matches,605.0,xk KVX,FWMF,23.0,11.7,78.0,6.64,42.0,15.0,8.0,7.0,4.0,2.0,11.0,0.94,6.0,2.0,0.0,2.0,1.0,0.0,Matches,,,,,,,,,,,,,,,,,,,,,,,,,,,,,,,,,,,,,,,,,,,,,,,,,,,,,,,,605.0,xk KVX,FWMF,23.0,11.7,1.0,0.0,0.0,11.0,15.0,2.0,73.0,2.0,12.0,1.0,0.0,0.0,58.0,0.0,6.0,0.0,Matches,605.0,xk KVX,FWMF,23.0,11.7,604.0,534.0,68.0,11.0,2.0,3.0,73.0,20.0,37.0,11.0,11.0,0.0,464.0,2.0,24.0,Matches,605.0,xk KVX,FWMF,23.0,11.7,464.0,604.0,76.8,6909.0,2273.0,268.0,315.0,85.1,147.0,188.0,78.2,33.0,61.0,54.1,4.0,4.6,5.3,-0.6,30.0,23.0,33.0,8.0,52.0,Matches,714,xk KVX,FWMF,23,22,1056.0,48.0,30.9,11.7,11,72.0,3,11,24.0,8,2.0,27.0,10.0,17.0,1.45,1.3,23.5,11.9,11.6,0.98,0.35,Matches,605.0,xk KVX,FWMF,23.0,11.7,789.0,2.0,42.0,224.0,534.0,79.0,789.0,111.0,53.0,47.7,54.0,48.6,629.0,4673.0,2347.0,74.0,53.0,35.0,33.0,17.0,586.0,194.0,Matches,605.0,xk KVX,FWMF,23.0,11.7,3.0,42.0,14.0,33.3,3.58,1.19,0.07,0.21,18.4,1.0,0.0,0.0,3.6,3.6,0.09,-0.6,-0.6,Matches,605.0,xk KVX,FWMF,23.0,22.0,11.0,1056.0,11.7,3.0,4.0,7.0,3.0,0.0,0.0,1.0,0.0,3.6,3.6,4.6,8.2,74.0,52.0,194.0,0.26,0.34,0.6,0.26,0.6,0.31,0.39,0.7,0.31,0.7,Matches,Edon Zhegrova,M/AM RLC,23,130,146,"Kosovo,Germany",LOSC Lille,12,12,17,10,16,10,4,12,4,4,12,12,6,17,7,11,13,13,9,10,9,11,18,4,12,5,8,9,15,16,14,7,12,16,12,7,10,8,12,11,8,2,1,1,1,3,1,3,2,2,3,1,8,18,14,8,17,11,5,7,1,1,1,1,1,1,1,15,1,18,17,15,20,12,181,72,20,7,11123229,6500,6500,4005,Northern_European,122,3,1999/3/31,28,3,16420.0,,18104985
1075,Tammy Abraham,Roma,1997,3.0,eng ENG,FW,24.0,24.3,17.0,10.0,4.0,8.0,5.0,3.0,16.0,18.8,13.0,10.0,4.0,6.0,3.0,20.0,14.0,0.0,Matches,3.0,eng ENG,FW,24.0,24.3,70.0,2.88,46.0,0.0,7.0,10.0,7.0,0.0,9.0,0.37,4.0,0.0,1.0,3.0,1.0,0.0,Matches,,,,,,,,,,,,,,,,,,,,,,,,,,,,,,,,,,,,,,,,,,,,,,,,,,,,,,,,3.0,eng ENG,FW,24.0,24.3,2.0,0.0,0.0,33.0,48.0,11.0,11.0,3.0,10.0,1.0,0.0,0.0,46.0,80.0,74.0,51.9,Matches,3.0,eng ENG,FW,24.0,24.3,513.0,475.0,35.0,2.0,4.0,3.0,11.0,1.0,0.0,0.0,0.0,0.0,342.0,3.0,8.0,Matches,3.0,eng ENG,FW,24.0,24.3,342.0,513.0,66.7,4964.0,1248.0,198.0,260.0,76.2,102.0,163.0,62.6,24.0,36.0,66.7,3.0,3.6,2.8,-0.6,33.0,18.0,17.0,2.0,54.0,Matches,3,eng ENG,FW,24,38,2189.0,58.0,64.0,24.3,24,77.0,7,14,24.0,0,1.66,32.0,25.0,7.0,0.29,-0.08,37.7,22.9,14.8,0.61,-0.16,Matches,3.0,eng ENG,FW,24.0,24.3,786.0,19.0,50.0,391.0,355.0,125.0,786.0,68.0,22.0,32.4,37.0,54.4,421.0,2154.0,856.0,35.0,20.0,16.0,62.0,31.0,621.0,141.0,Matches,3.0,eng ENG,FW,24.0,24.3,8.0,62.0,28.0,45.2,2.55,1.15,0.13,0.29,12.0,0.0,0.0,0.0,10.8,10.8,0.17,-2.8,-2.8,Matches,3.0,eng ENG,FW,24.0,38.0,24.0,2189.0,24.3,8.0,3.0,11.0,8.0,0.0,0.0,2.0,0.0,10.8,10.8,3.6,14.5,35.0,54.0,141.0,0.33,0.12,0.45,0.33,0.45,0.45,0.15,0.6,0.45,0.6,Matches,Tammy Abraham,S,24,153,163,"England,Nigeria",Associazione Sportiva Roma,4,9,14,15,14,10,15,12,4,6,13,14,8,14,14,15,15,12,13,12,12,16,16,12,15,8,16,16,15,15,17,16,14,16,13,14,14,8,16,6,6,1,3,2,2,3,3,2,3,3,3,1,16,15,14,11,15,13,15,10,1,1,1,1,1,1,1,1,1,1,1,1,1,20,196,87,12,20,104568749,7650,7250,6500,African_Caribbean,153,16,1997/10/2,11,3,110961.0,,28097985
1076,Francesco Acerbi,Inter,1988,5.0,it ITA,DF,34.0,26.9,33.0,19.0,22.0,7.0,4.0,20.0,27.0,74.1,7.0,25.0,18.0,7.0,41.0,74.0,85.0,2.0,Matches,5.0,it ITA,DF,34.0,26.9,37.0,1.37,34.0,1.0,0.0,2.0,0.0,0.0,1.0,0.04,1.0,0.0,0.0,0.0,0.0,0.0,Matches,,,,,,,,,,,,,,,,,,,,,,,,,,,,,,,,,,,,,,,,,,,,,,,,,,,,,,,,5.0,it ITA,DF,34.0,26.9,4.0,0.0,0.0,17.0,13.0,2.0,22.0,41.0,19.0,0.0,0.0,0.0,151.0,78.0,42.0,65.0,Matches,5.0,it ITA,DF,34.0,26.9,1644.0,1546.0,93.0,41.0,1.0,10.0,22.0,21.0,0.0,0.0,0.0,0.0,1455.0,5.0,4.0,Matches,5.0,it ITA,DF,34.0,26.9,1455.0,1644.0,88.5,27034.0,8090.0,545.0,594.0,91.8,737.0,802.0,91.9,149.0,202.0,73.8,2.0,1.1,1.2,0.9,16.0,86.0,14.0,3.0,100.0,Matches,5,it ITA,DF,34,31,2425.0,78.0,70.9,26.9,25,90.0,24,6,31.0,3,1.94,53.0,30.0,23.0,0.85,0.31,49.5,26.6,22.9,0.85,0.07,Matches,5.0,it ITA,DF,34.0,26.9,1890.0,226.0,858.0,880.0,167.0,27.0,1890.0,12.0,7.0,58.3,4.0,33.3,1041.0,5108.0,2867.0,39.0,33.0,2.0,13.0,7.0,1252.0,32.0,Matches,5.0,it ITA,DF,34.0,26.9,0.0,18.0,2.0,11.1,0.67,0.07,0.0,0.0,15.9,0.0,0.0,0.0,1.0,1.0,0.06,-1.0,-1.0,Matches,5.0,it ITA,DF,34.0,31.0,25.0,2425.0,26.9,0.0,2.0,2.0,0.0,0.0,0.0,4.0,0.0,1.0,1.0,1.1,2.1,39.0,100.0,32.0,0.0,0.07,0.07,0.0,0.07,0.04,0.04,0.08,0.04,0.08,Matches,Francesco Acerbi,D C,34,147,155,Italy,S.S. Lazio,3,9,7,9,12,8,17,3,3,15,13,9,17,12,15,17,15,14,14,12,13,19,11,14,9,15,15,15,10,10,15,16,20,11,16,17,14,6,15,2,7,4,3,3,3,3,3,2,4,2,2,3,10,19,13,12,15,18,14,12,1,8,20,1,1,1,1,1,1,1,1,1,1,1,192,88,20,9,2361385,7350,7550,6500,Mediterranean_Hispanic,147,4,1988/2/10,25,1,64038.0,FC Internazionale Milano,43017499
1077,Michel Aebischer,Bologna,1997,7.0,ch SUI,FWMF,25.0,17.1,12.0,6.0,3.0,6.0,3.0,2.0,18.0,11.1,16.0,14.0,2.0,12.0,7.0,19.0,9.0,0.0,Matches,7.0,ch SUI,FWMF,25.0,17.1,35.0,2.04,25.0,3.0,2.0,2.0,2.0,1.0,3.0,0.18,1.0,0.0,0.0,1.0,1.0,0.0,Matches,,,,,,,,,,,,,,,,,,,,,,,,,,,,,,,,,,,,,,,,,,,,,,,,,,,,,,,,7.0,ch SUI,FWMF,25.0,17.1,4.0,0.0,0.0,22.0,22.0,7.0,21.0,7.0,6.0,1.0,1.0,0.0,68.0,10.0,25.0,28.6,Matches,7.0,ch SUI,FWMF,25.0,17.1,674.0,641.0,30.0,10.0,0.0,3.0,21.0,13.0,4.0,1.0,3.0,0.0,557.0,3.0,16.0,Matches,7.0,ch SUI,FWMF,25.0,17.1,557.0,674.0,82.6,8050.0,2143.0,312.0,343.0,91.0,189.0,223.0,84.8,27.0,51.0,52.9,0.0,0.6,0.5,-0.6,15.0,37.0,7.0,1.0,46.0,Matches,8,ch SUI,FWMF,25,32,1542.0,48.0,45.1,17.1,18,72.0,5,14,17.0,6,1.5,23.0,26.0,-3.0,-0.18,-0.51,16.9,21.6,-4.8,-0.28,-0.28,Matches,7.0,ch SUI,FWMF,25.0,17.1,791.0,14.0,147.0,400.0,246.0,28.0,791.0,13.0,6.0,46.2,7.0,53.8,505.0,1992.0,841.0,14.0,12.0,4.0,30.0,17.0,618.0,85.0,Matches,7.0,ch SUI,FWMF,25.0,17.1,1.0,15.0,2.0,13.3,0.88,0.12,0.07,0.5,17.1,1.0,0.0,0.0,1.5,1.5,0.1,-0.5,-0.5,Matches,7.0,ch SUI,FWMF,25.0,32.0,18.0,1542.0,17.1,1.0,0.0,1.0,1.0,0.0,0.0,4.0,0.0,1.5,1.5,0.6,2.1,14.0,46.0,85.0,0.06,0.0,0.06,0.06,0.06,0.08,0.04,0.12,0.08,0.12,Matches,Michel Aebischer,M/AM C,25,129,137,Switzerland,Bologna FC 1909,13,11,12,8,14,13,9,12,8,8,15,10,11,14,10,13,10,15,13,12,15,11,11,12,12,9,15,14,12,10,13,9,12,11,15,13,13,10,14,9,12,2,3,1,4,2,2,2,4,2,2,3,12,11,5,13,9,14,12,14,1,1,1,1,1,1,12,10,20,10,1,16,1,1,183,74,12,20,3916222,6448,6798,4198,Northern_European,128,4,1997/1/6,10,0,12308.0,,98040986
1078,Kevin Agudelo,Spezia,1998,9.0,co COL,MFFW,23.0,23.7,71.0,38.0,22.0,30.0,19.0,25.0,59.0,42.4,34.0,39.0,5.0,34.0,10.0,81.0,6.0,0.0,Matches,9.0,co COL,MFFW,23.0,23.7,59.0,2.49,41.0,1.0,9.0,4.0,4.0,0.0,3.0,0.13,2.0,0.0,0.0,0.0,1.0,0.0,Matches,,,,,,,,,,,,,,,,,,,,,,,,,,,,,,,,,,,,,,,,,,,,,,,,,,,,,,,,9.0,co COL,MFFW,23.0,23.7,5.0,0.0,0.0,34.0,35.0,2.0,34.0,10.0,38.0,0.0,0.0,0.0,140.0,17.0,27.0,38.6,Matches,9.0,co COL,MFFW,23.0,23.7,735.0,711.0,17.0,2.0,5.0,1.0,34.0,7.0,5.0,3.0,2.0,0.0,531.0,7.0,39.0,Matches,9.0,co COL,MFFW,23.0,23.7,531.0,735.0,72.2,7885.0,2631.0,295.0,349.0,84.5,173.0,226.0,76.5,30.0,54.0,55.6,1.0,3.0,2.6,-2.0,28.0,58.0,31.0,2.0,110.0,Matches,12,co COL,MFFW,23,34,2131.0,63.0,62.3,23.7,23,78.0,6,11,31.0,2,0.74,20.0,39.0,-19.0,-0.8,0.04,24.4,38.7,-14.3,-0.6,-0.35,Matches,9.0,co COL,MFFW,23.0,23.7,1084.0,11.0,168.0,500.0,457.0,54.0,1084.0,109.0,50.0,45.9,50.0,45.9,662.0,4963.0,2740.0,81.0,71.0,19.0,59.0,55.0,699.0,100.0,Matches,9.0,co COL,MFFW,23.0,23.7,0.0,28.0,7.0,25.0,1.18,0.3,0.0,0.0,21.4,0.0,0.0,0.0,1.5,1.5,0.05,-1.5,-1.5,Matches,9.0,co COL,MFFW,23.0,34.0,23.0,2131.0,23.7,0.0,1.0,1.0,0.0,0.0,0.0,5.0,0.0,1.5,1.5,3.0,4.5,81.0,110.0,100.0,0.0,0.04,0.04,0.0,0.04,0.06,0.13,0.19,0.06,0.19,Matches,Kevin Agudelo,M/AM RC,23,126,143,Colombia,Spezia Calcio,6,13,14,11,14,12,7,13,3,6,14,10,9,15,12,14,13,13,12,13,11,12,14,9,13,9,13,13,13,15,14,9,15,13,12,12,11,12,10,7,12,2,3,3,2,4,3,3,3,3,3,3,14,12,7,10,12,12,11,16,1,1,1,1,1,1,10,11,18,13,12,20,17,14,178,72,20,9,3392392,6300,6100,4500,Mediterranean_Hispanic,125,10,1998/11/14,0,0,14230.0,,76062627
1079,Luis Alberto,Lazio,1992,13.0,es ESP,MF,29.0,27.1,49.0,29.0,18.0,20.0,11.0,23.0,72.0,31.9,49.0,35.0,6.0,29.0,9.0,58.0,4.0,0.0,Matches,13.0,es ESP,MF,29.0,27.1,115.0,4.24,80.0,30.0,0.0,4.0,0.0,1.0,15.0,0.55,13.0,2.0,0.0,0.0,0.0,0.0,Matches,,,,,,,,,,,,,,,,,,,,,,,,,,,,,,,,,,,,,,,,,,,,,,,,,,,,,,,,13.0,es ESP,MF,29.0,27.1,4.0,0.0,0.0,15.0,13.0,2.0,147.0,9.0,29.0,0.0,0.0,0.0,162.0,8.0,13.0,38.1,Matches,13.0,es ESP,MF,29.0,27.1,1988.0,1732.0,246.0,81.0,14.0,7.0,147.0,7.0,117.0,55.0,49.0,0.0,1640.0,10.0,30.0,Matches,13.0,es ESP,MF,29.0,27.1,1640.0,1988.0,82.5,25338.0,8690.0,905.0,986.0,91.8,560.0,646.0,86.7,116.0,238.0,48.7,7.0,7.0,6.3,0.0,66.0,210.0,56.0,1.0,248.0,Matches,17,es ESP,MF,29,35,2442.0,70.0,71.4,27.1,27,82.0,16,8,27.0,2,1.94,49.0,19.0,30.0,1.11,1.11,39.6,27.7,11.9,0.44,0.63,Matches,13.0,es ESP,MF,29.0,27.1,2217.0,29.0,269.0,1285.0,681.0,43.0,2215.0,41.0,19.0,46.3,20.0,48.8,1244.0,5632.0,3214.0,73.0,76.0,10.0,33.0,31.0,1632.0,94.0,Matches,13.0,es ESP,MF,29.0,27.1,6.0,45.0,17.0,37.8,1.66,0.63,0.11,0.29,23.2,4.0,1.0,2.0,4.4,2.7,0.06,1.6,2.3,Matches,13.0,es ESP,MF,29.0,35.0,27.0,2442.0,27.1,6.0,7.0,13.0,5.0,1.0,2.0,4.0,0.0,4.4,2.7,7.0,9.7,73.0,248.0,94.0,0.22,0.26,0.48,0.18,0.44,0.16,0.26,0.42,0.1,0.36,Matches,Luis Alberto,M/AM C,29,153,160,Spain,S.S. Lazio,17,12,15,15,17,15,6,15,4,8,17,14,9,16,12,15,13,13,14,17,16,17,20,12,15,10,16,14,12,13,13,10,14,12,13,12,14,9,15,7,14,1,1,4,2,3,3,3,3,2,1,3,14,17,14,12,13,12,13,11,1,1,1,1,1,1,11,10,20,9,11,18,11,11,183,74,11,20,35660624,7650,7550,7250,Mediterranean_Hispanic,152,5,1992/9/28,1,0,89038.0,,67131771
1080,Kelvin Amian,Spezia,1998,15.0,fr FRA,DF,24.0,26.4,54.0,32.0,33.0,12.0,9.0,24.0,31.0,77.4,7.0,34.0,12.0,22.0,22.0,76.0,87.0,1.0,Matches,15.0,fr FRA,DF,24.0,26.4,45.0,1.71,34.0,3.0,2.0,4.0,0.0,2.0,3.0,0.11,1.0,0.0,0.0,2.0,0.0,0.0,Matches,,,,,,,,,,,,,,,,,,,,,,,,,,,,,,,,,,,,,,,,,,,,,,,,,,,,,,,,15.0,fr FRA,DF,24.0,26.4,7.0,1.0,1.0,37.0,5.0,1.0,39.0,22.0,32.0,0.0,2.0,0.0,107.0,34.0,35.0,49.3,Matches,15.0,fr FRA,DF,24.0,26.4,1110.0,869.0,238.0,14.0,1.0,2.0,39.0,222.0,2.0,0.0,1.0,0.0,830.0,3.0,31.0,Matches,15.0,fr FRA,DF,24.0,26.4,830.0,1110.0,74.8,13341.0,5833.0,414.0,481.0,86.1,324.0,419.0,77.3,59.0,131.0,45.0,1.0,2.3,2.2,-1.3,18.0,80.0,19.0,10.0,102.0,Matches,22,fr FRA,DF,24,30,2372.0,79.0,69.4,26.4,26,87.0,22,4,31.0,0,0.73,21.0,42.0,-21.0,-0.8,0.06,32.0,41.6,-9.6,-0.37,0.35,Matches,15.0,fr FRA,DF,24.0,26.4,1395.0,110.0,506.0,512.0,383.0,47.0,1395.0,30.0,16.0,53.3,11.0,36.7,623.0,3822.0,2090.0,53.0,31.0,3.0,25.0,18.0,720.0,72.0,Matches,15.0,fr FRA,DF,24.0,26.4,0.0,26.0,7.0,26.9,0.99,0.27,0.0,0.0,16.7,1.0,0.0,0.0,2.7,2.7,0.1,-2.7,-2.7,Matches,15.0,fr FRA,DF,24.0,30.0,26.0,2372.0,26.4,0.0,1.0,1.0,0.0,0.0,0.0,7.0,1.0,2.7,2.7,2.3,5.0,53.0,102.0,72.0,0.0,0.04,0.04,0.0,0.04,0.1,0.09,0.19,0.1,0.19,Matches,Kelvin Amian,D RC,24,126,140,France,Spezia Calcio,10,11,10,7,13,3,14,10,13,14,12,5,13,12,14,14,13,13,13,12,13,12,10,11,13,12,13,13,13,13,14,10,16,13,14,13,13,12,12,7,11,1,1,3,1,2,1,2,2,2,1,3,13,14,6,12,12,13,13,15,1,14,20,19,1,1,1,1,1,1,1,1,1,1,180,78,8,20,2621506,6300,6100,3900,African_Caribbean,126,15,1998/2/8,0,0,13653.0,,48031443
1081,Bruno Amione,Sampdoria,2002,17.0,ar ARG,DF,20.0,23.2,50.0,33.0,36.0,14.0,0.0,19.0,43.0,44.2,24.0,26.0,11.0,15.0,25.0,75.0,62.0,1.0,Matches,17.0,ar ARG,DF,20.0,23.2,12.0,0.52,6.0,1.0,0.0,4.0,1.0,0.0,2.0,0.09,1.0,0.0,0.0,1.0,0.0,0.0,Matches,,,,,,,,,,,,,,,,,,,,,,,,,,,,,,,,,,,,,,,,,,,,,,,,,,,,,,,,17.0,ar ARG,DF,20.0,23.2,10.0,1.0,1.0,24.0,16.0,0.0,5.0,25.0,33.0,0.0,1.0,0.0,121.0,68.0,43.0,61.3,Matches,17.0,ar ARG,DF,20.0,23.2,1032.0,948.0,81.0,33.0,0.0,0.0,5.0,48.0,0.0,0.0,0.0,0.0,821.0,3.0,23.0,Matches,17.0,ar ARG,DF,20.0,23.2,821.0,1032.0,79.6,14337.0,5874.0,337.0,386.0,87.3,413.0,479.0,86.2,59.0,117.0,50.4,1.0,0.6,0.8,0.4,3.0,38.0,3.0,1.0,54.0,Matches,24,ar ARG,DF,20,26,2086.0,80.0,61.0,23.2,25,83.0,17,1,22.0,6,0.62,17.0,41.0,-24.0,-1.04,0.52,21.7,39.8,-18.0,-0.78,0.18,Matches,17.0,ar ARG,DF,20.0,23.2,1263.0,139.0,715.0,479.0,83.0,24.0,1263.0,10.0,2.0,20.0,6.0,60.0,663.0,2805.0,1165.0,11.0,16.0,0.0,20.0,1.0,691.0,9.0,Matches,17.0,ar ARG,DF,20.0,23.2,1.0,12.0,2.0,16.7,0.52,0.09,0.08,0.5,11.5,0.0,0.0,0.0,0.9,0.9,0.07,0.1,0.1,Matches,17.0,ar ARG,DF,20.0,26.0,25.0,2086.0,23.2,1.0,1.0,2.0,1.0,0.0,0.0,10.0,1.0,0.9,0.9,0.6,1.5,11.0,54.0,9.0,0.04,0.04,0.09,0.04,0.09,0.04,0.03,0.06,0.04,0.06,Matches,Bruno Amione,D C,20,114,-75,Argentina,Hellas Verona,5,7,8,6,11,6,13,5,6,14,11,6,14,12,15,12,14,11,13,11,11,14,8,8,7,13,12,16,12,11,14,13,15,12,11,14,13,13,13,6,10,3,4,2,1,1,4,2,1,3,1,3,14,15,4,12,13,17,13,12,1,10,20,1,1,1,1,1,1,1,1,1,1,1,185,81,20,8,6825600,5700,5650,3400,Native_American,114,11,2002/1/3,0,0,3557.0,U.C. Sampdoria,14216968
1082,Ethan Ampadu,Spezia,2000,18.0,wls WAL,DFMF,21.0,29.3,66.0,37.0,33.0,28.0,5.0,17.0,41.0,41.5,24.0,48.0,23.0,25.0,36.0,102.0,98.0,0.0,Matches,18.0,wls WAL,DFMF,21.0,29.3,40.0,1.36,33.0,0.0,0.0,4.0,2.0,1.0,4.0,0.14,4.0,0.0,0.0,0.0,0.0,0.0,Matches,,,,,,,,,,,,,,,,,,,,,,,,,,,,,,,,,,,,,,,,,,,,,,,,,,,,,,,,18.0,wls WAL,DFMF,21.0,29.3,10.0,1.0,1.0,44.0,20.0,1.0,11.0,36.0,37.0,0.0,2.0,0.0,203.0,61.0,40.0,60.4,Matches,18.0,wls WAL,DFMF,21.0,29.3,1548.0,1426.0,116.0,46.0,3.0,17.0,11.0,47.0,0.0,0.0,0.0,0.0,1254.0,6.0,20.0,Matches,18.0,wls WAL,DFMF,21.0,29.3,1254.0,1548.0,81.0,23855.0,9527.0,474.0,538.0,88.1,631.0,707.0,89.3,134.0,253.0,53.0,1.0,1.1,0.9,-0.1,13.0,106.0,14.0,4.0,125.0,Matches,25,wls WAL,DFMF,21,31,2639.0,85.0,77.2,29.3,31,85.0,22,0,,0,0.75,22.0,42.0,-20.0,-0.68,0.59,32.6,43.9,-11.3,-0.38,0.39,Matches,18.0,wls WAL,DFMF,21.0,29.3,1889.0,229.0,930.0,841.0,140.0,19.0,1889.0,12.0,9.0,75.0,1.0,8.3,1007.0,5907.0,3014.0,28.0,21.0,0.0,18.0,7.0,1090.0,10.0,Matches,18.0,wls WAL,DFMF,21.0,29.3,0.0,16.0,5.0,31.3,0.55,0.17,0.0,0.0,18.1,0.0,0.0,0.0,1.1,1.1,0.07,-1.1,-1.1,Matches,18.0,wls WAL,DFMF,21.0,31.0,31.0,2639.0,29.3,0.0,1.0,1.0,0.0,0.0,0.0,10.0,1.0,1.1,1.1,1.1,2.2,28.0,125.0,10.0,0.0,0.03,0.03,0.0,0.03,0.04,0.04,0.07,0.04,0.07,Matches,Ethan Ampadu,D/DM/M C,21,125,149,"Wales,England,Republic of Ireland",Chelsea,6,7,9,6,12,6,11,5,11,14,13,7,15,11,12,14,16,15,12,10,12,12,7,11,7,13,12,11,12,11,15,13,13,14,11,12,12,8,13,9,15,3,1,1,1,3,3,3,3,3,2,2,10,14,7,8,15,14,13,15,1,10,20,10,1,1,16,1,16,1,1,1,1,1,182,78,13,20,29229917,6250,6750,5500,Mixed_Race,124,11,2000/9/14,36,0,40597.0,Spezia Calcio,29175064
1083,Sofyan Amrabat,Fiorentina,1996,19.0,ma MAR,MF,25.0,22.2,39.0,24.0,15.0,17.0,7.0,16.0,29.0,55.2,13.0,23.0,5.0,18.0,21.0,60.0,18.0,2.0,Matches,19.0,ma MAR,MF,25.0,22.2,44.0,1.98,38.0,0.0,0.0,0.0,2.0,4.0,4.0,0.18,3.0,0.0,0.0,0.0,0.0,1.0,Matches,,,,,,,,,,,,,,,,,,,,,,,,,,,,,,,,,,,,,,,,,,,,,,,,,,,,,,,,19.0,ma MAR,MF,25.0,22.2,11.0,0.0,0.0,54.0,28.0,0.0,26.0,21.0,24.0,0.0,2.0,0.0,157.0,11.0,13.0,45.8,Matches,19.0,ma MAR,MF,25.0,22.2,1490.0,1396.0,91.0,80.0,1.0,22.0,26.0,9.0,1.0,0.0,0.0,0.0,1323.0,3.0,25.0,Matches,19.0,ma MAR,MF,25.0,22.2,1323.0,1490.0,88.8,26717.0,7147.0,450.0,504.0,89.3,636.0,677.0,93.9,217.0,258.0,84.1,1.0,1.1,1.6,-0.1,12.0,158.0,23.0,10.0,176.0,Matches,26,ma MAR,MF,25,29,1998.0,69.0,58.4,22.2,24,79.0,11,5,23.0,4,1.41,29.0,27.0,2.0,0.09,-0.42,30.5,25.7,4.8,0.22,-0.22,Matches,19.0,ma MAR,MF,25.0,22.2,1641.0,45.0,298.0,1106.0,256.0,6.0,1641.0,17.0,12.0,70.6,4.0,23.5,1054.0,6108.0,2876.0,36.0,28.0,1.0,20.0,16.0,1196.0,24.0,Matches,19.0,ma MAR,MF,25.0,22.2,0.0,13.0,4.0,30.8,0.59,0.18,0.0,0.0,26.6,0.0,0.0,0.0,0.5,0.5,0.04,-0.5,-0.5,Matches,19.0,ma MAR,MF,25.0,29.0,24.0,1998.0,22.2,0.0,1.0,1.0,0.0,0.0,0.0,11.0,0.0,0.5,0.5,1.1,1.6,36.0,176.0,24.0,0.0,0.05,0.05,0.0,0.05,0.02,0.05,0.07,0.02,0.07,Matches,Sofyan Amrabat,DM/M C,25,139,145,"Morocco,Holland",ACF Fiorentina,10,8,14,7,13,8,7,10,3,12,14,13,14,13,16,14,14,14,14,13,13,15,12,12,12,14,15,17,14,13,13,9,15,14,14,14,11,14,10,6,14,2,3,3,1,3,1,3,1,1,1,2,16,15,11,12,13,15,12,10,1,1,14,1,1,1,20,10,18,10,1,11,1,1,185,70,11,20,10496805,6946,6946,5396,North_African__Middle_Eastern,139,7,1996/8/21,36,0,36922.0,,37045879
1084,Felipe Anderson,Lazio,1993,20.0,br BRA,FW,29.0,32.9,80.0,50.0,31.0,41.0,8.0,31.0,88.0,35.2,57.0,58.0,6.0,52.0,31.0,111.0,27.0,0.0,Matches,20.0,br BRA,FW,29.0,32.9,99.0,3.01,79.0,1.0,10.0,6.0,3.0,0.0,15.0,0.46,8.0,0.0,4.0,2.0,1.0,0.0,Matches,,,,,,,,,,,,,,,,,,,,,,,,,,,,,,,,,,,,,,,,,,,,,,,,,,,,,,,,20.0,br BRA,FW,29.0,32.9,3.0,0.0,0.0,40.0,33.0,7.0,50.0,31.0,50.0,1.0,0.0,0.0,142.0,14.0,21.0,40.0,Matches,20.0,br BRA,FW,29.0,32.9,1410.0,1370.0,34.0,2.0,4.0,8.0,50.0,21.0,3.0,1.0,2.0,0.0,1093.0,6.0,41.0,Matches,20.0,br BRA,FW,29.0,32.9,1093.0,1410.0,77.5,15203.0,3384.0,665.0,780.0,85.3,331.0,416.0,79.6,49.0,86.0,57.0,2.0,4.8,4.2,-2.8,47.0,61.0,47.0,6.0,114.0,Matches,28,br BRA,FW,29,38,2958.0,78.0,86.5,32.9,35,82.0,23,3,28.0,0,1.95,48.0,24.0,24.0,0.73,-0.44,44.1,35.7,8.3,0.25,-0.03,Matches,20.0,br BRA,FW,29.0,32.9,1832.0,32.0,236.0,830.0,790.0,129.0,1832.0,105.0,54.0,51.4,42.0,40.0,967.0,5271.0,2369.0,83.0,62.0,31.0,85.0,44.0,1367.0,224.0,Matches,20.0,br BRA,FW,29.0,32.9,9.0,41.0,23.0,56.1,1.25,0.7,0.22,0.39,15.1,0.0,0.0,0.0,6.0,6.0,0.15,3.0,3.0,Matches,20.0,br BRA,FW,29.0,38.0,35.0,2958.0,32.9,9.0,2.0,11.0,9.0,0.0,0.0,3.0,0.0,6.0,6.0,4.8,10.9,83.0,114.0,224.0,0.27,0.06,0.33,0.27,0.33,0.18,0.15,0.33,0.18,0.33,Matches,Felipe Anderson,AM RL,29,149,155,Brazil,S.S. Lazio,9,16,17,13,16,11,4,12,3,5,14,12,10,17,13,14,9,12,10,15,13,14,18,6,13,5,18,11,15,16,11,8,15,15,12,8,13,11,13,7,17,2,2,2,2,2,2,2,1,3,1,3,15,16,8,16,10,17,16,14,1,1,1,1,8,5,1,12,1,12,18,13,20,14,175,70,14,20,24227050,7450,6900,6000,Mediterranean_Hispanic,148,8,1993/4/15,2,0,54231.0,,19105713
1085,Marko Arnautović,Bologna,1989,24.0,at AUT,FW,33.0,17.0,9.0,6.0,2.0,5.0,2.0,1.0,6.0,16.7,5.0,11.0,1.0,10.0,2.0,11.0,10.0,0.0,Matches,24.0,at AUT,FW,33.0,17.0,44.0,2.58,36.0,0.0,3.0,2.0,3.0,0.0,5.0,0.29,3.0,0.0,1.0,0.0,1.0,0.0,Matches,,,,,,,,,,,,,,,,,,,,,,,,,,,,,,,,,,,,,,,,,,,,,,,,,,,,,,,,24.0,at AUT,FW,33.0,17.0,5.0,0.0,0.0,22.0,20.0,11.0,9.0,2.0,6.0,0.0,0.0,0.0,36.0,10.0,12.0,45.5,Matches,24.0,at AUT,FW,33.0,17.0,467.0,420.0,40.0,0.0,3.0,0.0,9.0,4.0,0.0,0.0,0.0,0.0,328.0,7.0,15.0,Matches,24.0,at AUT,FW,33.0,17.0,328.0,467.0,70.2,4736.0,799.0,180.0,234.0,76.9,106.0,138.0,76.8,17.0,32.0,53.1,0.0,1.9,1.4,-1.9,22.0,17.0,14.0,1.0,36.0,Matches,34,at AUT,FW,33,21,1530.0,73.0,44.7,17.0,18,81.0,10,3,22.0,2,1.24,22.0,24.0,-2.0,-0.12,-0.4,19.8,21.2,-1.4,-0.08,0.09,Matches,24.0,at AUT,FW,33.0,17.0,618.0,14.0,44.0,325.0,255.0,57.0,615.0,27.0,13.0,48.1,11.0,40.7,361.0,1616.0,524.0,13.0,12.0,6.0,42.0,19.0,496.0,116.0,Matches,24.0,at AUT,FW,33.0,17.0,10.0,28.0,15.0,53.6,1.65,0.88,0.25,0.47,15.5,0.0,3.0,3.0,7.2,4.8,0.17,2.8,2.2,Matches,24.0,at AUT,FW,33.0,21.0,18.0,1530.0,17.0,10.0,0.0,10.0,7.0,3.0,3.0,5.0,0.0,7.2,4.8,1.9,6.7,13.0,36.0,116.0,0.59,0.0,0.59,0.41,0.41,0.42,0.11,0.53,0.28,0.39,Matches,Marko Arnautović,S,33,150,153,"Austria,Serbia",Bologna FC 1909,4,11,15,16,17,12,16,13,4,4,14,16,6,17,16,9,14,13,8,15,11,15,17,15,14,6,13,13,13,11,16,14,16,14,13,17,15,14,13,8,11,2,3,1,2,2,1,2,2,3,1,1,14,18,14,11,12,18,10,8,1,1,1,1,1,1,1,1,1,1,11,10,10,20,192,83,15,20,347975206,7500,7500,6300,Northern_European,149,6,1989/4/19,102,33,74038.0,,37003555
1086,Tolgay Arslan,Udinese,1990,25.0,de GER,MF,31.0,13.5,29.0,18.0,13.0,15.0,1.0,14.0,39.0,35.9,25.0,19.0,0.0,19.0,12.0,41.0,9.0,1.0,Matches,25.0,de GER,MF,31.0,13.5,44.0,3.28,30.0,5.0,3.0,1.0,4.0,1.0,0.0,0.0,0.0,0.0,0.0,0.0,0.0,0.0,Matches,,,,,,,,,,,,,,,,,,,,,,,,,,,,,,,,,,,,,,,,,,,,,,,,,,,,,,,,25.0,de GER,MF,31.0,13.5,3.0,0.0,0.0,15.0,35.0,0.0,28.0,12.0,18.0,0.0,0.0,0.0,78.0,8.0,4.0,66.7,Matches,25.0,de GER,MF,31.0,13.5,605.0,556.0,48.0,27.0,0.0,15.0,28.0,6.0,14.0,7.0,1.0,0.0,485.0,1.0,14.0,Matches,25.0,de GER,MF,31.0,13.5,485.0,605.0,80.2,8750.0,2629.0,228.0,261.0,87.4,169.0,200.0,84.5,71.0,101.0,70.3,0.0,1.6,1.6,-1.6,15.0,51.0,19.0,4.0,77.0,Matches,35,de GER,MF,31,36,1211.0,34.0,35.4,13.5,12,60.0,0,24,21.0,0,1.28,12.0,16.0,-4.0,-0.3,-0.42,16.7,17.7,-1.1,-0.08,0.07,Matches,25.0,de GER,MF,31.0,13.5,770.0,13.0,145.0,398.0,234.0,26.0,770.0,36.0,15.0,41.7,13.0,36.1,473.0,2944.0,1530.0,45.0,31.0,11.0,26.0,17.0,504.0,37.0,Matches,25.0,de GER,MF,31.0,13.5,1.0,25.0,5.0,20.0,1.86,0.37,0.04,0.2,21.1,1.0,0.0,0.0,2.2,2.2,0.09,-1.2,-1.2,Matches,25.0,de GER,MF,31.0,36.0,12.0,1211.0,13.5,1.0,0.0,1.0,1.0,0.0,0.0,3.0,0.0,2.2,2.2,1.6,3.8,45.0,77.0,37.0,0.07,0.0,0.07,0.07,0.07,0.16,0.12,0.29,0.16,0.29,Matches,Tolgay Arslan,DM/M C,31,129,140,"Germany,Turkey",Udinese Calcio,11,13,13,7,14,11,10,11,6,12,13,11,12,14,12,13,14,14,10,14,12,14,12,9,11,13,15,14,13,14,12,10,14,12,12,12,12,12,7,11,8,2,3,3,1,3,2,3,2,2,3,3,11,15,10,8,13,14,10,8,1,1,1,1,1,1,20,1,20,1,1,10,1,1,180,77,12,20,1421404,6450,6350,5050,North_African__Middle_Eastern,127,4,1990/8/16,0,0,14808.0,,91003495
1087,Emil Audero,Sampdoria,1997,29.0,it ITA,GK,25.0,25.0,0.0,0.0,0.0,0.0,0.0,0.0,2.0,0.0,2.0,0.0,0.0,0.0,0.0,0.0,7.0,1.0,Matches,29.0,it ITA,GK,25.0,25.0,5.0,0.2,5.0,0.0,0.0,0.0,0.0,0.0,0.0,0.0,0.0,0.0,0.0,0.0,0.0,0.0,Matches,1.0,it ITA,GK,25.0,25.0,39.0,5.0,0.0,4.0,2.0,32.3,0.21,-4.7,-0.19,159.0,441.0,36.1,714.0,104.0,45.8,39.1,200.0,57.0,44.2,356.0,24.0,6.7,23.0,0.92,13.9,Matches,1.0,it ITA,GK,25.0,25.0,25.0,2250.0,25.0,39.0,1.56,121.0,82.0,71.9,2.0,6.0,17.0,4.0,16.0,7.0,5.0,2.0,0.0,28.6,Matches,29.0,it ITA,GK,25.0,25.0,1.0,0.0,0.0,0.0,2.0,0.0,0.0,0.0,0.0,0.0,0.0,1.0,41.0,6.0,0.0,100.0,Matches,29.0,it ITA,GK,25.0,25.0,919.0,628.0,286.0,86.0,0.0,0.0,0.0,0.0,0.0,0.0,0.0,0.0,617.0,5.0,2.0,Matches,29.0,it ITA,GK,25.0,25.0,617.0,919.0,67.1,19319.0,14234.0,91.0,91.0,100.0,246.0,248.0,99.2,279.0,572.0,48.8,0.0,0.0,0.1,0.0,0.0,16.0,0.0,0.0,0.0,Matches,39,it ITA,GK,25,25,2250.0,90.0,65.8,25.0,25,90.0,25,0,,0,0.48,11.0,39.0,-28.0,-1.12,0.34,21.4,37.7,-16.3,-0.65,0.57,Matches,29.0,it ITA,GK,25.0,25.0,982.0,811.0,968.0,17.0,0.0,0.0,982.0,0.0,0.0,,0.0,,548.0,2997.0,1827.0,0.0,0.0,0.0,1.0,0.0,414.0,0.0,Matches,29.0,it ITA,GK,25.0,25.0,0.0,0.0,0.0,,0.0,0.0,,,,0.0,0.0,0.0,0.0,0.0,,0.0,0.0,Matches,29.0,it ITA,GK,25.0,25.0,25.0,2250.0,25.0,0.0,0.0,0.0,0.0,0.0,0.0,1.0,0.0,0.0,0.0,0.0,0.0,0.0,0.0,0.0,0.0,0.0,0.0,0.0,0.0,0.0,0.0,0.0,0.0,0.0,Matches,Emil Audero,GK,25,129,138,"Italy,Indonesia",U.C. Sampdoria,3,1,2,2,6,5,6,2,1,1,10,2,1,6,12,13,13,12,11,9,13,15,10,15,1,13,15,13,12,13,13,15,18,12,12,13,12,4,15,3,10,10,12,12,4,10,13,16,16,10,10,16,10,12,4,13,11,15,12,12,20,1,1,1,1,1,1,1,1,1,1,1,1,1,192,83,10,20,2641827,6450,6500,5250,10,128,6,1997/1/18,0,0,28461.0,,43152255
1088,Tommaso Augello,Sampdoria,1994,30.0,it ITA,DF,27.0,34.0,17.0,14.0,13.0,2.0,2.0,9.0,20.0,45.0,11.0,23.0,7.0,16.0,17.0,34.0,61.0,1.0,Matches,30.0,it ITA,DF,27.0,34.0,77.0,2.26,54.0,16.0,2.0,1.0,3.0,1.0,7.0,0.21,6.0,1.0,0.0,0.0,0.0,0.0,Matches,,,,,,,,,,,,,,,,,,,,,,,,,,,,,,,,,,,,,,,,,,,,,,,,,,,,,,,,30.0,it ITA,DF,27.0,34.0,3.0,0.0,0.0,14.0,26.0,1.0,170.0,17.0,14.0,0.0,1.0,0.0,183.0,38.0,32.0,54.3,Matches,30.0,it ITA,DF,27.0,34.0,1774.0,1408.0,365.0,49.0,0.0,5.0,170.0,295.0,21.0,6.0,15.0,0.0,1283.0,1.0,71.0,Matches,30.0,it ITA,DF,27.0,34.0,1283.0,1774.0,72.3,21887.0,9530.0,613.0,701.0,87.4,531.0,716.0,74.2,114.0,236.0,48.3,5.0,3.9,3.8,1.1,43.0,84.0,45.0,28.0,119.0,Matches,40,it ITA,DF,27,37,3061.0,83.0,89.5,34.0,35,85.0,28,2,45.0,1,0.51,23.0,64.0,-41.0,-1.21,0.3,31.0,59.4,-28.4,-0.84,0.1,Matches,30.0,it ITA,DF,27.0,34.0,1981.0,88.0,615.0,856.0,544.0,21.0,1981.0,64.0,36.0,56.3,23.0,35.9,1042.0,5837.0,3177.0,84.0,43.0,5.0,21.0,17.0,1167.0,153.0,Matches,30.0,it ITA,DF,27.0,34.0,2.0,11.0,4.0,36.4,0.32,0.12,0.18,0.5,14.5,0.0,0.0,0.0,1.0,1.0,0.09,1.0,1.0,Matches,30.0,it ITA,DF,27.0,37.0,35.0,3061.0,34.0,2.0,5.0,7.0,2.0,0.0,0.0,3.0,0.0,1.0,1.0,3.9,4.8,84.0,119.0,153.0,0.06,0.15,0.21,0.06,0.21,0.03,0.11,0.14,0.03,0.14,Matches,Tommaso Augello,D/WB L,27,129,134,Italy,U.C. Sampdoria,9,15,12,9,13,4,6,11,16,13,13,6,13,13,10,13,12,11,11,12,11,13,10,6,15,12,15,17,13,13,12,10,16,13,16,13,14,4,10,6,16,3,1,3,2,3,1,3,1,1,1,1,9,13,4,13,10,15,12,9,1,20,1,1,16,1,1,10,1,1,1,1,1,1,180,70,20,10,3293477,6450,6450,4700,Mediterranean_Hispanic,125,2,1994/8/30,0,0,8846.0,,43096264
1089,Carlos Augusto,Monza,1999,31.0,br BRA,DF,23.0,34.3,73.0,38.0,42.0,23.0,8.0,33.0,54.0,61.1,21.0,24.0,6.0,18.0,24.0,97.0,85.0,1.0,Matches,31.0,br BRA,DF,23.0,34.3,56.0,1.63,45.0,3.0,3.0,2.0,2.0,1.0,9.0,0.26,8.0,0.0,0.0,1.0,0.0,0.0,Matches,,,,,,,,,,,,,,,,,,,,,,,,,,,,,,,,,,,,,,,,,,,,,,,,,,,,,,,,31.0,br BRA,DF,23.0,34.3,4.0,0.0,0.0,41.0,19.0,6.0,54.0,24.0,38.0,0.0,0.0,0.0,157.0,57.0,33.0,63.3,Matches,31.0,br BRA,DF,23.0,34.3,1719.0,1409.0,305.0,20.0,2.0,7.0,54.0,280.0,0.0,0.0,0.0,0.0,1430.0,5.0,49.0,Matches,31.0,br BRA,DF,23.0,34.3,1430.0,1719.0,83.2,22788.0,6775.0,743.0,811.0,91.6,566.0,665.0,85.1,82.0,133.0,61.7,5.0,3.7,3.4,1.3,26.0,75.0,27.0,7.0,101.0,Matches,41,br BRA,DF,23,35,3083.0,88.0,90.1,34.3,35,88.0,31,0,,0,1.4,45.0,46.0,-1.0,-0.03,0.77,42.9,44.5,-1.6,-0.05,0.97,Matches,31.0,br BRA,DF,23.0,34.3,2073.0,111.0,676.0,917.0,498.0,71.0,2073.0,61.0,33.0,54.1,24.0,39.3,1032.0,5925.0,3073.0,87.0,62.0,15.0,45.0,28.0,1267.0,151.0,Matches,31.0,br BRA,DF,23.0,34.3,6.0,42.0,16.0,38.1,1.23,0.47,0.14,0.38,15.0,0.0,0.0,0.0,4.4,4.4,0.11,1.6,1.6,Matches,31.0,br BRA,DF,23.0,35.0,35.0,3083.0,34.3,6.0,5.0,11.0,6.0,0.0,0.0,4.0,0.0,4.4,4.4,3.7,8.1,87.0,101.0,151.0,0.18,0.15,0.32,0.18,0.32,0.13,0.11,0.24,0.13,0.24,Matches,Carlos Augusto,D/WB LC,23,124,141,"Brazil,Italy",Brianza,9,12,12,9,12,9,12,10,12,12,12,9,12,13,14,12,14,13,12,12,13,12,10,9,12,11,11,13,14,13,10,11,8,12,14,12,12,7,12,11,14,1,3,1,2,2,2,1,1,2,1,4,10,12,6,13,13,10,8,12,1,20,15,1,19,1,1,14,1,1,1,1,1,1,184,0,20,8,2243568,6198,5511,4977,Northern_European,120,2,1999/1/7,0,0,12114.0,,19350649
1090,Nedim Bajrami,Empoli,1999,34.0,al ALB,MFFW,23.0,10.4,8.0,4.0,3.0,3.0,2.0,4.0,6.0,66.7,2.0,5.0,0.0,5.0,7.0,15.0,4.0,0.0,Matches,34.0,al ALB,MFFW,23.0,10.4,39.0,3.74,27.0,8.0,2.0,1.0,1.0,0.0,4.0,0.38,2.0,0.0,1.0,0.0,1.0,0.0,Matches,,,,,,,,,,,,,,,,,,,,,,,,,,,,,,,,,,,,,,,,,,,,,,,,,,,,,,,,34.0,al ALB,MFFW,23.0,10.4,1.0,0.0,0.0,6.0,6.0,3.0,35.0,7.0,4.0,0.0,0.0,0.0,49.0,2.0,7.0,22.2,Matches,34.0,al ALB,MFFW,23.0,10.4,348.0,305.0,43.0,9.0,0.0,4.0,35.0,8.0,18.0,10.0,5.0,0.0,260.0,0.0,8.0,Matches,34.0,al ALB,MFFW,23.0,10.4,260.0,348.0,74.7,3968.0,1323.0,149.0,182.0,81.9,79.0,96.0,82.3,20.0,43.0,46.5,1.0,1.2,0.7,-0.2,15.0,19.0,6.0,0.0,29.0,Matches,45,al ALB,MFFW,23,19,940.0,49.0,27.5,10.4,8,80.0,4,11,27.0,1,1.21,8.0,14.0,-6.0,-0.57,-0.36,8.9,18.6,-9.7,-0.93,-0.58,Matches,34.0,al ALB,MFFW,23.0,10.4,457.0,1.0,66.0,185.0,219.0,27.0,457.0,31.0,11.0,35.5,18.0,58.1,267.0,1928.0,816.0,22.0,21.0,10.0,24.0,17.0,304.0,47.0,Matches,34.0,al ALB,MFFW,23.0,10.4,1.0,21.0,7.0,33.3,2.01,0.67,0.05,0.14,24.1,6.0,0.0,0.0,1.2,1.2,0.06,-0.2,-0.2,Matches,34.0,al ALB,MFFW,23.0,19.0,8.0,940.0,10.4,1.0,1.0,2.0,1.0,0.0,0.0,1.0,0.0,1.2,1.2,1.2,2.4,22.0,29.0,47.0,0.1,0.1,0.19,0.1,0.19,0.12,0.11,0.23,0.12,0.23,Matches,Nedim Bajrami,M/AM C,23,134,151,"Albania,Switzerland,North Macedonia",Empoli Football Club,13,13,13,13,14,13,8,14,4,7,14,14,8,15,13,12,12,14,11,14,13,13,14,10,14,7,14,14,13,13,13,9,13,14,13,11,11,8,10,5,14,2,1,3,3,1,1,3,2,1,1,3,14,14,7,12,13,14,11,9,1,1,1,1,1,1,10,1,18,1,1,20,1,1,179,68,11,20,9878407,6696,6096,5346,Northern_European,134,4,1999/2/28,7,0,29614.0,,98038311
1091,Tommaso Baldanzi,Empoli,2003,37.0,it ITA,MF,19.0,19.7,25.0,12.0,9.0,13.0,3.0,7.0,32.0,21.9,25.0,21.0,1.0,20.0,2.0,27.0,5.0,0.0,Matches,37.0,it ITA,MF,19.0,19.7,60.0,3.04,38.0,2.0,7.0,5.0,8.0,0.0,4.0,0.2,4.0,0.0,0.0,0.0,0.0,0.0,Matches,,,,,,,,,,,,,,,,,,,,,,,,,,,,,,,,,,,,,,,,,,,,,,,,,,,,,,,,37.0,it ITA,MF,19.0,19.7,2.0,0.0,0.0,12.0,37.0,1.0,21.0,2.0,12.0,0.0,0.0,0.0,69.0,3.0,9.0,25.0,Matches,37.0,it ITA,MF,19.0,19.7,647.0,592.0,52.0,6.0,3.0,4.0,21.0,3.0,6.0,1.0,0.0,0.0,534.0,3.0,19.0,Matches,37.0,it ITA,MF,19.0,19.7,534.0,647.0,82.5,7465.0,1747.0,307.0,332.0,92.5,175.0,206.0,85.0,19.0,41.0,46.3,0.0,1.8,1.8,-1.8,23.0,38.0,17.0,1.0,69.0,Matches,48,it ITA,MF,19,26,1772.0,68.0,51.8,19.7,24,72.0,6,2,28.0,5,1.15,17.0,23.0,-6.0,-0.3,0.02,18.9,26.2,-7.3,-0.37,0.3,Matches,37.0,it ITA,MF,19.0,19.7,841.0,11.0,109.0,408.0,334.0,46.0,841.0,60.0,23.0,38.3,30.0,50.0,548.0,3500.0,1772.0,57.0,51.0,14.0,33.0,15.0,600.0,94.0,Matches,37.0,it ITA,MF,19.0,19.7,4.0,33.0,12.0,36.4,1.68,0.61,0.12,0.33,20.1,0.0,0.0,0.0,2.4,2.4,0.07,1.6,1.6,Matches,37.0,it ITA,MF,19.0,26.0,24.0,1772.0,19.7,4.0,0.0,4.0,4.0,0.0,0.0,2.0,0.0,2.4,2.4,1.8,4.2,57.0,69.0,94.0,0.2,0.0,0.2,0.2,0.2,0.12,0.09,0.21,0.12,0.21,Matches,Tommaso Baldanzi,AM/S C,19,110,-8,Italy,Empoli Football Club,12,9,14,12,13,12,8,11,4,5,12,10,7,14,10,12,9,10,9,14,13,16,14,7,13,5,13,13,13,14,13,5,12,12,11,7,12,5,14,6,8,3,3,2,3,1,4,1,1,2,2,1,13,16,6,13,12,16,14,9,1,1,1,1,1,1,1,1,10,1,1,20,12,18,170,68,20,9,24080000,5500,5500,2250,Mediterranean_Hispanic,110,2,2003/3/23,0,0,4381.0,,43591641
1092,Lameck Banda,Lecce,2001,39.0,zm ZAM,FWMF,21.0,18.2,30.0,20.0,13.0,14.0,3.0,15.0,41.0,36.6,26.0,24.0,2.0,22.0,8.0,38.0,5.0,0.0,Matches,39.0,zm ZAM,FWMF,21.0,18.2,42.0,2.31,20.0,2.0,13.0,3.0,4.0,0.0,3.0,0.17,3.0,0.0,0.0,0.0,0.0,0.0,Matches,,,,,,,,,,,,,,,,,,,,,,,,,,,,,,,,,,,,,,,,,,,,,,,,,,,,,,,,39.0,zm ZAM,FWMF,21.0,18.2,6.0,0.0,0.0,31.0,37.0,11.0,51.0,8.0,20.0,0.0,0.0,0.0,82.0,7.0,32.0,17.9,Matches,39.0,zm ZAM,FWMF,21.0,18.2,428.0,409.0,17.0,1.0,0.0,1.0,51.0,5.0,11.0,5.0,1.0,0.0,278.0,2.0,22.0,Matches,39.0,zm ZAM,FWMF,21.0,18.2,278.0,428.0,65.0,3757.0,907.0,173.0,219.0,79.0,81.0,128.0,63.3,13.0,33.0,39.4,1.0,1.3,1.1,-0.3,14.0,17.0,7.0,1.0,28.0,Matches,51,zm ZAM,FWMF,21,36,1636.0,45.0,47.8,18.2,19,69.0,3,17,19.0,1,0.97,14.0,20.0,-6.0,-0.33,0.02,15.9,21.4,-5.5,-0.3,-0.27,Matches,39.0,zm ZAM,FWMF,21.0,18.2,720.0,13.0,75.0,266.0,403.0,74.0,720.0,112.0,48.0,42.9,48.0,42.9,505.0,4583.0,2236.0,86.0,55.0,38.0,67.0,36.0,509.0,160.0,Matches,39.0,zm ZAM,FWMF,21.0,18.2,2.0,36.0,12.0,33.3,1.98,0.66,0.06,0.17,19.0,0.0,0.0,0.0,3.1,3.1,0.09,-1.1,-1.1,Matches,39.0,zm ZAM,FWMF,21.0,36.0,19.0,1636.0,18.2,2.0,1.0,3.0,2.0,0.0,0.0,6.0,0.0,3.1,3.1,1.3,4.5,86.0,28.0,160.0,0.11,0.06,0.17,0.11,0.17,0.17,0.07,0.25,0.17,0.25,Matches,Lameck Banda,AM/S RL,21,123,149,Zambia,Salento,8,11,13,10,13,9,7,7,7,7,9,11,7,12,11,8,11,10,10,10,11,13,9,8,12,8,10,10,16,15,12,9,12,16,12,7,12,5,11,5,7,2,3,1,2,3,3,3,3,3,1,3,12,13,5,12,12,13,14,12,1,1,1,1,1,1,1,1,1,1,20,1,18,17,160,69,9,20,4659999,6150,5107,3881,African_Caribbean,112,18,2001/1/29,4,0,14621.0,,13205265
1093,Filippo Bandinelli,Empoli,1995,40.0,it ITA,MF,27.0,25.1,55.0,34.0,19.0,26.0,10.0,17.0,45.0,37.8,28.0,20.0,7.0,13.0,18.0,73.0,40.0,0.0,Matches,40.0,it ITA,MF,27.0,25.1,61.0,2.42,51.0,2.0,0.0,2.0,3.0,3.0,2.0,0.08,2.0,0.0,0.0,0.0,0.0,0.0,Matches,,,,,,,,,,,,,,,,,,,,,,,,,,,,,,,,,,,,,,,,,,,,,,,,,,,,,,,,40.0,it ITA,MF,27.0,25.1,10.0,0.0,0.0,53.0,37.0,0.0,91.0,18.0,34.0,0.0,1.0,0.0,138.0,10.0,19.0,34.5,Matches,40.0,it ITA,MF,27.0,25.1,1049.0,973.0,69.0,17.0,3.0,8.0,91.0,41.0,9.0,3.0,5.0,0.0,773.0,7.0,42.0,Matches,40.0,it ITA,MF,27.0,25.1,773.0,1049.0,73.7,12752.0,3934.0,379.0,434.0,87.3,299.0,379.0,78.9,64.0,138.0,46.4,0.0,2.6,2.4,-2.6,31.0,62.0,36.0,21.0,101.0,Matches,52,it ITA,MF,27,35,2263.0,65.0,66.2,25.1,28,74.0,3,7,26.0,1,1.17,24.0,27.0,-3.0,-0.12,0.58,24.9,34.7,-9.8,-0.39,0.37,Matches,40.0,it ITA,MF,27.0,25.1,1333.0,66.0,317.0,658.0,376.0,29.0,1333.0,42.0,15.0,35.7,21.0,50.0,746.0,3897.0,1736.0,40.0,41.0,7.0,42.0,30.0,863.0,89.0,Matches,40.0,it ITA,MF,27.0,25.1,2.0,24.0,7.0,29.2,0.95,0.28,0.08,0.29,23.4,0.0,0.0,0.0,1.7,1.7,0.07,0.3,0.3,Matches,40.0,it ITA,MF,27.0,35.0,28.0,2263.0,25.1,2.0,0.0,2.0,2.0,0.0,0.0,10.0,0.0,1.7,1.7,2.6,4.4,40.0,101.0,89.0,0.08,0.0,0.08,0.08,0.08,0.07,0.1,0.17,0.07,0.17,Matches,Filippo Bandinelli,M C,27,128,133,Italy,Empoli Football Club,11,12,13,11,12,10,10,13,9,10,14,10,10,13,15,13,14,12,13,12,13,14,10,14,14,11,15,14,14,12,12,10,14,14,15,12,13,9,13,6,15,2,1,1,1,3,2,1,2,4,2,1,14,12,6,10,8,13,12,10,1,1,1,1,1,1,12,7,20,1,14,13,1,1,180,70,20,9,2138964,6398,6398,4948,Northern_European,128,5,1995/3/29,0,0,21346.0,,43093472
1094,Antonín Barák,Fiorentina,1994,42.0,cz CZE,MF,27.0,20.0,21.0,9.0,5.0,7.0,9.0,6.0,16.0,37.5,10.0,16.0,2.0,14.0,3.0,24.0,13.0,0.0,Matches,42.0,cz CZE,MF,27.0,20.0,44.0,2.2,35.0,0.0,4.0,2.0,3.0,0.0,1.0,0.05,1.0,0.0,0.0,0.0,0.0,0.0,Matches,,,,,,,,,,,,,,,,,,,,,,,,,,,,,,,,,,,,,,,,,,,,,,,,,,,,,,,,42.0,cz CZE,MF,27.0,20.0,4.0,0.0,0.0,13.0,17.0,3.0,14.0,3.0,9.0,0.0,1.0,0.0,76.0,18.0,31.0,36.7,Matches,42.0,cz CZE,MF,27.0,20.0,719.0,689.0,28.0,6.0,5.0,6.0,14.0,7.0,0.0,0.0,0.0,0.0,590.0,2.0,16.0,Matches,42.0,cz CZE,MF,27.0,20.0,590.0,719.0,82.1,8980.0,1995.0,321.0,359.0,89.4,199.0,242.0,82.2,42.0,60.0,70.0,0.0,1.6,1.1,-1.6,22.0,59.0,14.0,2.0,82.0,Matches,54,cz CZE,MF,27,30,1799.0,60.0,52.6,20.0,21,78.0,6,9,18.0,4,1.33,25.0,26.0,-1.0,-0.05,-0.66,28.2,24.1,4.1,0.21,-0.21,Matches,42.0,cz CZE,MF,27.0,20.0,904.0,19.0,84.0,470.0,362.0,67.0,904.0,39.0,19.0,48.7,17.0,43.6,556.0,3364.0,1435.0,45.0,31.0,8.0,34.0,28.0,649.0,93.0,Matches,42.0,cz CZE,MF,27.0,20.0,2.0,32.0,7.0,21.9,1.6,0.35,0.06,0.29,17.7,0.0,0.0,0.0,2.6,2.6,0.08,-0.6,-0.6,Matches,42.0,cz CZE,MF,27.0,30.0,21.0,1799.0,20.0,2.0,0.0,2.0,2.0,0.0,0.0,4.0,0.0,2.6,2.6,1.6,4.1,45.0,82.0,93.0,0.1,0.0,0.1,0.1,0.1,0.13,0.08,0.21,0.13,0.21,Matches,Antonín Barák,M/AM C,27,143,148,Czech Republic,Hellas Verona,10,11,14,15,15,12,14,13,4,8,15,10,12,14,11,17,13,14,12,13,14,13,14,13,17,9,16,14,11,12,15,14,14,12,15,16,14,11,14,12,11,2,2,3,1,2,2,2,2,2,3,3,13,14,5,15,10,14,12,15,1,1,1,1,1,1,12,10,19,10,8,20,8,10,190,86,20,11,9765282,7150,6500,5500,Northern_European,143,1,1994/12/3,31,8,17787.0,ACF Fiorentina,25040431
1095,Nicolò Barella,Inter,1997,46.0,it ITA,MF,25.0,29.0,49.0,25.0,17.0,26.0,6.0,28.0,53.0,52.8,25.0,29.0,5.0,24.0,12.0,61.0,12.0,0.0,Matches,46.0,it ITA,MF,25.0,29.0,121.0,4.17,103.0,4.0,5.0,2.0,6.0,1.0,13.0,0.45,11.0,0.0,2.0,0.0,0.0,0.0,Matches,,,,,,,,,,,,,,,,,,,,,,,,,,,,,,,,,,,,,,,,,,,,,,,,,,,,,,,,46.0,it ITA,MF,25.0,29.0,6.0,0.0,0.0,32.0,45.0,9.0,84.0,12.0,25.0,0.0,0.0,0.0,178.0,20.0,15.0,57.1,Matches,46.0,it ITA,MF,25.0,29.0,1601.0,1566.0,29.0,13.0,6.0,16.0,84.0,8.0,6.0,0.0,2.0,0.0,1306.0,6.0,30.0,Matches,46.0,it ITA,MF,25.0,29.0,1306.0,1601.0,81.6,21320.0,6648.0,684.0,773.0,88.5,486.0,564.0,86.2,102.0,177.0,57.6,6.0,5.6,4.1,0.4,55.0,150.0,50.0,15.0,214.0,Matches,58,it ITA,MF,25,35,2613.0,75.0,76.4,29.0,31,81.0,17,4,23.0,2,1.8,51.0,31.0,20.0,0.69,-0.31,53.1,27.3,25.7,0.89,0.24,Matches,46.0,it ITA,MF,25.0,29.0,1892.0,43.0,303.0,962.0,656.0,57.0,1892.0,70.0,40.0,57.1,17.0,24.3,1253.0,7327.0,3430.0,76.0,69.0,10.0,52.0,39.0,1426.0,162.0,Matches,46.0,it ITA,MF,25.0,29.0,6.0,33.0,13.0,39.4,1.14,0.45,0.18,0.46,20.6,1.0,0.0,0.0,3.2,3.2,0.1,2.8,2.8,Matches,46.0,it ITA,MF,25.0,35.0,31.0,2613.0,29.0,6.0,6.0,12.0,6.0,0.0,0.0,6.0,0.0,3.2,3.2,5.6,8.8,76.0,214.0,162.0,0.21,0.21,0.41,0.21,0.41,0.11,0.19,0.3,0.11,0.3,Matches,Nicolò Barella,M C,25,160,171,Italy,FC Internazionale Milano,12,13,14,11,15,14,7,13,3,11,16,12,17,15,19,14,18,14,13,16,14,19,14,14,15,14,18,20,14,15,16,8,17,15,15,13,16,14,15,9,12,2,3,3,4,2,3,2,1,3,2,2,12,18,4,15,17,19,11,11,1,1,1,1,1,1,12,8,20,8,1,14,1,1,172,68,9,20,52249999,8000,8000,7800,Mediterranean_Hispanic,162,1,1997/2/7,39,8,178076.0,,43139595
1096,Musa Barrow,Bologna,1998,48.0,gm GAM,FWMF,23.0,21.8,21.0,4.0,10.0,6.0,5.0,8.0,14.0,57.1,6.0,25.0,1.0,24.0,1.0,22.0,7.0,0.0,Matches,48.0,gm GAM,FWMF,23.0,21.8,71.0,3.26,44.0,15.0,4.0,5.0,3.0,0.0,10.0,0.46,7.0,2.0,0.0,1.0,0.0,0.0,Matches,,,,,,,,,,,,,,,,,,,,,,,,,,,,,,,,,,,,,,,,,,,,,,,,,,,,,,,,48.0,gm GAM,FWMF,23.0,21.8,3.0,0.0,0.0,20.0,19.0,5.0,103.0,1.0,4.0,0.0,0.0,0.0,80.0,12.0,34.0,26.1,Matches,48.0,gm GAM,FWMF,23.0,21.8,806.0,701.0,94.0,17.0,5.0,17.0,103.0,13.0,50.0,30.0,18.0,0.0,583.0,11.0,22.0,Matches,48.0,gm GAM,FWMF,23.0,21.8,583.0,806.0,72.3,9580.0,2327.0,319.0,354.0,90.1,184.0,249.0,73.9,59.0,134.0,44.0,8.0,4.7,3.3,3.3,43.0,43.0,29.0,12.0,58.0,Matches,60,gm GAM,FWMF,23,32,1960.0,61.0,57.3,21.8,26,72.0,9,6,14.0,2,1.59,26.0,31.0,-5.0,-0.23,-0.78,21.6,31.0,-9.4,-0.43,-0.71,Matches,48.0,gm GAM,FWMF,23.0,21.8,1064.0,5.0,122.0,454.0,502.0,46.0,1064.0,71.0,24.0,33.8,41.0,57.7,667.0,4328.0,1960.0,68.0,59.0,19.0,50.0,31.0,791.0,141.0,Matches,48.0,gm GAM,FWMF,23.0,21.8,3.0,65.0,16.0,24.6,2.98,0.73,0.05,0.19,23.2,1.0,0.0,0.0,3.0,3.0,0.05,0.0,0.0,Matches,48.0,gm GAM,FWMF,23.0,32.0,26.0,1960.0,21.8,3.0,8.0,11.0,3.0,0.0,0.0,3.0,0.0,3.0,3.0,4.7,7.7,68.0,58.0,141.0,0.14,0.37,0.51,0.14,0.51,0.14,0.22,0.35,0.14,0.35,Matches,Musa Barrow,AM/S LC,23,135,150,The Gambia,Bologna FC 1909,12,13,14,13,14,12,12,14,4,4,13,12,5,14,12,12,10,12,10,11,11,10,16,8,12,4,12,10,15,15,13,10,13,16,13,11,11,10,10,5,13,3,4,2,1,2,1,1,2,2,3,2,14,10,8,12,11,16,12,11,1,1,1,1,1,1,1,1,1,1,20,15,10,19,184,76,10,20,11446401,6750,6850,5500,African_Caribbean,131,18,1998/11/14,27,4,28461.0,,43372270
1097,Federico Baschirotto,Lecce,1996,49.0,it ITA,DF,25.0,37.0,40.0,30.0,35.0,5.0,0.0,22.0,36.0,61.1,14.0,45.0,29.0,16.0,36.0,76.0,192.0,0.0,Matches,49.0,it ITA,DF,25.0,37.0,20.0,0.54,15.0,2.0,0.0,2.0,0.0,1.0,1.0,0.03,1.0,0.0,0.0,0.0,0.0,0.0,Matches,,,,,,,,,,,,,,,,,,,,,,,,,,,,,,,,,,,,,,,,,,,,,,,,,,,,,,,,49.0,it ITA,DF,25.0,37.0,6.0,0.0,0.0,37.0,11.0,0.0,14.0,36.0,30.0,0.0,1.0,0.0,204.0,91.0,64.0,58.7,Matches,49.0,it ITA,DF,25.0,37.0,1432.0,1312.0,113.0,66.0,1.0,22.0,14.0,41.0,0.0,0.0,0.0,0.0,1049.0,7.0,14.0,Matches,49.0,it ITA,DF,25.0,37.0,1049.0,1432.0,73.3,22612.0,8666.0,280.0,331.0,84.6,588.0,706.0,83.3,170.0,350.0,48.6,0.0,0.7,0.8,-0.7,8.0,86.0,7.0,3.0,107.0,Matches,61,it ITA,DF,25,37,3330.0,90.0,97.4,37.0,37,90.0,37,0,,0,0.97,33.0,44.0,-11.0,-0.3,1.7,35.5,41.3,-5.8,-0.16,0.11,Matches,49.0,it ITA,DF,25.0,37.0,1823.0,238.0,968.0,771.0,96.0,36.0,1823.0,5.0,3.0,60.0,1.0,20.0,849.0,4481.0,2352.0,12.0,4.0,0.0,10.0,2.0,918.0,12.0,Matches,49.0,it ITA,DF,25.0,37.0,3.0,21.0,6.0,28.6,0.57,0.16,0.14,0.5,11.8,0.0,0.0,0.0,1.9,1.9,0.09,1.1,1.1,Matches,49.0,it ITA,DF,25.0,37.0,37.0,3330.0,37.0,3.0,0.0,3.0,3.0,0.0,0.0,6.0,0.0,1.9,1.9,0.7,2.6,12.0,107.0,12.0,0.08,0.0,0.08,0.08,0.08,0.05,0.02,0.07,0.05,0.07,Matches,Federico Baschirotto,D RC,25,123,129,Italy,Salento,6,13,10,12,10,7,15,9,13,13,10,6,13,9,10,12,11,10,11,9,12,14,8,13,11,13,13,13,12,10,12,14,15,12,13,15,13,8,10,7,9,1,3,1,3,2,1,2,1,3,2,2,11,14,7,10,10,14,11,10,1,14,20,20,12,15,1,1,1,1,1,1,1,1,184,77,8,20,2043555,6142,6142,2192,Mediterranean_Hispanic,119,2,1996/9/20,0,0,14621.0,,43155683
1098,Alessandro Bastoni,Inter,1999,52.0,it ITA,DF,23.0,24.0,41.0,20.0,20.0,14.0,7.0,11.0,27.0,40.7,16.0,27.0,13.0,14.0,24.0,65.0,45.0,0.0,Matches,52.0,it ITA,DF,23.0,24.0,52.0,2.17,43.0,4.0,1.0,2.0,2.0,0.0,5.0,0.21,3.0,1.0,0.0,0.0,1.0,0.0,Matches,,,,,,,,,,,,,,,,,,,,,,,,,,,,,,,,,,,,,,,,,,,,,,,,,,,,,,,,52.0,it ITA,DF,23.0,24.0,3.0,0.0,0.0,19.0,15.0,1.0,49.0,24.0,20.0,0.0,0.0,0.0,117.0,39.0,23.0,62.9,Matches,52.0,it ITA,DF,23.0,24.0,1671.0,1510.0,152.0,53.0,2.0,24.0,49.0,77.0,0.0,0.0,0.0,0.0,1384.0,9.0,24.0,Matches,52.0,it ITA,DF,23.0,24.0,1384.0,1671.0,82.8,27841.0,9878.0,486.0,539.0,90.2,677.0,751.0,90.1,207.0,324.0,63.9,2.0,2.7,2.9,-0.7,15.0,130.0,29.0,11.0,141.0,Matches,65,it ITA,DF,23,29,2157.0,74.0,63.1,24.0,26,80.0,16,3,25.0,8,1.9,42.0,25.0,17.0,0.71,-0.15,42.5,21.9,20.6,0.86,0.07,Matches,52.0,it ITA,DF,23.0,24.0,1857.0,201.0,796.0,821.0,250.0,30.0,1857.0,15.0,8.0,53.3,6.0,40.0,1137.0,5797.0,3688.0,47.0,31.0,3.0,13.0,6.0,1310.0,44.0,Matches,52.0,it ITA,DF,23.0,24.0,0.0,12.0,3.0,25.0,0.5,0.13,0.0,0.0,13.1,0.0,0.0,0.0,1.0,1.0,0.09,-1.0,-1.0,Matches,52.0,it ITA,DF,23.0,29.0,26.0,2157.0,24.0,0.0,2.0,2.0,0.0,0.0,0.0,3.0,0.0,1.0,1.0,2.7,3.7,47.0,141.0,44.0,0.0,0.08,0.08,0.0,0.08,0.04,0.11,0.15,0.04,0.15,Matches,Alessandro Bastoni,D C,23,152,168,Italy,FC Internazionale Milano,4,10,11,8,14,5,15,5,12,15,15,8,16,14,14,15,16,13,15,14,13,16,12,12,11,14,17,15,14,13,15,15,17,14,15,15,13,13,14,7,10,3,2,3,1,2,3,2,2,2,2,1,14,17,5,14,17,17,14,11,1,10,20,1,1,1,8,1,1,1,1,1,1,1,190,75,20,9,59167500,7600,7650,7150,Mediterranean_Hispanic,152,2,1999/4/13,15,1,99807.0,,43252460
1099,Simone Bastoni,Spezia,1996,53.0,it ITA,MFDF,25.0,13.2,47.0,24.0,23.0,19.0,5.0,15.0,33.0,45.5,18.0,20.0,5.0,15.0,8.0,55.0,14.0,0.0,Matches,53.0,it ITA,MFDF,25.0,13.2,30.0,2.27,19.0,8.0,0.0,2.0,0.0,1.0,3.0,0.23,3.0,0.0,0.0,0.0,0.0,0.0,Matches,,,,,,,,,,,,,,,,,,,,,,,,,,,,,,,,,,,,,,,,,,,,,,,,,,,,,,,,53.0,it ITA,MFDF,25.0,13.2,7.0,0.0,0.0,29.0,12.0,2.0,103.0,8.0,24.0,0.0,0.0,0.0,87.0,12.0,9.0,57.1,Matches,53.0,it ITA,MFDF,25.0,13.2,596.0,481.0,114.0,23.0,2.0,5.0,103.0,43.0,48.0,26.0,16.0,0.0,367.0,1.0,38.0,Matches,53.0,it ITA,MFDF,25.0,13.2,367.0,596.0,61.6,6147.0,2336.0,188.0,222.0,84.7,124.0,203.0,61.1,41.0,108.0,38.0,4.0,1.7,1.3,2.3,18.0,35.0,11.0,8.0,32.0,Matches,66,it ITA,MFDF,25,19,1189.0,63.0,34.8,13.2,15,74.0,3,4,22.0,3,0.89,12.0,22.0,-10.0,-0.76,0.09,14.2,17.3,-3.0,-0.23,0.38,Matches,53.0,it ITA,MFDF,25.0,13.2,749.0,31.0,183.0,306.0,273.0,24.0,749.0,20.0,7.0,35.0,10.0,50.0,341.0,1724.0,853.0,20.0,16.0,2.0,20.0,14.0,401.0,65.0,Matches,53.0,it ITA,MFDF,25.0,13.2,2.0,22.0,7.0,31.8,1.67,0.53,0.09,0.29,20.9,2.0,0.0,0.0,1.1,1.1,0.05,0.9,0.9,Matches,53.0,it ITA,MFDF,25.0,19.0,15.0,1189.0,13.2,2.0,4.0,6.0,2.0,0.0,0.0,7.0,0.0,1.1,1.1,1.7,2.8,20.0,32.0,65.0,0.15,0.3,0.45,0.15,0.45,0.08,0.13,0.21,0.08,0.21,Matches,Simone Bastoni,D/WB/M LC,25,136,144,Italy,Spezia Calcio,11,14,13,12,12,12,13,13,3,11,14,8,15,13,14,13,12,14,13,13,14,15,12,11,14,12,13,14,14,14,14,11,13,13,14,11,14,12,11,5,15,2,2,1,1,3,1,3,3,1,1,3,14,15,8,12,12,15,15,15,1,17,1,1,17,1,12,17,20,1,1,1,1,1,181,74,20,8,6654020,6800,6600,5000,Mediterranean_Hispanic,134,6,1996/11/5,0,0,3654.0,,43124937
1100,Rodrigo Becão,Udinese,1996,55.0,br BRA,DF,26.0,27.6,70.0,36.0,50.0,17.0,3.0,40.0,53.0,75.5,13.0,44.0,24.0,20.0,26.0,96.0,68.0,2.0,Matches,55.0,br BRA,DF,26.0,27.6,29.0,1.05,20.0,4.0,0.0,1.0,2.0,2.0,1.0,0.04,1.0,0.0,0.0,0.0,0.0,0.0,Matches,,,,,,,,,,,,,,,,,,,,,,,,,,,,,,,,,,,,,,,,,,,,,,,,,,,,,,,,55.0,br BRA,DF,26.0,27.6,11.0,1.0,0.0,38.0,32.0,6.0,19.0,26.0,36.0,0.0,0.0,1.0,157.0,63.0,28.0,69.2,Matches,55.0,br BRA,DF,26.0,27.6,1400.0,1181.0,216.0,68.0,1.0,10.0,19.0,148.0,0.0,0.0,0.0,0.0,1089.0,3.0,31.0,Matches,55.0,br BRA,DF,26.0,27.6,1089.0,1400.0,77.8,20616.0,8692.0,425.0,477.0,89.1,524.0,626.0,83.7,128.0,239.0,53.6,1.0,0.6,0.9,0.4,10.0,77.0,5.0,2.0,98.0,Matches,68,br BRA,DF,26,28,2484.0,89.0,72.6,27.6,28,89.0,25,0,,0,1.5,38.0,31.0,7.0,0.25,1.02,35.2,37.7,-2.5,-0.09,0.14,Matches,55.0,br BRA,DF,26.0,27.6,1667.0,135.0,805.0,701.0,172.0,43.0,1667.0,10.0,5.0,50.0,5.0,50.0,850.0,3682.0,2219.0,19.0,15.0,3.0,16.0,2.0,948.0,48.0,Matches,55.0,br BRA,DF,26.0,27.6,2.0,19.0,5.0,26.3,0.69,0.18,0.11,0.4,12.1,0.0,0.0,0.0,1.5,1.5,0.08,0.5,0.5,Matches,55.0,br BRA,DF,26.0,28.0,28.0,2484.0,27.6,2.0,1.0,3.0,2.0,0.0,0.0,11.0,1.0,1.5,1.5,0.6,2.1,19.0,98.0,48.0,0.07,0.04,0.11,0.07,0.11,0.05,0.02,0.08,0.05,0.08,Matches,Rodrigo Becão,D C,26,140,146,Brazil,Udinese Calcio,4,5,6,6,10,7,15,6,4,15,12,6,16,10,13,15,15,14,15,9,13,16,8,13,10,14,16,16,13,12,15,15,15,14,14,14,14,11,12,4,5,1,3,1,2,3,1,3,3,2,1,1,16,12,9,12,13,15,11,16,1,1,20,1,1,1,1,1,1,1,1,1,1,1,191,79,8,20,8047415,7000,6600,5150,African_Caribbean,140,14,1996/1/19,0,0,14808.0,,19249501
1101,Andrea Belotti,Roma,1993,58.0,it ITA,FW,28.0,12.7,12.0,5.0,3.0,5.0,4.0,5.0,11.0,45.5,6.0,11.0,1.0,10.0,3.0,15.0,5.0,0.0,Matches,58.0,it ITA,FW,28.0,12.7,27.0,2.12,22.0,0.0,0.0,3.0,2.0,0.0,3.0,0.24,3.0,0.0,0.0,0.0,0.0,0.0,Matches,,,,,,,,,,,,,,,,,,,,,,,,,,,,,,,,,,,,,,,,,,,,,,,,,,,,,,,,58.0,it ITA,FW,28.0,12.7,0.0,0.0,0.0,21.0,36.0,7.0,6.0,3.0,5.0,0.0,0.0,0.0,24.0,36.0,61.0,37.1,Matches,58.0,it ITA,FW,28.0,12.7,258.0,241.0,13.0,1.0,1.0,1.0,6.0,3.0,0.0,0.0,0.0,0.0,171.0,4.0,14.0,Matches,58.0,it ITA,FW,28.0,12.7,171.0,258.0,66.3,2169.0,381.0,103.0,135.0,76.3,45.0,62.0,72.6,5.0,9.0,55.6,2.0,1.6,0.7,0.4,14.0,6.0,5.0,0.0,13.0,Matches,71,it ITA,FW,28,31,1146.0,37.0,33.5,12.7,11,70.0,2,20,19.0,2,1.58,19.0,17.0,2.0,0.16,-0.24,21.9,10.0,11.9,0.94,0.41,Matches,58.0,it ITA,FW,28.0,12.7,404.0,7.0,34.0,164.0,210.0,52.0,403.0,33.0,7.0,21.2,18.0,54.5,226.0,1235.0,452.0,21.0,14.0,11.0,34.0,15.0,322.0,94.0,Matches,58.0,it ITA,FW,28.0,12.7,0.0,19.0,9.0,47.4,1.49,0.71,0.0,0.0,12.7,0.0,0.0,1.0,3.5,2.7,0.14,-3.5,-2.7,Matches,58.0,it ITA,FW,28.0,31.0,11.0,1146.0,12.7,0.0,2.0,2.0,0.0,0.0,1.0,0.0,0.0,3.5,2.7,1.6,4.3,21.0,13.0,94.0,0.0,0.16,0.16,0.0,0.16,0.27,0.13,0.4,0.21,0.34,Matches,Andrea Belotti,S,28,140,156,Italy,Associazione Sportiva Roma,4,8,11,15,12,8,15,12,4,6,12,15,10,12,15,14,17,14,14,12,13,18,12,14,15,7,18,18,12,12,17,13,14,14,13,16,14,12,12,11,7,1,3,3,3,3,2,1,3,1,2,2,12,11,6,14,13,17,15,18,1,1,1,1,1,1,1,1,1,1,1,1,1,20,181,73,12,20,6909398,7000,7300,6350,Mediterranean_Hispanic,140,1,1993/12/20,44,12,85385.0,,43066936
1102,Marco Benassi,Cremonese,1994,60.0,it ITA,MF,27.0,11.1,26.0,15.0,9.0,11.0,6.0,15.0,24.0,62.5,9.0,13.0,1.0,12.0,12.0,38.0,19.0,0.0,Matches,60.0,it ITA,MF,27.0,11.1,19.0,1.72,9.0,6.0,1.0,2.0,0.0,1.0,1.0,0.09,1.0,0.0,0.0,0.0,0.0,0.0,Matches,,,,,,,,,,,,,,,,,,,,,,,,,,,,,,,,,,,,,,,,,,,,,,,,,,,,,,,,60.0,it ITA,MF,27.0,11.1,1.0,0.0,0.0,10.0,6.0,0.0,24.0,12.0,15.0,0.0,0.0,0.0,71.0,5.0,15.0,25.0,Matches,60.0,it ITA,MF,27.0,11.1,344.0,301.0,41.0,6.0,1.0,2.0,24.0,5.0,13.0,3.0,8.0,0.0,248.0,2.0,14.0,Matches,60.0,it ITA,MF,27.0,11.1,248.0,344.0,72.1,4318.0,1060.0,115.0,136.0,84.6,109.0,138.0,79.0,20.0,44.0,45.5,0.0,0.4,0.5,-0.4,7.0,17.0,4.0,2.0,27.0,Matches,73,it ITA,MF,27,15,998.0,67.0,29.2,11.1,11,81.0,7,4,27.0,1,0.87,9.0,21.0,-12.0,-1.08,-0.3,10.1,17.0,-6.8,-0.62,0.15,Matches,60.0,it ITA,MF,27.0,11.1,461.0,20.0,109.0,221.0,136.0,17.0,461.0,9.0,8.0,88.9,0.0,0.0,225.0,1193.0,439.0,10.0,14.0,0.0,12.0,10.0,224.0,30.0,Matches,60.0,it ITA,MF,27.0,11.1,0.0,19.0,8.0,42.1,1.71,0.72,0.0,0.0,19.9,0.0,0.0,0.0,1.3,1.3,0.07,-1.3,-1.3,Matches,60.0,it ITA,MF,27.0,15.0,11.0,998.0,11.1,0.0,0.0,0.0,0.0,0.0,0.0,1.0,0.0,1.3,1.3,0.4,1.7,10.0,27.0,30.0,0.0,0.0,0.0,0.0,0.0,0.12,0.04,0.16,0.12,0.16,Matches,Marco Benassi,M/AM C,27,120,135,Italy,ACF Fiorentina,10,12,11,10,12,9,12,14,8,9,12,11,12,13,13,13,14,12,13,11,12,14,11,13,16,11,16,14,12,12,13,11,11,12,12,11,13,9,13,13,13,2,1,1,3,1,1,1,3,2,1,2,13,13,7,14,12,15,15,13,1,1,1,11,1,10,12,7,20,11,1,16,10,1,183,80,11,20,829539,6000,6150,5250,Mediterranean_Hispanic,119,3,1994/9/8,0,0,39231.0,,43078262
1103,Ismaël Bennacer,Milan,1997,61.0,dz ALG,MF,24.0,22.3,59.0,33.0,26.0,31.0,2.0,30.0,51.0,58.8,21.0,25.0,7.0,18.0,26.0,85.0,16.0,1.0,Matches,61.0,dz ALG,MF,24.0,22.3,87.0,3.9,59.0,18.0,1.0,3.0,4.0,2.0,4.0,0.18,1.0,1.0,0.0,1.0,0.0,1.0,Matches,,,,,,,,,,,,,,,,,,,,,,,,,,,,,,,,,,,,,,,,,,,,,,,,,,,,,,,,61.0,dz ALG,MF,24.0,22.3,5.0,0.0,0.0,36.0,25.0,1.0,79.0,26.0,33.0,0.0,0.0,0.0,186.0,22.0,22.0,50.0,Matches,61.0,dz ALG,MF,24.0,22.3,1423.0,1309.0,112.0,54.0,4.0,11.0,79.0,5.0,51.0,19.0,27.0,0.0,1219.0,2.0,16.0,Matches,61.0,dz ALG,MF,24.0,22.3,1219.0,1423.0,85.7,21142.0,5792.0,565.0,616.0,91.7,451.0,505.0,89.3,151.0,228.0,66.2,2.0,3.3,3.1,-1.3,43.0,123.0,28.0,4.0,132.0,Matches,75,dz ALG,MF,24,28,2007.0,72.0,58.7,22.3,24,79.0,13,4,26.0,1,1.82,38.0,21.0,17.0,0.76,0.51,34.8,23.1,11.7,0.52,0.14,Matches,61.0,dz ALG,MF,24.0,22.3,1666.0,30.0,300.0,1023.0,369.0,10.0,1666.0,49.0,27.0,55.1,13.0,26.5,985.0,5133.0,2012.0,30.0,30.0,4.0,42.0,23.0,1097.0,52.0,Matches,61.0,dz ALG,MF,24.0,22.3,2.0,16.0,3.0,18.8,0.72,0.13,0.13,0.67,25.0,3.0,0.0,0.0,1.0,1.0,0.06,1.0,1.0,Matches,61.0,dz ALG,MF,24.0,28.0,24.0,2007.0,22.3,2.0,2.0,4.0,2.0,0.0,0.0,5.0,0.0,1.0,1.0,3.3,4.3,30.0,132.0,52.0,0.09,0.09,0.18,0.09,0.18,0.04,0.15,0.19,0.04,0.19,Matches,Ismaël Bennacer,DM/M C,24,152,163,"Algeria,France,Morocco",AC Milan,13,12,15,9,16,13,7,14,6,13,15,12,15,15,13,14,16,14,14,15,14,15,14,11,13,15,16,14,15,15,16,8,13,13,14,12,15,13,13,12,12,2,4,2,2,1,2,1,1,2,1,2,17,16,6,12,14,15,14,12,1,1,1,1,1,1,20,8,20,10,1,13,1,1,175,70,20,9,50000001,7596,7496,6396,North_African__Middle_Eastern,154,6,1997/12/1,40,2,53462.0,,48032338
1104,Domenico Berardi,Sassuolo,1994,62.0,it ITA,FW,27.0,20.7,23.0,14.0,8.0,10.0,5.0,9.0,40.0,22.5,31.0,13.0,0.0,13.0,19.0,42.0,18.0,0.0,Matches,62.0,it ITA,FW,27.0,20.7,105.0,5.07,78.0,10.0,5.0,5.0,6.0,1.0,17.0,0.82,10.0,1.0,1.0,3.0,2.0,0.0,Matches,,,,,,,,,,,,,,,,,,,,,,,,,,,,,,,,,,,,,,,,,,,,,,,,,,,,,,,,62.0,it ITA,FW,27.0,20.7,7.0,0.0,0.0,33.0,49.0,8.0,83.0,19.0,14.0,2.0,0.0,0.0,84.0,13.0,21.0,38.2,Matches,62.0,it ITA,FW,27.0,20.7,909.0,831.0,76.0,21.0,6.0,39.0,83.0,12.0,43.0,25.0,6.0,0.0,614.0,2.0,30.0,Matches,62.0,it ITA,FW,27.0,20.7,614.0,909.0,67.5,12161.0,3346.0,260.0,343.0,75.8,224.0,317.0,70.7,109.0,173.0,63.0,7.0,6.6,5.9,0.4,45.0,38.0,56.0,10.0,114.0,Matches,77,it ITA,FW,27,26,1866.0,72.0,54.6,20.7,22,80.0,11,4,24.0,1,1.12,30.0,32.0,-2.0,-0.1,0.6,34.3,25.5,8.8,0.42,0.83,Matches,62.0,it ITA,FW,27.0,20.7,1179.0,17.0,102.0,463.0,628.0,111.0,1171.0,50.0,22.0,44.0,20.0,40.0,766.0,3818.0,1586.0,57.0,29.0,31.0,60.0,23.0,905.0,213.0,Matches,62.0,it ITA,FW,27.0,20.7,12.0,75.0,19.0,25.3,3.62,0.92,0.07,0.26,22.0,4.0,7.0,8.0,11.4,5.1,0.07,0.6,-0.1,Matches,62.0,it ITA,FW,27.0,26.0,22.0,1866.0,20.7,12.0,7.0,19.0,5.0,7.0,8.0,7.0,0.0,11.4,5.1,6.6,11.7,57.0,114.0,213.0,0.58,0.34,0.92,0.24,0.58,0.55,0.32,0.87,0.24,0.56,Matches,Domenico Berardi,AM/S R,27,147,153,Italy,U.S. Sassuolo,12,14,13,15,14,15,10,15,5,5,15,17,8,15,16,14,12,15,12,16,14,16,15,16,16,8,15,13,15,14,13,10,14,14,14,11,16,14,12,12,14,3,1,2,3,2,3,1,1,2,1,2,13,13,12,17,14,14,13,11,1,1,1,1,1,1,1,1,1,10,12,12,20,16,183,72,20,9,23530070,7350,7450,6250,Northern_European,148,4,1994/8/1,24,6,106922.0,,43094553
1105,Bartosz Bereszyński,Sampdoria,1992,63.0,pl POL,DF,30.0,13.3,28.0,18.0,15.0,11.0,2.0,17.0,26.0,65.4,9.0,18.0,4.0,14.0,21.0,49.0,25.0,0.0,Matches,63.0,pl POL,DF,30.0,13.3,8.0,0.6,6.0,0.0,0.0,1.0,0.0,1.0,0.0,0.0,0.0,0.0,0.0,0.0,0.0,0.0,Matches,,,,,,,,,,,,,,,,,,,,,,,,,,,,,,,,,,,,,,,,,,,,,,,,,,,,,,,,63.0,pl POL,DF,30.0,13.3,1.0,0.0,0.0,13.0,10.0,0.0,31.0,21.0,18.0,0.0,0.0,0.0,68.0,18.0,11.0,62.1,Matches,63.0,pl POL,DF,30.0,13.3,644.0,480.0,161.0,28.0,0.0,1.0,31.0,133.0,0.0,0.0,0.0,0.0,471.0,3.0,19.0,Matches,63.0,pl POL,DF,30.0,13.3,471.0,644.0,73.1,6989.0,3219.0,286.0,316.0,90.5,143.0,210.0,68.1,28.0,73.0,38.4,0.0,0.1,0.3,-0.1,3.0,32.0,10.0,3.0,44.0,Matches,78,pl POL,DF,30,15,1198.0,80.0,35.0,13.3,15,80.0,10,0,,1,0.6,8.0,20.0,-12.0,-0.9,0.52,9.2,18.8,-9.6,-0.72,0.2,Matches,63.0,pl POL,DF,30.0,13.3,759.0,48.0,255.0,317.0,198.0,13.0,759.0,15.0,4.0,26.7,11.0,73.3,329.0,1643.0,860.0,20.0,16.0,1.0,12.0,5.0,354.0,40.0,Matches,63.0,pl POL,DF,30.0,13.3,0.0,3.0,0.0,0.0,0.23,0.0,0.0,,21.4,0.0,0.0,0.0,0.1,0.1,0.04,-0.1,-0.1,Matches,63.0,pl POL,DF,30.0,15.0,15.0,1198.0,13.3,0.0,0.0,0.0,0.0,0.0,0.0,1.0,0.0,0.1,0.1,0.1,0.2,20.0,44.0,40.0,0.0,0.0,0.0,0.0,0.0,0.01,0.01,0.02,0.01,0.02,Matches,Bartosz Bereszyński,D/WB R,30,131,138,Poland,U.C. Sampdoria,6,13,11,4,11,6,12,4,16,12,13,8,15,12,16,13,16,11,11,11,12,15,10,5,13,12,15,16,13,12,13,10,15,13,16,16,14,10,12,10,13,1,2,2,1,3,3,1,3,1,2,2,15,15,10,5,13,15,12,9,1,12,10,20,12,19,1,1,1,1,1,1,1,1,183,77,10,20,3895171,6550,6600,5000,Northern_European,127,2,1992/7/12,43,0,15962.0,,96011201
1106,Beto,Udinese,1998,66.0,gw GNB,FW,24.0,23.7,16.0,9.0,0.0,9.0,7.0,4.0,17.0,23.5,13.0,18.0,3.0,15.0,6.0,22.0,30.0,0.0,Matches,66.0,gw GNB,FW,24.0,23.7,49.0,2.07,31.0,0.0,8.0,5.0,5.0,0.0,4.0,0.17,3.0,0.0,1.0,0.0,0.0,0.0,Matches,,,,,,,,,,,,,,,,,,,,,,,,,,,,,,,,,,,,,,,,,,,,,,,,,,,,,,,,66.0,gw GNB,FW,24.0,23.7,2.0,0.0,0.0,36.0,26.0,9.0,9.0,6.0,9.0,0.0,0.0,0.0,31.0,70.0,64.0,52.2,Matches,66.0,gw GNB,FW,24.0,23.7,299.0,289.0,9.0,0.0,0.0,0.0,9.0,0.0,0.0,0.0,0.0,0.0,190.0,1.0,11.0,Matches,66.0,gw GNB,FW,24.0,23.7,190.0,299.0,63.5,2421.0,295.0,128.0,179.0,71.5,40.0,67.0,59.7,7.0,13.0,53.8,1.0,2.6,1.9,-1.6,23.0,9.0,4.0,0.0,13.0,Matches,86,gw GNB,FW,24,33,2129.0,65.0,62.3,23.7,23,80.0,11,10,28.0,0,1.27,25.0,31.0,-6.0,-0.25,-0.6,31.2,32.7,-1.5,-0.06,0.18,Matches,66.0,gw GNB,FW,24.0,23.7,652.0,34.0,49.0,274.0,336.0,130.0,651.0,76.0,32.0,42.1,40.0,52.6,364.0,1825.0,594.0,25.0,15.0,14.0,114.0,43.0,475.0,121.0,Matches,66.0,gw GNB,FW,24.0,23.7,10.0,60.0,20.0,33.3,2.54,0.85,0.15,0.45,13.7,0.0,1.0,1.0,10.9,10.1,0.17,-0.9,-1.1,Matches,66.0,gw GNB,FW,24.0,33.0,23.0,2129.0,23.7,10.0,1.0,11.0,9.0,1.0,1.0,2.0,0.0,10.9,10.1,2.6,12.6,25.0,13.0,121.0,0.42,0.04,0.47,0.38,0.42,0.46,0.11,0.57,0.43,0.53,Matches,Beto,S,24,142,151,"Guinea-Bissau,Portugal",Udinese Calcio,5,7,12,15,13,6,15,12,6,6,12,11,6,12,15,14,12,14,13,10,12,16,11,8,15,8,12,16,16,13,14,16,14,16,13,16,15,11,10,3,10,1,3,1,1,2,3,3,2,2,1,3,15,15,14,5,15,13,17,10,1,1,1,1,1,1,1,1,1,1,1,12,1,20,194,78,8,20,10878914,7100,6550,5400,Mediterranean_Hispanic,142,17,1998/1/31,0,0,7307.0,,83228124
1107,Matteo Bianchetti,Cremonese,1993,67.0,it ITA,DF,29.0,23.7,32.0,19.0,21.0,9.0,2.0,20.0,32.0,62.5,12.0,31.0,17.0,14.0,20.0,52.0,111.0,0.0,Matches,67.0,it ITA,DF,29.0,23.7,16.0,0.68,11.0,4.0,0.0,1.0,0.0,0.0,0.0,0.0,0.0,0.0,0.0,0.0,0.0,0.0,Matches,,,,,,,,,,,,,,,,,,,,,,,,,,,,,,,,,,,,,,,,,,,,,,,,,,,,,,,,67.0,it ITA,DF,29.0,23.7,5.0,0.0,0.0,18.0,10.0,0.0,3.0,20.0,19.0,0.0,1.0,0.0,137.0,63.0,40.0,61.2,Matches,67.0,it ITA,DF,29.0,23.7,935.0,870.0,61.0,44.0,0.0,2.0,3.0,1.0,0.0,0.0,0.0,0.0,729.0,4.0,8.0,Matches,67.0,it ITA,DF,29.0,23.7,729.0,935.0,78.0,14388.0,6137.0,242.0,281.0,86.1,400.0,455.0,87.9,79.0,171.0,46.2,0.0,0.5,0.5,-0.5,5.0,49.0,8.0,2.0,47.0,Matches,87,it ITA,DF,29,25,2132.0,85.0,62.3,23.7,22,89.0,20,3,59.0,9,0.6,26.0,47.0,-21.0,-0.89,-0.05,25.9,42.9,-17.0,-0.72,0.0,Matches,67.0,it ITA,DF,29.0,23.7,1169.0,188.0,692.0,447.0,37.0,13.0,1169.0,3.0,2.0,66.7,1.0,33.3,552.0,2612.0,1377.0,6.0,2.0,0.0,6.0,3.0,586.0,4.0,Matches,67.0,it ITA,DF,29.0,23.7,1.0,7.0,4.0,57.1,0.3,0.17,0.14,0.25,10.9,0.0,0.0,0.0,0.8,0.8,0.11,0.2,0.2,Matches,67.0,it ITA,DF,29.0,25.0,22.0,2132.0,23.7,1.0,0.0,1.0,1.0,0.0,0.0,5.0,0.0,0.8,0.8,0.5,1.2,6.0,47.0,4.0,0.04,0.0,0.04,0.04,0.04,0.03,0.02,0.05,0.03,0.05,Matches,Matteo Bianchetti,D RC,29,122,129,Italy,Cremonese,4,9,8,6,9,7,14,7,12,13,11,5,14,8,14,15,14,14,15,8,13,15,3,16,7,15,12,12,11,11,11,12,12,11,13,13,15,13,15,15,12,2,1,1,2,1,3,3,1,2,2,2,12,13,5,14,12,15,12,12,1,1,20,16,1,14,1,1,1,1,1,1,1,1,189,81,7,20,1889923,6100,6100,4900,Mediterranean_Hispanic,122,3,1993/3/17,0,0,11730.0,,43055102
1108,Jaka Bijol,Udinese,1999,69.0,si SVN,DF,23.0,30.3,39.0,23.0,32.0,7.0,0.0,16.0,27.0,59.3,11.0,41.0,25.0,16.0,29.0,68.0,165.0,0.0,Matches,69.0,si SVN,DF,23.0,30.3,21.0,0.69,17.0,0.0,0.0,4.0,0.0,0.0,3.0,0.1,3.0,0.0,0.0,0.0,0.0,0.0,Matches,,,,,,,,,,,,,,,,,,,,,,,,,,,,,,,,,,,,,,,,,,,,,,,,,,,,,,,,69.0,si SVN,DF,23.0,30.3,10.0,0.0,0.0,29.0,7.0,0.0,1.0,29.0,23.0,0.0,1.0,0.0,144.0,87.0,47.0,64.9,Matches,69.0,si SVN,DF,23.0,30.3,1381.0,1341.0,35.0,28.0,4.0,13.0,1.0,1.0,0.0,0.0,0.0,0.0,1170.0,5.0,5.0,Matches,69.0,si SVN,DF,23.0,30.3,1170.0,1381.0,84.7,24657.0,10028.0,322.0,367.0,87.7,681.0,730.0,93.3,155.0,253.0,61.3,2.0,1.6,1.7,0.4,9.0,54.0,5.0,1.0,66.0,Matches,89,si SVN,DF,23,32,2728.0,85.0,79.8,30.3,32,85.0,28,0,,3,1.19,34.0,38.0,-4.0,-0.13,-0.52,35.7,41.9,-6.2,-0.2,-0.37,Matches,69.0,si SVN,DF,23.0,30.3,1729.0,296.0,1068.0,612.0,53.0,40.0,1729.0,5.0,2.0,40.0,3.0,60.0,972.0,4732.0,2415.0,3.0,7.0,2.0,10.0,4.0,1032.0,7.0,Matches,69.0,si SVN,DF,23.0,30.3,3.0,20.0,7.0,35.0,0.66,0.23,0.15,0.43,9.5,0.0,0.0,0.0,2.2,2.2,0.11,0.8,0.8,Matches,69.0,si SVN,DF,23.0,32.0,32.0,2728.0,30.3,3.0,2.0,5.0,3.0,0.0,0.0,10.0,0.0,2.2,2.2,1.6,3.9,3.0,66.0,7.0,0.1,0.07,0.16,0.1,0.16,0.07,0.05,0.13,0.07,0.13,Matches,Jaka Bijol,D/DM C,23,130,151,Slovenia,Udinese Calcio,4,7,8,9,11,6,18,10,7,13,11,7,12,10,13,13,15,13,15,9,12,15,7,7,9,13,16,14,11,11,14,16,17,12,13,16,14,10,11,4,13,3,2,1,2,3,1,2,3,2,1,2,12,15,5,14,14,15,11,12,1,1,20,1,1,1,16,1,14,1,1,7,1,10,190,85,8,20,5110198,6500,6450,4500,Northern_European,127,4,1999/2/5,31,1,24439.0,,62215974
1109,Cristiano Biraghi,Fiorentina,1992,70.0,it ITA,DF,29.0,28.3,65.0,38.0,29.0,29.0,7.0,32.0,65.0,49.2,33.0,32.0,7.0,25.0,14.0,79.0,42.0,1.0,Matches,70.0,it ITA,DF,29.0,28.3,132.0,4.66,59.0,68.0,1.0,3.0,0.0,1.0,6.0,0.21,3.0,3.0,0.0,0.0,0.0,0.0,Matches,,,,,,,,,,,,,,,,,,,,,,,,,,,,,,,,,,,,,,,,,,,,,,,,,,,,,,,,70.0,it ITA,DF,29.0,28.3,1.0,0.0,0.0,29.0,38.0,1.0,300.0,14.0,38.0,0.0,0.0,1.0,137.0,19.0,25.0,43.2,Matches,70.0,it ITA,DF,29.0,28.3,1994.0,1440.0,548.0,94.0,0.0,27.0,300.0,292.0,162.0,71.0,63.0,0.0,1433.0,6.0,37.0,Matches,70.0,it ITA,DF,29.0,28.3,1433.0,1994.0,71.9,27338.0,10270.0,603.0,677.0,89.1,614.0,783.0,78.4,196.0,456.0,43.0,4.0,5.5,5.8,-1.5,82.0,114.0,35.0,23.0,161.0,Matches,90,it ITA,DF,29,33,2551.0,77.0,74.6,28.3,30,84.0,21,3,14.0,5,1.55,37.0,35.0,2.0,0.07,-0.76,39.2,34.4,4.8,0.17,-0.55,Matches,70.0,it ITA,DF,29.0,28.3,2213.0,72.0,534.0,904.0,793.0,26.0,2212.0,20.0,7.0,35.0,9.0,45.0,1011.0,4803.0,2798.0,69.0,51.0,10.0,16.0,6.0,1214.0,113.0,Matches,70.0,it ITA,DF,29.0,28.3,2.0,24.0,5.0,20.8,0.85,0.18,0.08,0.4,27.4,15.0,0.0,1.0,1.8,1.1,0.04,0.2,0.9,Matches,70.0,it ITA,DF,29.0,33.0,30.0,2551.0,28.3,2.0,4.0,6.0,2.0,0.0,1.0,1.0,0.0,1.8,1.1,5.5,6.6,69.0,161.0,113.0,0.07,0.14,0.21,0.07,0.21,0.07,0.19,0.26,0.04,0.23,Matches,Cristiano Biraghi,D/WB/M L,29,144,150,Italy,ACF Fiorentina,15,17,11,9,12,16,11,12,13,12,14,14,13,12,13,12,14,11,13,13,14,13,10,14,13,14,15,13,14,12,14,12,14,15,16,13,13,10,14,8,13,2,1,1,2,3,2,1,2,2,1,4,10,14,2,14,12,17,13,14,1,20,11,7,20,7,1,16,1,7,1,1,1,1,185,78,20,7,14298135,7200,7100,5550,Mediterranean_Hispanic,142,2,1992/9/1,13,1,42692.0,,43029905
1110,Samuele Birindelli,Monza,1999,71.0,it ITA,DF,23.0,15.6,35.0,19.0,21.0,10.0,4.0,18.0,29.0,62.1,11.0,28.0,8.0,20.0,16.0,51.0,30.0,0.0,Matches,71.0,it ITA,DF,23.0,15.6,35.0,2.25,30.0,0.0,2.0,2.0,1.0,0.0,4.0,0.26,4.0,0.0,0.0,0.0,0.0,0.0,Matches,,,,,,,,,,,,,,,,,,,,,,,,,,,,,,,,,,,,,,,,,,,,,,,,,,,,,,,,71.0,it ITA,DF,23.0,15.6,8.0,0.0,0.0,15.0,14.0,2.0,70.0,16.0,19.0,0.0,0.0,0.0,69.0,6.0,9.0,40.0,Matches,71.0,it ITA,DF,23.0,15.6,777.0,659.0,118.0,4.0,0.0,5.0,70.0,114.0,0.0,0.0,0.0,0.0,572.0,0.0,15.0,Matches,71.0,it ITA,DF,23.0,15.6,572.0,777.0,73.6,9832.0,2913.0,265.0,309.0,85.8,249.0,326.0,76.4,47.0,107.0,43.9,1.0,2.2,1.9,-1.2,18.0,27.0,19.0,13.0,43.0,Matches,91,it ITA,DF,23,31,1400.0,45.0,40.9,15.6,14,68.0,4,17,26.0,6,1.45,17.0,25.0,-8.0,-0.51,-0.69,18.9,25.1,-6.1,-0.4,-0.43,Matches,71.0,it ITA,DF,23.0,15.6,957.0,51.0,277.0,372.0,321.0,30.0,957.0,20.0,11.0,55.0,8.0,40.0,509.0,3234.0,1645.0,55.0,35.0,7.0,24.0,15.0,606.0,121.0,Matches,71.0,it ITA,DF,23.0,15.6,0.0,14.0,4.0,28.6,0.9,0.26,0.0,0.0,17.6,0.0,0.0,0.0,1.1,1.1,0.08,-1.1,-1.1,Matches,71.0,it ITA,DF,23.0,31.0,14.0,1400.0,15.6,0.0,1.0,1.0,0.0,0.0,0.0,8.0,0.0,1.1,1.1,2.2,3.3,55.0,43.0,121.0,0.0,0.06,0.06,0.0,0.06,0.07,0.14,0.21,0.07,0.21,Matches,Samuele Birindelli,D/WB R,23,127,144,Italy,Brianza,11,15,13,8,13,7,9,11,13,10,12,7,12,13,10,13,11,11,12,10,12,13,11,9,13,11,12,13,15,14,11,8,12,14,12,11,12,9,12,8,14,1,1,3,1,3,1,4,1,3,1,3,11,12,7,15,12,12,14,13,1,13,8,20,13,18,1,12,1,14,1,1,1,1,176,68,10,20,2936301,6350,6350,4250,Mediterranean_Hispanic,119,2,1999/7/19,0,0,19751.0,,43274094
1111,Alexis Blin,Lecce,1996,73.0,fr FRA,MF,25.0,26.4,69.0,39.0,27.0,33.0,9.0,38.0,73.0,52.1,35.0,55.0,15.0,40.0,34.0,103.0,74.0,0.0,Matches,73.0,fr FRA,MF,25.0,26.4,42.0,1.59,34.0,2.0,0.0,4.0,2.0,0.0,1.0,0.04,1.0,0.0,0.0,0.0,0.0,0.0,Matches,,,,,,,,,,,,,,,,,,,,,,,,,,,,,,,,,,,,,,,,,,,,,,,,,,,,,,,,73.0,fr FRA,MF,25.0,26.4,8.0,0.0,0.0,47.0,31.0,1.0,28.0,34.0,39.0,1.0,0.0,0.0,133.0,55.0,69.0,44.4,Matches,73.0,fr FRA,MF,25.0,26.4,963.0,903.0,59.0,15.0,1.0,11.0,28.0,20.0,2.0,1.0,0.0,0.0,766.0,1.0,16.0,Matches,73.0,fr FRA,MF,25.0,26.4,766.0,963.0,79.5,12309.0,3766.0,379.0,446.0,85.0,290.0,353.0,82.2,59.0,96.0,61.5,0.0,1.1,0.8,-1.1,15.0,88.0,13.0,3.0,101.0,Matches,94,fr FRA,MF,25,35,2376.0,68.0,69.5,26.4,26,80.0,13,9,32.0,2,1.0,22.0,29.0,-7.0,-0.27,0.25,24.6,28.8,-4.2,-0.16,0.0,Matches,73.0,fr FRA,MF,25.0,26.4,1299.0,86.0,352.0,697.0,257.0,33.0,1299.0,11.0,5.0,45.5,6.0,54.5,536.0,2330.0,1095.0,13.0,17.0,1.0,34.0,15.0,665.0,32.0,Matches,73.0,fr FRA,MF,25.0,26.4,1.0,22.0,4.0,18.2,0.83,0.15,0.05,0.25,12.9,0.0,0.0,0.0,2.8,2.8,0.13,-1.8,-1.8,Matches,73.0,fr FRA,MF,25.0,35.0,26.0,2376.0,26.4,1.0,0.0,1.0,1.0,0.0,0.0,8.0,0.0,2.8,2.8,1.1,3.9,13.0,101.0,32.0,0.04,0.0,0.04,0.04,0.04,0.11,0.04,0.15,0.11,0.15,Matches,Alexis Blin,DM/M C,25,125,131,France,Salento,5,6,10,5,13,6,11,8,5,12,14,8,14,13,13,12,15,12,14,13,13,14,7,12,12,15,15,14,12,13,14,11,15,12,16,14,12,12,10,7,10,3,1,3,3,2,3,1,2,2,3,1,18,14,6,13,12,14,13,12,1,1,8,12,1,8,20,1,20,1,1,8,1,1,184,78,8,20,2547060,6243,6193,3793,Northern_European,126,6,1996/9/16,0,0,5384.0,,85144161
1112,Giacomo Bonaventura,Fiorentina,1989,76.0,it ITA,MF,32.0,21.2,35.0,23.0,14.0,15.0,6.0,24.0,37.0,64.9,13.0,14.0,0.0,14.0,16.0,51.0,5.0,1.0,Matches,76.0,it ITA,MF,32.0,21.2,78.0,3.68,51.0,6.0,5.0,7.0,8.0,1.0,8.0,0.38,6.0,0.0,1.0,0.0,1.0,0.0,Matches,,,,,,,,,,,,,,,,,,,,,,,,,,,,,,,,,,,,,,,,,,,,,,,,,,,,,,,,76.0,it ITA,MF,32.0,21.2,4.0,1.0,0.0,24.0,40.0,2.0,48.0,16.0,23.0,1.0,0.0,0.0,140.0,14.0,22.0,38.9,Matches,76.0,it ITA,MF,32.0,21.2,916.0,864.0,51.0,27.0,4.0,6.0,48.0,5.0,8.0,0.0,5.0,0.0,754.0,1.0,24.0,Matches,76.0,it ITA,MF,32.0,21.2,754.0,916.0,82.3,11960.0,2716.0,391.0,437.0,89.5,265.0,308.0,86.0,60.0,97.0,61.9,1.0,3.1,2.5,-2.1,34.0,57.0,30.0,4.0,102.0,Matches,98,it ITA,MF,32,30,1911.0,64.0,55.9,21.2,21,80.0,9,9,25.0,3,1.5,28.0,25.0,3.0,0.14,-0.28,27.9,26.2,1.7,0.08,-0.51,Matches,76.0,it ITA,MF,32.0,21.2,1134.0,14.0,132.0,573.0,456.0,69.0,1134.0,54.0,23.0,42.6,19.0,35.2,707.0,4208.0,2260.0,64.0,60.0,10.0,23.0,29.0,804.0,91.0,Matches,76.0,it ITA,MF,32.0,21.2,5.0,49.0,14.0,28.6,2.31,0.66,0.1,0.36,19.6,2.0,0.0,0.0,4.3,4.3,0.09,0.7,0.7,Matches,76.0,it ITA,MF,32.0,30.0,21.0,1911.0,21.2,5.0,1.0,6.0,5.0,0.0,0.0,4.0,1.0,4.3,4.3,3.1,7.4,64.0,102.0,91.0,0.24,0.05,0.28,0.24,0.28,0.2,0.15,0.35,0.2,0.35,Matches,Giacomo Bonaventura,M/AM LC,32,141,153,Italy,ACF Fiorentina,14,13,13,12,14,13,11,15,12,9,15,11,10,15,12,15,12,14,15,14,15,16,12,15,15,12,16,13,11,13,13,10,17,12,14,10,15,6,14,10,17,1,2,2,1,1,2,2,1,1,3,1,12,16,8,14,16,19,14,14,1,1,1,1,9,7,1,15,20,12,17,16,11,10,180,75,11,20,3987604,7049,6283,5525,Mediterranean_Hispanic,141,2,1989/8/22,14,0,53462.0,,43006720
1113,Federico Bonazzoli,Salernitana,1997,77.0,it ITA,FWMF,25.0,12.4,5.0,3.0,0.0,3.0,2.0,0.0,9.0,0.0,9.0,9.0,1.0,8.0,3.0,8.0,0.0,0.0,Matches,77.0,it ITA,FWMF,25.0,12.4,26.0,2.09,20.0,0.0,1.0,3.0,2.0,0.0,3.0,0.24,3.0,0.0,0.0,0.0,0.0,0.0,Matches,,,,,,,,,,,,,,,,,,,,,,,,,,,,,,,,,,,,,,,,,,,,,,,,,,,,,,,,77.0,it ITA,FWMF,25.0,12.4,1.0,0.0,0.0,18.0,32.0,7.0,4.0,3.0,3.0,0.0,0.0,0.0,37.0,6.0,15.0,28.6,Matches,77.0,it ITA,FWMF,25.0,12.4,354.0,325.0,28.0,3.0,3.0,13.0,4.0,0.0,0.0,0.0,0.0,0.0,264.0,1.0,14.0,Matches,77.0,it ITA,FWMF,25.0,12.4,264.0,354.0,74.6,4654.0,966.0,135.0,162.0,83.3,84.0,104.0,80.8,37.0,53.0,69.8,1.0,1.1,0.7,-0.1,8.0,30.0,6.0,0.0,43.0,Matches,99,it ITA,FWMF,25,24,1119.0,47.0,32.7,12.4,12,71.0,3,12,23.0,14,0.88,9.0,14.0,-5.0,-0.4,-0.05,10.6,22.4,-11.7,-0.94,-0.21,Matches,77.0,it ITA,FWMF,25.0,12.4,487.0,0.0,33.0,269.0,191.0,31.0,487.0,23.0,12.0,52.2,9.0,39.1,304.0,1138.0,435.0,11.0,10.0,3.0,42.0,12.0,378.0,67.0,Matches,77.0,it ITA,FWMF,25.0,12.4,2.0,32.0,7.0,21.9,2.57,0.56,0.06,0.29,18.9,1.0,0.0,0.0,2.4,2.4,0.07,-0.4,-0.4,Matches,77.0,it ITA,FWMF,25.0,24.0,12.0,1119.0,12.4,2.0,1.0,3.0,2.0,0.0,0.0,1.0,0.0,2.4,2.4,1.1,3.5,11.0,43.0,67.0,0.16,0.08,0.24,0.16,0.24,0.19,0.09,0.28,0.19,0.28,Matches,Federico Bonazzoli,S,25,128,138,Italy,U.S. Salernitana 1919,8,11,12,14,14,11,14,11,6,6,12,13,8,13,13,13,16,13,11,11,12,15,15,10,15,5,12,15,13,13,14,13,15,14,13,12,10,7,13,8,11,3,3,4,4,4,3,2,1,2,2,2,10,14,4,10,8,16,13,13,1,1,1,1,1,1,1,1,1,1,11,13,14,20,182,74,20,9,9933192,6400,6400,4800,Mediterranean_Hispanic,129,4,1997/5/21,0,0,17787.0,,43143486
1114,Kevin Bonifazi,Bologna,1996,79.0,it ITA,DF,26.0,10.0,13.0,8.0,7.0,6.0,0.0,6.0,12.0,50.0,6.0,11.0,8.0,3.0,12.0,25.0,39.0,0.0,Matches,79.0,it ITA,DF,26.0,10.0,9.0,0.9,9.0,0.0,0.0,0.0,0.0,0.0,0.0,0.0,0.0,0.0,0.0,0.0,0.0,0.0,Matches,,,,,,,,,,,,,,,,,,,,,,,,,,,,,,,,,,,,,,,,,,,,,,,,,,,,,,,,79.0,it ITA,DF,26.0,10.0,2.0,0.0,0.0,6.0,1.0,1.0,2.0,12.0,8.0,0.0,0.0,0.0,61.0,8.0,17.0,32.0,Matches,79.0,it ITA,DF,26.0,10.0,722.0,702.0,19.0,17.0,2.0,5.0,2.0,1.0,0.0,0.0,0.0,0.0,643.0,1.0,1.0,Matches,79.0,it ITA,DF,26.0,10.0,643.0,722.0,89.1,12821.0,4841.0,216.0,229.0,94.3,343.0,369.0,93.0,81.0,116.0,69.8,0.0,0.0,0.1,0.0,2.0,36.0,0.0,0.0,33.0,Matches,101,it ITA,DF,26,13,902.0,69.0,26.4,10.0,9,86.0,7,4,32.0,12,1.23,16.0,17.0,-1.0,-0.1,-0.28,12.0,13.5,-1.5,-0.15,-0.03,Matches,79.0,it ITA,DF,26.0,10.0,828.0,127.0,448.0,364.0,22.0,4.0,828.0,7.0,5.0,71.4,2.0,28.6,549.0,3188.0,1823.0,4.0,3.0,0.0,9.0,5.0,613.0,0.0,Matches,79.0,it ITA,DF,26.0,10.0,0.0,2.0,0.0,0.0,0.2,0.0,0.0,,11.3,0.0,0.0,0.0,0.2,0.2,0.1,-0.2,-0.2,Matches,79.0,it ITA,DF,26.0,13.0,9.0,902.0,10.0,0.0,0.0,0.0,0.0,0.0,0.0,2.0,0.0,0.2,0.2,0.0,0.2,4.0,33.0,0.0,0.0,0.0,0.0,0.0,0.0,0.02,0.0,0.02,0.02,0.02,Matches,Kevin Bonifazi,D C,26,127,133,Italy,Bologna FC 1909,4,6,11,8,9,7,14,8,13,14,12,4,15,11,13,12,14,12,11,11,12,15,12,11,8,13,11,11,12,12,15,15,13,12,14,16,12,13,11,9,6,2,4,3,2,1,2,2,2,2,1,1,13,13,10,14,12,7,13,11,1,1,20,12,1,1,1,1,1,1,1,1,1,1,187,84,9,20,2523962,6350,6450,5050,Mediterranean_Hispanic,126,1,1996/5/19,0,0,35577.0,,43094128
1115,Mehdi Bourabia,Spezia,1991,82.0,ma MAR,MF,30.0,30.8,41.0,20.0,13.0,22.0,6.0,19.0,41.0,46.3,22.0,39.0,12.0,27.0,32.0,73.0,57.0,0.0,Matches,82.0,ma MAR,MF,30.0,30.8,80.0,2.6,59.0,7.0,6.0,4.0,1.0,3.0,7.0,0.23,6.0,0.0,0.0,1.0,0.0,0.0,Matches,,,,,,,,,,,,,,,,,,,,,,,,,,,,,,,,,,,,,,,,,,,,,,,,,,,,,,,,82.0,ma MAR,MF,30.0,30.8,3.0,0.0,0.0,33.0,18.0,1.0,64.0,32.0,20.0,0.0,0.0,0.0,192.0,21.0,32.0,39.6,Matches,82.0,ma MAR,MF,30.0,30.8,1282.0,1208.0,66.0,29.0,5.0,4.0,64.0,7.0,30.0,21.0,4.0,0.0,981.0,8.0,38.0,Matches,82.0,ma MAR,MF,30.0,30.8,981.0,1282.0,76.5,15009.0,4832.0,509.0,595.0,85.5,365.0,446.0,81.8,64.0,133.0,48.1,3.0,4.4,3.4,-1.4,37.0,94.0,32.0,10.0,113.0,Matches,106,ma MAR,MF,30,37,2771.0,75.0,81.0,30.8,36,76.0,12,1,31.0,1,0.82,28.0,50.0,-22.0,-0.71,0.53,33.6,49.2,-15.5,-0.5,-0.17,Matches,82.0,ma MAR,MF,30.0,30.8,1639.0,98.0,422.0,832.0,409.0,21.0,1639.0,64.0,28.0,43.8,32.0,50.0,810.0,3731.0,1777.0,37.0,30.0,5.0,54.0,27.0,956.0,58.0,Matches,82.0,ma MAR,MF,30.0,30.8,1.0,33.0,5.0,15.2,1.07,0.16,0.03,0.2,24.3,1.0,0.0,0.0,2.1,2.1,0.06,-1.1,-1.1,Matches,82.0,ma MAR,MF,30.0,37.0,36.0,2771.0,30.8,1.0,3.0,4.0,1.0,0.0,0.0,3.0,0.0,2.1,2.1,4.4,6.5,37.0,113.0,58.0,0.03,0.1,0.13,0.03,0.13,0.07,0.14,0.21,0.07,0.21,Matches,Mehdi Bourabia,DM/M C,30,126,131,"Morocco,France",Spezia Calcio,11,11,12,9,13,14,8,12,6,10,13,11,14,14,16,12,14,13,13,12,12,14,14,11,14,11,13,13,12,12,13,10,14,13,14,13,13,15,12,10,11,4,2,1,3,1,4,1,3,2,3,4,12,14,14,10,10,15,12,9,1,1,1,1,1,1,20,10,20,8,8,14,5,1,183,76,11,20,2263620,6299,6449,4499,North_African__Middle_Eastern,124,7,1991/8/7,8,0,21346.0,,85046580
1116,Edoardo Bove,Roma,2002,83.0,it ITA,MF,20.0,11.0,35.0,18.0,12.0,15.0,8.0,16.0,39.0,41.0,23.0,15.0,1.0,14.0,10.0,45.0,11.0,0.0,Matches,83.0,it ITA,MF,20.0,11.0,17.0,1.54,15.0,0.0,0.0,0.0,1.0,1.0,0.0,0.0,0.0,0.0,0.0,0.0,0.0,0.0,Matches,,,,,,,,,,,,,,,,,,,,,,,,,,,,,,,,,,,,,,,,,,,,,,,,,,,,,,,,83.0,it ITA,MF,20.0,11.0,2.0,0.0,0.0,24.0,23.0,1.0,9.0,10.0,18.0,0.0,0.0,0.0,80.0,14.0,12.0,53.8,Matches,83.0,it ITA,MF,20.0,11.0,406.0,373.0,33.0,8.0,2.0,2.0,9.0,16.0,4.0,1.0,1.0,0.0,309.0,0.0,12.0,Matches,83.0,it ITA,MF,20.0,11.0,309.0,406.0,76.1,4427.0,1026.0,168.0,201.0,83.6,110.0,139.0,79.1,13.0,30.0,43.3,0.0,0.9,0.7,-0.9,7.0,20.0,6.0,0.0,33.0,Matches,107,it ITA,MF,20,22,992.0,45.0,29.0,11.0,10,75.0,4,12,20.0,16,1.77,12.0,13.0,-1.0,-0.09,-0.57,13.0,12.7,0.3,0.03,-0.9,Matches,83.0,it ITA,MF,20.0,11.0,532.0,12.0,107.0,301.0,131.0,20.0,532.0,13.0,5.0,38.5,4.0,30.8,263.0,1015.0,404.0,9.0,9.0,2.0,25.0,17.0,289.0,26.0,Matches,83.0,it ITA,MF,20.0,11.0,1.0,7.0,2.0,28.6,0.64,0.18,0.14,0.5,12.9,0.0,0.0,0.0,0.8,0.5,0.07,0.2,0.5,Matches,83.0,it ITA,MF,20.0,22.0,10.0,992.0,11.0,1.0,0.0,1.0,1.0,0.0,0.0,2.0,0.0,0.8,0.5,0.9,1.4,9.0,33.0,26.0,0.09,0.0,0.09,0.09,0.09,0.07,0.08,0.15,0.05,0.13,Matches,Edoardo Bove,DM/M C,20,119,-8,Italy,Associazione Sportiva Roma,8,10,12,8,14,7,8,9,5,10,14,9,12,14,14,12,12,13,12,12,12,16,12,7,11,11,15,15,13,13,13,8,15,12,14,11,13,10,12,4,15,2,3,3,2,2,1,3,1,3,1,2,9,13,4,14,15,17,13,14,1,1,1,1,1,1,20,1,20,1,1,1,1,1,176,68,10,20,29549999,5949,5749,3607,Mediterranean_Hispanic,117,2,2002/5/16,0,0,7115.0,,43424702
1117,Domagoj Bradarić,Salernitana,1999,85.0,hr CRO,DF,22.0,25.0,26.0,19.0,14.0,8.0,4.0,7.0,16.0,43.8,9.0,20.0,5.0,15.0,21.0,47.0,44.0,0.0,Matches,85.0,hr CRO,DF,22.0,25.0,42.0,1.68,34.0,2.0,1.0,3.0,1.0,1.0,5.0,0.2,5.0,0.0,0.0,0.0,0.0,0.0,Matches,,,,,,,,,,,,,,,,,,,,,,,,,,,,,,,,,,,,,,,,,,,,,,,,,,,,,,,,85.0,hr CRO,DF,22.0,25.0,5.0,0.0,0.0,17.0,20.0,4.0,68.0,21.0,19.0,0.0,0.0,0.0,154.0,14.0,25.0,35.9,Matches,85.0,hr CRO,DF,22.0,25.0,1155.0,898.0,254.0,37.0,0.0,6.0,68.0,212.0,5.0,1.0,1.0,0.0,857.0,3.0,28.0,Matches,85.0,hr CRO,DF,22.0,25.0,857.0,1155.0,74.2,13414.0,4480.0,462.0,535.0,86.4,315.0,414.0,76.1,55.0,144.0,38.2,3.0,2.3,1.5,0.7,17.0,40.0,17.0,9.0,52.0,Matches,110,hr CRO,DF,22,31,2250.0,73.0,65.8,25.0,24,85.0,19,7,29.0,5,1.13,31.0,44.0,-13.0,-0.52,-0.44,22.8,44.3,-21.5,-0.86,-0.17,Matches,85.0,hr CRO,DF,22.0,25.0,1352.0,50.0,398.0,609.0,368.0,22.0,1352.0,50.0,17.0,34.0,28.0,56.0,706.0,4295.0,2396.0,63.0,46.0,8.0,27.0,10.0,744.0,107.0,Matches,85.0,hr CRO,DF,22.0,25.0,0.0,7.0,0.0,0.0,0.28,0.0,0.0,,23.8,1.0,0.0,0.0,0.2,0.2,0.03,-0.2,-0.2,Matches,85.0,hr CRO,DF,22.0,31.0,24.0,2250.0,25.0,0.0,3.0,3.0,0.0,0.0,0.0,5.0,0.0,0.2,0.2,2.3,2.5,63.0,52.0,107.0,0.0,0.12,0.12,0.0,0.12,0.01,0.09,0.1,0.01,0.1,Matches,Domagoj Bradarić,D/WB L,22,121,139,Croatia,U.S. Salernitana 1919,13,15,14,8,13,9,7,10,14,11,14,8,12,13,9,11,11,10,12,10,11,14,14,13,13,10,13,14,13,14,9,9,12,14,14,8,11,12,10,11,12,3,4,2,4,3,1,3,1,1,1,3,9,12,11,12,10,9,8,12,1,20,1,11,20,1,1,13,1,1,10,1,10,1,178,69,20,11,4457466,6046,6296,3496,Northern_European,116,4,1999/12/10,4,0,9198.0,,24054803
1118,Dylan Bronn,Salernitana,1995,88.0,tn TUN,DF,27.0,18.7,34.0,18.0,17.0,16.0,1.0,20.0,30.0,66.7,10.0,32.0,20.0,12.0,20.0,54.0,58.0,1.0,Matches,88.0,tn TUN,DF,27.0,18.7,14.0,0.75,12.0,0.0,0.0,2.0,0.0,0.0,2.0,0.11,2.0,0.0,0.0,0.0,0.0,0.0,Matches,,,,,,,,,,,,,,,,,,,,,,,,,,,,,,,,,,,,,,,,,,,,,,,,,,,,,,,,88.0,tn TUN,DF,27.0,18.7,5.0,1.0,0.0,29.0,10.0,0.0,7.0,20.0,18.0,0.0,1.0,0.0,109.0,34.0,23.0,59.6,Matches,88.0,tn TUN,DF,27.0,18.7,1007.0,942.0,59.0,37.0,1.0,13.0,7.0,22.0,0.0,0.0,0.0,0.0,855.0,6.0,9.0,Matches,88.0,tn TUN,DF,27.0,18.7,855.0,1007.0,84.9,15486.0,6081.0,355.0,387.0,91.7,407.0,443.0,91.9,82.0,137.0,59.9,0.0,0.4,0.8,-0.4,5.0,62.0,4.0,1.0,70.0,Matches,116,tn TUN,DF,27,24,1683.0,70.0,49.2,18.7,19,82.0,14,5,25.0,8,1.17,24.0,30.0,-6.0,-0.32,0.09,19.2,34.7,-15.5,-0.83,-0.05,Matches,88.0,tn TUN,DF,27.0,18.7,1196.0,106.0,562.0,590.0,48.0,10.0,1196.0,11.0,6.0,54.5,3.0,27.3,638.0,2651.0,1487.0,10.0,6.0,0.0,7.0,2.0,759.0,5.0,Matches,88.0,tn TUN,DF,27.0,18.7,0.0,8.0,1.0,12.5,0.43,0.05,0.0,0.0,15.8,0.0,0.0,0.0,0.7,0.7,0.08,-0.7,-0.7,Matches,88.0,tn TUN,DF,27.0,24.0,19.0,1683.0,18.7,0.0,0.0,0.0,0.0,0.0,0.0,5.0,1.0,0.7,0.7,0.4,1.0,10.0,70.0,5.0,0.0,0.0,0.0,0.0,0.0,0.03,0.02,0.05,0.03,0.05,Matches,Dylan Bronn,D RC,27,126,132,"Tunisia,France",U.S. Salernitana 1919,6,8,7,9,10,8,14,6,5,14,11,14,14,11,14,13,14,13,13,9,12,14,5,12,8,13,13,14,12,11,14,13,11,13,14,14,12,6,8,11,13,2,3,3,3,1,1,3,2,2,4,2,13,14,2,12,12,12,3,17,1,1,20,15,1,1,12,1,1,1,1,1,1,1,186,76,10,20,2621506,6300,6200,3850,Mediterranean_Hispanic,126,6,1995/6/19,35,2,18468.0,,48043981
1119,Marcelo Brozović,Inter,1992,89.0,hr CRO,MF,29.0,19.7,37.0,22.0,13.0,22.0,2.0,11.0,37.0,29.7,26.0,23.0,7.0,16.0,22.0,59.0,28.0,0.0,Matches,89.0,hr CRO,MF,29.0,19.7,58.0,2.95,42.0,8.0,1.0,7.0,0.0,0.0,8.0,0.41,8.0,0.0,0.0,0.0,0.0,0.0,Matches,,,,,,,,,,,,,,,,,,,,,,,,,,,,,,,,,,,,,,,,,,,,,,,,,,,,,,,,89.0,hr CRO,MF,29.0,19.7,8.0,0.0,0.0,24.0,13.0,0.0,45.0,22.0,22.0,0.0,0.0,0.0,141.0,6.0,12.0,33.3,Matches,89.0,hr CRO,MF,29.0,19.7,1502.0,1405.0,94.0,60.0,3.0,13.0,45.0,8.0,26.0,11.0,10.0,0.0,1318.0,3.0,13.0,Matches,89.0,hr CRO,MF,29.0,19.7,1318.0,1502.0,87.7,23163.0,6319.0,585.0,621.0,94.2,591.0,648.0,91.2,114.0,176.0,64.8,5.0,2.8,1.8,2.2,23.0,102.0,18.0,5.0,114.0,Matches,117,hr CRO,MF,29,28,1770.0,63.0,51.8,19.7,19,83.0,11,9,22.0,0,1.79,35.0,27.0,8.0,0.41,-0.74,35.2,20.9,14.3,0.73,-0.22,Matches,89.0,hr CRO,MF,29.0,19.7,1696.0,81.0,439.0,987.0,291.0,22.0,1696.0,27.0,16.0,59.3,9.0,33.3,1085.0,5728.0,2296.0,29.0,29.0,7.0,19.0,6.0,1218.0,35.0,Matches,89.0,hr CRO,MF,29.0,19.7,3.0,25.0,7.0,28.0,1.27,0.36,0.12,0.43,21.1,1.0,0.0,0.0,2.5,2.5,0.1,0.5,0.5,Matches,89.0,hr CRO,MF,29.0,28.0,19.0,1770.0,19.7,3.0,5.0,8.0,3.0,0.0,0.0,8.0,0.0,2.5,2.5,2.8,5.3,29.0,114.0,35.0,0.15,0.25,0.41,0.15,0.41,0.13,0.14,0.27,0.13,0.27,Matches,Marcelo Brozović,DM/M C,29,160,162,Croatia,FC Internazionale Milano,14,12,10,10,16,13,11,13,4,12,17,12,17,16,13,15,14,14,17,15,12,16,12,14,13,14,18,16,12,12,16,10,20,12,20,12,18,9,15,7,12,1,2,2,2,2,2,3,1,2,2,2,15,15,18,17,17,11,12,16,1,1,1,1,1,1,18,5,20,10,3,14,8,1,181,68,11,20,143687500,8000,7800,7250,Northern_European,158,2,1992/11/16,74,7,213653.0,,24016529
1120,Cristian Buonaiuto,Cremonese,1992,90.0,it ITA,MFFW,29.0,10.9,25.0,16.0,8.0,11.0,6.0,12.0,26.0,46.2,14.0,11.0,0.0,11.0,14.0,39.0,7.0,0.0,Matches,90.0,it ITA,MFFW,29.0,10.9,60.0,5.5,26.0,10.0,9.0,9.0,4.0,2.0,2.0,0.18,0.0,0.0,0.0,1.0,1.0,0.0,Matches,,,,,,,,,,,,,,,,,,,,,,,,,,,,,,,,,,,,,,,,,,,,,,,,,,,,,,,,90.0,it ITA,MFFW,29.0,10.9,3.0,0.0,0.0,17.0,23.0,1.0,70.0,14.0,16.0,1.0,0.0,0.0,65.0,6.0,22.0,21.4,Matches,90.0,it ITA,MFFW,29.0,10.9,465.0,383.0,80.0,17.0,1.0,5.0,70.0,15.0,39.0,23.0,12.0,0.0,304.0,2.0,11.0,Matches,90.0,it ITA,MFFW,29.0,10.9,304.0,465.0,65.4,4751.0,1632.0,159.0,191.0,83.2,100.0,148.0,67.6,27.0,84.0,32.1,0.0,1.8,1.7,-1.8,17.0,31.0,15.0,4.0,39.0,Matches,119,it ITA,MFFW,29,29,980.0,34.0,28.7,10.9,7,65.0,1,22,24.0,7,0.62,10.0,23.0,-13.0,-1.19,-0.46,12.3,19.4,-7.1,-0.65,0.1,Matches,90.0,it ITA,MFFW,29.0,10.9,652.0,11.0,62.0,282.0,319.0,49.0,651.0,47.0,20.0,42.6,23.0,48.9,395.0,2208.0,974.0,35.0,29.0,9.0,36.0,28.0,421.0,89.0,Matches,90.0,it ITA,MFFW,29.0,10.9,1.0,42.0,11.0,26.2,3.86,1.01,0.0,0.0,19.7,6.0,1.0,1.0,3.3,2.5,0.06,-2.3,-2.5,Matches,90.0,it ITA,MFFW,29.0,29.0,7.0,980.0,10.9,1.0,0.0,1.0,0.0,1.0,1.0,3.0,0.0,3.3,2.5,1.8,4.2,35.0,39.0,89.0,0.09,0.0,0.09,0.0,0.0,0.3,0.16,0.46,0.23,0.39,Matches,Cristian Buonaiuto,AM RLC,29,121,128,Italy,Cremonese,14,12,16,14,16,14,9,15,7,7,14,13,8,15,12,13,11,10,11,14,10,13,15,11,14,8,11,12,13,14,10,8,16,12,13,10,14,8,13,7,15,1,1,3,3,4,3,2,2,1,3,3,20,11,13,12,15,13,11,13,1,1,1,1,1,1,1,12,10,11,20,17,19,14,179,68,5,20,1896697,6050,6050,4000,Mediterranean_Hispanic,122,5,1992/12/29,0,0,12499.0,,43077862
1121,Alessandro Buongiorno,Torino,1999,91.0,it ITA,DF,23.0,30.2,38.0,25.0,22.0,16.0,0.0,16.0,31.0,51.6,15.0,38.0,19.0,19.0,60.0,98.0,105.0,2.0,Matches,91.0,it ITA,DF,23.0,30.2,22.0,0.73,17.0,0.0,0.0,2.0,1.0,2.0,4.0,0.13,3.0,0.0,0.0,1.0,0.0,0.0,Matches,,,,,,,,,,,,,,,,,,,,,,,,,,,,,,,,,,,,,,,,,,,,,,,,,,,,,,,,91.0,it ITA,DF,23.0,30.2,8.0,0.0,0.0,64.0,38.0,0.0,8.0,60.0,25.0,0.0,0.0,0.0,167.0,99.0,52.0,65.6,Matches,91.0,it ITA,DF,23.0,30.2,1573.0,1527.0,41.0,30.0,1.0,3.0,8.0,6.0,0.0,0.0,0.0,0.0,1332.0,5.0,21.0,Matches,91.0,it ITA,DF,23.0,30.2,1332.0,1573.0,84.7,22243.0,6857.0,578.0,643.0,89.9,671.0,750.0,89.5,57.0,113.0,50.4,2.0,1.3,1.0,0.7,8.0,70.0,5.0,3.0,81.0,Matches,120,it ITA,DF,23,34,2721.0,80.0,79.6,30.2,30,85.0,24,4,39.0,2,1.41,35.0,30.0,5.0,0.17,0.68,32.3,30.1,2.2,0.07,0.12,Matches,91.0,it ITA,DF,23.0,30.2,1938.0,161.0,860.0,976.0,110.0,33.0,1938.0,16.0,6.0,37.5,7.0,43.8,986.0,4659.0,2324.0,13.0,16.0,2.0,33.0,6.0,1180.0,19.0,Matches,91.0,it ITA,DF,23.0,30.2,1.0,20.0,1.0,5.0,0.66,0.03,0.05,1.0,8.6,0.0,0.0,0.0,2.2,2.2,0.11,-1.2,-1.2,Matches,91.0,it ITA,DF,23.0,34.0,30.0,2721.0,30.2,1.0,2.0,3.0,1.0,0.0,0.0,8.0,0.0,2.2,2.2,1.3,3.6,13.0,81.0,19.0,0.03,0.07,0.1,0.03,0.1,0.07,0.04,0.12,0.07,0.12,Matches,Alessandro Buongiorno,D C,23,132,153,Italy,Torino,4,8,9,6,11,7,14,10,6,14,12,5,14,11,14,14,12,12,14,10,14,15,8,10,7,15,12,13,12,13,13,15,14,12,13,14,13,10,13,7,10,1,2,1,4,1,2,2,3,3,2,1,14,16,7,14,14,15,12,13,1,12,20,1,1,1,1,1,1,1,1,1,1,1,191,82,20,8,7590243,6594,6394,4894,Mediterranean_Hispanic,132,1,1999/6/6,0,0,7884.0,,43270682
1122,Arthur Cabral,Fiorentina,1998,93.0,br BRA,FW,24.0,15.9,9.0,2.0,1.0,4.0,4.0,4.0,8.0,50.0,4.0,10.0,1.0,9.0,1.0,10.0,12.0,0.0,Matches,93.0,br BRA,FW,24.0,15.9,36.0,2.26,26.0,0.0,2.0,5.0,3.0,0.0,2.0,0.13,1.0,0.0,0.0,1.0,0.0,0.0,Matches,,,,,,,,,,,,,,,,,,,,,,,,,,,,,,,,,,,,,,,,,,,,,,,,,,,,,,,,93.0,br BRA,FW,24.0,15.9,4.0,0.0,0.0,26.0,18.0,2.0,4.0,1.0,2.0,0.0,1.0,0.0,39.0,49.0,49.0,50.0,Matches,93.0,br BRA,FW,24.0,15.9,271.0,253.0,16.0,0.0,1.0,1.0,4.0,3.0,0.0,0.0,0.0,0.0,183.0,2.0,14.0,Matches,93.0,br BRA,FW,24.0,15.9,183.0,271.0,67.5,2376.0,416.0,118.0,155.0,76.1,41.0,52.0,78.8,9.0,14.0,64.3,1.0,0.8,0.9,0.2,14.0,3.0,7.0,0.0,21.0,Matches,122,br BRA,FW,24,28,1432.0,51.0,41.9,15.9,15,77.0,5,13,21.0,6,1.5,25.0,17.0,8.0,0.5,0.41,24.6,18.1,6.5,0.41,0.18,Matches,93.0,br BRA,FW,24.0,15.9,489.0,14.0,36.0,168.0,289.0,102.0,487.0,35.0,15.0,42.9,17.0,48.6,270.0,1438.0,397.0,11.0,14.0,9.0,60.0,24.0,361.0,86.0,Matches,93.0,br BRA,FW,24.0,15.9,8.0,52.0,20.0,38.5,3.27,1.26,0.12,0.3,13.1,0.0,2.0,2.0,7.9,6.3,0.12,0.1,-0.3,Matches,93.0,br BRA,FW,24.0,28.0,15.0,1432.0,15.9,8.0,1.0,9.0,6.0,2.0,2.0,4.0,0.0,7.9,6.3,0.8,7.0,11.0,21.0,86.0,0.5,0.06,0.57,0.38,0.44,0.49,0.05,0.54,0.39,0.44,Matches,Arthur Cabral,S,24,136,145,Brazil,ACF Fiorentina,6,8,12,15,13,8,15,12,5,4,12,15,6,12,8,14,14,14,12,10,14,12,13,9,16,7,12,10,12,12,12,13,14,13,15,15,12,9,14,5,7,2,4,1,3,4,3,1,1,3,3,3,12,13,8,13,13,11,8,9,1,1,1,1,1,1,1,1,1,1,1,1,6,20,186,89,13,20,9966417,6800,7496,5397,Mixed_Race,136,7,1998/4/25,0,0,41923.0,,19266403
1123,Davide Calabria,Milan,1996,95.0,it ITA,DF,25.0,18.8,71.0,44.0,31.0,32.0,8.0,38.0,61.0,62.3,23.0,22.0,7.0,15.0,25.0,96.0,34.0,0.0,Matches,95.0,it ITA,DF,25.0,18.8,37.0,1.97,30.0,2.0,0.0,1.0,3.0,1.0,6.0,0.32,5.0,0.0,0.0,0.0,1.0,0.0,Matches,,,,,,,,,,,,,,,,,,,,,,,,,,,,,,,,,,,,,,,,,,,,,,,,,,,,,,,,95.0,it ITA,DF,25.0,18.8,6.0,0.0,0.0,16.0,15.0,1.0,41.0,25.0,44.0,1.0,1.0,0.0,122.0,13.0,12.0,52.0,Matches,95.0,it ITA,DF,25.0,18.8,1276.0,1076.0,194.0,18.0,0.0,5.0,41.0,171.0,5.0,0.0,5.0,0.0,1040.0,6.0,24.0,Matches,95.0,it ITA,DF,25.0,18.8,1040.0,1276.0,81.5,17672.0,5902.0,484.0,518.0,93.4,452.0,524.0,86.3,88.0,187.0,47.1,4.0,1.7,1.6,2.3,19.0,71.0,19.0,12.0,108.0,Matches,125,it ITA,DF,25,25,1690.0,68.0,49.4,18.8,21,78.0,10,4,15.0,3,1.72,35.0,25.0,10.0,0.53,-0.04,28.4,19.6,8.8,0.47,0.0,Matches,95.0,it ITA,DF,25.0,18.8,1474.0,59.0,414.0,768.0,307.0,16.0,1474.0,14.0,3.0,21.4,8.0,57.1,755.0,3303.0,1966.0,26.0,23.0,2.0,14.0,7.0,915.0,80.0,Matches,95.0,it ITA,DF,25.0,18.8,1.0,16.0,2.0,12.5,0.85,0.11,0.06,0.5,23.9,0.0,0.0,0.0,1.2,1.2,0.07,-0.2,-0.2,Matches,95.0,it ITA,DF,25.0,25.0,21.0,1690.0,18.8,1.0,4.0,5.0,1.0,0.0,0.0,6.0,0.0,1.2,1.2,1.7,2.9,26.0,108.0,80.0,0.05,0.21,0.27,0.05,0.27,0.06,0.09,0.15,0.06,0.15,Matches,Davide Calabria,D/WB RL,25,149,156,Italy,AC Milan,5,12,11,8,12,4,9,11,14,14,13,10,15,12,13,14,15,12,13,12,13,16,6,13,14,14,16,15,15,16,14,9,14,14,14,13,14,10,13,12,16,1,1,1,1,1,3,2,3,3,1,2,13,15,4,17,14,15,14,14,1,17,1,20,13,18,12,10,12,13,1,1,1,1,177,70,12,20,59572585,7450,7150,5850,Mediterranean_Hispanic,143,2,1996/12/6,7,0,71154.0,,43123020
1124,Mattia Caldara,Spezia,1994,96.0,it ITA,DF,28.0,13.9,23.0,14.0,10.0,11.0,2.0,9.0,20.0,45.0,11.0,23.0,16.0,7.0,17.0,40.0,88.0,2.0,Matches,96.0,it ITA,DF,28.0,13.9,7.0,0.5,7.0,0.0,0.0,0.0,0.0,0.0,1.0,0.07,1.0,0.0,0.0,0.0,0.0,0.0,Matches,,,,,,,,,,,,,,,,,,,,,,,,,,,,,,,,,,,,,,,,,,,,,,,,,,,,,,,,96.0,it ITA,DF,28.0,13.9,6.0,0.0,0.0,16.0,10.0,1.0,1.0,17.0,14.0,0.0,1.0,1.0,93.0,35.0,24.0,59.3,Matches,96.0,it ITA,DF,28.0,13.9,600.0,540.0,58.0,31.0,0.0,2.0,1.0,9.0,0.0,0.0,0.0,0.0,461.0,2.0,4.0,Matches,96.0,it ITA,DF,28.0,13.9,461.0,600.0,76.8,8308.0,3214.0,183.0,220.0,83.2,223.0,270.0,82.6,45.0,93.0,48.4,0.0,0.0,0.1,0.0,1.0,23.0,1.0,0.0,35.0,Matches,126,it ITA,DF,28,20,1253.0,63.0,36.6,13.9,13,87.0,11,7,17.0,15,1.1,10.0,22.0,-12.0,-0.86,-0.07,12.2,27.5,-15.3,-1.1,-0.98,Matches,96.0,it ITA,DF,28.0,13.9,791.0,145.0,450.0,304.0,46.0,17.0,791.0,5.0,2.0,40.0,2.0,40.0,380.0,1885.0,830.0,5.0,4.0,0.0,9.0,4.0,361.0,4.0,Matches,96.0,it ITA,DF,28.0,13.9,0.0,11.0,4.0,36.4,0.79,0.29,0.0,0.0,10.5,0.0,0.0,0.0,0.8,0.8,0.07,-0.8,-0.8,Matches,96.0,it ITA,DF,28.0,20.0,13.0,1253.0,13.9,0.0,0.0,0.0,0.0,0.0,0.0,6.0,0.0,0.8,0.8,0.0,0.8,5.0,35.0,4.0,0.0,0.0,0.0,0.0,0.0,0.06,0.0,0.06,0.06,0.06,Matches,Mattia Caldara,D C,28,125,142,Italy,AC Milan,4,4,6,9,11,4,15,6,11,14,13,8,13,11,12,13,11,12,12,10,12,14,7,12,7,15,13,13,12,11,12,15,9,11,12,14,10,8,12,16,10,1,1,1,3,2,2,4,1,3,1,3,12,15,3,11,12,18,16,14,1,1,20,1,1,1,1,1,1,1,1,1,1,1,187,79,10,20,1257223,6245,6245,5295,Mediterranean_Hispanic,124,4,1994/5/5,2,0,78269.0,Spezia Calcio,43081382
1125,Luca Caldirola,Monza,1991,97.0,it ITA,DF,31.0,26.1,26.0,14.0,19.0,4.0,3.0,13.0,26.0,50.0,13.0,32.0,18.0,14.0,25.0,51.0,66.0,1.0,Matches,97.0,it ITA,DF,31.0,26.1,12.0,0.46,12.0,0.0,0.0,0.0,0.0,0.0,1.0,0.04,1.0,0.0,0.0,0.0,0.0,0.0,Matches,,,,,,,,,,,,,,,,,,,,,,,,,,,,,,,,,,,,,,,,,,,,,,,,,,,,,,,,97.0,it ITA,DF,31.0,26.1,6.0,0.0,0.0,30.0,26.0,0.0,5.0,25.0,14.0,0.0,0.0,0.0,95.0,34.0,32.0,51.5,Matches,97.0,it ITA,DF,31.0,26.1,1435.0,1368.0,65.0,39.0,1.0,8.0,5.0,6.0,0.0,0.0,0.0,0.0,1262.0,2.0,8.0,Matches,97.0,it ITA,DF,31.0,26.1,1262.0,1435.0,87.9,22342.0,8287.0,534.0,555.0,96.2,592.0,653.0,90.7,109.0,179.0,60.9,0.0,0.5,0.3,-0.5,4.0,55.0,4.0,1.0,63.0,Matches,127,it ITA,DF,31,31,2353.0,76.0,68.8,26.1,27,83.0,17,4,31.0,4,1.65,36.0,32.0,4.0,0.15,0.83,32.1,33.7,-1.5,-0.06,0.26,Matches,97.0,it ITA,DF,31.0,26.1,1636.0,219.0,891.0,674.0,75.0,12.0,1636.0,3.0,1.0,33.3,1.0,33.3,978.0,4803.0,2623.0,12.0,11.0,0.0,5.0,1.0,1176.0,13.0,Matches,97.0,it ITA,DF,31.0,26.1,2.0,10.0,4.0,40.0,0.38,0.15,0.2,0.5,10.9,0.0,0.0,0.0,1.1,1.1,0.11,0.9,0.9,Matches,97.0,it ITA,DF,31.0,31.0,27.0,2353.0,26.1,2.0,0.0,2.0,2.0,0.0,0.0,6.0,0.0,1.1,1.1,0.5,1.6,12.0,63.0,13.0,0.08,0.0,0.08,0.08,0.08,0.04,0.02,0.06,0.04,0.06,Matches,Luca Caldirola,D LC,31,129,137,Italy,Brianza,4,13,10,10,12,4,17,4,10,13,10,7,13,10,8,13,10,12,15,10,14,14,4,13,8,14,17,10,11,11,11,15,13,12,13,12,17,8,16,6,10,1,1,1,1,1,1,1,1,1,1,1,12,14,4,14,12,16,15,17,1,16,20,1,1,1,1,1,1,1,1,1,1,1,187,75,20,10,1888381,6450,6450,5250,Northern_European,127,5,1991/2/1,0,0,24231.0,,43008773
1126,Hakan Çalhanoğlu,Inter,1994,98.0,tr TUR,MF,28.0,26.3,48.0,27.0,17.0,26.0,5.0,16.0,43.0,37.2,27.0,30.0,5.0,25.0,25.0,73.0,13.0,1.0,Matches,98.0,tr TUR,MF,28.0,26.3,131.0,4.99,75.0,46.0,0.0,5.0,4.0,1.0,11.0,0.42,8.0,3.0,0.0,0.0,0.0,0.0,Matches,,,,,,,,,,,,,,,,,,,,,,,,,,,,,,,,,,,,,,,,,,,,,,,,,,,,,,,,98.0,tr TUR,MF,28.0,26.3,3.0,0.0,0.0,46.0,26.0,2.0,167.0,25.0,27.0,0.0,0.0,0.0,193.0,14.0,15.0,48.3,Matches,98.0,tr TUR,MF,28.0,26.3,1677.0,1495.0,177.0,67.0,5.0,25.0,167.0,6.0,104.0,33.0,63.0,0.0,1396.0,5.0,12.0,Matches,98.0,tr TUR,MF,28.0,26.3,1396.0,1677.0,83.2,25576.0,7831.0,637.0,690.0,92.3,546.0,630.0,86.7,180.0,288.0,62.5,6.0,5.0,6.0,1.0,70.0,149.0,37.0,11.0,172.0,Matches,128,tr TUR,MF,28,33,2363.0,72.0,69.1,26.3,28,80.0,12,5,23.0,2,2.06,56.0,25.0,31.0,1.18,1.35,47.1,22.0,25.1,0.96,0.4,Matches,98.0,tr TUR,MF,28.0,26.3,1942.0,34.0,367.0,1015.0,581.0,26.0,1941.0,24.0,8.0,33.3,10.0,41.7,1167.0,5515.0,2601.0,46.0,55.0,6.0,32.0,12.0,1323.0,68.0,Matches,98.0,tr TUR,MF,28.0,26.3,3.0,55.0,16.0,29.1,2.09,0.61,0.04,0.13,26.5,10.0,1.0,1.0,3.1,2.3,0.04,-0.1,-0.3,Matches,98.0,tr TUR,MF,28.0,33.0,28.0,2363.0,26.3,3.0,6.0,9.0,2.0,1.0,1.0,3.0,0.0,3.1,2.3,5.0,7.3,46.0,172.0,68.0,0.11,0.23,0.34,0.08,0.3,0.12,0.19,0.31,0.09,0.28,Matches,Hakan Çalhanoğlu,M/AM LC,28,153,159,"Turkey,Germany",FC Internazionale Milano,18,17,11,13,17,16,7,17,4,8,18,16,11,16,11,14,10,14,12,18,15,12,16,9,14,11,15,10,13,14,13,8,16,12,13,9,13,8,11,5,16,2,1,2,2,3,1,3,2,1,1,4,12,16,6,7,13,14,16,14,1,1,1,1,1,1,12,17,20,11,16,17,10,7,178,69,12,20,30875000,7650,7350,6800,North_African__Middle_Eastern,151,3,1994/2/8,72,16,178076.0,,92026209
1127,Nicolò Cambiaghi,Empoli,2000,100.0,it ITA,FWMF,21.0,14.3,30.0,22.0,11.0,12.0,7.0,8.0,27.0,29.6,19.0,19.0,1.0,18.0,9.0,39.0,8.0,0.0,Matches,100.0,it ITA,FWMF,21.0,14.3,53.0,3.71,31.0,1.0,3.0,5.0,10.0,3.0,7.0,0.49,1.0,1.0,2.0,1.0,2.0,0.0,Matches,,,,,,,,,,,,,,,,,,,,,,,,,,,,,,,,,,,,,,,,,,,,,,,,,,,,,,,,100.0,it ITA,FWMF,21.0,14.3,5.0,1.0,1.0,25.0,60.0,1.0,41.0,9.0,22.0,1.0,0.0,0.0,64.0,3.0,15.0,16.7,Matches,100.0,it ITA,FWMF,21.0,14.3,432.0,420.0,10.0,1.0,0.0,0.0,41.0,7.0,1.0,0.0,0.0,0.0,321.0,2.0,25.0,Matches,100.0,it ITA,FWMF,21.0,14.3,321.0,432.0,74.3,4556.0,930.0,194.0,219.0,88.6,86.0,119.0,72.3,19.0,34.0,55.9,1.0,1.1,1.6,-0.1,15.0,19.0,18.0,5.0,42.0,Matches,130,it ITA,FWMF,21,28,1285.0,46.0,37.6,14.3,12,74.0,2,16,25.0,3,1.32,20.0,12.0,8.0,0.56,1.4,17.5,19.7,-2.2,-0.15,0.58,Matches,100.0,it ITA,FWMF,21.0,14.3,638.0,9.0,87.0,255.0,311.0,56.0,638.0,57.0,22.0,38.6,20.0,35.1,442.0,3746.0,1603.0,73.0,30.0,23.0,44.0,21.0,464.0,99.0,Matches,100.0,it ITA,FWMF,21.0,14.3,6.0,36.0,14.0,38.9,2.52,0.98,0.17,0.43,18.1,0.0,0.0,0.0,3.4,3.4,0.09,2.6,2.6,Matches,100.0,it ITA,FWMF,21.0,28.0,12.0,1285.0,14.3,6.0,1.0,7.0,6.0,0.0,0.0,5.0,1.0,3.4,3.4,1.1,4.5,73.0,42.0,99.0,0.42,0.07,0.49,0.42,0.49,0.23,0.08,0.31,0.23,0.31,Matches,Nicolò Cambiaghi,AM/S L,21,118,146,Italy,Atalanta,12,13,13,12,13,10,11,12,8,8,12,11,10,12,12,11,11,11,12,12,13,16,16,11,12,12,12,12,13,13,11,10,15,12,12,11,13,12,13,8,13,2,1,1,2,3,2,3,3,2,3,1,11,12,4,11,11,11,7,14,1,1,1,1,1,1,1,12,1,1,20,12,1,18,173,65,10,20,4368749,5900,5900,2750,Northern_European,118,2,2000/12/28,0,0,11120.0,Empoli Football Club,43295822
1128,Andrea Cambiaso,Bologna,2000,101.0,it ITA,DF,22.0,24.1,57.0,34.0,34.0,20.0,3.0,28.0,65.0,43.1,37.0,26.0,2.0,24.0,26.0,83.0,33.0,1.0,Matches,101.0,it ITA,DF,22.0,24.1,55.0,2.28,43.0,4.0,4.0,2.0,2.0,0.0,7.0,0.29,7.0,0.0,0.0,0.0,0.0,0.0,Matches,,,,,,,,,,,,,,,,,,,,,,,,,,,,,,,,,,,,,,,,,,,,,,,,,,,,,,,,101.0,it ITA,DF,22.0,24.1,2.0,0.0,0.0,26.0,30.0,5.0,56.0,26.0,34.0,0.0,0.0,0.0,154.0,3.0,24.0,11.1,Matches,101.0,it ITA,DF,22.0,24.1,1521.0,1281.0,238.0,24.0,0.0,9.0,56.0,211.0,3.0,1.0,1.0,0.0,1277.0,2.0,37.0,Matches,101.0,it ITA,DF,22.0,24.1,1277.0,1521.0,84.0,19674.0,6031.0,686.0,753.0,91.1,472.0,541.0,87.2,83.0,144.0,57.6,3.0,2.4,1.6,0.6,28.0,48.0,24.0,7.0,83.0,Matches,131,it ITA,DF,22,32,2170.0,68.0,63.5,24.1,25,81.0,17,7,19.0,2,1.38,30.0,28.0,2.0,0.08,-0.06,28.3,29.3,-1.0,-0.04,0.24,Matches,101.0,it ITA,DF,22.0,24.1,1790.0,70.0,620.0,771.0,423.0,40.0,1790.0,60.0,31.0,51.7,24.0,40.0,1030.0,5494.0,2822.0,64.0,59.0,17.0,42.0,18.0,1148.0,105.0,Matches,101.0,it ITA,DF,22.0,24.1,0.0,17.0,5.0,29.4,0.71,0.21,0.0,0.0,20.5,0.0,0.0,0.0,0.9,0.9,0.05,-0.9,-0.9,Matches,101.0,it ITA,DF,22.0,32.0,25.0,2170.0,24.1,0.0,3.0,3.0,0.0,0.0,0.0,2.0,0.0,0.9,0.9,2.4,3.3,64.0,83.0,105.0,0.0,0.12,0.12,0.0,0.12,0.04,0.1,0.14,0.04,0.14,Matches,Andrea Cambiaso,D/WB/M RL,22,128,151,Italy,Juventus,4,13,14,9,11,4,7,9,10,9,12,5,13,12,11,11,12,9,10,10,8,15,10,6,12,8,12,14,15,14,11,10,13,15,14,9,12,7,11,8,20,2,1,4,2,2,1,1,1,2,2,1,16,12,10,12,13,15,14,11,1,18,1,16,20,18,1,20,12,18,7,1,7,1,183,70,20,14,8487717,6400,6150,4750,Mediterranean_Hispanic,113,1,2000/2/20,0,0,19230.0,Bologna FC 1909,43339195
1129,Antonio Candreva,Salernitana,1987,103.0,it ITA,MFDF,35.0,30.3,17.0,7.0,13.0,2.0,2.0,11.0,38.0,28.9,27.0,7.0,3.0,4.0,17.0,34.0,32.0,0.0,Matches,103.0,it ITA,MFDF,35.0,30.3,99.0,3.27,67.0,22.0,2.0,5.0,3.0,0.0,11.0,0.36,9.0,1.0,0.0,1.0,0.0,0.0,Matches,,,,,,,,,,,,,,,,,,,,,,,,,,,,,,,,,,,,,,,,,,,,,,,,,,,,,,,,103.0,it ITA,MFDF,35.0,30.3,3.0,1.0,1.0,7.0,35.0,10.0,218.0,17.0,7.0,0.0,1.0,0.0,135.0,2.0,5.0,28.6,Matches,103.0,it ITA,MFDF,35.0,30.3,1597.0,1350.0,243.0,53.0,5.0,25.0,218.0,125.0,61.0,9.0,26.0,0.0,1165.0,4.0,46.0,Matches,103.0,it ITA,MFDF,35.0,30.3,1165.0,1597.0,72.9,19672.0,6882.0,604.0,660.0,91.5,393.0,536.0,73.3,124.0,285.0,43.5,4.0,4.7,4.9,-0.7,57.0,98.0,55.0,30.0,135.0,Matches,134,it ITA,MFDF,35,35,2726.0,78.0,79.7,30.3,32,83.0,18,3,21.0,0,1.17,41.0,46.0,-5.0,-0.17,1.0,30.3,50.1,-19.8,-0.65,0.73,Matches,103.0,it ITA,MFDF,35.0,30.3,1802.0,48.0,332.0,783.0,708.0,46.0,1802.0,34.0,8.0,23.5,14.0,41.2,1093.0,5695.0,2245.0,71.0,50.0,10.0,25.0,13.0,1298.0,171.0,Matches,103.0,it ITA,MFDF,35.0,30.3,7.0,46.0,20.0,43.5,1.52,0.66,0.15,0.35,22.2,3.0,0.0,0.0,3.7,3.7,0.08,3.3,3.3,Matches,103.0,it ITA,MFDF,35.0,35.0,32.0,2726.0,30.3,7.0,4.0,11.0,7.0,0.0,0.0,3.0,1.0,3.7,3.7,4.7,8.3,71.0,135.0,171.0,0.23,0.13,0.36,0.23,0.36,0.12,0.15,0.27,0.12,0.27,Matches,Antonio Candreva,WB/M RC,35,136,155,Italy,U.C. Sampdoria,12,16,15,13,16,12,5,12,6,9,15,13,8,15,11,16,11,13,12,14,13,18,16,12,15,12,10,13,13,12,13,9,17,12,13,9,16,8,12,8,16,1,3,3,3,3,3,3,1,2,1,1,13,12,9,13,12,18,11,13,1,1,1,1,1,18,1,12,16,20,12,10,14,1,180,70,12,20,1624188,6800,6600,6700,Mediterranean_Hispanic,136,3,1987/2/28,54,7,46249.0,U.S. Salernitana 1919,1400480
1130,Gianluca Caprari,Monza,1993,104.0,it ITA,MFFW,29.0,27.1,16.0,6.0,3.0,11.0,2.0,8.0,26.0,30.8,18.0,22.0,1.0,21.0,8.0,24.0,3.0,0.0,Matches,104.0,it ITA,MFFW,29.0,27.1,78.0,2.87,59.0,9.0,5.0,4.0,1.0,0.0,11.0,0.41,8.0,2.0,0.0,0.0,1.0,0.0,Matches,,,,,,,,,,,,,,,,,,,,,,,,,,,,,,,,,,,,,,,,,,,,,,,,,,,,,,,,104.0,it ITA,MFFW,29.0,27.1,7.0,0.0,0.0,34.0,50.0,9.0,76.0,8.0,6.0,0.0,0.0,0.0,101.0,6.0,21.0,22.2,Matches,104.0,it ITA,MFFW,29.0,27.1,1082.0,1019.0,57.0,11.0,5.0,15.0,76.0,7.0,33.0,6.0,24.0,0.0,853.0,6.0,45.0,Matches,104.0,it ITA,MFFW,29.0,27.1,853.0,1082.0,78.8,13026.0,2612.0,495.0,561.0,88.2,250.0,322.0,77.6,70.0,100.0,70.0,2.0,2.5,2.8,-0.5,29.0,56.0,30.0,4.0,92.0,Matches,138,it ITA,MFFW,29,37,2441.0,66.0,71.4,27.1,32,71.0,5,5,32.0,0,1.38,33.0,42.0,-9.0,-0.33,-0.79,31.0,35.1,-4.1,-0.15,-0.03,Matches,104.0,it ITA,MFFW,29.0,27.1,1364.0,7.0,128.0,668.0,577.0,103.0,1363.0,91.0,40.0,44.0,43.0,47.3,884.0,5535.0,2661.0,100.0,50.0,42.0,79.0,32.0,1089.0,188.0,Matches,104.0,it ITA,MFFW,29.0,27.1,5.0,50.0,13.0,26.0,1.84,0.48,0.08,0.31,20.0,1.0,1.0,1.0,5.0,4.2,0.08,0.0,-0.2,Matches,104.0,it ITA,MFFW,29.0,37.0,32.0,2441.0,27.1,5.0,2.0,7.0,4.0,1.0,1.0,7.0,0.0,5.0,4.2,2.5,6.7,100.0,92.0,188.0,0.18,0.07,0.26,0.15,0.22,0.18,0.09,0.28,0.15,0.25,Matches,Gianluca Caprari,AM/S RLC,28,138,142,Italy,Hellas Verona,13,13,15,13,15,13,7,13,3,4,14,10,4,16,10,14,11,13,11,14,12,16,16,11,15,4,12,12,15,17,15,7,13,13,12,7,15,5,14,5,14,1,3,2,2,2,1,2,3,3,1,1,13,14,3,12,10,13,15,17,1,1,1,1,1,1,1,1,1,1,20,20,15,17,176,72,9,20,7972902,6900,6800,5300,Mediterranean_Hispanic,131,3,1993/7/30,1,0,14383.0,Brianza,43067331
1131,Francesco Caputo,Sampdoria,1987,105.0,it ITA,FW,34.0,12.2,3.0,1.0,0.0,0.0,3.0,0.0,3.0,0.0,3.0,0.0,0.0,0.0,1.0,4.0,3.0,0.0,Matches,105.0,it ITA,FW,34.0,12.2,23.0,1.89,17.0,0.0,1.0,3.0,1.0,1.0,1.0,0.08,1.0,0.0,0.0,0.0,0.0,0.0,Matches,,,,,,,,,,,,,,,,,,,,,,,,,,,,,,,,,,,,,,,,,,,,,,,,,,,,,,,,105.0,it ITA,FW,34.0,12.2,0.0,0.0,0.0,5.0,24.0,11.0,3.0,1.0,1.0,0.0,0.0,0.0,18.0,6.0,21.0,22.2,Matches,105.0,it ITA,FW,34.0,12.2,237.0,208.0,28.0,0.0,0.0,0.0,3.0,2.0,0.0,0.0,0.0,0.0,168.0,1.0,9.0,Matches,105.0,it ITA,FW,34.0,12.2,168.0,237.0,70.9,2130.0,315.0,96.0,130.0,73.8,43.0,60.0,71.7,8.0,10.0,80.0,0.0,0.5,0.6,-0.5,9.0,11.0,4.0,0.0,11.0,Matches,139,it ITA,FW,34,15,1094.0,73.0,32.0,12.2,13,78.0,6,2,40.0,0,0.4,6.0,20.0,-14.0,-1.15,0.13,9.0,17.4,-8.4,-0.69,0.23,Matches,105.0,it ITA,FW,34.0,12.2,309.0,4.0,11.0,126.0,172.0,49.0,309.0,9.0,3.0,33.3,5.0,55.6,181.0,696.0,192.0,6.0,4.0,7.0,21.0,14.0,243.0,76.0,Matches,105.0,it ITA,FW,34.0,12.2,1.0,19.0,5.0,26.3,1.56,0.41,0.05,0.2,14.8,0.0,0.0,0.0,1.9,1.9,0.1,-0.9,-0.9,Matches,105.0,it ITA,FW,34.0,15.0,13.0,1094.0,12.2,1.0,0.0,1.0,1.0,0.0,0.0,0.0,0.0,1.9,1.9,0.5,2.4,6.0,11.0,76.0,0.08,0.0,0.08,0.08,0.08,0.15,0.04,0.19,0.15,0.19,Matches,Francesco Caputo,S,34,131,146,Italy,U.C. Sampdoria,5,10,10,15,12,6,13,5,4,4,12,13,6,12,10,17,12,15,12,15,16,17,12,15,17,3,13,15,12,12,15,11,16,12,15,12,14,4,15,13,6,1,1,2,1,3,3,2,1,2,1,2,14,17,7,14,13,15,15,14,1,1,1,1,1,1,1,1,1,1,1,1,1,20,181,74,10,20,347975206,6550,6550,5400,Mediterranean_Hispanic,129,4,1987/8/6,2,1,28461.0,,43016849
1132,Marco Carnesecchi,Cremonese,2000,110.0,it ITA,GK,22.0,27.0,1.0,1.0,1.0,0.0,0.0,1.0,2.0,50.0,1.0,0.0,0.0,0.0,0.0,1.0,11.0,2.0,Matches,110.0,it ITA,GK,22.0,27.0,9.0,0.33,6.0,3.0,0.0,0.0,0.0,0.0,2.0,0.07,1.0,1.0,0.0,0.0,0.0,0.0,Matches,3.0,it ITA,GK,22.0,27.0,47.0,2.0,3.0,7.0,1.0,44.2,0.28,-1.8,-0.07,157.0,523.0,30.0,745.0,135.0,52.2,41.4,203.0,66.0,53.1,402.0,29.0,7.2,29.0,1.07,14.1,Matches,3.0,it ITA,GK,22.0,27.0,27.0,2430.0,27.0,47.0,1.74,153.0,107.0,70.6,4.0,9.0,14.0,4.0,14.8,2.0,2.0,0.0,0.0,0.0,Matches,110.0,it ITA,GK,22.0,27.0,1.0,0.0,0.0,0.0,5.0,0.0,0.0,0.0,1.0,0.0,0.0,0.0,29.0,5.0,2.0,71.4,Matches,110.0,it ITA,GK,22.0,27.0,954.0,648.0,300.0,97.0,0.0,6.0,0.0,0.0,0.0,0.0,0.0,0.0,565.0,6.0,0.0,Matches,110.0,it ITA,GK,22.0,27.0,565.0,954.0,59.2,18072.0,14248.0,99.0,100.0,99.0,231.0,237.0,97.5,229.0,605.0,37.9,1.0,0.2,0.1,0.8,2.0,33.0,1.0,0.0,0.0,Matches,144,it ITA,GK,22,27,2430.0,90.0,71.1,27.0,27,90.0,27,0,,4,0.78,25.0,47.0,-22.0,-0.81,0.19,28.1,44.3,-16.2,-0.6,0.42,Matches,110.0,it ITA,GK,22.0,27.0,1036.0,906.0,1036.0,0.0,0.0,0.0,1036.0,0.0,0.0,,0.0,,568.0,2965.0,1600.0,0.0,0.0,0.0,0.0,0.0,407.0,0.0,Matches,110.0,it ITA,GK,22.0,27.0,0.0,0.0,0.0,,0.0,0.0,,,,0.0,0.0,0.0,0.0,0.0,,0.0,0.0,Matches,110.0,it ITA,GK,22.0,27.0,27.0,2430.0,27.0,0.0,1.0,1.0,0.0,0.0,0.0,1.0,0.0,0.0,0.0,0.2,0.2,0.0,0.0,0.0,0.0,0.04,0.04,0.0,0.04,0.0,0.01,0.01,0.0,0.01,Matches,Marco Carnesecchi,GK,22,129,159,Italy,Atalanta,2,3,1,1,8,6,5,3,3,1,8,3,2,8,9,13,10,10,15,8,12,15,7,13,7,15,13,15,10,14,13,15,15,10,15,13,15,6,15,6,14,14,16,15,10,15,9,12,14,14,13,10,12,16,6,15,12,18,14,14,20,1,1,1,1,1,1,1,1,1,1,1,1,1,191,80,5,20,14860000,6450,6450,4250,Mediterranean_Hispanic,129,2,2000/7/1,0,0,3557.0,Cremonese,43298002
1133,Nicolò Casale,Lazio,1998,111.0,it ITA,DF,24.0,27.1,42.0,20.0,28.0,14.0,0.0,22.0,34.0,64.7,12.0,25.0,17.0,8.0,17.0,59.0,73.0,1.0,Matches,111.0,it ITA,DF,24.0,27.1,12.0,0.44,10.0,1.0,0.0,1.0,0.0,0.0,4.0,0.15,3.0,0.0,0.0,1.0,0.0,0.0,Matches,,,,,,,,,,,,,,,,,,,,,,,,,,,,,,,,,,,,,,,,,,,,,,,,,,,,,,,,111.0,it ITA,DF,24.0,27.1,6.0,0.0,0.0,22.0,7.0,0.0,0.0,17.0,20.0,0.0,0.0,0.0,142.0,45.0,27.0,62.5,Matches,111.0,it ITA,DF,24.0,27.1,1616.0,1535.0,79.0,72.0,2.0,9.0,0.0,3.0,0.0,0.0,0.0,0.0,1485.0,2.0,8.0,Matches,111.0,it ITA,DF,24.0,27.1,1485.0,1616.0,91.9,26275.0,9500.0,591.0,633.0,93.4,701.0,741.0,94.6,142.0,169.0,84.0,1.0,0.3,0.6,0.7,4.0,55.0,1.0,0.0,70.0,Matches,145,it ITA,DF,24,29,2437.0,84.0,71.3,27.1,27,89.0,25,2,21.0,6,1.86,38.0,24.0,14.0,0.52,-0.95,36.3,28.5,7.7,0.29,0.09,Matches,111.0,it ITA,DF,24.0,27.1,1803.0,215.0,871.0,917.0,27.0,14.0,1803.0,3.0,1.0,33.3,2.0,66.7,1102.0,6813.0,3784.0,11.0,3.0,0.0,5.0,1.0,1246.0,3.0,Matches,111.0,it ITA,DF,24.0,27.1,1.0,8.0,2.0,25.0,0.3,0.07,0.13,0.5,10.9,0.0,0.0,0.0,0.6,0.6,0.08,0.4,0.4,Matches,111.0,it ITA,DF,24.0,29.0,27.0,2437.0,27.1,1.0,1.0,2.0,1.0,0.0,0.0,6.0,0.0,0.6,0.6,0.3,0.9,11.0,70.0,3.0,0.04,0.04,0.07,0.04,0.07,0.02,0.01,0.03,0.02,0.03,Matches,Nicolò Casale,D C,24,135,149,Italy,S.S. Lazio,4,8,9,5,11,5,13,5,11,14,11,5,16,11,13,15,13,14,16,9,13,15,4,11,8,14,12,14,13,11,14,14,13,14,15,14,14,8,12,10,12,1,3,2,2,1,3,4,2,1,1,2,15,15,8,11,14,15,13,12,1,13,20,14,11,11,1,1,1,1,1,1,1,1,191,82,9,20,6943404,6750,6750,4400,Mediterranean_Hispanic,135,2,1998/2/14,0,0,35577.0,,43206174
1134,Michele Castagnetti,Cremonese,1989,113.0,it ITA,MF,32.0,15.7,46.0,21.0,20.0,24.0,2.0,18.0,54.0,33.3,36.0,14.0,4.0,10.0,15.0,61.0,22.0,0.0,Matches,113.0,it ITA,MF,32.0,15.7,57.0,3.63,45.0,5.0,1.0,5.0,1.0,0.0,3.0,0.19,3.0,0.0,0.0,0.0,0.0,0.0,Matches,,,,,,,,,,,,,,,,,,,,,,,,,,,,,,,,,,,,,,,,,,,,,,,,,,,,,,,,113.0,it ITA,MF,32.0,15.7,2.0,0.0,0.0,16.0,12.0,0.0,38.0,15.0,21.0,0.0,0.0,0.0,99.0,9.0,14.0,39.1,Matches,113.0,it ITA,MF,32.0,15.7,807.0,729.0,73.0,41.0,4.0,10.0,38.0,8.0,18.0,11.0,6.0,0.0,624.0,5.0,12.0,Matches,113.0,it ITA,MF,32.0,15.7,624.0,807.0,77.3,10942.0,4257.0,284.0,331.0,85.8,263.0,328.0,80.2,62.0,113.0,54.9,1.0,1.8,1.9,-0.8,26.0,95.0,16.0,3.0,120.0,Matches,148,it ITA,MF,32,27,1412.0,52.0,41.3,15.7,14,74.0,5,13,29.0,6,0.78,19.0,29.0,-10.0,-0.64,0.39,18.1,26.3,-8.1,-0.52,0.35,Matches,113.0,it ITA,MF,32.0,15.7,941.0,33.0,209.0,560.0,184.0,9.0,941.0,12.0,8.0,66.7,3.0,25.0,449.0,1871.0,970.0,14.0,11.0,0.0,15.0,3.0,551.0,10.0,Matches,113.0,it ITA,MF,32.0,15.7,0.0,12.0,1.0,8.3,0.76,0.06,0.0,0.0,26.6,2.0,0.0,0.0,0.6,0.6,0.05,-0.6,-0.6,Matches,113.0,it ITA,MF,32.0,27.0,14.0,1412.0,15.7,0.0,1.0,1.0,0.0,0.0,0.0,2.0,0.0,0.6,0.6,1.8,2.5,14.0,120.0,10.0,0.0,0.06,0.06,0.0,0.06,0.04,0.12,0.16,0.04,0.16,Matches,Michele Castagnetti,DM/M C,32,122,130,Italy,Cremonese,12,10,11,10,14,12,10,14,8,11,15,10,14,15,15,14,10,12,13,15,13,8,11,10,12,14,13,12,11,12,12,10,15,11,14,11,12,13,10,8,14,2,1,1,1,1,1,3,1,1,1,1,11,10,5,10,8,12,10,10,1,1,1,1,1,1,20,1,20,1,1,1,1,1,180,77,20,5,881182,6093,6093,3943,Northern_European,124,3,1989/12/27,0,0,7884.0,,43009694
1135,Danilo Cataldi,Lazio,1994,115.0,it ITA,MF,27.0,21.3,25.0,16.0,7.0,15.0,3.0,14.0,40.0,35.0,26.0,23.0,9.0,14.0,24.0,49.0,33.0,0.0,Matches,115.0,it ITA,MF,27.0,21.3,35.0,1.64,21.0,13.0,0.0,1.0,0.0,0.0,2.0,0.09,1.0,0.0,0.0,1.0,0.0,0.0,Matches,,,,,,,,,,,,,,,,,,,,,,,,,,,,,,,,,,,,,,,,,,,,,,,,,,,,,,,,115.0,it ITA,MF,27.0,21.3,5.0,0.0,0.0,12.0,20.0,0.0,44.0,24.0,16.0,0.0,0.0,0.0,159.0,1.0,5.0,16.7,Matches,115.0,it ITA,MF,27.0,21.3,1325.0,1245.0,76.0,40.0,3.0,5.0,44.0,3.0,33.0,6.0,20.0,0.0,1147.0,4.0,14.0,Matches,115.0,it ITA,MF,27.0,21.3,1147.0,1325.0,86.6,17538.0,6173.0,658.0,708.0,92.9,354.0,410.0,86.3,94.0,142.0,66.2,1.0,1.1,1.5,-0.1,16.0,99.0,9.0,0.0,83.0,Matches,150,it ITA,MF,27,29,1921.0,66.0,56.2,21.3,26,72.0,4,3,18.0,2,1.97,37.0,15.0,22.0,1.03,0.55,30.1,22.4,7.7,0.36,0.23,Matches,115.0,it ITA,MF,27.0,21.3,1487.0,80.0,370.0,954.0,174.0,0.0,1487.0,18.0,6.0,33.3,8.0,44.4,752.0,2871.0,1108.0,8.0,9.0,0.0,7.0,8.0,1044.0,14.0,Matches,115.0,it ITA,MF,27.0,21.3,0.0,7.0,1.0,14.3,0.33,0.05,0.0,0.0,28.8,1.0,0.0,0.0,0.2,0.2,0.03,-0.2,-0.2,Matches,115.0,it ITA,MF,27.0,29.0,26.0,1921.0,21.3,0.0,1.0,1.0,0.0,0.0,0.0,5.0,0.0,0.2,0.2,1.1,1.4,8.0,83.0,14.0,0.0,0.05,0.05,0.0,0.05,0.01,0.05,0.06,0.01,0.06,Matches,Danilo Cataldi,DM/M C,27,139,145,Italy,S.S. Lazio,14,5,11,13,14,16,4,16,4,12,13,12,14,14,14,14,13,14,13,14,13,16,13,14,13,14,16,14,12,12,12,10,15,13,12,12,13,15,14,10,13,3,2,2,3,3,2,3,2,3,3,2,10,16,6,16,13,16,13,12,1,1,1,1,1,1,20,1,18,1,1,11,1,1,180,70,14,20,9586470,6950,6700,5000,Mediterranean_Hispanic,139,3,1994/8/6,0,0,49807.0,,43093936
1136,Federico Ceccherini,Hellas Verona,1992,117.0,it ITA,DF,30.0,15.7,25.0,19.0,15.0,9.0,1.0,13.0,23.0,56.5,10.0,17.0,10.0,7.0,19.0,44.0,55.0,0.0,Matches,117.0,it ITA,DF,30.0,15.7,19.0,1.2,13.0,2.0,0.0,0.0,0.0,4.0,2.0,0.13,1.0,0.0,0.0,0.0,0.0,1.0,Matches,,,,,,,,,,,,,,,,,,,,,,,,,,,,,,,,,,,,,,,,,,,,,,,,,,,,,,,,117.0,it ITA,DF,30.0,15.7,9.0,1.0,0.0,31.0,19.0,0.0,6.0,19.0,19.0,0.0,0.0,0.0,102.0,30.0,17.0,63.8,Matches,117.0,it ITA,DF,30.0,15.7,623.0,572.0,51.0,20.0,0.0,2.0,6.0,28.0,0.0,0.0,0.0,0.0,479.0,0.0,15.0,Matches,117.0,it ITA,DF,30.0,15.7,479.0,623.0,76.9,8667.0,3491.0,199.0,225.0,88.4,219.0,261.0,83.9,52.0,98.0,53.1,0.0,0.2,0.3,-0.2,5.0,43.0,7.0,2.0,53.0,Matches,153,it ITA,DF,30,22,1417.0,64.0,41.4,15.7,18,73.0,6,4,27.0,8,0.73,15.0,23.0,-8.0,-0.51,0.39,11.8,18.0,-6.2,-0.39,-0.03,Matches,117.0,it ITA,DF,30.0,15.7,780.0,86.0,308.0,386.0,96.0,15.0,780.0,3.0,2.0,66.7,1.0,33.3,368.0,1928.0,1123.0,25.0,14.0,2.0,13.0,8.0,409.0,20.0,Matches,117.0,it ITA,DF,30.0,15.7,2.0,7.0,2.0,28.6,0.44,0.13,0.29,1.0,15.0,0.0,0.0,0.0,0.8,0.8,0.11,1.2,1.2,Matches,117.0,it ITA,DF,30.0,22.0,18.0,1417.0,15.7,2.0,0.0,2.0,2.0,0.0,0.0,9.0,1.0,0.8,0.8,0.2,1.0,25.0,53.0,20.0,0.13,0.0,0.13,0.13,0.13,0.05,0.01,0.06,0.05,0.06,Matches,Federico Ceccherini,D C,30,128,139,Italy,Hellas Verona,5,6,7,5,11,7,12,8,9,15,11,8,15,10,15,13,14,13,16,8,12,15,10,10,12,13,14,16,13,12,13,14,15,13,14,13,13,13,12,12,11,3,2,3,2,1,2,2,3,3,2,3,13,12,3,14,12,17,13,12,1,8,20,13,1,1,1,1,1,1,1,1,1,1,187,75,8,20,2688568,6400,6400,4950,Mediterranean_Hispanic,128,3,1992/5/11,0,0,17885.0,,43075133
1137,Assan Ceesay,Lecce,1994,118.0,gm GAM,FW,28.0,20.1,23.0,18.0,7.0,8.0,8.0,9.0,17.0,52.9,8.0,15.0,2.0,13.0,3.0,26.0,24.0,0.0,Matches,118.0,gm GAM,FW,28.0,20.1,37.0,1.84,25.0,0.0,5.0,3.0,4.0,0.0,6.0,0.3,2.0,0.0,3.0,1.0,0.0,0.0,Matches,,,,,,,,,,,,,,,,,,,,,,,,,,,,,,,,,,,,,,,,,,,,,,,,,,,,,,,,118.0,gm GAM,FW,28.0,20.1,2.0,0.0,0.0,36.0,27.0,22.0,15.0,3.0,18.0,0.0,0.0,0.0,51.0,63.0,80.0,44.1,Matches,118.0,gm GAM,FW,28.0,20.1,394.0,370.0,20.0,0.0,0.0,2.0,15.0,5.0,1.0,0.0,0.0,0.0,226.0,4.0,17.0,Matches,118.0,gm GAM,FW,28.0,20.1,226.0,394.0,57.4,2930.0,366.0,128.0,193.0,66.3,62.0,106.0,58.5,12.0,28.0,42.9,0.0,0.8,0.7,-0.8,8.0,13.0,5.0,1.0,16.0,Matches,154,gm GAM,FW,28,34,1812.0,53.0,53.0,20.1,20,75.0,4,14,22.0,3,0.91,13.0,27.0,-14.0,-0.7,-0.75,16.6,22.4,-5.7,-0.29,-0.27,Matches,118.0,gm GAM,FW,28.0,20.1,642.0,28.0,69.0,270.0,311.0,71.0,641.0,36.0,22.0,61.1,12.0,33.3,304.0,1456.0,590.0,21.0,15.0,8.0,64.0,25.0,417.0,111.0,Matches,118.0,gm GAM,FW,28.0,20.1,6.0,41.0,10.0,24.4,2.04,0.5,0.12,0.5,14.7,0.0,1.0,1.0,5.1,4.3,0.11,0.9,0.7,Matches,118.0,gm GAM,FW,28.0,34.0,20.0,1812.0,20.1,6.0,0.0,6.0,5.0,1.0,1.0,2.0,0.0,5.1,4.3,0.8,5.1,21.0,16.0,111.0,0.3,0.0,0.3,0.25,0.25,0.25,0.04,0.29,0.21,0.25,Matches,Assan Ceesay,S RL,28,123,127,The Gambia,Salento,5,8,12,13,10,4,11,7,4,5,11,10,6,10,11,13,12,13,11,7,11,14,14,5,12,5,12,13,16,12,14,14,15,17,13,14,13,7,9,9,12,3,2,3,1,1,3,1,1,1,2,3,13,13,5,12,1,14,12,12,1,1,1,1,1,1,1,1,1,1,15,1,15,20,188,75,20,10,2303132,6150,6150,3550,African_Caribbean,118,15,1994/3/17,32,13,14621.0,,13161991
1138,Zeki Çelik,Roma,1997,120.0,tr TUR,DF,25.0,16.7,42.0,21.0,19.0,21.0,2.0,24.0,41.0,58.5,17.0,33.0,6.0,27.0,14.0,56.0,36.0,2.0,Matches,120.0,tr TUR,DF,25.0,16.7,40.0,2.4,33.0,3.0,0.0,1.0,1.0,2.0,5.0,0.3,4.0,0.0,0.0,0.0,0.0,1.0,Matches,,,,,,,,,,,,,,,,,,,,,,,,,,,,,,,,,,,,,,,,,,,,,,,,,,,,,,,,120.0,tr TUR,DF,25.0,16.7,7.0,1.0,1.0,26.0,6.0,2.0,42.0,14.0,21.0,0.0,0.0,0.0,96.0,11.0,13.0,45.8,Matches,120.0,tr TUR,DF,25.0,16.7,927.0,733.0,192.0,12.0,0.0,4.0,42.0,180.0,0.0,0.0,0.0,0.0,697.0,2.0,20.0,Matches,120.0,tr TUR,DF,25.0,16.7,697.0,927.0,75.2,11222.0,4779.0,365.0,408.0,89.5,250.0,323.0,77.4,59.0,124.0,47.6,1.0,1.6,1.4,-0.6,16.0,55.0,24.0,7.0,67.0,Matches,156,tr TUR,DF,25,24,1504.0,63.0,44.0,16.7,16,81.0,10,8,25.0,8,1.79,22.0,17.0,5.0,0.3,-0.03,24.3,13.7,10.6,0.63,-0.06,Matches,120.0,tr TUR,DF,25.0,16.7,1102.0,43.0,350.0,491.0,276.0,18.0,1102.0,16.0,6.0,37.5,10.0,62.5,522.0,2709.0,1444.0,34.0,31.0,6.0,17.0,13.0,604.0,76.0,Matches,120.0,tr TUR,DF,25.0,16.7,0.0,5.0,1.0,20.0,0.3,0.06,0.0,0.0,17.6,0.0,0.0,0.0,0.3,0.3,0.07,-0.3,-0.3,Matches,120.0,tr TUR,DF,25.0,24.0,16.0,1504.0,16.7,0.0,1.0,1.0,0.0,0.0,0.0,7.0,1.0,0.3,0.3,1.6,1.9,34.0,67.0,76.0,0.0,0.06,0.06,0.0,0.06,0.02,0.09,0.12,0.02,0.12,Matches,Zeki Çelik,D/WB RL,25,139,147,Turkey,Associazione Sportiva Roma,9,13,11,10,12,5,10,8,13,13,14,5,15,12,8,13,15,13,14,8,14,14,10,7,14,12,14,16,14,12,12,11,14,15,15,13,13,4,12,5,17,3,1,3,2,1,1,2,1,3,3,3,14,15,8,12,11,14,8,9,1,15,10,20,10,18,1,1,1,1,1,1,1,1,180,78,12,20,10619598,6950,6700,5000,Mediterranean_Hispanic,136,7,1997/2/17,32,2,49230.0,,70097248
1139,Patrick Ciurria,Monza,1995,126.0,it ITA,DFMF,27.0,30.6,31.0,18.0,20.0,10.0,1.0,17.0,33.0,51.5,16.0,24.0,2.0,22.0,7.0,38.0,32.0,0.0,Matches,126.0,it ITA,DFMF,27.0,30.6,67.0,2.19,42.0,12.0,4.0,6.0,2.0,1.0,4.0,0.13,3.0,1.0,0.0,0.0,0.0,0.0,Matches,,,,,,,,,,,,,,,,,,,,,,,,,,,,,,,,,,,,,,,,,,,,,,,,,,,,,,,,126.0,it ITA,DFMF,27.0,30.6,4.0,0.0,0.0,32.0,41.0,8.0,98.0,7.0,18.0,0.0,0.0,0.0,138.0,12.0,13.0,48.0,Matches,126.0,it ITA,DFMF,27.0,30.6,1335.0,1132.0,200.0,23.0,1.0,2.0,98.0,145.0,32.0,0.0,26.0,0.0,1061.0,3.0,16.0,Matches,126.0,it ITA,DFMF,27.0,30.6,1061.0,1335.0,79.5,16691.0,5156.0,563.0,633.0,88.9,387.0,493.0,78.5,76.0,140.0,54.3,5.0,5.5,3.3,-0.5,36.0,67.0,31.0,14.0,91.0,Matches,170,it ITA,DFMF,27,36,2753.0,76.0,80.5,30.6,31,85.0,21,5,25.0,2,1.44,42.0,35.0,7.0,0.23,1.71,38.5,40.0,-1.5,-0.05,0.47,Matches,126.0,it ITA,DFMF,27.0,30.6,1604.0,46.0,396.0,694.0,534.0,51.0,1604.0,54.0,18.0,33.3,28.0,51.9,877.0,5018.0,2362.0,67.0,48.0,9.0,47.0,16.0,1062.0,168.0,Matches,126.0,it ITA,DFMF,27.0,30.6,6.0,50.0,23.0,46.0,1.63,0.75,0.12,0.26,20.2,0.0,0.0,0.0,4.8,4.8,0.1,1.2,1.2,Matches,126.0,it ITA,DFMF,27.0,36.0,31.0,2753.0,30.6,6.0,5.0,11.0,6.0,0.0,0.0,4.0,0.0,4.8,4.8,5.5,10.2,67.0,91.0,168.0,0.2,0.16,0.36,0.2,0.36,0.16,0.18,0.34,0.16,0.34,Matches,Patrick Ciurria,WB/M/AM/S RC,27,127,133,Italy,Brianza,11,12,12,11,12,9,8,11,8,10,11,11,12,12,12,13,12,11,12,12,12,13,13,10,13,12,11,10,14,13,9,8,11,13,14,8,12,11,11,10,15,3,2,1,3,4,2,2,3,3,2,2,11,13,7,12,14,13,14,11,1,1,1,10,1,19,1,1,1,19,12,15,20,17,178,67,20,11,3116002,6350,6000,5200,Mediterranean_Hispanic,118,8,1995/2/9,0,0,24231.0,,43115532
1140,Omar Colley,Sampdoria,1992,128.0,gm GAM,DF,29.0,15.4,17.0,10.0,10.0,7.0,0.0,9.0,12.0,75.0,3.0,9.0,5.0,4.0,22.0,39.0,69.0,1.0,Matches,128.0,gm GAM,DF,29.0,15.4,5.0,0.33,2.0,0.0,0.0,1.0,1.0,1.0,0.0,0.0,0.0,0.0,0.0,0.0,0.0,0.0,Matches,,,,,,,,,,,,,,,,,,,,,,,,,,,,,,,,,,,,,,,,,,,,,,,,,,,,,,,,128.0,gm GAM,DF,29.0,15.4,5.0,0.0,0.0,15.0,18.0,1.0,0.0,22.0,10.0,0.0,0.0,0.0,73.0,27.0,30.0,47.4,Matches,128.0,gm GAM,DF,29.0,15.4,714.0,681.0,32.0,22.0,0.0,4.0,0.0,3.0,0.0,0.0,0.0,0.0,615.0,1.0,1.0,Matches,128.0,gm GAM,DF,29.0,15.4,615.0,714.0,86.1,12155.0,4062.0,165.0,186.0,88.7,380.0,412.0,92.2,58.0,96.0,60.4,0.0,0.0,0.1,0.0,0.0,38.0,1.0,0.0,33.0,Matches,172,gm GAM,DF,29,16,1384.0,87.0,40.5,15.4,15,89.0,14,1,45.0,0,0.44,6.0,25.0,-19.0,-1.24,0.0,13.4,22.8,-9.4,-0.61,0.39,Matches,128.0,gm GAM,DF,29.0,15.4,860.0,107.0,451.0,390.0,20.0,9.0,860.0,2.0,2.0,100.0,0.0,0.0,511.0,2142.0,1020.0,3.0,1.0,0.0,4.0,2.0,517.0,2.0,Matches,128.0,gm GAM,DF,29.0,15.4,1.0,6.0,4.0,66.7,0.39,0.26,0.17,0.25,9.0,0.0,0.0,0.0,1.2,1.2,0.2,-0.2,-0.2,Matches,128.0,gm GAM,DF,29.0,16.0,15.0,1384.0,15.4,1.0,0.0,1.0,1.0,0.0,0.0,5.0,0.0,1.2,1.2,0.0,1.2,3.0,33.0,2.0,0.07,0.0,0.07,0.07,0.07,0.08,0.0,0.08,0.08,0.08,Matches,Omar Colley,D C,29,127,135,The Gambia,U.C. Sampdoria,4,4,4,6,6,4,15,6,4,15,10,4,12,10,13,12,12,10,12,10,12,12,4,10,9,13,13,13,12,11,19,15,13,12,15,18,12,12,12,4,10,1,3,3,3,3,2,2,3,1,2,1,12,15,11,7,12,12,12,12,1,1,20,1,1,1,1,1,1,1,1,1,1,1,191,87,20,10,2523962,6350,6500,5200,African_Caribbean,123,17,1992/10/24,38,0,33845.0,,13115373
1141,Lorenzo Colombo,Lecce,2002,129.0,it ITA,FW,20.0,16.8,17.0,9.0,1.0,9.0,7.0,6.0,14.0,42.9,8.0,22.0,0.0,22.0,2.0,19.0,7.0,0.0,Matches,129.0,it ITA,FW,20.0,16.8,43.0,2.56,29.0,0.0,4.0,8.0,2.0,0.0,2.0,0.12,1.0,0.0,0.0,1.0,0.0,0.0,Matches,,,,,,,,,,,,,,,,,,,,,,,,,,,,,,,,,,,,,,,,,,,,,,,,,,,,,,,,129.0,it ITA,FW,20.0,16.8,4.0,0.0,0.0,36.0,16.0,8.0,10.0,2.0,9.0,0.0,0.0,0.0,52.0,41.0,118.0,25.8,Matches,129.0,it ITA,FW,20.0,16.8,332.0,316.0,13.0,0.0,0.0,9.0,10.0,2.0,0.0,0.0,0.0,0.0,208.0,3.0,14.0,Matches,129.0,it ITA,FW,20.0,16.8,208.0,332.0,62.7,2639.0,568.0,133.0,180.0,73.9,40.0,62.0,64.5,11.0,28.0,39.3,2.0,1.4,0.5,0.6,17.0,14.0,6.0,2.0,21.0,Matches,174,it ITA,FW,20,33,1515.0,46.0,44.3,16.8,18,69.0,0,15,18.0,4,0.97,20.0,18.0,2.0,0.12,0.83,18.8,19.3,-0.5,-0.03,0.23,Matches,129.0,it ITA,FW,20.0,16.8,588.0,6.0,24.0,266.0,304.0,74.0,586.0,37.0,11.0,29.7,22.0,59.5,307.0,1330.0,408.0,14.0,12.0,6.0,79.0,38.0,418.0,119.0,Matches,129.0,it ITA,FW,20.0,16.8,5.0,43.0,11.0,25.6,2.55,0.65,0.09,0.36,16.8,0.0,1.0,2.0,6.2,4.6,0.11,-1.2,-0.6,Matches,129.0,it ITA,FW,20.0,33.0,18.0,1515.0,16.8,5.0,2.0,7.0,4.0,1.0,2.0,4.0,0.0,6.2,4.6,1.4,6.1,14.0,21.0,119.0,0.3,0.12,0.42,0.24,0.36,0.37,0.09,0.45,0.27,0.36,Matches,Lorenzo Colombo,S,20,118,-8,Italy,AC Milan,3,7,11,14,13,9,14,13,3,4,11,12,5,13,12,12,11,12,10,11,12,17,8,6,13,7,11,11,13,13,12,12,14,13,12,12,12,11,7,9,8,1,3,1,1,2,3,3,2,4,1,2,14,16,5,13,15,14,14,13,1,1,1,1,1,1,1,1,1,1,11,1,13,20,183,76,20,12,55700000,5900,6100,4750,Mediterranean_Hispanic,118,1,2002/3/8,0,0,10672.0,Salento,43424893
1142,Andrea Colpani,Monza,1999,130.0,it ITA,MF,23.0,10.5,14.0,9.0,6.0,5.0,3.0,8.0,12.0,66.7,4.0,14.0,2.0,12.0,3.0,17.0,6.0,0.0,Matches,130.0,it ITA,MF,23.0,10.5,38.0,3.6,23.0,5.0,3.0,4.0,3.0,0.0,2.0,0.19,1.0,0.0,0.0,0.0,1.0,0.0,Matches,,,,,,,,,,,,,,,,,,,,,,,,,,,,,,,,,,,,,,,,,,,,,,,,,,,,,,,,130.0,it ITA,MF,23.0,10.5,1.0,0.0,0.0,22.0,26.0,0.0,33.0,3.0,9.0,1.0,0.0,0.0,55.0,6.0,10.0,37.5,Matches,130.0,it ITA,MF,23.0,10.5,409.0,374.0,30.0,4.0,3.0,8.0,33.0,3.0,22.0,4.0,18.0,0.0,319.0,5.0,9.0,Matches,130.0,it ITA,MF,23.0,10.5,319.0,409.0,78.0,5412.0,1268.0,157.0,180.0,87.2,123.0,145.0,84.8,30.0,55.0,54.5,1.0,1.9,1.8,-0.9,17.0,28.0,14.0,2.0,51.0,Matches,176,it ITA,MF,23,27,948.0,35.0,27.7,10.5,10,61.0,0,17,20.0,8,1.22,16.0,12.0,4.0,0.38,0.67,13.5,14.2,-0.7,-0.07,0.1,Matches,130.0,it ITA,MF,23.0,10.5,538.0,8.0,55.0,267.0,232.0,31.0,538.0,41.0,20.0,48.8,13.0,31.7,371.0,2327.0,1110.0,31.0,32.0,8.0,22.0,17.0,412.0,69.0,Matches,130.0,it ITA,MF,23.0,10.5,4.0,25.0,10.0,40.0,2.37,0.95,0.16,0.4,19.1,0.0,0.0,0.0,2.1,2.1,0.09,1.9,1.9,Matches,130.0,it ITA,MF,23.0,27.0,10.0,948.0,10.5,4.0,1.0,5.0,4.0,0.0,0.0,1.0,0.0,2.1,2.1,1.9,4.1,31.0,51.0,69.0,0.38,0.09,0.47,0.38,0.47,0.2,0.18,0.39,0.2,0.39,Matches,Andrea Colpani,DM/M C,23,120,139,Italy,Brianza,9,12,12,11,14,8,10,12,8,11,14,9,12,13,10,13,12,11,13,13,12,16,9,9,12,12,14,14,12,12,12,12,12,13,14,11,12,8,10,8,10,1,3,3,1,2,2,1,1,1,1,2,9,11,6,12,10,11,13,15,1,1,1,1,1,1,17,1,20,1,1,1,1,1,185,78,20,8,1901935,5998,5698,3498,Northern_European,121,2,1999/5/11,0,0,3269.0,,43252476
1143,Andrea Consigli,Sassuolo,1987,131.0,it ITA,GK,35.0,35.0,1.0,0.0,1.0,0.0,0.0,0.0,1.0,0.0,1.0,0.0,0.0,0.0,0.0,1.0,13.0,3.0,Matches,131.0,it ITA,GK,35.0,35.0,6.0,0.17,5.0,1.0,0.0,0.0,0.0,0.0,0.0,0.0,0.0,0.0,0.0,0.0,0.0,0.0,Matches,5.0,it ITA,GK,35.0,35.0,55.0,3.0,0.0,5.0,2.0,38.5,0.31,-14.5,-0.41,176.0,436.0,40.4,1140.0,187.0,30.4,33.3,285.0,31.2,32.5,467.0,28.0,6.0,28.0,0.8,14.2,Matches,5.0,it ITA,GK,35.0,35.0,35.0,3150.0,35.0,55.0,1.57,117.0,64.0,55.6,12.0,8.0,15.0,9.0,25.7,3.0,3.0,0.0,0.0,0.0,Matches,131.0,it ITA,GK,35.0,35.0,0.0,0.0,0.0,0.0,4.0,0.0,0.0,0.0,0.0,0.0,0.0,0.0,32.0,9.0,1.0,90.0,Matches,131.0,it ITA,GK,35.0,35.0,1427.0,1042.0,383.0,98.0,0.0,2.0,0.0,0.0,0.0,0.0,0.0,0.0,1130.0,2.0,0.0,Matches,131.0,it ITA,GK,35.0,35.0,1130.0,1427.0,79.2,31355.0,20598.0,200.0,201.0,99.5,483.0,486.0,99.4,444.0,735.0,60.4,0.0,0.0,0.0,0.0,0.0,16.0,0.0,0.0,1.0,Matches,178,it ITA,GK,35,35,3150.0,90.0,92.1,35.0,35,90.0,35,0,,1,1.26,45.0,55.0,-10.0,-0.29,1.05,48.4,44.0,4.4,0.13,0.96,Matches,131.0,it ITA,GK,35.0,35.0,1480.0,1194.0,1468.0,11.0,1.0,0.0,1480.0,0.0,0.0,,0.0,,873.0,4354.0,2708.0,0.0,0.0,0.0,1.0,0.0,761.0,0.0,Matches,131.0,it ITA,GK,35.0,35.0,0.0,0.0,0.0,,0.0,0.0,,,,0.0,0.0,0.0,0.0,0.0,,0.0,0.0,Matches,131.0,it ITA,GK,35.0,35.0,35.0,3150.0,35.0,0.0,0.0,0.0,0.0,0.0,0.0,0.0,0.0,0.0,0.0,0.0,0.0,0.0,1.0,0.0,0.0,0.0,0.0,0.0,0.0,0.0,0.0,0.0,0.0,0.0,Matches,Andrea Consigli,GK,35,132,143,Italy,U.S. Sassuolo,5,3,2,3,11,9,3,2,2,2,11,1,1,10,10,15,14,12,13,10,12,17,6,14,6,14,13,14,10,14,12,15,14,10,11,13,14,3,14,4,13,11,13,13,5,13,15,14,15,12,14,14,13,16,4,18,13,17,16,18,20,1,1,1,1,1,1,1,1,1,1,1,1,1,189,82,5,20,347975206,6600,6600,5000,Mediterranean_Hispanic,132,3,1987/1/27,0,0,35577.0,,7990128
1144,Diego Coppola,Hellas Verona,2003,133.0,it ITA,DF,18.0,13.1,25.0,17.0,15.0,10.0,0.0,11.0,24.0,45.8,13.0,20.0,6.0,14.0,14.0,39.0,38.0,0.0,Matches,133.0,it ITA,DF,18.0,13.1,9.0,0.69,6.0,2.0,0.0,0.0,0.0,1.0,0.0,0.0,0.0,0.0,0.0,0.0,0.0,0.0,Matches,,,,,,,,,,,,,,,,,,,,,,,,,,,,,,,,,,,,,,,,,,,,,,,,,,,,,,,,133.0,it ITA,DF,18.0,13.1,5.0,0.0,0.0,10.0,0.0,0.0,3.0,14.0,17.0,0.0,1.0,0.0,70.0,47.0,34.0,58.0,Matches,133.0,it ITA,DF,18.0,13.1,557.0,499.0,55.0,12.0,0.0,2.0,3.0,43.0,0.0,0.0,0.0,0.0,403.0,3.0,10.0,Matches,133.0,it ITA,DF,18.0,13.1,403.0,557.0,72.4,7562.0,3275.0,145.0,174.0,83.3,222.0,271.0,81.9,32.0,83.0,38.6,0.0,0.0,0.2,0.0,0.0,30.0,3.0,1.0,42.0,Matches,181,it ITA,DF,18,19,1177.0,62.0,34.4,13.1,11,85.0,9,8,30.0,10,1.0,8.0,16.0,-8.0,-0.61,0.19,13.2,16.1,-2.9,-0.22,0.22,Matches,133.0,it ITA,DF,18.0,13.1,693.0,66.0,337.0,302.0,61.0,9.0,693.0,4.0,2.0,50.0,2.0,50.0,312.0,1618.0,787.0,9.0,9.0,0.0,8.0,2.0,320.0,8.0,Matches,133.0,it ITA,DF,18.0,13.1,0.0,3.0,0.0,0.0,0.23,0.0,0.0,,11.8,0.0,0.0,0.0,0.3,0.3,0.11,-0.3,-0.3,Matches,133.0,it ITA,DF,18.0,19.0,11.0,1177.0,13.1,0.0,0.0,0.0,0.0,0.0,0.0,5.0,0.0,0.3,0.3,0.0,0.3,9.0,42.0,8.0,0.0,0.0,0.0,0.0,0.0,0.03,0.0,0.03,0.03,0.03,Matches,Diego Coppola,D C,18,125,-85,Italy,Hellas Verona,5,5,10,5,11,4,14,5,11,13,11,6,15,11,15,13,14,12,14,7,12,13,4,8,5,13,11,14,13,12,12,14,11,13,14,15,13,10,13,6,12,2,3,3,3,2,3,1,1,1,2,3,15,15,8,13,15,14,12,13,1,1,20,1,1,1,1,1,1,1,1,1,1,1,192,0,10,20,47176001,6250,6250,1010,Mediterranean_Hispanic,125,2,2003/12/28,0,0,17799.0,,43500130
1145,Joaquín Correa,Inter,1994,135.0,ar ARG,FW,27.0,10.6,12.0,7.0,3.0,6.0,3.0,4.0,15.0,26.7,11.0,4.0,1.0,3.0,3.0,15.0,0.0,0.0,Matches,135.0,ar ARG,FW,27.0,10.6,37.0,3.51,27.0,0.0,3.0,5.0,2.0,0.0,3.0,0.28,3.0,0.0,0.0,0.0,0.0,0.0,Matches,,,,,,,,,,,,,,,,,,,,,,,,,,,,,,,,,,,,,,,,,,,,,,,,,,,,,,,,135.0,ar ARG,FW,27.0,10.6,1.0,0.0,0.0,12.0,18.0,2.0,2.0,3.0,7.0,0.0,0.0,0.0,41.0,4.0,12.0,25.0,Matches,135.0,ar ARG,FW,27.0,10.6,283.0,274.0,6.0,1.0,4.0,1.0,2.0,3.0,0.0,0.0,0.0,0.0,224.0,3.0,13.0,Matches,135.0,ar ARG,FW,27.0,10.6,224.0,283.0,79.2,3438.0,691.0,119.0,142.0,83.8,82.0,96.0,85.4,13.0,14.0,92.9,1.0,1.3,1.0,-0.3,15.0,23.0,9.0,0.0,29.0,Matches,183,ar ARG,FW,27,26,950.0,37.0,27.8,10.6,12,61.0,0,14,16.0,3,1.77,13.0,12.0,1.0,0.09,-0.93,16.5,11.8,4.7,0.45,-0.53,Matches,135.0,ar ARG,FW,27.0,10.6,384.0,2.0,25.0,183.0,183.0,37.0,384.0,32.0,14.0,43.8,13.0,40.6,260.0,1515.0,646.0,19.0,13.0,9.0,29.0,16.0,301.0,61.0,Matches,135.0,ar ARG,FW,27.0,10.6,3.0,22.0,8.0,36.4,2.08,0.76,0.14,0.38,13.6,0.0,0.0,0.0,3.4,3.4,0.16,-0.4,-0.4,Matches,135.0,ar ARG,FW,27.0,26.0,12.0,950.0,10.6,3.0,1.0,4.0,3.0,0.0,0.0,1.0,0.0,3.4,3.4,1.3,4.7,19.0,29.0,61.0,0.28,0.09,0.38,0.28,0.38,0.33,0.12,0.45,0.33,0.45,Matches,Joaquín Correa,AM/S LC,27,145,155,"Argentina,Italy",FC Internazionale Milano,13,11,16,13,16,10,11,13,3,4,14,12,5,17,9,14,9,13,9,13,11,13,17,7,14,6,12,9,16,15,11,12,14,17,12,11,11,8,13,10,14,2,1,3,3,2,3,2,2,4,2,2,12,15,2,12,13,17,16,10,1,1,1,1,1,1,1,10,1,8,15,18,12,20,188,75,13,20,9005434,7250,7100,6400,Mediterranean_Hispanic,140,5,1994/8/13,17,3,124615.0,,14042683
1146,Lassana Coulibaly,Salernitana,1996,137.0,ml MLI,MF,26.0,32.1,84.0,50.0,42.0,35.0,7.0,30.0,73.0,41.1,43.0,35.0,7.0,28.0,25.0,109.0,33.0,2.0,Matches,137.0,ml MLI,MF,26.0,32.1,56.0,1.74,51.0,1.0,1.0,0.0,3.0,0.0,10.0,0.31,10.0,0.0,0.0,0.0,0.0,0.0,Matches,,,,,,,,,,,,,,,,,,,,,,,,,,,,,,,,,,,,,,,,,,,,,,,,,,,,,,,,137.0,ml MLI,MF,26.0,32.1,12.0,0.0,0.0,53.0,50.0,1.0,10.0,25.0,50.0,0.0,0.0,0.0,222.0,29.0,38.0,43.3,Matches,137.0,ml MLI,MF,26.0,32.1,1174.0,1149.0,23.0,20.0,3.0,5.0,10.0,3.0,0.0,0.0,0.0,0.0,978.0,2.0,26.0,Matches,137.0,ml MLI,MF,26.0,32.1,978.0,1174.0,83.3,15588.0,4473.0,489.0,554.0,88.3,399.0,453.0,88.1,57.0,92.0,62.0,3.0,1.8,1.5,1.2,20.0,91.0,10.0,1.0,120.0,Matches,185,ml MLI,MF,26,35,2892.0,83.0,84.6,32.1,34,84.0,24,1,34.0,0,1.11,42.0,57.0,-15.0,-0.47,-0.64,30.6,57.2,-26.5,-0.83,-0.16,Matches,137.0,ml MLI,MF,26.0,32.1,1540.0,86.0,399.0,933.0,245.0,17.0,1540.0,93.0,48.0,51.6,39.0,41.9,917.0,5811.0,2571.0,52.0,39.0,7.0,61.0,33.0,962.0,59.0,Matches,137.0,ml MLI,MF,26.0,32.1,3.0,16.0,6.0,37.5,0.5,0.19,0.19,0.5,20.8,0.0,0.0,0.0,0.8,0.8,0.05,2.2,2.2,Matches,137.0,ml MLI,MF,26.0,35.0,34.0,2892.0,32.1,3.0,3.0,6.0,3.0,0.0,0.0,12.0,0.0,0.8,0.8,1.8,2.6,52.0,120.0,59.0,0.09,0.09,0.19,0.09,0.19,0.03,0.06,0.08,0.03,0.08,Matches,Lassana Coulibaly,M C,26,129,135,Mali,U.S. Salernitana 1919,7,8,15,8,12,7,13,8,6,11,12,8,16,9,15,15,16,11,12,11,12,10,6,8,15,14,15,16,15,13,16,12,14,13,17,15,13,8,9,4,13,2,2,3,3,3,2,1,3,1,2,3,10,8,3,12,12,13,14,14,1,1,1,1,1,1,14,1,20,1,1,14,1,1,183,74,8,20,3346314,6450,6300,3750,African_Caribbean,128,15,1996/4/10,29,0,14806.0,,48036752
1147,Bryan Cristante,Roma,1995,139.0,it ITA,MFDF,27.0,32.6,113.0,62.0,55.0,49.0,9.0,55.0,90.0,61.1,35.0,39.0,10.0,29.0,18.0,131.0,53.0,0.0,Matches,139.0,it ITA,MFDF,27.0,32.6,42.0,1.29,37.0,0.0,0.0,5.0,0.0,0.0,7.0,0.21,5.0,0.0,0.0,2.0,0.0,0.0,Matches,,,,,,,,,,,,,,,,,,,,,,,,,,,,,,,,,,,,,,,,,,,,,,,,,,,,,,,,139.0,it ITA,MFDF,27.0,32.6,8.0,1.0,0.0,52.0,19.0,2.0,11.0,18.0,62.0,0.0,0.0,0.0,209.0,75.0,41.0,64.7,Matches,139.0,it ITA,MFDF,27.0,32.6,1679.0,1611.0,63.0,60.0,6.0,31.0,11.0,3.0,0.0,0.0,0.0,0.0,1381.0,5.0,19.0,Matches,139.0,it ITA,MFDF,27.0,32.6,1381.0,1679.0,82.3,25923.0,8226.0,571.0,647.0,88.3,590.0,666.0,88.6,182.0,296.0,61.5,1.0,1.4,2.0,-0.4,16.0,157.0,17.0,4.0,142.0,Matches,187,it ITA,MFDF,27,36,2938.0,82.0,85.9,32.6,34,85.0,26,2,24.0,0,1.67,36.0,27.0,9.0,0.28,-0.28,45.6,24.6,20.9,0.64,-0.18,Matches,139.0,it ITA,MFDF,27.0,32.6,1994.0,99.0,559.0,1257.0,196.0,39.0,1993.0,13.0,9.0,69.2,3.0,23.1,1043.0,4607.0,2063.0,16.0,13.0,4.0,25.0,11.0,1290.0,27.0,Matches,139.0,it ITA,MFDF,27.0,32.6,1.0,28.0,5.0,17.9,0.86,0.15,0.04,0.2,16.8,0.0,0.0,1.0,2.6,1.9,0.07,-1.6,-0.9,Matches,139.0,it ITA,MFDF,27.0,36.0,34.0,2938.0,32.6,1.0,1.0,2.0,1.0,0.0,1.0,8.0,1.0,2.6,1.9,1.4,3.3,16.0,142.0,27.0,0.03,0.03,0.06,0.03,0.06,0.08,0.04,0.12,0.06,0.1,Matches,Bryan Cristante,DM/M C,27,145,150,"Italy,Canada",Associazione Sportiva Roma,8,11,12,12,14,8,17,16,8,12,16,12,15,14,6,13,15,16,10,13,15,14,8,14,14,13,19,16,8,9,16,16,17,12,16,15,15,12,11,5,11,1,1,4,3,2,1,1,1,3,1,2,7,15,3,15,14,19,18,18,1,1,15,1,1,1,20,1,20,1,1,10,1,1,188,82,12,20,50047696,7250,7600,6250,Mediterranean_Hispanic,145,2,1995/3/3,27,2,64038.0,,43091113
1148,Juan Cuadrado,Juventus,1988,141.0,co COL,DFFW,34.0,23.1,50.0,34.0,34.0,13.0,3.0,27.0,65.0,41.5,38.0,15.0,2.0,13.0,24.0,74.0,32.0,0.0,Matches,141.0,co COL,DFFW,34.0,23.1,78.0,3.38,43.0,20.0,5.0,3.0,7.0,0.0,6.0,0.26,2.0,2.0,0.0,0.0,2.0,0.0,Matches,,,,,,,,,,,,,,,,,,,,,,,,,,,,,,,,,,,,,,,,,,,,,,,,,,,,,,,,141.0,co COL,DFFW,34.0,23.1,6.0,1.0,0.0,33.0,44.0,2.0,83.0,24.0,34.0,1.0,0.0,0.0,115.0,11.0,13.0,45.8,Matches,141.0,co COL,DFFW,34.0,23.1,1323.0,1126.0,193.0,29.0,0.0,28.0,83.0,128.0,36.0,12.0,21.0,0.0,1113.0,4.0,17.0,Matches,141.0,co COL,DFFW,34.0,23.1,1113.0,1323.0,84.1,21481.0,5507.0,468.0,520.0,90.0,460.0,526.0,87.5,170.0,231.0,73.6,3.0,2.7,2.3,0.3,42.0,62.0,24.0,10.0,92.0,Matches,190,co COL,DFFW,34,31,2078.0,67.0,60.8,23.1,24,77.0,10,7,32.0,0,2.03,35.0,15.0,20.0,0.87,0.67,33.1,23.5,9.7,0.42,0.15,Matches,141.0,co COL,DFFW,34.0,23.1,1581.0,41.0,400.0,758.0,433.0,50.0,1581.0,59.0,25.0,42.4,22.0,37.3,914.0,4703.0,2541.0,48.0,35.0,20.0,35.0,14.0,1057.0,125.0,Matches,141.0,co COL,DFFW,34.0,23.1,1.0,32.0,10.0,31.3,1.39,0.43,0.03,0.1,21.0,6.0,0.0,0.0,1.4,1.4,0.04,-0.4,-0.4,Matches,141.0,co COL,DFFW,34.0,31.0,24.0,2078.0,23.1,1.0,3.0,4.0,1.0,0.0,0.0,6.0,1.0,1.4,1.4,2.7,4.2,48.0,92.0,125.0,0.04,0.13,0.17,0.04,0.17,0.06,0.12,0.18,0.06,0.18,Matches,Juan Cuadrado,D/WB/M/AM R,34,152,163,"Colombia,Italy",Juventus,12,15,16,10,15,10,7,13,6,13,15,9,13,17,16,12,13,12,12,15,11,19,16,12,15,13,11,15,16,16,12,8,19,15,13,9,15,15,12,10,15,1,1,2,1,3,1,2,2,2,1,2,15,14,6,13,16,19,8,14,1,12,1,19,12,20,1,10,1,20,10,1,16,1,179,72,9,20,5383992,7600,7850,7600,African_Caribbean,142,13,1988/5/26,113,10,178076.0,,76010707
1149,Flavius Daniliuc,Salernitana,2001,146.0,at AUT,DF,21.0,24.4,57.0,29.0,37.0,17.0,3.0,26.0,47.0,55.3,21.0,30.0,13.0,17.0,29.0,86.0,76.0,0.0,Matches,146.0,at AUT,DF,21.0,24.4,18.0,0.74,15.0,1.0,0.0,2.0,0.0,0.0,0.0,0.0,0.0,0.0,0.0,0.0,0.0,0.0,Matches,,,,,,,,,,,,,,,,,,,,,,,,,,,,,,,,,,,,,,,,,,,,,,,,,,,,,,,,146.0,at AUT,DF,21.0,24.4,9.0,0.0,0.0,33.0,4.0,0.0,0.0,29.0,29.0,0.0,0.0,0.0,132.0,39.0,28.0,58.2,Matches,146.0,at AUT,DF,21.0,24.4,1127.0,1078.0,46.0,37.0,0.0,10.0,0.0,9.0,0.0,0.0,0.0,0.0,969.0,3.0,11.0,Matches,146.0,at AUT,DF,21.0,24.4,969.0,1127.0,86.0,18211.0,7113.0,377.0,415.0,90.8,475.0,524.0,90.6,101.0,153.0,66.0,2.0,0.5,0.2,1.5,7.0,56.0,2.0,0.0,70.0,Matches,197,at AUT,DF,21,27,2195.0,81.0,64.2,24.4,23,87.0,19,4,46.0,4,1.0,29.0,39.0,-10.0,-0.41,-0.12,22.4,43.4,-21.0,-0.86,-0.17,Matches,146.0,at AUT,DF,21.0,24.4,1374.0,200.0,757.0,572.0,58.0,16.0,1374.0,5.0,2.0,40.0,3.0,60.0,727.0,3691.0,1769.0,14.0,10.0,0.0,14.0,4.0,843.0,5.0,Matches,146.0,at AUT,DF,21.0,24.4,0.0,10.0,4.0,40.0,0.41,0.16,0.0,0.0,13.1,1.0,0.0,0.0,0.6,0.6,0.07,-0.6,-0.6,Matches,146.0,at AUT,DF,21.0,27.0,23.0,2195.0,24.4,0.0,2.0,2.0,0.0,0.0,0.0,9.0,0.0,0.6,0.6,0.5,1.2,14.0,70.0,5.0,0.0,0.08,0.08,0.0,0.08,0.03,0.02,0.05,0.03,0.05,Matches,Flavius Daniliuc,D RC,21,126,157,"Austria,Romania",U.S. Salernitana 1919,6,7,12,6,12,5,13,7,11,13,14,7,15,12,14,13,13,10,10,12,13,15,11,6,8,13,15,13,13,11,13,13,16,13,13,15,14,8,14,7,16,1,3,3,3,3,3,2,2,4,2,1,11,13,5,13,12,15,13,13,1,13,20,17,10,12,10,1,1,1,1,1,1,1,188,83,13,20,9339999,6300,5900,3250,Mediterranean_Hispanic,126,1,2001/4/27,0,0,12466.0,,91172522
1150,Matteo Darmian,Inter,1989,148.0,it ITA,DF,32.0,22.5,56.0,30.0,29.0,15.0,12.0,31.0,47.0,66.0,16.0,33.0,5.0,28.0,21.0,77.0,36.0,0.0,Matches,148.0,it ITA,DF,32.0,22.5,39.0,1.73,33.0,4.0,0.0,0.0,1.0,1.0,4.0,0.18,3.0,0.0,0.0,0.0,1.0,0.0,Matches,,,,,,,,,,,,,,,,,,,,,,,,,,,,,,,,,,,,,,,,,,,,,,,,,,,,,,,,148.0,it ITA,DF,32.0,22.5,3.0,0.0,0.0,21.0,20.0,3.0,28.0,21.0,30.0,0.0,0.0,0.0,121.0,15.0,23.0,39.5,Matches,148.0,it ITA,DF,32.0,22.5,1376.0,1246.0,127.0,18.0,2.0,16.0,28.0,109.0,0.0,0.0,0.0,0.0,1190.0,3.0,17.0,Matches,148.0,it ITA,DF,32.0,22.5,1190.0,1376.0,86.5,21419.0,7160.0,477.0,512.0,93.2,598.0,664.0,90.1,97.0,155.0,62.6,2.0,1.9,2.0,0.1,19.0,68.0,18.0,10.0,88.0,Matches,200,it ITA,DF,32,31,2025.0,65.0,59.2,22.5,24,80.0,10,7,16.0,5,1.84,30.0,22.0,8.0,0.36,-1.0,37.5,19.3,18.3,0.81,-0.05,Matches,148.0,it ITA,DF,32.0,22.5,1564.0,94.0,580.0,754.0,241.0,23.0,1564.0,25.0,9.0,36.0,9.0,36.0,914.0,3627.0,1984.0,22.0,18.0,4.0,14.0,10.0,1087.0,96.0,Matches,148.0,it ITA,DF,32.0,22.5,1.0,7.0,1.0,14.3,0.31,0.04,0.14,1.0,20.5,0.0,0.0,0.0,1.0,1.0,0.14,0.0,0.0,Matches,148.0,it ITA,DF,32.0,31.0,24.0,2025.0,22.5,1.0,2.0,3.0,1.0,0.0,0.0,3.0,0.0,1.0,1.0,1.9,2.9,22.0,88.0,96.0,0.04,0.09,0.13,0.04,0.13,0.04,0.09,0.13,0.04,0.13,Matches,Matteo Darmian,D/WB/M RLC,32,142,146,Italy,FC Internazionale Milano,4,12,10,10,13,3,11,8,10,13,12,4,15,12,12,13,14,13,15,10,12,17,5,10,13,14,16,15,13,14,15,11,17,13,14,13,15,9,14,5,17,4,2,3,2,3,1,2,3,3,2,3,10,16,8,14,15,18,18,18,1,16,15,20,17,20,1,15,1,18,1,1,1,1,183,70,11,20,5762053,7100,6750,5900,Northern_European,132,4,1989/12/2,36,1,49230.0,,7990060
1151,Paweł Dawidowicz,Hellas Verona,1995,150.0,pl POL,DF,27.0,18.1,48.0,31.0,28.0,17.0,3.0,22.0,31.0,71.0,9.0,14.0,9.0,5.0,23.0,71.0,71.0,0.0,Matches,150.0,pl POL,DF,27.0,18.1,16.0,0.88,13.0,1.0,0.0,1.0,0.0,1.0,1.0,0.06,0.0,0.0,0.0,1.0,0.0,0.0,Matches,,,,,,,,,,,,,,,,,,,,,,,,,,,,,,,,,,,,,,,,,,,,,,,,,,,,,,,,150.0,pl POL,DF,27.0,18.1,6.0,1.0,0.0,37.0,13.0,1.0,13.0,23.0,31.0,0.0,0.0,0.0,120.0,43.0,27.0,61.4,Matches,150.0,pl POL,DF,27.0,18.1,827.0,756.0,70.0,31.0,1.0,1.0,13.0,39.0,0.0,0.0,0.0,0.0,613.0,1.0,11.0,Matches,150.0,pl POL,DF,27.0,18.1,613.0,827.0,74.1,11131.0,4374.0,258.0,296.0,87.2,277.0,354.0,78.2,69.0,146.0,47.3,1.0,0.8,0.3,0.2,5.0,47.0,2.0,0.0,60.0,Matches,202,pl POL,DF,27,23,1632.0,71.0,47.7,18.1,20,78.0,14,3,26.0,6,1.08,16.0,27.0,-11.0,-0.61,0.25,16.8,20.9,-4.1,-0.23,0.27,Matches,150.0,pl POL,DF,27.0,18.1,1019.0,91.0,484.0,450.0,96.0,17.0,1019.0,8.0,1.0,12.5,4.0,50.0,463.0,2270.0,1282.0,20.0,13.0,1.0,8.0,4.0,498.0,17.0,Matches,150.0,pl POL,DF,27.0,18.1,1.0,11.0,2.0,18.2,0.61,0.11,0.09,0.5,10.7,0.0,0.0,0.0,1.1,1.1,0.1,-0.1,-0.1,Matches,150.0,pl POL,DF,27.0,23.0,20.0,1632.0,18.1,1.0,1.0,2.0,1.0,0.0,0.0,6.0,1.0,1.1,1.1,0.8,1.9,20.0,60.0,17.0,0.06,0.06,0.11,0.06,0.11,0.06,0.04,0.11,0.06,0.11,Matches,Paweł Dawidowicz,D C,27,129,134,Poland,Hellas Verona,6,8,10,7,11,6,14,9,7,15,11,8,15,11,15,12,14,11,12,10,12,14,8,10,5,14,14,12,11,10,13,16,14,12,13,17,13,6,14,9,13,1,2,3,4,2,4,3,2,1,1,2,13,15,6,12,12,15,14,13,1,1,20,11,1,1,15,1,10,1,1,1,1,1,189,80,8,20,3170192,6450,5801,5000,Northern_European,126,4,1995/5/20,8,0,7307.0,,96044665
1152,Charles De Ketelaere,Milan,2001,151.0,be BEL,MFFW,21.0,12.4,26.0,12.0,7.0,14.0,5.0,13.0,30.0,43.3,17.0,14.0,2.0,12.0,4.0,30.0,9.0,0.0,Matches,151.0,be BEL,MFFW,21.0,12.4,47.0,3.79,39.0,2.0,4.0,0.0,2.0,0.0,2.0,0.16,2.0,0.0,0.0,0.0,0.0,0.0,Matches,,,,,,,,,,,,,,,,,,,,,,,,,,,,,,,,,,,,,,,,,,,,,,,,,,,,,,,,151.0,be BEL,MFFW,21.0,12.4,2.0,0.0,0.0,19.0,15.0,2.0,10.0,4.0,12.0,0.0,0.0,0.0,56.0,19.0,30.0,38.8,Matches,151.0,be BEL,MFFW,21.0,12.4,383.0,362.0,21.0,2.0,2.0,2.0,10.0,9.0,0.0,0.0,0.0,0.0,299.0,0.0,13.0,Matches,151.0,be BEL,MFFW,21.0,12.4,299.0,383.0,78.1,4161.0,1234.0,183.0,225.0,81.3,95.0,110.0,86.4,11.0,16.0,68.8,1.0,2.0,1.8,-1.0,20.0,28.0,19.0,0.0,59.0,Matches,203,be BEL,MFFW,21,32,1116.0,35.0,32.6,12.4,9,67.0,0,23,22.0,5,1.78,19.0,19.0,0.0,0.0,-0.82,20.3,16.1,4.2,0.34,-0.19,Matches,151.0,be BEL,MFFW,21.0,12.4,533.0,10.0,50.0,241.0,252.0,60.0,533.0,59.0,36.0,61.0,16.0,27.1,313.0,2178.0,1149.0,45.0,26.0,14.0,25.0,30.0,351.0,69.0,Matches,151.0,be BEL,MFFW,21.0,12.4,0.0,19.0,3.0,15.8,1.53,0.24,0.0,0.0,12.5,0.0,0.0,0.0,2.0,2.0,0.11,-2.0,-2.0,Matches,151.0,be BEL,MFFW,21.0,32.0,9.0,1116.0,12.4,0.0,1.0,1.0,0.0,0.0,0.0,2.0,0.0,2.0,2.0,2.0,4.0,45.0,59.0,69.0,0.0,0.08,0.08,0.0,0.08,0.16,0.16,0.32,0.16,0.32,Matches,Charles De Ketelaere,M/AM/S C,21,145,169,Belgium,AC Milan,10,11,15,13,16,10,13,12,11,7,15,12,10,16,12,14,13,14,14,15,14,15,17,8,14,10,15,13,13,12,14,15,12,14,13,12,13,8,10,6,18,2,3,2,2,2,4,1,2,2,2,3,11,14,11,13,14,15,15,7,1,1,1,1,1,1,1,12,16,12,13,20,13,18,192,80,20,9,72036004,7250,7000,6250,Northern_European,142,2,2001/3/10,8,1,54231.0,,18110528
1153,Mattia De Sciglio,Juventus,1992,154.0,it ITA,DF,29.0,11.6,14.0,7.0,8.0,3.0,3.0,9.0,14.0,64.3,5.0,9.0,3.0,6.0,4.0,18.0,20.0,0.0,Matches,154.0,it ITA,DF,29.0,11.6,15.0,1.3,14.0,0.0,0.0,0.0,1.0,0.0,1.0,0.09,1.0,0.0,0.0,0.0,0.0,0.0,Matches,,,,,,,,,,,,,,,,,,,,,,,,,,,,,,,,,,,,,,,,,,,,,,,,,,,,,,,,154.0,it ITA,DF,29.0,11.6,0.0,0.0,0.0,4.0,11.0,0.0,26.0,4.0,7.0,0.0,0.0,0.0,40.0,10.0,11.0,47.6,Matches,154.0,it ITA,DF,29.0,11.6,569.0,475.0,93.0,7.0,0.0,6.0,26.0,86.0,0.0,0.0,0.0,0.0,450.0,1.0,4.0,Matches,154.0,it ITA,DF,29.0,11.6,450.0,569.0,79.1,8035.0,3019.0,189.0,227.0,83.3,213.0,252.0,84.5,44.0,75.0,58.7,0.0,0.5,0.4,-0.5,8.0,51.0,8.0,6.0,50.0,Matches,207,it ITA,DF,29,17,1042.0,61.0,30.5,11.6,11,76.0,4,6,34.0,2,2.18,17.0,8.0,9.0,0.78,0.25,13.4,12.4,0.9,0.08,-0.4,Matches,154.0,it ITA,DF,29.0,11.6,652.0,30.0,190.0,338.0,127.0,4.0,652.0,9.0,2.0,22.2,3.0,33.3,343.0,1610.0,755.0,16.0,12.0,0.0,8.0,7.0,406.0,40.0,Matches,154.0,it ITA,DF,29.0,11.6,0.0,4.0,0.0,0.0,0.35,0.0,0.0,,27.6,0.0,0.0,0.0,0.1,0.1,0.02,-0.1,-0.1,Matches,154.0,it ITA,DF,29.0,17.0,11.0,1042.0,11.6,0.0,0.0,0.0,0.0,0.0,0.0,0.0,0.0,0.1,0.1,0.5,0.6,16.0,50.0,40.0,0.0,0.0,0.0,0.0,0.0,0.01,0.04,0.05,0.01,0.05,Matches,Mattia De Sciglio,D/WB RL,29,136,146,Italy,Juventus,11,13,11,7,13,5,12,12,10,13,13,7,13,13,7,14,10,11,11,11,12,12,7,6,11,14,18,15,13,14,13,11,10,14,13,13,14,8,10,17,15,1,2,2,1,3,4,1,2,1,1,1,13,13,1,14,11,20,19,18,1,19,10,20,18,19,1,11,1,11,1,1,1,1,182,78,12,20,6088906,6800,6800,5750,Mediterranean_Hispanic,130,2,1992/10/20,39,0,53462.0,,43037008
1154,Koni De Winter,Empoli,2002,156.0,be BEL,DF,20.0,11.4,14.0,9.0,11.0,3.0,0.0,5.0,13.0,38.5,8.0,14.0,12.0,2.0,6.0,20.0,65.0,0.0,Matches,156.0,be BEL,DF,20.0,11.4,5.0,0.44,5.0,0.0,0.0,0.0,0.0,0.0,0.0,0.0,0.0,0.0,0.0,0.0,0.0,0.0,Matches,,,,,,,,,,,,,,,,,,,,,,,,,,,,,,,,,,,,,,,,,,,,,,,,,,,,,,,,156.0,be BEL,DF,20.0,11.4,3.0,0.0,0.0,13.0,2.0,0.0,0.0,6.0,9.0,0.0,0.0,0.0,58.0,16.0,11.0,59.3,Matches,156.0,be BEL,DF,20.0,11.4,494.0,473.0,21.0,13.0,0.0,0.0,0.0,1.0,0.0,0.0,0.0,0.0,424.0,0.0,2.0,Matches,156.0,be BEL,DF,20.0,11.4,424.0,494.0,85.8,7908.0,2790.0,166.0,181.0,91.7,226.0,249.0,90.8,31.0,58.0,53.4,0.0,0.2,0.1,-0.2,2.0,15.0,1.0,0.0,22.0,Matches,209,be BEL,DF,20,14,1024.0,73.0,29.9,11.4,12,83.0,10,2,15.0,13,1.0,9.0,17.0,-8.0,-0.7,-0.55,9.8,22.1,-12.3,-1.08,-0.82,Matches,156.0,be BEL,DF,20.0,11.4,614.0,118.0,405.0,207.0,6.0,0.0,614.0,2.0,1.0,50.0,1.0,50.0,347.0,1854.0,819.0,2.0,1.0,0.0,8.0,3.0,370.0,0.0,Matches,156.0,be BEL,DF,20.0,11.4,0.0,0.0,0.0,,0.0,0.0,,,,0.0,0.0,0.0,0.0,0.0,,0.0,0.0,Matches,156.0,be BEL,DF,20.0,14.0,12.0,1024.0,11.4,0.0,0.0,0.0,0.0,0.0,0.0,3.0,0.0,0.0,0.0,0.2,0.2,2.0,22.0,0.0,0.0,0.0,0.0,0.0,0.0,0.0,0.01,0.01,0.0,0.01,Matches,Koni De Winter,D C,20,118,-75,Belgium,Juventus,7,10,12,7,12,8,13,7,6,13,12,7,13,11,9,13,11,11,10,11,12,15,11,9,8,13,13,10,12,12,14,13,16,14,13,13,13,7,12,5,19,1,3,4,1,2,1,2,3,2,4,3,14,14,7,12,11,14,11,11,1,1,20,14,1,1,11,1,7,1,1,1,1,1,191,78,10,20,46000000,5900,4653,3160,Mixed_Race,118,11,2002/6/12,0,0,6811.0,Empoli Football Club,18108550
1155,Grégoire Defrel,Sassuolo,1991,157.0,mq MTQ,FW,31.0,13.0,9.0,7.0,5.0,2.0,2.0,4.0,13.0,30.8,9.0,11.0,0.0,11.0,2.0,11.0,5.0,0.0,Matches,157.0,mq MTQ,FW,31.0,13.0,16.0,1.23,14.0,0.0,0.0,1.0,1.0,0.0,1.0,0.08,1.0,0.0,0.0,0.0,0.0,0.0,Matches,,,,,,,,,,,,,,,,,,,,,,,,,,,,,,,,,,,,,,,,,,,,,,,,,,,,,,,,157.0,mq MTQ,FW,31.0,13.0,3.0,0.0,0.0,14.0,14.0,6.0,1.0,2.0,7.0,0.0,0.0,0.0,29.0,6.0,24.0,20.0,Matches,157.0,mq MTQ,FW,31.0,13.0,250.0,219.0,31.0,0.0,1.0,1.0,1.0,1.0,2.0,1.0,0.0,0.0,211.0,0.0,5.0,Matches,157.0,mq MTQ,FW,31.0,13.0,211.0,250.0,84.4,2451.0,347.0,138.0,151.0,91.4,46.0,56.0,82.1,3.0,9.0,33.3,1.0,0.5,0.2,0.5,9.0,12.0,1.0,0.0,10.0,Matches,210,mq MTQ,FW,31,27,1167.0,43.0,34.1,13.0,13,65.0,0,14,23.0,0,1.26,13.0,24.0,-11.0,-0.85,-0.73,14.4,17.1,-2.7,-0.21,-0.39,Matches,157.0,mq MTQ,FW,31.0,13.0,362.0,7.0,34.0,175.0,159.0,34.0,362.0,21.0,7.0,33.3,14.0,66.7,216.0,1003.0,331.0,11.0,12.0,2.0,28.0,17.0,254.0,75.0,Matches,157.0,mq MTQ,FW,31.0,13.0,2.0,16.0,10.0,62.5,1.23,0.77,0.13,0.2,11.8,0.0,0.0,0.0,3.5,3.5,0.22,-1.5,-1.5,Matches,157.0,mq MTQ,FW,31.0,27.0,13.0,1167.0,13.0,2.0,1.0,3.0,2.0,0.0,0.0,3.0,0.0,3.5,3.5,0.5,4.0,11.0,10.0,75.0,0.15,0.08,0.23,0.15,0.23,0.27,0.04,0.31,0.27,0.31,Matches,Grégoire Defrel,AM/S RC,31,123,146,"France,Martinique",U.S. Sassuolo,4,7,13,12,13,5,9,9,4,4,13,13,4,14,11,12,10,13,9,13,13,12,15,6,16,4,15,13,15,15,13,8,12,16,12,10,10,10,11,12,14,1,2,2,3,1,2,1,2,3,3,3,13,11,10,12,6,14,13,12,1,1,1,1,1,1,1,1,1,1,14,16,15,20,179,77,20,10,341684,6150,6400,5250,Mixed_Race,118,10,1991/6/17,0,0,30191.0,,43070623
1156,Merih Demiral,Atalanta,1998,159.0,tr TUR,DF,24.0,17.1,41.0,29.0,30.0,11.0,0.0,26.0,36.0,72.2,10.0,24.0,7.0,17.0,24.0,65.0,57.0,1.0,Matches,159.0,tr TUR,DF,24.0,17.1,4.0,0.23,4.0,0.0,0.0,0.0,0.0,0.0,0.0,0.0,0.0,0.0,0.0,0.0,0.0,0.0,Matches,,,,,,,,,,,,,,,,,,,,,,,,,,,,,,,,,,,,,,,,,,,,,,,,,,,,,,,,159.0,tr TUR,DF,24.0,17.1,5.0,0.0,0.0,13.0,13.0,1.0,2.0,24.0,29.0,0.0,0.0,0.0,123.0,52.0,29.0,64.2,Matches,159.0,tr TUR,DF,24.0,17.1,653.0,587.0,66.0,41.0,0.0,3.0,2.0,2.0,0.0,0.0,0.0,0.0,560.0,0.0,1.0,Matches,159.0,tr TUR,DF,24.0,17.1,560.0,653.0,85.8,10454.0,2949.0,204.0,225.0,90.7,293.0,330.0,88.8,54.0,85.0,63.5,0.0,0.5,0.5,-0.5,4.0,14.0,1.0,1.0,26.0,Matches,215,tr TUR,DF,24,28,1536.0,55.0,44.9,17.1,14,87.0,12,14,23.0,6,1.89,24.0,23.0,1.0,0.06,-0.75,26.5,17.9,8.5,0.5,0.13,Matches,159.0,tr TUR,DF,24.0,17.1,832.0,140.0,495.0,319.0,28.0,14.0,832.0,9.0,2.0,22.2,5.0,55.6,348.0,1662.0,564.0,3.0,5.0,1.0,6.0,2.0,374.0,4.0,Matches,159.0,tr TUR,DF,24.0,17.1,1.0,6.0,1.0,16.7,0.35,0.06,0.17,1.0,13.7,0.0,0.0,0.0,0.7,0.7,0.12,0.3,0.3,Matches,159.0,tr TUR,DF,24.0,28.0,14.0,1536.0,17.1,1.0,0.0,1.0,1.0,0.0,0.0,5.0,0.0,0.7,0.7,0.5,1.2,3.0,26.0,4.0,0.06,0.0,0.06,0.06,0.06,0.04,0.03,0.07,0.04,0.07,Matches,Merih Demiral,D C,24,145,158,Turkey,Atalanta,4,5,8,7,10,4,15,6,5,16,12,5,17,11,19,15,19,10,11,9,13,18,6,14,6,14,15,16,13,12,13,15,15,16,15,17,14,16,13,12,5,1,3,1,2,1,1,4,1,2,1,3,14,17,6,8,15,15,10,11,1,1,20,12,1,1,1,1,1,1,1,1,1,1,192,85,7,20,38896975,7250,7450,6450,Mediterranean_Hispanic,143,6,1998/3/5,35,2,71154.0,,83176849
1157,Fabio Depaoli,Hellas Verona,1997,161.0,it ITA,DF,25.0,24.1,48.0,28.0,25.0,16.0,7.0,25.0,44.0,56.8,19.0,32.0,6.0,26.0,18.0,66.0,33.0,3.0,Matches,161.0,it ITA,DF,25.0,24.1,43.0,1.78,27.0,9.0,1.0,0.0,5.0,1.0,4.0,0.17,3.0,1.0,0.0,0.0,0.0,0.0,Matches,,,,,,,,,,,,,,,,,,,,,,,,,,,,,,,,,,,,,,,,,,,,,,,,,,,,,,,,161.0,it ITA,DF,25.0,24.1,7.0,0.0,0.0,43.0,31.0,4.0,60.0,18.0,28.0,0.0,0.0,0.0,113.0,24.0,39.0,38.1,Matches,161.0,it ITA,DF,25.0,24.1,685.0,499.0,183.0,5.0,1.0,2.0,60.0,176.0,2.0,1.0,1.0,0.0,440.0,3.0,17.0,Matches,161.0,it ITA,DF,25.0,24.1,440.0,685.0,64.2,8131.0,4636.0,178.0,231.0,77.1,203.0,293.0,69.3,51.0,116.0,44.0,2.0,1.2,1.3,0.8,16.0,40.0,22.0,13.0,66.0,Matches,217,it ITA,DF,25,31,2173.0,70.0,63.5,24.1,24,85.0,18,7,20.0,2,0.91,20.0,39.0,-19.0,-0.79,-0.14,21.9,33.0,-11.1,-0.46,-0.24,Matches,161.0,it ITA,DF,25.0,24.1,953.0,51.0,238.0,411.0,317.0,35.0,953.0,46.0,11.0,23.9,27.0,58.7,408.0,1989.0,972.0,28.0,14.0,4.0,38.0,18.0,422.0,76.0,Matches,161.0,it ITA,DF,25.0,24.1,2.0,19.0,4.0,21.1,0.79,0.17,0.11,0.5,16.0,0.0,0.0,0.0,1.7,1.7,0.09,0.3,0.3,Matches,161.0,it ITA,DF,25.0,31.0,24.0,2173.0,24.1,2.0,2.0,4.0,2.0,0.0,0.0,7.0,0.0,1.7,1.7,1.2,2.9,28.0,66.0,76.0,0.08,0.08,0.17,0.08,0.17,0.07,0.05,0.12,0.07,0.12,Matches,Fabio Depaoli,D/WB/M R,25,128,136,Italy,U.C. Sampdoria,10,13,10,7,12,8,9,10,14,10,12,9,12,13,14,11,10,10,13,12,13,15,13,10,12,12,13,14,13,14,14,6,14,14,15,10,14,8,11,5,16,2,2,2,1,2,1,3,2,3,3,1,12,13,13,13,13,16,14,13,1,10,1,20,12,20,1,10,1,19,1,1,12,1,178,71,11,20,2821337,6400,6400,4600,Mediterranean_Hispanic,121,4,1997/4/24,0,0,10672.0,Hellas Verona,43161628
1158,Cyriel Dessers,Cremonese,1994,164.0,ng NGA,FW,27.0,17.6,11.0,4.0,4.0,4.0,3.0,2.0,6.0,33.3,4.0,14.0,2.0,12.0,3.0,14.0,5.0,0.0,Matches,164.0,ng NGA,FW,27.0,17.6,44.0,2.49,28.0,2.0,5.0,5.0,3.0,1.0,2.0,0.11,1.0,0.0,1.0,0.0,0.0,0.0,Matches,,,,,,,,,,,,,,,,,,,,,,,,,,,,,,,,,,,,,,,,,,,,,,,,,,,,,,,,164.0,ng NGA,FW,27.0,17.6,3.0,0.0,0.0,34.0,14.0,24.0,8.0,3.0,4.0,0.0,0.0,0.0,30.0,16.0,48.0,25.0,Matches,164.0,ng NGA,FW,27.0,17.6,280.0,250.0,29.0,0.0,1.0,1.0,8.0,3.0,0.0,0.0,0.0,0.0,180.0,1.0,9.0,Matches,164.0,ng NGA,FW,27.0,17.6,180.0,280.0,64.3,2509.0,437.0,107.0,153.0,69.9,58.0,81.0,71.6,7.0,14.0,50.0,1.0,1.6,1.5,-0.6,23.0,11.0,8.0,1.0,27.0,Matches,220,ng NGA,FW,27,26,1587.0,61.0,46.4,17.6,19,74.0,7,7,27.0,2,0.5,15.0,36.0,-21.0,-1.19,-0.6,18.4,33.3,-14.9,-0.84,-0.23,Matches,164.0,ng NGA,FW,27.0,17.6,466.0,8.0,18.0,162.0,289.0,115.0,465.0,36.0,13.0,36.1,22.0,61.1,268.0,1302.0,530.0,21.0,10.0,24.0,61.0,21.0,340.0,110.0,Matches,164.0,ng NGA,FW,27.0,17.6,6.0,49.0,12.0,24.5,2.78,0.68,0.12,0.5,13.6,0.0,0.0,1.0,7.1,6.4,0.13,-1.1,-0.4,Matches,164.0,ng NGA,FW,27.0,26.0,19.0,1587.0,17.6,6.0,1.0,7.0,6.0,0.0,1.0,3.0,0.0,7.1,6.4,1.6,8.0,21.0,27.0,110.0,0.34,0.06,0.4,0.34,0.4,0.4,0.09,0.5,0.36,0.45,Matches,Cyriel Dessers,S,27,126,130,"Nigeria,Belgium",Cremonese,6,7,10,14,12,10,13,9,9,6,10,13,6,11,9,13,14,13,12,11,12,12,14,8,13,6,12,14,13,12,13,12,13,14,14,13,10,5,11,5,10,3,3,1,1,2,1,2,1,3,1,2,19,9,5,10,12,14,10,18,1,1,1,1,1,1,1,1,1,1,14,14,12,20,184,83,15,20,11917257,6500,6250,5000,Mixed_Race,125,8,1994/12/8,3,1,29999.0,,18083867
1159,Gerard Deulofeu,Udinese,1994,167.0,es ESP,FW,28.0,13.5,8.0,5.0,5.0,1.0,2.0,5.0,15.0,33.3,10.0,8.0,1.0,7.0,2.0,10.0,1.0,0.0,Matches,167.0,es ESP,FW,28.0,13.5,82.0,6.09,54.0,14.0,6.0,5.0,3.0,0.0,9.0,0.67,7.0,2.0,0.0,0.0,0.0,0.0,Matches,,,,,,,,,,,,,,,,,,,,,,,,,,,,,,,,,,,,,,,,,,,,,,,,,,,,,,,,167.0,es ESP,FW,28.0,13.5,1.0,0.0,0.0,8.0,11.0,8.0,59.0,2.0,5.0,0.0,0.0,0.0,44.0,1.0,4.0,20.0,Matches,167.0,es ESP,FW,28.0,13.5,588.0,475.0,110.0,27.0,1.0,0.0,59.0,14.0,43.0,20.0,14.0,0.0,443.0,3.0,14.0,Matches,167.0,es ESP,FW,28.0,13.5,443.0,588.0,75.3,6574.0,2331.0,260.0,294.0,88.4,139.0,181.0,76.8,27.0,64.0,42.2,6.0,4.4,4.0,1.6,48.0,40.0,42.0,2.0,82.0,Matches,223,es ESP,FW,28,16,1211.0,76.0,35.4,13.5,15,80.0,8,1,13.0,0,1.69,19.0,15.0,4.0,0.3,0.5,17.5,16.2,1.3,0.09,0.35,Matches,167.0,es ESP,FW,28.0,13.5,725.0,5.0,44.0,295.0,400.0,82.0,725.0,45.0,20.0,44.4,21.0,46.7,455.0,3177.0,2005.0,72.0,39.0,33.0,22.0,18.0,506.0,118.0,Matches,167.0,es ESP,FW,28.0,13.5,2.0,44.0,12.0,27.3,3.27,0.89,0.05,0.17,17.4,10.0,0.0,0.0,5.1,5.1,0.11,-3.1,-3.1,Matches,167.0,es ESP,FW,28.0,16.0,15.0,1211.0,13.5,2.0,6.0,8.0,2.0,0.0,0.0,1.0,0.0,5.1,5.1,4.4,9.5,72.0,82.0,118.0,0.15,0.45,0.59,0.15,0.59,0.38,0.33,0.7,0.38,0.7,Matches,Gerard Deulofeu,AM/S RL,28,144,150,Spain,Udinese Calcio,14,14,17,14,16,14,8,14,4,5,14,12,5,17,7,13,10,12,10,14,13,14,17,8,15,7,13,11,15,16,14,7,14,14,11,7,14,8,12,13,13,3,3,3,1,3,2,3,2,2,1,3,13,16,12,9,9,13,7,10,1,1,1,1,1,1,1,11,1,11,19,5,17,20,177,73,10,20,12816255,7200,6600,5400,Mediterranean_Hispanic,129,4,1994/3/13,4,1,24615.0,,67107391
1160,Federico Di Francesco,Lecce,1994,169.0,it ITA,FWMF,28.0,22.6,28.0,16.0,7.0,11.0,10.0,9.0,19.0,47.4,10.0,16.0,0.0,16.0,8.0,36.0,14.0,0.0,Matches,169.0,it ITA,FWMF,28.0,22.6,49.0,2.17,29.0,5.0,5.0,2.0,6.0,2.0,5.0,0.22,2.0,1.0,1.0,1.0,0.0,0.0,Matches,,,,,,,,,,,,,,,,,,,,,,,,,,,,,,,,,,,,,,,,,,,,,,,,,,,,,,,,169.0,it ITA,FWMF,28.0,22.6,5.0,0.0,0.0,43.0,32.0,13.0,45.0,8.0,16.0,1.0,0.0,0.0,86.0,7.0,21.0,25.0,Matches,169.0,it ITA,FWMF,28.0,22.6,511.0,466.0,42.0,2.0,7.0,3.0,45.0,11.0,29.0,0.0,2.0,0.0,340.0,3.0,24.0,Matches,169.0,it ITA,FWMF,28.0,22.6,340.0,511.0,66.5,4915.0,1626.0,191.0,230.0,83.0,105.0,156.0,67.3,22.0,63.0,34.9,2.0,2.7,2.2,-0.7,25.0,29.0,18.0,3.0,60.0,Matches,225,it ITA,FWMF,28,36,2031.0,56.0,59.4,22.6,23,73.0,4,13,27.0,0,1.0,19.0,24.0,-5.0,-0.22,0.3,22.0,23.0,-1.0,-0.04,0.28,Matches,169.0,it ITA,FWMF,28.0,22.6,745.0,14.0,88.0,288.0,383.0,82.0,745.0,49.0,17.0,34.7,27.0,55.1,447.0,2745.0,1387.0,50.0,27.0,18.0,56.0,28.0,500.0,177.0,Matches,169.0,it ITA,FWMF,28.0,22.6,2.0,39.0,16.0,41.0,1.73,0.71,0.05,0.13,17.4,1.0,0.0,0.0,3.3,3.3,0.08,-1.3,-1.3,Matches,169.0,it ITA,FWMF,28.0,36.0,23.0,2031.0,22.6,2.0,2.0,4.0,2.0,0.0,0.0,5.0,0.0,3.3,3.3,2.7,6.0,50.0,60.0,177.0,0.09,0.09,0.18,0.09,0.18,0.14,0.12,0.27,0.14,0.27,Matches,Federico Di Francesco,AM/S RLC,28,127,134,Italy,Salento,12,11,13,12,12,10,7,11,4,5,12,11,8,14,12,12,13,13,13,12,12,18,12,11,16,7,12,12,13,15,12,7,14,13,12,8,11,8,12,10,17,1,3,3,2,1,3,1,3,1,1,4,13,13,5,11,12,16,14,13,1,1,1,1,10,10,1,14,8,14,18,17,20,18,171,71,11,20,3427602,6350,6350,5100,Mediterranean_Hispanic,119,3,1994/6/14,0,0,19751.0,,43087308
1161,Michele Di Gregorio,Monza,1997,170.0,it ITA,GK,25.0,37.0,0.0,0.0,0.0,0.0,0.0,0.0,3.0,0.0,3.0,1.0,0.0,1.0,4.0,4.0,18.0,3.0,Matches,170.0,it ITA,GK,25.0,37.0,3.0,0.08,3.0,0.0,0.0,0.0,0.0,0.0,1.0,0.03,1.0,0.0,0.0,0.0,0.0,0.0,Matches,8.0,it ITA,GK,25.0,37.0,49.0,3.0,1.0,4.0,1.0,48.7,0.28,0.7,0.02,166.0,476.0,34.9,1265.0,236.0,30.4,32.2,247.0,37.2,34.9,541.0,14.0,2.6,32.0,0.86,13.4,Matches,8.0,it ITA,GK,25.0,37.0,37.0,3330.0,37.0,49.0,1.32,167.0,119.0,72.5,14.0,10.0,13.0,10.0,27.0,3.0,3.0,0.0,0.0,0.0,Matches,170.0,it ITA,GK,25.0,37.0,0.0,0.0,0.0,0.0,3.0,0.0,0.0,4.0,0.0,0.0,0.0,0.0,31.0,4.0,1.0,80.0,Matches,170.0,it ITA,GK,25.0,37.0,1515.0,1162.0,350.0,103.0,0.0,9.0,0.0,0.0,0.0,0.0,0.0,0.0,1151.0,3.0,0.0,Matches,170.0,it ITA,GK,25.0,37.0,1151.0,1515.0,76.0,29670.0,19870.0,259.0,259.0,100.0,539.0,553.0,97.5,347.0,694.0,50.0,1.0,0.0,0.1,1.0,1.0,16.0,1.0,0.0,0.0,Matches,226,it ITA,GK,25,37,3330.0,90.0,97.4,37.0,37,90.0,37,0,,1,1.41,48.0,49.0,-1.0,-0.03,2.97,44.6,48.9,-4.3,-0.12,0.93,Matches,170.0,it ITA,GK,25.0,37.0,1607.0,1324.0,1600.0,7.0,0.0,0.0,1607.0,2.0,2.0,100.0,0.0,0.0,973.0,5309.0,3519.0,0.0,0.0,0.0,1.0,1.0,841.0,0.0,Matches,170.0,it ITA,GK,25.0,37.0,0.0,0.0,0.0,,0.0,0.0,,,,0.0,0.0,0.0,0.0,0.0,,0.0,0.0,Matches,170.0,it ITA,GK,25.0,37.0,37.0,3330.0,37.0,0.0,1.0,1.0,0.0,0.0,0.0,0.0,0.0,0.0,0.0,0.0,0.0,0.0,0.0,0.0,0.0,0.03,0.03,0.0,0.03,0.0,0.0,0.0,0.0,0.0,Matches,Michele Di Gregorio,GK,24,130,139,Italy,Brianza,1,1,4,2,10,4,4,7,11,4,11,1,7,11,11,11,11,11,13,13,14,13,11,12,10,14,12,12,12,12,10,10,12,11,14,13,14,8,12,7,11,14,12,14,10,14,12,13,15,12,12,11,12,14,8,14,12,14,12,12,20,1,1,1,1,1,1,1,1,1,1,1,1,1,187,88,8,20,2111204,6500,6400,4450,Northern_European,129,2,1997/7/27,0,0,15962.0,,43161669
1162,Giovanni Di Lorenzo,Napoli,1993,171.0,it ITA,DF,28.0,36.2,60.0,29.0,33.0,19.0,8.0,25.0,49.0,51.0,24.0,30.0,9.0,21.0,30.0,90.0,60.0,0.0,Matches,171.0,it ITA,DF,28.0,36.2,111.0,3.07,93.0,5.0,1.0,6.0,3.0,3.0,13.0,0.36,13.0,0.0,0.0,0.0,0.0,0.0,Matches,,,,,,,,,,,,,,,,,,,,,,,,,,,,,,,,,,,,,,,,,,,,,,,,,,,,,,,,171.0,it ITA,DF,28.0,36.2,2.0,0.0,0.0,31.0,36.0,4.0,88.0,30.0,29.0,0.0,0.0,0.0,171.0,41.0,34.0,54.7,Matches,171.0,it ITA,DF,28.0,36.2,2687.0,2311.0,366.0,58.0,5.0,25.0,88.0,304.0,2.0,0.0,0.0,0.0,2272.0,10.0,61.0,Matches,171.0,it ITA,DF,28.0,36.2,2272.0,2687.0,84.6,36646.0,12660.0,1208.0,1303.0,92.7,847.0,971.0,87.2,165.0,259.0,63.7,4.0,4.7,4.4,-0.7,47.0,177.0,61.0,9.0,256.0,Matches,227,it ITA,DF,28,37,3257.0,88.0,95.2,36.2,36,90.0,35,1,29.0,1,2.41,75.0,24.0,51.0,1.41,2.51,62.7,28.6,34.1,0.94,1.56,Matches,171.0,it ITA,DF,28.0,36.2,2957.0,104.0,715.0,1476.0,788.0,94.0,2957.0,33.0,12.0,36.4,17.0,51.5,1842.0,7948.0,4413.0,73.0,62.0,4.0,21.0,17.0,2119.0,182.0,Matches,171.0,it ITA,DF,28.0,36.2,3.0,31.0,13.0,41.9,0.86,0.36,0.1,0.23,11.8,0.0,0.0,0.0,2.7,2.7,0.09,0.3,0.3,Matches,171.0,it ITA,DF,28.0,37.0,36.0,3257.0,36.2,3.0,4.0,7.0,3.0,0.0,0.0,2.0,0.0,2.7,2.7,4.7,7.4,73.0,256.0,182.0,0.08,0.11,0.19,0.08,0.19,0.07,0.13,0.2,0.07,0.2,Matches,Giovanni Di Lorenzo,D/WB RC,28,152,155,Italy,Parthenope,4,13,11,11,12,3,14,12,11,14,13,10,16,11,14,13,15,14,13,11,13,15,6,11,14,13,15,15,15,13,15,13,18,17,17,14,16,10,12,6,14,2,2,2,2,3,3,2,2,1,4,3,14,15,7,14,14,17,13,11,1,11,16,20,10,17,1,8,1,15,1,1,1,1,183,83,9,20,36465002,7600,7750,6400,Mediterranean_Hispanic,148,8,1993/8/4,21,2,81923.0,,43075156
1163,Ángel Di María,Juventus,1988,172.0,ar ARG,FWMF,34.0,15.1,10.0,5.0,3.0,5.0,2.0,3.0,19.0,15.8,16.0,15.0,0.0,15.0,7.0,17.0,0.0,0.0,Matches,172.0,ar ARG,FWMF,34.0,15.1,83.0,5.48,45.0,24.0,6.0,6.0,1.0,1.0,7.0,0.46,5.0,2.0,0.0,0.0,0.0,0.0,Matches,,,,,,,,,,,,,,,,,,,,,,,,,,,,,,,,,,,,,,,,,,,,,,,,,,,,,,,,172.0,ar ARG,FWMF,34.0,15.1,1.0,1.0,0.0,6.0,24.0,4.0,97.0,7.0,5.0,0.0,0.0,0.0,52.0,1.0,6.0,14.3,Matches,172.0,ar ARG,FWMF,34.0,15.1,675.0,571.0,97.0,29.0,7.0,14.0,97.0,16.0,44.0,16.0,25.0,0.0,487.0,7.0,21.0,Matches,172.0,ar ARG,FWMF,34.0,15.1,487.0,675.0,72.1,9081.0,3166.0,220.0,251.0,87.6,181.0,233.0,77.7,74.0,141.0,52.5,4.0,4.5,4.1,-0.5,42.0,63.0,41.0,8.0,96.0,Matches,228,ar ARG,FWMF,34,26,1363.0,52.0,39.9,15.1,15,70.0,3,11,29.0,1,1.81,25.0,21.0,4.0,0.26,-0.57,22.6,18.2,4.5,0.3,-0.11,Matches,172.0,ar ARG,FWMF,34.0,15.1,851.0,2.0,71.0,372.0,426.0,46.0,850.0,80.0,32.0,40.0,41.0,51.3,552.0,3838.0,1814.0,56.0,43.0,13.0,32.0,26.0,640.0,95.0,Matches,172.0,ar ARG,FWMF,34.0,15.1,4.0,37.0,12.0,32.4,2.44,0.79,0.08,0.25,21.5,1.0,1.0,1.0,3.1,2.3,0.06,0.9,0.7,Matches,172.0,ar ARG,FWMF,34.0,26.0,15.0,1363.0,15.1,4.0,4.0,8.0,3.0,1.0,1.0,1.0,1.0,3.1,2.3,4.5,6.7,56.0,96.0,95.0,0.26,0.26,0.53,0.2,0.46,0.2,0.29,0.5,0.15,0.44,Matches,Ángel Di María,M/AM RLC,34,160,174,"Argentina,Italy",Juventus,16,17,17,14,16,14,5,17,4,4,17,14,7,19,12,16,12,14,12,18,14,16,17,10,15,4,12,12,15,17,12,10,15,15,12,10,14,14,16,9,16,2,2,1,2,3,3,4,3,3,2,1,12,18,10,13,16,18,6,12,1,1,1,1,7,1,1,17,13,18,17,16,20,9,180,75,20,8,17897694,8000,8500,7800,Mediterranean_Hispanic,158,7,1988/2/14,122,25,147885.0,,14000219
1164,Boulaye Dia,Salernitana,1996,173.0,sn SEN,FWMF,25.0,28.0,12.0,5.0,3.0,6.0,3.0,2.0,7.0,28.6,5.0,10.0,0.0,10.0,7.0,19.0,27.0,1.0,Matches,173.0,sn SEN,FWMF,25.0,28.0,64.0,2.29,53.0,0.0,3.0,5.0,3.0,0.0,9.0,0.32,8.0,0.0,1.0,0.0,0.0,0.0,Matches,,,,,,,,,,,,,,,,,,,,,,,,,,,,,,,,,,,,,,,,,,,,,,,,,,,,,,,,173.0,sn SEN,FWMF,25.0,28.0,4.0,0.0,0.0,28.0,43.0,13.0,6.0,7.0,5.0,0.0,0.0,0.0,97.0,20.0,58.0,25.6,Matches,173.0,sn SEN,FWMF,25.0,28.0,589.0,566.0,20.0,0.0,2.0,7.0,6.0,3.0,0.0,0.0,0.0,0.0,449.0,3.0,30.0,Matches,173.0,sn SEN,FWMF,25.0,28.0,449.0,589.0,76.2,6689.0,1268.0,238.0,287.0,82.9,148.0,184.0,80.4,29.0,39.0,74.4,6.0,3.1,1.9,2.9,35.0,31.0,16.0,2.0,50.0,Matches,230,sn SEN,FWMF,25,33,2518.0,76.0,73.6,28.0,27,85.0,16,6,37.0,1,1.09,40.0,46.0,-6.0,-0.21,0.58,26.9,47.3,-20.4,-0.73,0.28,Matches,173.0,sn SEN,FWMF,25.0,28.0,885.0,31.0,113.0,427.0,364.0,75.0,884.0,88.0,35.0,39.8,39.0,44.3,610.0,4033.0,1545.0,48.0,47.0,13.0,71.0,61.0,673.0,140.0,Matches,173.0,sn SEN,FWMF,25.0,28.0,16.0,47.0,21.0,44.7,1.68,0.75,0.32,0.71,15.0,0.0,1.0,1.0,8.8,8.0,0.17,7.2,7.0,Matches,173.0,sn SEN,FWMF,25.0,33.0,27.0,2518.0,28.0,16.0,6.0,22.0,15.0,1.0,1.0,4.0,0.0,8.8,8.0,3.1,11.1,48.0,50.0,140.0,0.57,0.21,0.79,0.54,0.75,0.31,0.11,0.43,0.29,0.4,Matches,Boulaye Dia,S R,25,137,145,"Senegal,France",Villarreal,8,11,14,14,12,8,13,11,6,5,12,13,6,13,8,13,13,12,12,10,11,14,13,10,14,9,12,13,17,14,14,13,14,17,15,14,14,9,13,9,9,2,3,2,4,2,1,1,3,2,3,2,12,14,3,12,10,10,11,17,1,1,1,1,1,1,1,1,1,1,10,1,15,20,180,75,20,7,9060929,6845,6495,4249,African_Caribbean,137,17,1996/11/16,17,2,19911.0,U.S. Salernitana 1919,50065334
1165,Brahim Díaz,Milan,1999,174.0,ma MAR,MFFW,22.0,21.4,32.0,15.0,5.0,22.0,5.0,5.0,15.0,33.3,10.0,11.0,0.0,11.0,7.0,39.0,6.0,0.0,Matches,174.0,ma MAR,MFFW,22.0,21.4,96.0,4.49,69.0,1.0,12.0,6.0,7.0,1.0,18.0,0.84,8.0,0.0,6.0,2.0,1.0,1.0,Matches,,,,,,,,,,,,,,,,,,,,,,,,,,,,,,,,,,,,,,,,,,,,,,,,,,,,,,,,174.0,ma MAR,MFFW,22.0,21.4,3.0,0.0,0.0,29.0,50.0,2.0,20.0,7.0,15.0,1.0,0.0,0.0,100.0,4.0,24.0,14.3,Matches,174.0,ma MAR,MFFW,22.0,21.4,719.0,677.0,37.0,8.0,11.0,2.0,20.0,9.0,6.0,0.0,4.0,0.0,575.0,5.0,24.0,Matches,174.0,ma MAR,MFFW,22.0,21.4,575.0,719.0,80.0,8239.0,2469.0,329.0,375.0,87.7,193.0,231.0,83.5,26.0,46.0,56.5,7.0,5.6,3.4,1.4,41.0,80.0,40.0,3.0,121.0,Matches,231,ma MAR,MFFW,22,33,1925.0,58.0,56.3,21.4,27,65.0,1,6,28.0,4,1.85,36.0,21.0,15.0,0.7,0.34,34.2,19.8,14.5,0.68,0.48,Matches,174.0,ma MAR,MFFW,22.0,21.4,990.0,6.0,63.0,538.0,413.0,65.0,990.0,86.0,39.0,45.3,40.0,46.5,691.0,4623.0,2512.0,80.0,68.0,17.0,74.0,48.0,763.0,116.0,Matches,174.0,ma MAR,MFFW,22.0,21.4,6.0,35.0,16.0,45.7,1.64,0.75,0.17,0.38,14.5,1.0,0.0,0.0,6.0,6.0,0.17,0.0,0.0,Matches,174.0,ma MAR,MFFW,22.0,33.0,27.0,1925.0,21.4,6.0,7.0,13.0,6.0,0.0,0.0,3.0,0.0,6.0,6.0,5.6,11.5,80.0,121.0,116.0,0.28,0.33,0.61,0.28,0.61,0.28,0.26,0.54,0.28,0.54,Matches,Brahim Díaz,AM RLC,22,145,158,"Spain,Morocco",R. Madrid,13,13,16,10,16,9,6,13,7,6,15,13,7,16,8,13,12,12,13,14,12,17,15,8,14,8,14,13,15,16,13,7,13,14,12,7,11,7,11,5,15,3,3,2,4,1,3,4,1,1,1,2,15,15,6,10,11,15,13,12,1,1,1,1,1,1,1,8,12,8,16,20,17,8,171,59,16,20,23700000,7250,6486,5870,Mediterranean_Hispanic,143,4,1999/8/3,1,1,124642.0,AC Milan,28106999
1166,Federico Dimarco,Inter,1997,175.0,it ITA,DF,24.0,23.0,31.0,25.0,6.0,18.0,7.0,9.0,19.0,47.4,10.0,15.0,4.0,11.0,18.0,49.0,20.0,0.0,Matches,175.0,it ITA,DF,24.0,23.0,103.0,4.48,64.0,29.0,1.0,5.0,3.0,1.0,8.0,0.35,6.0,0.0,1.0,1.0,0.0,0.0,Matches,,,,,,,,,,,,,,,,,,,,,,,,,,,,,,,,,,,,,,,,,,,,,,,,,,,,,,,,175.0,it ITA,DF,24.0,23.0,0.0,0.0,0.0,12.0,30.0,5.0,207.0,18.0,25.0,0.0,1.0,0.0,122.0,5.0,12.0,29.4,Matches,175.0,it ITA,DF,24.0,23.0,1257.0,1035.0,220.0,39.0,0.0,21.0,207.0,116.0,60.0,16.0,36.0,0.0,925.0,2.0,21.0,Matches,175.0,it ITA,DF,24.0,23.0,925.0,1257.0,73.6,17591.0,5969.0,392.0,448.0,87.5,377.0,472.0,79.9,129.0,268.0,48.1,3.0,6.9,5.5,-3.9,59.0,67.0,42.0,28.0,88.0,Matches,233,it ITA,DF,24,33,2069.0,63.0,60.5,23.0,26,72.0,3,7,29.0,1,2.0,50.0,24.0,26.0,1.13,0.93,42.2,21.1,21.2,0.92,0.23,Matches,175.0,it ITA,DF,24.0,23.0,1451.0,40.0,312.0,552.0,600.0,72.0,1451.0,20.0,5.0,25.0,13.0,65.0,776.0,3457.0,1846.0,45.0,29.0,6.0,18.0,11.0,955.0,189.0,Matches,175.0,it ITA,DF,24.0,23.0,4.0,49.0,15.0,30.6,2.13,0.65,0.08,0.27,20.7,7.0,0.0,0.0,3.1,3.1,0.06,0.9,0.9,Matches,175.0,it ITA,DF,24.0,33.0,26.0,2069.0,23.0,4.0,3.0,7.0,4.0,0.0,0.0,0.0,0.0,3.1,3.1,6.9,9.9,45.0,88.0,189.0,0.17,0.13,0.3,0.17,0.3,0.13,0.3,0.43,0.13,0.43,Matches,Federico Dimarco,D/WB/M LC,24,145,154,Italy,FC Internazionale Milano,16,16,11,11,13,15,11,17,7,13,14,13,14,14,12,14,15,13,14,12,13,15,15,10,13,13,15,16,14,14,14,10,14,14,13,11,14,7,13,8,13,4,1,2,1,2,1,1,1,3,3,2,12,14,6,14,12,16,13,13,1,20,19,1,19,1,1,17,1,1,1,1,1,1,175,75,20,8,13917489,7250,7250,6200,Northern_European,142,4,1997/11/10,4,0,56923.0,,43143488
1167,Koffi Djidji,Torino,1992,176.0,ci CIV,DF,29.0,26.9,50.0,25.0,32.0,17.0,1.0,18.0,32.0,56.3,14.0,29.0,14.0,15.0,34.0,84.0,72.0,0.0,Matches,176.0,ci CIV,DF,29.0,26.9,18.0,0.67,16.0,0.0,0.0,0.0,0.0,2.0,1.0,0.04,1.0,0.0,0.0,0.0,0.0,0.0,Matches,,,,,,,,,,,,,,,,,,,,,,,,,,,,,,,,,,,,,,,,,,,,,,,,,,,,,,,,176.0,ci CIV,DF,29.0,26.9,3.0,0.0,0.0,27.0,3.0,1.0,13.0,34.0,25.0,0.0,2.0,0.0,141.0,47.0,50.0,48.5,Matches,176.0,ci CIV,DF,29.0,26.9,1441.0,1408.0,30.0,15.0,1.0,10.0,13.0,14.0,0.0,0.0,0.0,0.0,1249.0,3.0,20.0,Matches,176.0,ci CIV,DF,29.0,26.9,1249.0,1441.0,86.7,22239.0,6388.0,504.0,543.0,92.8,617.0,672.0,91.8,101.0,171.0,59.1,0.0,0.1,0.3,-0.1,2.0,81.0,5.0,2.0,83.0,Matches,235,ci CIV,DF,29,34,2424.0,71.0,70.9,26.9,26,87.0,19,8,21.0,3,1.35,27.0,30.0,-3.0,-0.11,-0.47,28.2,28.9,-0.7,-0.03,-0.25,Matches,176.0,ci CIV,DF,29.0,26.9,1678.0,129.0,754.0,844.0,90.0,8.0,1678.0,5.0,4.0,80.0,1.0,20.0,919.0,3316.0,1486.0,11.0,10.0,0.0,7.0,6.0,1123.0,13.0,Matches,176.0,ci CIV,DF,29.0,26.9,1.0,8.0,4.0,50.0,0.3,0.15,0.13,0.25,12.2,0.0,0.0,0.0,0.9,0.9,0.12,0.1,0.1,Matches,176.0,ci CIV,DF,29.0,34.0,26.0,2424.0,26.9,1.0,0.0,1.0,1.0,0.0,0.0,3.0,0.0,0.9,0.9,0.1,1.1,11.0,83.0,13.0,0.04,0.0,0.04,0.04,0.04,0.04,0.0,0.04,0.04,0.04,Matches,Koffi Djidji,D C,29,134,138,"France,Ivory Coast",Torino,4,6,9,6,9,6,14,6,11,14,11,5,16,9,12,14,14,13,13,11,13,14,6,10,6,14,14,14,13,12,14,13,13,14,15,15,13,12,13,11,11,1,1,1,1,2,3,2,3,2,2,1,14,13,7,13,10,13,11,13,1,11,20,11,1,10,1,1,1,8,1,1,1,1,184,73,10,20,5386739,6700,6450,5000,African_Caribbean,134,13,1992/11/30,0,0,9037.0,,85052013
1168,Berat Djimsiti,Atalanta,1993,177.0,al ALB,DF,29.0,20.0,34.0,19.0,21.0,13.0,0.0,17.0,25.0,68.0,8.0,17.0,7.0,10.0,36.0,70.0,74.0,1.0,Matches,177.0,al ALB,DF,29.0,20.0,10.0,0.5,8.0,0.0,0.0,1.0,1.0,0.0,4.0,0.2,3.0,0.0,0.0,1.0,0.0,0.0,Matches,,,,,,,,,,,,,,,,,,,,,,,,,,,,,,,,,,,,,,,,,,,,,,,,,,,,,,,,177.0,al ALB,DF,29.0,20.0,3.0,0.0,0.0,15.0,8.0,0.0,0.0,36.0,19.0,0.0,0.0,0.0,112.0,59.0,42.0,58.4,Matches,177.0,al ALB,DF,29.0,20.0,1093.0,1047.0,45.0,29.0,0.0,3.0,0.0,15.0,0.0,0.0,0.0,0.0,953.0,1.0,8.0,Matches,177.0,al ALB,DF,29.0,20.0,953.0,1093.0,87.2,16622.0,5292.0,419.0,457.0,91.7,451.0,495.0,91.1,68.0,109.0,62.4,1.0,0.2,0.5,0.8,4.0,48.0,2.0,0.0,45.0,Matches,236,al ALB,DF,29,24,1797.0,75.0,52.5,20.0,20,85.0,16,4,23.0,5,1.42,27.0,23.0,4.0,0.2,-0.58,26.1,21.6,4.5,0.23,-0.42,Matches,177.0,al ALB,DF,29.0,20.0,1294.0,140.0,647.0,587.0,64.0,15.0,1294.0,7.0,4.0,57.1,2.0,28.6,700.0,3099.0,1396.0,7.0,7.0,1.0,10.0,5.0,817.0,9.0,Matches,177.0,al ALB,DF,29.0,20.0,0.0,5.0,0.0,0.0,0.25,0.0,0.0,,7.6,0.0,0.0,0.0,0.6,0.6,0.12,-0.6,-0.6,Matches,177.0,al ALB,DF,29.0,24.0,20.0,1797.0,20.0,0.0,1.0,1.0,0.0,0.0,0.0,3.0,0.0,0.6,0.6,0.2,0.8,7.0,45.0,9.0,0.0,0.05,0.05,0.0,0.05,0.03,0.01,0.04,0.03,0.04,Matches,Berat Djimsiti,D C,29,142,145,"Albania,Switzerland",Atalanta,4,7,8,5,10,4,15,4,5,16,11,4,16,11,13,15,17,13,13,10,13,15,6,11,7,14,16,13,11,11,13,16,14,13,14,17,13,12,12,6,12,1,1,3,3,3,4,3,3,2,1,1,13,14,5,14,7,15,12,15,1,14,20,14,1,1,1,1,1,1,1,1,1,1,190,83,10,20,12850716,7100,7000,5650,Mediterranean_Hispanic,139,2,1993/2/19,48,1,28461.0,,98015432
1169,Dodô,Fiorentina,1998,178.0,br BRA,DF,23.0,25.9,40.0,22.0,20.0,14.0,6.0,22.0,46.0,47.8,24.0,26.0,2.0,24.0,25.0,65.0,37.0,0.0,Matches,178.0,br BRA,DF,23.0,25.9,65.0,2.51,58.0,2.0,1.0,2.0,1.0,1.0,5.0,0.19,5.0,0.0,0.0,0.0,0.0,0.0,Matches,,,,,,,,,,,,,,,,,,,,,,,,,,,,,,,,,,,,,,,,,,,,,,,,,,,,,,,,178.0,br BRA,DF,23.0,25.9,5.0,1.0,1.0,28.0,40.0,0.0,61.0,25.0,22.0,0.0,1.0,0.0,184.0,19.0,13.0,59.4,Matches,178.0,br BRA,DF,23.0,25.9,1504.0,1272.0,229.0,21.0,2.0,8.0,61.0,208.0,0.0,0.0,0.0,0.0,1222.0,3.0,28.0,Matches,178.0,br BRA,DF,23.0,25.9,1222.0,1504.0,81.3,21567.0,6692.0,535.0,596.0,89.8,548.0,657.0,83.4,117.0,191.0,61.3,3.0,2.2,2.0,0.8,28.0,93.0,29.0,10.0,141.0,Matches,237,br BRA,DF,23,33,2331.0,71.0,68.2,25.9,28,78.0,16,5,30.0,2,1.58,38.0,28.0,10.0,0.39,0.39,38.6,29.3,9.2,0.36,0.16,Matches,178.0,br BRA,DF,23.0,25.9,1719.0,52.0,464.0,813.0,462.0,24.0,1719.0,62.0,34.0,54.8,21.0,33.9,1028.0,6650.0,3625.0,72.0,58.0,7.0,35.0,15.0,1083.0,104.0,Matches,178.0,br BRA,DF,23.0,25.9,1.0,11.0,4.0,36.4,0.42,0.15,0.09,0.25,20.5,0.0,0.0,0.0,0.7,0.7,0.06,0.3,0.3,Matches,178.0,br BRA,DF,23.0,33.0,28.0,2331.0,25.9,1.0,3.0,4.0,1.0,0.0,0.0,5.0,1.0,0.7,0.7,2.2,2.9,72.0,141.0,104.0,0.04,0.12,0.15,0.04,0.15,0.03,0.09,0.11,0.03,0.11,Matches,Dodô,AM RLC,27,130,140,Brazil,Khorfakkan Club,12,12,15,11,14,12,8,11,5,6,13,14,8,13,12,13,10,12,11,14,14,12,14,10,13,6,12,12,15,15,15,6,15,14,13,5,12,13,11,9,11,3,1,2,1,1,4,3,1,2,2,3,12,12,7,13,11,12,6,11,1,1,1,1,1,1,1,1,12,1,17,20,17,12,178,73,10,20,5515748,6150,6150,3000,Mediterranean_Hispanic,127,11,1994/9/5,0,0,22548.0,,19158806
1170,Josh Doig,Hellas Verona,2002,179.0,sct SCO,DF,20.0,15.0,19.0,8.0,6.0,7.0,6.0,6.0,16.0,37.5,10.0,25.0,6.0,19.0,11.0,30.0,13.0,1.0,Matches,179.0,sct SCO,DF,20.0,15.0,35.0,2.32,23.0,6.0,3.0,1.0,2.0,0.0,7.0,0.46,5.0,0.0,1.0,0.0,1.0,0.0,Matches,,,,,,,,,,,,,,,,,,,,,,,,,,,,,,,,,,,,,,,,,,,,,,,,,,,,,,,,179.0,sct SCO,DF,20.0,15.0,1.0,0.0,0.0,14.0,7.0,2.0,46.0,11.0,8.0,0.0,0.0,0.0,93.0,16.0,23.0,41.0,Matches,179.0,sct SCO,DF,20.0,15.0,534.0,412.0,119.0,1.0,0.0,0.0,46.0,116.0,2.0,2.0,0.0,0.0,360.0,3.0,21.0,Matches,179.0,sct SCO,DF,20.0,15.0,360.0,534.0,67.4,6111.0,2875.0,181.0,220.0,82.3,141.0,207.0,68.1,32.0,70.0,45.7,3.0,1.2,1.3,1.8,12.0,28.0,12.0,8.0,27.0,Matches,238,sct SCO,DF,20,22,1354.0,62.0,39.6,15.0,15,77.0,7,7,28.0,8,0.86,13.0,22.0,-9.0,-0.6,0.23,13.4,15.7,-2.2,-0.15,0.37,Matches,179.0,sct SCO,DF,20.0,15.0,705.0,27.0,191.0,276.0,256.0,27.0,705.0,54.0,23.0,42.6,22.0,40.7,336.0,2325.0,1064.0,41.0,24.0,5.0,33.0,16.0,360.0,61.0,Matches,179.0,sct SCO,DF,20.0,15.0,2.0,18.0,6.0,33.3,1.2,0.4,0.11,0.33,16.1,0.0,0.0,0.0,1.8,1.8,0.1,0.2,0.2,Matches,179.0,sct SCO,DF,20.0,22.0,15.0,1354.0,15.0,2.0,3.0,5.0,2.0,0.0,0.0,1.0,0.0,1.8,1.8,1.2,3.0,41.0,27.0,61.0,0.13,0.2,0.33,0.13,0.33,0.12,0.08,0.2,0.12,0.2,Matches,Josh Doig,D/WB L,20,126,149,Scotland,Hellas Verona,7,13,12,9,11,4,11,10,7,11,11,7,13,12,10,12,11,12,11,12,13,15,11,5,14,12,14,14,14,12,11,15,14,15,14,12,14,8,10,3,11,2,3,2,3,1,3,1,2,3,2,2,13,14,6,14,12,15,13,14,1,20,10,1,20,1,1,14,1,1,1,1,1,1,189,0,20,12,12824000,6300,4932,2542,Northern_European,123,0,2002/5/18,0,0,11692.0,,61093823
1171,Nicolás Domínguez,Bologna,1998,180.0,ar ARG,MF,24.0,25.6,79.0,49.0,34.0,33.0,12.0,39.0,76.0,51.3,37.0,29.0,3.0,26.0,21.0,100.0,29.0,1.0,Matches,180.0,ar ARG,MF,24.0,25.6,71.0,2.78,61.0,2.0,3.0,1.0,3.0,1.0,5.0,0.2,5.0,0.0,0.0,0.0,0.0,0.0,Matches,,,,,,,,,,,,,,,,,,,,,,,,,,,,,,,,,,,,,,,,,,,,,,,,,,,,,,,,180.0,ar ARG,MF,24.0,25.6,10.0,0.0,0.0,43.0,32.0,2.0,19.0,21.0,49.0,0.0,1.0,0.0,167.0,37.0,27.0,57.8,Matches,180.0,ar ARG,MF,24.0,25.6,1420.0,1335.0,73.0,43.0,19.0,14.0,19.0,26.0,0.0,0.0,0.0,0.0,1169.0,12.0,25.0,Matches,180.0,ar ARG,MF,24.0,25.6,1169.0,1420.0,82.3,18139.0,5084.0,618.0,693.0,89.2,408.0,483.0,84.5,85.0,130.0,65.4,2.0,2.9,2.8,-0.9,36.0,118.0,25.0,2.0,147.0,Matches,239,ar ARG,MF,24,31,2300.0,74.0,67.3,25.6,26,82.0,13,5,34.0,1,1.39,34.0,31.0,3.0,0.12,0.04,31.1,32.0,-0.9,-0.04,0.28,Matches,180.0,ar ARG,MF,24.0,25.6,1703.0,47.0,308.0,991.0,419.0,37.0,1703.0,37.0,23.0,62.2,12.0,32.4,908.0,3910.0,1802.0,39.0,41.0,5.0,50.0,21.0,1170.0,84.0,Matches,180.0,ar ARG,MF,24.0,25.6,3.0,42.0,17.0,40.5,1.64,0.67,0.07,0.18,22.5,0.0,0.0,0.0,2.6,2.6,0.06,0.4,0.4,Matches,180.0,ar ARG,MF,24.0,31.0,26.0,2300.0,25.6,3.0,2.0,5.0,3.0,0.0,0.0,10.0,0.0,2.6,2.6,2.9,5.4,39.0,147.0,84.0,0.12,0.08,0.2,0.12,0.2,0.1,0.11,0.21,0.1,0.21,Matches,Nicolás Domínguez,DM/M C,24,136,149,"Argentina,Italy",Bologna FC 1909,6,10,11,9,15,7,13,11,5,9,15,10,16,15,14,14,15,13,12,14,13,16,14,10,13,12,14,16,12,13,11,11,15,12,17,11,15,14,13,7,12,2,3,1,4,1,3,3,3,1,3,3,16,15,7,11,15,14,10,11,1,1,1,1,1,1,20,7,20,7,1,14,1,1,179,73,10,20,6654020,6800,6600,6000,Mediterranean_Hispanic,134,5,1998/6/28,11,1,17307.0,,14077011
1172,Bartłomiej Drągowski,Spezia,1997,182.0,pl POL,GK,24.0,32.7,1.0,0.0,1.0,0.0,0.0,1.0,5.0,20.0,4.0,0.0,0.0,0.0,1.0,2.0,15.0,3.0,Matches,182.0,pl POL,GK,24.0,32.7,7.0,0.21,6.0,1.0,0.0,0.0,0.0,0.0,2.0,0.06,2.0,0.0,0.0,0.0,0.0,0.0,Matches,9.0,pl POL,GK,24.0,32.7,54.0,4.0,1.0,7.0,3.0,46.1,0.25,-4.9,-0.15,151.0,482.0,31.3,975.0,159.0,37.6,34.6,196.0,58.7,46.5,472.0,13.0,2.8,32.0,0.98,14.1,Matches,9.0,pl POL,GK,24.0,34.0,34.0,2946.0,32.7,54.0,1.65,164.0,112.0,69.5,6.0,10.0,18.0,6.0,17.6,6.0,4.0,1.0,1.0,20.0,Matches,182.0,pl POL,GK,24.0,32.7,1.0,0.0,0.0,0.0,6.0,0.0,0.0,1.0,0.0,0.0,0.0,0.0,38.0,8.0,1.0,88.9,Matches,182.0,pl POL,GK,24.0,32.7,1173.0,889.0,282.0,86.0,0.0,3.0,0.0,0.0,0.0,0.0,0.0,0.0,808.0,2.0,1.0,Matches,182.0,pl POL,GK,24.0,32.7,808.0,1173.0,68.9,21748.0,14971.0,205.0,206.0,99.5,355.0,362.0,98.1,240.0,594.0,40.4,1.0,0.1,0.2,0.9,1.0,22.0,3.0,0.0,0.0,Matches,241,pl POL,GK,24,34,2946.0,87.0,86.1,32.7,34,87.0,32,0,,3,0.8,24.0,54.0,-30.0,-0.92,-0.73,32.4,50.9,-18.5,-0.56,-0.65,Matches,182.0,pl POL,GK,24.0,32.7,1265.0,1027.0,1258.0,7.0,0.0,0.0,1265.0,0.0,0.0,,0.0,,757.0,4042.0,2471.0,0.0,0.0,0.0,0.0,0.0,646.0,0.0,Matches,182.0,pl POL,GK,24.0,32.7,0.0,0.0,0.0,,0.0,0.0,,,,0.0,0.0,0.0,0.0,0.0,,0.0,0.0,Matches,182.0,pl POL,GK,24.0,34.0,34.0,2946.0,32.7,0.0,1.0,1.0,0.0,0.0,0.0,1.0,0.0,0.0,0.0,0.1,0.1,0.0,0.0,0.0,0.0,0.03,0.03,0.0,0.03,0.0,0.0,0.0,0.0,0.0,Matches,Bartłomiej Drągowski,GK,24,130,139,Poland,Spezia Calcio,4,2,3,1,9,6,10,3,3,2,10,3,1,9,12,13,14,10,10,8,13,15,2,12,3,13,8,11,12,12,14,17,13,11,14,13,11,5,8,11,14,13,14,12,12,14,10,12,17,8,13,12,11,13,12,12,12,15,11,8,20,1,1,1,1,1,1,1,1,1,1,1,1,1,191,74,9,20,3073665,6500,6500,5500,Northern_European,128,2,1997/8/19,2,0,28461.0,,96052559
1173,Ondrej Duda,Hellas Verona,1994,183.0,sk SVK,MF,27.0,11.8,22.0,14.0,7.0,12.0,3.0,9.0,16.0,56.3,7.0,11.0,0.0,11.0,13.0,35.0,8.0,0.0,Matches,183.0,sk SVK,MF,27.0,11.8,20.0,1.69,13.0,1.0,1.0,2.0,2.0,1.0,2.0,0.17,1.0,0.0,0.0,1.0,0.0,0.0,Matches,,,,,,,,,,,,,,,,,,,,,,,,,,,,,,,,,,,,,,,,,,,,,,,,,,,,,,,,183.0,sk SVK,MF,27.0,11.8,4.0,0.0,0.0,17.0,26.0,0.0,14.0,13.0,14.0,0.0,0.0,0.0,107.0,11.0,14.0,44.0,Matches,183.0,sk SVK,MF,27.0,11.8,433.0,400.0,30.0,10.0,2.0,6.0,14.0,2.0,7.0,4.0,1.0,0.0,323.0,3.0,9.0,Matches,183.0,sk SVK,MF,27.0,11.8,323.0,433.0,74.6,5654.0,1659.0,148.0,177.0,83.6,128.0,154.0,83.1,35.0,64.0,54.7,0.0,0.3,0.5,-0.3,5.0,42.0,5.0,1.0,44.0,Matches,242,sk SVK,MF,27,15,1061.0,71.0,31.0,11.8,11,83.0,7,4,38.0,1,1.13,8.0,15.0,-7.0,-0.59,0.21,10.1,13.2,-3.1,-0.26,0.16,Matches,183.0,sk SVK,MF,27.0,11.8,573.0,20.0,86.0,363.0,131.0,11.0,573.0,34.0,20.0,58.8,8.0,23.5,311.0,1850.0,701.0,15.0,14.0,0.0,14.0,17.0,302.0,22.0,Matches,183.0,sk SVK,MF,27.0,11.8,0.0,13.0,4.0,30.8,1.1,0.34,0.0,0.0,22.6,1.0,0.0,0.0,0.8,0.8,0.07,-0.8,-0.8,Matches,183.0,sk SVK,MF,27.0,15.0,11.0,1061.0,11.8,0.0,0.0,0.0,0.0,0.0,0.0,4.0,0.0,0.8,0.8,0.3,1.1,15.0,44.0,22.0,0.0,0.0,0.0,0.0,0.0,0.07,0.03,0.1,0.07,0.1,Matches,Ondrej Duda,AM C,27,131,138,Slovakia,1. FC Köln,13,12,13,12,17,12,8,12,4,8,12,15,8,16,12,11,9,12,10,16,10,9,15,6,14,9,11,11,13,13,12,8,10,12,15,11,9,9,12,10,8,1,2,2,3,1,1,4,2,4,3,2,13,14,10,7,10,11,9,14,1,1,1,1,1,1,1,7,15,7,9,20,9,12,181,74,12,20,3270160,6250,6750,5150,Northern_European,128,3,1994/12/5,59,10,19164.0,,63023511
1174,Denzel Dumfries,Inter,1996,184.0,nl NED,DF,26.0,24.6,35.0,18.0,17.0,13.0,5.0,22.0,34.0,64.7,12.0,33.0,9.0,24.0,12.0,47.0,26.0,0.0,Matches,184.0,nl NED,DF,26.0,24.6,71.0,2.88,48.0,4.0,1.0,9.0,8.0,1.0,11.0,0.45,6.0,0.0,0.0,2.0,3.0,0.0,Matches,,,,,,,,,,,,,,,,,,,,,,,,,,,,,,,,,,,,,,,,,,,,,,,,,,,,,,,,184.0,nl NED,DF,26.0,24.6,4.0,0.0,0.0,31.0,39.0,2.0,82.0,12.0,18.0,2.0,1.0,1.0,90.0,41.0,41.0,50.0,Matches,184.0,nl NED,DF,26.0,24.6,1004.0,833.0,168.0,6.0,1.0,2.0,82.0,162.0,0.0,0.0,0.0,0.0,745.0,3.0,27.0,Matches,184.0,nl NED,DF,26.0,24.6,745.0,1004.0,74.2,12394.0,3688.0,358.0,416.0,86.1,313.0,409.0,76.5,56.0,111.0,50.5,4.0,4.9,3.9,-0.9,32.0,32.0,32.0,18.0,59.0,Matches,243,nl NED,DF,26,34,2218.0,65.0,64.9,24.6,25,80.0,11,9,23.0,4,1.85,54.0,26.0,28.0,1.14,1.06,49.2,23.4,25.8,1.05,0.61,Matches,184.0,nl NED,DF,26.0,24.6,1263.0,42.0,266.0,551.0,467.0,99.0,1263.0,52.0,18.0,34.6,23.0,44.2,674.0,3940.0,1928.0,62.0,32.0,23.0,39.0,20.0,785.0,172.0,Matches,184.0,nl NED,DF,26.0,24.6,1.0,33.0,13.0,39.4,1.34,0.53,0.03,0.08,11.4,0.0,0.0,0.0,3.6,3.6,0.11,-2.6,-2.6,Matches,184.0,nl NED,DF,26.0,34.0,25.0,2218.0,24.6,1.0,4.0,5.0,1.0,0.0,0.0,4.0,0.0,3.6,3.6,4.9,8.5,62.0,59.0,172.0,0.04,0.16,0.2,0.04,0.2,0.15,0.2,0.35,0.15,0.35,Matches,Denzel Dumfries,D/WB/M R,26,153,159,"Holland,Aruba",FC Internazionale Milano,11,13,13,12,12,5,16,11,11,10,13,11,14,12,14,13,13,12,11,11,12,16,11,9,17,11,12,14,17,14,14,15,15,18,15,15,13,12,11,5,13,1,1,3,2,1,2,2,3,2,1,4,14,15,7,13,13,17,12,12,1,10,12,20,10,20,8,1,1,18,1,1,9,1,189,80,9,20,68371876,7650,7100,6600,African_Caribbean,143,12,1996/4/18,34,5,61731.0,,37052843
1175,Alfred Duncan,Fiorentina,1993,185.0,gh GHA,MF,29.0,12.3,18.0,10.0,0.0,17.0,1.0,10.0,21.0,47.6,11.0,9.0,0.0,9.0,8.0,26.0,6.0,0.0,Matches,185.0,gh GHA,MF,29.0,12.3,39.0,3.17,32.0,2.0,1.0,2.0,1.0,1.0,5.0,0.41,3.0,0.0,1.0,1.0,0.0,0.0,Matches,,,,,,,,,,,,,,,,,,,,,,,,,,,,,,,,,,,,,,,,,,,,,,,,,,,,,,,,185.0,gh GHA,MF,29.0,12.3,3.0,0.0,0.0,26.0,12.0,1.0,26.0,8.0,10.0,0.0,0.0,0.0,67.0,9.0,7.0,56.3,Matches,185.0,gh GHA,MF,29.0,12.3,540.0,518.0,19.0,9.0,4.0,2.0,26.0,6.0,4.0,0.0,4.0,0.0,421.0,3.0,10.0,Matches,185.0,gh GHA,MF,29.0,12.3,421.0,540.0,78.0,7705.0,2400.0,173.0,198.0,87.4,183.0,217.0,84.3,49.0,88.0,55.7,0.0,0.6,0.7,-0.6,14.0,58.0,10.0,5.0,70.0,Matches,244,gh GHA,MF,29,25,1103.0,44.0,32.3,12.3,13,66.0,2,12,20.0,8,1.56,17.0,10.0,7.0,0.57,0.45,16.6,13.2,3.3,0.27,-0.05,Matches,185.0,gh GHA,MF,29.0,12.3,634.0,10.0,92.0,371.0,179.0,9.0,634.0,23.0,12.0,52.2,8.0,34.8,348.0,1705.0,786.0,18.0,16.0,4.0,17.0,14.0,434.0,30.0,Matches,185.0,gh GHA,MF,29.0,12.3,1.0,9.0,2.0,22.2,0.73,0.16,0.11,0.5,24.1,0.0,0.0,0.0,0.5,0.5,0.05,0.5,0.5,Matches,185.0,gh GHA,MF,29.0,25.0,13.0,1103.0,12.3,1.0,0.0,1.0,1.0,0.0,0.0,3.0,0.0,0.5,0.5,0.6,1.1,18.0,70.0,30.0,0.08,0.0,0.08,0.08,0.08,0.04,0.05,0.09,0.04,0.09,Matches,Alfred Duncan,DM/M C,29,134,145,"Ghana,Italy",ACF Fiorentina,12,11,13,8,13,11,10,12,9,13,13,10,13,12,14,13,15,12,14,12,13,15,11,9,14,14,16,16,12,12,15,10,15,14,14,15,14,12,14,9,12,4,2,3,2,2,2,3,2,3,3,2,13,13,4,13,11,15,15,11,1,1,1,1,1,10,18,1,20,10,1,12,1,1,178,78,20,9,6841445,6700,6800,5500,African_Caribbean,132,19,1993/3/10,9,0,46346.0,,43084308
1176,Paulo Dybala,Roma,1993,186.0,ar ARG,MFFW,28.0,19.3,14.0,4.0,1.0,8.0,5.0,8.0,26.0,30.8,18.0,12.0,1.0,11.0,8.0,22.0,4.0,0.0,Matches,186.0,ar ARG,MFFW,28.0,19.3,104.0,5.38,48.0,29.0,4.0,10.0,13.0,0.0,8.0,0.41,4.0,2.0,0.0,1.0,1.0,0.0,Matches,,,,,,,,,,,,,,,,,,,,,,,,,,,,,,,,,,,,,,,,,,,,,,,,,,,,,,,,186.0,ar ARG,MFFW,28.0,19.3,5.0,0.0,0.0,10.0,56.0,5.0,82.0,8.0,4.0,2.0,0.0,0.0,81.0,4.0,16.0,20.0,Matches,186.0,ar ARG,MFFW,28.0,19.3,833.0,734.0,97.0,23.0,5.0,28.0,82.0,10.0,54.0,14.0,37.0,0.0,650.0,2.0,28.0,Matches,186.0,ar ARG,MFFW,28.0,19.3,650.0,833.0,78.0,11560.0,2954.0,340.0,384.0,88.5,189.0,235.0,80.4,100.0,149.0,67.1,6.0,6.9,4.5,-0.9,53.0,49.0,21.0,1.0,75.0,Matches,245,ar ARG,MFFW,28,25,1739.0,70.0,50.8,19.3,21,77.0,7,4,28.0,1,1.81,35.0,21.0,14.0,0.72,0.83,32.8,14.7,18.0,0.93,0.54,Matches,186.0,ar ARG,MFFW,28.0,19.3,1089.0,2.0,85.0,542.0,478.0,78.0,1084.0,64.0,27.0,42.2,27.0,42.2,689.0,4141.0,1816.0,56.0,43.0,20.0,62.0,32.0,785.0,109.0,Matches,186.0,ar ARG,MFFW,28.0,19.3,12.0,60.0,18.0,30.0,3.11,0.93,0.12,0.39,20.7,3.0,5.0,5.0,9.3,5.3,0.09,2.7,1.7,Matches,186.0,ar ARG,MFFW,28.0,25.0,21.0,1739.0,19.3,12.0,6.0,18.0,7.0,5.0,5.0,5.0,0.0,9.3,5.3,6.9,12.2,56.0,75.0,109.0,0.62,0.31,0.93,0.36,0.67,0.48,0.36,0.83,0.28,0.63,Matches,Paulo Dybala,AM/S RC,28,160,177,"Argentina,Poland,Italy",Associazione Sportiva Roma,16,15,18,15,18,17,13,17,4,4,17,16,4,19,9,16,10,12,11,17,14,13,17,11,14,4,14,12,14,18,18,7,10,12,12,12,13,5,11,16,13,1,2,3,3,3,3,3,2,3,1,3,14,14,12,9,9,11,13,15,1,1,1,1,1,1,1,1,1,1,12,20,15,20,177,79,20,10,20000000,8000,8404,7750,Mediterranean_Hispanic,158,4,1993/11/15,34,3,160192.0,,14044150
1177,Edin Džeko,Inter,1986,187.0,ba BIH,FW,36.0,19.2,3.0,2.0,0.0,3.0,0.0,0.0,4.0,0.0,4.0,15.0,1.0,14.0,3.0,6.0,25.0,0.0,Matches,187.0,ba BIH,FW,36.0,19.2,61.0,3.16,47.0,0.0,1.0,12.0,1.0,0.0,11.0,0.57,7.0,0.0,1.0,3.0,0.0,0.0,Matches,,,,,,,,,,,,,,,,,,,,,,,,,,,,,,,,,,,,,,,,,,,,,,,,,,,,,,,,187.0,ba BIH,FW,36.0,19.2,3.0,0.0,0.0,26.0,24.0,10.0,24.0,3.0,2.0,0.0,0.0,0.0,60.0,41.0,43.0,48.8,Matches,187.0,ba BIH,FW,36.0,19.2,528.0,505.0,20.0,1.0,6.0,8.0,24.0,1.0,0.0,0.0,0.0,0.0,364.0,3.0,16.0,Matches,187.0,ba BIH,FW,36.0,19.2,364.0,528.0,68.9,5741.0,1417.0,195.0,253.0,77.1,122.0,173.0,70.5,30.0,55.0,54.5,3.0,3.2,3.3,-0.2,23.0,39.0,20.0,2.0,67.0,Matches,246,ba BIH,FW,36,33,1732.0,52.0,50.6,19.2,18,79.0,9,15,21.0,5,1.82,44.0,20.0,24.0,1.25,0.98,36.8,17.3,19.5,1.01,0.37,Matches,187.0,ba BIH,FW,36.0,19.2,749.0,30.0,67.0,351.0,341.0,113.0,749.0,26.0,8.0,30.8,14.0,53.8,400.0,2047.0,726.0,32.0,12.0,15.0,48.0,16.0,587.0,150.0,Matches,187.0,ba BIH,FW,36.0,19.2,9.0,73.0,24.0,32.9,3.79,1.25,0.12,0.38,14.4,0.0,0.0,0.0,9.7,9.7,0.13,-0.7,-0.7,Matches,187.0,ba BIH,FW,36.0,33.0,18.0,1732.0,19.2,9.0,3.0,12.0,9.0,0.0,0.0,3.0,0.0,9.7,9.7,3.2,13.0,32.0,67.0,150.0,0.47,0.16,0.62,0.47,0.62,0.5,0.17,0.67,0.5,0.67,Matches,Edin Džeko,S,36,150,168,Bosnia and Herzegovina,FC Internazionale Milano,4,11,10,16,16,8,17,12,4,5,15,13,7,15,8,16,14,13,14,14,15,17,12,14,13,6,17,13,11,9,17,16,19,11,13,17,14,10,14,4,5,1,2,1,1,2,2,2,3,3,3,4,10,17,8,13,13,20,13,10,1,1,1,1,1,1,1,1,1,1,1,1,1,20,193,94,18,20,1671771,7500,7750,6900,Northern_European,150,2,1986/3/17,124,63,178076.0,,8502440
1178,Enzo Ebosse,Udinese,1999,189.0,cm CMR,DF,23.0,10.3,15.0,9.0,11.0,4.0,0.0,9.0,13.0,69.2,4.0,27.0,6.0,21.0,11.0,26.0,29.0,0.0,Matches,189.0,cm CMR,DF,23.0,10.3,8.0,0.78,7.0,0.0,0.0,0.0,1.0,0.0,0.0,0.0,0.0,0.0,0.0,0.0,0.0,0.0,Matches,,,,,,,,,,,,,,,,,,,,,,,,,,,,,,,,,,,,,,,,,,,,,,,,,,,,,,,,189.0,cm CMR,DF,23.0,10.3,3.0,0.0,0.0,9.0,4.0,1.0,15.0,11.0,9.0,0.0,0.0,0.0,48.0,15.0,14.0,51.7,Matches,189.0,cm CMR,DF,23.0,10.3,557.0,479.0,77.0,17.0,0.0,11.0,15.0,59.0,1.0,0.0,0.0,0.0,453.0,1.0,3.0,Matches,189.0,cm CMR,DF,23.0,10.3,453.0,557.0,81.3,8801.0,3202.0,179.0,201.0,89.1,203.0,240.0,84.6,65.0,102.0,63.7,0.0,0.0,0.1,0.0,1.0,43.0,4.0,1.0,51.0,Matches,248,cm CMR,DF,23,20,930.0,47.0,27.2,10.3,9,77.0,7,11,22.0,4,1.15,15.0,14.0,1.0,0.1,0.17,13.0,13.5,-0.4,-0.04,0.12,Matches,189.0,cm CMR,DF,23.0,10.3,667.0,51.0,292.0,306.0,72.0,0.0,667.0,7.0,4.0,57.1,1.0,14.3,338.0,1593.0,868.0,11.0,7.0,1.0,8.0,3.0,383.0,20.0,Matches,189.0,cm CMR,DF,23.0,10.3,0.0,3.0,0.0,0.0,0.29,0.0,0.0,,26.4,0.0,0.0,0.0,0.1,0.1,0.03,-0.1,-0.1,Matches,189.0,cm CMR,DF,23.0,20.0,9.0,930.0,10.3,0.0,0.0,0.0,0.0,0.0,0.0,3.0,0.0,0.1,0.1,0.0,0.1,11.0,51.0,20.0,0.0,0.0,0.0,0.0,0.0,0.01,0.0,0.01,0.01,0.01,Matches,Enzo Ebosse,D/WB LC,23,125,142,"Cameroon,France",Udinese Calcio,5,11,10,5,12,4,13,6,11,13,12,6,14,12,10,12,13,11,11,11,11,11,10,7,12,14,13,13,13,13,11,13,14,13,15,15,11,8,10,8,12,3,3,3,2,1,3,2,2,2,4,3,16,11,7,9,7,9,11,17,1,20,18,1,17,1,1,14,1,1,1,1,1,1,185,77,20,9,2998645,6250,6150,2500,North_African__Middle_Eastern,120,12,1999/3/11,0,0,17799.0,,48036572
1179,Tyronne Ebuehi,Empoli,1995,190.0,ng NGA,DF,26.0,21.4,22.0,14.0,11.0,7.0,4.0,9.0,13.0,69.2,4.0,23.0,12.0,11.0,12.0,34.0,79.0,1.0,Matches,190.0,ng NGA,DF,26.0,21.4,29.0,1.36,22.0,5.0,0.0,1.0,1.0,0.0,4.0,0.19,3.0,0.0,0.0,1.0,0.0,0.0,Matches,,,,,,,,,,,,,,,,,,,,,,,,,,,,,,,,,,,,,,,,,,,,,,,,,,,,,,,,190.0,ng NGA,DF,26.0,21.4,0.0,0.0,0.0,12.0,17.0,3.0,28.0,12.0,14.0,0.0,0.0,0.0,91.0,19.0,32.0,37.3,Matches,190.0,ng NGA,DF,26.0,21.4,881.0,684.0,192.0,7.0,0.0,0.0,28.0,185.0,0.0,0.0,0.0,0.0,688.0,5.0,28.0,Matches,190.0,ng NGA,DF,26.0,21.4,688.0,881.0,78.1,11680.0,4092.0,301.0,347.0,86.7,316.0,380.0,83.2,54.0,102.0,52.9,4.0,1.9,1.1,2.1,12.0,26.0,11.0,7.0,41.0,Matches,249,ng NGA,DF,26,26,1923.0,74.0,56.2,21.4,22,84.0,14,4,20.0,7,1.42,24.0,24.0,0.0,0.0,0.72,23.8,31.5,-7.7,-0.36,0.35,Matches,190.0,ng NGA,DF,26.0,21.4,1089.0,105.0,452.0,437.0,210.0,28.0,1089.0,26.0,11.0,42.3,9.0,34.6,558.0,2977.0,1483.0,31.0,21.0,5.0,16.0,14.0,604.0,42.0,Matches,190.0,ng NGA,DF,26.0,21.4,2.0,19.0,4.0,21.1,0.89,0.19,0.11,0.5,10.9,0.0,0.0,0.0,3.1,3.1,0.16,-1.1,-1.1,Matches,190.0,ng NGA,DF,26.0,26.0,22.0,1923.0,21.4,2.0,4.0,6.0,2.0,0.0,0.0,0.0,0.0,3.1,3.1,1.9,5.0,31.0,41.0,42.0,0.09,0.19,0.28,0.09,0.28,0.14,0.09,0.23,0.14,0.23,Matches,Tyronne Ebuehi,D/WB/M RL,26,120,126,"Nigeria,Holland",Empoli Football Club,7,10,12,5,13,6,10,4,9,8,12,5,12,13,10,10,9,12,12,10,12,13,13,5,14,13,13,14,14,14,13,10,12,14,14,10,10,8,12,12,9,1,2,3,2,3,3,3,1,2,1,2,9,13,6,12,14,14,15,5,1,15,1,20,15,18,1,12,1,16,1,1,1,1,187,76,8,20,1295512,6000,6300,4500,African_Caribbean,111,10,1995/12/16,10,0,5999.0,,37047573
1180,Kingsley Ehizibue,Udinese,1995,192.0,nl NED,DF,27.0,17.1,47.0,31.0,28.0,13.0,6.0,29.0,45.0,64.4,16.0,21.0,3.0,18.0,10.0,57.0,42.0,1.0,Matches,192.0,nl NED,DF,27.0,17.1,31.0,1.82,22.0,2.0,0.0,5.0,1.0,1.0,3.0,0.18,2.0,0.0,0.0,0.0,1.0,0.0,Matches,,,,,,,,,,,,,,,,,,,,,,,,,,,,,,,,,,,,,,,,,,,,,,,,,,,,,,,,192.0,nl NED,DF,27.0,17.1,7.0,0.0,0.0,33.0,20.0,1.0,37.0,10.0,31.0,0.0,0.0,0.0,84.0,15.0,17.0,46.9,Matches,192.0,nl NED,DF,27.0,17.1,565.0,493.0,72.0,1.0,0.0,2.0,37.0,70.0,1.0,0.0,0.0,0.0,412.0,0.0,30.0,Matches,192.0,nl NED,DF,27.0,17.1,412.0,565.0,72.9,6819.0,2543.0,191.0,230.0,83.0,169.0,216.0,78.2,38.0,68.0,55.9,0.0,0.9,1.1,-0.9,8.0,32.0,12.0,7.0,40.0,Matches,252,nl NED,DF,27,27,1535.0,57.0,44.9,17.1,16,83.0,7,11,19.0,2,1.3,24.0,24.0,0.0,0.0,0.05,22.4,24.0,-1.6,-0.1,0.06,Matches,192.0,nl NED,DF,27.0,17.1,779.0,51.0,267.0,282.0,236.0,31.0,779.0,43.0,14.0,32.6,19.0,44.2,400.0,2323.0,1020.0,29.0,16.0,7.0,20.0,11.0,407.0,69.0,Matches,192.0,nl NED,DF,27.0,17.1,2.0,13.0,6.0,46.2,0.76,0.35,0.15,0.33,15.1,0.0,0.0,0.0,2.0,2.0,0.16,0.0,0.0,Matches,192.0,nl NED,DF,27.0,27.0,16.0,1535.0,17.1,2.0,0.0,2.0,2.0,0.0,0.0,7.0,0.0,2.0,2.0,0.9,3.0,29.0,40.0,69.0,0.12,0.0,0.12,0.12,0.12,0.12,0.06,0.17,0.12,0.17,Matches,Kingsley Ehizibue,D/WB R,27,125,130,"Nigeria,Holland,Germany",Udinese Calcio,8,12,12,8,10,7,10,7,14,12,11,8,13,11,12,8,14,9,8,9,9,12,10,9,12,11,10,16,16,13,13,15,16,18,15,12,9,11,12,3,9,1,2,1,2,3,3,2,1,1,2,3,9,13,8,14,8,16,15,13,1,1,1,20,1,20,1,1,1,15,1,1,10,1,189,83,7,20,2072819,6250,6000,4250,African_Caribbean,115,16,1995/5/25,0,0,17799.0,,37053569
1181,Albin Ekdal,Spezia,1989,193.0,se SWE,MF,33.0,19.3,37.0,20.0,14.0,20.0,3.0,19.0,45.0,42.2,26.0,24.0,2.0,22.0,26.0,63.0,36.0,0.0,Matches,193.0,se SWE,MF,33.0,19.3,35.0,1.82,26.0,0.0,1.0,4.0,2.0,2.0,1.0,0.05,1.0,0.0,0.0,0.0,0.0,0.0,Matches,,,,,,,,,,,,,,,,,,,,,,,,,,,,,,,,,,,,,,,,,,,,,,,,,,,,,,,,193.0,se SWE,MF,33.0,19.3,6.0,1.0,1.0,32.0,28.0,0.0,4.0,26.0,20.0,0.0,0.0,0.0,126.0,36.0,21.0,63.2,Matches,193.0,se SWE,MF,33.0,19.3,782.0,756.0,24.0,20.0,1.0,4.0,4.0,2.0,0.0,0.0,0.0,0.0,606.0,2.0,14.0,Matches,193.0,se SWE,MF,33.0,19.3,606.0,782.0,77.5,8887.0,3150.0,334.0,401.0,83.3,214.0,260.0,82.3,27.0,60.0,45.0,2.0,1.6,0.9,0.4,10.0,62.0,17.0,2.0,80.0,Matches,253,se SWE,MF,33,31,1734.0,56.0,50.7,19.3,18,79.0,8,13,24.0,1,0.97,14.0,29.0,-15.0,-0.78,0.08,26.0,28.1,-2.1,-0.11,0.74,Matches,193.0,se SWE,MF,33.0,19.3,999.0,49.0,256.0,551.0,208.0,34.0,999.0,19.0,12.0,63.2,5.0,26.3,496.0,2381.0,929.0,15.0,24.0,2.0,32.0,17.0,566.0,35.0,Matches,193.0,se SWE,MF,33.0,19.3,0.0,19.0,4.0,21.1,0.99,0.21,0.0,0.0,14.4,0.0,0.0,0.0,2.9,2.9,0.16,-2.9,-2.9,Matches,193.0,se SWE,MF,33.0,31.0,18.0,1734.0,19.3,0.0,2.0,2.0,0.0,0.0,0.0,6.0,1.0,2.9,2.9,1.6,4.4,15.0,80.0,35.0,0.0,0.1,0.1,0.0,0.1,0.15,0.08,0.23,0.15,0.23,Matches,Albin Ekdal,DM/M C,32,125,142,Sweden,Spezia Calcio,6,10,10,9,13,9,12,10,4,12,15,10,12,14,12,16,15,16,16,12,12,15,10,16,11,14,15,15,10,10,15,11,17,11,13,12,15,10,16,9,16,1,2,2,3,1,2,1,1,3,2,3,15,15,4,12,13,16,13,16,1,1,1,1,1,1,20,1,20,1,1,1,1,1,186,82,10,20,347975206,6249,6749,6099,Northern_European,125,3,1989/7/28,66,0,39134.0,,8120012
1182,Salvatore Esposito,Spezia,2000,199.0,it ITA,MF,21.0,10.8,15.0,12.0,8.0,5.0,2.0,5.0,21.0,23.8,16.0,9.0,1.0,8.0,11.0,26.0,18.0,0.0,Matches,199.0,it ITA,MF,21.0,10.8,28.0,2.6,13.0,11.0,0.0,1.0,3.0,0.0,0.0,0.0,0.0,0.0,0.0,0.0,0.0,0.0,Matches,,,,,,,,,,,,,,,,,,,,,,,,,,,,,,,,,,,,,,,,,,,,,,,,,,,,,,,,199.0,it ITA,MF,21.0,10.8,5.0,1.0,1.0,11.0,24.0,2.0,54.0,11.0,12.0,0.0,0.0,0.0,63.0,7.0,4.0,63.6,Matches,199.0,it ITA,MF,21.0,10.8,653.0,570.0,81.0,41.0,1.0,9.0,54.0,1.0,39.0,25.0,10.0,0.0,500.0,2.0,12.0,Matches,199.0,it ITA,MF,21.0,10.8,500.0,653.0,76.6,8468.0,2456.0,254.0,281.0,90.4,187.0,225.0,83.1,44.0,108.0,40.7,0.0,1.5,1.3,-1.5,12.0,49.0,6.0,1.0,51.0,Matches,259,it ITA,MF,21,15,971.0,65.0,28.4,10.8,10,84.0,6,5,26.0,5,0.44,7.0,19.0,-12.0,-1.11,-0.41,13.2,14.7,-1.5,-0.14,0.47,Matches,199.0,it ITA,MF,21.0,10.8,737.0,21.0,175.0,409.0,156.0,7.0,737.0,14.0,6.0,42.9,4.0,28.6,354.0,1296.0,584.0,4.0,3.0,1.0,10.0,4.0,466.0,11.0,Matches,199.0,it ITA,MF,21.0,10.8,1.0,14.0,2.0,14.3,1.3,0.19,0.07,0.5,28.5,11.0,0.0,0.0,0.7,0.7,0.05,0.3,0.3,Matches,199.0,it ITA,MF,21.0,15.0,10.0,971.0,10.8,1.0,0.0,1.0,1.0,0.0,0.0,5.0,1.0,0.7,0.7,1.5,2.2,4.0,51.0,11.0,0.09,0.0,0.09,0.09,0.09,0.06,0.14,0.21,0.06,0.21,Matches,Salvatore Esposito,DM/M C,21,122,157,Italy,SPAL,12,12,12,8,12,14,11,11,9,13,14,10,11,13,13,13,12,11,12,13,12,18,10,8,11,12,12,14,13,13,12,9,17,12,13,12,15,10,9,4,12,1,2,2,1,2,2,2,3,3,3,1,10,16,11,9,12,15,12,16,1,1,1,1,1,1,20,1,19,10,1,10,1,1,178,70,11,20,5685000,6100,6781,3922,Mediterranean_Hispanic,121,2,2000/10/7,0,0,11953.0,,43317730
1183,Nicolò Fagioli,Juventus,2001,200.0,it ITA,MF,21.0,16.9,29.0,19.0,12.0,15.0,2.0,8.0,27.0,29.6,19.0,16.0,2.0,14.0,8.0,37.0,7.0,1.0,Matches,200.0,it ITA,MF,21.0,16.9,39.0,2.31,25.0,4.0,1.0,4.0,5.0,0.0,7.0,0.41,4.0,1.0,0.0,0.0,2.0,0.0,Matches,,,,,,,,,,,,,,,,,,,,,,,,,,,,,,,,,,,,,,,,,,,,,,,,,,,,,,,,200.0,it ITA,MF,21.0,16.9,3.0,0.0,0.0,20.0,23.0,1.0,23.0,8.0,19.0,1.0,0.0,0.0,102.0,1.0,7.0,12.5,Matches,200.0,it ITA,MF,21.0,16.9,607.0,574.0,32.0,11.0,5.0,10.0,23.0,12.0,9.0,2.0,4.0,0.0,505.0,1.0,14.0,Matches,200.0,it ITA,MF,21.0,16.9,505.0,607.0,83.2,8123.0,1759.0,278.0,307.0,90.6,173.0,201.0,86.1,44.0,73.0,60.3,3.0,1.3,1.1,1.7,15.0,49.0,18.0,3.0,56.0,Matches,260,it ITA,MF,21,26,1520.0,58.0,44.4,16.9,17,76.0,8,9,26.0,8,2.0,31.0,16.0,15.0,0.89,0.51,26.1,17.4,8.7,0.51,0.27,Matches,200.0,it ITA,MF,21.0,16.9,749.0,17.0,124.0,411.0,221.0,15.0,749.0,19.0,8.0,42.1,8.0,42.1,471.0,2225.0,921.0,27.0,19.0,5.0,33.0,28.0,536.0,56.0,Matches,200.0,it ITA,MF,21.0,16.9,3.0,13.0,8.0,61.5,0.77,0.47,0.23,0.38,19.7,0.0,0.0,0.0,1.5,1.5,0.12,1.5,1.5,Matches,200.0,it ITA,MF,21.0,26.0,17.0,1520.0,16.9,3.0,3.0,6.0,3.0,0.0,0.0,3.0,0.0,1.5,1.5,1.3,2.8,27.0,56.0,56.0,0.18,0.18,0.36,0.18,0.36,0.09,0.08,0.17,0.09,0.17,Matches,Nicolò Fagioli,DM/M/AM C,21,129,155,Italy,Juventus,12,13,14,8,15,12,9,11,7,10,14,13,12,14,15,14,14,12,14,15,12,15,15,10,12,12,13,12,13,16,12,9,15,12,13,11,13,7,12,9,14,1,3,1,2,2,3,2,2,1,2,2,14,18,10,11,13,13,13,13,1,1,1,1,1,1,19,1,20,1,1,18,1,1,178,71,7,20,11675000,6550,6550,4250,Mediterranean_Hispanic,128,2,2001/2/12,0,0,35577.0,,43372948
1184,Wladimiro Falcone,Lecce,1995,201.0,it ITA,GK,27.0,38.0,2.0,0.0,2.0,0.0,0.0,2.0,2.0,100.0,0.0,0.0,0.0,0.0,2.0,4.0,21.0,3.0,Matches,201.0,it ITA,GK,27.0,38.0,6.0,0.16,4.0,2.0,0.0,0.0,0.0,0.0,0.0,0.0,0.0,0.0,0.0,0.0,0.0,0.0,Matches,10.0,it ITA,GK,27.0,38.0,46.0,5.0,2.0,6.0,3.0,43.2,0.24,0.2,0.01,194.0,721.0,26.9,876.0,143.0,56.8,42.1,282.0,79.1,53.5,534.0,23.0,4.3,42.0,1.11,14.1,Matches,10.0,it ITA,GK,27.0,38.0,38.0,3420.0,38.0,46.0,1.21,156.0,112.0,73.7,8.0,12.0,18.0,6.0,15.8,6.0,5.0,1.0,0.0,16.7,Matches,201.0,it ITA,GK,27.0,38.0,2.0,0.0,0.0,1.0,5.0,0.0,0.0,2.0,0.0,0.0,1.0,0.0,45.0,12.0,2.0,85.7,Matches,201.0,it ITA,GK,27.0,38.0,1167.0,771.0,387.0,105.0,0.0,4.0,0.0,0.0,0.0,0.0,0.0,0.0,597.0,9.0,0.0,Matches,201.0,it ITA,GK,27.0,38.0,597.0,1167.0,51.2,19884.0,15815.0,88.0,88.0,100.0,221.0,230.0,96.1,285.0,836.0,34.1,0.0,0.2,0.1,-0.2,3.0,16.0,2.0,0.0,0.0,Matches,262,it ITA,GK,27,38,3420.0,90.0,100.0,38.0,38,90.0,38,0,,0,0.95,33.0,46.0,-13.0,-0.34,,36.1,42.1,-6.1,-0.16,,Matches,201.0,it ITA,GK,27.0,38.0,1272.0,1056.0,1267.0,5.0,0.0,0.0,1272.0,0.0,0.0,,0.0,,660.0,4252.0,2301.0,0.0,0.0,0.0,1.0,0.0,432.0,0.0,Matches,201.0,it ITA,GK,27.0,38.0,0.0,0.0,0.0,,0.0,0.0,,,,0.0,0.0,0.0,0.0,0.0,,0.0,0.0,Matches,201.0,it ITA,GK,27.0,38.0,38.0,3420.0,38.0,0.0,0.0,0.0,0.0,0.0,0.0,2.0,0.0,0.0,0.0,0.2,0.2,0.0,0.0,0.0,0.0,0.0,0.0,0.0,0.0,0.0,0.01,0.01,0.0,0.01,Matches,Wladimiro Falcone,GK,27,128,133,Italy,U.C. Sampdoria,3,1,1,2,9,6,11,2,1,2,10,4,2,9,12,12,13,11,16,12,12,15,13,12,6,13,12,12,12,12,12,17,13,11,13,13,13,6,13,4,11,12,13,11,3,13,12,13,14,10,11,11,10,13,3,15,10,12,10,12,20,1,1,1,1,1,1,1,1,1,1,1,1,1,195,85,10,20,2489415,6400,6400,4253,Mediterranean_Hispanic,127,5,1995/4/12,0,0,2845.0,Salento,43094480
1185,Davide Faraoni,Hellas Verona,1991,202.0,it ITA,DF,30.0,16.5,34.0,24.0,19.0,13.0,2.0,16.0,41.0,39.0,25.0,30.0,11.0,19.0,15.0,49.0,37.0,0.0,Matches,202.0,it ITA,DF,30.0,16.5,28.0,1.7,18.0,2.0,4.0,4.0,0.0,0.0,4.0,0.24,2.0,0.0,1.0,1.0,0.0,0.0,Matches,,,,,,,,,,,,,,,,,,,,,,,,,,,,,,,,,,,,,,,,,,,,,,,,,,,,,,,,202.0,it ITA,DF,30.0,16.5,7.0,0.0,0.0,21.0,11.0,4.0,37.0,15.0,24.0,0.0,0.0,0.0,85.0,14.0,21.0,40.0,Matches,202.0,it ITA,DF,30.0,16.5,592.0,451.0,137.0,7.0,1.0,6.0,37.0,130.0,0.0,0.0,0.0,0.0,394.0,4.0,15.0,Matches,202.0,it ITA,DF,30.0,16.5,394.0,592.0,66.6,7297.0,3426.0,167.0,205.0,81.5,167.0,237.0,70.5,53.0,112.0,47.3,3.0,1.0,0.7,2.0,11.0,34.0,20.0,9.0,54.0,Matches,264,it ITA,DF,30,23,1485.0,65.0,43.4,16.5,19,74.0,8,4,19.0,3,0.88,12.0,36.0,-24.0,-1.45,-1.27,16.4,26.4,-10.0,-0.61,-0.42,Matches,202.0,it ITA,DF,30.0,16.5,770.0,55.0,226.0,335.0,213.0,27.0,770.0,16.0,7.0,43.8,9.0,56.3,322.0,1217.0,549.0,11.0,9.0,2.0,12.0,4.0,341.0,33.0,Matches,202.0,it ITA,DF,30.0,16.5,2.0,20.0,5.0,25.0,1.21,0.3,0.1,0.4,18.6,0.0,0.0,0.0,2.7,2.7,0.14,-0.7,-0.7,Matches,202.0,it ITA,DF,30.0,23.0,19.0,1485.0,16.5,2.0,3.0,5.0,2.0,0.0,0.0,7.0,0.0,2.7,2.7,1.0,3.7,11.0,54.0,33.0,0.12,0.18,0.3,0.12,0.3,0.17,0.06,0.23,0.17,0.23,Matches,Davide Faraoni,D/WB/M RC,30,137,142,Italy,Hellas Verona,10,14,11,12,12,7,13,9,11,11,12,7,11,13,10,13,14,13,14,12,13,14,9,10,16,13,14,16,14,13,13,11,14,15,14,11,16,13,13,7,15,2,1,2,2,2,3,1,1,2,3,2,12,14,8,11,13,15,15,10,1,10,15,19,10,20,1,1,10,17,1,1,1,1,180,71,9,20,5988914,6850,6750,5250,Mediterranean_Hispanic,134,4,1991/10/25,0,0,17885.0,,43008971
1186,Federico Fazio,Salernitana,1987,203.0,ar ARG,DF,35.0,11.9,15.0,12.0,8.0,7.0,0.0,4.0,11.0,36.4,7.0,9.0,4.0,5.0,28.0,43.0,61.0,0.0,Matches,203.0,ar ARG,DF,35.0,11.9,12.0,1.0,7.0,1.0,0.0,4.0,0.0,0.0,0.0,0.0,0.0,0.0,0.0,0.0,0.0,0.0,Matches,,,,,,,,,,,,,,,,,,,,,,,,,,,,,,,,,,,,,,,,,,,,,,,,,,,,,,,,203.0,ar ARG,DF,35.0,11.9,2.0,1.0,0.0,11.0,6.0,0.0,4.0,28.0,12.0,0.0,3.0,0.0,74.0,36.0,13.0,73.5,Matches,203.0,ar ARG,DF,35.0,11.9,536.0,503.0,33.0,18.0,0.0,8.0,4.0,15.0,0.0,0.0,0.0,0.0,410.0,0.0,6.0,Matches,203.0,ar ARG,DF,35.0,11.9,410.0,536.0,76.5,7740.0,3216.0,139.0,170.0,81.8,214.0,250.0,85.6,47.0,94.0,50.0,0.0,0.1,0.1,-0.1,3.0,24.0,3.0,0.0,40.0,Matches,268,ar ARG,DF,35,14,1074.0,77.0,31.4,11.9,12,88.0,10,2,8.0,1,1.21,19.0,19.0,0.0,0.0,0.54,15.0,22.9,-7.9,-0.66,0.21,Matches,203.0,ar ARG,DF,35.0,11.9,679.0,84.0,318.0,309.0,58.0,17.0,679.0,8.0,4.0,50.0,4.0,50.0,347.0,1507.0,877.0,13.0,11.0,1.0,11.0,5.0,358.0,4.0,Matches,203.0,ar ARG,DF,35.0,11.9,1.0,11.0,2.0,18.2,0.92,0.17,0.09,0.5,10.7,0.0,0.0,0.0,0.7,0.7,0.06,0.3,0.3,Matches,203.0,ar ARG,DF,35.0,14.0,12.0,1074.0,11.9,1.0,0.0,1.0,1.0,0.0,0.0,2.0,1.0,0.7,0.7,0.1,0.8,13.0,40.0,4.0,0.08,0.0,0.08,0.08,0.08,0.06,0.01,0.07,0.06,0.07,Matches,Federico Fazio,D C,35,129,150,"Argentina,Italy",U.S. Salernitana 1919,3,3,13,8,13,3,17,3,3,15,12,6,15,13,14,14,15,12,11,12,11,16,12,16,9,13,13,13,9,7,12,17,16,12,12,17,14,14,12,12,10,3,1,4,3,3,1,3,2,3,1,3,14,13,13,13,11,18,12,15,1,1,20,1,1,1,12,1,1,1,1,1,1,1,195,85,12,20,347975206,6449,6749,5399,Mediterranean_Hispanic,127,4,1987/3/17,10,1,35577.0,,964847
1187,Lewis Ferguson,Bologna,1999,205.0,sct SCO,MFFW,22.0,25.7,44.0,25.0,16.0,20.0,8.0,20.0,40.0,50.0,20.0,22.0,7.0,15.0,19.0,63.0,25.0,0.0,Matches,205.0,sct SCO,MFFW,22.0,25.7,62.0,2.41,45.0,1.0,1.0,8.0,6.0,1.0,5.0,0.19,4.0,0.0,0.0,1.0,0.0,0.0,Matches,,,,,,,,,,,,,,,,,,,,,,,,,,,,,,,,,,,,,,,,,,,,,,,,,,,,,,,,205.0,sct SCO,MFFW,22.0,25.7,4.0,0.0,0.0,50.0,41.0,6.0,13.0,19.0,25.0,0.0,0.0,0.0,106.0,27.0,36.0,42.9,Matches,205.0,sct SCO,MFFW,22.0,25.7,1218.0,1190.0,25.0,11.0,4.0,0.0,13.0,12.0,0.0,0.0,0.0,0.0,1039.0,3.0,20.0,Matches,205.0,sct SCO,MFFW,22.0,25.7,1039.0,1218.0,85.3,14524.0,2797.0,632.0,690.0,91.6,332.0,376.0,88.3,37.0,68.0,54.4,0.0,1.0,1.2,-1.0,16.0,70.0,12.0,0.0,88.0,Matches,270,sct SCO,MFFW,22,32,2314.0,72.0,67.7,25.7,27,82.0,15,5,21.0,4,1.5,40.0,30.0,10.0,0.39,0.88,30.5,32.8,-2.3,-0.09,0.12,Matches,205.0,sct SCO,MFFW,22.0,25.7,1472.0,44.0,272.0,794.0,415.0,69.0,1472.0,25.0,9.0,36.0,12.0,48.0,830.0,3488.0,1460.0,31.0,37.0,7.0,33.0,16.0,1129.0,114.0,Matches,205.0,sct SCO,MFFW,22.0,25.7,7.0,43.0,18.0,41.9,1.67,0.7,0.16,0.39,15.5,0.0,0.0,0.0,4.7,4.7,0.11,2.3,2.3,Matches,205.0,sct SCO,MFFW,22.0,32.0,27.0,2314.0,25.7,7.0,0.0,7.0,7.0,0.0,0.0,4.0,0.0,4.7,4.7,1.0,5.7,31.0,88.0,114.0,0.27,0.0,0.27,0.27,0.27,0.18,0.04,0.22,0.18,0.22,Matches,Lewis Ferguson,M C,22,121,139,Scotland,Bologna FC 1909,8,8,11,10,13,12,13,12,3,10,13,15,13,13,15,12,15,12,10,10,11,16,8,13,14,11,14,16,13,12,13,12,17,13,16,13,14,13,15,2,9,3,4,3,3,2,3,1,2,1,2,3,9,14,8,13,15,13,8,14,1,1,1,1,1,1,14,1,20,1,1,15,1,5,181,75,8,20,3488040,6050,5900,4000,Northern_European,121,1,1999/8/24,4,0,14230.0,,61078132
1188,Alex Ferrari,Cremonese,1994,207.0,it ITA,DF,28.0,11.2,40.0,23.0,32.0,7.0,1.0,28.0,42.0,66.7,14.0,19.0,4.0,15.0,25.0,65.0,45.0,1.0,Matches,207.0,it ITA,DF,28.0,11.2,6.0,0.54,4.0,0.0,1.0,0.0,1.0,0.0,0.0,0.0,0.0,0.0,0.0,0.0,0.0,0.0,Matches,,,,,,,,,,,,,,,,,,,,,,,,,,,,,,,,,,,,,,,,,,,,,,,,,,,,,,,,207.0,it ITA,DF,28.0,11.2,3.0,0.0,0.0,8.0,13.0,0.0,6.0,25.0,23.0,0.0,0.0,0.0,70.0,15.0,6.0,71.4,Matches,207.0,it ITA,DF,28.0,11.2,458.0,415.0,43.0,18.0,0.0,4.0,6.0,25.0,0.0,0.0,0.0,0.0,339.0,0.0,8.0,Matches,207.0,it ITA,DF,28.0,11.2,339.0,458.0,74.0,6421.0,2306.0,129.0,161.0,80.1,169.0,203.0,83.3,38.0,78.0,48.7,0.0,0.1,0.2,-0.1,3.0,27.0,5.0,1.0,27.0,Matches,272,it ITA,DF,28,16,1007.0,63.0,29.4,11.2,13,74.0,5,3,15.0,4,0.88,10.0,21.0,-11.0,-0.98,-0.16,9.9,18.5,-8.5,-0.76,-0.06,Matches,207.0,it ITA,DF,28.0,11.2,604.0,54.0,301.0,268.0,41.0,1.0,604.0,8.0,4.0,50.0,4.0,50.0,286.0,1217.0,493.0,2.0,3.0,0.0,8.0,1.0,274.0,5.0,Matches,207.0,it ITA,DF,28.0,11.2,0.0,0.0,0.0,,0.0,0.0,,,,0.0,0.0,0.0,0.0,0.0,,0.0,0.0,Matches,207.0,it ITA,DF,28.0,16.0,13.0,1007.0,11.2,0.0,0.0,0.0,0.0,0.0,0.0,3.0,0.0,0.0,0.0,0.1,0.1,2.0,27.0,5.0,0.0,0.0,0.0,0.0,0.0,0.0,0.01,0.01,0.0,0.01,Matches,Alex Ferrari,D RC,28,125,130,Italy,U.C. Sampdoria,4,10,10,4,12,4,15,4,4,13,12,4,15,11,11,13,12,12,11,11,12,13,12,10,10,15,13,13,12,12,13,15,12,12,12,13,14,10,10,12,11,2,3,1,3,1,1,4,3,1,3,2,11,12,8,11,12,8,8,10,1,12,20,18,1,1,1,1,1,1,1,1,1,1,191,80,10,20,2194749,6250,6250,4350,Mediterranean_Hispanic,124,2,1994/7/1,0,0,14230.0,,43093049
1189,Davide Frattesi,Sassuolo,1999,211.0,it ITA,MF,22.0,31.9,63.0,36.0,24.0,29.0,10.0,25.0,44.0,56.8,19.0,27.0,6.0,21.0,16.0,79.0,42.0,0.0,Matches,211.0,it ITA,MF,22.0,31.9,79.0,2.47,60.0,0.0,7.0,5.0,5.0,2.0,4.0,0.13,4.0,0.0,0.0,0.0,0.0,0.0,Matches,,,,,,,,,,,,,,,,,,,,,,,,,,,,,,,,,,,,,,,,,,,,,,,,,,,,,,,,211.0,it ITA,MF,22.0,31.9,4.0,0.0,0.0,39.0,58.0,0.0,21.0,16.0,36.0,0.0,0.0,0.0,153.0,23.0,24.0,48.9,Matches,211.0,it ITA,MF,22.0,31.9,1024.0,998.0,25.0,19.0,6.0,21.0,21.0,6.0,0.0,0.0,0.0,0.0,812.0,1.0,25.0,Matches,211.0,it ITA,MF,22.0,31.9,812.0,1024.0,79.3,13717.0,3762.0,400.0,479.0,83.5,301.0,363.0,82.9,80.0,116.0,69.0,0.0,1.9,2.0,-1.9,27.0,80.0,22.0,1.0,137.0,Matches,282,it ITA,MF,22,36,2873.0,80.0,84.0,31.9,35,81.0,15,1,33.0,1,1.22,40.0,47.0,-7.0,-0.22,0.93,43.4,40.3,3.2,0.1,0.31,Matches,211.0,it ITA,MF,22.0,31.9,1417.0,68.0,280.0,704.0,456.0,109.0,1417.0,74.0,34.0,45.9,27.0,36.5,809.0,4866.0,2374.0,73.0,54.0,21.0,56.0,44.0,993.0,94.0,Matches,211.0,it ITA,MF,22.0,31.9,7.0,64.0,24.0,37.5,2.0,0.75,0.11,0.29,13.9,0.0,0.0,0.0,7.8,7.8,0.12,-0.8,-0.8,Matches,211.0,it ITA,MF,22.0,36.0,35.0,2873.0,31.9,7.0,0.0,7.0,7.0,0.0,0.0,4.0,0.0,7.8,7.8,1.9,9.7,73.0,137.0,94.0,0.22,0.0,0.22,0.22,0.22,0.24,0.06,0.3,0.24,0.3,Matches,Davide Frattesi,M C,22,140,159,Italy,U.S. Sassuolo,7,10,15,13,13,8,14,13,6,10,14,12,12,14,14,13,14,13,14,13,14,15,12,10,15,12,15,14,15,14,12,13,16,14,14,13,13,13,12,3,13,1,1,1,2,1,4,3,1,2,1,3,10,13,5,13,16,15,11,13,1,1,1,1,1,1,15,1,20,1,1,12,1,1,184,74,10,20,33179997,6997,7197,5247,Mediterranean_Hispanic,141,1,1999/9/22,3,0,25000.0,,43272557
1190,Manolo Gabbiadini,Sampdoria,1991,213.0,it ITA,FWMF,30.0,26.2,23.0,15.0,8.0,9.0,6.0,9.0,23.0,39.1,14.0,16.0,2.0,14.0,6.0,29.0,25.0,0.0,Matches,213.0,it ITA,FWMF,30.0,26.2,62.0,2.36,39.0,1.0,3.0,8.0,9.0,2.0,4.0,0.15,2.0,0.0,0.0,0.0,1.0,1.0,Matches,,,,,,,,,,,,,,,,,,,,,,,,,,,,,,,,,,,,,,,,,,,,,,,,,,,,,,,,213.0,it ITA,FWMF,30.0,26.2,6.0,0.0,0.0,41.0,67.0,13.0,25.0,6.0,15.0,1.0,0.0,0.0,72.0,42.0,72.0,36.8,Matches,213.0,it ITA,FWMF,30.0,26.2,625.0,590.0,32.0,4.0,9.0,2.0,25.0,5.0,12.0,2.0,8.0,0.0,428.0,3.0,23.0,Matches,213.0,it ITA,FWMF,30.0,26.2,428.0,625.0,68.5,5770.0,1470.0,263.0,332.0,79.2,116.0,167.0,69.5,19.0,45.0,42.2,2.0,4.5,4.1,-2.5,27.0,33.0,28.0,2.0,55.0,Matches,284,it ITA,FWMF,30,35,2354.0,67.0,68.8,26.2,27,79.0,11,8,29.0,2,0.49,19.0,49.0,-30.0,-1.15,0.29,26.1,47.2,-21.1,-0.81,0.13,Matches,213.0,it ITA,FWMF,30.0,26.2,885.0,30.0,112.0,389.0,393.0,83.0,885.0,25.0,6.0,24.0,16.0,64.0,535.0,2482.0,1022.0,32.0,24.0,10.0,52.0,30.0,683.0,111.0,Matches,213.0,it ITA,FWMF,30.0,26.2,7.0,72.0,28.0,38.9,2.75,1.07,0.1,0.25,19.3,6.0,0.0,0.0,7.4,7.4,0.1,-0.4,-0.4,Matches,213.0,it ITA,FWMF,30.0,35.0,27.0,2354.0,26.2,7.0,2.0,9.0,7.0,0.0,0.0,6.0,0.0,7.4,7.4,4.5,11.9,32.0,55.0,111.0,0.27,0.08,0.34,0.27,0.34,0.28,0.17,0.45,0.28,0.45,Matches,Manolo Gabbiadini,AM/S RLC,30,134,148,Italy,U.C. Sampdoria,12,12,13,16,16,16,11,15,4,4,13,18,6,15,11,13,12,13,13,13,13,13,15,10,14,4,13,13,12,12,13,12,12,12,12,13,14,9,15,10,12,4,2,3,1,1,1,2,1,1,2,3,14,14,6,11,10,17,15,11,1,1,1,1,1,1,1,1,1,1,15,19,16,20,186,75,20,9,5311294,6700,7000,6000,Mediterranean_Hispanic,130,4,1991/11/26,11,2,27114.0,,43050841
1191,Antonino Gallo,Lecce,2000,218.0,it ITA,DF,22.0,27.6,56.0,36.0,35.0,12.0,9.0,38.0,57.0,66.7,19.0,37.0,6.0,31.0,13.0,69.0,71.0,0.0,Matches,218.0,it ITA,DF,22.0,27.6,64.0,2.32,50.0,9.0,3.0,1.0,1.0,0.0,1.0,0.04,1.0,0.0,0.0,0.0,0.0,0.0,Matches,,,,,,,,,,,,,,,,,,,,,,,,,,,,,,,,,,,,,,,,,,,,,,,,,,,,,,,,218.0,it ITA,DF,22.0,27.6,5.0,1.0,1.0,13.0,17.0,2.0,89.0,13.0,36.0,0.0,0.0,2.0,198.0,25.0,29.0,46.3,Matches,218.0,it ITA,DF,22.0,27.6,1254.0,980.0,267.0,20.0,0.0,14.0,89.0,247.0,0.0,0.0,0.0,0.0,843.0,7.0,24.0,Matches,218.0,it ITA,DF,22.0,27.6,843.0,1254.0,67.2,15118.0,6837.0,373.0,438.0,85.2,365.0,511.0,71.4,89.0,245.0,36.3,1.0,1.9,2.1,-0.9,38.0,121.0,34.0,19.0,154.0,Matches,289,it ITA,DF,22,32,2486.0,78.0,72.7,27.6,28,86.0,23,4,21.0,4,1.09,24.0,28.0,-4.0,-0.14,0.72,26.4,27.1,-0.7,-0.03,0.49,Matches,218.0,it ITA,DF,22.0,27.6,1509.0,91.0,472.0,646.0,415.0,14.0,1509.0,29.0,15.0,51.7,10.0,34.5,683.0,4301.0,2501.0,71.0,44.0,5.0,22.0,7.0,706.0,65.0,Matches,218.0,it ITA,DF,22.0,27.6,0.0,10.0,2.0,20.0,0.36,0.07,0.0,0.0,25.8,0.0,0.0,0.0,0.6,0.6,0.06,-0.6,-0.6,Matches,218.0,it ITA,DF,22.0,32.0,28.0,2486.0,27.6,0.0,1.0,1.0,0.0,0.0,0.0,5.0,1.0,0.6,0.6,1.9,2.6,71.0,154.0,65.0,0.0,0.04,0.04,0.0,0.04,0.02,0.07,0.09,0.02,0.09,Matches,Antonino Gallo,D/WB L,22,120,143,Italy,Salento,9,14,14,7,14,9,9,9,12,11,13,7,13,13,13,11,11,10,11,10,11,14,12,10,13,12,11,11,14,14,11,10,14,14,14,10,14,4,14,3,16,3,1,2,2,1,3,2,3,1,3,2,16,13,4,13,13,15,14,14,1,20,1,10,18,10,1,15,1,10,10,1,1,1,183,74,20,8,3439999,5991,5991,3001,Mediterranean_Hispanic,115,1,2000/1/5,0,0,7115.0,,43297394
1192,Federico Gatti,Juventus,1998,219.0,it ITA,DF,24.0,16.1,15.0,11.0,9.0,4.0,2.0,9.0,15.0,60.0,6.0,20.0,14.0,6.0,21.0,36.0,54.0,2.0,Matches,219.0,it ITA,DF,24.0,16.1,19.0,1.18,17.0,0.0,0.0,1.0,1.0,0.0,0.0,0.0,0.0,0.0,0.0,0.0,0.0,0.0,Matches,,,,,,,,,,,,,,,,,,,,,,,,,,,,,,,,,,,,,,,,,,,,,,,,,,,,,,,,219.0,it ITA,DF,24.0,16.1,4.0,0.0,0.0,16.0,13.0,0.0,3.0,21.0,11.0,0.0,0.0,0.0,97.0,32.0,26.0,55.2,Matches,219.0,it ITA,DF,24.0,16.1,957.0,923.0,31.0,21.0,0.0,23.0,3.0,8.0,0.0,0.0,0.0,0.0,808.0,3.0,11.0,Matches,219.0,it ITA,DF,24.0,16.1,808.0,957.0,84.4,16192.0,5297.0,287.0,307.0,93.5,404.0,443.0,91.2,111.0,181.0,61.3,0.0,1.5,1.1,-1.5,6.0,47.0,3.0,0.0,56.0,Matches,292,it ITA,DF,24,18,1448.0,80.0,42.3,16.1,16,90.0,16,2,4.0,20,1.72,16.0,13.0,3.0,0.19,-0.73,22.1,16.7,5.4,0.34,-0.04,Matches,219.0,it ITA,DF,24.0,16.1,1116.0,100.0,527.0,532.0,71.0,23.0,1116.0,11.0,8.0,72.7,2.0,18.2,721.0,3952.0,2208.0,18.0,14.0,1.0,8.0,6.0,806.0,13.0,Matches,219.0,it ITA,DF,24.0,16.1,0.0,13.0,4.0,30.8,0.81,0.25,0.0,0.0,15.5,0.0,0.0,0.0,0.6,0.6,0.04,-0.6,-0.6,Matches,219.0,it ITA,DF,24.0,18.0,16.0,1448.0,16.1,0.0,0.0,0.0,0.0,0.0,0.0,4.0,0.0,0.6,0.6,1.5,2.0,18.0,56.0,13.0,0.0,0.0,0.0,0.0,0.0,0.03,0.09,0.13,0.03,0.13,Matches,Federico Gatti,D C,24,130,149,Italy,Juventus,7,7,8,10,10,7,15,7,8,13,11,7,14,10,14,15,15,14,12,10,12,15,7,12,7,13,16,16,12,11,12,15,14,13,14,15,14,7,14,10,12,2,3,2,1,1,1,2,2,3,1,3,12,15,5,13,12,16,14,15,1,1,20,1,1,1,12,1,10,1,1,1,1,1,190,84,9,20,2305249,6500,7000,5250,Mediterranean_Hispanic,130,2,1998/6/24,1,0,35577.0,,43491384
1193,Valentin Gendrey,Lecce,2000,220.0,fr FRA,DF,22.0,34.5,88.0,57.0,54.0,25.0,9.0,40.0,71.0,56.3,31.0,45.0,4.0,41.0,37.0,125.0,89.0,0.0,Matches,220.0,fr FRA,DF,22.0,34.5,49.0,1.42,37.0,5.0,1.0,0.0,4.0,2.0,4.0,0.12,2.0,0.0,0.0,0.0,2.0,0.0,Matches,,,,,,,,,,,,,,,,,,,,,,,,,,,,,,,,,,,,,,,,,,,,,,,,,,,,,,,,220.0,fr FRA,DF,22.0,34.5,4.0,0.0,0.0,23.0,27.0,1.0,74.0,37.0,57.0,2.0,1.0,0.0,198.0,48.0,43.0,52.7,Matches,220.0,fr FRA,DF,22.0,34.5,1448.0,1076.0,367.0,15.0,1.0,8.0,74.0,352.0,0.0,0.0,0.0,0.0,1031.0,5.0,33.0,Matches,220.0,fr FRA,DF,22.0,34.5,1031.0,1448.0,71.2,16693.0,8217.0,539.0,637.0,84.6,399.0,551.0,72.4,70.0,188.0,37.2,2.0,2.9,1.8,-0.9,27.0,72.0,21.0,13.0,112.0,Matches,294,fr FRA,DF,22,37,3101.0,84.0,90.7,34.5,35,88.0,29,2,11.0,1,0.97,30.0,42.0,-12.0,-0.35,-0.07,32.2,38.2,-6.0,-0.17,-0.16,Matches,220.0,fr FRA,DF,22.0,34.5,1811.0,106.0,616.0,778.0,436.0,16.0,1811.0,35.0,14.0,40.0,17.0,48.6,757.0,4118.0,2380.0,47.0,34.0,4.0,48.0,12.0,787.0,107.0,Matches,220.0,fr FRA,DF,22.0,34.5,0.0,10.0,0.0,0.0,0.29,0.0,0.0,,22.0,0.0,0.0,0.0,0.6,0.6,0.06,-0.6,-0.6,Matches,220.0,fr FRA,DF,22.0,37.0,35.0,3101.0,34.5,0.0,2.0,2.0,0.0,0.0,0.0,4.0,0.0,0.6,0.6,2.9,3.5,47.0,112.0,107.0,0.0,0.06,0.06,0.0,0.06,0.02,0.08,0.1,0.02,0.1,Matches,Valentin Gendrey,D RC,22,120,143,France,Salento,7,13,11,5,13,6,9,8,11,12,12,8,14,12,11,13,10,12,12,11,11,13,7,8,13,14,12,12,14,14,12,8,12,14,14,11,12,9,12,8,10,3,3,2,1,1,2,4,3,3,3,1,13,14,5,12,12,13,12,13,1,1,15,20,1,7,1,1,1,1,1,1,1,1,179,70,10,20,3655999,5995,5243,2524,North_African__Middle_Eastern,120,9,2000/6/21,0,0,1153.0,,49047752
1194,Olivier Giroud,Milan,1986,224.0,fr FRA,FW,35.0,23.8,8.0,5.0,2.0,4.0,2.0,2.0,10.0,20.0,8.0,11.0,3.0,8.0,3.0,11.0,23.0,0.0,Matches,224.0,fr FRA,FW,35.0,23.8,50.0,2.1,39.0,0.0,0.0,8.0,3.0,0.0,6.0,0.25,3.0,0.0,0.0,3.0,0.0,0.0,Matches,,,,,,,,,,,,,,,,,,,,,,,,,,,,,,,,,,,,,,,,,,,,,,,,,,,,,,,,224.0,fr FRA,FW,35.0,23.8,8.0,1.0,1.0,38.0,24.0,16.0,5.0,3.0,5.0,0.0,0.0,0.0,48.0,101.0,63.0,61.6,Matches,224.0,fr FRA,FW,35.0,23.8,560.0,527.0,32.0,2.0,1.0,1.0,5.0,1.0,0.0,0.0,0.0,0.0,351.0,1.0,13.0,Matches,224.0,fr FRA,FW,35.0,23.8,351.0,560.0,62.7,4172.0,765.0,223.0,333.0,67.0,81.0,123.0,65.9,8.0,15.0,53.3,5.0,4.0,2.0,1.0,24.0,13.0,7.0,0.0,36.0,Matches,299,fr FRA,FW,35,33,2139.0,65.0,62.5,23.8,25,78.0,9,8,23.0,2,1.88,42.0,25.0,17.0,0.72,0.43,36.5,23.4,13.1,0.55,0.23,Matches,224.0,fr FRA,FW,35.0,23.8,801.0,29.0,59.0,348.0,402.0,158.0,798.0,14.0,7.0,50.0,6.0,42.9,350.0,934.0,359.0,12.0,10.0,7.0,63.0,16.0,611.0,152.0,Matches,224.0,fr FRA,FW,35.0,23.8,13.0,77.0,29.0,37.7,3.24,1.22,0.13,0.34,12.7,6.0,3.0,3.0,12.7,10.4,0.14,0.3,-0.4,Matches,224.0,fr FRA,FW,35.0,33.0,25.0,2139.0,23.8,13.0,5.0,18.0,10.0,3.0,3.0,8.0,1.0,12.7,10.4,4.0,14.4,12.0,36.0,152.0,0.55,0.21,0.76,0.42,0.63,0.53,0.17,0.7,0.44,0.61,Matches,Olivier Giroud,S,35,151,156,France,AC Milan,4,8,11,15,15,12,19,13,6,8,12,16,7,14,14,17,17,16,14,13,14,20,14,17,17,9,19,15,9,12,19,17,17,12,12,18,14,12,17,10,3,2,3,1,3,3,2,2,1,1,2,3,15,19,8,14,14,20,14,14,1,1,1,1,1,1,1,1,1,1,1,1,1,20,192,93,20,9,6043985,7550,7450,7250,Mediterranean_Hispanic,151,2,1986/9/30,112,48,86345.0,,34000647
1195,Robin Gosens,Inter,1994,229.0,de GER,DF,28.0,13.2,34.0,18.0,15.0,10.0,9.0,15.0,25.0,60.0,10.0,16.0,2.0,14.0,23.0,57.0,15.0,0.0,Matches,229.0,de GER,DF,28.0,13.2,41.0,3.13,35.0,1.0,2.0,2.0,1.0,0.0,2.0,0.15,2.0,0.0,0.0,0.0,0.0,0.0,Matches,,,,,,,,,,,,,,,,,,,,,,,,,,,,,,,,,,,,,,,,,,,,,,,,,,,,,,,,229.0,de GER,DF,28.0,13.2,2.0,0.0,0.0,17.0,3.0,3.0,43.0,23.0,18.0,0.0,0.0,0.0,52.0,20.0,12.0,62.5,Matches,229.0,de GER,DF,28.0,13.2,660.0,570.0,86.0,1.0,1.0,3.0,43.0,85.0,0.0,0.0,0.0,0.0,506.0,4.0,14.0,Matches,229.0,de GER,DF,28.0,13.2,506.0,660.0,76.7,8158.0,2994.0,267.0,293.0,91.1,202.0,263.0,76.8,30.0,75.0,40.0,0.0,2.4,2.9,-2.4,16.0,34.0,15.0,8.0,41.0,Matches,305,de GER,DF,28,32,1184.0,37.0,34.6,13.2,11,73.0,2,21,18.0,3,1.88,17.0,15.0,2.0,0.15,-0.93,23.0,13.1,9.9,0.75,-0.12,Matches,229.0,de GER,DF,28.0,13.2,813.0,27.0,194.0,309.0,314.0,48.0,813.0,17.0,7.0,41.2,8.0,47.1,417.0,1753.0,864.0,29.0,18.0,5.0,17.0,3.0,525.0,102.0,Matches,229.0,de GER,DF,28.0,13.2,3.0,26.0,5.0,19.2,1.98,0.38,0.12,0.6,12.7,0.0,0.0,0.0,3.0,3.0,0.11,0.0,0.0,Matches,229.0,de GER,DF,28.0,32.0,11.0,1184.0,13.2,3.0,0.0,3.0,3.0,0.0,0.0,2.0,0.0,3.0,3.0,2.4,5.3,29.0,41.0,102.0,0.23,0.0,0.23,0.23,0.23,0.23,0.18,0.41,0.23,0.41,Matches,Robin Gosens,D/WB/M L,28,145,156,"Germany,Holland",Atalanta,11,14,11,15,13,6,16,13,8,12,13,6,15,14,13,15,13,14,13,12,13,16,10,10,17,11,15,14,15,12,14,14,12,16,13,13,13,10,15,12,12,1,3,1,1,2,2,3,1,2,2,4,12,16,5,12,15,17,14,13,1,20,1,1,20,1,1,19,1,1,1,1,1,1,184,76,20,9,15000000,7250,7200,6500,Northern_European,141,2,1994/7/5,13,2,28461.0,FC Internazionale Milano,37041773
1196,Alberto Grassi,Empoli,1995,230.0,it ITA,MF,27.0,13.3,26.0,21.0,13.0,13.0,0.0,15.0,24.0,62.5,9.0,23.0,12.0,11.0,27.0,53.0,45.0,0.0,Matches,230.0,it ITA,MF,27.0,13.3,13.0,0.98,11.0,0.0,0.0,1.0,1.0,0.0,1.0,0.08,1.0,0.0,0.0,0.0,0.0,0.0,Matches,,,,,,,,,,,,,,,,,,,,,,,,,,,,,,,,,,,,,,,,,,,,,,,,,,,,,,,,230.0,it ITA,MF,27.0,13.3,3.0,0.0,0.0,22.0,13.0,0.0,0.0,27.0,21.0,0.0,0.0,0.0,91.0,26.0,11.0,70.3,Matches,230.0,it ITA,MF,27.0,13.3,559.0,538.0,19.0,19.0,0.0,1.0,0.0,0.0,0.0,0.0,0.0,0.0,453.0,2.0,8.0,Matches,230.0,it ITA,MF,27.0,13.3,453.0,559.0,81.0,6919.0,2055.0,255.0,289.0,88.2,146.0,181.0,80.7,31.0,53.0,58.5,0.0,0.4,0.3,-0.4,6.0,27.0,5.0,0.0,50.0,Matches,306,it ITA,MF,27,25,1194.0,48.0,34.9,13.3,14,72.0,5,11,17.0,2,1.12,17.0,16.0,1.0,0.08,0.6,14.9,22.1,-7.1,-0.54,-0.04,Matches,230.0,it ITA,MF,27.0,13.3,734.0,79.0,261.0,400.0,80.0,13.0,734.0,8.0,4.0,50.0,4.0,50.0,302.0,1330.0,474.0,5.0,6.0,1.0,18.0,12.0,398.0,10.0,Matches,230.0,it ITA,MF,27.0,13.3,0.0,10.0,3.0,30.0,0.75,0.23,0.0,0.0,15.7,0.0,0.0,0.0,0.6,0.6,0.06,-0.6,-0.6,Matches,230.0,it ITA,MF,27.0,25.0,14.0,1194.0,13.3,0.0,0.0,0.0,0.0,0.0,0.0,3.0,0.0,0.6,0.6,0.4,0.9,5.0,50.0,10.0,0.0,0.0,0.0,0.0,0.0,0.04,0.03,0.07,0.04,0.07,Matches,Alberto Grassi,DM/M C,27,123,130,Italy,Parma Calcio 1913,8,10,10,7,11,5,11,10,7,11,12,11,15,13,12,13,15,12,12,13,13,15,14,9,14,13,14,14,12,12,14,11,13,13,13,12,14,13,14,18,14,2,2,3,3,3,3,3,1,2,3,3,12,15,7,14,13,15,14,12,1,1,1,5,1,10,17,1,20,10,1,1,1,1,183,75,12,20,2256349,6150,6150,4950,Mediterranean_Hispanic,122,4,1995/3/7,0,0,32018.0,Empoli Football Club,43081383
1197,Koray Günter,Hellas Verona,1994,233.0,de GER,DF,27.0,11.1,10.0,6.0,1.0,8.0,1.0,4.0,7.0,57.1,3.0,24.0,15.0,9.0,30.0,40.0,46.0,0.0,Matches,233.0,de GER,DF,27.0,11.1,13.0,1.17,10.0,1.0,0.0,2.0,0.0,0.0,1.0,0.09,0.0,0.0,0.0,1.0,0.0,0.0,Matches,,,,,,,,,,,,,,,,,,,,,,,,,,,,,,,,,,,,,,,,,,,,,,,,,,,,,,,,233.0,de GER,DF,27.0,11.1,3.0,0.0,0.0,17.0,10.0,0.0,3.0,30.0,6.0,0.0,0.0,0.0,81.0,22.0,21.0,51.2,Matches,233.0,de GER,DF,27.0,11.1,422.0,400.0,21.0,20.0,0.0,3.0,3.0,1.0,0.0,0.0,0.0,0.0,323.0,1.0,5.0,Matches,233.0,de GER,DF,27.0,11.1,323.0,422.0,76.5,6871.0,3172.0,102.0,126.0,81.0,160.0,183.0,87.4,58.0,101.0,57.4,0.0,0.9,0.3,-0.9,8.0,31.0,1.0,1.0,36.0,Matches,310,de GER,DF,27,13,1003.0,77.0,29.3,11.1,11,86.0,10,2,29.0,5,0.31,9.0,22.0,-13.0,-1.17,-0.61,12.3,17.9,-5.6,-0.5,-0.19,Matches,233.0,de GER,DF,27.0,11.1,557.0,82.0,283.0,252.0,29.0,10.0,557.0,4.0,3.0,75.0,1.0,25.0,221.0,1219.0,733.0,7.0,6.0,0.0,3.0,1.0,230.0,3.0,Matches,233.0,de GER,DF,27.0,11.1,1.0,9.0,1.0,11.1,0.81,0.09,0.11,1.0,14.2,0.0,0.0,0.0,0.9,0.9,0.1,0.1,0.1,Matches,233.0,de GER,DF,27.0,13.0,11.0,1003.0,11.1,1.0,0.0,1.0,1.0,0.0,0.0,3.0,0.0,0.9,0.9,0.9,1.9,7.0,36.0,3.0,0.09,0.0,0.09,0.09,0.09,0.08,0.08,0.17,0.08,0.17,Matches,Koray Günter,D C,27,129,136,"Germany,Turkey",Hellas Verona,4,7,8,6,11,4,14,5,7,15,11,5,16,10,14,12,16,11,12,9,12,13,7,14,5,14,15,13,12,12,13,13,14,11,14,15,13,14,12,7,8,1,3,3,3,2,3,3,1,3,3,1,11,14,5,15,7,15,14,15,1,1,20,11,1,1,1,1,1,1,1,1,1,1,184,79,11,20,3170192,6450,6300,5100,Mediterranean_Hispanic,127,4,1994/8/16,0,0,28817.0,,92023404
1198,Emmanuel Gyasi,Spezia,1994,235.0,gh GHA,FWDF,28.0,31.2,24.0,15.0,11.0,10.0,3.0,9.0,36.0,25.0,27.0,24.0,6.0,18.0,8.0,32.0,26.0,0.0,Matches,235.0,gh GHA,FWDF,28.0,31.2,53.0,1.7,44.0,0.0,2.0,2.0,3.0,2.0,0.0,0.0,0.0,0.0,0.0,0.0,0.0,0.0,Matches,,,,,,,,,,,,,,,,,,,,,,,,,,,,,,,,,,,,,,,,,,,,,,,,,,,,,,,,235.0,gh GHA,FWDF,28.0,31.2,10.0,0.0,0.0,47.0,37.0,23.0,22.0,8.0,15.0,0.0,0.0,0.0,120.0,18.0,53.0,25.4,Matches,235.0,gh GHA,FWDF,28.0,31.2,802.0,711.0,91.0,3.0,1.0,2.0,22.0,59.0,2.0,0.0,0.0,0.0,646.0,0.0,26.0,Matches,235.0,gh GHA,FWDF,28.0,31.2,646.0,802.0,80.5,8305.0,1651.0,417.0,475.0,87.8,181.0,226.0,80.1,14.0,26.0,53.8,0.0,1.9,1.7,-1.9,22.0,16.0,18.0,2.0,52.0,Matches,312,gh GHA,FWDF,28,35,2810.0,80.0,82.2,31.2,35,80.0,11,0,,0,0.86,26.0,45.0,-19.0,-0.61,1.16,32.1,45.1,-13.0,-0.42,0.33,Matches,235.0,gh GHA,FWDF,28.0,31.2,1103.0,39.0,196.0,444.0,472.0,92.0,1103.0,39.0,7.0,17.9,29.0,74.4,627.0,3276.0,1210.0,35.0,33.0,15.0,72.0,42.0,746.0,154.0,Matches,235.0,gh GHA,FWDF,28.0,31.2,2.0,34.0,13.0,38.2,1.09,0.42,0.06,0.15,13.7,0.0,0.0,0.0,4.0,4.0,0.12,-2.0,-2.0,Matches,235.0,gh GHA,FWDF,28.0,35.0,35.0,2810.0,31.2,2.0,0.0,2.0,2.0,0.0,0.0,10.0,0.0,4.0,4.0,1.9,5.9,35.0,52.0,154.0,0.06,0.0,0.06,0.06,0.06,0.13,0.06,0.19,0.13,0.19,Matches,Emmanuel Gyasi,AM/S RL,28,132,136,"Ghana,Italy",Spezia Calcio,7,13,14,12,13,7,12,11,4,7,14,11,8,13,13,12,12,11,13,13,12,13,12,8,14,8,13,12,14,13,13,10,13,14,14,12,12,9,11,2,15,1,1,1,3,1,1,4,1,3,2,3,12,14,13,11,9,13,11,11,1,1,1,1,12,12,1,14,1,14,20,13,16,18,182,74,8,20,5037830,6597,5921,4610,African_Caribbean,125,17,1994/1/11,3,0,3654.0,,43112998
1199,Nicolas Haas,Empoli,1996,238.0,ch SUI,MF,26.0,12.8,27.0,13.0,16.0,6.0,5.0,12.0,24.0,50.0,12.0,16.0,4.0,12.0,8.0,35.0,27.0,0.0,Matches,238.0,ch SUI,MF,26.0,12.8,19.0,1.48,17.0,1.0,1.0,0.0,0.0,0.0,1.0,0.08,0.0,1.0,0.0,0.0,0.0,0.0,Matches,,,,,,,,,,,,,,,,,,,,,,,,,,,,,,,,,,,,,,,,,,,,,,,,,,,,,,,,238.0,ch SUI,MF,26.0,12.8,2.0,0.0,0.0,20.0,11.0,1.0,11.0,8.0,13.0,0.0,0.0,0.0,62.0,6.0,19.0,24.0,Matches,238.0,ch SUI,MF,26.0,12.8,409.0,400.0,9.0,4.0,0.0,3.0,11.0,2.0,0.0,0.0,0.0,0.0,304.0,0.0,16.0,Matches,238.0,ch SUI,MF,26.0,12.8,304.0,409.0,74.3,5096.0,1341.0,149.0,179.0,83.2,122.0,158.0,77.2,26.0,41.0,63.4,1.0,0.9,0.3,0.1,9.0,29.0,6.0,0.0,36.0,Matches,315,ch SUI,MF,26,24,1156.0,48.0,33.8,12.8,12,72.0,2,12,24.0,11,1.25,9.0,17.0,-8.0,-0.62,-0.46,10.6,21.0,-10.4,-0.8,-0.44,Matches,238.0,ch SUI,MF,26.0,12.8,554.0,43.0,187.0,254.0,115.0,16.0,554.0,6.0,1.0,16.7,4.0,66.7,263.0,946.0,449.0,10.0,13.0,2.0,17.0,9.0,336.0,23.0,Matches,238.0,ch SUI,MF,26.0,12.8,1.0,8.0,3.0,37.5,0.62,0.23,0.13,0.33,16.5,0.0,0.0,0.0,1.2,1.2,0.15,-0.2,-0.2,Matches,238.0,ch SUI,MF,26.0,24.0,12.0,1156.0,12.8,1.0,1.0,2.0,1.0,0.0,0.0,2.0,0.0,1.2,1.2,0.9,2.1,10.0,36.0,23.0,0.08,0.08,0.16,0.08,0.16,0.09,0.07,0.16,0.09,0.16,Matches,Nicolas Haas,M C,26,125,131,Switzerland,Empoli Football Club,10,11,10,9,12,12,11,10,6,10,13,10,13,14,13,13,14,12,13,13,13,14,12,10,12,13,15,14,12,13,13,10,12,13,15,11,15,11,12,12,12,2,1,2,2,1,2,2,4,1,1,1,13,13,12,9,14,15,13,14,1,1,1,1,1,1,14,6,20,6,1,15,1,1,178,74,10,20,2574089,6250,5900,5100,Northern_European,125,2,1996/1/23,0,0,28461.0,,98033333
1200,Hans Hateboer,Atalanta,1994,241.0,nl NED,DF,28.0,15.5,21.0,13.0,11.0,8.0,2.0,11.0,27.0,40.7,16.0,23.0,4.0,19.0,12.0,33.0,25.0,0.0,Matches,241.0,nl NED,DF,28.0,15.5,22.0,1.42,19.0,1.0,1.0,1.0,0.0,0.0,1.0,0.06,1.0,0.0,0.0,0.0,0.0,0.0,Matches,,,,,,,,,,,,,,,,,,,,,,,,,,,,,,,,,,,,,,,,,,,,,,,,,,,,,,,,241.0,nl NED,DF,28.0,15.5,7.0,0.0,0.0,19.0,3.0,1.0,23.0,12.0,13.0,0.0,0.0,0.0,50.0,24.0,14.0,63.2,Matches,241.0,nl NED,DF,28.0,15.5,702.0,571.0,129.0,3.0,2.0,1.0,23.0,126.0,0.0,0.0,0.0,0.0,560.0,2.0,13.0,Matches,241.0,nl NED,DF,28.0,15.5,560.0,702.0,79.8,8088.0,2850.0,339.0,376.0,90.2,173.0,223.0,77.6,31.0,60.0,51.7,1.0,1.5,1.4,-0.5,13.0,28.0,16.0,7.0,55.0,Matches,318,nl NED,DF,28,17,1397.0,82.0,40.8,15.5,17,82.0,11,0,,4,1.82,22.0,16.0,6.0,0.39,-0.15,21.3,17.4,3.9,0.25,-0.3,Matches,241.0,nl NED,DF,28.0,15.5,823.0,37.0,220.0,343.0,263.0,29.0,823.0,9.0,4.0,44.4,3.0,33.3,398.0,1804.0,904.0,16.0,14.0,1.0,8.0,7.0,505.0,73.0,Matches,241.0,nl NED,DF,28.0,15.5,1.0,12.0,4.0,33.3,0.77,0.26,0.08,0.25,10.5,0.0,0.0,0.0,1.3,1.3,0.11,-0.3,-0.3,Matches,241.0,nl NED,DF,28.0,17.0,17.0,1397.0,15.5,1.0,1.0,2.0,1.0,0.0,0.0,7.0,0.0,1.3,1.3,1.5,2.8,16.0,55.0,73.0,0.06,0.06,0.13,0.06,0.13,0.09,0.1,0.18,0.09,0.18,Matches,Hans Hateboer,D/WB/M R,28,141,149,Holland,Atalanta,8,12,10,11,11,8,14,8,11,13,11,8,13,12,16,12,16,14,14,8,12,16,8,11,13,13,16,15,15,11,14,14,16,17,15,16,12,15,13,10,12,2,1,1,2,2,3,2,2,2,1,1,16,13,3,13,13,15,14,12,1,1,13,20,1,20,1,1,1,16,1,1,1,1,185,72,8,20,11012888,7048,6748,5898,Northern_European,137,2,1994/1/9,13,0,28461.0,,37046941
1201,Liam Henderson,Empoli,1996,242.0,sct SCO,MF,26.0,11.2,13.0,10.0,6.0,5.0,2.0,4.0,21.0,19.0,17.0,10.0,2.0,8.0,10.0,23.0,10.0,0.0,Matches,242.0,sct SCO,MF,26.0,11.2,33.0,2.95,30.0,1.0,0.0,1.0,0.0,1.0,1.0,0.09,1.0,0.0,0.0,0.0,0.0,0.0,Matches,,,,,,,,,,,,,,,,,,,,,,,,,,,,,,,,,,,,,,,,,,,,,,,,,,,,,,,,242.0,sct SCO,MF,26.0,11.2,9.0,0.0,0.0,35.0,12.0,2.0,35.0,10.0,10.0,0.0,0.0,0.0,61.0,6.0,11.0,35.3,Matches,242.0,sct SCO,MF,26.0,11.2,545.0,512.0,29.0,10.0,3.0,6.0,35.0,4.0,8.0,2.0,3.0,0.0,432.0,4.0,10.0,Matches,242.0,sct SCO,MF,26.0,11.2,432.0,545.0,79.3,7210.0,2156.0,188.0,212.0,88.7,194.0,222.0,87.4,33.0,76.0,43.4,1.0,1.4,0.9,-0.4,17.0,31.0,12.0,9.0,38.0,Matches,319,sct SCO,MF,26,25,1007.0,40.0,29.4,11.2,11,65.0,0,14,21.0,12,1.16,10.0,19.0,-9.0,-0.8,-0.69,11.2,20.4,-9.2,-0.82,-0.44,Matches,242.0,sct SCO,MF,26.0,11.2,622.0,19.0,135.0,353.0,142.0,14.0,622.0,5.0,0.0,0.0,5.0,100.0,368.0,1669.0,709.0,11.0,9.0,0.0,11.0,6.0,440.0,38.0,Matches,242.0,sct SCO,MF,26.0,11.2,0.0,12.0,5.0,41.7,1.07,0.45,0.0,0.0,23.5,1.0,0.0,0.0,0.5,0.5,0.04,-0.5,-0.5,Matches,242.0,sct SCO,MF,26.0,25.0,11.0,1007.0,11.2,0.0,1.0,1.0,0.0,0.0,0.0,9.0,0.0,0.5,0.5,1.4,1.9,11.0,38.0,38.0,0.0,0.09,0.09,0.0,0.09,0.04,0.12,0.17,0.04,0.17,Matches,Liam Henderson,M/AM C,26,128,134,Scotland,Empoli Football Club,11,11,10,9,13,12,7,14,5,9,14,9,11,13,14,12,14,13,13,13,14,15,11,11,14,11,14,14,12,12,13,11,15,12,16,13,13,11,13,7,13,2,2,2,1,1,2,1,1,1,3,1,15,12,6,12,12,15,11,8,1,1,1,1,1,1,1,10,20,10,10,19,10,1,183,67,10,20,3468584,6400,5800,5000,Northern_European,128,5,1996/4/25,0,0,28461.0,,61058564
1202,Matheus Henrique,Sassuolo,1997,244.0,br BRA,MF,24.0,21.6,26.0,12.0,9.0,11.0,6.0,12.0,24.0,50.0,12.0,15.0,4.0,11.0,12.0,38.0,10.0,0.0,Matches,244.0,br BRA,MF,24.0,21.6,62.0,2.87,53.0,2.0,1.0,2.0,2.0,2.0,5.0,0.23,4.0,1.0,0.0,0.0,0.0,0.0,Matches,,,,,,,,,,,,,,,,,,,,,,,,,,,,,,,,,,,,,,,,,,,,,,,,,,,,,,,,244.0,br BRA,MF,24.0,21.6,4.0,0.0,0.0,22.0,33.0,1.0,9.0,12.0,12.0,0.0,0.0,0.0,97.0,11.0,19.0,36.7,Matches,244.0,br BRA,MF,24.0,21.6,864.0,834.0,28.0,16.0,3.0,8.0,9.0,6.0,3.0,0.0,0.0,0.0,741.0,2.0,25.0,Matches,244.0,br BRA,MF,24.0,21.6,741.0,864.0,85.8,12502.0,3344.0,345.0,386.0,89.4,296.0,323.0,91.6,72.0,91.0,79.1,1.0,1.8,1.3,-0.8,27.0,85.0,16.0,0.0,116.0,Matches,321,br BRA,MF,24,30,1947.0,65.0,56.9,21.6,21,80.0,9,9,30.0,8,1.17,27.0,39.0,-12.0,-0.55,-0.43,29.1,26.7,2.3,0.11,0.14,Matches,244.0,br BRA,MF,24.0,21.6,1025.0,29.0,153.0,563.0,321.0,31.0,1025.0,53.0,34.0,64.2,10.0,18.9,696.0,3965.0,1950.0,40.0,39.0,3.0,28.0,16.0,766.0,68.0,Matches,244.0,br BRA,MF,24.0,21.6,4.0,25.0,12.0,48.0,1.16,0.55,0.16,0.33,16.9,0.0,0.0,0.0,2.9,2.9,0.11,1.1,1.1,Matches,244.0,br BRA,MF,24.0,30.0,21.0,1947.0,21.6,4.0,1.0,5.0,4.0,0.0,0.0,4.0,0.0,2.9,2.9,1.8,4.6,40.0,116.0,68.0,0.18,0.05,0.23,0.18,0.23,0.13,0.08,0.21,0.13,0.21,Matches,Matheus Henrique,DM/M C,24,126,139,Brazil,U.S. Sassuolo,5,6,15,9,15,8,10,12,9,10,14,9,12,15,14,13,13,12,11,14,12,14,13,6,14,13,15,15,13,14,13,9,14,14,13,10,11,13,14,7,12,1,3,1,3,1,3,2,1,3,2,1,11,14,7,12,12,15,10,13,1,1,1,1,1,1,18,1,20,1,1,12,1,1,175,71,8,20,7609044,6300,6986,5339,Mixed_Race,128,8,1997/12/19,1,0,10961.0,,19263862
1203,Thomas Henry,Hellas Verona,1994,245.0,fr FRA,FW,27.0,11.4,5.0,3.0,1.0,1.0,3.0,1.0,5.0,20.0,4.0,6.0,2.0,4.0,0.0,5.0,14.0,0.0,Matches,245.0,fr FRA,FW,27.0,11.4,22.0,1.92,16.0,1.0,1.0,3.0,1.0,0.0,0.0,0.0,0.0,0.0,0.0,0.0,0.0,0.0,Matches,,,,,,,,,,,,,,,,,,,,,,,,,,,,,,,,,,,,,,,,,,,,,,,,,,,,,,,,245.0,fr FRA,FW,27.0,11.4,4.0,0.0,0.0,27.0,16.0,9.0,5.0,0.0,3.0,0.0,0.0,0.0,29.0,46.0,39.0,54.1,Matches,245.0,fr FRA,FW,27.0,11.4,226.0,213.0,9.0,0.0,1.0,2.0,5.0,1.0,0.0,0.0,0.0,0.0,115.0,4.0,9.0,Matches,245.0,fr FRA,FW,27.0,11.4,115.0,226.0,50.9,1405.0,437.0,71.0,124.0,57.3,19.0,46.0,41.3,7.0,12.0,58.3,0.0,1.1,0.5,-1.1,13.0,14.0,6.0,0.0,18.0,Matches,322,fr FRA,FW,27,16,1030.0,64.0,30.1,11.4,13,75.0,3,3,18.0,3,0.5,10.0,17.0,-7.0,-0.61,0.18,10.9,15.5,-4.6,-0.41,-0.05,Matches,245.0,fr FRA,FW,27.0,11.4,374.0,15.0,25.0,160.0,192.0,48.0,374.0,14.0,3.0,21.4,11.0,78.6,193.0,618.0,181.0,3.0,7.0,1.0,52.0,25.0,303.0,58.0,Matches,245.0,fr FRA,FW,27.0,11.4,2.0,18.0,5.0,27.8,1.57,0.44,0.11,0.4,17.4,0.0,0.0,0.0,1.7,1.7,0.1,0.3,0.3,Matches,245.0,fr FRA,FW,27.0,16.0,13.0,1030.0,11.4,2.0,0.0,2.0,2.0,0.0,0.0,4.0,0.0,1.7,1.7,1.1,2.8,3.0,18.0,58.0,0.17,0.0,0.17,0.17,0.17,0.15,0.09,0.24,0.15,0.24,Matches,Thomas Henry,S,27,130,135,France,Hellas Verona,4,8,12,14,13,6,17,12,5,4,12,14,5,12,12,14,15,13,12,11,14,14,9,8,13,10,15,13,12,11,16,15,13,12,13,17,14,7,8,4,13,2,3,3,1,2,2,1,1,3,3,2,10,13,10,11,13,14,11,11,1,1,1,1,1,1,1,1,1,1,1,1,1,20,191,88,8,20,9887062,6500,5306,4977,Northern_European,129,5,1994/9/20,0,0,28461.0,,49030852
1204,Theo Hernández,Milan,1997,246.0,fr FRA,DF,24.0,30.8,43.0,24.0,27.0,15.0,1.0,22.0,38.0,57.9,16.0,34.0,7.0,27.0,21.0,64.0,35.0,1.0,Matches,246.0,fr FRA,DF,24.0,30.8,87.0,2.82,51.0,17.0,3.0,7.0,8.0,1.0,8.0,0.26,5.0,2.0,1.0,0.0,0.0,0.0,Matches,,,,,,,,,,,,,,,,,,,,,,,,,,,,,,,,,,,,,,,,,,,,,,,,,,,,,,,,246.0,fr FRA,DF,24.0,30.8,7.0,0.0,0.0,22.0,57.0,2.0,92.0,21.0,24.0,0.0,0.0,1.0,190.0,37.0,15.0,71.2,Matches,246.0,fr FRA,DF,24.0,30.8,1751.0,1403.0,344.0,50.0,1.0,24.0,92.0,272.0,22.0,2.0,18.0,0.0,1391.0,4.0,42.0,Matches,246.0,fr FRA,DF,24.0,30.8,1391.0,1751.0,79.4,23094.0,7593.0,686.0,765.0,89.7,554.0,672.0,82.4,112.0,203.0,55.2,3.0,3.3,2.9,-0.3,37.0,90.0,36.0,12.0,128.0,Matches,323,fr FRA,DF,24,32,2771.0,87.0,81.0,30.8,32,87.0,27,0,,2,2.0,56.0,31.0,25.0,0.81,1.37,48.9,30.5,18.4,0.6,0.69,Matches,246.0,fr FRA,DF,24.0,30.8,2078.0,69.0,495.0,1026.0,584.0,69.0,2077.0,68.0,19.0,27.9,36.0,52.9,1173.0,7669.0,4489.0,108.0,80.0,16.0,46.0,19.0,1280.0,146.0,Matches,246.0,fr FRA,DF,24.0,30.8,4.0,51.0,11.0,21.6,1.66,0.36,0.06,0.27,23.1,5.0,1.0,1.0,4.1,3.3,0.06,-0.1,-0.3,Matches,246.0,fr FRA,DF,24.0,32.0,32.0,2771.0,30.8,4.0,3.0,7.0,3.0,1.0,1.0,7.0,0.0,4.1,3.3,3.3,6.6,108.0,128.0,146.0,0.13,0.1,0.23,0.1,0.19,0.13,0.11,0.24,0.11,0.21,Matches,Theo Hernández,D/WB L,24,159,167,"France,Spain",AC Milan,8,15,16,13,14,12,13,15,11,12,13,15,14,13,18,13,14,12,11,12,12,16,13,13,17,11,12,13,17,14,17,12,16,18,16,13,14,16,14,6,11,1,2,1,1,1,1,3,2,1,1,3,17,15,14,10,15,14,6,9,1,20,10,1,20,1,1,15,1,1,10,1,1,1,184,81,20,8,179870630,7950,7900,7250,Mediterranean_Hispanic,149,2,1997/10/6,7,1,98653.0,,67211695
1205,Isak Hien,Hellas Verona,1999,247.0,se SWE,DF,23.0,29.0,73.0,36.0,54.0,19.0,0.0,38.0,61.0,62.3,23.0,40.0,17.0,23.0,31.0,104.0,92.0,1.0,Matches,247.0,se SWE,DF,23.0,29.0,18.0,0.62,15.0,1.0,0.0,0.0,0.0,2.0,0.0,0.0,0.0,0.0,0.0,0.0,0.0,0.0,Matches,,,,,,,,,,,,,,,,,,,,,,,,,,,,,,,,,,,,,,,,,,,,,,,,,,,,,,,,247.0,se SWE,DF,23.0,29.0,9.0,0.0,0.0,52.0,23.0,0.0,1.0,31.0,36.0,0.0,0.0,0.0,229.0,80.0,53.0,60.2,Matches,247.0,se SWE,DF,23.0,29.0,1031.0,979.0,49.0,26.0,0.0,5.0,1.0,23.0,0.0,0.0,0.0,0.0,775.0,3.0,18.0,Matches,247.0,se SWE,DF,23.0,29.0,775.0,1031.0,75.2,16071.0,6179.0,206.0,269.0,76.6,449.0,532.0,84.4,108.0,183.0,59.0,0.0,0.1,0.2,-0.1,2.0,41.0,3.0,1.0,54.0,Matches,324,se SWE,DF,23,32,2607.0,81.0,76.2,29.0,28,87.0,26,4,40.0,0,0.97,24.0,42.0,-18.0,-0.62,0.49,28.2,37.9,-9.8,-0.34,0.14,Matches,247.0,se SWE,DF,23.0,29.0,1349.0,168.0,794.0,526.0,47.0,13.0,1349.0,31.0,16.0,51.6,11.0,35.5,606.0,2735.0,1294.0,17.0,10.0,0.0,26.0,10.0,576.0,2.0,Matches,247.0,se SWE,DF,23.0,29.0,0.0,3.0,0.0,0.0,0.1,0.0,0.0,,8.6,0.0,0.0,0.0,0.3,0.3,0.09,-0.3,-0.3,Matches,247.0,se SWE,DF,23.0,32.0,28.0,2607.0,29.0,0.0,0.0,0.0,0.0,0.0,0.0,9.0,0.0,0.3,0.3,0.1,0.4,17.0,54.0,2.0,0.0,0.0,0.0,0.0,0.0,0.01,0.0,0.01,0.01,0.01,Matches,Isak Hien,D C,23,121,142,"Sweden,Ghana,Burkina Faso",Hellas Verona,6,8,10,5,10,5,13,7,9,13,12,5,13,11,12,12,15,10,10,10,10,15,8,7,8,11,12,13,14,12,13,17,12,15,14,17,13,9,12,6,14,3,2,1,1,1,2,3,1,3,3,3,14,13,8,11,15,14,14,15,1,10,20,12,8,10,1,6,1,6,6,1,6,8,191,88,7,20,3152995,6050,6050,2250,African_Caribbean,119,12,1999/1/13,0,0,7795.0,,93083839
1206,Morten Hjulmand,Lecce,1999,248.0,dk DEN,MF,23.0,32.9,90.0,52.0,49.0,40.0,1.0,37.0,67.0,55.2,30.0,43.0,11.0,32.0,72.0,162.0,54.0,0.0,Matches,248.0,dk DEN,MF,23.0,32.9,60.0,1.82,53.0,3.0,0.0,1.0,3.0,0.0,6.0,0.18,6.0,0.0,0.0,0.0,0.0,0.0,Matches,,,,,,,,,,,,,,,,,,,,,,,,,,,,,,,,,,,,,,,,,,,,,,,,,,,,,,,,248.0,dk DEN,MF,23.0,32.9,9.0,1.0,0.0,61.0,38.0,0.0,17.0,72.0,52.0,0.0,1.0,0.0,252.0,41.0,29.0,58.6,Matches,248.0,dk DEN,MF,23.0,32.9,1325.0,1233.0,88.0,83.0,2.0,26.0,17.0,3.0,1.0,0.0,1.0,0.0,1040.0,4.0,19.0,Matches,248.0,dk DEN,MF,23.0,32.9,1040.0,1325.0,78.5,19699.0,6227.0,428.0,516.0,82.9,452.0,521.0,86.8,138.0,225.0,61.3,4.0,2.1,1.5,1.9,26.0,152.0,19.0,5.0,159.0,Matches,325,dk DEN,MF,23,35,2962.0,85.0,86.6,32.9,34,86.0,30,1,27.0,1,0.94,31.0,44.0,-13.0,-0.4,-0.4,32.3,36.2,-3.9,-0.12,0.3,Matches,248.0,dk DEN,MF,23.0,32.9,1665.0,101.0,472.0,982.0,225.0,6.0,1665.0,26.0,17.0,65.4,3.0,11.5,750.0,3378.0,1324.0,9.0,16.0,0.0,29.0,19.0,791.0,16.0,Matches,248.0,dk DEN,MF,23.0,32.9,0.0,17.0,4.0,23.5,0.52,0.12,0.0,0.0,26.2,0.0,0.0,0.0,0.6,0.6,0.03,-0.6,-0.6,Matches,248.0,dk DEN,MF,23.0,35.0,34.0,2962.0,32.9,0.0,4.0,4.0,0.0,0.0,0.0,9.0,1.0,0.6,0.6,2.1,2.7,9.0,159.0,16.0,0.0,0.12,0.12,0.0,0.12,0.02,0.06,0.08,0.02,0.08,Matches,Morten Hjulmand,DM/M C,23,126,148,Denmark,Salento,8,10,10,9,14,7,10,10,9,12,14,7,13,14,12,12,14,12,11,14,11,14,9,8,15,15,13,14,13,11,14,12,14,13,13,12,12,9,10,7,10,1,2,3,2,1,3,1,2,2,1,1,11,14,5,11,13,14,13,13,1,1,1,1,1,1,20,13,19,5,1,11,1,1,185,77,11,20,3673929,6300,6200,3556,Northern_European,124,5,1999/6/25,0,0,4038.0,,27132703
1207,Emil Holm,Spezia,2000,249.0,se SWE,DF,22.0,15.5,26.0,15.0,13.0,8.0,5.0,16.0,31.0,51.6,15.0,21.0,6.0,15.0,9.0,35.0,41.0,0.0,Matches,249.0,se SWE,DF,22.0,15.5,36.0,2.33,24.0,5.0,2.0,2.0,3.0,0.0,1.0,0.06,1.0,0.0,0.0,0.0,0.0,0.0,Matches,,,,,,,,,,,,,,,,,,,,,,,,,,,,,,,,,,,,,,,,,,,,,,,,,,,,,,,,249.0,se SWE,DF,22.0,15.5,4.0,0.0,0.0,22.0,16.0,2.0,50.0,9.0,15.0,0.0,0.0,0.0,81.0,65.0,62.0,51.2,Matches,249.0,se SWE,DF,22.0,15.5,573.0,463.0,108.0,1.0,1.0,3.0,50.0,107.0,0.0,0.0,0.0,0.0,342.0,2.0,21.0,Matches,249.0,se SWE,DF,22.0,15.5,342.0,573.0,59.7,5181.0,1707.0,178.0,246.0,72.4,127.0,204.0,62.3,17.0,63.0,27.0,1.0,1.3,1.1,-0.3,13.0,30.0,12.0,5.0,40.0,Matches,326,se SWE,DF,22,20,1393.0,70.0,40.7,15.5,17,79.0,9,3,15.0,3,0.9,14.0,24.0,-10.0,-0.65,0.29,16.0,23.3,-7.3,-0.47,0.0,Matches,249.0,se SWE,DF,22.0,15.5,804.0,42.0,179.0,318.0,318.0,40.0,804.0,44.0,18.0,40.9,21.0,47.7,338.0,2509.0,1128.0,41.0,24.0,10.0,47.0,22.0,430.0,82.0,Matches,249.0,se SWE,DF,22.0,15.5,1.0,15.0,5.0,33.3,0.97,0.32,0.07,0.2,14.9,0.0,0.0,0.0,1.2,1.2,0.08,-0.2,-0.2,Matches,249.0,se SWE,DF,22.0,20.0,17.0,1393.0,15.5,1.0,1.0,2.0,1.0,0.0,0.0,4.0,0.0,1.2,1.2,1.3,2.5,41.0,40.0,82.0,0.06,0.06,0.13,0.06,0.13,0.08,0.08,0.16,0.08,0.16,Matches,Emil Holm,D/WB R,22,124,147,Sweden,Spezia Calcio,7,11,12,7,11,9,12,8,8,10,10,5,11,11,11,11,14,11,13,10,12,14,8,7,13,11,14,14,14,11,12,15,10,16,15,14,12,6,11,8,11,2,2,2,1,1,1,3,2,4,1,1,11,14,6,13,11,14,12,8,1,10,14,20,1,20,1,1,1,15,1,1,12,1,191,83,7,20,5127999,6200,5505,861,Northern_European,117,4,2000/5/13,0,0,3999.0,,93085044
1208,Elseid Hysaj,Lazio,1994,253.0,al ALB,DF,28.0,22.2,39.0,23.0,24.0,11.0,4.0,23.0,41.0,56.1,18.0,31.0,7.0,24.0,20.0,59.0,42.0,0.0,Matches,253.0,al ALB,DF,28.0,22.2,38.0,1.71,34.0,0.0,2.0,0.0,2.0,0.0,2.0,0.09,2.0,0.0,0.0,0.0,0.0,0.0,Matches,,,,,,,,,,,,,,,,,,,,,,,,,,,,,,,,,,,,,,,,,,,,,,,,,,,,,,,,253.0,al ALB,DF,28.0,22.2,3.0,0.0,0.0,19.0,14.0,2.0,16.0,20.0,23.0,0.0,1.0,0.0,132.0,24.0,24.0,50.0,Matches,253.0,al ALB,DF,28.0,22.2,1399.0,1208.0,190.0,23.0,2.0,5.0,16.0,167.0,0.0,0.0,0.0,0.0,1186.0,1.0,27.0,Matches,253.0,al ALB,DF,28.0,22.2,1186.0,1399.0,84.8,17630.0,7029.0,669.0,715.0,93.6,420.0,487.0,86.2,60.0,114.0,52.6,1.0,1.1,1.1,-0.1,13.0,101.0,15.0,6.0,103.0,Matches,330,al ALB,DF,28,34,1998.0,59.0,58.4,22.2,22,82.0,14,12,16.0,3,2.09,38.0,17.0,21.0,0.95,0.38,31.4,22.9,8.5,0.38,0.3,Matches,253.0,al ALB,DF,28.0,22.2,1589.0,61.0,542.0,825.0,235.0,10.0,1589.0,21.0,6.0,28.6,10.0,47.6,822.0,3533.0,1836.0,36.0,27.0,4.0,19.0,13.0,1019.0,60.0,Matches,253.0,al ALB,DF,28.0,22.2,1.0,4.0,2.0,50.0,0.18,0.09,0.25,0.5,20.8,0.0,0.0,0.0,0.2,0.2,0.04,0.8,0.8,Matches,253.0,al ALB,DF,28.0,34.0,22.0,1998.0,22.2,1.0,1.0,2.0,1.0,0.0,0.0,3.0,0.0,0.2,0.2,1.1,1.3,36.0,103.0,60.0,0.05,0.05,0.09,0.05,0.09,0.01,0.05,0.06,0.01,0.06,Matches,Elseid Hysaj,D RL,28,136,145,Albania,S.S. Lazio,8,12,12,8,12,8,11,8,9,13,12,8,14,12,13,15,14,10,10,12,10,13,8,12,15,13,15,14,14,14,14,11,16,15,17,13,11,6,13,6,15,3,2,2,2,2,3,3,1,3,3,3,15,14,7,13,12,14,13,13,1,16,10,20,15,15,1,9,1,10,1,1,1,1,182,70,11,20,7103724,6800,7450,5746,Mediterranean_Hispanic,133,6,1994/2/2,71,2,71154.0,,43083951
1209,Rasmus Højlund,Atalanta,2003,254.0,dk DEN,FW,19.0,20.4,4.0,3.0,0.0,2.0,2.0,1.0,6.0,16.7,5.0,9.0,1.0,8.0,1.0,5.0,5.0,0.0,Matches,254.0,dk DEN,FW,19.0,20.4,56.0,2.75,37.0,0.0,7.0,6.0,6.0,0.0,5.0,0.25,3.0,0.0,0.0,0.0,2.0,0.0,Matches,,,,,,,,,,,,,,,,,,,,,,,,,,,,,,,,,,,,,,,,,,,,,,,,,,,,,,,,254.0,dk DEN,FW,19.0,20.4,1.0,0.0,0.0,21.0,32.0,6.0,7.0,1.0,3.0,2.0,0.0,0.0,58.0,33.0,56.0,37.1,Matches,254.0,dk DEN,FW,19.0,20.4,435.0,408.0,24.0,1.0,2.0,2.0,7.0,1.0,0.0,0.0,0.0,0.0,318.0,3.0,17.0,Matches,254.0,dk DEN,FW,19.0,20.4,318.0,435.0,73.1,4078.0,574.0,200.0,257.0,77.8,75.0,97.0,77.3,16.0,18.0,88.9,2.0,2.4,1.8,-0.4,24.0,23.0,11.0,1.0,37.0,Matches,331,dk DEN,FW,19,32,1834.0,57.0,53.6,20.4,20,74.0,5,12,29.0,3,1.69,45.0,29.0,16.0,0.79,0.67,34.5,23.1,11.4,0.56,0.29,Matches,254.0,dk DEN,FW,19.0,20.4,700.0,6.0,17.0,251.0,438.0,133.0,700.0,75.0,28.0,37.3,31.0,41.3,455.0,2524.0,855.0,40.0,26.0,31.0,94.0,56.0,570.0,224.0,Matches,254.0,dk DEN,FW,19.0,20.4,9.0,54.0,28.0,51.9,2.65,1.37,0.17,0.32,12.9,0.0,0.0,0.0,9.5,9.5,0.18,-0.5,-0.5,Matches,254.0,dk DEN,FW,19.0,32.0,20.0,1834.0,20.4,9.0,2.0,11.0,9.0,0.0,0.0,1.0,0.0,9.5,9.5,2.4,11.8,40.0,37.0,224.0,0.44,0.1,0.54,0.44,0.54,0.47,0.12,0.58,0.47,0.58,Matches,Rasmus Højlund,AM/S C,19,132,-85,Denmark,Atalanta,7,10,12,15,13,7,13,9,7,7,12,9,7,13,14,14,14,12,11,10,12,15,11,8,13,8,14,14,13,11,13,15,13,15,14,14,13,10,12,7,9,2,2,2,3,1,2,3,2,1,1,2,16,15,5,15,15,16,14,10,1,1,1,1,1,1,1,1,1,1,1,16,1,20,191,79,20,12,66000000,6600,6400,3000,Northern_European,131,3,2003/2/4,0,0,12308.0,,27160181
1210,Igor,Fiorentina,1998,258.0,br BRA,DF,24.0,22.9,43.0,29.0,21.0,18.0,4.0,20.0,27.0,74.1,7.0,33.0,14.0,19.0,25.0,68.0,56.0,2.0,Matches,258.0,br BRA,DF,24.0,22.9,19.0,0.83,16.0,0.0,2.0,0.0,0.0,1.0,1.0,0.04,1.0,0.0,0.0,0.0,0.0,0.0,Matches,,,,,,,,,,,,,,,,,,,,,,,,,,,,,,,,,,,,,,,,,,,,,,,,,,,,,,,,258.0,br BRA,DF,24.0,22.9,10.0,1.0,1.0,29.0,13.0,0.0,1.0,25.0,29.0,0.0,0.0,0.0,157.0,38.0,28.0,57.6,Matches,258.0,br BRA,DF,24.0,22.9,1324.0,1256.0,67.0,57.0,1.0,12.0,1.0,10.0,0.0,0.0,0.0,0.0,1165.0,1.0,12.0,Matches,258.0,br BRA,DF,24.0,22.9,1165.0,1324.0,88.0,23901.0,7556.0,322.0,343.0,93.9,686.0,733.0,93.6,144.0,213.0,67.6,0.0,0.2,0.2,-0.2,3.0,77.0,2.0,0.0,76.0,Matches,337,br BRA,DF,24,27,2057.0,76.0,60.1,22.9,23,84.0,18,4,31.0,7,1.33,26.0,24.0,2.0,0.09,-0.44,33.0,26.7,6.3,0.28,-0.08,Matches,258.0,br BRA,DF,24.0,22.9,1522.0,122.0,668.0,820.0,46.0,12.0,1522.0,13.0,9.0,69.2,2.0,15.4,901.0,5350.0,3206.0,19.0,13.0,0.0,9.0,11.0,973.0,2.0,Matches,258.0,br BRA,DF,24.0,22.9,0.0,7.0,0.0,0.0,0.31,0.0,0.0,,12.4,0.0,0.0,0.0,0.5,0.5,0.08,-0.5,-0.5,Matches,258.0,br BRA,DF,24.0,27.0,23.0,2057.0,22.9,0.0,0.0,0.0,0.0,0.0,0.0,10.0,1.0,0.5,0.5,0.2,0.8,19.0,76.0,2.0,0.0,0.0,0.0,0.0,0.0,0.02,0.01,0.03,0.02,0.03,Matches,Igor,D LC,24,140,154,Brazil,ACF Fiorentina,6,9,11,6,12,6,14,9,12,15,14,7,15,13,14,13,14,12,13,11,12,14,11,8,9,14,14,15,14,12,15,14,15,14,15,15,13,12,10,8,12,3,2,1,2,2,1,3,4,2,3,3,12,14,6,10,10,14,12,12,1,16,20,1,15,1,1,12,1,1,1,1,1,1,185,85,20,10,11706474,7050,5460,5460,African_Caribbean,139,13,1998/2/7,0,0,17307.0,,16199713
1211,Ivan Ilić,Torino,2001,261.0,rs SRB,MF,21.0,13.1,18.0,7.0,6.0,11.0,1.0,10.0,20.0,50.0,10.0,12.0,3.0,9.0,5.0,23.0,10.0,0.0,Matches,261.0,rs SRB,MF,21.0,13.1,35.0,2.68,28.0,5.0,0.0,0.0,1.0,1.0,5.0,0.38,4.0,0.0,0.0,0.0,1.0,0.0,Matches,,,,,,,,,,,,,,,,,,,,,,,,,,,,,,,,,,,,,,,,,,,,,,,,,,,,,,,,261.0,rs SRB,MF,21.0,13.1,3.0,0.0,0.0,13.0,19.0,1.0,34.0,5.0,7.0,1.0,0.0,0.0,71.0,11.0,15.0,42.3,Matches,261.0,rs SRB,MF,21.0,13.1,824.0,767.0,55.0,29.0,3.0,1.0,34.0,7.0,19.0,17.0,2.0,0.0,713.0,2.0,9.0,Matches,261.0,rs SRB,MF,21.0,13.1,713.0,824.0,86.5,11609.0,2711.0,338.0,367.0,92.1,311.0,348.0,89.4,41.0,69.0,59.4,2.0,1.1,1.4,0.9,13.0,66.0,12.0,4.0,66.0,Matches,340,rs SRB,MF,21,14,1177.0,84.0,34.4,13.1,13,88.0,9,1,37.0,1,1.57,18.0,12.0,6.0,0.46,0.66,14.8,9.4,5.4,0.41,0.55,Matches,261.0,rs SRB,MF,21.0,13.1,930.0,19.0,150.0,613.0,179.0,8.0,930.0,15.0,7.0,46.7,3.0,20.0,518.0,3188.0,1577.0,29.0,28.0,3.0,19.0,5.0,666.0,28.0,Matches,261.0,rs SRB,MF,21.0,13.1,2.0,5.0,2.0,40.0,0.38,0.15,0.4,1.0,27.2,0.0,0.0,0.0,0.2,0.2,0.04,1.8,1.8,Matches,261.0,rs SRB,MF,21.0,14.0,13.0,1177.0,13.1,2.0,2.0,4.0,2.0,0.0,0.0,3.0,0.0,0.2,0.2,1.1,1.3,29.0,66.0,28.0,0.15,0.15,0.31,0.15,0.31,0.02,0.08,0.1,0.02,0.1,Matches,Ivan Ilić,DM/M/AM C,21,135,159,Serbia,Hellas Verona,13,12,15,10,14,12,9,11,7,8,14,10,12,15,10,14,11,14,12,14,13,15,13,9,11,12,16,12,12,13,13,12,15,14,14,12,13,9,12,6,11,3,1,3,2,2,1,3,2,3,1,2,16,15,6,12,12,17,11,12,1,1,1,1,1,1,18,1,20,1,1,18,1,1,182,75,20,11,32960000,6750,6400,5300,Northern_European,133,4,2001/3/17,3,0,4999.0,,62201068
1212,Ciro Immobile,Lazio,1990,265.0,it ITA,FW,32.0,24.7,11.0,5.0,4.0,4.0,3.0,6.0,9.0,66.7,3.0,10.0,2.0,8.0,1.0,12.0,14.0,0.0,Matches,265.0,it ITA,FW,32.0,24.7,72.0,2.92,48.0,0.0,7.0,12.0,5.0,0.0,15.0,0.61,10.0,0.0,0.0,3.0,2.0,0.0,Matches,,,,,,,,,,,,,,,,,,,,,,,,,,,,,,,,,,,,,,,,,,,,,,,,,,,,,,,,265.0,it ITA,FW,32.0,24.7,3.0,0.0,0.0,21.0,24.0,21.0,5.0,1.0,5.0,3.0,0.0,0.0,52.0,14.0,33.0,29.8,Matches,265.0,it ITA,FW,32.0,24.7,629.0,605.0,19.0,0.0,5.0,2.0,5.0,8.0,0.0,0.0,0.0,0.0,472.0,5.0,25.0,Matches,265.0,it ITA,FW,32.0,24.7,472.0,629.0,75.0,6048.0,963.0,295.0,356.0,82.9,120.0,156.0,76.9,19.0,26.0,73.1,5.0,1.9,1.6,3.1,26.0,19.0,11.0,0.0,43.0,Matches,344,it ITA,FW,32,31,2219.0,72.0,64.9,24.7,27,79.0,17,4,22.0,2,1.97,42.0,19.0,23.0,0.93,0.41,32.9,28.6,4.2,0.17,-0.25,Matches,265.0,it ITA,FW,32.0,24.7,868.0,18.0,55.0,370.0,451.0,159.0,863.0,43.0,18.0,41.9,20.0,46.5,503.0,2914.0,1134.0,40.0,21.0,27.0,63.0,22.0,695.0,174.0,Matches,265.0,it ITA,FW,32.0,24.7,12.0,72.0,30.0,41.7,2.92,1.22,0.11,0.27,15.0,0.0,4.0,5.0,14.2,10.3,0.14,-2.2,-2.3,Matches,265.0,it ITA,FW,32.0,31.0,27.0,2219.0,24.7,12.0,5.0,17.0,8.0,4.0,5.0,3.0,0.0,14.2,10.3,1.9,12.2,40.0,43.0,174.0,0.49,0.2,0.69,0.32,0.53,0.57,0.08,0.65,0.42,0.49,Matches,Ciro Immobile,S,32,160,165,Italy,S.S. Lazio,3,3,12,18,13,3,16,13,3,4,12,17,7,12,14,19,15,14,13,11,14,20,12,15,19,3,16,16,15,14,16,11,20,16,15,13,17,8,11,3,7,2,3,3,3,4,1,3,4,2,2,2,6,19,8,17,12,20,14,12,1,1,1,1,1,1,1,1,1,1,6,10,6,20,185,85,14,20,347975206,8000,8000,7750,Mediterranean_Hispanic,158,3,1990/2/20,55,15,142499.0,,43010773
1213,Ardian Ismajli,Empoli,1996,266.0,al ALB,DF,25.0,23.3,40.0,32.0,25.0,15.0,0.0,18.0,24.0,75.0,6.0,47.0,31.0,16.0,27.0,67.0,120.0,0.0,Matches,266.0,al ALB,DF,25.0,23.3,11.0,0.47,9.0,0.0,0.0,1.0,0.0,1.0,0.0,0.0,0.0,0.0,0.0,0.0,0.0,0.0,Matches,,,,,,,,,,,,,,,,,,,,,,,,,,,,,,,,,,,,,,,,,,,,,,,,,,,,,,,,266.0,al ALB,DF,25.0,23.3,3.0,0.0,0.0,19.0,13.0,0.0,0.0,27.0,32.0,0.0,0.0,1.0,93.0,57.0,41.0,58.2,Matches,266.0,al ALB,DF,25.0,23.3,1029.0,980.0,48.0,28.0,1.0,5.0,0.0,2.0,0.0,0.0,0.0,0.0,871.0,1.0,14.0,Matches,266.0,al ALB,DF,25.0,23.3,871.0,1029.0,84.6,17177.0,5741.0,273.0,295.0,92.5,504.0,562.0,89.7,87.0,141.0,61.7,0.0,0.3,0.4,-0.3,5.0,26.0,3.0,0.0,42.0,Matches,346,al ALB,DF,25,25,2094.0,84.0,61.2,23.3,22,90.0,22,3,38.0,2,1.12,24.0,27.0,-3.0,-0.13,0.48,25.2,30.2,-4.9,-0.21,0.77,Matches,266.0,al ALB,DF,25.0,23.3,1301.0,242.0,785.0,494.0,25.0,18.0,1301.0,2.0,2.0,100.0,0.0,0.0,694.0,3506.0,1752.0,10.0,2.0,0.0,3.0,2.0,762.0,0.0,Matches,266.0,al ALB,DF,25.0,23.3,0.0,9.0,2.0,22.2,0.39,0.09,0.0,0.0,12.0,0.0,0.0,0.0,0.7,0.7,0.08,-0.7,-0.7,Matches,266.0,al ALB,DF,25.0,25.0,22.0,2094.0,23.3,0.0,0.0,0.0,0.0,0.0,0.0,3.0,0.0,0.7,0.7,0.3,1.0,10.0,42.0,0.0,0.0,0.0,0.0,0.0,0.0,0.03,0.01,0.04,0.03,0.04,Matches,Ardian Ismajli,D RC,25,126,135,"Albania,Kosovo",Empoli Football Club,5,8,8,8,10,7,14,8,14,14,12,6,14,9,14,14,15,12,12,11,10,13,7,12,9,14,14,14,12,12,14,14,12,13,15,15,10,11,11,9,11,2,1,4,2,3,1,2,1,1,3,1,11,12,14,12,11,14,8,12,1,1,20,16,1,10,1,1,1,1,1,1,1,1,185,80,8,20,2621506,6300,5950,5000,Mediterranean_Hispanic,127,4,1996/9/30,27,1,32115.0,,24052869
1214,Armando Izzo,Monza,1992,268.0,it ITA,DF,30.0,27.4,73.0,50.0,44.0,27.0,2.0,29.0,45.0,64.4,16.0,29.0,17.0,12.0,50.0,123.0,87.0,1.0,Matches,268.0,it ITA,DF,30.0,27.4,26.0,0.95,22.0,0.0,0.0,1.0,1.0,2.0,1.0,0.04,0.0,0.0,0.0,0.0,1.0,0.0,Matches,,,,,,,,,,,,,,,,,,,,,,,,,,,,,,,,,,,,,,,,,,,,,,,,,,,,,,,,268.0,it ITA,DF,30.0,27.4,10.0,0.0,0.0,44.0,45.0,1.0,7.0,50.0,50.0,1.0,1.0,0.0,150.0,40.0,37.0,51.9,Matches,268.0,it ITA,DF,30.0,27.4,1597.0,1495.0,96.0,67.0,1.0,19.0,7.0,25.0,0.0,0.0,0.0,0.0,1389.0,6.0,8.0,Matches,268.0,it ITA,DF,30.0,27.4,1389.0,1597.0,87.0,25346.0,7926.0,543.0,583.0,93.1,687.0,755.0,91.0,131.0,213.0,61.5,0.0,0.9,0.8,-0.9,15.0,85.0,7.0,2.0,96.0,Matches,348,it ITA,DF,30,30,2466.0,82.0,72.1,27.4,29,85.0,19,1,5.0,0,1.73,39.0,25.0,14.0,0.51,2.21,33.1,32.8,0.3,0.01,0.55,Matches,268.0,it ITA,DF,30.0,27.4,1890.0,191.0,962.0,812.0,130.0,28.0,1890.0,22.0,11.0,50.0,9.0,40.9,1041.0,4854.0,2484.0,22.0,10.0,1.0,11.0,8.0,1280.0,29.0,Matches,268.0,it ITA,DF,30.0,27.4,1.0,16.0,4.0,25.0,0.58,0.15,0.06,0.25,10.4,0.0,0.0,0.0,2.1,2.1,0.13,-1.1,-1.1,Matches,268.0,it ITA,DF,30.0,30.0,29.0,2466.0,27.4,1.0,0.0,1.0,1.0,0.0,0.0,10.0,0.0,2.1,2.1,0.9,3.1,22.0,96.0,29.0,0.04,0.0,0.04,0.04,0.04,0.08,0.03,0.11,0.08,0.11,Matches,Armando Izzo,D RC,30,133,146,Italy,Torino,4,8,10,9,12,4,15,8,4,14,12,5,14,12,16,15,15,13,13,9,14,16,7,14,9,13,14,14,14,13,14,12,14,14,13,13,12,12,13,11,11,3,3,2,3,1,2,3,1,3,3,3,12,14,9,13,12,14,13,15,1,1,20,17,1,10,1,1,1,1,1,1,1,1,183,78,8,20,5365133,6650,6500,5250,Mediterranean_Hispanic,134,4,1992/3/2,3,0,60480.0,Brianza,43093074
1215,Juan Jesus,Napoli,1991,271.0,br BRA,DF,31.0,10.4,16.0,11.0,9.0,6.0,1.0,9.0,12.0,75.0,3.0,18.0,11.0,7.0,10.0,26.0,29.0,0.0,Matches,271.0,br BRA,DF,31.0,10.4,13.0,1.25,10.0,0.0,0.0,2.0,0.0,1.0,1.0,0.1,1.0,0.0,0.0,0.0,0.0,0.0,Matches,,,,,,,,,,,,,,,,,,,,,,,,,,,,,,,,,,,,,,,,,,,,,,,,,,,,,,,,271.0,br BRA,DF,31.0,10.4,2.0,0.0,0.0,10.0,5.0,0.0,0.0,10.0,11.0,0.0,0.0,0.0,58.0,30.0,9.0,76.9,Matches,271.0,br BRA,DF,31.0,10.4,742.0,703.0,38.0,30.0,1.0,0.0,0.0,7.0,0.0,0.0,0.0,0.0,669.0,1.0,1.0,Matches,271.0,br BRA,DF,31.0,10.4,669.0,742.0,90.2,12151.0,4256.0,252.0,265.0,95.1,356.0,387.0,92.0,50.0,67.0,74.6,0.0,0.1,0.3,-0.1,2.0,45.0,1.0,0.0,55.0,Matches,352,br BRA,DF,31,15,933.0,62.0,27.3,10.4,10,87.0,9,5,13.0,22,2.2,20.0,8.0,12.0,1.16,-0.18,17.6,9.6,8.0,0.77,-0.13,Matches,271.0,br BRA,DF,31.0,10.4,834.0,56.0,300.0,518.0,21.0,7.0,834.0,0.0,0.0,,0.0,,532.0,3282.0,2091.0,14.0,9.0,0.0,5.0,1.0,575.0,3.0,Matches,271.0,br BRA,DF,31.0,10.4,1.0,5.0,1.0,20.0,0.48,0.1,0.2,1.0,17.3,0.0,0.0,0.0,0.2,0.2,0.04,0.8,0.8,Matches,271.0,br BRA,DF,31.0,15.0,10.0,933.0,10.4,1.0,0.0,1.0,1.0,0.0,0.0,2.0,0.0,0.2,0.2,0.1,0.3,14.0,55.0,3.0,0.1,0.0,0.1,0.1,0.1,0.02,0.01,0.02,0.02,0.02,Matches,Juan Jesus,D LC,31,138,145,Brazil,Parthenope,4,10,11,6,11,5,14,6,10,15,12,9,17,11,16,13,17,10,10,11,11,17,7,13,9,13,14,17,14,13,17,13,15,15,16,17,14,13,13,5,12,3,2,2,3,3,1,3,1,1,2,3,14,16,10,13,14,18,10,9,1,17,20,10,1,1,1,1,1,1,1,1,1,1,185,83,20,7,6306376,6900,6500,5500,Mixed_Race,138,12,1991/6/10,4,0,35577.0,,19042304
1216,Luka Jović,Fiorentina,1997,273.0,rs SRB,FWMF,24.0,17.0,6.0,3.0,1.0,4.0,1.0,2.0,8.0,25.0,6.0,7.0,2.0,5.0,2.0,8.0,10.0,0.0,Matches,273.0,rs SRB,FWMF,24.0,17.0,48.0,2.82,33.0,0.0,5.0,8.0,2.0,0.0,4.0,0.23,3.0,0.0,1.0,0.0,0.0,0.0,Matches,,,,,,,,,,,,,,,,,,,,,,,,,,,,,,,,,,,,,,,,,,,,,,,,,,,,,,,,273.0,rs SRB,FWMF,24.0,17.0,3.0,0.0,0.0,23.0,8.0,11.0,1.0,2.0,3.0,0.0,0.0,0.0,18.0,29.0,54.0,34.9,Matches,273.0,rs SRB,FWMF,24.0,17.0,297.0,263.0,32.0,0.0,2.0,1.0,1.0,1.0,0.0,0.0,0.0,0.0,228.0,2.0,6.0,Matches,273.0,rs SRB,FWMF,24.0,17.0,228.0,297.0,76.8,3607.0,613.0,118.0,142.0,83.1,82.0,107.0,76.6,18.0,24.0,75.0,3.0,1.5,1.0,1.5,23.0,19.0,5.0,0.0,28.0,Matches,355,rs SRB,FWMF,24,31,1534.0,49.0,44.9,17.0,16,76.0,8,15,22.0,4,1.19,24.0,23.0,1.0,0.06,-0.37,24.0,21.2,2.8,0.17,-0.25,Matches,273.0,rs SRB,FWMF,24.0,17.0,437.0,11.0,27.0,196.0,219.0,79.0,436.0,22.0,15.0,68.2,6.0,27.3,214.0,1023.0,316.0,8.0,8.0,4.0,25.0,16.0,326.0,75.0,Matches,273.0,rs SRB,FWMF,24.0,17.0,6.0,56.0,19.0,33.9,3.29,1.11,0.11,0.32,13.3,0.0,0.0,1.0,7.9,7.1,0.13,-1.9,-1.1,Matches,273.0,rs SRB,FWMF,24.0,31.0,16.0,1534.0,17.0,6.0,3.0,9.0,6.0,0.0,1.0,3.0,0.0,7.9,7.1,1.5,8.6,8.0,28.0,75.0,0.35,0.18,0.53,0.35,0.53,0.46,0.09,0.55,0.42,0.51,Matches,Luka Jović,S,24,140,155,Serbia,ACF Fiorentina,7,11,12,14,14,8,15,10,4,5,12,11,5,13,7,16,13,14,9,12,10,14,13,7,16,6,10,7,13,14,17,12,11,15,11,14,11,6,17,9,7,3,4,2,2,1,2,1,2,1,3,2,11,9,12,7,16,10,10,15,1,1,1,1,1,1,1,10,1,10,10,12,10,20,181,79,17,20,10668922,7000,7000,6750,Northern_European,139,3,1997/12/23,26,9,30877.0,,62113639
1217,Pierre Kalulu,Milan,2000,276.0,fr FRA,DF,22.0,28.3,57.0,39.0,33.0,21.0,3.0,28.0,42.0,66.7,14.0,41.0,17.0,24.0,41.0,98.0,56.0,1.0,Matches,276.0,fr FRA,DF,22.0,28.3,33.0,1.17,28.0,2.0,0.0,2.0,0.0,1.0,3.0,0.11,2.0,1.0,0.0,0.0,0.0,0.0,Matches,,,,,,,,,,,,,,,,,,,,,,,,,,,,,,,,,,,,,,,,,,,,,,,,,,,,,,,,276.0,fr FRA,DF,22.0,28.3,4.0,0.0,0.0,24.0,23.0,2.0,28.0,41.0,39.0,0.0,1.0,0.0,165.0,36.0,33.0,52.2,Matches,276.0,fr FRA,DF,22.0,28.3,1821.0,1674.0,143.0,52.0,3.0,3.0,28.0,86.0,0.0,0.0,0.0,0.0,1589.0,4.0,13.0,Matches,276.0,fr FRA,DF,22.0,28.3,1589.0,1821.0,87.3,29265.0,9921.0,612.0,663.0,92.3,836.0,909.0,92.0,128.0,208.0,61.5,0.0,1.2,1.2,-1.2,10.0,109.0,10.0,5.0,138.0,Matches,359,fr FRA,DF,22,34,2548.0,75.0,74.5,28.3,26,88.0,25,8,32.0,2,1.76,46.0,41.0,5.0,0.18,-1.47,42.7,34.3,8.4,0.3,-0.66,Matches,276.0,fr FRA,DF,22.0,28.3,2099.0,118.0,890.0,1056.0,172.0,18.0,2099.0,18.0,10.0,55.6,5.0,27.8,1284.0,7528.0,4148.0,52.0,25.0,0.0,25.0,5.0,1410.0,43.0,Matches,276.0,fr FRA,DF,22.0,28.3,1.0,11.0,2.0,18.2,0.39,0.07,0.09,0.5,10.0,0.0,0.0,0.0,1.5,1.5,0.14,-0.5,-0.5,Matches,276.0,fr FRA,DF,22.0,34.0,26.0,2548.0,28.3,1.0,0.0,1.0,1.0,0.0,0.0,4.0,0.0,1.5,1.5,1.2,2.8,52.0,138.0,43.0,0.04,0.0,0.04,0.04,0.04,0.05,0.04,0.1,0.05,0.1,Matches,Pierre Kalulu,D RC,22,149,169,"France,Democratic Republic of Congo",AC Milan,6,11,11,8,13,5,14,8,12,15,13,6,15,13,11,15,15,14,15,12,14,15,7,11,13,15,14,14,14,13,15,11,15,16,15,14,15,8,13,5,17,1,2,3,3,2,1,2,1,1,1,2,16,16,7,12,13,14,15,17,1,14,20,17,8,12,1,1,1,11,1,1,1,1,184,79,10,20,72036004,7450,6471,6087,African_Caribbean,149,16,2000/6/5,0,0,14808.0,,49045184
1218,Grigoris Kastanos,Salernitana,1998,280.0,cy CYP,MFDF,24.0,14.3,39.0,23.0,18.0,19.0,2.0,16.0,40.0,40.0,24.0,20.0,6.0,14.0,8.0,47.0,8.0,0.0,Matches,280.0,cy CYP,MFDF,24.0,14.3,36.0,2.52,25.0,7.0,1.0,1.0,2.0,0.0,5.0,0.35,1.0,2.0,0.0,1.0,1.0,0.0,Matches,,,,,,,,,,,,,,,,,,,,,,,,,,,,,,,,,,,,,,,,,,,,,,,,,,,,,,,,280.0,cy CYP,MFDF,24.0,14.3,4.0,0.0,0.0,22.0,42.0,0.0,26.0,8.0,23.0,0.0,0.0,0.0,70.0,23.0,24.0,48.9,Matches,280.0,cy CYP,MFDF,24.0,14.3,621.0,525.0,90.0,27.0,1.0,6.0,26.0,47.0,16.0,3.0,0.0,0.0,460.0,6.0,23.0,Matches,280.0,cy CYP,MFDF,24.0,14.3,460.0,621.0,74.1,6840.0,2528.0,253.0,281.0,90.0,130.0,181.0,71.8,37.0,77.0,48.1,1.0,0.6,0.9,0.4,13.0,47.0,11.0,3.0,57.0,Matches,364,cy CYP,MFDF,24,28,1286.0,46.0,37.6,14.3,13,73.0,5,15,22.0,9,1.04,20.0,24.0,-4.0,-0.28,0.14,13.1,27.7,-14.6,-1.02,-0.35,Matches,280.0,cy CYP,MFDF,24.0,14.3,770.0,20.0,157.0,365.0,258.0,25.0,770.0,34.0,13.0,38.2,14.0,41.2,458.0,2257.0,1111.0,27.0,19.0,3.0,16.0,19.0,508.0,59.0,Matches,280.0,cy CYP,MFDF,24.0,14.3,2.0,30.0,9.0,30.0,2.1,0.63,0.07,0.22,22.2,0.0,0.0,0.0,1.9,1.9,0.06,0.1,0.1,Matches,280.0,cy CYP,MFDF,24.0,28.0,13.0,1286.0,14.3,2.0,1.0,3.0,2.0,0.0,0.0,4.0,0.0,1.9,1.9,0.6,2.5,27.0,57.0,59.0,0.14,0.07,0.21,0.14,0.21,0.13,0.05,0.18,0.13,0.18,Matches,Grigoris Kastanos,M/AM C,24,124,137,Cyprus,U.S. Salernitana 1919,10,12,12,8,13,15,8,14,7,9,13,10,10,13,13,11,11,11,10,13,13,15,14,10,13,10,11,14,14,14,12,9,12,13,14,12,10,7,12,7,13,3,3,3,1,3,1,3,3,4,3,1,14,16,2,14,8,8,17,18,1,1,1,1,1,1,11,8,20,8,9,19,7,1,179,70,20,10,2381032,6200,6050,4500,North_African__Middle_Eastern,122,9,1998/1/30,47,3,15902.0,,26030142
1219,Moise Kean,Juventus,2000,281.0,it ITA,FW,22.0,11.1,8.0,6.0,2.0,5.0,1.0,3.0,7.0,42.9,4.0,4.0,0.0,4.0,5.0,13.0,2.0,0.0,Matches,281.0,it ITA,FW,22.0,11.1,31.0,2.8,21.0,0.0,4.0,5.0,0.0,1.0,2.0,0.18,2.0,0.0,0.0,0.0,0.0,0.0,Matches,,,,,,,,,,,,,,,,,,,,,,,,,,,,,,,,,,,,,,,,,,,,,,,,,,,,,,,,281.0,it ITA,FW,22.0,11.1,5.0,1.0,0.0,15.0,18.0,8.0,5.0,5.0,6.0,0.0,0.0,0.0,40.0,9.0,11.0,45.0,Matches,281.0,it ITA,FW,22.0,11.1,187.0,176.0,9.0,1.0,1.0,0.0,5.0,1.0,0.0,0.0,0.0,0.0,130.0,2.0,11.0,Matches,281.0,it ITA,FW,22.0,11.1,130.0,187.0,69.5,1655.0,337.0,79.0,101.0,78.2,30.0,42.0,71.4,5.0,9.0,55.6,0.0,1.1,0.6,-1.1,8.0,7.0,6.0,1.0,13.0,Matches,366,it ITA,FW,22,28,995.0,36.0,29.1,11.1,11,64.0,0,17,17.0,2,1.89,11.0,8.0,3.0,0.27,-0.47,14.2,10.8,3.4,0.31,-0.07,Matches,281.0,it ITA,FW,22.0,11.1,333.0,3.0,32.0,146.0,165.0,57.0,333.0,41.0,14.0,34.1,23.0,56.1,220.0,1487.0,667.0,30.0,15.0,20.0,29.0,29.0,252.0,76.0,Matches,281.0,it ITA,FW,22.0,11.1,6.0,38.0,14.0,36.8,3.44,1.27,0.16,0.43,14.4,0.0,0.0,0.0,6.3,6.3,0.16,-0.3,-0.3,Matches,281.0,it ITA,FW,22.0,28.0,11.0,995.0,11.1,6.0,0.0,6.0,6.0,0.0,0.0,5.0,1.0,6.3,6.3,1.1,7.4,30.0,13.0,76.0,0.54,0.0,0.54,0.54,0.54,0.57,0.1,0.67,0.57,0.67,Matches,Moise Kean,AM/S RL,22,137,156,"Italy,Ivory Coast",Everton,4,10,14,14,12,10,10,12,4,5,12,12,6,13,16,15,15,12,11,10,9,15,14,12,15,5,11,13,16,15,14,12,18,15,14,16,10,15,11,7,8,2,1,3,2,1,1,2,4,3,2,3,12,17,13,10,16,11,11,14,1,1,1,1,1,1,1,1,1,1,16,8,15,20,183,72,11,20,27999999,6850,6850,5800,African_Caribbean,135,18,2000/2/28,12,4,57996.0,Juventus,43274977
1220,Jakub Kiwior,Spezia,2000,282.0,pl POL,DF,22.0,16.0,22.0,17.0,15.0,7.0,0.0,6.0,24.0,25.0,18.0,26.0,18.0,8.0,24.0,46.0,71.0,1.0,Matches,282.0,pl POL,DF,22.0,16.0,15.0,0.94,9.0,3.0,0.0,1.0,0.0,2.0,1.0,0.06,1.0,0.0,0.0,0.0,0.0,0.0,Matches,,,,,,,,,,,,,,,,,,,,,,,,,,,,,,,,,,,,,,,,,,,,,,,,,,,,,,,,282.0,pl POL,DF,22.0,16.0,3.0,0.0,0.0,16.0,5.0,0.0,14.0,24.0,17.0,0.0,0.0,0.0,93.0,22.0,12.0,64.7,Matches,282.0,pl POL,DF,22.0,16.0,775.0,683.0,89.0,34.0,1.0,3.0,14.0,12.0,9.0,6.0,3.0,0.0,653.0,3.0,4.0,Matches,282.0,pl POL,DF,22.0,16.0,653.0,775.0,84.3,13165.0,4165.0,209.0,238.0,87.8,343.0,371.0,92.5,93.0,147.0,63.3,0.0,0.2,0.6,-0.2,4.0,25.0,5.0,0.0,37.0,Matches,369,pl POL,DF,22,17,1443.0,85.0,42.2,16.0,17,85.0,13,0,,1,0.88,16.0,27.0,-11.0,-0.69,0.22,15.3,26.6,-11.3,-0.71,-0.4,Matches,282.0,pl POL,DF,22.0,16.0,953.0,177.0,594.0,307.0,58.0,15.0,953.0,7.0,5.0,71.4,2.0,28.6,464.0,2749.0,1395.0,13.0,3.0,1.0,8.0,5.0,498.0,6.0,Matches,282.0,pl POL,DF,22.0,16.0,0.0,10.0,2.0,20.0,0.62,0.12,0.0,0.0,16.6,1.0,0.0,0.0,0.6,0.6,0.06,-0.6,-0.6,Matches,282.0,pl POL,DF,22.0,17.0,17.0,1443.0,16.0,0.0,0.0,0.0,0.0,0.0,0.0,3.0,0.0,0.6,0.6,0.2,0.8,13.0,37.0,6.0,0.0,0.0,0.0,0.0,0.0,0.04,0.01,0.05,0.04,0.05,Matches,Jakub Kiwior,D/DM LC,22,131,159,Poland,Spezia Calcio,9,11,12,7,12,12,13,8,7,14,12,8,13,13,12,15,13,13,14,12,12,14,9,11,7,15,15,13,12,12,11,14,15,13,13,12,14,11,12,5,11,3,3,2,1,3,2,2,1,3,2,1,15,14,1,10,12,15,9,12,1,15,20,1,14,1,17,1,10,1,1,1,1,1,188,78,20,8,10016000,6550,6100,2006,Northern_European,129,5,2000/2/15,2,0,25443.0,,96102946
1221,Simon Kjær,Milan,1989,283.0,dk DEN,DF,33.0,11.2,15.0,8.0,9.0,6.0,0.0,7.0,11.0,63.6,4.0,14.0,11.0,3.0,9.0,24.0,35.0,1.0,Matches,283.0,dk DEN,DF,33.0,11.2,5.0,0.45,4.0,1.0,0.0,0.0,0.0,0.0,0.0,0.0,0.0,0.0,0.0,0.0,0.0,0.0,Matches,,,,,,,,,,,,,,,,,,,,,,,,,,,,,,,,,,,,,,,,,,,,,,,,,,,,,,,,283.0,dk DEN,DF,33.0,11.2,4.0,0.0,0.0,8.0,1.0,0.0,2.0,9.0,8.0,0.0,0.0,0.0,55.0,19.0,14.0,57.6,Matches,283.0,dk DEN,DF,33.0,11.2,683.0,667.0,16.0,15.0,0.0,6.0,2.0,1.0,0.0,0.0,0.0,0.0,591.0,0.0,1.0,Matches,283.0,dk DEN,DF,33.0,11.2,591.0,683.0,86.5,12451.0,4463.0,175.0,193.0,90.7,313.0,331.0,94.6,99.0,152.0,65.1,0.0,0.0,0.2,0.0,0.0,47.0,1.0,0.0,45.0,Matches,370,dk DEN,DF,33,17,1007.0,59.0,29.4,11.2,12,74.0,4,5,24.0,16,1.82,12.0,7.0,5.0,0.45,-0.15,13.0,12.3,0.7,0.06,-0.58,Matches,283.0,dk DEN,DF,33.0,11.2,761.0,95.0,432.0,322.0,11.0,2.0,761.0,0.0,0.0,,0.0,,458.0,1956.0,1166.0,3.0,2.0,0.0,1.0,0.0,535.0,1.0,Matches,283.0,dk DEN,DF,33.0,11.2,0.0,0.0,0.0,,0.0,0.0,,,,0.0,0.0,0.0,0.0,0.0,,0.0,0.0,Matches,283.0,dk DEN,DF,33.0,17.0,12.0,1007.0,11.2,0.0,0.0,0.0,0.0,0.0,0.0,4.0,0.0,0.0,0.0,0.0,0.0,3.0,45.0,1.0,0.0,0.0,0.0,0.0,0.0,0.0,0.0,0.0,0.0,0.0,Matches,Simon Kjær,D C,33,148,155,Denmark,AC Milan,4,9,6,4,10,12,15,4,4,16,14,13,15,11,15,16,17,17,16,12,15,20,5,18,7,17,18,14,9,10,15,15,16,11,12,15,16,14,14,11,8,2,1,3,2,4,1,1,3,1,1,3,15,18,9,13,14,20,20,14,1,1,20,1,1,1,8,1,1,1,1,1,1,1,190,86,9,20,347975206,7400,7950,6250,Northern_European,148,1,1989/3/26,119,5,36922.0,,947424
1222,Teun Koopmeiners,Atalanta,1998,284.0,nl NED,MF,24.0,31.8,46.0,26.0,15.0,24.0,7.0,28.0,55.0,50.9,27.0,41.0,5.0,36.0,19.0,65.0,36.0,2.0,Matches,284.0,nl NED,MF,24.0,31.8,132.0,4.16,85.0,31.0,3.0,11.0,2.0,0.0,17.0,0.54,10.0,3.0,1.0,3.0,0.0,0.0,Matches,,,,,,,,,,,,,,,,,,,,,,,,,,,,,,,,,,,,,,,,,,,,,,,,,,,,,,,,284.0,nl NED,MF,24.0,31.8,7.0,0.0,0.0,48.0,27.0,6.0,158.0,19.0,26.0,0.0,0.0,0.0,193.0,38.0,23.0,62.3,Matches,284.0,nl NED,MF,24.0,31.8,1727.0,1558.0,162.0,55.0,5.0,19.0,158.0,26.0,77.0,42.0,26.0,0.0,1271.0,7.0,33.0,Matches,284.0,nl NED,MF,24.0,31.8,1271.0,1727.0,73.6,23257.0,8953.0,532.0,612.0,86.9,530.0,665.0,79.7,160.0,344.0,46.5,4.0,6.4,6.9,-2.4,58.0,154.0,51.0,15.0,186.0,Matches,371,nl NED,MF,24,33,2858.0,87.0,83.6,31.8,32,88.0,29,1,45.0,0,1.73,57.0,36.0,21.0,0.66,1.14,47.3,33.3,14.0,0.44,0.09,Matches,284.0,nl NED,MF,24.0,31.8,2056.0,85.0,476.0,916.0,691.0,63.0,2052.0,54.0,28.0,51.9,23.0,42.6,1136.0,5759.0,3052.0,60.0,64.0,11.0,48.0,32.0,1396.0,106.0,Matches,284.0,nl NED,MF,24.0,31.8,10.0,55.0,23.0,41.8,1.73,0.72,0.15,0.35,21.9,6.0,2.0,4.0,7.6,4.3,0.08,2.4,3.7,Matches,284.0,nl NED,MF,24.0,33.0,32.0,2858.0,31.8,10.0,4.0,14.0,8.0,2.0,4.0,7.0,0.0,7.6,4.3,6.4,10.7,60.0,186.0,106.0,0.31,0.13,0.44,0.25,0.38,0.24,0.2,0.44,0.14,0.34,Matches,Teun Koopmeiners,DM/M C,24,149,164,Holland,Atalanta,12,12,11,13,14,16,10,15,4,11,15,16,12,14,12,16,12,12,14,13,16,18,7,15,10,13,17,15,11,12,15,12,15,12,16,15,15,7,12,3,13,1,2,1,3,1,2,2,3,2,3,1,18,16,8,12,11,18,16,10,1,8,14,1,1,1,19,1,20,1,1,1,1,1,184,77,20,12,23015697,7450,7100,5500,Northern_European,147,0,1998/2/28,9,1,36922.0,,37057982
1223,Filip Kostić,Juventus,1992,285.0,rs SRB,DFFW,29.0,28.5,41.0,26.0,17.0,20.0,4.0,21.0,47.0,44.7,26.0,30.0,4.0,26.0,16.0,57.0,32.0,0.0,Matches,285.0,rs SRB,DFFW,29.0,28.5,93.0,3.26,67.0,17.0,3.0,6.0,0.0,0.0,12.0,0.42,8.0,2.0,0.0,2.0,0.0,0.0,Matches,,,,,,,,,,,,,,,,,,,,,,,,,,,,,,,,,,,,,,,,,,,,,,,,,,,,,,,,285.0,rs SRB,DFFW,29.0,28.5,3.0,0.0,0.0,29.0,12.0,2.0,227.0,16.0,26.0,0.0,0.0,0.0,139.0,13.0,13.0,50.0,Matches,285.0,rs SRB,DFFW,29.0,28.5,1212.0,1041.0,167.0,15.0,4.0,11.0,227.0,106.0,46.0,2.0,41.0,1.0,830.0,4.0,56.0,Matches,285.0,rs SRB,DFFW,29.0,28.5,830.0,1212.0,68.5,14092.0,4148.0,413.0,489.0,84.5,309.0,431.0,71.7,86.0,195.0,44.1,8.0,7.1,4.8,0.9,66.0,44.0,47.0,31.0,78.0,Matches,373,rs SRB,DFFW,29,37,2564.0,69.0,75.0,28.5,33,75.0,12,4,26.0,1,1.86,38.0,32.0,6.0,0.21,-1.58,38.7,34.4,4.4,0.15,-0.83,Matches,285.0,rs SRB,DFFW,29.0,28.5,1488.0,41.0,237.0,595.0,674.0,62.0,1488.0,52.0,23.0,44.2,24.0,46.2,809.0,4882.0,2587.0,101.0,54.0,22.0,50.0,20.0,943.0,230.0,Matches,285.0,rs SRB,DFFW,29.0,28.5,3.0,37.0,11.0,29.7,1.3,0.39,0.08,0.27,19.6,0.0,0.0,0.0,2.4,2.4,0.06,0.6,0.6,Matches,285.0,rs SRB,DFFW,29.0,37.0,33.0,2564.0,28.5,3.0,8.0,11.0,3.0,0.0,0.0,3.0,0.0,2.4,2.4,7.1,9.4,101.0,78.0,230.0,0.11,0.28,0.39,0.11,0.39,0.08,0.25,0.33,0.08,0.33,Matches,Filip Kostić,WB/M/AM L,29,148,155,Serbia,Juventus,15,18,13,10,13,12,6,13,10,7,15,11,8,14,13,11,14,11,11,13,12,15,12,7,13,8,13,14,15,13,16,10,16,16,16,13,13,8,13,5,16,1,3,2,1,3,1,2,3,1,1,2,13,17,12,10,14,13,10,12,1,10,1,1,18,1,1,20,10,14,18,10,14,1,184,84,20,7,18833967,7400,7400,6500,Mediterranean_Hispanic,138,6,1992/11/1,48,3,61731.0,,62070416
1224,Christian Kouamé,Fiorentina,1997,286.0,ci CIV,FW,24.0,20.7,27.0,18.0,8.0,10.0,9.0,7.0,14.0,50.0,7.0,15.0,3.0,12.0,12.0,39.0,8.0,0.0,Matches,286.0,ci CIV,FW,24.0,20.7,83.0,4.01,67.0,0.0,4.0,5.0,7.0,0.0,8.0,0.39,6.0,0.0,1.0,1.0,0.0,0.0,Matches,,,,,,,,,,,,,,,,,,,,,,,,,,,,,,,,,,,,,,,,,,,,,,,,,,,,,,,,286.0,ci CIV,FW,24.0,20.7,5.0,0.0,0.0,32.0,56.0,7.0,49.0,12.0,18.0,1.0,0.0,0.0,91.0,62.0,52.0,54.4,Matches,286.0,ci CIV,FW,24.0,20.7,661.0,628.0,31.0,2.0,1.0,6.0,49.0,21.0,2.0,0.0,0.0,0.0,468.0,2.0,15.0,Matches,286.0,ci CIV,FW,24.0,20.7,468.0,661.0,70.8,6983.0,1648.0,275.0,348.0,79.0,134.0,194.0,69.1,32.0,55.0,58.2,4.0,3.7,2.8,0.3,39.0,29.0,31.0,10.0,54.0,Matches,374,ci CIV,FW,24,28,1866.0,67.0,54.6,20.7,22,79.0,10,6,21.0,10,1.39,27.0,27.0,0.0,0.0,-0.58,30.6,22.0,8.6,0.42,0.24,Matches,286.0,ci CIV,FW,24.0,20.7,942.0,8.0,74.0,324.0,559.0,111.0,942.0,66.0,21.0,31.8,36.0,54.5,564.0,2844.0,1302.0,50.0,32.0,24.0,80.0,42.0,703.0,203.0,Matches,286.0,ci CIV,FW,24.0,20.7,4.0,42.0,13.0,31.0,2.03,0.63,0.1,0.31,13.8,1.0,0.0,0.0,5.3,5.3,0.13,-1.3,-1.3,Matches,286.0,ci CIV,FW,24.0,28.0,22.0,1866.0,20.7,4.0,4.0,8.0,4.0,0.0,0.0,5.0,0.0,5.3,5.3,3.7,9.0,50.0,54.0,203.0,0.19,0.19,0.39,0.19,0.39,0.26,0.18,0.43,0.26,0.43,Matches,Christian Kouamé,AM/S RL,24,136,144,"Ivory Coast,Italy",ACF Fiorentina,5,8,15,14,13,10,13,10,4,4,11,12,4,13,12,13,14,12,11,11,13,14,14,7,13,10,12,12,17,15,13,13,14,16,13,10,12,9,12,10,11,1,1,2,2,1,1,2,3,2,3,2,14,14,6,13,11,14,14,12,1,1,1,1,1,1,1,1,1,1,17,1,17,20,185,70,9,20,7143604,6798,6248,5398,African_Caribbean,132,14,1997/12/6,14,1,42692.0,,43201838
1225,Rade Krunić,Milan,1993,290.0,ba BIH,MF,28.0,18.4,40.0,28.0,18.0,18.0,4.0,16.0,50.0,32.0,34.0,31.0,11.0,20.0,16.0,56.0,21.0,0.0,Matches,290.0,ba BIH,MF,28.0,18.4,41.0,2.23,35.0,1.0,0.0,2.0,2.0,1.0,6.0,0.33,6.0,0.0,0.0,0.0,0.0,0.0,Matches,,,,,,,,,,,,,,,,,,,,,,,,,,,,,,,,,,,,,,,,,,,,,,,,,,,,,,,,290.0,ba BIH,MF,28.0,18.4,8.0,0.0,0.0,16.0,19.0,0.0,3.0,16.0,28.0,0.0,0.0,0.0,134.0,28.0,24.0,53.8,Matches,290.0,ba BIH,MF,28.0,18.4,955.0,931.0,24.0,16.0,2.0,1.0,3.0,4.0,3.0,1.0,1.0,0.0,819.0,0.0,19.0,Matches,290.0,ba BIH,MF,28.0,18.4,819.0,955.0,85.8,12702.0,3734.0,403.0,460.0,87.6,337.0,372.0,90.6,43.0,59.0,72.9,1.0,1.1,1.0,-0.1,15.0,61.0,12.0,0.0,73.0,Matches,379,ba BIH,MF,28,23,1657.0,72.0,48.5,18.4,18,83.0,10,5,34.0,5,2.13,34.0,17.0,17.0,0.92,0.72,29.3,20.1,9.2,0.5,0.07,Matches,290.0,ba BIH,MF,28.0,18.4,1115.0,43.0,284.0,673.0,171.0,24.0,1115.0,26.0,19.0,73.1,4.0,15.4,659.0,3562.0,1910.0,31.0,27.0,2.0,10.0,8.0,728.0,21.0,Matches,290.0,ba BIH,MF,28.0,18.4,0.0,14.0,2.0,14.3,0.76,0.11,0.0,0.0,14.9,0.0,0.0,0.0,1.1,1.1,0.08,-1.1,-1.1,Matches,290.0,ba BIH,MF,28.0,23.0,18.0,1657.0,18.4,0.0,1.0,1.0,0.0,0.0,0.0,8.0,0.0,1.1,1.1,1.1,2.2,31.0,73.0,21.0,0.0,0.05,0.05,0.0,0.05,0.06,0.06,0.12,0.06,0.12,Matches,Rade Krunić,M/AM C,28,140,143,"Bosnia and Herzegovina,Serbia",AC Milan,11,12,13,9,12,13,12,13,8,11,14,11,13,13,11,13,14,12,15,12,12,14,11,11,13,13,16,15,13,14,15,12,14,14,14,13,14,11,10,8,18,2,3,3,3,2,3,2,3,3,3,4,15,13,5,13,12,14,14,12,1,1,1,1,1,1,15,14,20,11,14,19,10,8,184,74,12,20,5309058,7000,6700,5200,Mediterranean_Hispanic,137,2,1993/10/7,27,2,39231.0,,62025884
1226,Khvicha Kvaratskhelia,Napoli,2001,292.0,ge GEO,FW,21.0,28.0,43.0,23.0,12.0,8.0,23.0,17.0,43.0,39.5,26.0,20.0,0.0,20.0,5.0,48.0,6.0,1.0,Matches,292.0,ge GEO,FW,21.0,28.0,136.0,4.86,90.0,3.0,20.0,13.0,8.0,2.0,24.0,0.86,10.0,1.0,3.0,6.0,4.0,0.0,Matches,,,,,,,,,,,,,,,,,,,,,,,,,,,,,,,,,,,,,,,,,,,,,,,,,,,,,,,,292.0,ge GEO,FW,21.0,28.0,1.0,0.0,0.0,20.0,45.0,6.0,76.0,5.0,23.0,4.0,0.0,0.0,118.0,8.0,13.0,38.1,Matches,292.0,ge GEO,FW,21.0,28.0,1136.0,1083.0,49.0,9.0,14.0,15.0,76.0,18.0,22.0,8.0,3.0,0.0,900.0,4.0,22.0,Matches,292.0,ge GEO,FW,21.0,28.0,900.0,1136.0,79.2,12766.0,2560.0,570.0,623.0,91.5,225.0,301.0,74.8,63.0,118.0,53.4,10.0,7.7,6.6,2.3,54.0,41.0,46.0,8.0,91.0,Matches,381,ge GEO,FW,21,34,2518.0,74.0,73.6,28.0,30,79.0,8,4,38.0,0,2.29,58.0,21.0,37.0,1.32,0.13,49.9,23.1,26.8,0.96,0.34,Matches,292.0,ge GEO,FW,21.0,28.0,1548.0,8.0,110.0,486.0,976.0,175.0,1546.0,199.0,75.0,37.7,107.0,53.8,1054.0,6935.0,3699.0,139.0,62.0,84.0,63.0,48.0,1221.0,291.0,Matches,292.0,ge GEO,FW,21.0,28.0,12.0,83.0,30.0,36.1,2.97,1.07,0.12,0.33,19.1,3.0,2.0,2.0,8.2,6.6,0.08,3.8,3.4,Matches,292.0,ge GEO,FW,21.0,34.0,30.0,2518.0,28.0,12.0,10.0,22.0,10.0,2.0,2.0,1.0,0.0,8.2,6.6,7.7,14.2,139.0,91.0,291.0,0.43,0.36,0.79,0.36,0.71,0.29,0.27,0.56,0.23,0.51,Matches,Khvicha Kvaratskhelia,AM RLC,21,153,174,Georgia,Parthenope,8,12,18,15,17,12,11,14,4,4,14,12,5,18,11,12,12,15,12,14,14,17,19,5,13,6,9,9,15,18,12,10,16,14,13,10,15,8,16,6,13,3,1,3,2,2,3,3,2,1,3,2,19,16,4,11,17,16,13,14,1,1,1,1,1,1,1,12,1,10,20,15,15,12,183,70,15,20,74983994,7650,6297,5631,Northern_European,150,2,2001/2/12,17,8,29614.0,,59130638
1227,Sam Lammers,Sampdoria,1997,295.0,nl NED,FW,25.0,12.2,12.0,5.0,2.0,7.0,3.0,6.0,15.0,40.0,9.0,10.0,3.0,7.0,6.0,18.0,11.0,0.0,Matches,295.0,nl NED,FW,25.0,12.2,28.0,2.3,23.0,0.0,2.0,2.0,0.0,1.0,1.0,0.08,1.0,0.0,0.0,0.0,0.0,0.0,Matches,,,,,,,,,,,,,,,,,,,,,,,,,,,,,,,,,,,,,,,,,,,,,,,,,,,,,,,,295.0,nl NED,FW,25.0,12.2,1.0,0.0,0.0,19.0,23.0,1.0,2.0,6.0,5.0,0.0,0.0,0.0,28.0,31.0,40.0,43.7,Matches,295.0,nl NED,FW,25.0,12.2,254.0,244.0,9.0,0.0,1.0,0.0,2.0,2.0,0.0,0.0,0.0,0.0,172.0,1.0,9.0,Matches,295.0,nl NED,FW,25.0,12.2,172.0,254.0,67.7,2243.0,537.0,116.0,153.0,75.8,45.0,69.0,65.2,4.0,4.0,100.0,1.0,1.2,0.7,-0.2,14.0,13.0,8.0,1.0,19.0,Matches,384,nl NED,FW,25,19,1100.0,58.0,32.2,12.2,13,75.0,3,6,20.0,0,0.47,6.0,21.0,-15.0,-1.23,0.01,11.1,23.4,-12.3,-1.01,-0.24,Matches,295.0,nl NED,FW,25.0,12.2,409.0,15.0,38.0,214.0,163.0,44.0,409.0,29.0,16.0,55.2,12.0,41.4,260.0,1113.0,515.0,17.0,11.0,6.0,53.0,18.0,335.0,65.0,Matches,295.0,nl NED,FW,25.0,12.2,1.0,23.0,8.0,34.8,1.88,0.65,0.04,0.13,11.6,0.0,0.0,0.0,2.5,2.5,0.11,-1.5,-1.5,Matches,295.0,nl NED,FW,25.0,19.0,13.0,1100.0,12.2,1.0,1.0,2.0,1.0,0.0,0.0,1.0,0.0,2.5,2.5,1.2,3.7,17.0,19.0,65.0,0.08,0.08,0.16,0.08,0.16,0.2,0.1,0.3,0.2,0.3,Matches,Sam Lammers,AM/S C,25,128,134,Holland,Atalanta,6,9,13,12,14,10,13,11,7,5,11,13,5,13,8,14,12,12,12,13,11,15,13,7,14,6,12,13,12,14,14,14,12,12,13,12,12,7,11,6,12,1,1,2,1,2,1,2,3,1,3,3,11,15,7,11,14,15,12,11,1,1,1,1,1,1,1,7,7,6,8,16,11,20,191,77,20,15,1293112,6400,6000,5250,Northern_European,127,5,1997/4/30,0,0,23384.0,Empoli Football Club,37056187
1228,Kevin Lasagna,Hellas Verona,1992,297.0,it ITA,FWMF,29.0,17.5,12.0,6.0,7.0,3.0,2.0,6.0,14.0,42.9,8.0,17.0,1.0,16.0,5.0,17.0,13.0,0.0,Matches,297.0,it ITA,FWMF,29.0,17.5,39.0,2.23,25.0,0.0,5.0,4.0,3.0,2.0,3.0,0.17,1.0,0.0,1.0,1.0,0.0,0.0,Matches,,,,,,,,,,,,,,,,,,,,,,,,,,,,,,,,,,,,,,,,,,,,,,,,,,,,,,,,297.0,it ITA,FWMF,29.0,17.5,2.0,0.0,0.0,25.0,22.0,15.0,13.0,5.0,6.0,0.0,0.0,0.0,64.0,20.0,68.0,22.7,Matches,297.0,it ITA,FWMF,29.0,17.5,258.0,236.0,16.0,1.0,0.0,1.0,13.0,3.0,0.0,0.0,0.0,0.0,157.0,6.0,17.0,Matches,297.0,it ITA,FWMF,29.0,17.5,157.0,258.0,60.9,2338.0,547.0,77.0,112.0,68.8,54.0,81.0,66.7,8.0,18.0,44.4,2.0,1.7,0.4,0.3,17.0,9.0,9.0,0.0,19.0,Matches,386,it ITA,FWMF,29,26,1572.0,60.0,46.0,17.5,17,76.0,7,9,31.0,0,0.81,13.0,26.0,-13.0,-0.74,-0.01,16.6,21.9,-5.3,-0.31,0.12,Matches,297.0,it ITA,FWMF,29.0,17.5,482.0,15.0,62.0,182.0,249.0,67.0,482.0,38.0,13.0,34.2,18.0,47.4,267.0,1736.0,747.0,36.0,23.0,14.0,53.0,34.0,317.0,105.0,Matches,297.0,it ITA,FWMF,29.0,17.5,1.0,52.0,11.0,21.2,2.98,0.63,0.02,0.09,18.2,0.0,0.0,0.0,6.0,6.0,0.12,-5.0,-5.0,Matches,297.0,it ITA,FWMF,29.0,26.0,17.0,1572.0,17.5,1.0,2.0,3.0,1.0,0.0,0.0,2.0,0.0,6.0,6.0,1.7,7.7,36.0,19.0,105.0,0.06,0.11,0.17,0.06,0.17,0.35,0.09,0.44,0.35,0.44,Matches,Kevin Lasagna,S,29,128,144,Italy,Hellas Verona,9,11,12,12,11,9,14,11,7,7,11,12,7,12,15,13,14,9,12,9,9,16,12,7,16,7,15,16,17,14,12,10,15,17,11,11,11,8,14,4,12,1,3,2,3,2,1,1,3,2,3,1,13,16,2,13,12,17,14,10,1,1,1,1,1,1,1,1,1,1,12,11,12,20,181,80,20,10,2987298,6400,6400,5300,Mediterranean_Hispanic,124,2,1992/8/10,7,0,25000.0,,43092927
1229,Valentino Lazaro,Torino,1996,299.0,at AUT,DF,26.0,15.3,10.0,5.0,6.0,0.0,4.0,6.0,14.0,42.9,8.0,16.0,3.0,13.0,3.0,13.0,29.0,0.0,Matches,299.0,at AUT,DF,26.0,15.3,51.0,3.34,33.0,14.0,2.0,2.0,0.0,0.0,4.0,0.26,3.0,1.0,0.0,0.0,0.0,0.0,Matches,,,,,,,,,,,,,,,,,,,,,,,,,,,,,,,,,,,,,,,,,,,,,,,,,,,,,,,,299.0,at AUT,DF,26.0,15.3,4.0,0.0,0.0,14.0,3.0,1.0,86.0,3.0,5.0,0.0,1.0,0.0,86.0,14.0,13.0,51.9,Matches,299.0,at AUT,DF,26.0,15.3,902.0,693.0,205.0,22.0,0.0,1.0,86.0,142.0,41.0,14.0,17.0,1.0,674.0,4.0,20.0,Matches,299.0,at AUT,DF,26.0,15.3,674.0,902.0,74.7,11347.0,4278.0,329.0,374.0,88.0,260.0,336.0,77.4,65.0,139.0,46.8,3.0,2.7,2.5,0.3,29.0,48.0,19.0,10.0,74.0,Matches,388,at AUT,DF,26,23,1373.0,60.0,40.1,15.3,15,80.0,6,8,22.0,3,1.17,17.0,17.0,0.0,0.0,-0.04,16.1,18.5,-2.4,-0.16,-0.35,Matches,299.0,at AUT,DF,26.0,15.3,1017.0,38.0,200.0,433.0,394.0,23.0,1017.0,35.0,16.0,45.7,13.0,37.1,496.0,2428.0,1262.0,44.0,25.0,8.0,16.0,4.0,607.0,84.0,Matches,299.0,at AUT,DF,26.0,15.3,0.0,7.0,2.0,28.6,0.46,0.13,0.0,0.0,14.0,0.0,0.0,0.0,0.4,0.4,0.06,-0.4,-0.4,Matches,299.0,at AUT,DF,26.0,23.0,15.0,1373.0,15.3,0.0,3.0,3.0,0.0,0.0,0.0,4.0,0.0,0.4,0.4,2.7,3.1,44.0,74.0,84.0,0.0,0.2,0.2,0.0,0.2,0.03,0.18,0.21,0.03,0.21,Matches,Valentino Lazaro,D/WB/M R,26,131,138,"Austria,Angola,Greece",FC Internazionale Milano,13,13,14,9,14,11,9,11,9,10,13,10,12,15,13,12,8,11,9,12,10,10,15,7,13,9,11,13,15,15,12,9,13,14,13,10,12,6,11,11,17,3,1,2,3,2,3,3,2,3,1,2,9,14,10,12,11,13,14,14,1,5,1,19,11,19,1,13,10,20,8,10,14,8,180,76,10,20,2720891,6550,7200,5400,Mixed_Race,125,12,1996/3/24,36,3,43845.0,Torino,16067510
1230,Darko Lazović,Hellas Verona,1990,301.0,rs SRB,MFDF,31.0,24.9,24.0,13.0,9.0,12.0,3.0,13.0,29.0,44.8,16.0,14.0,3.0,11.0,16.0,40.0,19.0,0.0,Matches,301.0,rs SRB,MFDF,31.0,24.9,67.0,2.69,46.0,11.0,5.0,2.0,0.0,3.0,5.0,0.2,3.0,2.0,0.0,0.0,0.0,0.0,Matches,,,,,,,,,,,,,,,,,,,,,,,,,,,,,,,,,,,,,,,,,,,,,,,,,,,,,,,,301.0,rs SRB,MFDF,31.0,24.9,0.0,0.0,0.0,8.0,3.0,9.0,123.0,16.0,13.0,0.0,0.0,0.0,142.0,6.0,16.0,27.3,Matches,301.0,rs SRB,MFDF,31.0,24.9,836.0,710.0,117.0,10.0,6.0,1.0,123.0,69.0,37.0,15.0,16.0,0.0,517.0,9.0,38.0,Matches,301.0,rs SRB,MFDF,31.0,24.9,517.0,836.0,61.8,8845.0,3738.0,248.0,317.0,78.2,199.0,291.0,68.4,55.0,152.0,36.2,5.0,6.4,5.3,-1.4,45.0,49.0,34.0,15.0,81.0,Matches,390,rs SRB,MFDF,31,30,2242.0,75.0,65.6,24.9,27,79.0,12,3,36.0,0,0.94,23.0,36.0,-13.0,-0.52,0.62,24.1,31.4,-7.3,-0.3,0.22,Matches,301.0,rs SRB,MFDF,31.0,24.9,1052.0,26.0,197.0,411.0,461.0,67.0,1052.0,54.0,19.0,35.2,30.0,55.6,542.0,3366.0,1943.0,72.0,37.0,21.0,38.0,14.0,620.0,167.0,Matches,301.0,rs SRB,MFDF,31.0,24.9,4.0,43.0,14.0,32.6,1.73,0.56,0.09,0.29,18.8,4.0,0.0,0.0,3.6,3.6,0.08,0.4,0.4,Matches,301.0,rs SRB,MFDF,31.0,30.0,27.0,2242.0,24.9,4.0,5.0,9.0,4.0,0.0,0.0,0.0,0.0,3.6,3.6,6.4,10.0,72.0,81.0,167.0,0.16,0.2,0.36,0.16,0.36,0.14,0.26,0.4,0.14,0.4,Matches,Darko Lazović,WB/M RL,31,137,144,Serbia,Hellas Verona,9,14,15,10,13,6,7,12,5,9,12,6,9,13,11,12,9,11,12,12,12,14,15,9,16,10,11,14,16,13,13,10,13,17,15,11,14,7,8,7,17,3,1,2,2,1,3,2,2,3,3,1,13,13,7,12,11,17,11,9,1,14,1,11,20,16,1,18,10,15,14,11,12,1,181,66,10,20,347975206,6850,6800,5200,Northern_European,130,2,1990/9/15,23,0,21346.0,,5747078
1231,Manuel Lazzari,Lazio,1993,302.0,it ITA,DF,28.0,20.9,33.0,21.0,13.0,14.0,6.0,21.0,36.0,58.3,15.0,20.0,6.0,14.0,18.0,51.0,36.0,1.0,Matches,302.0,it ITA,DF,28.0,20.9,29.0,1.39,24.0,1.0,1.0,0.0,2.0,1.0,4.0,0.19,4.0,0.0,0.0,0.0,0.0,0.0,Matches,,,,,,,,,,,,,,,,,,,,,,,,,,,,,,,,,,,,,,,,,,,,,,,,,,,,,,,,302.0,it ITA,DF,28.0,20.9,8.0,0.0,0.0,15.0,39.0,0.0,36.0,18.0,21.0,0.0,0.0,1.0,90.0,9.0,14.0,39.1,Matches,302.0,it ITA,DF,28.0,20.9,1183.0,987.0,194.0,17.0,0.0,2.0,36.0,177.0,0.0,0.0,0.0,0.0,1033.0,2.0,25.0,Matches,302.0,it ITA,DF,28.0,20.9,1033.0,1183.0,87.3,14314.0,5026.0,622.0,666.0,93.4,327.0,376.0,87.0,38.0,55.0,69.1,0.0,0.7,0.9,-0.7,10.0,49.0,13.0,7.0,64.0,Matches,391,it ITA,DF,28,28,1879.0,67.0,54.9,20.9,22,80.0,10,6,21.0,7,1.75,31.0,16.0,15.0,0.72,-0.16,26.2,23.1,3.1,0.15,-0.25,Matches,302.0,it ITA,DF,28.0,20.9,1380.0,52.0,433.0,657.0,310.0,27.0,1380.0,41.0,18.0,43.9,18.0,43.9,789.0,5925.0,3933.0,98.0,62.0,15.0,25.0,3.0,921.0,74.0,Matches,302.0,it ITA,DF,28.0,20.9,0.0,6.0,2.0,33.3,0.29,0.1,0.0,0.0,17.7,0.0,0.0,0.0,0.3,0.3,0.05,-0.3,-0.3,Matches,302.0,it ITA,DF,28.0,28.0,22.0,1879.0,20.9,0.0,0.0,0.0,0.0,0.0,0.0,8.0,0.0,0.3,0.3,0.7,1.0,98.0,64.0,74.0,0.0,0.0,0.0,0.0,0.0,0.02,0.03,0.05,0.02,0.05,Matches,Manuel Lazzari,D/WB R,28,145,150,Italy,S.S. Lazio,7,13,13,10,12,3,7,10,6,11,13,5,13,13,13,15,15,10,12,12,13,16,14,8,16,12,15,16,17,17,11,7,18,17,14,8,13,8,14,8,13,3,2,3,3,1,3,3,1,1,2,3,13,15,7,16,13,16,9,11,1,1,1,20,1,20,1,1,1,15,1,1,11,1,174,65,11,20,16074698,7250,7100,6000,Mediterranean_Hispanic,134,6,1993/11/29,2,0,53462.0,,43096538
1232,Rafael Leão,Milan,1999,303.0,pt POR,FWMF,23.0,26.9,8.0,7.0,2.0,3.0,3.0,6.0,14.0,42.9,8.0,9.0,2.0,7.0,15.0,23.0,8.0,0.0,Matches,303.0,pt POR,FWMF,23.0,26.9,123.0,4.57,80.0,3.0,24.0,8.0,8.0,0.0,18.0,0.67,12.0,1.0,4.0,0.0,1.0,0.0,Matches,,,,,,,,,,,,,,,,,,,,,,,,,,,,,,,,,,,,,,,,,,,,,,,,,,,,,,,,303.0,pt POR,FWMF,23.0,26.9,7.0,1.0,1.0,20.0,30.0,10.0,71.0,15.0,7.0,1.0,0.0,0.0,84.0,29.0,29.0,50.0,Matches,303.0,pt POR,FWMF,23.0,26.9,845.0,802.0,39.0,3.0,5.0,17.0,71.0,28.0,7.0,0.0,0.0,0.0,595.0,4.0,29.0,Matches,303.0,pt POR,FWMF,23.0,26.9,595.0,845.0,70.4,10191.0,3212.0,282.0,365.0,77.3,226.0,302.0,74.8,65.0,107.0,60.7,8.0,7.0,6.2,1.0,49.0,64.0,59.0,14.0,122.0,Matches,392,pt POR,FWMF,23,35,2421.0,69.0,70.8,26.9,28,79.0,13,7,31.0,0,2.0,53.0,31.0,22.0,0.82,0.91,44.5,27.9,16.6,0.62,0.51,Matches,303.0,pt POR,FWMF,23.0,26.9,1195.0,10.0,66.0,487.0,672.0,144.0,1195.0,171.0,77.0,45.0,76.0,44.4,804.0,7464.0,3808.0,136.0,113.0,64.0,69.0,38.0,924.0,235.0,Matches,303.0,pt POR,FWMF,23.0,26.9,15.0,92.0,29.0,31.5,3.42,1.08,0.16,0.52,17.9,0.0,0.0,0.0,10.8,10.8,0.12,4.2,4.2,Matches,303.0,pt POR,FWMF,23.0,35.0,28.0,2421.0,26.9,15.0,8.0,23.0,15.0,0.0,0.0,7.0,1.0,10.8,10.8,7.0,17.9,136.0,122.0,235.0,0.56,0.3,0.86,0.56,0.86,0.4,0.26,0.66,0.4,0.66,Matches,Rafael Leão,AM/S L,23,163,176,"Portugal,Angola",AC Milan,5,15,17,15,16,6,11,13,6,4,15,12,7,15,9,13,8,13,11,14,13,14,17,8,15,7,13,13,17,18,16,14,15,16,11,14,14,5,12,8,12,2,1,1,1,2,4,2,2,3,2,1,12,16,6,11,12,13,9,12,1,1,1,1,1,1,1,1,1,1,20,14,12,17,188,81,14,20,150000002,8100,7650,6350,African_Caribbean,159,16,1999/6/10,9,0,34423.0,,83111483
1233,Mehdi Léris,Sampdoria,1998,304.0,dz ALG,MFDF,24.0,27.3,63.0,46.0,30.0,24.0,9.0,23.0,55.0,41.8,32.0,38.0,6.0,32.0,27.0,90.0,34.0,0.0,Matches,304.0,dz ALG,MFDF,24.0,27.3,50.0,1.83,40.0,0.0,1.0,4.0,3.0,2.0,4.0,0.15,1.0,0.0,0.0,3.0,0.0,0.0,Matches,,,,,,,,,,,,,,,,,,,,,,,,,,,,,,,,,,,,,,,,,,,,,,,,,,,,,,,,304.0,dz ALG,MFDF,24.0,27.3,13.0,0.0,0.0,52.0,47.0,10.0,57.0,27.0,46.0,0.0,0.0,0.0,149.0,96.0,66.0,59.3,Matches,304.0,dz ALG,MFDF,24.0,27.3,932.0,879.0,47.0,5.0,4.0,6.0,57.0,41.0,0.0,0.0,0.0,0.0,618.0,6.0,41.0,Matches,304.0,dz ALG,MFDF,24.0,27.3,618.0,932.0,66.3,8836.0,2937.0,373.0,446.0,83.6,177.0,290.0,61.0,37.0,89.0,41.6,1.0,1.8,1.7,-0.8,20.0,48.0,19.0,5.0,62.0,Matches,394,dz ALG,MFDF,24,32,2460.0,77.0,71.9,27.3,29,81.0,20,3,34.0,1,0.53,20.0,48.0,-28.0,-1.02,0.76,26.7,48.0,-21.3,-0.78,0.23,Matches,304.0,dz ALG,MFDF,24.0,27.3,1296.0,51.0,263.0,592.0,464.0,78.0,1296.0,69.0,29.0,42.0,31.0,44.9,742.0,3782.0,1647.0,56.0,31.0,13.0,80.0,48.0,874.0,165.0,Matches,304.0,dz ALG,MFDF,24.0,27.3,1.0,30.0,12.0,40.0,1.1,0.44,0.03,0.08,12.8,0.0,0.0,0.0,3.4,3.4,0.11,-2.4,-2.4,Matches,304.0,dz ALG,MFDF,24.0,32.0,29.0,2460.0,27.3,1.0,1.0,2.0,1.0,0.0,0.0,13.0,0.0,3.4,3.4,1.8,5.2,56.0,62.0,165.0,0.04,0.04,0.07,0.04,0.07,0.13,0.07,0.19,0.13,0.19,Matches,Mehdi Léris,M/AM RL,24,124,135,"France,Algeria",U.C. Sampdoria,11,15,13,12,14,10,10,12,4,6,12,10,4,14,10,12,12,10,10,11,10,8,16,10,14,10,10,10,14,15,12,11,13,14,12,9,12,4,12,4,16,2,3,1,3,1,1,2,1,3,4,3,13,14,9,12,12,11,12,17,1,1,1,1,1,1,1,19,12,20,18,13,19,1,186,74,10,20,2142929,6200,5750,4167,North_African__Middle_Eastern,117,6,1998/5/23,0,0,10000.0,,43252697
1234,Karol Linetty,Torino,1995,305.0,pl POL,MF,27.0,21.0,32.0,17.0,7.0,22.0,3.0,13.0,25.0,52.0,12.0,28.0,8.0,20.0,19.0,51.0,25.0,0.0,Matches,305.0,pl POL,MF,27.0,21.0,41.0,1.96,32.0,4.0,1.0,1.0,2.0,1.0,1.0,0.05,1.0,0.0,0.0,0.0,0.0,0.0,Matches,,,,,,,,,,,,,,,,,,,,,,,,,,,,,,,,,,,,,,,,,,,,,,,,,,,,,,,,305.0,pl POL,MF,27.0,21.0,8.0,0.0,0.0,50.0,22.0,4.0,21.0,19.0,17.0,0.0,1.0,0.0,129.0,24.0,26.0,48.0,Matches,305.0,pl POL,MF,27.0,21.0,966.0,913.0,49.0,32.0,3.0,10.0,21.0,1.0,16.0,5.0,8.0,0.0,832.0,4.0,10.0,Matches,305.0,pl POL,MF,27.0,21.0,832.0,966.0,86.1,13835.0,3130.0,391.0,439.0,89.1,366.0,395.0,92.7,55.0,84.0,65.5,0.0,0.9,0.8,-0.9,20.0,77.0,5.0,1.0,73.0,Matches,396,pl POL,MF,27,32,1886.0,59.0,55.1,21.0,22,76.0,10,10,21.0,5,1.41,22.0,26.0,-4.0,-0.19,-0.48,24.9,23.4,1.5,0.07,0.05,Matches,305.0,pl POL,MF,27.0,21.0,1175.0,37.0,213.0,708.0,260.0,21.0,1175.0,22.0,7.0,31.8,13.0,59.1,625.0,3132.0,1657.0,27.0,24.0,3.0,27.0,11.0,767.0,32.0,Matches,305.0,pl POL,MF,27.0,21.0,1.0,16.0,4.0,25.0,0.76,0.19,0.06,0.25,20.9,0.0,0.0,0.0,1.0,1.0,0.06,0.0,0.0,Matches,305.0,pl POL,MF,27.0,32.0,22.0,1886.0,21.0,1.0,0.0,1.0,1.0,0.0,0.0,8.0,0.0,1.0,1.0,0.9,1.9,27.0,73.0,32.0,0.05,0.0,0.05,0.05,0.05,0.05,0.04,0.09,0.05,0.09,Matches,Karol Linetty,DM/M/AM C,27,133,138,Poland,Torino,10,11,12,11,13,9,10,11,8,10,14,10,14,13,13,13,14,13,13,12,12,15,12,13,13,11,14,14,12,12,15,9,16,13,14,12,13,13,14,10,14,4,1,1,1,2,1,1,1,1,2,3,14,13,8,15,10,13,12,11,1,1,1,1,1,1,17,11,20,11,5,16,5,1,176,73,15,20,6921683,6650,6850,5250,Northern_European,131,1,1995/2/2,41,5,49807.0,,96032464
1235,Stanislav Lobotka,Napoli,1994,308.0,sk SVK,MF,27.0,34.5,83.0,44.0,35.0,35.0,13.0,43.0,73.0,58.9,30.0,29.0,7.0,22.0,23.0,106.0,16.0,0.0,Matches,308.0,sk SVK,MF,27.0,34.5,70.0,2.03,58.0,1.0,1.0,2.0,5.0,3.0,8.0,0.23,6.0,1.0,0.0,1.0,0.0,0.0,Matches,,,,,,,,,,,,,,,,,,,,,,,,,,,,,,,,,,,,,,,,,,,,,,,,,,,,,,,,308.0,sk SVK,MF,27.0,34.5,2.0,0.0,0.0,25.0,55.0,0.0,2.0,23.0,44.0,1.0,0.0,0.0,254.0,12.0,17.0,41.4,Matches,308.0,sk SVK,MF,27.0,34.5,2301.0,2252.0,47.0,33.0,0.0,14.0,2.0,2.0,0.0,0.0,0.0,0.0,2163.0,2.0,10.0,Matches,308.0,sk SVK,MF,27.0,34.5,2163.0,2301.0,94.0,35855.0,8577.0,1040.0,1095.0,95.0,890.0,933.0,95.4,172.0,191.0,90.1,1.0,1.0,1.3,0.0,17.0,214.0,14.0,0.0,172.0,Matches,399,sk SVK,MF,27,38,3101.0,82.0,90.7,34.5,34,87.0,20,4,38.0,0,2.37,75.0,27.0,48.0,1.39,1.11,60.1,29.1,31.0,0.9,0.34,Matches,308.0,sk SVK,MF,27.0,34.5,2536.0,66.0,523.0,1653.0,379.0,14.0,2536.0,27.0,18.0,66.7,5.0,18.5,1628.0,7751.0,3135.0,51.0,68.0,9.0,25.0,16.0,1950.0,39.0,Matches,308.0,sk SVK,MF,27.0,34.5,1.0,11.0,4.0,36.4,0.32,0.12,0.09,0.25,22.3,0.0,0.0,0.0,0.6,0.6,0.06,0.4,0.4,Matches,308.0,sk SVK,MF,27.0,38.0,34.0,3101.0,34.5,1.0,1.0,2.0,1.0,0.0,0.0,2.0,0.0,0.6,0.6,1.0,1.6,51.0,172.0,39.0,0.03,0.03,0.06,0.03,0.06,0.02,0.03,0.05,0.02,0.05,Matches,Stanislav Lobotka,DM/M C,27,150,155,Slovakia,Parthenope,4,11,14,6,17,4,5,9,5,12,16,8,17,17,13,14,15,17,15,14,15,15,12,10,9,14,17,15,13,15,16,7,15,12,15,10,15,5,11,12,11,1,2,2,3,3,3,3,3,3,3,1,13,14,3,15,13,15,16,16,1,1,1,1,1,1,20,1,18,1,1,14,1,1,172,64,13,20,30058676,7500,7500,6250,Northern_European,150,4,1994/11/25,40,3,49230.0,,63012964
1236,Manuel Locatelli,Juventus,1998,309.0,it ITA,MF,24.0,27.2,59.0,33.0,26.0,23.0,10.0,30.0,53.0,56.6,23.0,50.0,22.0,28.0,27.0,86.0,59.0,0.0,Matches,309.0,it ITA,MF,24.0,27.2,56.0,2.06,46.0,3.0,2.0,3.0,1.0,1.0,7.0,0.26,5.0,0.0,1.0,0.0,1.0,0.0,Matches,,,,,,,,,,,,,,,,,,,,,,,,,,,,,,,,,,,,,,,,,,,,,,,,,,,,,,,,309.0,it ITA,MF,24.0,27.2,8.0,0.0,0.0,44.0,31.0,0.0,13.0,27.0,33.0,0.0,0.0,0.0,168.0,34.0,30.0,53.1,Matches,309.0,it ITA,MF,24.0,27.2,1362.0,1294.0,64.0,52.0,1.0,20.0,13.0,6.0,4.0,0.0,3.0,0.0,1114.0,4.0,28.0,Matches,309.0,it ITA,MF,24.0,27.2,1114.0,1362.0,81.8,20892.0,7015.0,478.0,547.0,87.4,462.0,526.0,87.8,153.0,225.0,68.0,2.0,1.8,1.3,0.2,22.0,144.0,13.0,1.0,134.0,Matches,400,it ITA,MF,24,32,2446.0,76.0,71.5,27.2,29,81.0,16,3,31.0,2,1.94,40.0,19.0,21.0,0.77,0.59,40.5,27.8,12.7,0.47,0.38,Matches,309.0,it ITA,MF,24.0,27.2,1671.0,100.0,466.0,939.0,283.0,20.0,1671.0,27.0,15.0,55.6,11.0,40.7,804.0,3203.0,1475.0,25.0,18.0,4.0,29.0,19.0,1083.0,37.0,Matches,309.0,it ITA,MF,24.0,27.2,0.0,29.0,12.0,41.4,1.07,0.44,0.0,0.0,23.9,0.0,0.0,0.0,1.5,1.5,0.05,-1.5,-1.5,Matches,309.0,it ITA,MF,24.0,32.0,29.0,2446.0,27.2,0.0,2.0,2.0,0.0,0.0,0.0,8.0,0.0,1.5,1.5,1.8,3.2,25.0,134.0,37.0,0.0,0.07,0.07,0.0,0.07,0.05,0.07,0.12,0.05,0.12,Matches,Manuel Locatelli,DM/M C,24,149,162,Italy,U.S. Sassuolo,11,11,12,11,15,10,13,14,7,12,16,11,16,15,14,15,15,14,13,14,13,17,13,14,14,14,17,15,12,13,14,13,14,12,14,13,14,14,14,11,13,1,1,4,2,3,1,3,3,3,2,3,13,17,4,13,13,16,20,17,1,1,1,1,1,1,20,1,20,1,1,11,1,1,186,75,10,20,37258394,7450,7450,6500,Mediterranean_Hispanic,148,4,1998/1/8,24,3,106731.0,Juventus,43167354
1237,Luka Lochoshvili,Cremonese,1998,310.0,ge GEO,DF,24.0,20.4,45.0,19.0,30.0,11.0,4.0,22.0,31.0,71.0,9.0,31.0,10.0,21.0,22.0,67.0,89.0,0.0,Matches,310.0,ge GEO,DF,24.0,20.4,14.0,0.68,10.0,0.0,1.0,2.0,0.0,1.0,2.0,0.1,1.0,0.0,0.0,1.0,0.0,0.0,Matches,,,,,,,,,,,,,,,,,,,,,,,,,,,,,,,,,,,,,,,,,,,,,,,,,,,,,,,,310.0,ge GEO,DF,24.0,20.4,4.0,0.0,0.0,27.0,9.0,1.0,6.0,22.0,19.0,0.0,1.0,0.0,88.0,38.0,32.0,54.3,Matches,310.0,ge GEO,DF,24.0,20.4,791.0,756.0,33.0,27.0,0.0,2.0,6.0,5.0,0.0,0.0,0.0,0.0,627.0,2.0,7.0,Matches,310.0,ge GEO,DF,24.0,20.4,627.0,791.0,79.3,11677.0,4375.0,236.0,259.0,91.1,343.0,386.0,88.9,46.0,125.0,36.8,2.0,1.1,0.2,0.9,5.0,43.0,3.0,1.0,70.0,Matches,401,ge GEO,DF,24,25,1839.0,74.0,53.8,20.4,22,79.0,9,3,31.0,7,0.72,21.0,33.0,-12.0,-0.59,0.61,21.1,32.2,-11.1,-0.54,0.39,Matches,310.0,ge GEO,DF,24.0,20.4,1019.0,133.0,561.0,414.0,54.0,9.0,1019.0,9.0,6.0,66.7,3.0,33.3,544.0,2851.0,1642.0,17.0,14.0,0.0,11.0,5.0,589.0,5.0,Matches,310.0,ge GEO,DF,24.0,20.4,1.0,8.0,2.0,25.0,0.39,0.1,0.13,0.5,16.3,0.0,0.0,0.0,0.6,0.6,0.08,0.4,0.4,Matches,310.0,ge GEO,DF,24.0,25.0,22.0,1839.0,20.4,1.0,2.0,3.0,1.0,0.0,0.0,4.0,0.0,0.6,0.6,1.1,1.7,17.0,70.0,5.0,0.05,0.1,0.15,0.05,0.15,0.03,0.05,0.08,0.03,0.08,Matches,Luka Lochoshvili,D C,24,125,139,Georgia,Cremonese,7,9,9,7,10,9,14,10,13,13,9,10,14,8,15,14,14,12,12,10,12,8,5,10,10,15,14,13,11,11,15,15,14,11,14,13,14,8,14,6,12,3,2,2,2,2,3,1,1,3,3,2,20,11,3,11,12,12,11,11,1,14,20,1,1,1,1,1,1,1,1,1,1,1,192,84,20,8,1842506,6250,6250,4250,Northern_European,124,1,1998/5/29,0,0,17185.0,,59093382
1238,Ademola Lookman,Atalanta,1997,311.0,ng NGA,FWMF,24.0,19.2,13.0,5.0,2.0,6.0,5.0,3.0,15.0,20.0,12.0,18.0,0.0,18.0,4.0,17.0,1.0,0.0,Matches,311.0,ng NGA,FWMF,24.0,19.2,87.0,4.53,60.0,6.0,10.0,5.0,5.0,1.0,12.0,0.62,8.0,0.0,1.0,2.0,1.0,0.0,Matches,,,,,,,,,,,,,,,,,,,,,,,,,,,,,,,,,,,,,,,,,,,,,,,,,,,,,,,,311.0,ng NGA,FWMF,24.0,19.2,3.0,0.0,0.0,24.0,36.0,11.0,38.0,4.0,5.0,1.0,0.0,0.0,86.0,3.0,13.0,18.8,Matches,311.0,ng NGA,FWMF,24.0,19.2,649.0,601.0,46.0,7.0,6.0,3.0,38.0,11.0,16.0,2.0,7.0,0.0,492.0,2.0,25.0,Matches,311.0,ng NGA,FWMF,24.0,19.2,492.0,649.0,75.8,6802.0,2025.0,284.0,333.0,85.3,144.0,189.0,76.2,25.0,44.0,56.8,6.0,6.6,4.9,-0.6,39.0,30.0,33.0,4.0,79.0,Matches,402,ng NGA,FWMF,24,31,1729.0,56.0,50.6,19.2,20,73.0,3,11,25.0,1,1.65,38.0,23.0,15.0,0.78,0.62,34.7,20.9,13.8,0.72,0.58,Matches,311.0,ng NGA,FWMF,24.0,19.2,867.0,2.0,58.0,350.0,470.0,111.0,864.0,80.0,34.0,42.5,37.0,46.3,572.0,3472.0,1744.0,73.0,28.0,33.0,47.0,46.0,675.0,185.0,Matches,311.0,ng NGA,FWMF,24.0,19.2,13.0,49.0,23.0,46.9,2.55,1.2,0.2,0.43,15.8,1.0,3.0,3.0,9.1,6.7,0.14,3.9,3.3,Matches,311.0,ng NGA,FWMF,24.0,31.0,20.0,1729.0,19.2,13.0,6.0,19.0,10.0,3.0,3.0,3.0,0.0,9.1,6.7,6.6,13.3,73.0,79.0,185.0,0.68,0.31,0.99,0.52,0.83,0.47,0.34,0.82,0.35,0.69,Matches,Ademola Lookman,M/AM/S RLC,24,143,154,"Nigeria,England",Atalanta,9,12,15,14,13,11,8,13,8,8,12,10,8,14,13,9,8,12,11,12,8,15,14,8,13,8,8,15,17,15,13,7,14,15,12,9,12,2,14,10,12,3,3,2,3,2,2,1,2,2,4,2,11,17,10,10,12,12,13,15,1,1,1,1,1,1,1,18,1,15,20,16,18,16,174,71,12,20,14136321,7150,7050,5750,African_Caribbean,130,16,1997/10/20,4,1,44423.0,,29141828
1239,Maxime Lopez,Sassuolo,1997,312.0,fr FRA,MF,24.0,25.5,42.0,18.0,26.0,12.0,4.0,16.0,56.0,28.6,40.0,24.0,6.0,18.0,22.0,64.0,21.0,0.0,Matches,312.0,fr FRA,MF,24.0,25.5,73.0,2.87,64.0,6.0,1.0,2.0,0.0,0.0,4.0,0.16,3.0,0.0,0.0,1.0,0.0,0.0,Matches,,,,,,,,,,,,,,,,,,,,,,,,,,,,,,,,,,,,,,,,,,,,,,,,,,,,,,,,312.0,fr FRA,MF,24.0,25.5,11.0,0.0,0.0,31.0,11.0,0.0,25.0,22.0,18.0,0.0,0.0,0.0,172.0,4.0,3.0,57.1,Matches,312.0,fr FRA,MF,24.0,25.5,1673.0,1606.0,60.0,44.0,3.0,9.0,25.0,3.0,12.0,2.0,6.0,0.0,1471.0,7.0,14.0,Matches,312.0,fr FRA,MF,24.0,25.5,1471.0,1673.0,87.9,25307.0,8848.0,676.0,738.0,91.6,611.0,675.0,90.5,144.0,190.0,75.8,0.0,2.1,2.3,-2.1,32.0,179.0,19.0,3.0,210.0,Matches,403,fr FRA,MF,24,30,2296.0,77.0,67.1,25.5,25,85.0,18,5,34.0,2,1.27,29.0,36.0,-7.0,-0.27,0.29,34.6,33.3,1.3,0.05,0.0,Matches,312.0,fr FRA,MF,24.0,25.5,1855.0,60.0,456.0,1070.0,345.0,14.0,1855.0,27.0,11.0,40.7,15.0,55.6,1214.0,6585.0,3157.0,54.0,58.0,2.0,17.0,12.0,1407.0,40.0,Matches,312.0,fr FRA,MF,24.0,25.5,0.0,16.0,5.0,31.3,0.63,0.2,0.0,0.0,22.7,0.0,0.0,0.0,1.0,1.0,0.06,-1.0,-1.0,Matches,312.0,fr FRA,MF,24.0,30.0,25.0,2296.0,25.5,0.0,0.0,0.0,0.0,0.0,0.0,11.0,0.0,1.0,1.0,2.1,3.1,54.0,210.0,40.0,0.0,0.0,0.0,0.0,0.0,0.04,0.08,0.12,0.04,0.12,Matches,Maxime Lopez,DM/M C,24,141,154,"France,Algeria",U.S. Sassuolo,11,11,12,9,16,10,4,10,5,13,15,8,13,15,15,14,14,14,13,15,14,15,14,9,13,14,16,14,14,16,15,4,15,13,14,8,14,8,14,7,13,1,2,3,1,2,1,3,1,2,2,1,17,15,6,13,14,16,15,16,1,1,1,1,1,1,20,1,20,1,1,15,1,1,167,58,9,20,13480184,7050,6950,5400,Northern_European,137,7,1997/12/4,0,0,14808.0,,85140254
1240,Sandi Lovrić,Udinese,1998,314.0,si SVN,MF,24.0,25.9,40.0,18.0,16.0,16.0,8.0,25.0,43.0,58.1,18.0,25.0,2.0,23.0,26.0,66.0,21.0,0.0,Matches,314.0,si SVN,MF,24.0,25.9,87.0,3.35,53.0,18.0,4.0,9.0,2.0,1.0,9.0,0.35,6.0,1.0,1.0,1.0,0.0,0.0,Matches,,,,,,,,,,,,,,,,,,,,,,,,,,,,,,,,,,,,,,,,,,,,,,,,,,,,,,,,314.0,si SVN,MF,24.0,25.9,4.0,0.0,0.0,31.0,33.0,1.0,75.0,26.0,18.0,0.0,0.0,0.0,145.0,7.0,16.0,30.4,Matches,314.0,si SVN,MF,24.0,25.9,963.0,884.0,74.0,33.0,4.0,12.0,75.0,5.0,36.0,6.0,15.0,0.0,767.0,5.0,15.0,Matches,314.0,si SVN,MF,24.0,25.9,767.0,963.0,79.6,12855.0,3831.0,378.0,432.0,87.5,266.0,320.0,83.1,83.0,142.0,58.5,6.0,3.2,3.0,2.8,47.0,86.0,24.0,10.0,105.0,Matches,407,si SVN,MF,24,37,2335.0,63.0,68.3,25.9,28,75.0,6,9,27.0,0,1.22,29.0,34.0,-5.0,-0.19,-0.52,30.5,36.7,-6.1,-0.24,-0.34,Matches,314.0,si SVN,MF,24.0,25.9,1272.0,35.0,210.0,646.0,438.0,55.0,1272.0,38.0,14.0,36.8,20.0,52.6,734.0,3806.0,1793.0,42.0,34.0,10.0,51.0,22.0,818.0,90.0,Matches,314.0,si SVN,MF,24.0,25.9,5.0,71.0,18.0,25.4,2.74,0.69,0.07,0.28,22.3,4.0,0.0,0.0,4.8,4.8,0.07,0.2,0.2,Matches,314.0,si SVN,MF,24.0,37.0,28.0,2335.0,25.9,5.0,6.0,11.0,5.0,0.0,0.0,4.0,0.0,4.8,4.8,3.2,8.0,42.0,105.0,90.0,0.19,0.23,0.42,0.19,0.42,0.18,0.12,0.31,0.18,0.31,Matches,Sandi Lovrić,M/AM C,24,130,143,"Slovenia,Austria",Udinese Calcio,8,10,13,8,14,8,9,13,8,9,13,12,11,14,13,12,11,12,12,13,13,12,11,9,12,12,14,14,13,13,12,13,14,13,14,12,13,9,11,3,3,1,3,3,1,1,1,1,3,4,1,3,14,9,8,13,9,12,11,13,1,1,1,1,1,1,10,1,20,3,1,18,1,1,180,75,13,20,2300591,6500,6650,4500,Northern_European,129,4,1998/3/28,22,3,24439.0,,16135875
1241,Hirving Lozano,Napoli,1995,315.0,mx MEX,FW,27.0,17.8,24.0,13.0,10.0,6.0,8.0,9.0,21.0,42.9,12.0,31.0,0.0,31.0,15.0,39.0,6.0,0.0,Matches,315.0,mx MEX,FW,27.0,17.8,68.0,3.82,52.0,0.0,7.0,4.0,2.0,3.0,8.0,0.45,7.0,0.0,0.0,1.0,0.0,0.0,Matches,,,,,,,,,,,,,,,,,,,,,,,,,,,,,,,,,,,,,,,,,,,,,,,,,,,,,,,,315.0,mx MEX,FW,27.0,17.8,3.0,0.0,0.0,27.0,31.0,4.0,73.0,15.0,13.0,0.0,0.0,0.0,60.0,8.0,13.0,38.1,Matches,315.0,mx MEX,FW,27.0,17.8,588.0,579.0,6.0,0.0,0.0,3.0,73.0,5.0,1.0,0.0,0.0,0.0,441.0,3.0,23.0,Matches,315.0,mx MEX,FW,27.0,17.8,441.0,588.0,75.0,6393.0,1550.0,250.0,291.0,85.9,140.0,182.0,76.9,30.0,50.0,60.0,3.0,3.3,3.3,-0.3,30.0,25.0,40.0,22.0,49.0,Matches,408,mx MEX,FW,27,32,1605.0,50.0,46.9,17.8,20,67.0,1,12,22.0,1,2.41,39.0,8.0,31.0,1.74,0.85,29.3,11.9,17.4,0.98,0.21,Matches,315.0,mx MEX,FW,27.0,17.8,811.0,9.0,73.0,285.0,467.0,77.0,810.0,78.0,38.0,48.7,31.0,39.7,570.0,4050.0,2285.0,86.0,29.0,22.0,39.0,13.0,607.0,190.0,Matches,315.0,mx MEX,FW,27.0,17.8,3.0,41.0,13.0,31.7,2.3,0.73,0.05,0.15,18.5,0.0,1.0,1.0,5.4,4.6,0.11,-2.4,-2.6,Matches,315.0,mx MEX,FW,27.0,32.0,20.0,1605.0,17.8,3.0,3.0,6.0,2.0,1.0,1.0,3.0,0.0,5.4,4.6,3.3,7.9,86.0,49.0,190.0,0.17,0.17,0.34,0.11,0.28,0.3,0.19,0.49,0.26,0.45,Matches,Hirving Lozano,AM/S RL,26,148,153,Mexico,Parthenope,9,13,14,14,15,12,12,12,5,4,14,14,6,15,12,14,9,15,10,13,13,12,16,7,16,6,11,12,16,16,11,9,13,16,13,7,12,10,13,9,14,3,1,1,1,1,1,3,1,3,1,1,10,15,6,12,11,16,12,14,1,1,1,1,1,1,1,10,1,10,18,12,20,16,175,70,11,20,25772795,7400,7750,6500,Native_American,142,8,1995/7/30,58,15,110961.0,,51042313
1242,Jhon Lucumí,Bologna,1998,316.0,co COL,DF,24.0,32.2,53.0,37.0,39.0,13.0,1.0,24.0,43.0,55.8,19.0,43.0,26.0,17.0,35.0,88.0,100.0,1.0,Matches,316.0,co COL,DF,24.0,32.2,30.0,0.93,25.0,0.0,0.0,3.0,1.0,1.0,6.0,0.19,5.0,0.0,0.0,0.0,1.0,0.0,Matches,,,,,,,,,,,,,,,,,,,,,,,,,,,,,,,,,,,,,,,,,,,,,,,,,,,,,,,,316.0,co COL,DF,24.0,32.2,8.0,0.0,0.0,29.0,18.0,0.0,1.0,35.0,37.0,1.0,4.0,1.0,204.0,41.0,30.0,57.7,Matches,316.0,co COL,DF,24.0,32.2,1951.0,1870.0,78.0,59.0,3.0,24.0,1.0,2.0,0.0,0.0,0.0,0.0,1731.0,3.0,15.0,Matches,316.0,co COL,DF,24.0,32.2,1731.0,1951.0,88.7,32107.0,11819.0,691.0,732.0,94.4,842.0,902.0,93.3,181.0,263.0,68.8,1.0,0.4,0.6,0.6,9.0,98.0,6.0,1.0,84.0,Matches,409,co COL,DF,24,33,2900.0,88.0,84.8,32.2,33,88.0,31,0,,1,1.58,51.0,39.0,12.0,0.37,1.76,39.0,40.2,-1.2,-0.04,0.59,Matches,316.0,co COL,DF,24.0,32.2,2258.0,304.0,1222.0,998.0,51.0,16.0,2258.0,6.0,4.0,66.7,2.0,33.3,1409.0,7653.0,4456.0,37.0,15.0,2.0,19.0,6.0,1537.0,6.0,Matches,316.0,co COL,DF,24.0,32.2,0.0,11.0,2.0,18.2,0.34,0.06,0.0,0.0,14.5,0.0,0.0,0.0,0.7,0.7,0.06,-0.7,-0.7,Matches,316.0,co COL,DF,24.0,33.0,33.0,2900.0,32.2,0.0,1.0,1.0,0.0,0.0,0.0,8.0,0.0,0.7,0.7,0.4,1.0,37.0,84.0,6.0,0.0,0.03,0.03,0.0,0.03,0.02,0.01,0.03,0.02,0.03,Matches,Jhon Lucumí,D C,24,131,145,Colombia,Bologna FC 1909,4,11,12,7,11,5,13,6,11,13,13,9,14,12,14,14,14,12,13,11,14,12,13,13,10,13,14,11,13,11,14,13,13,13,13,15,14,14,11,5,12,2,1,2,4,3,1,3,2,3,1,3,16,11,9,12,12,15,13,13,1,13,20,1,10,1,9,1,1,1,1,1,1,1,187,84,20,10,15877494,6550,6500,4950,African_Caribbean,131,15,1998/6/26,6,0,29230.0,,76042952
1243,Romelu Lukaku,Inter,1993,318.0,be BEL,FW,29.0,18.4,3.0,1.0,1.0,0.0,2.0,2.0,5.0,40.0,3.0,3.0,1.0,2.0,0.0,3.0,16.0,0.0,Matches,318.0,be BEL,FW,29.0,18.4,73.0,3.96,59.0,0.0,6.0,5.0,3.0,0.0,11.0,0.6,9.0,0.0,2.0,0.0,0.0,0.0,Matches,,,,,,,,,,,,,,,,,,,,,,,,,,,,,,,,,,,,,,,,,,,,,,,,,,,,,,,,318.0,be BEL,FW,29.0,18.4,1.0,0.0,0.0,16.0,6.0,13.0,24.0,0.0,1.0,0.0,0.0,0.0,23.0,39.0,35.0,52.7,Matches,318.0,be BEL,FW,29.0,18.4,404.0,384.0,18.0,0.0,5.0,2.0,24.0,0.0,0.0,0.0,0.0,0.0,277.0,2.0,19.0,Matches,318.0,be BEL,FW,29.0,18.4,277.0,404.0,68.6,3427.0,748.0,153.0,197.0,77.7,65.0,98.0,66.3,15.0,27.0,55.6,6.0,4.1,2.9,1.9,32.0,17.0,15.0,2.0,41.0,Matches,411,be BEL,FW,29,25,1660.0,66.0,48.5,18.4,19,81.0,10,6,21.0,1,1.8,27.0,16.0,11.0,0.6,-0.32,33.9,18.3,15.6,0.84,0.03,Matches,318.0,be BEL,FW,29.0,18.4,575.0,18.0,26.0,211.0,339.0,100.0,573.0,29.0,15.0,51.7,13.0,44.8,328.0,1767.0,778.0,34.0,21.0,12.0,47.0,28.0,482.0,159.0,Matches,318.0,be BEL,FW,29.0,18.4,10.0,49.0,20.0,40.8,2.66,1.08,0.16,0.4,15.0,0.0,2.0,2.0,9.0,7.4,0.15,1.0,0.6,Matches,318.0,be BEL,FW,29.0,25.0,19.0,1660.0,18.4,10.0,6.0,16.0,8.0,2.0,2.0,1.0,0.0,9.0,7.4,4.1,11.5,34.0,41.0,159.0,0.54,0.33,0.87,0.43,0.76,0.49,0.22,0.71,0.4,0.62,Matches,Romelu Lukaku,S,29,162,176,"Belgium,Democratic Republic of Congo",Chelsea,4,10,13,18,13,11,15,14,3,5,13,20,10,14,16,14,16,16,13,11,14,18,13,16,15,5,19,12,14,8,20,16,13,17,14,20,17,10,12,7,6,3,3,3,1,4,1,1,1,2,2,4,19,18,8,9,17,17,15,12,1,1,1,1,1,1,1,1,1,1,1,1,1,20,191,93,20,12,142679281,8150,8982,7984,African_Caribbean,161,17,1993/5/13,102,68,405971.0,FC Internazionale Milano,18007344
1244,Saša Lukić,Torino,1996,319.0,rs SRB,MF,25.0,13.3,21.0,14.0,10.0,10.0,1.0,9.0,15.0,60.0,6.0,17.0,7.0,10.0,13.0,34.0,10.0,0.0,Matches,319.0,rs SRB,MF,25.0,13.3,44.0,3.31,35.0,3.0,0.0,2.0,3.0,1.0,2.0,0.15,2.0,0.0,0.0,0.0,0.0,0.0,Matches,,,,,,,,,,,,,,,,,,,,,,,,,,,,,,,,,,,,,,,,,,,,,,,,,,,,,,,,319.0,rs SRB,MF,25.0,13.3,4.0,0.0,0.0,26.0,10.0,0.0,25.0,13.0,14.0,0.0,0.0,0.0,81.0,22.0,22.0,50.0,Matches,319.0,rs SRB,MF,25.0,13.3,732.0,692.0,38.0,29.0,1.0,6.0,25.0,5.0,4.0,0.0,4.0,0.0,627.0,2.0,7.0,Matches,319.0,rs SRB,MF,25.0,13.3,627.0,732.0,85.7,11788.0,2410.0,232.0,265.0,87.5,307.0,339.0,90.6,78.0,102.0,76.5,0.0,1.4,1.3,-1.4,16.0,54.0,8.0,3.0,44.0,Matches,412,rs SRB,MF,25,16,1195.0,75.0,34.9,13.3,13,87.0,12,3,23.0,0,1.06,13.0,18.0,-5.0,-0.38,-0.62,13.7,17.4,-3.7,-0.28,-0.5,Matches,319.0,rs SRB,MF,25.0,13.3,850.0,29.0,129.0,537.0,190.0,23.0,849.0,7.0,1.0,14.3,4.0,57.1,448.0,2360.0,1057.0,26.0,18.0,4.0,17.0,8.0,556.0,33.0,Matches,319.0,rs SRB,MF,25.0,13.3,2.0,15.0,3.0,20.0,1.13,0.23,0.07,0.33,20.2,1.0,1.0,1.0,1.7,0.9,0.06,0.3,0.1,Matches,319.0,rs SRB,MF,25.0,16.0,13.0,1195.0,13.3,2.0,0.0,2.0,1.0,1.0,1.0,4.0,0.0,1.7,0.9,1.4,2.3,26.0,44.0,33.0,0.15,0.0,0.15,0.08,0.08,0.13,0.11,0.23,0.07,0.18,Matches,Saša Lukić,DM/M/AM C,25,137,143,Serbia,Torino,12,11,13,11,14,7,11,13,4,10,15,14,14,14,15,13,12,14,13,13,13,14,14,10,13,13,14,13,13,12,14,11,14,13,14,13,13,14,13,9,11,2,2,2,3,1,1,1,2,3,2,1,12,13,9,12,12,15,13,13,1,1,1,1,1,1,17,1,20,1,1,17,1,1,182,77,12,20,9337307,6850,6900,5200,Mediterranean_Hispanic,137,3,1996/8/13,30,1,25000.0,,62124117
1245,Sebastiano Luperto,Empoli,1996,320.0,it ITA,DF,25.0,34.8,33.0,18.0,24.0,8.0,1.0,9.0,20.0,45.0,11.0,54.0,42.0,12.0,43.0,76.0,163.0,1.0,Matches,320.0,it ITA,DF,25.0,34.8,12.0,0.34,10.0,1.0,0.0,1.0,0.0,0.0,2.0,0.06,2.0,0.0,0.0,0.0,0.0,0.0,Matches,,,,,,,,,,,,,,,,,,,,,,,,,,,,,,,,,,,,,,,,,,,,,,,,,,,,,,,,320.0,it ITA,DF,25.0,34.8,4.0,2.0,1.0,21.0,21.0,0.0,2.0,43.0,18.0,0.0,0.0,0.0,170.0,72.0,67.0,51.8,Matches,320.0,it ITA,DF,25.0,34.8,1705.0,1532.0,171.0,81.0,1.0,8.0,2.0,2.0,0.0,0.0,0.0,0.0,1474.0,2.0,7.0,Matches,320.0,it ITA,DF,25.0,34.8,1474.0,1705.0,86.5,29332.0,10243.0,461.0,492.0,93.7,809.0,878.0,92.1,183.0,298.0,61.4,0.0,0.6,0.4,-0.6,3.0,54.0,3.0,1.0,72.0,Matches,413,it ITA,DF,25,36,3135.0,87.0,91.7,34.8,36,87.0,32,0,,0,1.08,34.0,44.0,-10.0,-0.29,0.34,34.9,53.5,-18.6,-0.54,-0.27,Matches,320.0,it ITA,DF,25.0,34.8,2057.0,414.0,1236.0,783.0,52.0,23.0,2057.0,2.0,2.0,100.0,0.0,0.0,1125.0,5044.0,2598.0,13.0,6.0,1.0,6.0,3.0,1191.0,3.0,Matches,320.0,it ITA,DF,25.0,34.8,2.0,18.0,4.0,22.2,0.52,0.11,0.11,0.5,12.7,0.0,0.0,0.0,1.2,1.2,0.07,0.8,0.8,Matches,320.0,it ITA,DF,25.0,36.0,36.0,3135.0,34.8,2.0,0.0,2.0,2.0,0.0,0.0,4.0,2.0,1.2,1.2,0.6,1.9,13.0,72.0,3.0,0.06,0.0,0.06,0.06,0.06,0.04,0.02,0.05,0.04,0.05,Matches,Sebastiano Luperto,D LC,25,128,134,Italy,Parthenope,5,9,7,6,10,7,15,6,11,14,12,9,13,10,14,14,14,13,13,10,11,12,5,11,9,14,13,14,12,11,12,16,15,13,14,15,12,10,10,5,12,3,3,2,3,3,3,1,1,3,3,2,12,14,5,14,12,13,13,10,1,15,20,4,1,1,1,1,1,1,1,1,1,1,191,75,20,8,1540325,6400,6400,5150,Mediterranean_Hispanic,128,1,1996/9/6,0,0,24903.0,Empoli Football Club,43095145
1246,Giangiacomo Magnani,Hellas Verona,1995,323.0,it ITA,DF,26.0,17.0,33.0,22.0,20.0,11.0,2.0,19.0,25.0,76.0,6.0,20.0,15.0,5.0,21.0,54.0,76.0,0.0,Matches,323.0,it ITA,DF,26.0,17.0,13.0,0.76,11.0,0.0,1.0,1.0,0.0,0.0,2.0,0.12,1.0,0.0,1.0,0.0,0.0,0.0,Matches,,,,,,,,,,,,,,,,,,,,,,,,,,,,,,,,,,,,,,,,,,,,,,,,,,,,,,,,323.0,it ITA,DF,26.0,17.0,7.0,1.0,0.0,22.0,8.0,0.0,4.0,21.0,22.0,0.0,0.0,1.0,93.0,33.0,21.0,61.1,Matches,323.0,it ITA,DF,26.0,17.0,499.0,485.0,12.0,8.0,0.0,6.0,4.0,4.0,0.0,0.0,0.0,0.0,367.0,2.0,2.0,Matches,323.0,it ITA,DF,26.0,17.0,367.0,499.0,73.5,7603.0,2655.0,125.0,151.0,82.8,176.0,211.0,83.4,61.0,122.0,50.0,1.0,0.2,0.2,0.8,5.0,32.0,4.0,1.0,32.0,Matches,416,it ITA,DF,26,24,1532.0,64.0,44.8,17.0,19,73.0,10,5,30.0,5,1.08,14.0,24.0,-10.0,-0.59,0.27,16.1,23.1,-7.0,-0.41,-0.07,Matches,323.0,it ITA,DF,26.0,17.0,683.0,102.0,341.0,323.0,27.0,7.0,683.0,5.0,3.0,60.0,2.0,40.0,316.0,1386.0,605.0,5.0,5.0,1.0,6.0,3.0,307.0,5.0,Matches,323.0,it ITA,DF,26.0,17.0,0.0,7.0,1.0,14.3,0.41,0.06,0.0,0.0,19.1,0.0,0.0,0.0,0.5,0.5,0.07,-0.5,-0.5,Matches,323.0,it ITA,DF,26.0,24.0,19.0,1532.0,17.0,0.0,1.0,1.0,0.0,0.0,0.0,7.0,1.0,0.5,0.5,0.2,0.7,5.0,32.0,5.0,0.0,0.06,0.06,0.0,0.06,0.03,0.01,0.04,0.03,0.04,Matches,Giangiacomo Magnani,D C,26,121,130,Italy,Hellas Verona,4,5,5,6,11,4,14,6,10,14,10,3,12,10,15,15,13,11,13,9,12,14,7,11,7,12,13,13,12,11,13,15,15,13,12,15,13,13,13,10,10,1,2,3,1,2,3,1,3,1,2,2,10,12,10,13,16,15,12,13,1,1,20,1,1,1,1,1,1,1,1,1,1,1,190,87,9,20,704149,6050,6050,5000,Northern_European,119,2,1995/10/4,0,0,21346.0,,43125080
1247,Mike Maignan,Milan,1995,324.0,fr FRA,GK,27.0,22.0,1.0,0.0,1.0,0.0,0.0,1.0,1.0,100.0,0.0,0.0,0.0,0.0,1.0,2.0,10.0,1.0,Matches,324.0,fr FRA,GK,27.0,22.0,3.0,0.14,3.0,0.0,0.0,0.0,0.0,0.0,1.0,0.05,1.0,0.0,0.0,0.0,0.0,0.0,Matches,15.0,fr FRA,GK,27.0,22.0,21.0,2.0,1.0,2.0,0.0,20.3,0.28,-0.7,-0.03,76.0,193.0,39.4,725.0,119.0,22.8,29.8,85.0,32.9,35.1,221.0,15.0,6.8,32.0,1.46,17.8,Matches,15.0,fr FRA,GK,27.0,22.0,22.0,1978.0,22.0,21.0,0.96,62.0,40.0,69.4,11.0,7.0,4.0,8.0,36.4,3.0,2.0,1.0,0.0,33.3,Matches,324.0,fr FRA,GK,27.0,22.0,0.0,0.0,0.0,0.0,3.0,0.0,0.0,1.0,0.0,0.0,0.0,0.0,32.0,3.0,0.0,100.0,Matches,324.0,fr FRA,GK,27.0,22.0,814.0,698.0,112.0,27.0,0.0,0.0,0.0,0.0,0.0,0.0,0.0,0.0,674.0,4.0,0.0,Matches,324.0,fr FRA,GK,27.0,22.0,674.0,814.0,82.8,16900.0,10659.0,133.0,134.0,99.3,354.0,360.0,98.3,185.0,314.0,58.9,1.0,0.0,0.0,1.0,1.0,17.0,0.0,0.0,1.0,Matches,418,fr FRA,GK,27,22,1978.0,90.0,57.8,22.0,22,90.0,21,0,,0,1.82,37.0,21.0,16.0,0.73,0.42,34.3,22.1,12.2,0.56,0.21,Matches,324.0,fr FRA,GK,27.0,22.0,853.0,639.0,838.0,15.0,0.0,0.0,853.0,0.0,0.0,,0.0,,618.0,3323.0,2132.0,0.0,0.0,0.0,0.0,0.0,525.0,0.0,Matches,324.0,fr FRA,GK,27.0,22.0,0.0,0.0,0.0,,0.0,0.0,,,,0.0,0.0,0.0,0.0,0.0,,0.0,0.0,Matches,324.0,fr FRA,GK,27.0,22.0,22.0,1978.0,22.0,0.0,1.0,1.0,0.0,0.0,0.0,0.0,0.0,0.0,0.0,0.0,0.0,0.0,1.0,0.0,0.0,0.05,0.05,0.0,0.05,0.0,0.0,0.0,0.0,0.0,Matches,Mike Maignan,GK,27,161,166,"France,French Guiana,Haiti",AC Milan,1,1,6,1,12,1,6,10,5,1,13,9,5,12,8,15,14,15,16,13,14,15,6,15,1,15,15,12,8,16,14,15,17,11,14,15,17,5,14,6,1,13,15,16,13,15,16,14,17,7,9,14,15,18,5,15,15,16,12,12,20,1,1,1,1,1,1,1,1,1,1,1,1,1,191,89,9,20,157734860,8050,7250,6100,African_Caribbean,163,14,1995/7/3,4,0,69037.0,,85094520
1248,Gianluca Mancini,Roma,1996,332.0,it ITA,DF,26.0,31.8,37.0,19.0,27.0,9.0,1.0,18.0,34.0,52.9,16.0,38.0,17.0,21.0,46.0,83.0,67.0,0.0,Matches,332.0,it ITA,DF,26.0,31.8,37.0,1.17,30.0,1.0,0.0,4.0,1.0,1.0,3.0,0.09,2.0,0.0,0.0,0.0,1.0,0.0,Matches,,,,,,,,,,,,,,,,,,,,,,,,,,,,,,,,,,,,,,,,,,,,,,,,,,,,,,,,332.0,it ITA,DF,26.0,31.8,7.0,0.0,0.0,39.0,25.0,2.0,28.0,46.0,19.0,0.0,1.0,0.0,112.0,58.0,26.0,69.0,Matches,332.0,it ITA,DF,26.0,31.8,1621.0,1536.0,76.0,69.0,3.0,17.0,28.0,5.0,0.0,0.0,0.0,0.0,1306.0,9.0,14.0,Matches,332.0,it ITA,DF,26.0,31.8,1306.0,1621.0,80.6,24870.0,8978.0,494.0,542.0,91.1,638.0,718.0,88.9,157.0,311.0,50.5,2.0,1.6,1.3,0.4,16.0,104.0,15.0,5.0,93.0,Matches,426,it ITA,DF,26,35,2858.0,82.0,83.6,31.8,33,84.0,23,2,41.0,2,1.69,35.0,28.0,7.0,0.22,-0.58,43.9,25.3,18.6,0.58,-0.5,Matches,332.0,it ITA,DF,26.0,31.8,1865.0,189.0,855.0,885.0,139.0,30.0,1865.0,14.0,6.0,42.9,5.0,35.7,1124.0,5050.0,3089.0,17.0,21.0,0.0,16.0,7.0,1324.0,19.0,Matches,332.0,it ITA,DF,26.0,31.8,1.0,22.0,5.0,22.7,0.69,0.16,0.05,0.2,13.1,0.0,0.0,0.0,2.3,2.3,0.1,-1.3,-1.3,Matches,332.0,it ITA,DF,26.0,35.0,33.0,2858.0,31.8,1.0,2.0,3.0,1.0,0.0,0.0,7.0,0.0,2.3,2.3,1.6,3.9,17.0,93.0,19.0,0.03,0.06,0.09,0.03,0.09,0.07,0.05,0.12,0.07,0.12,Matches,Gianluca Mancini,D C,26,144,150,Italy,Associazione Sportiva Roma,5,9,10,11,12,5,16,6,9,14,14,6,15,12,19,14,13,15,16,10,12,18,8,12,12,14,18,16,12,12,12,16,16,13,16,14,14,18,10,8,12,3,1,2,1,2,2,1,2,1,1,1,6,13,17,12,12,16,3,2,1,1,20,8,1,1,12,1,1,1,1,1,1,1,190,82,11,20,18715437,7199,7199,6199,Mediterranean_Hispanic,143,1,1996/4/17,9,0,71154.0,,43093502
1249,Rolando Mandragora,Fiorentina,1997,333.0,it ITA,MF,25.0,21.7,42.0,24.0,12.0,22.0,8.0,23.0,52.0,44.2,29.0,25.0,3.0,22.0,16.0,58.0,21.0,0.0,Matches,333.0,it ITA,MF,25.0,21.7,87.0,4.02,59.0,19.0,0.0,6.0,2.0,1.0,8.0,0.37,5.0,1.0,0.0,1.0,1.0,0.0,Matches,,,,,,,,,,,,,,,,,,,,,,,,,,,,,,,,,,,,,,,,,,,,,,,,,,,,,,,,333.0,it ITA,MF,25.0,21.7,8.0,0.0,0.0,31.0,18.0,1.0,74.0,16.0,24.0,0.0,0.0,0.0,121.0,35.0,23.0,60.3,Matches,333.0,it ITA,MF,25.0,21.7,984.0,886.0,95.0,52.0,1.0,17.0,74.0,6.0,36.0,16.0,15.0,0.0,790.0,3.0,17.0,Matches,333.0,it ITA,MF,25.0,21.7,790.0,984.0,80.3,15068.0,4733.0,311.0,356.0,87.4,354.0,400.0,88.5,100.0,167.0,59.9,4.0,4.9,4.1,-0.9,34.0,115.0,18.0,6.0,142.0,Matches,427,it ITA,MF,25,29,1950.0,67.0,57.0,21.7,22,82.0,11,7,22.0,5,1.55,29.0,22.0,7.0,0.32,0.14,32.8,23.3,9.5,0.44,0.31,Matches,333.0,it ITA,MF,25.0,21.7,1190.0,33.0,175.0,670.0,356.0,37.0,1190.0,16.0,5.0,31.3,9.0,56.3,598.0,2489.0,1243.0,18.0,25.0,3.0,13.0,8.0,720.0,59.0,Matches,333.0,it ITA,MF,25.0,21.7,2.0,37.0,5.0,13.5,1.71,0.23,0.05,0.4,22.9,2.0,0.0,0.0,1.5,1.5,0.04,0.5,0.5,Matches,333.0,it ITA,MF,25.0,29.0,22.0,1950.0,21.7,2.0,4.0,6.0,2.0,0.0,0.0,8.0,0.0,1.5,1.5,4.9,6.4,18.0,142.0,59.0,0.09,0.18,0.28,0.09,0.28,0.07,0.23,0.3,0.07,0.3,Matches,Rolando Mandragora,DM/M C,25,135,145,Italy,ACF Fiorentina,13,10,11,10,14,13,7,11,8,12,14,11,14,14,14,14,14,12,13,14,13,14,14,13,14,14,15,14,13,13,14,10,13,13,13,13,15,10,15,7,13,2,3,2,1,3,2,1,2,1,3,3,12,14,3,13,11,14,14,12,1,1,13,1,1,1,20,1,20,1,1,10,1,1,183,75,20,9,10243832,6750,6700,5350,Mediterranean_Hispanic,136,3,1997/6/29,1,0,56923.0,,43159580
1250,Gian Marco Ferrari,Sassuolo,1992,336.0,it ITA,DF,30.0,24.7,23.0,16.0,11.0,10.0,2.0,10.0,17.0,58.8,7.0,29.0,20.0,9.0,23.0,46.0,81.0,4.0,Matches,336.0,it ITA,DF,30.0,24.7,21.0,0.85,19.0,1.0,0.0,0.0,1.0,0.0,2.0,0.08,2.0,0.0,0.0,0.0,0.0,0.0,Matches,,,,,,,,,,,,,,,,,,,,,,,,,,,,,,,,,,,,,,,,,,,,,,,,,,,,,,,,336.0,it ITA,DF,30.0,24.7,5.0,0.0,0.0,24.0,31.0,0.0,6.0,23.0,16.0,0.0,2.0,0.0,110.0,47.0,24.0,66.2,Matches,336.0,it ITA,DF,30.0,24.7,1295.0,1164.0,127.0,83.0,0.0,16.0,6.0,5.0,0.0,0.0,0.0,0.0,1111.0,4.0,4.0,Matches,336.0,it ITA,DF,30.0,24.7,1111.0,1295.0,85.8,22139.0,8213.0,353.0,387.0,91.2,598.0,655.0,91.3,144.0,221.0,65.2,0.0,0.4,1.0,-0.4,4.0,78.0,5.0,1.0,101.0,Matches,431,it ITA,DF,30,33,2223.0,67.0,65.0,24.7,24,88.0,21,9,13.0,4,1.09,27.0,40.0,-13.0,-0.53,-0.45,35.5,35.3,0.2,0.01,-0.12,Matches,336.0,it ITA,DF,30.0,24.7,1476.0,210.0,749.0,672.0,66.0,14.0,1476.0,2.0,0.0,0.0,1.0,50.0,858.0,4530.0,2799.0,11.0,10.0,0.0,10.0,2.0,938.0,4.0,Matches,336.0,it ITA,DF,30.0,24.7,1.0,8.0,1.0,12.5,0.32,0.04,0.13,1.0,10.6,0.0,0.0,0.0,1.2,1.2,0.15,-0.2,-0.2,Matches,336.0,it ITA,DF,30.0,33.0,24.0,2223.0,24.7,1.0,0.0,1.0,1.0,0.0,0.0,5.0,0.0,1.2,1.2,0.4,1.6,11.0,101.0,4.0,0.04,0.0,0.04,0.04,0.04,0.05,0.02,0.07,0.05,0.07,Matches,Gian Marco Ferrari,D C,30,134,145,Italy,U.S. Sassuolo,3,6,6,7,12,3,15,8,5,14,13,8,13,11,14,14,14,13,13,12,14,15,10,13,8,15,13,12,12,12,14,15,18,12,15,15,14,10,14,6,8,3,1,1,2,2,3,1,2,3,1,2,12,13,9,15,14,15,13,14,1,1,20,1,1,1,1,1,1,1,1,1,1,1,189,82,20,8,6344468,6693,6693,5443,Mediterranean_Hispanic,134,2,1992/5/15,1,1,21346.0,,43077074
1251,Pablo Marí,Monza,1993,337.0,es ESP,DF,28.0,27.6,37.0,19.0,29.0,7.0,1.0,17.0,26.0,65.4,9.0,22.0,14.0,8.0,31.0,68.0,111.0,3.0,Matches,337.0,es ESP,DF,28.0,27.6,14.0,0.51,13.0,1.0,0.0,0.0,0.0,0.0,0.0,0.0,0.0,0.0,0.0,0.0,0.0,0.0,Matches,,,,,,,,,,,,,,,,,,,,,,,,,,,,,,,,,,,,,,,,,,,,,,,,,,,,,,,,337.0,es ESP,DF,28.0,27.6,4.0,0.0,0.0,31.0,9.0,1.0,1.0,31.0,19.0,0.0,0.0,0.0,131.0,59.0,27.0,68.6,Matches,337.0,es ESP,DF,28.0,27.6,1621.0,1544.0,71.0,40.0,0.0,7.0,1.0,8.0,0.0,0.0,0.0,0.0,1431.0,6.0,9.0,Matches,337.0,es ESP,DF,28.0,27.6,1431.0,1621.0,88.3,29354.0,11383.0,404.0,446.0,90.6,822.0,866.0,94.9,194.0,275.0,70.5,0.0,0.3,0.3,-0.3,3.0,74.0,2.0,0.0,57.0,Matches,433,es ESP,DF,28,30,2487.0,83.0,72.7,27.6,28,86.0,25,2,35.0,1,1.43,37.0,37.0,0.0,0.0,0.39,33.6,38.6,-5.0,-0.18,-0.14,Matches,337.0,es ESP,DF,28.0,27.6,1874.0,299.0,1090.0,750.0,37.0,15.0,1874.0,4.0,2.0,50.0,2.0,50.0,1049.0,5335.0,2820.0,6.0,8.0,1.0,10.0,5.0,1273.0,3.0,Matches,337.0,es ESP,DF,28.0,27.6,1.0,10.0,2.0,20.0,0.36,0.07,0.1,0.5,15.2,0.0,0.0,0.0,0.6,0.6,0.06,0.4,0.4,Matches,337.0,es ESP,DF,28.0,30.0,28.0,2487.0,27.6,1.0,0.0,1.0,1.0,0.0,0.0,4.0,0.0,0.6,0.6,0.3,1.0,6.0,57.0,3.0,0.04,0.0,0.04,0.04,0.04,0.02,0.01,0.04,0.02,0.04,Matches,Pablo Marí,D C,28,133,145,Spain,Arsenal,5,5,7,5,13,4,15,8,9,15,14,7,15,13,15,12,15,11,12,14,11,12,7,13,7,13,14,14,12,12,13,17,11,13,13,16,14,14,11,10,9,3,2,1,1,2,1,3,1,2,4,1,13,13,9,11,12,12,9,9,1,9,20,1,1,1,11,1,1,1,1,1,1,1,191,87,20,8,7516251,6650,6650,5750,Mediterranean_Hispanic,132,5,1993/8/31,0,0,57996.0,Brianza,67157583
1252,Răzvan Marin,Empoli,1996,338.0,ro ROU,MF,26.0,28.2,44.0,22.0,22.0,21.0,1.0,19.0,40.0,47.5,21.0,29.0,11.0,18.0,14.0,58.0,33.0,0.0,Matches,338.0,ro ROU,MF,26.0,28.2,92.0,3.26,54.0,34.0,2.0,1.0,1.0,0.0,4.0,0.14,1.0,3.0,0.0,0.0,0.0,0.0,Matches,,,,,,,,,,,,,,,,,,,,,,,,,,,,,,,,,,,,,,,,,,,,,,,,,,,,,,,,338.0,ro ROU,MF,26.0,28.2,7.0,0.0,0.0,31.0,21.0,1.0,140.0,14.0,22.0,0.0,1.0,0.0,148.0,16.0,17.0,48.5,Matches,338.0,ro ROU,MF,26.0,28.2,1594.0,1358.0,228.0,128.0,4.0,18.0,140.0,5.0,94.0,39.0,39.0,0.0,1260.0,8.0,25.0,Matches,338.0,ro ROU,MF,26.0,28.2,1260.0,1594.0,79.0,23304.0,8229.0,537.0,575.0,93.4,490.0,586.0,83.6,187.0,338.0,55.3,4.0,4.2,4.5,-0.2,56.0,113.0,30.0,7.0,118.0,Matches,435,ro ROU,MF,26,33,2538.0,77.0,74.2,28.2,28,86.0,21,5,25.0,1,1.09,25.0,39.0,-14.0,-0.5,-0.7,26.8,40.9,-14.1,-0.5,0.05,Matches,338.0,ro ROU,MF,26.0,28.2,1805.0,76.0,428.0,971.0,425.0,16.0,1805.0,39.0,22.0,56.4,15.0,38.5,1051.0,5460.0,2560.0,35.0,41.0,3.0,24.0,22.0,1164.0,27.0,Matches,338.0,ro ROU,MF,26.0,28.2,2.0,33.0,8.0,24.2,1.17,0.28,0.06,0.25,27.6,10.0,0.0,0.0,1.4,1.4,0.04,0.6,0.6,Matches,338.0,ro ROU,MF,26.0,33.0,28.0,2538.0,28.2,2.0,4.0,6.0,2.0,0.0,0.0,7.0,0.0,1.4,1.4,4.2,5.5,35.0,118.0,27.0,0.07,0.14,0.21,0.07,0.21,0.05,0.15,0.2,0.05,0.2,Matches,Răzvan Marin,DM/M C,26,130,136,Romania,Cagliari Calcio,11,13,11,11,11,14,11,15,5,12,15,14,12,13,10,13,13,14,13,15,14,15,14,10,14,12,13,13,12,13,14,10,14,12,13,11,14,7,14,6,13,2,1,1,1,1,1,1,1,3,3,1,13,16,6,11,15,15,14,15,1,1,1,1,1,1,17,10,20,10,1,15,1,1,177,70,8,20,8379890,6495,6595,5745,Mediterranean_Hispanic,130,6,1996/5/23,41,2,35577.0,Empoli Football Club,57113505
1253,Marlon,Monza,1995,339.0,br BRA,DF,26.0,17.7,35.0,21.0,20.0,14.0,1.0,15.0,29.0,51.7,14.0,13.0,4.0,9.0,18.0,53.0,50.0,0.0,Matches,339.0,br BRA,DF,26.0,17.7,7.0,0.4,6.0,0.0,0.0,1.0,0.0,0.0,0.0,0.0,0.0,0.0,0.0,0.0,0.0,0.0,Matches,,,,,,,,,,,,,,,,,,,,,,,,,,,,,,,,,,,,,,,,,,,,,,,,,,,,,,,,339.0,br BRA,DF,26.0,17.7,7.0,1.0,0.0,23.0,5.0,1.0,5.0,18.0,21.0,0.0,0.0,1.0,71.0,40.0,21.0,65.6,Matches,339.0,br BRA,DF,26.0,17.7,1029.0,984.0,45.0,32.0,0.0,3.0,5.0,7.0,0.0,0.0,0.0,0.0,950.0,0.0,1.0,Matches,339.0,br BRA,DF,26.0,17.7,950.0,1029.0,92.3,17131.0,5816.0,363.0,390.0,93.1,509.0,534.0,95.3,66.0,83.0,79.5,0.0,0.3,0.5,-0.3,1.0,72.0,5.0,2.0,63.0,Matches,436,br BRA,DF,26,28,1592.0,57.0,46.5,17.7,18,75.0,10,10,23.0,5,1.32,15.0,26.0,-11.0,-0.62,-0.97,20.2,25.1,-4.9,-0.28,-0.25,Matches,339.0,br BRA,DF,26.0,17.7,1182.0,115.0,552.0,587.0,47.0,11.0,1182.0,5.0,2.0,40.0,3.0,60.0,683.0,3472.0,1874.0,19.0,9.0,1.0,6.0,1.0,851.0,12.0,Matches,339.0,br BRA,DF,26.0,17.7,0.0,5.0,1.0,20.0,0.28,0.06,0.0,0.0,11.0,0.0,0.0,0.0,0.3,0.2,0.05,-0.3,-0.2,Matches,339.0,br BRA,DF,26.0,28.0,18.0,1592.0,17.7,0.0,0.0,0.0,0.0,0.0,0.0,7.0,1.0,0.3,0.2,0.3,0.6,19.0,63.0,12.0,0.0,0.0,0.0,0.0,0.0,0.01,0.02,0.03,0.01,0.03,Matches,Marlon,D C,26,135,140,Brazil,Shakhtar Donetsk,6,6,10,5,12,7,16,8,10,16,13,8,16,14,14,13,12,10,12,12,11,14,12,12,9,14,12,13,12,12,14,13,14,12,13,15,12,12,11,10,12,3,3,3,3,1,3,2,3,1,2,3,12,14,10,18,13,16,14,12,1,1,20,10,1,1,12,1,1,1,1,1,1,1,182,80,11,20,20131765,6750,6500,5150,African_Caribbean,133,17,1995/9/7,0,0,10821.0,Brianza,19189110
1254,Lautaro Martínez,Inter,1997,341.0,ar ARG,FW,24.0,28.6,25.0,14.0,3.0,15.0,7.0,7.0,23.0,30.4,16.0,31.0,1.0,30.0,13.0,38.0,16.0,1.0,Matches,341.0,ar ARG,FW,24.0,28.6,94.0,3.28,65.0,2.0,4.0,13.0,9.0,1.0,16.0,0.56,9.0,0.0,1.0,3.0,2.0,1.0,Matches,,,,,,,,,,,,,,,,,,,,,,,,,,,,,,,,,,,,,,,,,,,,,,,,,,,,,,,,341.0,ar ARG,FW,24.0,28.6,3.0,0.0,0.0,46.0,63.0,13.0,14.0,13.0,14.0,1.0,0.0,0.0,95.0,40.0,42.0,48.8,Matches,341.0,ar ARG,FW,24.0,28.6,681.0,632.0,46.0,1.0,6.0,6.0,14.0,5.0,0.0,0.0,0.0,0.0,503.0,3.0,24.0,Matches,341.0,ar ARG,FW,24.0,28.6,503.0,681.0,73.9,7435.0,1886.0,262.0,340.0,77.1,167.0,204.0,81.9,32.0,44.0,72.7,6.0,5.4,2.9,0.6,46.0,39.0,25.0,1.0,83.0,Matches,439,ar ARG,FW,24,38,2576.0,68.0,75.3,28.6,27,84.0,18,11,27.0,0,1.89,59.0,37.0,22.0,0.77,0.02,53.1,27.0,26.1,0.91,0.33,Matches,341.0,ar ARG,FW,24.0,28.6,1085.0,23.0,90.0,474.0,536.0,171.0,1083.0,72.0,29.0,40.3,31.0,43.1,619.0,2854.0,1336.0,49.0,33.0,22.0,75.0,48.0,793.0,172.0,Matches,341.0,ar ARG,FW,24.0,28.6,21.0,125.0,51.0,40.8,4.37,1.78,0.16,0.39,15.1,0.0,1.0,2.0,18.1,16.5,0.14,2.9,3.5,Matches,341.0,ar ARG,FW,24.0,38.0,27.0,2576.0,28.6,21.0,6.0,27.0,20.0,1.0,2.0,3.0,0.0,18.1,16.5,5.4,21.9,49.0,83.0,172.0,0.73,0.21,0.94,0.7,0.91,0.63,0.19,0.82,0.58,0.76,Matches,Lautaro Martínez,S,24,161,170,Argentina,FC Internazionale Milano,4,8,14,15,16,8,16,14,3,5,12,15,8,16,18,15,18,13,12,12,13,19,16,12,16,7,15,18,16,17,14,11,16,17,15,13,15,14,13,6,11,2,3,3,1,1,3,3,2,3,3,2,16,18,4,14,13,19,11,9,1,1,1,1,1,1,1,1,1,1,1,13,1,20,174,79,12,20,127462502,8050,8000,7900,Mediterranean_Hispanic,160,7,1997/8/22,38,20,213653.0,,14110660
1255,Lucas Martínez Quarta,Fiorentina,1996,342.0,ar ARG,DF,26.0,24.1,80.0,48.0,44.0,32.0,4.0,42.0,61.0,68.9,19.0,41.0,19.0,22.0,48.0,128.0,78.0,1.0,Matches,342.0,ar ARG,DF,26.0,24.1,28.0,1.16,21.0,2.0,0.0,4.0,0.0,1.0,2.0,0.08,2.0,0.0,0.0,0.0,0.0,0.0,Matches,,,,,,,,,,,,,,,,,,,,,,,,,,,,,,,,,,,,,,,,,,,,,,,,,,,,,,,,342.0,ar ARG,DF,26.0,24.1,6.0,0.0,0.0,21.0,25.0,1.0,4.0,48.0,48.0,0.0,0.0,0.0,167.0,76.0,36.0,67.9,Matches,342.0,ar ARG,DF,26.0,24.1,1524.0,1460.0,61.0,54.0,0.0,38.0,4.0,7.0,0.0,0.0,0.0,0.0,1245.0,3.0,12.0,Matches,342.0,ar ARG,DF,26.0,24.1,1245.0,1524.0,81.7,27128.0,10926.0,357.0,402.0,88.8,664.0,741.0,89.6,213.0,340.0,62.6,1.0,0.6,0.7,0.4,8.0,119.0,5.0,1.0,119.0,Matches,440,ar ARG,DF,26,27,2171.0,80.0,63.5,24.1,25,84.0,20,2,41.0,8,1.48,33.0,31.0,2.0,0.08,-0.49,33.4,28.3,5.1,0.21,-0.26,Matches,342.0,ar ARG,DF,26.0,24.1,1835.0,139.0,854.0,890.0,111.0,35.0,1835.0,16.0,12.0,75.0,3.0,18.8,1088.0,6689.0,3255.0,19.0,25.0,1.0,11.0,6.0,1131.0,6.0,Matches,342.0,ar ARG,DF,26.0,24.1,1.0,27.0,10.0,37.0,1.12,0.41,0.04,0.1,13.9,0.0,0.0,0.0,2.5,2.5,0.09,-1.5,-1.5,Matches,342.0,ar ARG,DF,26.0,27.0,25.0,2171.0,24.1,1.0,1.0,2.0,1.0,0.0,0.0,6.0,0.0,2.5,2.5,0.6,3.1,19.0,119.0,6.0,0.04,0.04,0.08,0.04,0.08,0.1,0.02,0.13,0.1,0.13,Matches,Lucas Martínez Quarta,D C,26,140,146,"Argentina,Italy",ACF Fiorentina,5,8,12,8,12,6,14,7,9,15,13,7,16,13,14,14,15,14,14,12,12,15,8,11,12,15,15,14,14,13,15,13,14,13,14,13,13,12,14,7,11,1,2,3,1,1,3,2,4,1,1,3,15,14,6,12,14,14,12,12,1,1,20,1,1,1,8,1,1,1,1,1,1,1,183,78,8,20,11706474,7050,6850,5750,Mediterranean_Hispanic,139,8,1996/5/10,11,0,24615.0,,14110832
1256,Adam Marušić,Lazio,1992,343.0,me MNE,DF,29.0,30.7,41.0,30.0,23.0,14.0,4.0,25.0,39.0,64.1,14.0,20.0,6.0,14.0,38.0,79.0,63.0,1.0,Matches,343.0,me MNE,DF,29.0,30.7,35.0,1.14,28.0,3.0,0.0,1.0,0.0,3.0,3.0,0.1,2.0,0.0,0.0,1.0,0.0,0.0,Matches,,,,,,,,,,,,,,,,,,,,,,,,,,,,,,,,,,,,,,,,,,,,,,,,,,,,,,,,343.0,me MNE,DF,29.0,30.7,8.0,1.0,0.0,22.0,14.0,1.0,17.0,38.0,30.0,0.0,0.0,0.0,175.0,29.0,25.0,53.7,Matches,343.0,me MNE,DF,29.0,30.7,1829.0,1573.0,253.0,28.0,0.0,8.0,17.0,225.0,0.0,0.0,0.0,0.0,1564.0,3.0,18.0,Matches,343.0,me MNE,DF,29.0,30.7,1564.0,1829.0,85.5,23902.0,9688.0,866.0,939.0,92.2,546.0,644.0,84.8,104.0,164.0,63.4,2.0,1.1,1.2,0.9,9.0,107.0,7.0,4.0,116.0,Matches,441,me MNE,DF,29,33,2760.0,84.0,80.7,30.7,31,86.0,23,2,40.0,1,1.91,47.0,25.0,22.0,0.72,-0.37,39.6,33.8,5.8,0.19,-0.35,Matches,343.0,me MNE,DF,29.0,30.7,2049.0,100.0,795.0,1005.0,260.0,17.0,2049.0,15.0,10.0,66.7,3.0,20.0,1065.0,4702.0,2669.0,38.0,39.0,4.0,13.0,13.0,1334.0,43.0,Matches,343.0,me MNE,DF,29.0,30.7,0.0,16.0,7.0,43.8,0.52,0.23,0.0,0.0,24.0,0.0,0.0,0.0,0.7,0.7,0.04,-0.7,-0.7,Matches,343.0,me MNE,DF,29.0,33.0,31.0,2760.0,30.7,0.0,2.0,2.0,0.0,0.0,0.0,8.0,1.0,0.7,0.7,1.1,1.8,38.0,116.0,43.0,0.0,0.07,0.07,0.0,0.07,0.02,0.03,0.06,0.02,0.06,Matches,Adam Marušić,D/WB RL,29,145,150,"Montenegro,Serbia",S.S. Lazio,4,12,10,11,12,4,8,13,4,12,12,11,12,12,15,12,16,13,12,11,12,16,13,8,15,15,16,16,14,13,14,13,15,15,15,15,14,13,12,12,16,4,2,3,1,3,3,4,2,3,2,4,15,16,7,15,13,17,10,7,1,18,11,20,15,20,1,12,1,15,4,1,11,1,185,85,14,20,16074698,7250,7400,5850,Northern_European,137,4,1992/10/17,49,3,32115.0,,62095383
1257,Nemanja Matić,Roma,1988,345.0,rs SRB,MF,33.0,20.6,47.0,27.0,24.0,19.0,4.0,19.0,33.0,57.6,14.0,27.0,7.0,20.0,25.0,72.0,21.0,1.0,Matches,345.0,rs SRB,MF,33.0,20.6,52.0,2.53,46.0,1.0,3.0,2.0,0.0,0.0,7.0,0.34,5.0,0.0,1.0,1.0,0.0,0.0,Matches,,,,,,,,,,,,,,,,,,,,,,,,,,,,,,,,,,,,,,,,,,,,,,,,,,,,,,,,345.0,rs SRB,MF,33.0,20.6,5.0,0.0,0.0,19.0,17.0,1.0,12.0,25.0,27.0,0.0,0.0,0.0,171.0,19.0,14.0,57.6,Matches,345.0,rs SRB,MF,33.0,20.6,1295.0,1229.0,59.0,56.0,2.0,16.0,12.0,2.0,1.0,0.0,0.0,0.0,1109.0,7.0,19.0,Matches,345.0,rs SRB,MF,33.0,20.6,1109.0,1295.0,85.6,19601.0,6044.0,490.0,532.0,92.1,454.0,510.0,89.0,124.0,179.0,69.3,2.0,2.6,1.9,-0.6,24.0,136.0,16.0,3.0,134.0,Matches,443,rs SRB,MF,33,35,1852.0,53.0,54.2,20.6,16,85.0,11,19,26.0,1,1.69,34.0,23.0,11.0,0.53,0.48,33.8,20.2,13.7,0.67,0.0,Matches,345.0,rs SRB,MF,33.0,20.6,1475.0,51.0,324.0,942.0,231.0,25.0,1475.0,33.0,24.0,72.7,5.0,15.2,913.0,5440.0,3060.0,50.0,44.0,7.0,22.0,19.0,1006.0,17.0,Matches,345.0,rs SRB,MF,33.0,20.6,2.0,11.0,4.0,36.4,0.53,0.19,0.18,0.5,16.3,0.0,0.0,0.0,1.0,1.0,0.09,1.0,1.0,Matches,345.0,rs SRB,MF,33.0,35.0,16.0,1852.0,20.6,2.0,2.0,4.0,2.0,0.0,0.0,5.0,0.0,1.0,1.0,2.6,3.6,50.0,134.0,17.0,0.1,0.1,0.19,0.1,0.19,0.05,0.13,0.17,0.05,0.17,Matches,Nemanja Matić,DM/M C,33,143,165,"Serbia,Slovakia",Associazione Sportiva Roma,10,11,12,8,15,10,16,14,5,13,15,12,16,15,10,15,14,16,14,13,14,13,4,14,10,16,16,13,8,10,19,16,10,10,12,17,11,11,13,7,10,4,1,3,2,3,3,1,3,2,3,1,13,13,5,16,16,18,11,11,1,1,7,1,1,1,20,1,20,1,1,1,1,1,194,85,20,11,2990937,7150,6750,6500,Northern_European,145,1,1988/8/1,48,2,86345.0,,62000307
1258,Pasquale Mazzocchi,Salernitana,1995,347.0,it ITA,DF,27.0,21.8,32.0,18.0,21.0,5.0,6.0,17.0,37.0,45.9,20.0,10.0,2.0,8.0,10.0,42.0,37.0,2.0,Matches,347.0,it ITA,DF,27.0,21.8,63.0,2.9,43.0,12.0,5.0,0.0,2.0,1.0,9.0,0.41,5.0,1.0,2.0,0.0,1.0,0.0,Matches,,,,,,,,,,,,,,,,,,,,,,,,,,,,,,,,,,,,,,,,,,,,,,,,,,,,,,,,347.0,it ITA,DF,27.0,21.8,2.0,0.0,0.0,27.0,17.0,5.0,90.0,10.0,18.0,1.0,0.0,0.0,129.0,12.0,14.0,46.2,Matches,347.0,it ITA,DF,27.0,21.8,949.0,726.0,219.0,13.0,2.0,6.0,90.0,185.0,21.0,2.0,17.0,0.0,702.0,4.0,29.0,Matches,347.0,it ITA,DF,27.0,21.8,702.0,949.0,74.0,11136.0,3985.0,379.0,417.0,90.9,245.0,339.0,72.3,56.0,122.0,45.9,3.0,2.6,2.0,0.4,30.0,37.0,21.0,12.0,60.0,Matches,445,it ITA,DF,27,27,1958.0,73.0,57.3,21.8,23,80.0,10,4,31.0,1,1.3,28.0,34.0,-6.0,-0.28,0.22,21.9,34.7,-12.8,-0.59,0.5,Matches,347.0,it ITA,DF,27.0,21.8,1196.0,59.0,348.0,469.0,398.0,36.0,1196.0,103.0,58.0,56.3,36.0,35.0,654.0,4495.0,2330.0,70.0,55.0,15.0,54.0,34.0,680.0,102.0,Matches,347.0,it ITA,DF,27.0,21.8,2.0,18.0,6.0,33.3,0.83,0.28,0.11,0.33,21.0,1.0,0.0,0.0,1.3,1.3,0.07,0.7,0.7,Matches,347.0,it ITA,DF,27.0,27.0,23.0,1958.0,21.8,2.0,3.0,5.0,2.0,0.0,0.0,2.0,0.0,1.3,1.3,2.6,3.9,70.0,60.0,102.0,0.09,0.14,0.23,0.09,0.23,0.06,0.12,0.18,0.06,0.18,Matches,Pasquale Mazzocchi,D/WB RL,26,135,140,Italy,U.S. Salernitana 1919,11,14,15,7,14,8,7,9,8,11,13,7,12,13,13,14,15,14,12,11,13,17,12,9,14,12,14,16,14,15,11,8,13,14,14,11,15,12,12,7,15,1,1,2,1,1,3,2,1,3,4,4,12,13,6,12,11,11,12,13,1,18,1,19,19,20,1,10,1,10,10,1,10,1,185,73,8,20,6045722,6750,7100,4500,Mediterranean_Hispanic,132,8,1995/7/27,0,0,3845.0,,43124221
1259,Gary Medel,Bologna,1987,349.0,cl CHI,MFDF,34.0,16.4,25.0,15.0,16.0,7.0,2.0,9.0,16.0,56.3,7.0,17.0,10.0,7.0,28.0,53.0,34.0,0.0,Matches,349.0,cl CHI,MFDF,34.0,16.4,23.0,1.4,20.0,0.0,0.0,0.0,1.0,2.0,2.0,0.12,2.0,0.0,0.0,0.0,0.0,0.0,Matches,,,,,,,,,,,,,,,,,,,,,,,,,,,,,,,,,,,,,,,,,,,,,,,,,,,,,,,,349.0,cl CHI,MFDF,34.0,16.4,5.0,0.0,0.0,19.0,16.0,0.0,4.0,28.0,15.0,0.0,0.0,0.0,141.0,15.0,15.0,50.0,Matches,349.0,cl CHI,MFDF,34.0,16.4,1102.0,1057.0,45.0,42.0,1.0,8.0,4.0,2.0,0.0,0.0,0.0,0.0,986.0,0.0,7.0,Matches,349.0,cl CHI,MFDF,34.0,16.4,986.0,1102.0,89.5,17960.0,6023.0,399.0,427.0,93.4,454.0,481.0,94.4,107.0,155.0,69.0,1.0,0.4,0.4,0.6,7.0,61.0,5.0,0.0,58.0,Matches,448,cl CHI,MFDF,34,29,1478.0,51.0,43.2,16.4,17,76.0,6,12,15.0,5,1.45,24.0,25.0,-1.0,-0.06,-0.29,18.4,20.4,-2.0,-0.12,0.01,Matches,349.0,cl CHI,MFDF,34.0,16.4,1226.0,123.0,520.0,656.0,60.0,0.0,1226.0,6.0,4.0,66.7,2.0,33.3,643.0,2305.0,983.0,1.0,3.0,0.0,6.0,4.0,803.0,5.0,Matches,349.0,cl CHI,MFDF,34.0,16.4,0.0,2.0,0.0,0.0,0.12,0.0,0.0,,26.5,0.0,0.0,0.0,0.1,0.1,0.03,-0.1,-0.1,Matches,349.0,cl CHI,MFDF,34.0,29.0,17.0,1478.0,16.4,0.0,1.0,1.0,0.0,0.0,0.0,5.0,0.0,0.1,0.1,0.4,0.5,1.0,58.0,5.0,0.0,0.06,0.06,0.0,0.06,0.0,0.02,0.03,0.0,0.03,Matches,Gary Medel,D/DM/M C,34,130,152,"Chile,Spain",Bologna FC 1909,5,12,6,5,10,5,12,8,10,15,13,4,14,12,18,16,18,13,13,11,12,20,5,13,10,15,18,18,13,12,16,9,12,10,12,14,15,16,16,12,16,2,3,1,3,2,3,2,4,3,1,2,14,19,12,14,15,19,8,7,1,6,20,10,1,1,20,1,17,1,1,1,1,1,171,76,7,20,251687,6494,7182,6127,Native_American,128,7,1987/8/3,148,7,36922.0,,75000560
1260,Soualiho Meïté,Cremonese,1994,350.0,fr FRA,MF,28.0,26.3,47.0,31.0,25.0,15.0,7.0,22.0,46.0,47.8,24.0,27.0,6.0,21.0,27.0,74.0,36.0,0.0,Matches,350.0,fr FRA,MF,28.0,26.3,45.0,1.71,38.0,1.0,3.0,0.0,1.0,2.0,3.0,0.11,3.0,0.0,0.0,0.0,0.0,0.0,Matches,,,,,,,,,,,,,,,,,,,,,,,,,,,,,,,,,,,,,,,,,,,,,,,,,,,,,,,,350.0,fr FRA,MF,28.0,26.3,5.0,0.0,0.0,27.0,47.0,0.0,9.0,27.0,31.0,0.0,0.0,0.0,174.0,28.0,17.0,62.2,Matches,350.0,fr FRA,MF,28.0,26.3,1026.0,993.0,28.0,23.0,3.0,7.0,9.0,2.0,0.0,0.0,0.0,0.0,863.0,5.0,11.0,Matches,350.0,fr FRA,MF,28.0,26.3,863.0,1026.0,84.1,14666.0,3741.0,423.0,476.0,88.9,340.0,380.0,89.5,80.0,125.0,64.0,2.0,0.7,0.5,1.3,14.0,77.0,18.0,3.0,82.0,Matches,449,fr FRA,MF,28,31,2366.0,76.0,69.2,26.3,28,82.0,19,3,21.0,1,0.84,24.0,47.0,-23.0,-0.87,-0.02,26.0,45.8,-19.8,-0.75,-0.11,Matches,350.0,fr FRA,MF,28.0,26.3,1282.0,72.0,363.0,759.0,176.0,13.0,1282.0,60.0,28.0,46.7,18.0,30.0,719.0,3526.0,1612.0,26.0,20.0,4.0,30.0,30.0,811.0,22.0,Matches,350.0,fr FRA,MF,28.0,26.3,0.0,17.0,3.0,17.6,0.65,0.11,0.0,0.0,24.4,0.0,0.0,0.0,0.5,0.5,0.03,-0.5,-0.5,Matches,350.0,fr FRA,MF,28.0,31.0,28.0,2366.0,26.3,0.0,2.0,2.0,0.0,0.0,0.0,5.0,0.0,0.5,0.5,0.7,1.2,26.0,82.0,22.0,0.0,0.08,0.08,0.0,0.08,0.02,0.03,0.04,0.02,0.04,Matches,Soualiho Meïté,DM/M C,28,130,137,"France,Ivory Coast",SL Benfica,8,10,13,7,13,8,13,12,9,12,14,9,13,14,13,14,14,14,12,13,13,14,13,8,13,13,14,11,11,11,16,14,15,11,14,16,10,10,12,8,11,3,3,1,1,2,1,2,3,1,4,2,12,15,8,10,11,15,13,13,1,1,1,1,1,1,18,1,20,1,1,14,1,1,187,82,12,20,1645874,6500,6500,5050,African_Caribbean,130,15,1994/3/17,0,0,29020.0,Cremonese,85049379
1261,Alex Meret,Napoli,1997,351.0,it ITA,GK,25.0,34.0,0.0,0.0,0.0,0.0,0.0,0.0,0.0,,0.0,0.0,0.0,0.0,0.0,0.0,6.0,1.0,Matches,351.0,it ITA,GK,25.0,34.0,1.0,0.03,1.0,0.0,0.0,0.0,0.0,0.0,0.0,0.0,0.0,0.0,0.0,0.0,0.0,0.0,Matches,18.0,it ITA,GK,25.0,34.0,24.0,1.0,0.0,1.0,0.0,25.0,0.25,1.0,0.03,56.0,145.0,38.6,733.0,121.0,14.3,26.1,198.0,20.2,26.9,335.0,11.0,3.3,39.0,1.15,17.0,Matches,18.0,it ITA,GK,25.0,34.0,34.0,3060.0,34.0,24.0,0.71,91.0,66.0,74.7,26.0,5.0,3.0,16.0,47.1,2.0,1.0,1.0,0.0,50.0,Matches,351.0,it ITA,GK,25.0,34.0,0.0,0.0,0.0,0.0,0.0,0.0,0.0,0.0,0.0,0.0,0.0,0.0,66.0,4.0,0.0,100.0,Matches,351.0,it ITA,GK,25.0,34.0,931.0,688.0,243.0,45.0,0.0,2.0,0.0,0.0,0.0,0.0,0.0,0.0,818.0,0.0,0.0,Matches,351.0,it ITA,GK,25.0,34.0,818.0,931.0,87.9,18824.0,11619.0,189.0,189.0,100.0,438.0,441.0,99.3,188.0,298.0,63.1,0.0,0.0,0.0,0.0,0.0,1.0,0.0,0.0,0.0,Matches,451,it ITA,GK,25,34,3060.0,90.0,89.5,34.0,34,90.0,34,0,,4,2.44,72.0,24.0,48.0,1.41,1.16,58.9,27.2,31.7,0.93,0.61,Matches,351.0,it ITA,GK,25.0,34.0,974.0,828.0,972.0,2.0,0.0,0.0,974.0,0.0,0.0,,0.0,,544.0,2256.0,1190.0,0.0,0.0,0.0,0.0,0.0,476.0,0.0,Matches,351.0,it ITA,GK,25.0,34.0,0.0,0.0,0.0,,0.0,0.0,,,,0.0,0.0,0.0,0.0,0.0,,0.0,0.0,Matches,351.0,it ITA,GK,25.0,34.0,34.0,3060.0,34.0,0.0,0.0,0.0,0.0,0.0,0.0,0.0,0.0,0.0,0.0,0.0,0.0,0.0,0.0,0.0,0.0,0.0,0.0,0.0,0.0,0.0,0.0,0.0,0.0,0.0,Matches,Alex Meret,GK,25,147,156,Italy,Parthenope,1,2,2,1,7,1,6,2,3,2,8,3,3,8,8,14,12,12,12,5,14,11,3,9,3,16,13,13,10,18,14,16,13,12,13,13,12,3,12,11,1,14,14,13,5,16,10,15,17,12,11,10,7,13,3,14,11,15,15,12,20,1,1,1,1,1,1,1,1,1,1,1,1,1,190,80,20,7,18050738,7343,7343,5843,Mediterranean_Hispanic,143,2,1997/3/22,2,0,53462.0,,43140326
1262,Junior Messias,Milan,1991,353.0,br BRA,FWDF,31.0,16.6,24.0,18.0,9.0,9.0,6.0,5.0,19.0,26.3,14.0,20.0,4.0,16.0,7.0,31.0,28.0,0.0,Matches,353.0,br BRA,FWDF,31.0,16.6,46.0,2.76,29.0,1.0,5.0,5.0,5.0,1.0,7.0,0.42,5.0,0.0,1.0,0.0,1.0,0.0,Matches,,,,,,,,,,,,,,,,,,,,,,,,,,,,,,,,,,,,,,,,,,,,,,,,,,,,,,,,353.0,br BRA,FWDF,31.0,16.6,3.0,0.0,0.0,24.0,24.0,1.0,25.0,7.0,18.0,0.0,0.0,0.0,69.0,25.0,41.0,37.9,Matches,353.0,br BRA,FWDF,31.0,16.6,563.0,532.0,30.0,4.0,4.0,2.0,25.0,24.0,2.0,0.0,1.0,0.0,430.0,1.0,12.0,Matches,353.0,br BRA,FWDF,31.0,16.6,430.0,563.0,76.4,6793.0,1803.0,232.0,277.0,83.8,156.0,191.0,81.7,30.0,57.0,52.6,2.0,0.8,1.6,1.2,13.0,33.0,8.0,2.0,54.0,Matches,454,br BRA,FWDF,31,25,1498.0,60.0,43.8,16.6,19,70.0,3,6,29.0,4,1.8,32.0,19.0,13.0,0.78,0.41,23.4,16.1,7.4,0.44,-0.04,Matches,353.0,br BRA,FWDF,31.0,16.6,765.0,32.0,122.0,336.0,323.0,54.0,765.0,68.0,34.0,50.0,21.0,30.9,466.0,3060.0,1659.0,45.0,42.0,18.0,32.0,14.0,530.0,137.0,Matches,353.0,br BRA,FWDF,31.0,16.6,5.0,32.0,11.0,34.4,1.92,0.66,0.16,0.45,18.7,1.0,0.0,0.0,2.3,2.3,0.07,2.7,2.7,Matches,353.0,br BRA,FWDF,31.0,25.0,19.0,1498.0,16.6,5.0,2.0,7.0,5.0,0.0,0.0,3.0,0.0,2.3,2.3,0.8,3.0,45.0,54.0,137.0,0.3,0.12,0.42,0.3,0.42,0.14,0.05,0.18,0.14,0.18,Matches,Junior Messias,AM/S RC,31,142,145,Brazil,AC Milan,13,13,15,12,14,11,13,11,6,7,13,11,8,14,12,13,12,12,13,13,13,18,15,10,13,6,14,12,15,14,13,11,15,14,14,12,12,8,11,9,14,2,2,3,3,3,1,3,2,2,2,1,18,18,6,15,12,19,15,14,1,1,1,1,1,1,1,10,1,13,12,17,20,18,179,70,20,11,8590006,7100,5598,5027,Mixed_Race,139,12,1991/5/13,0,0,35577.0,,43315178
1263,Nikola Milenković,Fiorentina,1997,355.0,rs SRB,DF,24.0,23.7,40.0,25.0,20.0,17.0,3.0,18.0,27.0,66.7,9.0,27.0,14.0,13.0,22.0,62.0,72.0,0.0,Matches,355.0,rs SRB,DF,24.0,23.7,24.0,1.01,21.0,0.0,0.0,3.0,0.0,0.0,2.0,0.08,2.0,0.0,0.0,0.0,0.0,0.0,Matches,,,,,,,,,,,,,,,,,,,,,,,,,,,,,,,,,,,,,,,,,,,,,,,,,,,,,,,,355.0,rs SRB,DF,24.0,23.7,4.0,0.0,0.0,39.0,21.0,0.0,0.0,22.0,25.0,0.0,0.0,1.0,127.0,73.0,30.0,70.9,Matches,355.0,rs SRB,DF,24.0,23.7,1292.0,1245.0,43.0,38.0,0.0,10.0,0.0,5.0,0.0,0.0,0.0,0.0,1107.0,4.0,9.0,Matches,355.0,rs SRB,DF,24.0,23.7,1107.0,1292.0,85.7,21399.0,6777.0,397.0,443.0,89.6,570.0,634.0,89.9,129.0,182.0,70.9,1.0,0.5,0.9,0.5,6.0,62.0,3.0,0.0,78.0,Matches,457,rs SRB,DF,24,27,2137.0,79.0,62.5,23.7,23,86.0,21,4,39.0,9,1.48,34.0,27.0,7.0,0.29,0.08,35.4,27.0,8.5,0.36,0.13,Matches,355.0,rs SRB,DF,24.0,23.7,1520.0,143.0,743.0,710.0,74.0,35.0,1520.0,0.0,0.0,,0.0,,816.0,3547.0,1782.0,9.0,10.0,0.0,7.0,0.0,902.0,3.0,Matches,355.0,rs SRB,DF,24.0,23.7,2.0,19.0,5.0,26.3,0.8,0.21,0.11,0.4,9.4,0.0,0.0,0.0,1.9,1.9,0.1,0.1,0.1,Matches,355.0,rs SRB,DF,24.0,27.0,23.0,2137.0,23.7,2.0,1.0,3.0,2.0,0.0,0.0,4.0,0.0,1.9,1.9,0.5,2.4,9.0,78.0,3.0,0.08,0.04,0.13,0.08,0.13,0.08,0.02,0.1,0.08,0.1,Matches,Nikola Milenković,D RC,24,148,162,Serbia,ACF Fiorentina,4,9,9,10,11,4,16,8,9,15,13,6,15,11,17,14,16,13,14,11,13,15,7,11,8,15,15,15,13,12,14,17,16,14,15,16,12,14,12,8,11,3,2,4,1,3,1,3,2,3,2,3,14,14,12,13,13,15,14,11,1,1,20,16,1,1,1,1,1,1,1,1,1,1,195,92,9,20,23000363,7500,7150,6000,Mediterranean_Hispanic,148,3,1997/10/12,37,3,106922.0,,62191195
1264,Arkadiusz Milik,Juventus,1994,356.0,pl POL,FW,28.0,17.6,12.0,8.0,2.0,8.0,2.0,2.0,8.0,25.0,6.0,10.0,1.0,9.0,1.0,13.0,14.0,0.0,Matches,356.0,pl POL,FW,28.0,17.6,36.0,2.05,20.0,1.0,1.0,7.0,3.0,4.0,3.0,0.17,2.0,0.0,0.0,0.0,0.0,1.0,Matches,,,,,,,,,,,,,,,,,,,,,,,,,,,,,,,,,,,,,,,,,,,,,,,,,,,,,,,,356.0,pl POL,FW,28.0,17.6,3.0,1.0,1.0,27.0,29.0,8.0,6.0,1.0,8.0,1.0,1.0,0.0,40.0,36.0,56.0,39.1,Matches,356.0,pl POL,FW,28.0,17.6,450.0,420.0,26.0,4.0,2.0,3.0,6.0,1.0,0.0,0.0,0.0,0.0,346.0,4.0,9.0,Matches,356.0,pl POL,FW,28.0,17.6,346.0,450.0,76.9,4924.0,810.0,207.0,253.0,81.8,110.0,132.0,83.3,14.0,23.0,60.9,1.0,2.1,0.7,-1.1,17.0,17.0,9.0,0.0,34.0,Matches,458,pl POL,FW,28,27,1586.0,59.0,46.4,17.6,17,77.0,6,10,28.0,1,1.74,28.0,13.0,15.0,0.85,0.46,28.0,18.2,9.8,0.56,0.37,Matches,356.0,pl POL,FW,28.0,17.6,623.0,16.0,45.0,322.0,261.0,75.0,622.0,22.0,11.0,50.0,9.0,40.9,343.0,1317.0,473.0,10.0,18.0,2.0,50.0,16.0,483.0,85.0,Matches,356.0,pl POL,FW,28.0,17.6,7.0,43.0,22.0,51.2,2.44,1.25,0.16,0.32,14.2,2.0,0.0,1.0,6.5,5.7,0.13,0.5,1.3,Matches,356.0,pl POL,FW,28.0,27.0,17.0,1586.0,17.6,7.0,1.0,8.0,7.0,0.0,1.0,3.0,1.0,6.5,5.7,2.1,7.7,10.0,34.0,85.0,0.4,0.06,0.45,0.4,0.45,0.37,0.12,0.49,0.32,0.44,Matches,Arkadiusz Milik,S,28,151,160,Poland,Olympique de Marseille,10,10,12,16,15,15,15,14,4,4,13,15,6,16,10,17,14,14,14,11,15,13,14,11,15,4,15,16,14,14,16,14,12,13,13,15,13,10,13,14,11,1,1,2,1,3,2,3,3,3,3,3,11,16,9,9,13,10,12,15,1,1,1,1,1,1,1,1,1,1,1,12,1,20,186,80,20,10,53670146,7550,7850,6800,Northern_European,152,5,1994/2/28,62,16,75941.0,Juventus,96026541
1265,Sergej Milinković-Savić,Lazio,1995,357.0,rs SRB,MF,27.0,33.6,58.0,35.0,22.0,23.0,13.0,24.0,67.0,35.8,43.0,50.0,12.0,38.0,28.0,86.0,49.0,0.0,Matches,357.0,rs SRB,MF,27.0,33.6,79.0,2.35,67.0,1.0,4.0,4.0,2.0,1.0,13.0,0.39,12.0,0.0,0.0,1.0,0.0,0.0,Matches,,,,,,,,,,,,,,,,,,,,,,,,,,,,,,,,,,,,,,,,,,,,,,,,,,,,,,,,357.0,rs SRB,MF,27.0,33.6,10.0,0.0,0.0,45.0,72.0,2.0,29.0,28.0,35.0,0.0,0.0,0.0,168.0,96.0,71.0,57.5,Matches,357.0,rs SRB,MF,27.0,33.6,1930.0,1882.0,41.0,25.0,15.0,22.0,29.0,16.0,0.0,0.0,0.0,0.0,1465.0,7.0,41.0,Matches,357.0,rs SRB,MF,27.0,33.6,1465.0,1930.0,75.9,22950.0,6133.0,813.0,978.0,83.1,479.0,600.0,79.8,117.0,216.0,54.2,8.0,7.1,4.9,0.9,42.0,138.0,43.0,3.0,166.0,Matches,459,rs SRB,MF,27,36,3022.0,84.0,88.4,33.6,34,87.0,25,2,37.0,1,1.89,54.0,27.0,27.0,0.8,0.13,43.9,38.2,5.6,0.17,-0.78,Matches,357.0,rs SRB,MF,27.0,33.6,2411.0,73.0,442.0,1341.0,652.0,87.0,2411.0,80.0,39.0,48.8,31.0,38.8,1406.0,5856.0,2161.0,47.0,32.0,11.0,106.0,66.0,1926.0,129.0,Matches,357.0,rs SRB,MF,27.0,33.6,9.0,64.0,19.0,29.7,1.91,0.57,0.14,0.47,17.3,8.0,0.0,0.0,6.8,6.8,0.11,2.2,2.2,Matches,357.0,rs SRB,MF,27.0,36.0,34.0,3022.0,33.6,9.0,8.0,17.0,9.0,0.0,0.0,10.0,0.0,6.8,6.8,7.1,13.9,47.0,166.0,129.0,0.27,0.24,0.51,0.27,0.51,0.2,0.21,0.41,0.2,0.41,Matches,Sergej Milinković-Savić,M/AM C,27,162,167,"Serbia,Spain",S.S. Lazio,4,6,14,16,16,15,17,15,3,7,16,13,13,16,14,15,17,12,11,15,13,17,18,14,16,11,16,15,12,12,17,17,20,12,18,17,17,14,16,5,12,2,2,1,3,2,2,1,2,2,1,3,15,15,4,19,14,16,12,12,1,1,1,1,1,1,11,7,20,6,8,17,7,11,191,82,17,20,63440998,8100,7168,8047,Northern_European,162,4,1995/2/27,34,6,114037.0,,62127037
1266,Vanja Milinković-Savić,Torino,1997,358.0,rs SRB,GK,25.0,38.0,2.0,1.0,2.0,0.0,0.0,2.0,2.0,100.0,0.0,0.0,0.0,0.0,1.0,3.0,19.0,1.0,Matches,358.0,rs SRB,GK,25.0,38.0,6.0,0.16,4.0,2.0,0.0,0.0,0.0,0.0,1.0,0.03,1.0,0.0,0.0,0.0,0.0,0.0,Matches,19.0,rs SRB,GK,25.0,38.0,41.0,5.0,0.0,6.0,0.0,35.8,0.23,-5.2,-0.14,285.0,939.0,30.4,1506.0,185.0,45.0,39.7,286.0,91.3,70.0,469.0,36.0,7.7,70.0,1.84,16.2,Matches,19.0,rs SRB,GK,25.0,38.0,38.0,3420.0,38.0,41.0,1.08,136.0,95.0,73.5,14.0,11.0,13.0,11.0,28.9,6.0,5.0,0.0,1.0,0.0,Matches,358.0,rs SRB,GK,25.0,38.0,4.0,0.0,0.0,0.0,4.0,0.0,0.0,1.0,1.0,0.0,0.0,0.0,64.0,12.0,2.0,85.7,Matches,358.0,rs SRB,GK,25.0,38.0,1806.0,1412.0,380.0,93.0,0.0,8.0,0.0,1.0,0.0,0.0,0.0,0.0,1113.0,14.0,1.0,Matches,358.0,rs SRB,GK,25.0,38.0,1113.0,1806.0,61.6,35389.0,25444.0,158.0,160.0,98.8,551.0,558.0,98.7,401.0,1070.0,37.5,0.0,0.5,0.2,-0.5,1.0,94.0,2.0,0.0,0.0,Matches,460,rs SRB,GK,25,38,3420.0,90.0,100.0,38.0,38,90.0,38,0,,0,1.39,42.0,41.0,1.0,0.03,,41.8,40.0,1.8,0.05,,Matches,358.0,rs SRB,GK,25.0,38.0,1882.0,1342.0,1862.0,21.0,1.0,1.0,1882.0,0.0,0.0,,0.0,,1187.0,7724.0,4634.0,0.0,0.0,0.0,2.0,1.0,1000.0,0.0,Matches,358.0,rs SRB,GK,25.0,38.0,0.0,0.0,0.0,,0.0,0.0,,,,0.0,0.0,0.0,0.0,0.0,,0.0,0.0,Matches,358.0,rs SRB,GK,25.0,38.0,38.0,3420.0,38.0,0.0,0.0,0.0,0.0,0.0,0.0,4.0,0.0,0.0,0.0,0.5,0.5,0.0,0.0,0.0,0.0,0.0,0.0,0.0,0.0,0.0,0.01,0.01,0.0,0.01,Matches,Vanja Milinković-Savić,GK,25,130,139,"Serbia,Spain",Torino,14,1,1,2,10,16,9,14,2,2,9,2,1,8,11,11,13,10,13,9,13,16,8,14,7,12,11,11,12,13,11,17,11,10,13,12,12,8,12,10,10,15,14,14,15,13,16,13,12,12,11,12,10,13,11,11,12,12,13,13,20,1,1,1,1,1,1,1,1,1,1,1,1,1,202,92,9,20,3143521,6500,6700,4000,Northern_European,130,1,1997/2/20,4,0,14230.0,,62142830
1267,Fabio Miretti,Juventus,2003,362.0,it ITA,MFFW,18.0,13.7,24.0,11.0,15.0,6.0,3.0,12.0,29.0,41.4,17.0,20.0,1.0,19.0,4.0,28.0,11.0,0.0,Matches,362.0,it ITA,MFFW,18.0,13.7,48.0,3.51,31.0,5.0,5.0,5.0,2.0,0.0,7.0,0.51,6.0,0.0,0.0,0.0,1.0,0.0,Matches,,,,,,,,,,,,,,,,,,,,,,,,,,,,,,,,,,,,,,,,,,,,,,,,,,,,,,,,362.0,it ITA,MFFW,18.0,13.7,2.0,0.0,0.0,24.0,27.0,4.0,28.0,4.0,11.0,1.0,0.0,0.0,74.0,10.0,20.0,33.3,Matches,362.0,it ITA,MFFW,18.0,13.7,511.0,482.0,27.0,6.0,2.0,5.0,28.0,5.0,13.0,5.0,7.0,0.0,364.0,2.0,19.0,Matches,362.0,it ITA,MFFW,18.0,13.7,364.0,511.0,71.2,5842.0,1673.0,192.0,236.0,81.4,135.0,170.0,79.4,25.0,60.0,41.7,2.0,1.3,1.3,0.7,16.0,39.0,17.0,4.0,60.0,Matches,464,it ITA,MFFW,18,27,1234.0,46.0,36.1,13.7,14,67.0,1,13,23.0,7,1.78,14.0,9.0,5.0,0.36,-0.38,18.6,15.2,3.4,0.25,-0.17,Matches,362.0,it ITA,MFFW,18.0,13.7,694.0,15.0,109.0,346.0,249.0,45.0,694.0,43.0,19.0,44.2,18.0,41.9,408.0,2017.0,1075.0,33.0,21.0,6.0,41.0,26.0,476.0,85.0,Matches,362.0,it ITA,MFFW,18.0,13.7,0.0,20.0,5.0,25.0,1.46,0.36,0.0,0.0,17.0,0.0,0.0,0.0,2.4,2.4,0.12,-2.4,-2.4,Matches,362.0,it ITA,MFFW,18.0,27.0,14.0,1234.0,13.7,0.0,2.0,2.0,0.0,0.0,0.0,2.0,0.0,2.4,2.4,1.3,3.8,33.0,60.0,85.0,0.0,0.15,0.15,0.0,0.15,0.18,0.1,0.27,0.18,0.27,Matches,Fabio Miretti,M C,18,132,-9,Italy,Juventus,13,11,14,9,14,12,7,10,8,10,13,12,11,14,13,15,13,11,12,13,13,16,11,14,13,12,14,14,12,14,14,8,11,12,14,11,13,11,13,3,11,3,2,3,1,3,3,3,2,1,3,1,13,16,3,15,17,18,10,9,1,1,1,1,1,1,14,11,20,8,1,13,1,1,180,72,14,20,73200001,6500,6500,2750,Mediterranean_Hispanic,132,2,2003/8/3,0,0,10769.0,,43500510
1268,Henrikh Mkhitaryan,Inter,1989,364.0,am ARM,MF,33.0,22.1,41.0,26.0,13.0,22.0,6.0,14.0,41.0,34.1,27.0,27.0,4.0,23.0,21.0,62.0,18.0,0.0,Matches,364.0,am ARM,MF,33.0,22.1,80.0,3.63,61.0,0.0,2.0,5.0,8.0,4.0,8.0,0.36,7.0,0.0,0.0,0.0,0.0,1.0,Matches,,,,,,,,,,,,,,,,,,,,,,,,,,,,,,,,,,,,,,,,,,,,,,,,,,,,,,,,364.0,am ARM,MF,33.0,22.1,4.0,0.0,0.0,28.0,28.0,0.0,19.0,21.0,26.0,0.0,0.0,0.0,166.0,9.0,12.0,42.9,Matches,364.0,am ARM,MF,33.0,22.1,1058.0,1037.0,18.0,7.0,4.0,6.0,19.0,9.0,2.0,1.0,1.0,0.0,924.0,3.0,13.0,Matches,364.0,am ARM,MF,33.0,22.1,924.0,1058.0,87.3,15228.0,3797.0,454.0,497.0,91.3,361.0,408.0,88.5,79.0,96.0,82.3,2.0,2.1,2.4,-0.1,19.0,93.0,32.0,8.0,133.0,Matches,466,am ARM,MF,33,31,1986.0,64.0,58.1,22.1,24,75.0,6,7,26.0,1,1.84,44.0,18.0,26.0,1.18,0.99,41.9,18.0,23.9,1.09,0.61,Matches,364.0,am ARM,MF,33.0,22.1,1288.0,31.0,195.0,710.0,402.0,38.0,1288.0,35.0,14.0,40.0,16.0,45.7,754.0,4097.0,2024.0,48.0,47.0,10.0,44.0,20.0,899.0,74.0,Matches,364.0,am ARM,MF,33.0,22.1,3.0,35.0,6.0,17.1,1.59,0.27,0.09,0.5,19.9,0.0,0.0,0.0,2.8,2.8,0.08,0.2,0.2,Matches,364.0,am ARM,MF,33.0,31.0,24.0,1986.0,22.1,3.0,2.0,5.0,3.0,0.0,0.0,4.0,0.0,2.8,2.8,2.1,4.9,48.0,133.0,74.0,0.14,0.09,0.23,0.14,0.23,0.13,0.1,0.22,0.13,0.22,Matches,Henrikh Mkhitaryan,M/AM LC,33,149,165,Armenia,FC Internazionale Milano,11,12,14,14,15,11,10,14,4,7,15,13,10,16,14,17,10,12,11,16,15,15,14,5,16,9,15,12,13,15,13,8,14,14,12,10,11,6,12,11,17,3,3,3,3,1,2,2,2,1,2,1,17,16,10,6,11,19,13,14,1,1,1,1,1,1,1,13,18,12,16,20,12,10,177,75,15,20,5875523,7450,8000,6900,North_African__Middle_Eastern,149,6,1989/1/21,94,32,93653.0,,59006269
1269,Lorenzo Montipò,Hellas Verona,1996,367.0,it ITA,GK,26.0,37.0,1.0,0.0,1.0,0.0,0.0,0.0,3.0,0.0,3.0,1.0,0.0,1.0,0.0,1.0,26.0,3.0,Matches,367.0,it ITA,GK,26.0,37.0,12.0,0.32,5.0,7.0,0.0,0.0,0.0,0.0,0.0,0.0,0.0,0.0,0.0,0.0,0.0,0.0,Matches,21.0,it ITA,GK,26.0,37.0,59.0,1.0,1.0,4.0,3.0,49.6,0.27,-6.4,-0.17,360.0,775.0,46.5,905.0,124.0,62.9,44.3,284.0,72.5,52.1,496.0,26.0,5.2,55.0,1.49,15.3,Matches,21.0,it ITA,GK,26.0,37.0,37.0,3330.0,37.0,59.0,1.59,181.0,124.0,68.0,7.0,9.0,21.0,5.0,13.5,2.0,1.0,1.0,0.0,50.0,Matches,367.0,it ITA,GK,26.0,37.0,1.0,0.0,0.0,0.0,5.0,0.0,0.0,0.0,0.0,0.0,0.0,0.0,55.0,4.0,2.0,66.7,Matches,367.0,it ITA,GK,26.0,37.0,1192.0,786.0,403.0,119.0,0.0,2.0,0.0,0.0,0.0,0.0,0.0,0.0,745.0,3.0,0.0,Matches,367.0,it ITA,GK,26.0,37.0,745.0,1192.0,62.5,29263.0,24967.0,75.0,76.0,98.7,246.0,251.0,98.0,421.0,859.0,49.0,0.0,0.0,0.2,0.0,0.0,65.0,1.0,0.0,0.0,Matches,469,it ITA,GK,26,37,3330.0,90.0,97.4,37.0,37,90.0,37,0,,0,0.87,31.0,59.0,-28.0,-0.76,-0.76,34.7,48.8,-14.1,-0.38,-0.38,Matches,367.0,it ITA,GK,26.0,37.0,1309.0,1050.0,1297.0,14.0,0.0,0.0,1309.0,0.0,0.0,,0.0,,622.0,4073.0,2169.0,0.0,1.0,0.0,6.0,0.0,461.0,0.0,Matches,367.0,it ITA,GK,26.0,37.0,0.0,0.0,0.0,,0.0,0.0,,,,0.0,0.0,0.0,0.0,0.0,,0.0,0.0,Matches,367.0,it ITA,GK,26.0,37.0,37.0,3330.0,37.0,0.0,0.0,0.0,0.0,0.0,0.0,1.0,0.0,0.0,0.0,0.0,0.0,0.0,0.0,0.0,0.0,0.0,0.0,0.0,0.0,0.0,0.0,0.0,0.0,0.0,Matches,Lorenzo Montipò,GK,26,133,139,Italy,Hellas Verona,3,2,3,1,10,1,7,1,1,3,7,3,3,8,10,12,13,12,11,9,11,13,8,10,9,12,11,10,12,14,11,15,13,11,14,11,12,8,12,9,1,15,14,14,8,13,16,14,17,11,12,12,11,13,2,14,11,13,14,11,20,1,1,1,1,1,1,1,1,1,1,1,1,1,191,82,8,20,4163418,6650,6650,4450,Northern_European,131,4,1996/2/20,0,0,9615.0,,43124226
1270,Nikola Moro,Bologna,1998,368.0,hr CRO,MF,24.0,13.6,32.0,21.0,11.0,15.0,6.0,14.0,36.0,38.9,22.0,15.0,2.0,13.0,8.0,40.0,18.0,0.0,Matches,368.0,hr CRO,MF,24.0,13.6,49.0,3.59,43.0,0.0,4.0,1.0,1.0,0.0,6.0,0.44,5.0,0.0,1.0,0.0,0.0,0.0,Matches,,,,,,,,,,,,,,,,,,,,,,,,,,,,,,,,,,,,,,,,,,,,,,,,,,,,,,,,368.0,hr CRO,MF,24.0,13.6,1.0,0.0,0.0,15.0,11.0,1.0,18.0,8.0,21.0,0.0,0.0,0.0,97.0,20.0,11.0,64.5,Matches,368.0,hr CRO,MF,24.0,13.6,806.0,783.0,19.0,12.0,4.0,10.0,18.0,7.0,0.0,0.0,0.0,0.0,643.0,4.0,18.0,Matches,368.0,hr CRO,MF,24.0,13.6,643.0,806.0,79.8,11678.0,3780.0,284.0,341.0,83.3,259.0,302.0,85.8,91.0,126.0,72.2,5.0,2.2,1.3,2.8,18.0,85.0,13.0,3.0,102.0,Matches,470,hr CRO,MF,24,26,1226.0,47.0,35.8,13.6,12,76.0,5,14,23.0,9,1.62,23.0,16.0,7.0,0.51,0.64,17.1,19.5,-2.5,-0.18,-0.08,Matches,368.0,hr CRO,MF,24.0,13.6,931.0,29.0,210.0,549.0,181.0,18.0,931.0,26.0,18.0,69.2,7.0,26.9,553.0,2627.0,1180.0,24.0,22.0,1.0,13.0,9.0,654.0,35.0,Matches,368.0,hr CRO,MF,24.0,13.6,1.0,21.0,3.0,14.3,1.54,0.22,0.05,0.33,23.9,0.0,0.0,0.0,0.8,0.8,0.04,0.2,0.2,Matches,368.0,hr CRO,MF,24.0,26.0,12.0,1226.0,13.6,1.0,5.0,6.0,1.0,0.0,0.0,1.0,0.0,0.8,0.8,2.2,3.0,24.0,102.0,35.0,0.07,0.37,0.44,0.07,0.44,0.06,0.16,0.22,0.06,0.22,Matches,Nikola Moro,DM/M C,24,126,139,Croatia,Dinamo Moscow,8,12,11,10,12,12,12,12,4,10,14,10,12,13,13,15,12,13,13,13,11,13,9,10,11,12,16,14,12,11,12,12,14,11,14,13,14,11,11,9,12,2,4,1,1,4,2,2,4,1,1,3,12,8,8,9,11,12,10,10,1,1,1,1,1,1,20,1,20,1,1,13,1,1,184,78,15,20,6578815,6300,6550,5000,Northern_European,125,6,1998/3/12,1,0,36410.0,Bologna FC 1909,24046418
1271,Dany Mota,Monza,1998,369.0,pt POR,FWMF,24.0,21.2,8.0,7.0,1.0,3.0,4.0,2.0,10.0,20.0,8.0,5.0,1.0,4.0,6.0,14.0,25.0,0.0,Matches,369.0,pt POR,FWMF,24.0,21.2,57.0,2.68,42.0,0.0,5.0,6.0,4.0,0.0,8.0,0.38,2.0,0.0,3.0,1.0,2.0,0.0,Matches,,,,,,,,,,,,,,,,,,,,,,,,,,,,,,,,,,,,,,,,,,,,,,,,,,,,,,,,369.0,pt POR,FWMF,24.0,21.2,2.0,0.0,0.0,20.0,33.0,13.0,45.0,6.0,7.0,2.0,0.0,0.0,60.0,33.0,60.0,35.5,Matches,369.0,pt POR,FWMF,24.0,21.2,610.0,575.0,33.0,2.0,1.0,3.0,45.0,5.0,0.0,0.0,0.0,0.0,425.0,2.0,34.0,Matches,369.0,pt POR,FWMF,24.0,21.2,425.0,610.0,69.7,6145.0,958.0,240.0,299.0,80.3,138.0,194.0,71.1,21.0,35.0,60.0,1.0,2.1,1.8,-1.1,27.0,21.0,14.0,5.0,34.0,Matches,472,pt POR,FWMF,24,29,1912.0,66.0,55.9,21.2,21,79.0,6,8,33.0,2,1.52,28.0,22.0,6.0,0.28,0.88,23.0,28.4,-5.4,-0.25,-0.25,Matches,369.0,pt POR,FWMF,24.0,21.2,835.0,25.0,76.0,405.0,364.0,94.0,835.0,73.0,35.0,47.9,25.0,34.2,519.0,3543.0,1410.0,66.0,35.0,31.0,76.0,36.0,639.0,166.0,Matches,369.0,pt POR,FWMF,24.0,21.2,5.0,28.0,11.0,39.3,1.32,0.52,0.18,0.45,12.1,0.0,0.0,0.0,5.1,5.1,0.18,-0.1,-0.1,Matches,369.0,pt POR,FWMF,24.0,29.0,21.0,1912.0,21.2,5.0,1.0,6.0,5.0,0.0,0.0,2.0,0.0,5.1,5.1,2.1,7.3,66.0,34.0,166.0,0.24,0.05,0.28,0.24,0.28,0.24,0.1,0.34,0.24,0.34,Matches,Dany Mota,AM/S RL,24,127,136,"Portugal,Luxembourg",Brianza,12,12,13,15,15,14,14,14,5,4,14,14,10,13,12,14,12,11,13,12,12,14,12,13,15,6,13,13,13,13,13,10,14,12,14,13,16,5,12,8,13,1,2,1,3,3,3,3,4,1,3,2,15,14,5,12,13,16,14,16,1,1,1,1,1,1,1,1,1,1,18,1,19,20,180,76,5,20,3116002,6350,5900,5450,Mediterranean_Hispanic,127,3,1998/5/2,0,0,8462.0,,43257364
1272,Luis Muriel,Atalanta,1991,372.0,co COL,FWMF,31.0,11.9,9.0,6.0,2.0,3.0,4.0,5.0,16.0,31.3,11.0,9.0,0.0,9.0,2.0,11.0,2.0,0.0,Matches,372.0,co COL,FWMF,31.0,11.9,67.0,5.61,43.0,15.0,4.0,3.0,2.0,0.0,6.0,0.5,5.0,0.0,0.0,0.0,1.0,0.0,Matches,,,,,,,,,,,,,,,,,,,,,,,,,,,,,,,,,,,,,,,,,,,,,,,,,,,,,,,,372.0,co COL,FWMF,31.0,11.9,2.0,2.0,1.0,18.0,15.0,3.0,82.0,2.0,6.0,1.0,0.0,0.0,39.0,11.0,27.0,28.9,Matches,372.0,co COL,FWMF,31.0,11.9,539.0,454.0,83.0,9.0,8.0,14.0,82.0,12.0,47.0,25.0,17.0,0.0,354.0,2.0,17.0,Matches,372.0,co COL,FWMF,31.0,11.9,354.0,539.0,65.7,6248.0,1973.0,171.0,224.0,76.3,117.0,163.0,71.8,49.0,105.0,46.7,3.0,3.5,4.1,-0.5,37.0,29.0,34.0,6.0,71.0,Matches,478,co COL,FWMF,31,29,1073.0,37.0,31.4,11.9,10,65.0,0,19,22.0,2,1.59,20.0,15.0,5.0,0.42,-0.08,17.9,11.9,6.0,0.5,0.1,Matches,372.0,co COL,FWMF,31.0,11.9,712.0,3.0,37.0,251.0,428.0,70.0,711.0,70.0,34.0,48.6,33.0,47.1,416.0,2792.0,1367.0,53.0,38.0,22.0,49.0,27.0,545.0,124.0,Matches,372.0,co COL,FWMF,31.0,11.9,3.0,33.0,8.0,24.2,2.77,0.67,0.06,0.25,20.6,4.0,1.0,1.0,2.8,2.0,0.06,0.2,0.0,Matches,372.0,co COL,FWMF,31.0,29.0,10.0,1073.0,11.9,3.0,3.0,6.0,2.0,1.0,1.0,2.0,2.0,2.8,2.0,3.5,5.6,53.0,71.0,124.0,0.25,0.25,0.5,0.17,0.42,0.24,0.3,0.53,0.17,0.47,Matches,Luis Muriel,S,31,148,158,Colombia,Atalanta,6,11,17,17,18,15,9,16,3,4,13,17,3,18,11,16,10,13,10,14,12,15,18,7,14,2,11,11,16,13,14,10,13,16,10,14,12,9,11,10,12,1,1,2,3,1,3,4,3,1,1,1,12,16,5,12,12,16,13,12,1,1,1,1,1,1,1,1,1,1,10,14,8,20,179,79,12,20,11910202,7400,7300,6500,Mixed_Race,146,12,1991/4/16,44,8,44423.0,,76015142
1273,Jeison Murillo,Sampdoria,1992,373.0,co COL,DF,30.0,11.7,22.0,11.0,16.0,6.0,0.0,17.0,26.0,65.4,9.0,22.0,14.0,8.0,8.0,30.0,39.0,0.0,Matches,373.0,co COL,DF,30.0,11.7,9.0,0.77,6.0,1.0,0.0,1.0,1.0,0.0,0.0,0.0,0.0,0.0,0.0,0.0,0.0,0.0,Matches,,,,,,,,,,,,,,,,,,,,,,,,,,,,,,,,,,,,,,,,,,,,,,,,,,,,,,,,373.0,co COL,DF,30.0,11.7,6.0,1.0,1.0,18.0,19.0,0.0,1.0,8.0,11.0,0.0,0.0,1.0,65.0,28.0,20.0,58.3,Matches,373.0,co COL,DF,30.0,11.7,557.0,501.0,53.0,29.0,1.0,7.0,1.0,24.0,0.0,0.0,0.0,0.0,456.0,3.0,7.0,Matches,373.0,co COL,DF,30.0,11.7,456.0,557.0,81.9,9153.0,3324.0,145.0,159.0,91.2,254.0,286.0,88.8,55.0,97.0,56.7,0.0,0.0,0.1,0.0,2.0,30.0,1.0,0.0,35.0,Matches,479,co COL,DF,30,20,1057.0,53.0,30.9,11.7,12,74.0,5,8,22.0,12,0.6,7.0,23.0,-16.0,-1.36,-0.18,8.1,19.2,-11.0,-0.94,-0.13,Matches,373.0,co COL,DF,30.0,11.7,671.0,81.0,323.0,325.0,28.0,4.0,671.0,4.0,2.0,50.0,1.0,25.0,336.0,1509.0,903.0,8.0,4.0,0.0,7.0,1.0,385.0,3.0,Matches,373.0,co COL,DF,30.0,11.7,0.0,3.0,0.0,0.0,0.26,0.0,0.0,,14.8,0.0,0.0,0.0,0.2,0.2,0.06,-0.2,-0.2,Matches,373.0,co COL,DF,30.0,20.0,12.0,1057.0,11.7,0.0,0.0,0.0,0.0,0.0,0.0,6.0,1.0,0.2,0.2,0.0,0.2,8.0,35.0,3.0,0.0,0.0,0.0,0.0,0.0,0.02,0.0,0.02,0.02,0.02,Matches,Jeison Murillo,D C,30,125,145,"Colombia,Spain",U.C. Sampdoria,4,6,10,4,10,4,13,5,4,13,12,8,15,10,13,12,15,12,10,12,12,16,6,13,9,15,12,13,12,13,13,13,13,12,14,15,10,12,10,13,9,3,1,2,3,1,2,1,2,1,2,3,14,13,3,11,11,13,16,15,1,1,20,1,1,1,1,1,1,1,1,1,1,1,182,78,10,20,1635869,6241,6691,5491,Mixed_Race,124,12,1992/5/27,32,1,27114.0,,76016518
1274,Juan Musso,Atalanta,1994,375.0,ar ARG,GK,28.0,23.1,1.0,1.0,1.0,0.0,0.0,1.0,1.0,100.0,0.0,0.0,0.0,0.0,0.0,1.0,11.0,1.0,Matches,375.0,ar ARG,GK,28.0,23.1,1.0,0.04,1.0,0.0,0.0,0.0,0.0,0.0,0.0,0.0,0.0,0.0,0.0,0.0,0.0,0.0,Matches,22.0,ar ARG,GK,28.0,23.1,27.0,2.0,0.0,3.0,2.0,21.7,0.23,-3.3,-0.14,109.0,276.0,39.5,547.0,152.0,32.5,32.1,157.0,62.4,48.6,253.0,14.0,5.5,24.0,1.04,15.6,Matches,22.0,ar ARG,GK,28.0,24.0,24.0,2077.0,23.1,27.0,1.17,89.0,64.0,71.9,13.0,4.0,7.0,7.0,29.2,2.0,2.0,0.0,0.0,0.0,Matches,375.0,ar ARG,GK,28.0,23.1,1.0,0.0,0.0,0.0,5.0,0.0,0.0,0.0,1.0,0.0,0.0,1.0,18.0,1.0,0.0,100.0,Matches,375.0,ar ARG,GK,28.0,23.1,705.0,497.0,207.0,50.0,0.0,3.0,0.0,0.0,0.0,0.0,0.0,0.0,513.0,1.0,1.0,Matches,375.0,ar ARG,GK,28.0,23.1,513.0,705.0,72.8,14449.0,10079.0,93.0,93.0,100.0,243.0,246.0,98.8,174.0,360.0,48.3,0.0,0.1,0.0,-0.1,1.0,0.0,0.0,0.0,0.0,Matches,481,ar ARG,GK,28,24,2077.0,87.0,60.7,23.1,24,87.0,23,0,,10,1.79,41.0,27.0,14.0,0.61,0.34,36.5,23.5,13.1,0.57,0.35,Matches,375.0,ar ARG,GK,28.0,23.1,745.0,654.0,742.0,3.0,0.0,0.0,745.0,0.0,0.0,,0.0,,436.0,2893.0,1620.0,0.0,1.0,1.0,2.0,0.0,316.0,0.0,Matches,375.0,ar ARG,GK,28.0,23.1,0.0,0.0,0.0,,0.0,0.0,,,,0.0,0.0,0.0,0.0,0.0,,0.0,0.0,Matches,375.0,ar ARG,GK,28.0,24.0,24.0,2077.0,23.1,0.0,0.0,0.0,0.0,0.0,0.0,1.0,0.0,0.0,0.0,0.1,0.1,0.0,0.0,0.0,0.0,0.0,0.0,0.0,0.0,0.0,0.0,0.0,0.0,0.0,Matches,Juan Musso,GK,28,145,157,"Argentina,Italy",Atalanta,7,3,2,1,8,9,8,2,3,2,10,3,2,7,5,13,13,12,14,12,12,15,3,12,1,13,15,13,12,16,13,14,14,13,12,12,12,12,14,3,13,15,12,12,5,14,11,14,18,14,11,15,15,13,4,15,8,18,14,11,20,1,1,1,1,1,1,1,1,1,1,1,1,1,191,93,7,20,19938228,7250,7150,5750,Mediterranean_Hispanic,142,7,1994/5/6,2,0,56923.0,,14048328
1275,Joakim Mæhle,Atalanta,1997,376.0,dk DEN,DFMF,25.0,24.5,32.0,18.0,12.0,7.0,13.0,22.0,39.0,56.4,17.0,29.0,6.0,23.0,24.0,56.0,26.0,0.0,Matches,376.0,dk DEN,DFMF,25.0,24.5,81.0,3.3,68.0,4.0,4.0,1.0,2.0,2.0,6.0,0.24,4.0,1.0,1.0,0.0,0.0,0.0,Matches,,,,,,,,,,,,,,,,,,,,,,,,,,,,,,,,,,,,,,,,,,,,,,,,,,,,,,,,376.0,dk DEN,DFMF,25.0,24.5,5.0,1.0,0.0,16.0,19.0,6.0,38.0,24.0,18.0,0.0,0.0,0.0,138.0,4.0,12.0,25.0,Matches,376.0,dk DEN,DFMF,25.0,24.5,1455.0,1211.0,239.0,7.0,1.0,2.0,38.0,231.0,1.0,0.0,1.0,0.0,1188.0,5.0,42.0,Matches,376.0,dk DEN,DFMF,25.0,24.5,1188.0,1455.0,81.6,16528.0,5309.0,737.0,818.0,90.1,358.0,439.0,81.5,45.0,84.0,53.6,3.0,2.9,2.9,0.1,37.0,71.0,46.0,10.0,137.0,Matches,482,dk DEN,DFMF,25,34,2209.0,65.0,64.6,24.5,25,82.0,12,9,19.0,2,1.62,39.0,33.0,6.0,0.24,-0.65,36.7,30.4,6.3,0.26,-0.48,Matches,376.0,dk DEN,DFMF,25.0,24.5,1707.0,43.0,347.0,697.0,683.0,58.0,1707.0,53.0,18.0,34.0,32.0,60.4,932.0,4932.0,2801.0,81.0,64.0,11.0,39.0,24.0,1110.0,186.0,Matches,376.0,dk DEN,DFMF,25.0,24.5,3.0,26.0,6.0,23.1,1.06,0.24,0.12,0.5,18.5,0.0,0.0,0.0,3.0,3.0,0.12,0.0,0.0,Matches,376.0,dk DEN,DFMF,25.0,34.0,25.0,2209.0,24.5,3.0,3.0,6.0,3.0,0.0,0.0,5.0,1.0,3.0,3.0,2.9,5.9,81.0,137.0,186.0,0.12,0.12,0.24,0.12,0.24,0.12,0.12,0.24,0.12,0.24,Matches,Joakim Mæhle,D/WB RL,25,138,144,Denmark,Atalanta,6,13,13,9,13,6,7,10,6,9,12,6,11,13,15,12,11,13,12,12,10,15,14,10,13,10,14,16,14,13,14,11,16,14,17,12,12,8,14,6,17,1,1,2,1,2,3,1,3,3,1,4,17,15,5,14,13,13,14,13,1,17,1,19,17,20,1,14,1,15,9,1,11,1,184,81,12,20,7103724,6800,7500,5500,Northern_European,127,4,1997/5/20,29,9,24615.0,,27097478
1276,Dimitris Nikolaou,Spezia,1998,383.0,gr GRE,DF,23.0,32.9,45.0,32.0,31.0,10.0,4.0,25.0,37.0,67.6,12.0,41.0,26.0,15.0,27.0,72.0,82.0,0.0,Matches,383.0,gr GRE,DF,23.0,32.9,27.0,0.82,23.0,3.0,0.0,1.0,0.0,0.0,0.0,0.0,0.0,0.0,0.0,0.0,0.0,0.0,Matches,,,,,,,,,,,,,,,,,,,,,,,,,,,,,,,,,,,,,,,,,,,,,,,,,,,,,,,,383.0,gr GRE,DF,23.0,32.9,9.0,1.0,0.0,27.0,20.0,0.0,18.0,27.0,32.0,0.0,0.0,0.0,202.0,30.0,29.0,50.8,Matches,383.0,gr GRE,DF,23.0,32.9,1660.0,1519.0,136.0,48.0,0.0,25.0,18.0,67.0,0.0,0.0,0.0,0.0,1348.0,5.0,10.0,Matches,383.0,gr GRE,DF,23.0,32.9,1348.0,1660.0,81.2,24411.0,9983.0,598.0,652.0,91.7,569.0,651.0,87.4,149.0,298.0,50.0,0.0,0.9,0.8,-0.9,10.0,112.0,6.0,2.0,105.0,Matches,494,gr GRE,DF,23,36,2958.0,82.0,86.5,32.9,34,87.0,27,2,7.0,0,0.84,28.0,53.0,-25.0,-0.76,0.41,35.4,50.4,-15.0,-0.46,0.12,Matches,383.0,gr GRE,DF,23.0,32.9,1926.0,243.0,989.0,814.0,136.0,14.0,1926.0,14.0,10.0,71.4,2.0,14.3,1138.0,5327.0,2878.0,20.0,19.0,0.0,18.0,10.0,1242.0,15.0,Matches,383.0,gr GRE,DF,23.0,32.9,1.0,10.0,3.0,30.0,0.3,0.09,0.1,0.33,20.3,0.0,0.0,0.0,0.8,0.8,0.08,0.2,0.2,Matches,383.0,gr GRE,DF,23.0,36.0,34.0,2958.0,32.9,1.0,0.0,1.0,1.0,0.0,0.0,9.0,1.0,0.8,0.8,0.9,1.7,20.0,105.0,15.0,0.03,0.0,0.03,0.03,0.03,0.03,0.03,0.05,0.03,0.05,Matches,Dimitris Nikolaou,D C,23,129,143,Greece,Spezia Calcio,6,7,7,7,10,6,13,8,9,14,11,9,15,11,15,14,15,12,15,6,14,14,7,13,7,14,13,13,12,12,14,15,13,12,15,14,13,11,12,4,12,2,2,3,1,2,1,3,1,1,2,2,15,15,9,11,15,14,12,11,1,10,20,1,6,1,10,1,1,1,1,1,1,1,188,82,20,5,5052142,6450,5520,4595,Mediterranean_Hispanic,131,2,1998/8/13,1,0,32115.0,,36105265
1277,Bram Nuytinck,Sampdoria,1990,386.0,nl NED,DF,32.0,16.6,54.0,38.0,33.0,21.0,0.0,23.0,34.0,67.6,11.0,36.0,21.0,15.0,23.0,77.0,84.0,0.0,Matches,386.0,nl NED,DF,32.0,16.6,6.0,0.36,5.0,0.0,0.0,0.0,0.0,1.0,1.0,0.06,1.0,0.0,0.0,0.0,0.0,0.0,Matches,,,,,,,,,,,,,,,,,,,,,,,,,,,,,,,,,,,,,,,,,,,,,,,,,,,,,,,,386.0,nl NED,DF,32.0,16.6,4.0,0.0,0.0,23.0,8.0,0.0,0.0,23.0,38.0,0.0,1.0,0.0,74.0,29.0,34.0,46.0,Matches,386.0,nl NED,DF,32.0,16.6,659.0,628.0,26.0,24.0,0.0,1.0,0.0,2.0,0.0,0.0,0.0,0.0,559.0,5.0,3.0,Matches,386.0,nl NED,DF,32.0,16.6,559.0,659.0,84.8,11417.0,3707.0,138.0,163.0,84.7,359.0,387.0,92.8,59.0,95.0,62.1,1.0,0.3,0.4,0.7,3.0,16.0,0.0,0.0,23.0,Matches,497,nl NED,DF,32,19,1498.0,79.0,43.8,16.6,19,79.0,12,0,,0,0.63,14.0,31.0,-17.0,-1.02,0.38,17.6,30.6,-13.0,-0.78,0.12,Matches,386.0,nl NED,DF,32.0,16.6,878.0,160.0,575.0,290.0,15.0,12.0,878.0,1.0,0.0,0.0,1.0,100.0,471.0,2123.0,936.0,4.0,0.0,0.0,4.0,2.0,486.0,3.0,Matches,386.0,nl NED,DF,32.0,16.6,0.0,4.0,0.0,0.0,0.24,0.0,0.0,,10.7,0.0,0.0,0.0,0.3,0.3,0.06,-0.3,-0.3,Matches,386.0,nl NED,DF,32.0,19.0,19.0,1498.0,16.6,0.0,1.0,1.0,0.0,0.0,0.0,4.0,0.0,0.3,0.3,0.3,0.5,4.0,23.0,3.0,0.0,0.06,0.06,0.0,0.06,0.02,0.02,0.03,0.02,0.03,Matches,Bram Nuytinck,D C,32,128,135,Holland,Udinese Calcio,6,7,7,5,14,7,14,5,5,15,12,5,14,11,13,13,14,12,14,11,12,15,11,14,13,14,14,12,12,11,13,15,14,12,14,15,14,12,14,11,8,2,3,1,2,2,3,1,2,4,3,1,15,14,13,12,13,13,14,12,1,10,20,1,1,1,1,1,1,1,1,1,1,1,190,80,20,6,1153145,6400,6000,5100,Northern_European,128,3,1990/5/4,0,0,21346.0,,37006661
1278,M'Bala Nzola,Spezia,1996,387.0,ao ANG,FW,25.0,29.5,12.0,5.0,0.0,6.0,6.0,3.0,9.0,33.3,6.0,20.0,6.0,14.0,7.0,19.0,21.0,0.0,Matches,387.0,ao ANG,FW,25.0,29.5,67.0,2.27,52.0,0.0,5.0,4.0,6.0,0.0,7.0,0.24,3.0,0.0,3.0,0.0,1.0,0.0,Matches,,,,,,,,,,,,,,,,,,,,,,,,,,,,,,,,,,,,,,,,,,,,,,,,,,,,,,,,387.0,ao ANG,FW,25.0,29.5,8.0,0.0,0.0,57.0,41.0,10.0,10.0,7.0,5.0,0.0,0.0,0.0,74.0,42.0,80.0,34.4,Matches,387.0,ao ANG,FW,25.0,29.5,593.0,566.0,25.0,4.0,0.0,1.0,10.0,6.0,0.0,0.0,0.0,0.0,471.0,2.0,17.0,Matches,387.0,ao ANG,FW,25.0,29.5,471.0,593.0,79.4,5580.0,916.0,309.0,363.0,85.1,108.0,138.0,78.3,8.0,10.0,80.0,2.0,2.5,2.7,-0.5,28.0,23.0,18.0,2.0,50.0,Matches,498,ao ANG,FW,25,31,2653.0,86.0,77.6,29.5,29,89.0,26,2,35.0,0,0.91,26.0,43.0,-17.0,-0.58,1.07,32.0,47.4,-15.3,-0.52,-0.21,Matches,387.0,ao ANG,FW,25.0,29.5,966.0,32.0,64.0,351.0,562.0,143.0,963.0,80.0,30.0,37.5,39.0,48.8,620.0,3345.0,995.0,50.0,26.0,28.0,123.0,69.0,769.0,215.0,Matches,387.0,ao ANG,FW,25.0,29.5,13.0,60.0,20.0,33.3,2.04,0.68,0.17,0.5,14.9,0.0,3.0,3.0,11.0,8.6,0.14,2.0,1.4,Matches,387.0,ao ANG,FW,25.0,31.0,29.0,2653.0,29.5,13.0,2.0,15.0,10.0,3.0,3.0,8.0,0.0,11.0,8.6,2.5,11.1,50.0,50.0,215.0,0.44,0.07,0.51,0.34,0.41,0.37,0.09,0.46,0.29,0.38,Matches,M'Bala Nzola,S,25,133,138,"Angola,France",Spezia Calcio,4,12,13,14,13,9,12,11,4,5,12,14,7,13,18,12,13,13,11,11,11,16,9,8,14,7,15,12,14,14,16,13,17,16,14,17,12,10,12,3,14,2,1,3,1,2,1,2,3,1,2,1,10,17,9,8,12,17,9,6,1,1,1,1,1,1,1,1,1,1,14,1,13,20,185,82,20,8,4194259,6650,5969,4459,African_Caribbean,133,19,1996/8/18,5,2,14230.0,,83103196
1279,Guillermo Ochoa,Salernitana,1985,389.0,mx MEX,GK,37.0,20.0,0.0,0.0,0.0,0.0,0.0,0.0,2.0,0.0,2.0,0.0,0.0,0.0,0.0,0.0,9.0,1.0,Matches,389.0,mx MEX,GK,37.0,20.0,5.0,0.25,5.0,0.0,0.0,0.0,0.0,0.0,2.0,0.1,2.0,0.0,0.0,0.0,0.0,0.0,Matches,23.0,mx MEX,GK,37.0,20.0,33.0,3.0,1.0,6.0,0.0,34.8,0.3,1.8,0.09,135.0,430.0,31.4,556.0,45.0,53.6,40.9,200.0,66.0,47.3,311.0,11.0,3.5,10.0,0.5,12.3,Matches,23.0,mx MEX,GK,37.0,20.0,20.0,1800.0,20.0,33.0,1.65,105.0,71.0,71.4,4.0,10.0,6.0,4.0,20.0,4.0,3.0,1.0,0.0,25.0,Matches,389.0,mx MEX,GK,37.0,20.0,1.0,0.0,0.0,0.0,1.0,0.0,0.0,0.0,0.0,0.0,0.0,0.0,22.0,2.0,0.0,100.0,Matches,389.0,mx MEX,GK,37.0,20.0,760.0,476.0,280.0,80.0,0.0,0.0,0.0,0.0,0.0,0.0,0.0,0.0,441.0,4.0,0.0,Matches,389.0,mx MEX,GK,37.0,20.0,441.0,760.0,58.0,14422.0,10713.0,62.0,63.0,98.4,183.0,186.0,98.4,196.0,507.0,38.7,0.0,0.0,0.0,0.0,0.0,13.0,0.0,0.0,0.0,Matches,500,mx MEX,GK,37,20,1800.0,90.0,52.6,20.0,20,90.0,20,0,,3,1.1,26.0,33.0,-7.0,-0.35,0.04,17.9,33.7,-15.8,-0.79,0.02,Matches,389.0,mx MEX,GK,37.0,20.0,824.0,692.0,819.0,5.0,0.0,0.0,824.0,0.0,0.0,,0.0,,396.0,2117.0,1426.0,0.0,0.0,0.0,1.0,0.0,326.0,0.0,Matches,389.0,mx MEX,GK,37.0,20.0,0.0,0.0,0.0,,0.0,0.0,,,,0.0,0.0,0.0,0.0,0.0,,0.0,0.0,Matches,389.0,mx MEX,GK,37.0,20.0,20.0,1800.0,20.0,0.0,0.0,0.0,0.0,0.0,0.0,1.0,0.0,0.0,0.0,0.0,0.0,0.0,0.0,0.0,0.0,0.0,0.0,0.0,0.0,0.0,0.0,0.0,0.0,0.0,Matches,Guillermo Ochoa,GK,37,140,148,"Mexico,Spain",CF América,5,1,3,1,11,7,10,3,10,7,11,10,13,9,7,15,14,17,15,9,11,16,7,15,5,13,14,8,13,16,8,12,12,12,12,13,13,7,16,7,1,10,12,12,15,13,13,16,17,7,15,11,13,16,12,12,15,17,18,14,20,1,1,1,1,1,1,1,1,1,1,1,1,1,185,78,8,20,617061,7500,7500,6008,Mediterranean_Hispanic,139,9,1985/7/13,128,0,74999.0,,5666492
1280,David Okereke,Cremonese,1997,391.0,ng NGA,FWMF,24.0,25.2,12.0,8.0,4.0,5.0,3.0,3.0,16.0,18.8,13.0,23.0,3.0,20.0,10.0,22.0,12.0,0.0,Matches,391.0,ng NGA,FWMF,24.0,25.2,73.0,2.9,42.0,1.0,11.0,7.0,10.0,2.0,6.0,0.24,0.0,0.0,3.0,1.0,2.0,0.0,Matches,,,,,,,,,,,,,,,,,,,,,,,,,,,,,,,,,,,,,,,,,,,,,,,,,,,,,,,,391.0,ng NGA,FWMF,24.0,25.2,4.0,0.0,0.0,21.0,33.0,9.0,22.0,10.0,8.0,3.0,1.0,0.0,60.0,49.0,85.0,36.6,Matches,391.0,ng NGA,FWMF,24.0,25.2,504.0,485.0,14.0,1.0,3.0,5.0,22.0,7.0,0.0,0.0,0.0,0.0,353.0,5.0,25.0,Matches,391.0,ng NGA,FWMF,24.0,25.2,353.0,504.0,70.0,5730.0,1348.0,188.0,245.0,76.7,117.0,147.0,79.6,34.0,50.0,68.0,0.0,1.1,1.1,-1.1,21.0,31.0,24.0,5.0,70.0,Matches,502,ng NGA,FWMF,24,33,2266.0,69.0,66.3,25.2,25,79.0,9,8,36.0,2,0.73,23.0,41.0,-18.0,-0.71,0.45,27.3,43.8,-16.5,-0.66,0.19,Matches,391.0,ng NGA,FWMF,24.0,25.2,788.0,20.0,65.0,325.0,412.0,91.0,787.0,83.0,39.0,47.0,35.0,42.2,471.0,3128.0,1554.0,56.0,45.0,17.0,63.0,35.0,581.0,144.0,Matches,391.0,ng NGA,FWMF,24.0,25.2,7.0,60.0,20.0,33.3,2.38,0.79,0.1,0.3,17.2,0.0,1.0,1.0,5.9,5.2,0.09,1.1,0.8,Matches,391.0,ng NGA,FWMF,24.0,33.0,25.0,2266.0,25.2,7.0,0.0,7.0,6.0,1.0,1.0,4.0,0.0,5.9,5.2,1.1,6.3,56.0,70.0,144.0,0.28,0.0,0.28,0.24,0.24,0.24,0.04,0.28,0.2,0.25,Matches,David Okereke,AM/S R,24,127,135,Nigeria,Cremonese,5,8,13,14,13,8,11,11,6,5,12,13,5,14,12,13,11,13,9,11,11,14,14,9,14,9,12,11,14,15,14,11,13,14,14,14,12,9,10,12,11,3,2,2,2,3,1,2,1,2,2,3,14,13,6,10,14,13,11,12,1,1,1,1,1,1,1,1,1,1,14,1,16,20,182,77,10,20,3116002,6350,6500,4850,African_Caribbean,127,17,1997/8/29,0,0,19751.0,,43273310
1281,Caleb Okoli,Atalanta,2001,392.0,it ITA,DF,21.0,10.7,21.0,17.0,14.0,6.0,1.0,10.0,25.0,40.0,15.0,10.0,5.0,5.0,30.0,51.0,44.0,3.0,Matches,392.0,it ITA,DF,21.0,10.7,2.0,0.19,1.0,0.0,0.0,1.0,0.0,0.0,1.0,0.09,1.0,0.0,0.0,0.0,0.0,0.0,Matches,,,,,,,,,,,,,,,,,,,,,,,,,,,,,,,,,,,,,,,,,,,,,,,,,,,,,,,,392.0,it ITA,DF,21.0,10.7,3.0,0.0,0.0,15.0,8.0,0.0,2.0,30.0,17.0,0.0,0.0,0.0,66.0,43.0,25.0,63.2,Matches,392.0,it ITA,DF,21.0,10.7,458.0,419.0,37.0,18.0,0.0,3.0,2.0,17.0,0.0,0.0,0.0,0.0,345.0,2.0,8.0,Matches,392.0,it ITA,DF,21.0,10.7,345.0,458.0,75.3,5887.0,2267.0,156.0,190.0,82.1,151.0,189.0,79.9,28.0,49.0,57.1,0.0,0.0,0.1,0.0,0.0,11.0,2.0,0.0,19.0,Matches,503,it ITA,DF,21,17,960.0,56.0,28.1,10.7,9,85.0,8,8,24.0,19,1.76,19.0,10.0,9.0,0.84,0.51,17.3,9.7,7.6,0.72,0.4,Matches,392.0,it ITA,DF,21.0,10.7,598.0,62.0,328.0,229.0,48.0,12.0,598.0,1.0,0.0,0.0,1.0,100.0,265.0,1059.0,463.0,4.0,5.0,0.0,12.0,5.0,286.0,12.0,Matches,392.0,it ITA,DF,21.0,10.7,0.0,7.0,2.0,28.6,0.66,0.19,0.0,0.0,12.2,0.0,0.0,0.0,0.5,0.5,0.06,-0.5,-0.5,Matches,392.0,it ITA,DF,21.0,17.0,9.0,960.0,10.7,0.0,0.0,0.0,0.0,0.0,0.0,3.0,0.0,0.5,0.5,0.0,0.5,4.0,19.0,12.0,0.0,0.0,0.0,0.0,0.0,0.04,0.0,0.04,0.04,0.04,Matches,Caleb Okoli,D C,21,133,164,"Italy,Nigeria",Atalanta,7,7,8,6,9,6,14,6,10,15,9,7,14,9,14,14,13,14,13,8,12,14,7,12,8,14,12,14,14,14,13,14,16,14,15,14,14,11,16,5,10,2,2,1,1,1,1,2,2,3,1,1,14,15,8,13,14,15,15,10,1,1,20,1,1,1,1,1,1,1,1,1,1,1,187,76,8,20,20710001,6650,6650,4256,African_Caribbean,133,15,2001/7/13,0,0,19999.0,,43372285
1282,Mathías Olivera,Napoli,1997,393.0,uy URU,DF,24.0,18.3,39.0,23.0,16.0,16.0,7.0,22.0,43.0,51.2,21.0,28.0,2.0,26.0,22.0,61.0,26.0,0.0,Matches,393.0,uy URU,DF,24.0,18.3,43.0,2.35,37.0,3.0,1.0,1.0,0.0,1.0,3.0,0.16,3.0,0.0,0.0,0.0,0.0,0.0,Matches,,,,,,,,,,,,,,,,,,,,,,,,,,,,,,,,,,,,,,,,,,,,,,,,,,,,,,,,393.0,uy URU,DF,24.0,18.3,2.0,0.0,0.0,21.0,25.0,2.0,19.0,22.0,23.0,0.0,0.0,0.0,99.0,33.0,42.0,44.0,Matches,393.0,uy URU,DF,24.0,18.3,1381.0,1176.0,201.0,26.0,1.0,8.0,19.0,173.0,2.0,1.0,0.0,0.0,1200.0,4.0,19.0,Matches,393.0,uy URU,DF,24.0,18.3,1200.0,1381.0,86.9,16376.0,4940.0,780.0,832.0,93.8,316.0,366.0,86.3,57.0,101.0,56.4,2.0,2.1,2.0,-0.1,24.0,100.0,12.0,4.0,88.0,Matches,504,uy URU,DF,24,30,1643.0,55.0,48.0,18.3,17,87.0,14,13,13.0,6,2.37,29.0,11.0,18.0,0.99,-0.58,24.8,15.5,9.3,0.51,-0.69,Matches,393.0,uy URU,DF,24.0,18.3,1588.0,47.0,360.0,805.0,432.0,40.0,1588.0,30.0,10.0,33.3,13.0,43.3,931.0,4080.0,2379.0,60.0,44.0,9.0,22.0,24.0,1040.0,68.0,Matches,393.0,uy URU,DF,24.0,18.3,2.0,9.0,4.0,44.4,0.49,0.22,0.22,0.5,12.8,0.0,0.0,0.0,0.7,0.7,0.08,1.3,1.3,Matches,393.0,uy URU,DF,24.0,30.0,17.0,1643.0,18.3,2.0,2.0,4.0,2.0,0.0,0.0,2.0,0.0,0.7,0.7,2.1,2.8,60.0,88.0,68.0,0.11,0.11,0.22,0.11,0.22,0.04,0.12,0.16,0.04,0.16,Matches,Mathías Olivera,D/WB L,24,136,148,"Uruguay,Spain",Parthenope,10,14,12,8,13,9,12,9,13,13,12,8,15,12,11,14,13,13,14,10,13,14,12,11,13,14,15,16,14,12,12,13,14,14,14,13,14,11,12,7,11,1,2,2,1,4,1,2,1,1,2,2,7,12,7,3,10,11,12,10,1,20,1,1,16,1,1,15,1,1,1,1,1,1,184,78,20,9,6088906,6800,6900,5750,Mediterranean_Hispanic,137,6,1997/10/31,6,0,36922.0,,78076343
1283,André Onana,Inter,1996,394.0,cm CMR,GK,26.0,24.0,0.0,0.0,0.0,0.0,0.0,0.0,1.0,0.0,1.0,0.0,0.0,0.0,0.0,0.0,5.0,0.0,Matches,394.0,cm CMR,GK,26.0,24.0,8.0,0.33,6.0,2.0,0.0,0.0,0.0,0.0,0.0,0.0,0.0,0.0,0.0,0.0,0.0,0.0,Matches,24.0,cm CMR,GK,26.0,24.0,24.0,2.0,0.0,5.0,2.0,19.3,0.21,-2.7,-0.11,105.0,270.0,38.9,875.0,115.0,25.5,29.6,152.0,30.9,35.4,283.0,15.0,5.3,10.0,0.42,12.5,Matches,24.0,cm CMR,GK,26.0,24.0,24.0,2160.0,24.0,24.0,1.0,83.0,61.0,73.5,14.0,3.0,7.0,8.0,33.3,2.0,2.0,0.0,0.0,0.0,Matches,394.0,cm CMR,GK,26.0,24.0,1.0,0.0,0.0,0.0,3.0,0.0,0.0,0.0,0.0,0.0,0.0,1.0,24.0,3.0,0.0,100.0,Matches,394.0,cm CMR,GK,26.0,24.0,1030.0,845.0,182.0,30.0,0.0,6.0,0.0,0.0,0.0,0.0,0.0,0.0,837.0,3.0,0.0,Matches,394.0,cm CMR,GK,26.0,24.0,837.0,1030.0,81.3,20562.0,13611.0,224.0,224.0,100.0,386.0,394.0,98.0,220.0,402.0,54.7,0.0,0.1,0.1,-0.1,3.0,17.0,1.0,0.0,2.0,Matches,506,cm CMR,GK,26,24,2160.0,90.0,63.2,24.0,24,90.0,24,0,,14,1.88,39.0,24.0,15.0,0.62,-0.38,42.5,21.8,20.7,0.86,0.08,Matches,394.0,cm CMR,GK,26.0,24.0,1071.0,890.0,1058.0,13.0,0.0,0.0,1071.0,0.0,0.0,,0.0,,728.0,3561.0,2314.0,0.0,0.0,0.0,1.0,0.0,657.0,0.0,Matches,394.0,cm CMR,GK,26.0,24.0,0.0,0.0,0.0,,0.0,0.0,,,,0.0,0.0,0.0,0.0,0.0,,0.0,0.0,Matches,394.0,cm CMR,GK,26.0,24.0,24.0,2160.0,24.0,0.0,0.0,0.0,0.0,0.0,0.0,1.0,0.0,0.0,0.0,0.1,0.1,0.0,2.0,0.0,0.0,0.0,0.0,0.0,0.0,0.0,0.0,0.0,0.0,0.0,Matches,André Onana,GK,26,149,158,Cameroon,FC Internazionale Milano,2,2,3,1,10,5,5,3,3,3,14,3,3,12,9,13,14,14,13,8,13,15,15,11,2,15,12,12,12,15,15,16,16,12,13,13,12,8,15,7,14,15,14,13,15,15,14,15,15,16,5,15,14,16,5,12,15,12,14,10,20,1,1,1,1,1,1,1,1,1,1,1,1,1,192,93,6,20,22500000,7600,7100,6050,African_Caribbean,149,15,1996/4/2,30,0,74038.0,,67201634
1284,Divock Origi,Milan,1995,395.0,be BEL,FW,27.0,11.4,10.0,5.0,4.0,3.0,3.0,5.0,10.0,50.0,5.0,6.0,2.0,4.0,0.0,10.0,13.0,0.0,Matches,395.0,be BEL,FW,27.0,11.4,24.0,2.11,15.0,0.0,3.0,3.0,3.0,0.0,1.0,0.09,1.0,0.0,0.0,0.0,0.0,0.0,Matches,,,,,,,,,,,,,,,,,,,,,,,,,,,,,,,,,,,,,,,,,,,,,,,,,,,,,,,,395.0,be BEL,FW,27.0,11.4,1.0,0.0,0.0,13.0,17.0,6.0,11.0,0.0,5.0,0.0,0.0,0.0,33.0,15.0,34.0,30.6,Matches,395.0,be BEL,FW,27.0,11.4,193.0,184.0,8.0,0.0,1.0,1.0,11.0,0.0,0.0,0.0,0.0,0.0,128.0,1.0,6.0,Matches,395.0,be BEL,FW,27.0,11.4,128.0,193.0,66.3,1699.0,360.0,75.0,97.0,77.3,35.0,53.0,66.0,6.0,13.0,46.2,1.0,1.2,0.5,-0.2,11.0,7.0,6.0,1.0,18.0,Matches,507,be BEL,FW,27,27,1027.0,38.0,30.0,11.4,10,70.0,2,17,19.0,4,1.63,14.0,13.0,1.0,0.09,-0.66,15.5,13.2,2.3,0.2,-0.38,Matches,395.0,be BEL,FW,27.0,11.4,336.0,14.0,34.0,131.0,183.0,49.0,336.0,33.0,15.0,45.5,9.0,27.3,201.0,1391.0,705.0,24.0,18.0,13.0,39.0,25.0,243.0,79.0,Matches,395.0,be BEL,FW,27.0,11.4,2.0,29.0,12.0,41.4,2.54,1.05,0.07,0.17,18.2,0.0,0.0,0.0,2.1,2.1,0.07,-0.1,-0.1,Matches,395.0,be BEL,FW,27.0,27.0,10.0,1027.0,11.4,2.0,1.0,3.0,2.0,0.0,0.0,1.0,0.0,2.1,2.1,1.2,3.3,24.0,18.0,79.0,0.18,0.09,0.26,0.18,0.26,0.19,0.1,0.29,0.19,0.29,Matches,Divock Origi,AM/S L,27,144,158,"Belgium,Kenya",AC Milan,5,10,15,13,16,9,13,12,6,7,13,13,8,14,12,13,12,14,12,12,11,8,15,7,14,7,13,15,14,14,14,14,13,15,13,15,12,5,13,12,10,2,2,4,2,1,3,2,1,2,3,1,16,10,5,18,11,15,12,16,1,1,1,1,1,1,1,1,1,1,18,1,14,20,189,75,13,20,13107532,7200,6438,6524,African_Caribbean,143,15,1995/4/18,32,3,98653.0,,18045347
1285,Riccardo Orsolini,Bologna,1997,396.0,it ITA,FW,25.0,23.6,30.0,19.0,15.0,10.0,5.0,17.0,41.0,41.5,24.0,29.0,3.0,26.0,8.0,38.0,18.0,0.0,Matches,396.0,it ITA,FW,25.0,23.6,98.0,4.16,46.0,26.0,6.0,10.0,9.0,1.0,8.0,0.34,0.0,5.0,0.0,2.0,1.0,0.0,Matches,,,,,,,,,,,,,,,,,,,,,,,,,,,,,,,,,,,,,,,,,,,,,,,,,,,,,,,,396.0,it ITA,FW,25.0,23.6,8.0,2.0,1.0,39.0,43.0,18.0,99.0,8.0,19.0,1.0,0.0,0.0,113.0,16.0,25.0,39.0,Matches,396.0,it ITA,FW,25.0,23.6,867.0,777.0,89.0,26.0,0.0,30.0,99.0,5.0,56.0,35.0,13.0,0.0,553.0,1.0,41.0,Matches,396.0,it ITA,FW,25.0,23.6,553.0,867.0,63.8,10205.0,3119.0,279.0,374.0,74.6,161.0,250.0,64.4,89.0,164.0,54.3,4.0,3.1,2.7,0.9,44.0,48.0,12.0,5.0,62.0,Matches,508,it ITA,FW,25,32,2124.0,66.0,62.1,23.6,22,83.0,12,10,30.0,2,1.59,31.0,31.0,0.0,0.0,-0.28,28.1,30.3,-2.1,-0.09,0.1,Matches,396.0,it ITA,FW,25.0,23.6,1215.0,22.0,193.0,487.0,544.0,101.0,1212.0,85.0,33.0,38.8,44.0,51.8,716.0,4369.0,1892.0,53.0,37.0,34.0,69.0,36.0,881.0,212.0,Matches,396.0,it ITA,FW,25.0,23.6,11.0,89.0,27.0,30.3,3.77,1.14,0.09,0.3,20.8,8.0,3.0,3.0,10.5,8.1,0.09,0.5,-0.1,Matches,396.0,it ITA,FW,25.0,32.0,22.0,2124.0,23.6,11.0,4.0,15.0,8.0,3.0,3.0,8.0,2.0,10.5,8.1,3.1,11.2,53.0,62.0,212.0,0.47,0.17,0.64,0.34,0.51,0.44,0.13,0.58,0.34,0.48,Matches,Riccardo Orsolini,AM R,25,135,143,Italy,Bologna FC 1909,14,13,15,12,14,14,11,14,5,4,12,13,4,15,15,14,14,11,11,11,10,16,15,11,13,5,11,14,15,14,13,11,14,15,14,13,12,7,14,4,14,2,2,2,3,1,1,2,3,1,3,3,12,16,12,10,12,13,14,12,1,1,1,3,1,5,1,3,5,14,7,12,20,15,183,73,20,9,5900759,6747,6747,5497,Mediterranean_Hispanic,135,3,1997/1/24,2,2,39231.0,,43162321
1286,Victor Osimhen,Napoli,1998,397.0,ng NGA,FW,23.0,28.5,10.0,6.0,1.0,2.0,7.0,0.0,7.0,0.0,7.0,6.0,1.0,5.0,6.0,16.0,29.0,0.0,Matches,397.0,ng NGA,FW,23.0,28.5,80.0,2.8,54.0,0.0,5.0,11.0,8.0,2.0,9.0,0.32,6.0,0.0,0.0,1.0,2.0,0.0,Matches,,,,,,,,,,,,,,,,,,,,,,,,,,,,,,,,,,,,,,,,,,,,,,,,,,,,,,,,397.0,ng NGA,FW,23.0,28.5,4.0,0.0,0.0,40.0,38.0,32.0,19.0,6.0,6.0,2.0,1.0,0.0,58.0,65.0,54.0,54.6,Matches,397.0,ng NGA,FW,23.0,28.5,400.0,383.0,17.0,0.0,1.0,3.0,19.0,9.0,0.0,0.0,0.0,0.0,276.0,0.0,27.0,Matches,397.0,ng NGA,FW,23.0,28.5,276.0,400.0,69.0,3890.0,582.0,158.0,199.0,79.4,71.0,108.0,65.7,21.0,29.0,72.4,4.0,2.8,1.7,1.2,34.0,20.0,10.0,2.0,28.0,Matches,509,ng NGA,FW,23,32,2566.0,80.0,75.0,28.5,30,83.0,13,2,32.0,0,2.34,59.0,17.0,42.0,1.47,0.74,49.0,20.0,29.1,1.02,0.61,Matches,397.0,ng NGA,FW,23.0,28.5,789.0,31.0,45.0,224.0,537.0,232.0,786.0,75.0,25.0,33.3,36.0,48.0,469.0,2589.0,836.0,43.0,23.0,27.0,96.0,49.0,594.0,196.0,Matches,397.0,ng NGA,FW,23.0,28.5,26.0,132.0,52.0,39.4,4.63,1.82,0.18,0.46,12.8,1.0,2.0,3.0,21.3,18.9,0.14,4.7,5.1,Matches,397.0,ng NGA,FW,23.0,32.0,30.0,2566.0,28.5,26.0,4.0,30.0,24.0,2.0,3.0,4.0,0.0,21.3,18.9,2.8,21.8,43.0,28.0,196.0,0.91,0.14,1.05,0.84,0.98,0.75,0.1,0.85,0.66,0.76,Matches,Victor Osimhen,S,23,157,171,Nigeria,Parthenope,4,8,13,15,14,7,14,12,4,4,12,14,8,14,15,14,14,14,13,11,13,14,13,10,19,5,12,13,17,15,14,15,14,19,12,16,14,13,14,12,10,2,1,1,2,2,2,1,3,2,1,3,14,16,12,10,14,14,11,10,1,1,1,1,1,1,1,1,1,1,10,1,10,20,185,78,9,20,96427502,7850,7500,7250,African_Caribbean,154,16,1998/12/29,23,15,110961.0,,13158205
1287,Leandro Paredes,Juventus,1994,402.0,ar ARG,MF,28.0,10.9,19.0,13.0,7.0,11.0,1.0,10.0,22.0,45.5,12.0,8.0,0.0,8.0,17.0,36.0,22.0,0.0,Matches,402.0,ar ARG,MF,28.0,10.9,46.0,4.24,28.0,15.0,2.0,1.0,0.0,0.0,3.0,0.28,3.0,0.0,0.0,0.0,0.0,0.0,Matches,,,,,,,,,,,,,,,,,,,,,,,,,,,,,,,,,,,,,,,,,,,,,,,,,,,,,,,,402.0,ar ARG,MF,28.0,10.9,7.0,1.0,0.0,20.0,10.0,0.0,51.0,17.0,13.0,0.0,1.0,0.0,75.0,4.0,3.0,57.1,Matches,402.0,ar ARG,MF,28.0,10.9,778.0,679.0,98.0,51.0,3.0,4.0,51.0,4.0,43.0,24.0,17.0,0.0,681.0,1.0,4.0,Matches,402.0,ar ARG,MF,28.0,10.9,681.0,778.0,87.5,12988.0,4913.0,263.0,280.0,93.9,316.0,339.0,93.2,92.0,140.0,65.7,0.0,1.9,2.5,-1.9,21.0,65.0,12.0,2.0,72.0,Matches,518,ar ARG,MF,28,25,977.0,39.0,28.6,10.9,8,76.0,3,17,22.0,4,1.68,15.0,12.0,3.0,0.28,-0.46,17.4,15.4,2.0,0.19,-0.24,Matches,402.0,ar ARG,MF,28.0,10.9,868.0,41.0,216.0,494.0,161.0,4.0,868.0,6.0,4.0,66.7,1.0,16.7,473.0,1989.0,1029.0,11.0,10.0,2.0,5.0,4.0,587.0,11.0,Matches,402.0,ar ARG,MF,28.0,10.9,1.0,16.0,2.0,12.5,1.47,0.18,0.06,0.5,26.6,4.0,0.0,0.0,0.6,0.6,0.04,0.4,0.4,Matches,402.0,ar ARG,MF,28.0,25.0,8.0,977.0,10.9,1.0,0.0,1.0,1.0,0.0,0.0,7.0,1.0,0.6,0.6,1.9,2.5,11.0,72.0,11.0,0.09,0.0,0.09,0.09,0.09,0.06,0.18,0.23,0.06,0.23,Matches,Leandro Paredes,DM/M C,28,149,154,Argentina,Paris Saint-Germain,15,12,14,11,15,14,12,15,7,12,15,13,14,16,17,15,16,14,14,13,14,14,13,10,14,12,15,14,13,14,13,10,14,13,15,13,13,15,13,10,10,3,1,1,2,1,3,2,3,1,3,3,15,8,5,10,15,13,10,9,1,1,1,1,1,1,19,1,20,1,1,12,1,1,180,75,10,20,28214999,7450,7450,6750,Mediterranean_Hispanic,150,6,1994/6/29,44,4,172603.0,Juventus,14024702
1288,Fabiano Parisi,Empoli,2000,403.0,it ITA,DF,21.0,31.4,65.0,35.0,37.0,21.0,7.0,30.0,72.0,41.7,42.0,51.0,16.0,35.0,41.0,106.0,91.0,0.0,Matches,403.0,it ITA,DF,21.0,31.4,62.0,1.97,42.0,4.0,7.0,2.0,6.0,1.0,8.0,0.25,6.0,0.0,1.0,0.0,1.0,0.0,Matches,,,,,,,,,,,,,,,,,,,,,,,,,,,,,,,,,,,,,,,,,,,,,,,,,,,,,,,,403.0,it ITA,DF,21.0,31.4,10.0,1.0,0.0,34.0,74.0,0.0,59.0,41.0,35.0,1.0,1.0,0.0,233.0,30.0,13.0,69.8,Matches,403.0,it ITA,DF,21.0,31.4,1646.0,1305.0,332.0,31.0,1.0,7.0,59.0,300.0,1.0,1.0,0.0,0.0,1263.0,9.0,50.0,Matches,403.0,it ITA,DF,21.0,31.4,1263.0,1646.0,76.7,20129.0,9462.0,684.0,768.0,89.1,457.0,589.0,77.6,95.0,184.0,51.6,0.0,2.0,1.5,-2.0,21.0,99.0,35.0,11.0,154.0,Matches,519,it ITA,DF,21,33,2830.0,86.0,82.7,31.4,33,86.0,28,0,,2,1.21,31.0,37.0,-6.0,-0.19,0.72,32.5,45.0,-12.5,-0.4,0.67,Matches,403.0,it ITA,DF,21.0,31.4,2094.0,159.0,727.0,930.0,483.0,26.0,2094.0,129.0,64.0,49.6,47.0,36.4,1105.0,7030.0,4064.0,102.0,75.0,13.0,55.0,39.0,1113.0,68.0,Matches,403.0,it ITA,DF,21.0,31.4,2.0,21.0,2.0,9.5,0.67,0.06,0.1,1.0,21.9,0.0,0.0,0.0,1.8,1.8,0.09,0.2,0.2,Matches,403.0,it ITA,DF,21.0,33.0,33.0,2830.0,31.4,2.0,0.0,2.0,2.0,0.0,0.0,10.0,1.0,1.8,1.8,2.0,3.8,102.0,154.0,68.0,0.06,0.0,0.06,0.06,0.06,0.06,0.06,0.12,0.06,0.12,Matches,Fabiano Parisi,D/WB L,21,133,159,Italy,Empoli Football Club,10,13,15,9,13,6,7,10,8,11,13,6,14,13,12,12,13,12,13,11,12,16,5,10,12,12,13,14,16,15,14,8,12,15,14,11,14,15,11,7,12,1,1,1,2,2,1,1,3,1,2,2,13,16,8,12,12,16,14,12,1,20,1,1,19,1,1,15,9,1,1,1,1,1,178,70,20,7,27200002,6650,6650,5000,Mediterranean_Hispanic,127,2,2000/11/9,0,0,3654.0,,43429372
1289,Mario Pašalić,Atalanta,1995,404.0,hr CRO,MFFW,27.0,19.7,22.0,10.0,6.0,14.0,2.0,6.0,23.0,26.1,17.0,22.0,4.0,18.0,21.0,43.0,13.0,0.0,Matches,404.0,hr CRO,MFFW,27.0,19.7,51.0,2.58,46.0,0.0,2.0,2.0,0.0,1.0,6.0,0.3,5.0,0.0,0.0,1.0,0.0,0.0,Matches,,,,,,,,,,,,,,,,,,,,,,,,,,,,,,,,,,,,,,,,,,,,,,,,,,,,,,,,404.0,hr CRO,MFFW,27.0,19.7,3.0,0.0,0.0,24.0,16.0,2.0,5.0,21.0,10.0,0.0,0.0,0.0,102.0,37.0,34.0,52.1,Matches,404.0,hr CRO,MFFW,27.0,19.7,705.0,676.0,26.0,11.0,0.0,3.0,5.0,5.0,0.0,0.0,0.0,0.0,567.0,3.0,18.0,Matches,404.0,hr CRO,MFFW,27.0,19.7,567.0,705.0,80.4,9192.0,2177.0,286.0,335.0,85.4,216.0,246.0,87.8,46.0,69.0,66.7,2.0,2.2,1.6,-0.2,16.0,55.0,25.0,2.0,82.0,Matches,520,hr CRO,MFFW,27,32,1769.0,55.0,51.7,19.7,24,65.0,1,8,26.0,2,1.69,33.0,24.0,9.0,0.46,-0.03,30.9,22.3,8.6,0.44,0.02,Matches,404.0,hr CRO,MFFW,27.0,19.7,899.0,21.0,135.0,491.0,279.0,57.0,899.0,25.0,8.0,32.0,15.0,60.0,545.0,2839.0,1137.0,24.0,22.0,3.0,35.0,26.0,659.0,83.0,Matches,404.0,hr CRO,MFFW,27.0,19.7,5.0,32.0,8.0,25.0,1.63,0.41,0.16,0.63,12.1,0.0,0.0,0.0,5.7,5.7,0.18,-0.7,-0.7,Matches,404.0,hr CRO,MFFW,27.0,32.0,24.0,1769.0,19.7,5.0,2.0,7.0,5.0,0.0,0.0,3.0,0.0,5.7,5.7,2.2,7.9,24.0,82.0,83.0,0.25,0.1,0.36,0.25,0.36,0.29,0.11,0.4,0.29,0.4,Matches,Mario Pašalić,M/AM C,27,147,152,"Croatia,Germany",Atalanta,8,10,12,16,14,7,12,14,4,8,14,9,11,14,13,17,12,13,10,13,13,13,11,11,18,9,14,14,13,14,14,14,13,13,13,12,14,12,12,8,14,3,1,2,2,2,2,1,2,1,3,3,15,16,6,17,13,17,14,15,1,1,1,1,1,1,12,1,20,1,1,20,1,1,188,82,17,20,20490768,7350,7150,5900,Northern_European,142,3,1995/2/9,40,7,35577.0,,24021244
1290,Patric,Lazio,1993,405.0,es ESP,DF,29.0,15.7,17.0,11.0,12.0,3.0,2.0,11.0,16.0,68.8,5.0,17.0,12.0,5.0,11.0,28.0,53.0,1.0,Matches,405.0,es ESP,DF,29.0,15.7,6.0,0.38,6.0,0.0,0.0,0.0,0.0,0.0,0.0,0.0,0.0,0.0,0.0,0.0,0.0,0.0,Matches,,,,,,,,,,,,,,,,,,,,,,,,,,,,,,,,,,,,,,,,,,,,,,,,,,,,,,,,405.0,es ESP,DF,29.0,15.7,1.0,0.0,0.0,3.0,4.0,0.0,0.0,11.0,11.0,0.0,0.0,0.0,96.0,8.0,22.0,26.7,Matches,405.0,es ESP,DF,29.0,15.7,1063.0,979.0,82.0,43.0,0.0,18.0,0.0,0.0,0.0,0.0,0.0,0.0,947.0,2.0,1.0,Matches,405.0,es ESP,DF,29.0,15.7,947.0,1063.0,89.1,19277.0,6374.0,317.0,342.0,92.7,426.0,448.0,95.1,173.0,235.0,73.6,0.0,0.0,0.2,0.0,2.0,30.0,2.0,0.0,27.0,Matches,521,es ESP,DF,29,18,1413.0,79.0,41.3,15.7,16,85.0,13,2,27.0,17,2.28,30.0,7.0,23.0,1.46,1.15,24.1,16.9,7.2,0.46,0.34,Matches,405.0,es ESP,DF,29.0,15.7,1181.0,214.0,709.0,469.0,8.0,0.0,1181.0,3.0,2.0,66.7,1.0,33.3,648.0,3007.0,1314.0,0.0,0.0,0.0,4.0,0.0,813.0,3.0,Matches,405.0,es ESP,DF,29.0,15.7,0.0,2.0,1.0,50.0,0.13,0.06,0.0,0.0,21.9,0.0,0.0,0.0,0.1,0.1,0.06,-0.1,-0.1,Matches,405.0,es ESP,DF,29.0,18.0,16.0,1413.0,15.7,0.0,0.0,0.0,0.0,0.0,0.0,1.0,0.0,0.1,0.1,0.0,0.2,0.0,27.0,3.0,0.0,0.0,0.0,0.0,0.0,0.01,0.0,0.01,0.01,0.01,Matches,Patric,D C,29,141,146,Spain,S.S. Lazio,4,10,11,5,13,4,14,3,4,14,13,6,16,14,19,18,19,12,12,14,13,16,14,13,13,12,17,17,13,14,13,11,15,14,13,14,13,14,14,7,17,3,3,1,2,2,3,1,1,2,1,3,16,16,4,17,8,16,10,10,1,12,20,14,10,12,1,10,1,10,1,1,9,1,184,72,11,20,10642250,7050,6950,5500,Mediterranean_Hispanic,140,2,1993/4/17,0,0,35577.0,,67100019
1291,Rui Patrício,Roma,1988,406.0,pt POR,GK,34.0,35.0,1.0,1.0,1.0,0.0,0.0,1.0,1.0,100.0,0.0,0.0,0.0,0.0,2.0,3.0,6.0,3.0,Matches,406.0,pt POR,GK,34.0,35.0,2.0,0.06,0.0,1.0,0.0,0.0,0.0,1.0,0.0,0.0,0.0,0.0,0.0,0.0,0.0,0.0,Matches,25.0,pt POR,GK,34.0,35.0,35.0,2.0,1.0,4.0,1.0,27.6,0.23,-6.4,-0.18,135.0,328.0,41.2,644.0,121.0,37.6,33.6,240.0,35.8,34.8,402.0,16.0,4.0,25.0,0.71,13.8,Matches,25.0,pt POR,GK,34.0,35.0,35.0,3150.0,35.0,35.0,1.0,108.0,73.0,69.4,17.0,8.0,10.0,13.0,37.1,3.0,2.0,1.0,0.0,33.3,Matches,406.0,pt POR,GK,34.0,35.0,1.0,0.0,0.0,1.0,0.0,0.0,0.0,2.0,1.0,0.0,1.0,0.0,37.0,2.0,0.0,100.0,Matches,406.0,pt POR,GK,34.0,35.0,887.0,580.0,304.0,64.0,0.0,0.0,0.0,0.0,0.0,0.0,0.0,0.0,677.0,3.0,0.0,Matches,406.0,pt POR,GK,34.0,35.0,677.0,887.0,76.3,18489.0,12522.0,130.0,130.0,100.0,310.0,313.0,99.0,235.0,439.0,53.5,0.0,0.0,0.0,0.0,0.0,7.0,0.0,0.0,0.0,Matches,522,pt POR,GK,34,35,3150.0,90.0,92.1,35.0,35,90.0,35,0,,1,1.69,47.0,35.0,12.0,0.34,0.34,52.8,28.4,24.4,0.7,0.38,Matches,406.0,pt POR,GK,34.0,35.0,932.0,839.0,930.0,2.0,0.0,0.0,932.0,0.0,0.0,,0.0,,497.0,2728.0,1483.0,0.0,0.0,0.0,2.0,0.0,381.0,0.0,Matches,406.0,pt POR,GK,34.0,35.0,0.0,0.0,0.0,,0.0,0.0,,,,0.0,0.0,0.0,0.0,0.0,,0.0,0.0,Matches,406.0,pt POR,GK,34.0,35.0,35.0,3150.0,35.0,0.0,0.0,0.0,0.0,0.0,0.0,1.0,0.0,0.0,0.0,0.0,0.0,0.0,0.0,0.0,0.0,0.0,0.0,0.0,0.0,0.0,0.0,0.0,0.0,0.0,Matches,Rui Patrício,GK,34,147,157,Portugal,Associazione Sportiva Roma,1,3,5,2,9,2,8,1,12,1,11,4,3,8,12,13,12,14,15,5,13,18,11,14,11,15,13,14,11,14,16,16,16,10,12,14,16,7,15,8,14,16,9,16,6,16,11,17,17,5,12,14,17,18,5,8,15,18,18,17,20,1,1,1,1,1,1,1,1,1,1,1,1,1,190,84,20,6,347975206,7342,7242,6142,Northern_European,147,1,1988/2/15,104,0,66537.0,,55000929
1292,Pedro,Lazio,1987,407.0,es ESP,FW,35.0,21.1,35.0,24.0,14.0,10.0,11.0,11.0,30.0,36.7,19.0,18.0,2.0,16.0,6.0,41.0,4.0,1.0,Matches,407.0,es ESP,FW,35.0,21.1,53.0,2.52,36.0,1.0,6.0,6.0,2.0,2.0,7.0,0.33,5.0,0.0,0.0,1.0,1.0,0.0,Matches,,,,,,,,,,,,,,,,,,,,,,,,,,,,,,,,,,,,,,,,,,,,,,,,,,,,,,,,407.0,es ESP,FW,35.0,21.1,1.0,0.0,0.0,26.0,30.0,5.0,34.0,6.0,24.0,1.0,0.0,0.0,89.0,1.0,5.0,16.7,Matches,407.0,es ESP,FW,35.0,21.1,950.0,919.0,26.0,10.0,2.0,10.0,34.0,12.0,3.0,2.0,0.0,0.0,771.0,5.0,18.0,Matches,407.0,es ESP,FW,35.0,21.1,771.0,950.0,81.2,10609.0,2051.0,473.0,524.0,90.3,216.0,280.0,77.1,37.0,69.0,53.6,3.0,2.6,2.0,0.4,23.0,36.0,23.0,3.0,52.0,Matches,524,es ESP,FW,35,36,1898.0,53.0,55.5,21.1,17,73.0,2,19,35.0,0,1.89,33.0,20.0,13.0,0.62,-0.39,28.4,20.1,8.3,0.4,0.31,Matches,407.0,es ESP,FW,35.0,21.1,1171.0,11.0,145.0,588.0,450.0,79.0,1171.0,68.0,32.0,47.1,27.0,39.7,749.0,4207.0,1952.0,64.0,42.0,20.0,48.0,28.0,933.0,144.0,Matches,407.0,es ESP,FW,35.0,21.1,4.0,42.0,16.0,38.1,1.99,0.76,0.1,0.25,19.3,0.0,0.0,0.0,3.4,3.4,0.08,0.6,0.6,Matches,407.0,es ESP,FW,35.0,36.0,17.0,1898.0,21.1,4.0,3.0,7.0,4.0,0.0,0.0,1.0,0.0,3.4,3.4,2.6,6.1,64.0,52.0,144.0,0.19,0.14,0.33,0.19,0.33,0.16,0.13,0.29,0.16,0.29,Matches,Pedro,AM RLC,34,149,165,Spain,S.S. Lazio,12,12,16,15,17,10,6,16,3,4,12,13,5,16,14,15,12,13,13,13,15,20,18,8,17,5,14,17,14,17,15,6,20,14,10,7,13,7,16,10,17,2,2,3,1,2,2,1,2,2,1,4,17,20,5,14,15,20,12,17,1,1,1,1,1,1,1,10,1,10,20,17,20,12,167,66,17,20,2315029,7450,7500,7000,Mediterranean_Hispanic,149,6,1987/7/28,65,17,61731.0,,1510305
1293,Lorenzo Pellegrini,Roma,1996,410.0,it ITA,MF,26.0,28.3,52.0,29.0,24.0,24.0,4.0,22.0,48.0,45.8,26.0,27.0,4.0,23.0,26.0,78.0,22.0,0.0,Matches,410.0,it ITA,MF,26.0,28.3,132.0,4.67,64.0,49.0,3.0,9.0,6.0,1.0,10.0,0.35,2.0,6.0,0.0,2.0,0.0,0.0,Matches,,,,,,,,,,,,,,,,,,,,,,,,,,,,,,,,,,,,,,,,,,,,,,,,,,,,,,,,410.0,it ITA,MF,26.0,28.3,5.0,0.0,0.0,25.0,57.0,5.0,162.0,26.0,29.0,0.0,0.0,0.0,130.0,12.0,24.0,33.3,Matches,410.0,it ITA,MF,26.0,28.3,1114.0,908.0,205.0,86.0,12.0,10.0,162.0,6.0,100.0,45.0,51.0,0.0,816.0,1.0,24.0,Matches,410.0,it ITA,MF,26.0,28.3,816.0,1114.0,73.2,14299.0,4489.0,390.0,452.0,86.3,275.0,352.0,78.1,118.0,238.0,49.6,5.0,6.9,6.2,-1.9,70.0,62.0,23.0,3.0,106.0,Matches,527,it ITA,MF,26,32,2545.0,80.0,74.4,28.3,29,85.0,14,3,29.0,3,1.72,35.0,26.0,9.0,0.32,0.01,44.3,20.6,23.7,0.84,0.67,Matches,410.0,it ITA,MF,26.0,28.3,1461.0,32.0,186.0,743.0,548.0,52.0,1458.0,76.0,32.0,42.1,34.0,44.7,788.0,4744.0,2021.0,58.0,39.0,5.0,53.0,36.0,913.0,113.0,Matches,410.0,it ITA,MF,26.0,28.3,4.0,62.0,17.0,27.4,2.19,0.6,0.03,0.12,21.5,9.0,2.0,3.0,8.0,5.7,0.09,-4.0,-3.7,Matches,410.0,it ITA,MF,26.0,32.0,29.0,2545.0,28.3,4.0,5.0,9.0,2.0,2.0,3.0,5.0,0.0,8.0,5.7,6.9,12.5,58.0,106.0,113.0,0.14,0.18,0.32,0.07,0.25,0.28,0.24,0.53,0.2,0.44,Matches,Lorenzo Pellegrini,DM/M/AM C,26,155,162,Italy,Associazione Sportiva Roma,16,16,14,12,17,16,9,12,4,11,14,12,11,16,13,15,14,12,11,16,12,15,16,13,16,11,18,16,13,15,11,10,15,12,15,10,16,13,13,12,14,1,1,1,1,3,1,1,1,3,1,1,9,15,8,20,16,18,13,12,1,1,1,1,1,1,17,1,20,1,10,20,1,1,186,77,14,20,140095310,7750,7500,6750,Mediterranean_Hispanic,151,4,1996/6/19,23,5,142499.0,,43094100
1294,Roberto Pereyra,Udinese,1991,413.0,ar ARG,DFMF,31.0,31.3,36.0,20.0,21.0,12.0,3.0,16.0,44.0,36.4,28.0,20.0,5.0,15.0,16.0,52.0,28.0,0.0,Matches,413.0,ar ARG,DFMF,31.0,31.3,104.0,3.31,91.0,0.0,7.0,5.0,1.0,0.0,10.0,0.32,10.0,0.0,0.0,0.0,0.0,0.0,Matches,,,,,,,,,,,,,,,,,,,,,,,,,,,,,,,,,,,,,,,,,,,,,,,,,,,,,,,,413.0,ar ARG,DFMF,31.0,31.3,7.0,0.0,0.0,31.0,47.0,2.0,71.0,16.0,20.0,0.0,1.0,0.0,160.0,3.0,9.0,25.0,Matches,413.0,ar ARG,DFMF,31.0,31.3,1277.0,1174.0,99.0,31.0,1.0,7.0,71.0,57.0,4.0,2.0,1.0,0.0,1038.0,4.0,40.0,Matches,413.0,ar ARG,DFMF,31.0,31.3,1038.0,1277.0,81.3,15942.0,5060.0,561.0,611.0,91.8,377.0,460.0,82.0,61.0,104.0,58.7,7.0,5.5,5.7,1.5,49.0,86.0,49.0,14.0,143.0,Matches,530,ar ARG,DFMF,31,34,2820.0,83.0,82.5,31.3,33,84.0,20,1,32.0,2,1.21,41.0,42.0,-1.0,-0.03,-0.03,37.7,42.7,-5.0,-0.16,-0.18,Matches,413.0,ar ARG,DFMF,31.0,31.3,1602.0,53.0,323.0,722.0,583.0,102.0,1601.0,101.0,39.0,38.6,51.0,50.5,984.0,5692.0,2599.0,66.0,43.0,16.0,53.0,37.0,1102.0,186.0,Matches,413.0,ar ARG,DFMF,31.0,31.3,5.0,41.0,16.0,39.0,1.31,0.51,0.12,0.31,17.0,1.0,0.0,1.0,4.7,3.9,0.1,0.3,1.1,Matches,413.0,ar ARG,DFMF,31.0,34.0,33.0,2820.0,31.3,5.0,7.0,12.0,5.0,0.0,1.0,7.0,0.0,4.7,3.9,5.5,9.5,66.0,143.0,186.0,0.16,0.22,0.38,0.16,0.38,0.15,0.18,0.33,0.13,0.3,Matches,Roberto Pereyra,WB/M/AM RC,31,142,150,Argentina,Udinese Calcio,13,14,14,12,14,13,6,12,3,8,15,14,9,15,11,14,10,14,10,15,14,15,14,8,14,8,15,15,12,14,13,8,13,12,12,12,13,10,15,13,16,2,3,3,1,3,3,4,3,3,3,1,15,15,7,9,14,12,13,11,1,1,1,12,3,19,1,12,20,17,13,19,13,1,182,77,12,20,5489584,7100,6750,5500,Mediterranean_Hispanic,132,10,1991/1/7,19,2,24615.0,,14021900
1295,Nehuén Pérez,Udinese,2000,414.0,ar ARG,DF,22.0,31.3,77.0,40.0,54.0,20.0,3.0,39.0,55.0,70.9,16.0,53.0,23.0,30.0,35.0,112.0,106.0,1.0,Matches,414.0,ar ARG,DF,22.0,31.3,28.0,0.89,24.0,2.0,0.0,1.0,0.0,1.0,1.0,0.03,1.0,0.0,0.0,0.0,0.0,0.0,Matches,,,,,,,,,,,,,,,,,,,,,,,,,,,,,,,,,,,,,,,,,,,,,,,,,,,,,,,,414.0,ar ARG,DF,22.0,31.3,7.0,1.0,0.0,29.0,11.0,0.0,18.0,35.0,40.0,0.0,0.0,1.0,146.0,35.0,22.0,61.4,Matches,414.0,ar ARG,DF,22.0,31.3,1807.0,1621.0,184.0,57.0,0.0,63.0,18.0,120.0,0.0,0.0,0.0,0.0,1538.0,2.0,13.0,Matches,414.0,ar ARG,DF,22.0,31.3,1538.0,1807.0,85.1,30754.0,10954.0,557.0,598.0,93.1,730.0,810.0,90.1,224.0,352.0,63.6,0.0,0.5,0.5,-0.5,10.0,107.0,8.0,3.0,101.0,Matches,531,ar ARG,DF,22,34,2818.0,83.0,82.4,31.3,33,85.0,24,1,13.0,0,1.18,38.0,39.0,-1.0,-0.03,-0.03,37.9,43.2,-5.3,-0.17,-0.23,Matches,414.0,ar ARG,DF,22.0,31.3,2136.0,248.0,1051.0,947.0,153.0,21.0,2136.0,11.0,5.0,45.5,6.0,54.5,1217.0,6225.0,3638.0,23.0,24.0,1.0,15.0,9.0,1379.0,26.0,Matches,414.0,ar ARG,DF,22.0,31.3,2.0,16.0,8.0,50.0,0.51,0.26,0.13,0.25,18.9,0.0,0.0,0.0,1.0,1.0,0.06,1.0,1.0,Matches,414.0,ar ARG,DF,22.0,34.0,33.0,2818.0,31.3,2.0,0.0,2.0,2.0,0.0,0.0,7.0,1.0,1.0,1.0,0.5,1.5,23.0,101.0,26.0,0.06,0.0,0.06,0.06,0.06,0.03,0.02,0.05,0.03,0.05,Matches,Nehuén Pérez,D C,22,130,155,Argentina,Udinese Calcio,4,6,6,6,10,5,14,8,13,14,12,5,15,10,17,15,15,15,15,12,10,17,5,10,7,14,14,13,14,14,14,13,14,14,14,12,13,14,14,3,5,3,2,2,1,3,3,3,3,2,2,3,15,18,12,10,18,18,9,10,1,1,20,1,1,1,1,1,1,1,1,1,1,1,184,76,10,20,8872000,6500,6600,5200,Mediterranean_Hispanic,131,11,2000/6/24,0,0,24439.0,,14181374
1296,Mattia Perin,Juventus,1992,416.0,it ITA,GK,29.0,10.5,0.0,0.0,0.0,0.0,0.0,0.0,0.0,,0.0,0.0,0.0,0.0,0.0,0.0,0.0,0.0,Matches,416.0,it ITA,GK,29.0,10.5,0.0,0.0,0.0,0.0,0.0,0.0,0.0,0.0,0.0,0.0,0.0,0.0,0.0,0.0,0.0,0.0,Matches,28.0,it ITA,GK,29.0,10.5,7.0,1.0,0.0,1.0,0.0,11.2,0.23,4.2,0.39,32.0,107.0,29.9,287.0,54.0,28.6,30.8,63.0,39.7,35.9,154.0,4.0,2.6,11.0,1.04,15.7,Matches,28.0,it ITA,GK,29.0,11.0,10.0,948.0,10.5,7.0,0.66,40.0,32.0,85.0,5.0,3.0,2.0,6.0,60.0,2.0,1.0,1.0,0.0,50.0,Matches,416.0,it ITA,GK,29.0,10.5,0.0,0.0,0.0,0.0,1.0,0.0,0.0,0.0,0.0,0.0,0.0,0.0,18.0,2.0,0.0,100.0,Matches,416.0,it ITA,GK,29.0,10.5,351.0,267.0,83.0,20.0,0.0,1.0,0.0,0.0,0.0,0.0,0.0,0.0,265.0,1.0,0.0,Matches,416.0,it ITA,GK,29.0,10.5,265.0,351.0,75.5,6305.0,4120.0,64.0,65.0,98.5,148.0,148.0,100.0,53.0,137.0,38.7,0.0,0.0,0.0,0.0,0.0,6.0,0.0,0.0,1.0,Matches,533,it ITA,GK,29,11,948.0,86.0,27.7,10.5,10,90.0,10,1,48.0,26,1.91,16.0,7.0,9.0,0.85,0.34,14.8,12.4,2.4,0.23,-0.18,Matches,416.0,it ITA,GK,29.0,10.5,362.0,329.0,359.0,3.0,0.0,0.0,362.0,0.0,0.0,,0.0,,230.0,1152.0,801.0,0.0,0.0,0.0,0.0,0.0,185.0,0.0,Matches,416.0,it ITA,GK,29.0,10.5,0.0,0.0,0.0,,0.0,0.0,,,,0.0,0.0,0.0,0.0,0.0,,0.0,0.0,Matches,416.0,it ITA,GK,29.0,11.0,10.0,948.0,10.5,0.0,0.0,0.0,0.0,0.0,0.0,0.0,0.0,0.0,0.0,0.0,0.0,0.0,1.0,0.0,0.0,0.0,0.0,0.0,0.0,0.0,0.0,0.0,0.0,0.0,Matches,Mattia Perin,GK,29,140,150,Italy,Juventus,5,5,5,5,7,5,5,5,5,5,7,5,1,7,10,12,17,11,13,6,12,15,3,12,2,14,10,11,12,15,13,15,8,11,10,11,15,5,9,15,1,13,13,14,17,15,11,15,17,15,9,14,14,14,13,15,13,13,11,14,20,1,1,1,1,1,1,1,1,1,1,1,1,1,188,74,7,20,6858591,7000,6750,5500,Mediterranean_Hispanic,137,3,1992/11/10,2,0,53462.0,,43044345
1297,Matteo Pessina,Monza,1997,418.0,it ITA,MF,25.0,32.6,57.0,36.0,28.0,21.0,8.0,26.0,62.0,41.9,36.0,50.0,15.0,35.0,37.0,94.0,33.0,1.0,Matches,418.0,it ITA,MF,25.0,32.6,69.0,2.12,57.0,1.0,2.0,0.0,7.0,2.0,11.0,0.34,9.0,0.0,1.0,0.0,1.0,0.0,Matches,,,,,,,,,,,,,,,,,,,,,,,,,,,,,,,,,,,,,,,,,,,,,,,,,,,,,,,,418.0,it ITA,MF,25.0,32.6,6.0,0.0,0.0,41.0,53.0,1.0,36.0,37.0,36.0,0.0,0.0,0.0,225.0,38.0,35.0,52.1,Matches,418.0,it ITA,MF,25.0,32.6,2025.0,1919.0,94.0,66.0,2.0,10.0,36.0,10.0,15.0,0.0,12.0,0.0,1719.0,12.0,43.0,Matches,418.0,it ITA,MF,25.0,32.6,1719.0,2025.0,84.9,28932.0,8199.0,807.0,896.0,90.1,731.0,813.0,89.9,134.0,190.0,70.5,3.0,2.1,2.7,0.9,22.0,150.0,36.0,3.0,193.0,Matches,535,it ITA,MF,25,35,2932.0,84.0,85.7,32.6,34,85.0,25,1,30.0,1,1.49,44.0,43.0,1.0,0.03,0.95,40.3,43.4,-3.1,-0.09,0.34,Matches,418.0,it ITA,MF,25.0,32.6,2378.0,87.0,587.0,1333.0,484.0,51.0,2375.0,58.0,34.0,58.6,19.0,32.8,1434.0,8205.0,3834.0,77.0,45.0,6.0,62.0,35.0,1704.0,88.0,Matches,418.0,it ITA,MF,25.0,32.6,5.0,25.0,6.0,24.0,0.77,0.18,0.08,0.33,19.2,0.0,3.0,3.0,5.1,2.8,0.11,-0.1,-0.8,Matches,418.0,it ITA,MF,25.0,35.0,34.0,2932.0,32.6,5.0,3.0,8.0,2.0,3.0,3.0,6.0,0.0,5.1,2.8,2.1,4.9,77.0,193.0,88.0,0.15,0.09,0.25,0.06,0.15,0.16,0.06,0.22,0.08,0.15,Matches,Matteo Pessina,M/AM C,25,137,150,Italy,Atalanta,8,12,14,12,14,7,12,11,4,9,14,10,12,14,15,13,15,13,14,13,12,17,14,10,16,11,15,17,14,12,14,13,13,14,15,12,13,12,13,6,15,1,2,2,1,1,1,3,3,3,3,1,15,16,8,14,16,17,13,13,1,1,1,1,1,1,14,5,20,7,10,20,11,7,187,75,20,10,8488460,6850,7000,6100,Mediterranean_Hispanic,135,2,1997/4/21,14,4,35577.0,Brianza,43155796
1298,Andrea Petagna,Monza,1995,419.0,it ITA,FW,27.0,18.5,7.0,5.0,2.0,3.0,2.0,3.0,6.0,50.0,3.0,16.0,4.0,12.0,3.0,10.0,18.0,0.0,Matches,419.0,it ITA,FW,27.0,18.5,41.0,2.22,32.0,0.0,4.0,4.0,1.0,0.0,7.0,0.38,3.0,0.0,2.0,1.0,1.0,0.0,Matches,,,,,,,,,,,,,,,,,,,,,,,,,,,,,,,,,,,,,,,,,,,,,,,,,,,,,,,,419.0,it ITA,FW,27.0,18.5,2.0,0.0,0.0,29.0,30.0,10.0,3.0,3.0,5.0,1.0,1.0,0.0,46.0,39.0,36.0,52.0,Matches,419.0,it ITA,FW,27.0,18.5,434.0,387.0,41.0,0.0,4.0,10.0,3.0,1.0,0.0,0.0,0.0,0.0,316.0,6.0,9.0,Matches,419.0,it ITA,FW,27.0,18.5,316.0,434.0,72.8,4500.0,728.0,193.0,237.0,81.4,85.0,122.0,69.7,17.0,27.0,63.0,5.0,4.4,2.0,0.6,30.0,20.0,10.0,0.0,34.0,Matches,536,it ITA,FW,27,31,1663.0,54.0,48.6,18.5,19,70.0,2,12,27.0,2,1.23,23.0,32.0,-9.0,-0.49,-0.74,22.4,27.2,-4.8,-0.26,-0.23,Matches,419.0,it ITA,FW,27.0,18.5,641.0,21.0,47.0,343.0,256.0,88.0,640.0,37.0,20.0,54.1,11.0,29.7,373.0,2180.0,657.0,23.0,13.0,11.0,64.0,43.0,497.0,132.0,Matches,419.0,it ITA,FW,27.0,18.5,4.0,35.0,12.0,34.3,1.89,0.65,0.09,0.25,13.2,0.0,1.0,1.0,5.7,4.9,0.14,-1.7,-1.9,Matches,419.0,it ITA,FW,27.0,31.0,19.0,1663.0,18.5,4.0,5.0,9.0,3.0,1.0,1.0,2.0,0.0,5.7,4.9,4.4,9.3,23.0,34.0,132.0,0.22,0.27,0.49,0.16,0.43,0.31,0.24,0.54,0.26,0.5,Matches,Andrea Petagna,S,27,132,145,Italy,Parthenope,3,8,12,13,12,6,16,11,4,5,13,14,9,14,13,13,16,12,13,14,12,13,12,11,13,7,18,15,12,11,18,15,15,13,12,18,12,9,10,8,8,1,1,2,1,3,2,3,3,1,4,2,12,14,5,12,10,16,15,14,1,1,1,1,1,1,1,1,1,1,1,1,1,20,190,85,20,10,2375105,6600,6600,5850,Mediterranean_Hispanic,131,6,1995/6/30,1,0,64038.0,Brianza,43091160
1299,Giuseppe Pezzella,Lecce,1997,420.0,it ITA,DF,24.0,10.2,21.0,9.0,16.0,2.0,3.0,9.0,16.0,56.3,7.0,11.0,3.0,8.0,8.0,29.0,31.0,1.0,Matches,420.0,it ITA,DF,24.0,10.2,17.0,1.66,14.0,2.0,0.0,0.0,1.0,0.0,3.0,0.29,3.0,0.0,0.0,0.0,0.0,0.0,Matches,,,,,,,,,,,,,,,,,,,,,,,,,,,,,,,,,,,,,,,,,,,,,,,,,,,,,,,,420.0,it ITA,DF,24.0,10.2,2.0,0.0,0.0,16.0,11.0,1.0,34.0,8.0,9.0,0.0,0.0,0.0,49.0,11.0,8.0,57.9,Matches,420.0,it ITA,DF,24.0,10.2,534.0,410.0,123.0,13.0,0.0,3.0,34.0,109.0,1.0,0.0,1.0,0.0,419.0,1.0,16.0,Matches,420.0,it ITA,DF,24.0,10.2,419.0,534.0,78.5,6752.0,2619.0,209.0,238.0,87.8,176.0,215.0,81.9,25.0,55.0,45.5,1.0,0.6,0.3,0.4,7.0,44.0,10.0,4.0,65.0,Matches,537,it ITA,DF,24,16,918.0,57.0,26.8,10.2,10,80.0,5,6,20.0,18,0.75,10.0,18.0,-8.0,-0.78,-0.6,10.1,14.7,-4.5,-0.44,-0.39,Matches,420.0,it ITA,DF,24.0,10.2,649.0,41.0,217.0,253.0,185.0,11.0,649.0,19.0,7.0,36.8,9.0,47.4,320.0,2060.0,1151.0,28.0,16.0,3.0,12.0,11.0,334.0,48.0,Matches,420.0,it ITA,DF,24.0,10.2,0.0,4.0,0.0,0.0,0.39,0.0,0.0,,20.7,0.0,0.0,0.0,0.1,0.1,0.04,-0.1,-0.1,Matches,420.0,it ITA,DF,24.0,16.0,10.0,918.0,10.2,0.0,1.0,1.0,0.0,0.0,0.0,2.0,0.0,0.1,0.1,0.6,0.7,28.0,65.0,48.0,0.0,0.1,0.1,0.0,0.1,0.01,0.05,0.07,0.01,0.07,Matches,Giuseppe Pezzella,D/WB/M L,24,133,145,Italy,Parma Calcio 1913,9,12,11,7,12,8,11,7,12,12,13,6,14,12,14,12,13,12,13,10,11,17,8,10,13,12,15,15,14,13,14,12,15,14,15,14,14,8,12,3,14,1,3,1,3,3,3,3,1,2,3,3,10,12,5,15,17,17,14,17,1,20,12,10,19,10,1,17,1,1,1,1,1,1,187,81,20,10,4783677,6645,6645,4895,Mediterranean_Hispanic,128,4,1997/11/29,0,0,16009.0,Salento,43161921
1300,Krzysztof Piątek,Salernitana,1995,421.0,pl POL,FW,27.0,23.8,18.0,11.0,3.0,9.0,6.0,5.0,21.0,23.8,16.0,17.0,4.0,13.0,2.0,20.0,39.0,0.0,Matches,421.0,pl POL,FW,27.0,23.8,53.0,2.23,36.0,0.0,5.0,6.0,5.0,1.0,10.0,0.42,6.0,0.0,1.0,3.0,0.0,0.0,Matches,,,,,,,,,,,,,,,,,,,,,,,,,,,,,,,,,,,,,,,,,,,,,,,,,,,,,,,,421.0,pl POL,FW,27.0,23.8,5.0,0.0,0.0,39.0,44.0,22.0,14.0,2.0,11.0,0.0,0.0,0.0,58.0,90.0,115.0,43.9,Matches,421.0,pl POL,FW,27.0,23.8,558.0,501.0,51.0,0.0,0.0,1.0,14.0,2.0,0.0,0.0,0.0,0.0,379.0,6.0,12.0,Matches,421.0,pl POL,FW,27.0,23.8,379.0,558.0,67.9,5117.0,687.0,219.0,293.0,74.7,110.0,158.0,69.6,17.0,33.0,51.5,5.0,2.1,0.8,2.9,22.0,24.0,10.0,0.0,33.0,Matches,539,pl POL,FW,27,33,2140.0,65.0,62.6,23.8,23,79.0,13,10,33.0,1,1.09,33.0,44.0,-11.0,-0.46,-0.25,24.5,43.9,-19.4,-0.81,-0.03,Matches,421.0,pl POL,FW,27.0,23.8,848.0,45.0,83.0,433.0,341.0,84.0,847.0,24.0,10.0,41.7,10.0,41.7,440.0,2049.0,620.0,27.0,17.0,11.0,78.0,35.0,615.0,121.0,Matches,421.0,pl POL,FW,27.0,23.8,4.0,57.0,19.0,33.3,2.4,0.8,0.05,0.16,15.5,1.0,1.0,1.0,8.3,7.6,0.13,-4.3,-4.6,Matches,421.0,pl POL,FW,27.0,33.0,23.0,2140.0,23.8,4.0,5.0,9.0,3.0,1.0,1.0,5.0,0.0,8.3,7.6,2.1,9.7,27.0,33.0,121.0,0.17,0.21,0.38,0.13,0.34,0.35,0.09,0.44,0.32,0.41,Matches,Krzysztof Piątek,S,27,135,145,Poland,Hertha Berlin,6,8,11,16,13,9,14,12,7,6,9,17,9,12,11,17,14,16,15,9,12,13,10,12,15,7,11,11,12,13,16,13,14,12,13,14,12,8,10,4,7,2,1,1,2,1,1,1,3,2,3,2,12,15,9,8,13,15,10,14,1,1,1,1,1,1,1,1,1,1,1,10,1,20,183,77,10,20,11099860,6750,7350,5750,Northern_European,134,1,1995/7/1,23,10,96154.0,U.S. Salernitana 1919,96054420
1301,Charles Pickel,Cremonese,1997,424.0,cd COD,MF,25.0,27.6,55.0,23.0,25.0,26.0,4.0,32.0,57.0,56.1,25.0,37.0,5.0,32.0,24.0,79.0,36.0,1.0,Matches,424.0,cd COD,MF,25.0,27.6,52.0,1.89,49.0,1.0,0.0,2.0,0.0,0.0,2.0,0.07,2.0,0.0,0.0,0.0,0.0,0.0,Matches,,,,,,,,,,,,,,,,,,,,,,,,,,,,,,,,,,,,,,,,,,,,,,,,,,,,,,,,424.0,cd COD,MF,25.0,27.6,8.0,1.0,0.0,34.0,18.0,4.0,11.0,24.0,23.0,0.0,0.0,0.0,163.0,47.0,76.0,38.2,Matches,424.0,cd COD,MF,25.0,27.6,978.0,940.0,34.0,10.0,0.0,0.0,11.0,14.0,0.0,0.0,0.0,0.0,756.0,4.0,21.0,Matches,424.0,cd COD,MF,25.0,27.6,756.0,978.0,77.3,12014.0,3464.0,379.0,459.0,82.6,308.0,369.0,83.5,46.0,85.0,54.1,0.0,1.2,1.1,-1.2,20.0,80.0,15.0,1.0,104.0,Matches,542,cd COD,MF,25,33,2483.0,75.0,72.6,27.6,30,81.0,16,3,22.0,2,0.73,26.0,46.0,-20.0,-0.72,0.52,28.6,44.3,-15.7,-0.57,0.54,Matches,424.0,cd COD,MF,25.0,27.6,1261.0,50.0,270.0,715.0,288.0,44.0,1261.0,18.0,4.0,22.2,10.0,55.6,584.0,2332.0,1067.0,18.0,21.0,1.0,34.0,18.0,691.0,61.0,Matches,424.0,cd COD,MF,25.0,27.6,1.0,23.0,7.0,30.4,0.83,0.25,0.04,0.14,15.9,0.0,0.0,0.0,1.6,1.6,0.07,-0.6,-0.6,Matches,424.0,cd COD,MF,25.0,33.0,30.0,2483.0,27.6,1.0,0.0,1.0,1.0,0.0,0.0,8.0,1.0,1.6,1.6,1.2,2.8,18.0,104.0,61.0,0.04,0.0,0.04,0.04,0.04,0.06,0.04,0.1,0.06,0.1,Matches,Charles Pickel,DM/M C,25,127,135,Switzerland,Cremonese,7,9,10,7,12,9,11,12,8,13,13,8,14,13,15,12,12,10,14,11,14,12,8,10,12,15,14,13,11,12,12,13,15,12,15,13,13,11,11,7,18,1,3,3,1,1,2,1,3,3,3,2,13,13,6,8,13,11,13,20,1,1,14,12,1,1,20,1,20,1,1,1,1,1,184,76,12,20,8934601,6350,6350,4250,African_Caribbean,126,12,1997/5/15,0,0,19751.0,,98033713
1302,Andrea Pinamonti,Sassuolo,1999,425.0,it ITA,FW,23.0,24.0,10.0,7.0,0.0,5.0,5.0,3.0,7.0,42.9,4.0,19.0,2.0,17.0,2.0,12.0,11.0,0.0,Matches,425.0,it ITA,FW,23.0,24.0,53.0,2.21,34.0,0.0,1.0,10.0,7.0,1.0,3.0,0.12,0.0,0.0,0.0,2.0,1.0,0.0,Matches,,,,,,,,,,,,,,,,,,,,,,,,,,,,,,,,,,,,,,,,,,,,,,,,,,,,,,,,425.0,it ITA,FW,23.0,24.0,3.0,1.0,0.0,21.0,31.0,8.0,14.0,2.0,7.0,1.0,0.0,0.0,32.0,36.0,79.0,31.3,Matches,425.0,it ITA,FW,23.0,24.0,496.0,441.0,54.0,0.0,1.0,3.0,14.0,0.0,0.0,0.0,0.0,0.0,324.0,1.0,22.0,Matches,425.0,it ITA,FW,23.0,24.0,324.0,496.0,65.3,3971.0,594.0,216.0,285.0,75.8,68.0,117.0,58.1,12.0,23.0,52.2,0.0,1.5,1.6,-1.5,17.0,15.0,14.0,2.0,29.0,Matches,544,it ITA,FW,23,32,2161.0,68.0,63.2,24.0,25,77.0,8,7,32.0,0,1.16,29.0,32.0,-3.0,-0.12,0.66,34.8,28.8,6.0,0.25,0.55,Matches,425.0,it ITA,FW,23.0,24.0,738.0,11.0,26.0,351.0,367.0,120.0,737.0,30.0,10.0,33.3,17.0,56.7,383.0,1470.0,443.0,17.0,11.0,11.0,60.0,56.0,567.0,166.0,Matches,425.0,it ITA,FW,23.0,24.0,5.0,66.0,21.0,31.8,2.75,0.87,0.06,0.19,15.3,0.0,1.0,1.0,7.1,6.3,0.1,-2.1,-2.3,Matches,425.0,it ITA,FW,23.0,32.0,25.0,2161.0,24.0,5.0,0.0,5.0,4.0,1.0,1.0,3.0,1.0,7.1,6.3,1.5,7.8,17.0,29.0,166.0,0.21,0.0,0.21,0.17,0.17,0.3,0.06,0.36,0.26,0.32,Matches,Andrea Pinamonti,S,23,136,153,Italy,FC Internazionale Milano,5,7,11,14,13,7,14,13,5,5,11,14,6,14,5,12,13,14,11,11,13,12,12,8,15,5,13,14,14,13,14,14,14,14,14,15,12,5,11,5,9,1,2,2,1,1,3,3,2,2,2,1,12,13,5,12,11,14,12,10,1,1,1,1,1,1,1,1,1,1,1,1,1,20,185,75,12,20,20000000,6800,6750,5300,Northern_European,135,2,1999/5/19,0,0,71154.0,U.S. Sassuolo,43252773
1303,Lorenzo Pirola,Salernitana,2002,426.0,it ITA,DF,20.0,21.6,33.0,29.0,18.0,14.0,1.0,19.0,27.0,70.4,8.0,50.0,35.0,15.0,30.0,63.0,85.0,1.0,Matches,426.0,it ITA,DF,20.0,21.6,11.0,0.51,5.0,1.0,0.0,4.0,1.0,0.0,1.0,0.05,0.0,0.0,0.0,1.0,0.0,0.0,Matches,,,,,,,,,,,,,,,,,,,,,,,,,,,,,,,,,,,,,,,,,,,,,,,,,,,,,,,,426.0,it ITA,DF,20.0,21.6,4.0,0.0,0.0,28.0,9.0,0.0,1.0,30.0,29.0,0.0,0.0,0.0,83.0,48.0,39.0,55.2,Matches,426.0,it ITA,DF,20.0,21.6,989.0,952.0,31.0,26.0,0.0,2.0,1.0,5.0,0.0,0.0,0.0,0.0,790.0,6.0,13.0,Matches,426.0,it ITA,DF,20.0,21.6,790.0,989.0,79.9,14168.0,5069.0,320.0,355.0,90.1,399.0,470.0,84.9,65.0,127.0,51.2,0.0,0.4,0.4,-0.4,3.0,43.0,4.0,0.0,43.0,Matches,546,it ITA,DF,20,26,1941.0,75.0,56.8,21.6,23,82.0,12,3,22.0,11,1.12,25.0,38.0,-13.0,-0.6,-0.54,17.2,35.2,-18.0,-0.83,-0.07,Matches,426.0,it ITA,DF,20.0,21.6,1235.0,169.0,719.0,472.0,51.0,19.0,1235.0,8.0,5.0,62.5,3.0,37.5,641.0,2541.0,1280.0,13.0,12.0,0.0,12.0,2.0,771.0,4.0,Matches,426.0,it ITA,DF,20.0,21.6,2.0,13.0,2.0,15.4,0.6,0.09,0.15,1.0,11.5,0.0,0.0,0.0,1.5,1.5,0.11,0.5,0.5,Matches,426.0,it ITA,DF,20.0,26.0,23.0,1941.0,21.6,2.0,0.0,2.0,2.0,0.0,0.0,4.0,0.0,1.5,1.5,0.4,1.9,13.0,43.0,4.0,0.09,0.0,0.09,0.09,0.09,0.07,0.02,0.09,0.07,0.09,Matches,Lorenzo Pirola,D C,20,113,-75,Italy,FC Internazionale Milano,3,8,7,8,11,3,13,4,5,13,12,4,13,12,10,13,12,11,11,12,11,15,8,10,8,12,12,13,13,12,13,13,16,13,12,14,13,8,11,3,10,2,2,2,1,3,3,3,2,4,3,3,12,14,3,12,13,14,11,7,1,12,20,1,1,1,1,1,1,1,1,1,1,1,185,78,20,9,50240000,5645,5645,3009,Mediterranean_Hispanic,112,2,2002/2/20,0,0,7871.0,U.S. Salernitana 1919,43425720
1304,Matteo Politano,Napoli,1993,431.0,it ITA,FW,28.0,13.0,18.0,9.0,9.0,5.0,4.0,11.0,25.0,44.0,14.0,6.0,0.0,6.0,7.0,25.0,7.0,0.0,Matches,431.0,it ITA,FW,28.0,13.0,71.0,5.48,45.0,8.0,8.0,6.0,4.0,0.0,4.0,0.31,3.0,0.0,0.0,1.0,0.0,0.0,Matches,,,,,,,,,,,,,,,,,,,,,,,,,,,,,,,,,,,,,,,,,,,,,,,,,,,,,,,,431.0,it ITA,FW,28.0,13.0,1.0,0.0,0.0,11.0,22.0,1.0,82.0,7.0,9.0,0.0,0.0,0.0,66.0,3.0,6.0,33.3,Matches,431.0,it ITA,FW,28.0,13.0,641.0,571.0,64.0,13.0,2.0,8.0,82.0,19.0,32.0,18.0,3.0,0.0,468.0,6.0,24.0,Matches,431.0,it ITA,FW,28.0,13.0,468.0,641.0,73.0,7418.0,2472.0,258.0,290.0,89.0,150.0,202.0,74.3,41.0,89.0,46.1,3.0,3.6,2.4,-0.6,34.0,34.0,27.0,8.0,72.0,Matches,552,it ITA,FW,28,27,1166.0,43.0,34.1,13.0,14,63.0,0,13,22.0,6,2.33,22.0,12.0,10.0,0.77,-0.79,23.8,11.3,12.6,0.97,0.16,Matches,431.0,it ITA,FW,28.0,13.0,798.0,10.0,103.0,267.0,439.0,57.0,795.0,55.0,23.0,41.8,25.0,45.5,523.0,4082.0,2237.0,81.0,38.0,27.0,31.0,11.0,587.0,138.0,Matches,431.0,it ITA,FW,28.0,13.0,3.0,30.0,6.0,20.0,2.32,0.46,0.03,0.17,20.7,1.0,2.0,3.0,4.1,1.7,0.06,-1.1,-0.7,Matches,431.0,it ITA,FW,28.0,27.0,14.0,1166.0,13.0,3.0,3.0,6.0,1.0,2.0,3.0,1.0,0.0,4.1,1.7,3.6,5.4,81.0,72.0,138.0,0.23,0.23,0.46,0.08,0.31,0.32,0.28,0.6,0.13,0.41,Matches,Matteo Politano,AM/S RLC,28,148,153,Italy,Parthenope,16,15,13,13,15,14,8,16,5,6,14,14,7,14,7,14,11,15,12,13,14,14,14,10,15,7,14,13,15,16,12,7,14,14,13,9,12,4,14,7,14,3,3,2,2,2,3,4,3,3,2,3,13,14,2,11,14,15,14,10,1,1,1,1,6,9,1,10,1,14,15,15,20,16,171,65,20,10,25772795,7400,7250,6350,Mediterranean_Hispanic,144,3,1993/8/3,7,3,78269.0,,43093382
1305,Stefan Posch,Bologna,1997,433.0,at AUT,DF,25.0,28.1,81.0,43.0,41.0,29.0,11.0,44.0,75.0,58.7,31.0,44.0,15.0,29.0,35.0,116.0,69.0,0.0,Matches,433.0,at AUT,DF,25.0,28.1,54.0,1.92,41.0,4.0,3.0,1.0,4.0,1.0,4.0,0.14,3.0,0.0,1.0,0.0,0.0,0.0,Matches,,,,,,,,,,,,,,,,,,,,,,,,,,,,,,,,,,,,,,,,,,,,,,,,,,,,,,,,433.0,at AUT,DF,25.0,28.1,6.0,0.0,0.0,47.0,28.0,1.0,49.0,35.0,43.0,0.0,0.0,0.0,157.0,27.0,28.0,49.1,Matches,433.0,at AUT,DF,25.0,28.1,1805.0,1489.0,311.0,35.0,4.0,16.0,49.0,276.0,0.0,0.0,0.0,0.0,1399.0,5.0,45.0,Matches,433.0,at AUT,DF,25.0,28.1,1399.0,1805.0,77.5,24735.0,10680.0,659.0,724.0,91.0,568.0,682.0,83.3,147.0,303.0,48.5,2.0,2.0,1.9,0.0,23.0,112.0,27.0,6.0,148.0,Matches,554,at AUT,DF,25,30,2532.0,84.0,74.0,28.1,30,84.0,21,0,,3,1.63,42.0,34.0,8.0,0.28,0.69,33.8,34.4,-0.7,-0.02,0.4,Matches,433.0,at AUT,DF,25.0,28.1,2145.0,127.0,851.0,955.0,363.0,36.0,2145.0,35.0,13.0,37.1,16.0,45.7,1118.0,5528.0,3091.0,45.0,41.0,3.0,39.0,11.0,1286.0,65.0,Matches,433.0,at AUT,DF,25.0,28.1,6.0,28.0,10.0,35.7,1.0,0.36,0.21,0.6,14.2,1.0,0.0,0.0,3.3,3.3,0.12,2.7,2.7,Matches,433.0,at AUT,DF,25.0,30.0,30.0,2532.0,28.1,6.0,2.0,8.0,6.0,0.0,0.0,6.0,0.0,3.3,3.3,2.0,5.3,45.0,148.0,65.0,0.21,0.07,0.28,0.21,0.28,0.12,0.07,0.19,0.12,0.19,Matches,Stefan Posch,D RC,25,129,138,Austria,TSG Hoffenheim,5,9,9,6,11,5,13,6,10,13,11,9,14,11,8,13,14,16,12,9,13,12,5,10,6,12,16,10,13,13,12,16,14,14,14,12,14,11,16,7,10,3,3,3,3,3,3,1,3,1,4,3,12,15,10,10,16,13,15,18,1,8,20,15,1,11,10,1,7,1,1,1,1,1,189,82,12,20,3178596,6445,6345,4745,Northern_European,128,2,1997/5/14,16,1,21999.0,Bologna FC 1909,16147386
1306,Ivan Provedel,Lazio,1994,434.0,it ITA,GK,28.0,37.9,1.0,0.0,1.0,0.0,0.0,0.0,0.0,,0.0,0.0,0.0,0.0,0.0,1.0,15.0,1.0,Matches,434.0,it ITA,GK,28.0,37.9,7.0,0.18,7.0,0.0,0.0,0.0,0.0,0.0,1.0,0.03,1.0,0.0,0.0,0.0,0.0,0.0,Matches,30.0,it ITA,GK,28.0,37.9,30.0,1.0,0.0,5.0,1.0,31.4,0.25,2.4,0.06,158.0,373.0,42.4,1121.0,166.0,27.4,32.2,198.0,33.3,33.2,493.0,21.0,4.3,55.0,1.45,16.5,Matches,30.0,it ITA,GK,28.0,38.0,37.0,3413.0,37.9,30.0,0.79,128.0,99.0,77.3,21.0,8.0,8.0,21.0,56.8,2.0,1.0,0.0,1.0,0.0,Matches,434.0,it ITA,GK,28.0,37.9,1.0,0.0,0.0,0.0,5.0,0.0,0.0,0.0,0.0,0.0,0.0,0.0,78.0,3.0,1.0,75.0,Matches,434.0,it ITA,GK,28.0,37.9,1323.0,1037.0,282.0,84.0,0.0,9.0,0.0,0.0,0.0,0.0,0.0,0.0,1061.0,4.0,0.0,Matches,434.0,it ITA,GK,28.0,37.9,1061.0,1323.0,80.2,28575.0,20681.0,236.0,237.0,99.6,410.0,421.0,97.4,408.0,654.0,62.4,0.0,0.0,0.1,0.0,1.0,21.0,1.0,0.0,0.0,Matches,556,it ITA,GK,28,38,3413.0,90.0,99.8,37.9,37,90.0,37,1,83.0,0,1.95,60.0,30.0,30.0,0.79,0.79,51.1,41.3,9.8,0.26,-0.45,Matches,434.0,it ITA,GK,28.0,37.9,1405.0,1206.0,1397.0,9.0,0.0,0.0,1405.0,1.0,1.0,100.0,0.0,0.0,845.0,4576.0,2732.0,0.0,0.0,0.0,1.0,0.0,748.0,0.0,Matches,434.0,it ITA,GK,28.0,37.9,0.0,0.0,0.0,,0.0,0.0,,,,0.0,0.0,0.0,0.0,0.0,,0.0,0.0,Matches,434.0,it ITA,GK,28.0,38.0,37.0,3413.0,37.9,0.0,0.0,0.0,0.0,0.0,0.0,1.0,0.0,0.0,0.0,0.0,0.0,0.0,0.0,0.0,0.0,0.0,0.0,0.0,0.0,0.0,0.0,0.0,0.0,0.0,Matches,Ivan Provedel,GK,28,144,150,Italy,S.S. Lazio,3,3,2,2,9,1,1,1,2,1,11,1,3,10,6,13,12,12,13,13,13,16,3,10,7,14,15,15,12,14,12,15,13,12,12,12,15,3,13,4,1,13,13,14,4,15,16,14,17,11,13,13,12,16,10,18,14,17,14,15,20,1,1,1,1,1,1,1,1,1,1,1,1,1,192,84,8,20,11469091,7200,7200,4500,Mediterranean_Hispanic,143,0,1994/3/17,0,0,35577.0,,43094150
1307,Adrien Rabiot,Juventus,1995,439.0,fr FRA,MF,27.0,30.5,65.0,35.0,31.0,23.0,11.0,30.0,57.0,52.6,27.0,37.0,7.0,30.0,26.0,91.0,44.0,1.0,Matches,439.0,fr FRA,MF,27.0,30.5,82.0,2.69,68.0,0.0,3.0,6.0,3.0,2.0,8.0,0.26,5.0,0.0,1.0,1.0,1.0,0.0,Matches,,,,,,,,,,,,,,,,,,,,,,,,,,,,,,,,,,,,,,,,,,,,,,,,,,,,,,,,439.0,fr FRA,MF,27.0,30.5,9.0,0.0,0.0,45.0,42.0,2.0,34.0,26.0,35.0,0.0,0.0,0.0,179.0,50.0,39.0,56.2,Matches,439.0,fr FRA,MF,27.0,30.5,1191.0,1153.0,32.0,16.0,2.0,6.0,34.0,15.0,0.0,0.0,0.0,0.0,971.0,6.0,22.0,Matches,439.0,fr FRA,MF,27.0,30.5,971.0,1191.0,81.5,15511.0,4279.0,513.0,586.0,87.5,339.0,412.0,82.3,83.0,117.0,70.9,4.0,2.3,1.9,1.7,31.0,99.0,23.0,4.0,133.0,Matches,561,fr FRA,MF,27,32,2748.0,86.0,80.4,30.5,31,88.0,27,1,24.0,0,1.91,47.0,27.0,20.0,0.66,0.25,44.6,30.2,14.4,0.47,0.57,Matches,439.0,fr FRA,MF,27.0,30.5,1555.0,68.0,321.0,801.0,458.0,83.0,1555.0,55.0,27.0,49.1,18.0,32.7,889.0,6016.0,3069.0,72.0,69.0,5.0,56.0,35.0,1010.0,109.0,Matches,439.0,fr FRA,MF,27.0,30.5,8.0,48.0,22.0,45.8,1.57,0.72,0.17,0.36,16.4,0.0,0.0,0.0,6.2,5.8,0.13,1.8,2.2,Matches,439.0,fr FRA,MF,27.0,32.0,31.0,2748.0,30.5,8.0,4.0,12.0,8.0,0.0,0.0,9.0,0.0,6.2,5.8,2.3,8.2,72.0,133.0,109.0,0.26,0.13,0.39,0.26,0.39,0.2,0.08,0.28,0.19,0.27,Matches,Adrien Rabiot,DM/M LC,27,147,157,France,Juventus,11,14,13,9,16,9,13,14,7,11,16,12,15,15,9,13,9,13,10,11,12,10,12,6,14,16,15,15,12,12,15,14,15,16,18,17,11,13,15,10,15,2,3,3,3,2,3,3,2,2,2,4,10,10,14,12,12,12,10,10,1,9,7,1,12,1,18,18,20,1,1,10,1,1,188,71,20,8,16952440,7350,7500,7250,Northern_European,146,5,1995/4/3,29,2,172499.0,,85086031
1308,Nemanja Radonjić,Torino,1996,440.0,rs SRB,MFFW,26.0,16.2,2.0,1.0,2.0,0.0,0.0,0.0,4.0,0.0,4.0,3.0,0.0,3.0,2.0,4.0,4.0,0.0,Matches,440.0,rs SRB,MFFW,26.0,16.2,49.0,3.03,28.0,4.0,14.0,2.0,1.0,0.0,6.0,0.37,5.0,0.0,1.0,0.0,0.0,0.0,Matches,,,,,,,,,,,,,,,,,,,,,,,,,,,,,,,,,,,,,,,,,,,,,,,,,,,,,,,,440.0,rs SRB,MFFW,26.0,16.2,1.0,0.0,0.0,17.0,17.0,12.0,76.0,2.0,1.0,0.0,0.0,0.0,63.0,7.0,14.0,33.3,Matches,440.0,rs SRB,MFFW,26.0,16.2,473.0,440.0,29.0,1.0,2.0,5.0,76.0,3.0,25.0,17.0,5.0,0.0,298.0,4.0,23.0,Matches,440.0,rs SRB,MFFW,26.0,16.2,298.0,473.0,63.0,4373.0,1199.0,181.0,231.0,78.4,77.0,124.0,62.1,25.0,62.0,40.3,2.0,1.7,2.4,0.3,18.0,20.0,19.0,8.0,42.0,Matches,562,rs SRB,MFFW,26,28,1461.0,52.0,42.7,16.2,16,77.0,4,12,20.0,2,1.18,18.0,18.0,0.0,0.0,-0.05,18.0,17.6,0.4,0.03,-0.04,Matches,440.0,rs SRB,MFFW,26.0,16.2,714.0,2.0,47.0,236.0,444.0,90.0,714.0,120.0,50.0,41.7,60.0,50.0,520.0,4385.0,2110.0,86.0,48.0,52.0,53.0,34.0,568.0,163.0,Matches,440.0,rs SRB,MFFW,26.0,16.2,2.0,52.0,17.0,32.7,3.2,1.05,0.04,0.12,17.5,0.0,0.0,0.0,5.0,5.0,0.1,-3.0,-3.0,Matches,440.0,rs SRB,MFFW,26.0,28.0,16.0,1461.0,16.2,2.0,2.0,4.0,2.0,0.0,0.0,1.0,0.0,5.0,5.0,1.7,6.6,86.0,42.0,163.0,0.12,0.12,0.25,0.12,0.25,0.31,0.1,0.41,0.31,0.41,Matches,Nemanja Radonjić,AM RLC,26,134,139,Serbia,Olympique de Marseille,10,13,16,13,14,9,7,13,3,4,11,11,8,15,15,12,10,12,9,13,8,11,16,8,13,6,9,12,16,16,14,11,10,15,12,11,11,12,11,8,9,3,2,3,4,3,4,2,2,3,2,1,8,13,14,9,11,9,10,8,1,1,1,5,1,10,1,1,1,1,20,16,16,14,185,77,10,20,5667285,6700,6650,5250,Mediterranean_Hispanic,130,6,1996/2/15,35,5,34520.0,Torino,62124125
1309,Giacomo Raspadori,Napoli,2000,449.0,it ITA,FWMF,22.0,10.1,10.0,8.0,0.0,6.0,4.0,4.0,10.0,40.0,6.0,9.0,0.0,9.0,4.0,14.0,4.0,0.0,Matches,449.0,it ITA,FWMF,22.0,10.1,43.0,4.26,27.0,8.0,1.0,5.0,2.0,0.0,3.0,0.3,2.0,1.0,0.0,0.0,0.0,0.0,Matches,,,,,,,,,,,,,,,,,,,,,,,,,,,,,,,,,,,,,,,,,,,,,,,,,,,,,,,,449.0,it ITA,FWMF,22.0,10.1,1.0,0.0,0.0,7.0,12.0,1.0,32.0,4.0,8.0,0.0,0.0,0.0,31.0,3.0,8.0,27.3,Matches,449.0,it ITA,FWMF,22.0,10.1,452.0,409.0,43.0,16.0,0.0,6.0,32.0,1.0,19.0,9.0,4.0,0.0,348.0,0.0,14.0,Matches,449.0,it ITA,FWMF,22.0,10.1,348.0,452.0,77.0,5535.0,1098.0,180.0,211.0,85.3,115.0,139.0,82.7,30.0,61.0,49.2,2.0,1.3,1.3,0.7,18.0,20.0,13.0,1.0,33.0,Matches,572,it ITA,FWMF,22,25,911.0,36.0,26.6,10.1,10,62.0,1,15,19.0,7,2.24,17.0,8.0,9.0,0.89,-0.55,16.5,8.7,7.8,0.77,-0.13,Matches,449.0,it ITA,FWMF,22.0,10.1,577.0,4.0,50.0,238.0,290.0,55.0,577.0,21.0,8.0,38.1,10.0,47.6,348.0,1424.0,539.0,13.0,10.0,5.0,31.0,14.0,445.0,88.0,Matches,449.0,it ITA,FWMF,22.0,10.1,2.0,41.0,16.0,39.0,4.05,1.58,0.05,0.13,17.1,3.0,0.0,0.0,3.5,3.5,0.09,-1.5,-1.5,Matches,449.0,it ITA,FWMF,22.0,25.0,10.0,911.0,10.1,2.0,2.0,4.0,2.0,0.0,0.0,1.0,0.0,3.5,3.5,1.3,4.8,13.0,33.0,88.0,0.2,0.2,0.4,0.2,0.4,0.35,0.13,0.47,0.35,0.47,Matches,Giacomo Raspadori,AM/S LC,22,146,165,Italy,U.S. Sassuolo,13,10,13,15,16,14,11,12,6,6,13,13,6,14,12,14,11,14,12,13,13,15,16,11,16,4,14,14,15,16,15,7,15,14,13,11,13,4,14,6,13,2,4,2,4,2,2,1,1,1,4,3,15,15,6,14,13,17,15,14,1,1,1,1,1,1,1,1,1,1,16,17,10,20,172,69,15,20,25000000,7298,7398,5698,Mediterranean_Hispanic,144,2,2000/2/18,13,3,13425.0,Parthenope,43316850
1310,Ante Rebić,Milan,1993,451.0,hr CRO,FWMF,28.0,10.9,10.0,8.0,1.0,3.0,6.0,3.0,11.0,27.3,8.0,6.0,1.0,5.0,1.0,11.0,5.0,0.0,Matches,451.0,hr CRO,FWMF,28.0,10.9,34.0,3.12,23.0,1.0,1.0,4.0,4.0,1.0,3.0,0.28,3.0,0.0,0.0,0.0,0.0,0.0,Matches,,,,,,,,,,,,,,,,,,,,,,,,,,,,,,,,,,,,,,,,,,,,,,,,,,,,,,,,451.0,hr CRO,FWMF,28.0,10.9,4.0,0.0,0.0,18.0,15.0,8.0,39.0,1.0,8.0,0.0,0.0,0.0,36.0,12.0,15.0,44.4,Matches,451.0,hr CRO,FWMF,28.0,10.9,334.0,316.0,15.0,2.0,4.0,1.0,39.0,4.0,4.0,2.0,1.0,0.0,187.0,3.0,16.0,Matches,451.0,hr CRO,FWMF,28.0,10.9,187.0,334.0,56.0,2673.0,815.0,110.0,148.0,74.3,51.0,98.0,52.0,14.0,38.0,36.8,2.0,2.0,1.9,0.0,13.0,12.0,12.0,3.0,29.0,Matches,577,hr CRO,FWMF,28,23,980.0,43.0,28.7,10.9,10,72.0,2,13,20.0,5,1.74,17.0,11.0,6.0,0.55,0.0,15.4,13.0,2.4,0.22,-0.35,Matches,451.0,hr CRO,FWMF,28.0,10.9,437.0,5.0,22.0,136.0,283.0,56.0,437.0,31.0,15.0,48.4,14.0,45.2,254.0,1213.0,390.0,17.0,10.0,5.0,26.0,15.0,341.0,92.0,Matches,451.0,hr CRO,FWMF,28.0,10.9,3.0,27.0,13.0,48.1,2.48,1.19,0.11,0.23,16.0,2.0,0.0,0.0,3.5,3.5,0.13,-0.5,-0.5,Matches,451.0,hr CRO,FWMF,28.0,23.0,10.0,980.0,10.9,3.0,2.0,5.0,3.0,0.0,0.0,4.0,0.0,3.5,3.5,2.0,5.5,17.0,29.0,92.0,0.28,0.18,0.46,0.28,0.46,0.32,0.19,0.5,0.32,0.5,Matches,Ante Rebić,AM/S L,28,147,156,Croatia,AC Milan,6,13,13,14,12,7,15,13,5,6,13,10,9,13,18,14,17,12,11,12,11,14,13,11,16,8,14,12,15,14,16,13,12,16,13,14,12,12,15,15,14,2,1,2,2,3,3,3,1,2,2,3,15,14,16,10,16,13,7,7,1,1,1,1,1,1,1,10,1,8,20,14,11,18,185,78,14,20,16807193,7350,6043,6949,Northern_European,142,2,1993/9/21,42,3,86345.0,,24023726
1311,Arkadiusz Reca,Spezia,1995,452.0,pl POL,DF,27.0,24.1,44.0,28.0,22.0,12.0,10.0,19.0,32.0,59.4,13.0,21.0,5.0,16.0,24.0,68.0,54.0,0.0,Matches,452.0,pl POL,DF,27.0,24.1,50.0,2.07,39.0,2.0,3.0,4.0,1.0,1.0,2.0,0.08,1.0,0.0,0.0,1.0,0.0,0.0,Matches,,,,,,,,,,,,,,,,,,,,,,,,,,,,,,,,,,,,,,,,,,,,,,,,,,,,,,,,452.0,pl POL,DF,27.0,24.1,5.0,0.0,0.0,32.0,15.0,2.0,99.0,24.0,28.0,0.0,1.0,0.0,125.0,19.0,22.0,46.3,Matches,452.0,pl POL,DF,27.0,24.1,1197.0,943.0,250.0,5.0,0.0,9.0,99.0,245.0,0.0,0.0,0.0,0.0,827.0,4.0,45.0,Matches,452.0,pl POL,DF,27.0,24.1,827.0,1197.0,69.1,14250.0,5884.0,393.0,478.0,82.2,320.0,430.0,74.4,89.0,200.0,44.5,1.0,2.2,2.1,-1.2,23.0,76.0,33.0,25.0,79.0,Matches,578,pl POL,DF,27,30,2173.0,72.0,63.5,24.1,24,83.0,17,6,30.0,1,0.71,21.0,38.0,-17.0,-0.7,0.31,25.5,35.3,-9.8,-0.41,0.18,Matches,452.0,pl POL,DF,27.0,24.1,1483.0,90.0,469.0,605.0,424.0,32.0,1483.0,61.0,19.0,31.1,36.0,59.0,736.0,5119.0,3001.0,82.0,50.0,8.0,38.0,10.0,821.0,94.0,Matches,452.0,pl POL,DF,27.0,24.1,1.0,22.0,8.0,36.4,0.91,0.33,0.05,0.13,23.7,0.0,0.0,0.0,1.0,1.0,0.04,0.0,0.0,Matches,452.0,pl POL,DF,27.0,30.0,24.0,2173.0,24.1,1.0,1.0,2.0,1.0,0.0,0.0,5.0,0.0,1.0,1.0,2.2,3.2,82.0,79.0,94.0,0.04,0.04,0.08,0.04,0.08,0.04,0.09,0.13,0.04,0.13,Matches,Arkadiusz Reca,D/WB/M L,27,128,133,Poland,Spezia Calcio,6,14,13,7,12,7,12,12,15,10,12,7,12,13,13,11,12,10,9,10,12,13,13,8,14,12,11,13,15,14,13,13,12,16,13,10,12,10,13,7,13,3,3,1,1,2,1,3,4,3,3,4,13,12,8,10,11,15,14,12,1,20,1,1,20,1,1,17,1,1,10,1,1,1,187,81,20,10,3103470,6400,5950,5000,Northern_European,120,2,1995/6/17,15,0,22115.0,,96048686
1312,Samuele Ricci,Torino,2001,455.0,it ITA,MF,20.0,23.0,32.0,21.0,17.0,10.0,5.0,18.0,23.0,78.3,5.0,20.0,5.0,15.0,17.0,49.0,29.0,1.0,Matches,455.0,it ITA,MF,20.0,23.0,38.0,1.65,27.0,3.0,2.0,4.0,2.0,0.0,1.0,0.04,0.0,0.0,0.0,1.0,0.0,0.0,Matches,,,,,,,,,,,,,,,,,,,,,,,,,,,,,,,,,,,,,,,,,,,,,,,,,,,,,,,,455.0,it ITA,MF,20.0,23.0,6.0,0.0,0.0,22.0,58.0,0.0,31.0,17.0,21.0,0.0,0.0,0.0,136.0,11.0,15.0,42.3,Matches,455.0,it ITA,MF,20.0,23.0,1181.0,1111.0,66.0,52.0,2.0,4.0,31.0,1.0,13.0,12.0,1.0,0.0,1034.0,4.0,16.0,Matches,455.0,it ITA,MF,20.0,23.0,1034.0,1181.0,87.6,17604.0,4043.0,464.0,508.0,91.3,451.0,492.0,91.7,83.0,114.0,72.8,1.0,1.8,1.4,-0.8,16.0,96.0,12.0,2.0,104.0,Matches,583,it ITA,MF,20,28,2070.0,74.0,60.5,23.0,23,84.0,15,5,28.0,3,1.54,28.0,22.0,6.0,0.26,0.59,24.3,23.5,0.8,0.04,-0.03,Matches,455.0,it ITA,MF,20.0,23.0,1376.0,50.0,233.0,900.0,258.0,15.0,1376.0,26.0,8.0,30.8,12.0,46.2,868.0,4897.0,2083.0,43.0,30.0,5.0,21.0,17.0,974.0,31.0,Matches,455.0,it ITA,MF,20.0,23.0,2.0,21.0,7.0,33.3,0.91,0.3,0.1,0.29,21.5,0.0,0.0,0.0,1.7,1.7,0.08,0.3,0.3,Matches,455.0,it ITA,MF,20.0,28.0,23.0,2070.0,23.0,2.0,1.0,3.0,2.0,0.0,0.0,6.0,0.0,1.7,1.7,1.8,3.5,43.0,104.0,31.0,0.09,0.04,0.13,0.09,0.13,0.07,0.08,0.15,0.07,0.15,Matches,Samuele Ricci,DM/M C,20,133,162,Italy,Torino,10,11,13,9,13,10,6,12,4,10,16,8,12,14,12,15,13,13,14,14,14,16,13,11,12,11,13,14,12,13,14,11,15,13,15,12,12,5,13,4,11,2,4,1,2,2,2,3,3,2,3,1,13,14,6,13,13,15,15,12,1,1,1,1,1,1,18,1,20,10,1,10,10,1,181,70,10,20,48300003,6650,6900,5150,Mediterranean_Hispanic,133,3,2001/8/21,0,0,35577.0,,43390774
1313,Tomás Rincón,Sampdoria,1988,456.0,ve VEN,MF,34.0,28.4,56.0,27.0,22.0,26.0,8.0,29.0,61.0,47.5,32.0,37.0,7.0,30.0,30.0,86.0,18.0,0.0,Matches,456.0,ve VEN,MF,34.0,28.4,39.0,1.37,35.0,0.0,0.0,1.0,1.0,2.0,3.0,0.11,2.0,0.0,0.0,0.0,0.0,1.0,Matches,,,,,,,,,,,,,,,,,,,,,,,,,,,,,,,,,,,,,,,,,,,,,,,,,,,,,,,,456.0,ve VEN,MF,34.0,28.4,7.0,1.0,0.0,58.0,28.0,0.0,21.0,30.0,27.0,0.0,0.0,0.0,164.0,35.0,16.0,68.6,Matches,456.0,ve VEN,MF,34.0,28.4,1245.0,1186.0,56.0,36.0,2.0,29.0,21.0,5.0,1.0,0.0,1.0,0.0,1018.0,3.0,12.0,Matches,456.0,ve VEN,MF,34.0,28.4,1018.0,1245.0,81.8,18851.0,5530.0,434.0,496.0,87.5,432.0,501.0,86.2,129.0,200.0,64.5,2.0,1.2,1.9,0.8,21.0,116.0,22.0,6.0,122.0,Matches,585,ve VEN,MF,34,34,2555.0,75.0,74.7,28.4,30,81.0,17,4,31.0,2,0.47,18.0,56.0,-38.0,-1.34,-0.4,24.9,48.9,-23.9,-0.84,0.01,Matches,456.0,ve VEN,MF,34.0,28.4,1497.0,47.0,331.0,928.0,259.0,20.0,1497.0,47.0,27.0,57.4,17.0,36.2,874.0,3925.0,1687.0,27.0,28.0,6.0,26.0,29.0,988.0,35.0,Matches,456.0,ve VEN,MF,34.0,28.4,0.0,11.0,3.0,27.3,0.39,0.11,0.0,0.0,22.0,0.0,0.0,0.0,0.6,0.6,0.05,-0.6,-0.6,Matches,456.0,ve VEN,MF,34.0,34.0,30.0,2555.0,28.4,0.0,2.0,2.0,0.0,0.0,0.0,7.0,1.0,0.6,0.6,1.2,1.8,27.0,122.0,35.0,0.0,0.07,0.07,0.0,0.07,0.02,0.04,0.06,0.02,0.06,Matches,Tomás Rincón,DM/M C,34,129,141,Venezuela,U.C. Sampdoria,4,6,10,6,13,4,13,9,4,15,12,6,16,11,19,15,18,11,13,9,12,19,5,13,10,16,15,17,11,10,17,10,16,11,15,15,14,12,15,6,11,4,2,2,3,2,1,2,2,1,3,3,18,13,6,15,12,17,10,15,1,1,1,1,1,1,20,1,20,1,1,1,1,1,177,75,10,20,295640,6450,6750,5000,Mediterranean_Hispanic,126,6,1988/1/13,118,1,115067.0,,86000589
1314,Ricardo Rodríguez,Torino,1992,458.0,ch SUI,DF,29.0,29.7,54.0,33.0,30.0,17.0,7.0,28.0,42.0,66.7,14.0,30.0,15.0,15.0,38.0,92.0,61.0,0.0,Matches,458.0,ch SUI,DF,29.0,29.7,57.0,1.92,46.0,8.0,1.0,2.0,0.0,0.0,2.0,0.07,2.0,0.0,0.0,0.0,0.0,0.0,Matches,,,,,,,,,,,,,,,,,,,,,,,,,,,,,,,,,,,,,,,,,,,,,,,,,,,,,,,,458.0,ch SUI,DF,29.0,29.7,3.0,0.0,0.0,25.0,8.0,0.0,71.0,38.0,33.0,0.0,0.0,0.0,164.0,30.0,29.0,50.8,Matches,458.0,ch SUI,DF,29.0,29.7,1757.0,1602.0,145.0,40.0,0.0,18.0,71.0,87.0,13.0,10.0,3.0,0.0,1439.0,10.0,31.0,Matches,458.0,ch SUI,DF,29.0,29.7,1439.0,1757.0,81.9,25311.0,8461.0,664.0,726.0,91.5,625.0,718.0,87.0,128.0,242.0,52.9,0.0,1.9,2.2,-1.9,29.0,114.0,26.0,12.0,133.0,Matches,587,ch SUI,DF,29,35,2670.0,76.0,78.1,29.7,30,85.0,21,5,27.0,2,1.34,33.0,31.0,2.0,0.07,0.19,32.2,29.9,2.3,0.08,0.14,Matches,458.0,ch SUI,DF,29.0,29.7,1993.0,119.0,692.0,998.0,314.0,12.0,1993.0,13.0,7.0,53.8,5.0,38.5,1136.0,5905.0,3111.0,49.0,58.0,5.0,13.0,11.0,1328.0,51.0,Matches,458.0,ch SUI,DF,29.0,29.7,0.0,11.0,4.0,36.4,0.37,0.13,0.0,0.0,23.9,1.0,0.0,0.0,0.4,0.4,0.04,-0.4,-0.4,Matches,458.0,ch SUI,DF,29.0,35.0,30.0,2670.0,29.7,0.0,0.0,0.0,0.0,0.0,0.0,3.0,0.0,0.4,0.4,1.9,2.4,49.0,133.0,51.0,0.0,0.0,0.0,0.0,0.0,0.01,0.07,0.08,0.01,0.08,Matches,Ricardo Rodríguez,D/WB LC,29,135,155,"Switzerland,Spain,Chile",Torino,13,14,10,8,13,14,10,12,16,13,13,13,14,13,11,13,14,13,14,12,13,13,10,12,11,14,14,12,13,13,14,12,17,12,13,13,13,6,14,9,13,3,2,1,3,2,3,1,1,1,3,4,18,14,4,12,18,16,17,19,1,20,20,1,16,1,1,14,1,1,1,1,1,1,182,77,20,8,8788654,6845,6795,5295,Mediterranean_Hispanic,132,6,1992/8/25,98,9,53462.0,,98003635
1315,Rogério,Sassuolo,1998,459.0,br BRA,DF,24.0,33.3,37.0,21.0,22.0,8.0,7.0,17.0,35.0,48.6,18.0,32.0,9.0,23.0,37.0,74.0,70.0,0.0,Matches,459.0,br BRA,DF,24.0,33.3,74.0,2.22,62.0,6.0,1.0,1.0,4.0,0.0,6.0,0.18,5.0,0.0,0.0,0.0,1.0,0.0,Matches,,,,,,,,,,,,,,,,,,,,,,,,,,,,,,,,,,,,,,,,,,,,,,,,,,,,,,,,459.0,br BRA,DF,24.0,33.3,5.0,1.0,0.0,30.0,38.0,0.0,113.0,37.0,21.0,0.0,0.0,0.0,162.0,21.0,32.0,39.6,Matches,459.0,br BRA,DF,24.0,33.3,2038.0,1647.0,385.0,53.0,1.0,22.0,113.0,332.0,0.0,0.0,0.0,0.0,1644.0,6.0,52.0,Matches,459.0,br BRA,DF,24.0,33.3,1644.0,2038.0,80.7,28400.0,11170.0,820.0,884.0,92.8,618.0,731.0,84.5,174.0,313.0,55.6,3.0,2.7,2.2,0.3,30.0,126.0,47.0,25.0,185.0,Matches,588,br BRA,DF,24,36,2996.0,83.0,87.6,33.3,34,88.0,29,2,9.0,1,1.14,41.0,55.0,-14.0,-0.42,-0.42,46.2,44.6,1.6,0.05,0.0,Matches,459.0,br BRA,DF,24.0,33.3,2308.0,94.0,780.0,1033.0,523.0,31.0,2308.0,41.0,23.0,56.1,11.0,26.8,1272.0,7803.0,4585.0,110.0,65.0,13.0,28.0,8.0,1419.0,115.0,Matches,459.0,br BRA,DF,24.0,33.3,0.0,15.0,5.0,33.3,0.45,0.15,0.0,0.0,23.4,0.0,0.0,0.0,0.5,0.5,0.04,-0.5,-0.5,Matches,459.0,br BRA,DF,24.0,36.0,34.0,2996.0,33.3,0.0,3.0,3.0,0.0,0.0,0.0,5.0,1.0,0.5,0.5,2.7,3.3,110.0,185.0,115.0,0.0,0.09,0.09,0.0,0.09,0.02,0.08,0.1,0.02,0.1,Matches,Rogério,D/WB L,24,128,140,Brazil,U.S. Sassuolo,6,11,11,6,13,7,7,10,10,11,13,6,12,13,14,13,13,14,13,11,13,14,14,10,15,12,13,13,15,15,13,7,14,15,15,10,10,11,11,12,11,2,1,2,3,2,2,4,2,2,1,2,13,12,4,11,11,15,9,12,1,20,1,1,18,1,1,15,1,1,1,1,1,1,178,70,20,6,3174004,6400,6200,5250,Mixed_Race,123,12,1998/1/13,0,0,25000.0,,19284576
1316,Alessio Romagnoli,Lazio,1995,461.0,it ITA,DF,27.0,32.5,33.0,15.0,19.0,14.0,0.0,11.0,22.0,50.0,11.0,33.0,26.0,7.0,38.0,71.0,108.0,0.0,Matches,461.0,it ITA,DF,27.0,32.5,14.0,0.43,11.0,3.0,0.0,0.0,0.0,0.0,3.0,0.09,3.0,0.0,0.0,0.0,0.0,0.0,Matches,,,,,,,,,,,,,,,,,,,,,,,,,,,,,,,,,,,,,,,,,,,,,,,,,,,,,,,,461.0,it ITA,DF,27.0,32.5,6.0,0.0,0.0,35.0,19.0,1.0,0.0,38.0,15.0,0.0,0.0,0.0,139.0,78.0,45.0,63.4,Matches,461.0,it ITA,DF,27.0,32.5,1849.0,1688.0,161.0,91.0,1.0,13.0,0.0,2.0,0.0,0.0,0.0,0.0,1673.0,0.0,6.0,Matches,461.0,it ITA,DF,27.0,32.5,1673.0,1849.0,90.5,28906.0,11821.0,753.0,789.0,95.4,717.0,764.0,93.8,153.0,223.0,68.6,0.0,0.1,0.4,-0.1,2.0,91.0,4.0,0.0,62.0,Matches,590,it ITA,DF,27,34,2922.0,86.0,85.4,32.5,33,88.0,30,1,34.0,2,1.82,49.0,28.0,21.0,0.65,-0.98,40.3,36.1,4.2,0.13,-0.88,Matches,461.0,it ITA,DF,27.0,32.5,2107.0,306.0,1089.0,988.0,34.0,17.0,2107.0,1.0,1.0,100.0,0.0,0.0,1087.0,4470.0,2054.0,3.0,7.0,2.0,10.0,3.0,1386.0,3.0,Matches,461.0,it ITA,DF,27.0,32.5,2.0,13.0,5.0,38.5,0.4,0.15,0.15,0.4,11.9,0.0,0.0,0.0,1.4,1.4,0.11,0.6,0.6,Matches,461.0,it ITA,DF,27.0,34.0,33.0,2922.0,32.5,2.0,0.0,2.0,2.0,0.0,0.0,6.0,0.0,1.4,1.4,0.1,1.6,3.0,62.0,3.0,0.06,0.0,0.06,0.06,0.06,0.04,0.0,0.05,0.04,0.05,Matches,Alessio Romagnoli,D C,27,145,150,Italy,S.S. Lazio,5,5,8,8,12,4,15,5,13,16,14,12,15,13,14,13,13,15,13,12,13,15,5,13,8,15,15,14,12,12,15,15,14,13,16,14,14,13,14,11,9,1,2,1,3,3,1,1,3,1,3,2,19,15,4,14,14,17,15,13,1,10,20,1,1,1,1,1,1,1,1,1,1,1,188,78,20,11,17020269,7250,6900,6750,Mediterranean_Hispanic,144,3,1995/1/12,12,2,106922.0,,43093395
1317,Marten de Roon,Atalanta,1991,464.0,nl NED,MF,31.0,32.9,77.0,39.0,37.0,35.0,5.0,37.0,81.0,45.7,44.0,37.0,4.0,33.0,36.0,113.0,58.0,0.0,Matches,464.0,nl NED,MF,31.0,32.9,51.0,1.55,45.0,0.0,1.0,1.0,3.0,1.0,2.0,0.06,2.0,0.0,0.0,0.0,0.0,0.0,Matches,,,,,,,,,,,,,,,,,,,,,,,,,,,,,,,,,,,,,,,,,,,,,,,,,,,,,,,,464.0,nl NED,MF,31.0,32.9,7.0,0.0,0.0,46.0,24.0,1.0,13.0,36.0,39.0,0.0,0.0,0.0,218.0,51.0,31.0,62.2,Matches,464.0,nl NED,MF,31.0,32.9,1912.0,1833.0,75.0,54.0,0.0,24.0,13.0,17.0,0.0,0.0,0.0,0.0,1587.0,4.0,21.0,Matches,464.0,nl NED,MF,31.0,32.9,1587.0,1912.0,83.0,29393.0,8619.0,635.0,714.0,88.9,736.0,842.0,87.4,177.0,273.0,64.8,1.0,1.8,2.0,-0.8,20.0,156.0,24.0,1.0,171.0,Matches,593,nl NED,MF,31,35,2964.0,85.0,86.7,32.9,34,87.0,31,1,10.0,0,1.74,57.0,40.0,17.0,0.52,0.32,48.3,35.9,12.4,0.38,-0.38,Matches,464.0,nl NED,MF,31.0,32.9,2209.0,119.0,634.0,1232.0,354.0,21.0,2209.0,10.0,4.0,40.0,5.0,50.0,1127.0,4700.0,2195.0,18.0,30.0,2.0,16.0,15.0,1389.0,23.0,Matches,464.0,nl NED,MF,31.0,32.9,3.0,19.0,5.0,26.3,0.58,0.15,0.16,0.6,20.6,0.0,0.0,0.0,1.1,1.1,0.06,1.9,1.9,Matches,464.0,nl NED,MF,31.0,35.0,34.0,2964.0,32.9,3.0,1.0,4.0,3.0,0.0,0.0,7.0,0.0,1.1,1.1,1.8,2.9,18.0,171.0,23.0,0.09,0.03,0.12,0.09,0.12,0.03,0.06,0.09,0.03,0.09,Matches,Marten de Roon,DM/M C,31,147,152,Holland,Atalanta,7,8,10,8,13,5,14,10,10,13,13,6,17,12,16,16,15,14,14,12,15,16,8,13,12,16,18,17,12,11,13,14,16,12,17,15,14,14,14,4,12,1,3,1,3,3,2,2,3,3,1,3,15,14,9,16,13,17,12,10,1,1,10,1,1,1,20,1,20,1,1,1,1,1,185,76,9,20,347975206,7350,7250,6300,Northern_European,145,2,1991/3/29,27,0,35577.0,,37001813
1318,Nicolò Rovella,Monza,2001,466.0,it ITA,MF,20.0,19.3,45.0,29.0,22.0,21.0,2.0,13.0,36.0,36.1,23.0,20.0,1.0,19.0,40.0,85.0,17.0,0.0,Matches,466.0,it ITA,MF,20.0,19.3,53.0,2.74,41.0,5.0,1.0,1.0,2.0,3.0,7.0,0.36,5.0,1.0,0.0,0.0,0.0,1.0,Matches,,,,,,,,,,,,,,,,,,,,,,,,,,,,,,,,,,,,,,,,,,,,,,,,,,,,,,,,466.0,it ITA,MF,20.0,19.3,5.0,1.0,0.0,26.0,21.0,2.0,28.0,40.0,29.0,0.0,0.0,0.0,141.0,9.0,10.0,47.4,Matches,466.0,it ITA,MF,20.0,19.3,1363.0,1292.0,68.0,52.0,1.0,24.0,28.0,6.0,10.0,2.0,7.0,0.0,1206.0,3.0,15.0,Matches,466.0,it ITA,MF,20.0,19.3,1206.0,1363.0,88.5,22554.0,5545.0,496.0,534.0,92.9,549.0,594.0,92.4,145.0,193.0,75.1,2.0,2.2,1.6,-0.2,22.0,105.0,15.0,2.0,99.0,Matches,595,it ITA,MF,20,25,1740.0,70.0,50.9,19.3,21,76.0,9,4,34.0,1,1.64,31.0,20.0,11.0,0.57,1.37,23.8,23.0,0.8,0.04,0.37,Matches,466.0,it ITA,MF,20.0,19.3,1556.0,46.0,374.0,950.0,248.0,10.0,1556.0,15.0,6.0,40.0,8.0,53.3,950.0,5023.0,2259.0,26.0,30.0,2.0,20.0,7.0,1134.0,19.0,Matches,466.0,it ITA,MF,20.0,19.3,1.0,21.0,6.0,28.6,1.09,0.31,0.05,0.17,25.5,1.0,0.0,0.0,1.2,1.2,0.06,-0.2,-0.2,Matches,466.0,it ITA,MF,20.0,25.0,21.0,1740.0,19.3,1.0,2.0,3.0,1.0,0.0,0.0,5.0,1.0,1.2,1.2,2.2,3.4,26.0,99.0,19.0,0.05,0.1,0.16,0.05,0.16,0.06,0.11,0.18,0.06,0.18,Matches,Nicolò Rovella,DM/M C,20,127,-85,Italy,Juventus,14,13,12,8,13,12,8,11,8,11,14,11,15,12,13,12,13,11,13,13,13,15,13,10,13,13,14,13,12,13,13,8,15,13,14,11,14,11,13,6,13,3,2,1,3,2,2,1,2,1,2,2,10,15,4,11,13,15,18,12,1,1,1,1,1,1,20,1,20,1,1,12,1,1,179,70,10,20,63800001,6350,6300,5100,Mediterranean_Hispanic,127,2,2001/12/4,0,0,35576.0,Brianza,43372892
1319,Amir Rrahmani,Napoli,1994,468.0,xk KVX,DF,28.0,27.2,33.0,18.0,20.0,13.0,0.0,17.0,26.0,65.4,9.0,36.0,20.0,16.0,14.0,47.0,79.0,1.0,Matches,468.0,xk KVX,DF,28.0,27.2,26.0,0.96,23.0,0.0,1.0,1.0,0.0,1.0,4.0,0.15,4.0,0.0,0.0,0.0,0.0,0.0,Matches,,,,,,,,,,,,,,,,,,,,,,,,,,,,,,,,,,,,,,,,,,,,,,,,,,,,,,,,468.0,xk KVX,DF,28.0,27.2,2.0,0.0,0.0,22.0,12.0,1.0,1.0,14.0,18.0,0.0,0.0,0.0,162.0,67.0,40.0,62.6,Matches,468.0,xk KVX,DF,28.0,27.2,2167.0,2097.0,67.0,63.0,0.0,30.0,1.0,3.0,0.0,0.0,0.0,0.0,1977.0,3.0,7.0,Matches,468.0,xk KVX,DF,28.0,27.2,1977.0,2167.0,91.2,39821.0,13543.0,641.0,688.0,93.2,1039.0,1081.0,96.1,266.0,349.0,76.2,1.0,1.0,0.8,0.0,12.0,149.0,7.0,0.0,135.0,Matches,597,xk KVX,DF,28,29,2448.0,84.0,71.6,27.2,27,89.0,25,2,23.0,3,2.31,56.0,22.0,34.0,1.25,-0.14,45.6,22.3,23.3,0.86,-0.04,Matches,468.0,xk KVX,DF,28.0,27.2,2372.0,228.0,955.0,1327.0,102.0,29.0,2372.0,6.0,3.0,50.0,2.0,33.3,1573.0,8201.0,5024.0,23.0,23.0,1.0,9.0,3.0,1768.0,5.0,Matches,468.0,xk KVX,DF,28.0,27.2,2.0,21.0,3.0,14.3,0.77,0.11,0.1,0.67,13.4,0.0,0.0,0.0,1.8,1.8,0.09,0.2,0.2,Matches,468.0,xk KVX,DF,28.0,29.0,27.0,2448.0,27.2,2.0,1.0,3.0,2.0,0.0,0.0,2.0,0.0,1.8,1.8,1.0,2.9,23.0,135.0,5.0,0.07,0.04,0.11,0.07,0.11,0.07,0.04,0.11,0.07,0.11,Matches,Amir Rrahmani,D C,28,149,153,"Kosovo,Albania",Parthenope,5,9,8,10,11,6,16,8,11,15,12,7,15,10,15,15,15,13,14,10,14,15,4,11,10,14,15,16,12,11,15,16,14,12,16,16,14,12,13,8,12,3,2,3,3,1,3,1,2,2,2,3,12,14,6,13,12,15,10,12,1,14,20,13,1,1,1,1,1,1,1,1,1,1,192,83,13,20,26788546,7443,6615,6181,Northern_European,149,5,1994/2/24,48,6,44423.0,,11023165
1320,Ruan,Sassuolo,1999,469.0,br BRA,DF,23.0,19.0,38.0,26.0,25.0,12.0,1.0,19.0,29.0,65.5,10.0,29.0,17.0,12.0,24.0,62.0,80.0,3.0,Matches,469.0,br BRA,DF,23.0,19.0,6.0,0.32,6.0,0.0,0.0,0.0,0.0,0.0,0.0,0.0,0.0,0.0,0.0,0.0,0.0,0.0,Matches,,,,,,,,,,,,,,,,,,,,,,,,,,,,,,,,,,,,,,,,,,,,,,,,,,,,,,,,469.0,br BRA,DF,23.0,19.0,13.0,3.0,2.0,27.0,14.0,0.0,0.0,24.0,26.0,0.0,1.0,1.0,112.0,51.0,36.0,58.6,Matches,469.0,br BRA,DF,23.0,19.0,939.0,875.0,62.0,35.0,1.0,3.0,0.0,2.0,0.0,0.0,0.0,0.0,835.0,2.0,8.0,Matches,469.0,br BRA,DF,23.0,19.0,835.0,939.0,88.9,16214.0,4320.0,248.0,275.0,90.2,499.0,535.0,93.3,74.0,97.0,76.3,0.0,0.0,0.8,0.0,1.0,22.0,1.0,0.0,22.0,Matches,598,br BRA,DF,23,23,1711.0,74.0,50.0,19.0,21,81.0,12,2,7.0,12,1.09,25.0,31.0,-6.0,-0.32,0.11,24.6,23.0,1.6,0.09,0.07,Matches,469.0,br BRA,DF,23.0,19.0,1136.0,191.0,681.0,431.0,28.0,13.0,1136.0,4.0,3.0,75.0,1.0,25.0,601.0,2703.0,1221.0,6.0,5.0,0.0,4.0,5.0,660.0,3.0,Matches,469.0,br BRA,DF,23.0,19.0,0.0,5.0,1.0,20.0,0.26,0.05,0.0,0.0,10.4,0.0,0.0,0.0,0.5,0.5,0.1,-0.5,-0.5,Matches,469.0,br BRA,DF,23.0,23.0,21.0,1711.0,19.0,0.0,0.0,0.0,0.0,0.0,0.0,13.0,3.0,0.5,0.5,0.0,0.5,6.0,22.0,3.0,0.0,0.0,0.0,0.0,0.0,0.03,0.0,0.03,0.03,0.03,Matches,Ruan,D C,23,119,144,"Brazil,Italy",U.S. Sassuolo,7,7,9,8,9,12,14,9,9,12,10,4,14,9,13,12,14,12,11,8,12,14,5,12,7,12,13,12,14,14,11,14,14,16,14,14,12,8,10,5,8,1,2,3,3,3,2,2,3,1,3,1,13,13,1,13,13,14,10,12,1,1,20,10,1,1,1,1,1,1,1,1,1,1,187,74,5,20,2079183,5950,6150,2750,Mixed_Race,121,11,1999/6/7,0,0,10908.0,,19352206
1321,Mário Rui,Napoli,1991,472.0,pt POR,DF,31.0,19.4,34.0,22.0,17.0,13.0,4.0,20.0,41.0,48.8,21.0,17.0,4.0,13.0,15.0,49.0,24.0,1.0,Matches,472.0,pt POR,DF,31.0,19.4,87.0,4.48,63.0,21.0,1.0,0.0,1.0,1.0,13.0,0.67,11.0,1.0,0.0,0.0,0.0,1.0,Matches,,,,,,,,,,,,,,,,,,,,,,,,,,,,,,,,,,,,,,,,,,,,,,,,,,,,,,,,472.0,pt POR,DF,31.0,19.4,2.0,1.0,0.0,19.0,31.0,0.0,110.0,15.0,22.0,0.0,0.0,0.0,155.0,13.0,25.0,34.2,Matches,472.0,pt POR,DF,31.0,19.4,1734.0,1427.0,300.0,70.0,2.0,30.0,110.0,188.0,42.0,15.0,19.0,0.0,1408.0,7.0,26.0,Matches,472.0,pt POR,DF,31.0,19.4,1408.0,1734.0,81.2,25486.0,8770.0,685.0,748.0,91.6,520.0,625.0,83.2,180.0,290.0,62.1,6.0,4.0,4.4,2.0,46.0,146.0,54.0,17.0,153.0,Matches,602,pt POR,DF,31,22,1749.0,80.0,51.1,19.4,21,81.0,7,1,45.0,8,2.77,47.0,16.0,31.0,1.6,0.63,39.4,16.1,23.3,1.2,0.68,Matches,472.0,pt POR,DF,31.0,19.4,1864.0,36.0,381.0,946.0,552.0,11.0,1864.0,16.0,8.0,50.0,5.0,31.3,1101.0,4711.0,2976.0,52.0,56.0,2.0,10.0,7.0,1243.0,97.0,Matches,472.0,pt POR,DF,31.0,19.4,0.0,11.0,4.0,36.4,0.57,0.21,0.0,0.0,21.9,2.0,0.0,0.0,0.6,0.6,0.06,-0.6,-0.6,Matches,472.0,pt POR,DF,31.0,22.0,21.0,1749.0,19.4,0.0,6.0,6.0,0.0,0.0,0.0,2.0,1.0,0.6,0.6,4.0,4.6,52.0,153.0,97.0,0.0,0.31,0.31,0.0,0.31,0.03,0.2,0.24,0.03,0.24,Matches,Mário Rui,D/WB/M L,31,147,148,Portugal,Parthenope,13,15,11,7,13,12,8,11,12,14,14,7,15,13,13,14,15,12,14,12,14,15,12,9,13,13,15,15,16,16,14,6,16,15,15,11,14,10,12,8,11,2,3,2,3,2,2,3,2,3,4,2,14,14,8,12,13,15,14,13,1,20,1,1,18,1,1,16,1,1,1,1,1,1,170,67,20,7,347975206,7339,7239,5789,Mediterranean_Hispanic,144,4,1991/5/27,11,0,74808.0,,55027761
1322,Abdelhamid Sabiri,Sampdoria,1996,474.0,ma MAR,MFFW,25.0,11.9,18.0,7.0,5.0,9.0,4.0,4.0,13.0,30.8,9.0,18.0,4.0,14.0,2.0,20.0,5.0,0.0,Matches,474.0,ma MAR,MFFW,25.0,11.9,41.0,3.45,22.0,7.0,3.0,4.0,5.0,0.0,0.0,0.0,0.0,0.0,0.0,0.0,0.0,0.0,Matches,,,,,,,,,,,,,,,,,,,,,,,,,,,,,,,,,,,,,,,,,,,,,,,,,,,,,,,,474.0,ma MAR,MFFW,25.0,11.9,5.0,0.0,0.0,28.0,39.0,0.0,54.0,2.0,7.0,0.0,0.0,0.0,50.0,30.0,29.0,50.8,Matches,474.0,ma MAR,MFFW,25.0,11.9,461.0,390.0,69.0,33.0,3.0,8.0,54.0,3.0,32.0,9.0,19.0,0.0,310.0,2.0,11.0,Matches,474.0,ma MAR,MFFW,25.0,11.9,310.0,461.0,67.2,5531.0,1574.0,141.0,180.0,78.3,118.0,162.0,72.8,39.0,85.0,45.9,0.0,1.4,1.2,-1.4,14.0,44.0,12.0,0.0,49.0,Matches,605,ma MAR,MFFW,25,18,1069.0,59.0,31.3,11.9,12,75.0,6,6,28.0,4,0.5,6.0,20.0,-14.0,-1.18,0.08,10.8,18.0,-7.2,-0.61,0.35,Matches,474.0,ma MAR,MFFW,25.0,11.9,618.0,15.0,64.0,304.0,257.0,31.0,616.0,39.0,14.0,35.9,17.0,43.6,363.0,1503.0,536.0,7.0,20.0,5.0,34.0,28.0,423.0,54.0,Matches,474.0,ma MAR,MFFW,25.0,11.9,2.0,31.0,9.0,29.0,2.61,0.76,0.03,0.11,25.5,8.0,1.0,2.0,3.0,1.4,0.04,-1.0,-0.4,Matches,474.0,ma MAR,MFFW,25.0,18.0,12.0,1069.0,11.9,2.0,0.0,2.0,1.0,1.0,2.0,5.0,0.0,3.0,1.4,1.4,2.8,7.0,49.0,54.0,0.17,0.0,0.17,0.08,0.08,0.26,0.12,0.38,0.11,0.23,Matches,Abdelhamid Sabiri,M/AM LC,25,134,142,"Morocco,Germany",U.C. Sampdoria,13,13,15,13,13,16,13,16,8,6,12,15,9,15,16,15,12,13,10,15,10,12,16,9,15,8,13,13,12,15,12,12,13,12,13,12,13,10,13,5,13,3,1,3,3,2,3,3,2,1,3,1,9,14,2,6,13,11,8,10,1,1,1,1,1,1,1,16,18,10,16,20,14,12,185,80,12,20,6035562,6700,5978,4219,North_African__Middle_Eastern,134,12,1996/11/28,0,0,2115.0,,91175740
1323,Alexis Saelemaekers,Milan,1999,475.0,be BEL,FWDF,23.0,15.6,31.0,20.0,12.0,16.0,3.0,19.0,41.0,46.3,22.0,13.0,1.0,12.0,19.0,50.0,11.0,0.0,Matches,475.0,be BEL,FWDF,23.0,15.6,63.0,4.05,42.0,5.0,7.0,7.0,2.0,0.0,6.0,0.39,5.0,0.0,1.0,0.0,0.0,0.0,Matches,,,,,,,,,,,,,,,,,,,,,,,,,,,,,,,,,,,,,,,,,,,,,,,,,,,,,,,,475.0,be BEL,FWDF,23.0,15.6,1.0,0.0,0.0,23.0,22.0,2.0,48.0,19.0,20.0,0.0,1.0,0.0,63.0,9.0,5.0,64.3,Matches,475.0,be BEL,FWDF,23.0,15.6,621.0,573.0,46.0,5.0,3.0,2.0,48.0,36.0,5.0,2.0,3.0,0.0,480.0,2.0,12.0,Matches,475.0,be BEL,FWDF,23.0,15.6,480.0,621.0,77.3,6935.0,1932.0,279.0,332.0,84.0,155.0,197.0,78.7,26.0,46.0,56.5,3.0,4.1,3.6,-1.1,22.0,28.0,30.0,10.0,52.0,Matches,606,be BEL,FWDF,23,30,1403.0,47.0,41.0,15.6,14,67.0,0,16,29.0,1,1.7,21.0,16.0,5.0,0.32,-0.39,23.3,16.4,6.9,0.44,-0.04,Matches,475.0,be BEL,FWDF,23.0,15.6,836.0,13.0,105.0,337.0,407.0,50.0,836.0,72.0,31.0,43.1,32.0,44.4,503.0,3229.0,1563.0,52.0,23.0,15.0,38.0,21.0,568.0,143.0,Matches,475.0,be BEL,FWDF,23.0,15.6,2.0,35.0,10.0,28.6,2.25,0.64,0.06,0.2,20.7,0.0,0.0,0.0,2.5,2.5,0.07,-0.5,-0.5,Matches,475.0,be BEL,FWDF,23.0,30.0,14.0,1403.0,15.6,2.0,3.0,5.0,2.0,0.0,0.0,1.0,0.0,2.5,2.5,4.1,6.6,52.0,52.0,143.0,0.13,0.19,0.32,0.13,0.32,0.16,0.27,0.42,0.16,0.42,Matches,Alexis Saelemaekers,WB/M/AM R,23,143,159,Belgium,AC Milan,6,13,14,8,13,10,11,12,9,11,13,7,13,13,14,12,13,11,13,14,11,16,11,10,14,13,18,15,15,14,12,10,15,14,15,10,13,12,12,5,17,1,3,3,3,3,1,2,2,1,2,3,15,14,4,11,13,15,12,11,1,7,1,13,9,16,1,11,1,19,13,11,20,1,180,72,12,20,13488424,7150,6750,6250,Northern_European,139,1,1999/6/27,9,1,24615.0,,18097159
1324,Antonio Sanabria,Torino,1996,479.0,py PAR,FW,26.0,27.0,11.0,5.0,3.0,3.0,5.0,1.0,7.0,14.3,6.0,9.0,2.0,7.0,4.0,15.0,7.0,0.0,Matches,479.0,py PAR,FW,26.0,27.0,50.0,1.85,41.0,0.0,5.0,2.0,1.0,1.0,5.0,0.19,5.0,0.0,0.0,0.0,0.0,0.0,Matches,,,,,,,,,,,,,,,,,,,,,,,,,,,,,,,,,,,,,,,,,,,,,,,,,,,,,,,,479.0,py PAR,FW,26.0,27.0,4.0,0.0,0.0,33.0,27.0,14.0,2.0,4.0,5.0,0.0,0.0,0.0,64.0,86.0,124.0,41.0,Matches,479.0,py PAR,FW,26.0,27.0,691.0,632.0,58.0,2.0,1.0,5.0,2.0,2.0,0.0,0.0,0.0,0.0,524.0,1.0,18.0,Matches,479.0,py PAR,FW,26.0,27.0,524.0,691.0,75.8,7116.0,910.0,335.0,405.0,82.7,132.0,177.0,74.6,23.0,31.0,74.2,4.0,3.0,1.4,1.0,25.0,34.0,15.0,0.0,46.0,Matches,612,py PAR,FW,26,33,2433.0,74.0,71.1,27.0,28,82.0,12,5,25.0,2,1.33,29.0,31.0,-2.0,-0.07,-0.35,31.2,27.2,4.0,0.15,0.35,Matches,479.0,py PAR,FW,26.0,27.0,946.0,11.0,49.0,457.0,450.0,117.0,945.0,41.0,23.0,56.1,11.0,26.8,496.0,2285.0,536.0,17.0,19.0,11.0,83.0,29.0,730.0,139.0,Matches,479.0,py PAR,FW,26.0,27.0,12.0,67.0,24.0,35.8,2.48,0.89,0.16,0.46,13.5,0.0,1.0,1.0,9.3,8.5,0.13,2.7,2.5,Matches,479.0,py PAR,FW,26.0,33.0,28.0,2433.0,27.0,12.0,4.0,16.0,11.0,1.0,1.0,4.0,0.0,9.3,8.5,3.0,11.5,17.0,46.0,139.0,0.44,0.15,0.59,0.41,0.55,0.34,0.11,0.45,0.32,0.42,Matches,Antonio Sanabria,S,26,131,136,"Paraguay,Spain",Torino,5,9,12,13,15,11,16,11,4,5,12,12,6,14,13,13,12,12,11,12,12,13,13,9,15,5,13,11,14,15,13,13,13,13,12,12,12,9,8,10,11,1,3,1,1,1,4,3,3,1,2,2,11,13,8,12,11,14,13,12,1,1,1,1,1,1,1,1,1,1,10,1,7,20,180,76,11,20,4686704,6550,6300,5300,Mediterranean_Hispanic,130,6,1996/3/4,29,2,56923.0,,67181404
1325,Alex Sandro,Juventus,1991,481.0,br BRA,DF,31.0,19.9,35.0,20.0,16.0,16.0,3.0,15.0,22.0,68.2,7.0,27.0,10.0,17.0,15.0,50.0,64.0,1.0,Matches,481.0,br BRA,DF,31.0,19.9,36.0,1.81,32.0,0.0,2.0,0.0,1.0,1.0,3.0,0.15,3.0,0.0,0.0,0.0,0.0,0.0,Matches,,,,,,,,,,,,,,,,,,,,,,,,,,,,,,,,,,,,,,,,,,,,,,,,,,,,,,,,481.0,br BRA,DF,31.0,19.9,5.0,1.0,0.0,27.0,25.0,1.0,19.0,15.0,20.0,1.0,0.0,0.0,127.0,39.0,22.0,63.9,Matches,481.0,br BRA,DF,31.0,19.9,1256.0,1100.0,152.0,24.0,0.0,8.0,19.0,117.0,0.0,0.0,0.0,0.0,1081.0,4.0,13.0,Matches,481.0,br BRA,DF,31.0,19.9,1081.0,1256.0,86.1,19560.0,6667.0,466.0,504.0,92.5,477.0,532.0,89.7,120.0,172.0,69.8,1.0,0.9,1.1,0.1,12.0,93.0,9.0,3.0,97.0,Matches,614,br BRA,DF,31,25,1787.0,71.0,52.3,19.9,21,82.0,16,4,15.0,8,1.92,35.0,20.0,15.0,0.76,0.31,31.6,23.8,7.8,0.39,0.07,Matches,481.0,br BRA,DF,31.0,19.9,1455.0,118.0,521.0,750.0,196.0,13.0,1455.0,28.0,19.0,67.9,4.0,14.3,763.0,4257.0,2489.0,51.0,36.0,3.0,26.0,17.0,901.0,25.0,Matches,481.0,br BRA,DF,31.0,19.9,0.0,5.0,0.0,0.0,0.25,0.0,0.0,,22.7,0.0,0.0,0.0,0.2,0.2,0.04,-0.2,-0.2,Matches,481.0,br BRA,DF,31.0,25.0,21.0,1787.0,19.9,0.0,1.0,1.0,0.0,0.0,0.0,5.0,1.0,0.2,0.2,0.9,1.1,51.0,97.0,25.0,0.0,0.05,0.05,0.0,0.05,0.01,0.05,0.05,0.01,0.05,Matches,Alex Sandro,D/WB/M L,31,143,168,Brazil,Juventus,11,14,13,10,15,8,14,11,13,13,14,9,15,14,11,15,14,14,10,12,13,13,14,7,12,15,14,15,13,13,14,12,16,14,14,14,13,14,11,10,12,3,2,2,3,1,1,3,3,2,2,2,13,13,6,14,13,15,15,17,1,20,12,1,20,1,1,17,5,1,9,1,1,1,180,80,20,10,11677504,7200,7933,6985,African_Caribbean,142,14,1991/1/26,37,2,231653.0,,19067093
1326,Riccardo Saponara,Fiorentina,1991,483.0,it ITA,FW,30.0,13.4,10.0,5.0,3.0,6.0,1.0,5.0,9.0,55.6,4.0,7.0,1.0,6.0,5.0,15.0,9.0,1.0,Matches,483.0,it ITA,FW,30.0,13.4,49.0,3.66,36.0,0.0,4.0,5.0,3.0,1.0,5.0,0.37,4.0,0.0,0.0,1.0,0.0,0.0,Matches,,,,,,,,,,,,,,,,,,,,,,,,,,,,,,,,,,,,,,,,,,,,,,,,,,,,,,,,483.0,it ITA,FW,30.0,13.4,4.0,0.0,0.0,14.0,22.0,5.0,32.0,5.0,5.0,0.0,0.0,0.0,67.0,8.0,8.0,50.0,Matches,483.0,it ITA,FW,30.0,13.4,457.0,451.0,3.0,0.0,2.0,6.0,32.0,3.0,0.0,0.0,0.0,0.0,329.0,3.0,13.0,Matches,483.0,it ITA,FW,30.0,13.4,329.0,457.0,72.0,4773.0,1264.0,209.0,249.0,83.9,85.0,122.0,69.7,19.0,39.0,48.7,3.0,3.4,2.2,-0.4,20.0,26.0,27.0,7.0,56.0,Matches,616,it ITA,FW,30,29,1208.0,42.0,35.3,13.4,14,62.0,0,15,23.0,8,1.55,21.0,17.0,4.0,0.3,0.05,18.8,18.9,-0.1,0.0,-0.48,Matches,483.0,it ITA,FW,30.0,13.4,606.0,12.0,66.0,235.0,317.0,61.0,606.0,42.0,18.0,42.9,19.0,45.2,409.0,2870.0,1567.0,56.0,37.0,16.0,29.0,19.0,470.0,125.0,Matches,483.0,it ITA,FW,30.0,13.4,4.0,37.0,13.0,35.1,2.76,0.97,0.11,0.31,19.4,0.0,0.0,0.0,2.8,2.8,0.08,1.2,1.2,Matches,483.0,it ITA,FW,30.0,29.0,14.0,1208.0,13.4,4.0,3.0,7.0,4.0,0.0,0.0,4.0,0.0,2.8,2.8,3.4,6.2,56.0,56.0,125.0,0.3,0.22,0.52,0.3,0.52,0.21,0.26,0.46,0.21,0.46,Matches,Riccardo Saponara,AM LC,30,132,142,Italy,ACF Fiorentina,13,13,15,13,14,14,8,14,4,5,14,12,9,16,8,14,11,13,11,14,12,12,16,11,14,7,14,13,12,12,12,10,15,12,13,11,12,8,12,11,13,3,1,3,3,3,2,3,1,2,4,2,10,14,5,12,8,15,14,14,1,1,1,1,1,1,1,1,12,1,19,20,11,15,184,73,12,20,2130174,6598,6298,5148,Mediterranean_Hispanic,130,3,1991/12/21,0,0,24615.0,,43056489
1327,Giorgio Scalvini,Atalanta,2003,486.0,it ITA,DF,18.0,25.9,54.0,29.0,30.0,18.0,6.0,29.0,55.0,52.7,26.0,36.0,13.0,23.0,56.0,110.0,57.0,2.0,Matches,486.0,it ITA,DF,18.0,25.9,33.0,1.27,29.0,1.0,2.0,0.0,0.0,1.0,5.0,0.19,5.0,0.0,0.0,0.0,0.0,0.0,Matches,,,,,,,,,,,,,,,,,,,,,,,,,,,,,,,,,,,,,,,,,,,,,,,,,,,,,,,,486.0,it ITA,DF,18.0,25.9,7.0,0.0,0.0,55.0,6.0,6.0,8.0,56.0,29.0,0.0,0.0,0.0,179.0,49.0,37.0,57.0,Matches,486.0,it ITA,DF,18.0,25.9,1486.0,1443.0,40.0,29.0,1.0,21.0,8.0,11.0,0.0,0.0,0.0,0.0,1205.0,3.0,20.0,Matches,486.0,it ITA,DF,18.0,25.9,1205.0,1486.0,81.1,19877.0,8249.0,613.0,687.0,89.2,476.0,545.0,87.3,90.0,184.0,48.9,2.0,0.4,0.8,1.6,9.0,133.0,14.0,2.0,158.0,Matches,621,it ITA,DF,18,32,2335.0,73.0,68.3,25.9,29,79.0,15,3,19.0,4,1.75,46.0,35.0,11.0,0.42,-0.16,36.8,29.9,6.9,0.27,-0.51,Matches,486.0,it ITA,DF,18.0,25.9,1762.0,124.0,687.0,861.0,226.0,32.0,1762.0,26.0,12.0,46.2,11.0,42.3,917.0,3552.0,1989.0,22.0,22.0,6.0,20.0,8.0,1146.0,34.0,Matches,486.0,it ITA,DF,18.0,25.9,2.0,17.0,4.0,23.5,0.66,0.15,0.12,0.5,11.2,0.0,0.0,0.0,2.0,2.0,0.12,0.0,0.0,Matches,486.0,it ITA,DF,18.0,32.0,29.0,2335.0,25.9,2.0,2.0,4.0,2.0,0.0,0.0,7.0,0.0,2.0,2.0,0.4,2.4,22.0,158.0,34.0,0.08,0.08,0.15,0.08,0.15,0.08,0.01,0.09,0.08,0.09,Matches,Giorgio Scalvini,D/DM C,18,131,-9,Italy,Atalanta,4,6,10,6,11,4,13,7,5,14,11,4,14,12,12,15,12,13,15,11,13,16,7,9,7,14,15,13,12,12,12,15,15,13,15,14,14,10,15,6,7,4,1,2,1,2,3,2,3,3,2,2,16,17,6,14,15,18,12,13,1,1,20,1,1,1,17,1,12,1,1,1,1,1,194,87,10,20,69240000,6550,6250,3513,Mediterranean_Hispanic,130,1,2003/12/11,1,0,29769.0,,43500755
1328,Jerdy Schouten,Bologna,1997,487.0,nl NED,MF,25.0,27.9,63.0,38.0,28.0,33.0,2.0,27.0,49.0,55.1,22.0,40.0,17.0,23.0,40.0,103.0,43.0,1.0,Matches,487.0,nl NED,MF,25.0,27.9,56.0,2.01,53.0,0.0,0.0,2.0,0.0,1.0,6.0,0.22,6.0,0.0,0.0,0.0,0.0,0.0,Matches,,,,,,,,,,,,,,,,,,,,,,,,,,,,,,,,,,,,,,,,,,,,,,,,,,,,,,,,487.0,nl NED,MF,25.0,27.9,3.0,0.0,0.0,25.0,30.0,2.0,3.0,40.0,38.0,0.0,0.0,1.0,216.0,28.0,27.0,50.9,Matches,487.0,nl NED,MF,25.0,27.9,1498.0,1487.0,8.0,8.0,4.0,13.0,3.0,0.0,0.0,0.0,0.0,0.0,1299.0,3.0,16.0,Matches,487.0,nl NED,MF,25.0,27.9,1299.0,1498.0,86.7,20836.0,5831.0,688.0,763.0,90.2,494.0,553.0,89.3,87.0,115.0,75.7,2.0,1.5,1.0,0.5,19.0,118.0,9.0,0.0,139.0,Matches,622,nl NED,MF,25,33,2509.0,76.0,73.4,27.9,29,84.0,17,4,16.0,1,1.27,35.0,37.0,-2.0,-0.07,-0.66,32.4,36.0,-3.6,-0.13,-0.01,Matches,487.0,nl NED,MF,25.0,27.9,1807.0,81.0,492.0,1138.0,193.0,10.0,1807.0,48.0,27.0,56.3,13.0,27.1,1033.0,4285.0,1647.0,15.0,13.0,1.0,43.0,25.0,1239.0,29.0,Matches,487.0,nl NED,MF,25.0,27.9,0.0,8.0,2.0,25.0,0.29,0.07,0.0,0.0,18.0,0.0,0.0,0.0,0.4,0.4,0.05,-0.4,-0.4,Matches,487.0,nl NED,MF,25.0,33.0,29.0,2509.0,27.9,0.0,2.0,2.0,0.0,0.0,0.0,3.0,0.0,0.4,0.4,1.5,1.9,15.0,139.0,29.0,0.0,0.07,0.07,0.0,0.07,0.02,0.05,0.07,0.02,0.07,Matches,Jerdy Schouten,DM/M C,25,133,142,Holland,Bologna FC 1909,9,10,15,8,15,9,12,12,8,12,15,10,15,16,13,14,12,12,11,13,13,14,12,10,12,13,16,14,11,12,15,10,12,11,14,11,13,16,10,11,13,2,2,2,1,3,3,2,3,3,3,2,14,16,2,15,10,16,14,12,1,1,10,1,1,1,20,1,20,1,1,5,1,1,185,77,11,20,5273663,6650,6550,5250,Northern_European,133,0,1997/1/12,1,0,35221.0,,37057744
1329,Perr Schuurs,Torino,1999,488.0,nl NED,DF,22.0,25.8,51.0,25.0,29.0,17.0,5.0,14.0,26.0,53.8,12.0,28.0,16.0,12.0,28.0,79.0,102.0,0.0,Matches,488.0,nl NED,DF,22.0,25.8,20.0,0.77,14.0,0.0,3.0,1.0,1.0,1.0,2.0,0.08,2.0,0.0,0.0,0.0,0.0,0.0,Matches,,,,,,,,,,,,,,,,,,,,,,,,,,,,,,,,,,,,,,,,,,,,,,,,,,,,,,,,488.0,nl NED,DF,22.0,25.8,5.0,0.0,0.0,31.0,3.0,2.0,2.0,28.0,25.0,0.0,1.0,0.0,177.0,60.0,49.0,55.0,Matches,488.0,nl NED,DF,22.0,25.8,1201.0,1165.0,36.0,31.0,0.0,1.0,2.0,5.0,0.0,0.0,0.0,0.0,1058.0,0.0,7.0,Matches,488.0,nl NED,DF,22.0,25.8,1058.0,1201.0,88.1,20819.0,6259.0,320.0,358.0,89.4,622.0,671.0,92.7,108.0,142.0,76.1,2.0,0.9,0.8,1.1,7.0,35.0,3.0,0.0,56.0,Matches,623,nl NED,DF,22,30,2326.0,78.0,68.0,25.8,28,82.0,21,2,14.0,4,1.43,26.0,29.0,-3.0,-0.12,-0.45,28.6,25.1,3.4,0.13,0.27,Matches,488.0,nl NED,DF,22.0,25.8,1479.0,145.0,759.0,671.0,67.0,17.0,1479.0,14.0,10.0,71.4,3.0,21.4,768.0,3730.0,1812.0,14.0,16.0,1.0,21.0,7.0,814.0,2.0,Matches,488.0,nl NED,DF,22.0,25.8,0.0,14.0,1.0,7.1,0.54,0.04,0.0,0.0,14.9,2.0,0.0,0.0,0.9,0.9,0.07,-0.9,-0.9,Matches,488.0,nl NED,DF,22.0,30.0,28.0,2326.0,25.8,0.0,2.0,2.0,0.0,0.0,0.0,5.0,0.0,0.9,0.9,0.9,1.8,14.0,56.0,2.0,0.0,0.08,0.08,0.0,0.08,0.04,0.03,0.07,0.04,0.07,Matches,Perr Schuurs,D/DM C,22,132,157,Holland,Torino,7,9,7,7,11,15,15,14,7,14,13,8,14,12,8,15,10,13,14,13,12,15,9,12,8,14,12,13,11,12,13,15,14,12,13,13,13,4,11,9,10,4,2,1,4,2,2,3,2,2,1,2,15,12,8,15,14,15,16,15,1,1,20,14,1,12,16,1,1,1,1,1,1,1,191,87,9,20,12258749,6600,6050,5000,Northern_European,131,3,1999/11/26,0,0,49999.0,,37062161
1330,Stefano Sensi,Monza,1995,493.0,it ITA,MF,26.0,18.0,41.0,26.0,25.0,13.0,3.0,18.0,48.0,37.5,30.0,13.0,3.0,10.0,20.0,61.0,4.0,0.0,Matches,493.0,it ITA,MF,26.0,18.0,63.0,3.5,38.0,18.0,0.0,2.0,4.0,1.0,8.0,0.44,7.0,0.0,0.0,0.0,1.0,0.0,Matches,,,,,,,,,,,,,,,,,,,,,,,,,,,,,,,,,,,,,,,,,,,,,,,,,,,,,,,,493.0,it ITA,MF,26.0,18.0,8.0,0.0,0.0,18.0,50.0,2.0,50.0,20.0,26.0,1.0,0.0,0.0,124.0,8.0,10.0,44.4,Matches,493.0,it ITA,MF,26.0,18.0,1281.0,1185.0,94.0,51.0,6.0,18.0,50.0,6.0,32.0,10.0,16.0,0.0,1089.0,2.0,16.0,Matches,493.0,it ITA,MF,26.0,18.0,1089.0,1281.0,85.0,20124.0,6412.0,464.0,516.0,89.9,465.0,511.0,91.0,134.0,194.0,69.1,1.0,2.1,2.6,-1.1,24.0,128.0,21.0,3.0,143.0,Matches,630,it ITA,MF,26,28,1618.0,58.0,47.3,18.0,21,70.0,4,7,22.0,5,1.36,17.0,25.0,-8.0,-0.44,-0.64,19.3,22.4,-3.1,-0.17,-0.06,Matches,493.0,it ITA,MF,26.0,18.0,1442.0,22.0,276.0,880.0,299.0,11.0,1442.0,29.0,11.0,37.9,9.0,31.0,903.0,4511.0,1934.0,27.0,32.0,2.0,32.0,15.0,1103.0,37.0,Matches,493.0,it ITA,MF,26.0,18.0,3.0,18.0,7.0,38.9,1.0,0.39,0.17,0.43,24.8,4.0,0.0,0.0,1.4,1.4,0.08,1.6,1.6,Matches,493.0,it ITA,MF,26.0,28.0,21.0,1618.0,18.0,3.0,1.0,4.0,3.0,0.0,0.0,8.0,0.0,1.4,1.4,2.1,3.5,27.0,143.0,37.0,0.17,0.06,0.22,0.17,0.22,0.08,0.12,0.19,0.08,0.19,Matches,Stefano Sensi,DM/M/AM C,26,137,150,Italy,FC Internazionale Milano,11,13,12,11,16,16,4,13,5,6,16,12,10,16,11,15,11,15,12,15,15,15,16,11,13,13,16,12,13,16,10,4,7,13,10,7,11,8,15,20,11,2,3,2,2,1,1,2,3,1,2,3,12,15,9,12,15,16,15,13,1,1,1,1,1,1,18,1,20,1,1,16,1,1,168,63,12,20,4423330,6846,6746,6246,Mediterranean_Hispanic,136,5,1995/8/5,9,3,71154.0,Brianza,43109319
1331,Luigi Sepe,Salernitana,1991,494.0,it ITA,GK,31.0,17.0,0.0,0.0,0.0,0.0,0.0,0.0,1.0,0.0,1.0,0.0,0.0,0.0,0.0,0.0,0.0,0.0,Matches,494.0,it ITA,GK,31.0,17.0,1.0,0.06,1.0,0.0,0.0,0.0,0.0,0.0,0.0,0.0,0.0,0.0,0.0,0.0,0.0,0.0,Matches,36.0,it ITA,GK,31.0,17.0,27.0,4.0,0.0,0.0,0.0,30.3,0.27,3.3,0.2,76.0,274.0,27.7,490.0,84.0,40.6,35.9,154.0,48.7,41.1,222.0,16.0,7.2,13.0,0.76,14.2,Matches,36.0,it ITA,GK,31.0,17.0,17.0,1530.0,17.0,27.0,1.59,87.0,57.0,73.6,4.0,5.0,8.0,3.0,17.6,7.0,4.0,3.0,0.0,42.9,Matches,494.0,it ITA,GK,31.0,17.0,3.0,0.0,0.0,1.0,2.0,0.0,0.0,0.0,0.0,0.0,1.0,0.0,27.0,4.0,0.0,100.0,Matches,494.0,it ITA,GK,31.0,17.0,648.0,435.0,209.0,55.0,0.0,1.0,0.0,0.0,0.0,0.0,0.0,0.0,441.0,4.0,0.0,Matches,494.0,it ITA,GK,31.0,17.0,441.0,648.0,68.1,11985.0,9017.0,79.0,79.0,100.0,216.0,217.0,99.5,143.0,345.0,41.4,0.0,0.0,0.0,0.0,0.0,8.0,0.0,0.0,0.0,Matches,631,it ITA,GK,31,17,1530.0,90.0,44.7,17.0,17,90.0,17,0,,16,1.0,19.0,27.0,-8.0,-0.47,-0.18,17.6,31.1,-13.6,-0.8,0.01,Matches,494.0,it ITA,GK,31.0,17.0,692.0,605.0,692.0,0.0,0.0,0.0,692.0,0.0,0.0,,0.0,,346.0,1709.0,1260.0,0.0,0.0,0.0,1.0,0.0,273.0,0.0,Matches,494.0,it ITA,GK,31.0,17.0,0.0,0.0,0.0,,0.0,0.0,,,,0.0,0.0,0.0,0.0,0.0,,0.0,0.0,Matches,494.0,it ITA,GK,31.0,17.0,17.0,1530.0,17.0,0.0,0.0,0.0,0.0,0.0,0.0,3.0,0.0,0.0,0.0,0.0,0.0,0.0,0.0,0.0,0.0,0.0,0.0,0.0,0.0,0.0,0.0,0.0,0.0,0.0,Matches,Luigi Sepe,GK,31,129,140,Italy,U.S. Salernitana 1919,1,3,3,1,10,3,8,1,2,1,11,3,1,9,13,13,12,13,14,11,12,13,4,10,2,14,12,12,13,13,14,14,12,12,14,12,14,8,13,4,11,12,10,11,10,14,14,14,15,6,14,12,12,14,13,9,12,8,14,13,20,1,1,1,1,1,1,1,1,1,1,1,1,1,185,75,20,7,1966106,6437,6437,4987,Mediterranean_Hispanic,129,7,1991/5/8,0,0,32115.0,,43030617
1332,Leonardo Sernicola,Cremonese,1997,495.0,it ITA,DF,25.0,25.7,45.0,33.0,25.0,13.0,7.0,29.0,43.0,67.4,14.0,23.0,6.0,17.0,38.0,83.0,55.0,0.0,Matches,495.0,it ITA,DF,25.0,25.7,55.0,2.14,40.0,5.0,1.0,3.0,5.0,1.0,4.0,0.16,3.0,0.0,0.0,0.0,1.0,0.0,Matches,,,,,,,,,,,,,,,,,,,,,,,,,,,,,,,,,,,,,,,,,,,,,,,,,,,,,,,,495.0,it ITA,DF,25.0,25.7,11.0,0.0,0.0,40.0,43.0,3.0,118.0,38.0,33.0,0.0,1.0,0.0,136.0,29.0,21.0,58.0,Matches,495.0,it ITA,DF,25.0,25.7,945.0,737.0,203.0,12.0,2.0,6.0,118.0,179.0,12.0,0.0,11.0,0.0,615.0,5.0,25.0,Matches,495.0,it ITA,DF,25.0,25.7,615.0,945.0,65.1,10638.0,4546.0,293.0,352.0,83.2,239.0,389.0,61.4,64.0,143.0,44.8,2.0,2.3,2.2,-0.3,25.0,50.0,29.0,21.0,62.0,Matches,632,it ITA,DF,25,32,2317.0,72.0,67.7,25.7,27,82.0,18,5,22.0,4,0.78,25.0,50.0,-25.0,-0.97,-0.32,27.7,45.5,-17.8,-0.69,0.09,Matches,495.0,it ITA,DF,25.0,25.7,1220.0,67.0,352.0,498.0,387.0,24.0,1220.0,57.0,24.0,42.1,22.0,38.6,592.0,3716.0,2045.0,60.0,45.0,5.0,28.0,21.0,610.0,95.0,Matches,495.0,it ITA,DF,25.0,25.7,2.0,25.0,5.0,20.0,0.97,0.19,0.08,0.4,21.3,0.0,0.0,0.0,1.3,1.3,0.05,0.7,0.7,Matches,495.0,it ITA,DF,25.0,32.0,27.0,2317.0,25.7,2.0,2.0,4.0,2.0,0.0,0.0,11.0,0.0,1.3,1.3,2.3,3.7,60.0,62.0,95.0,0.08,0.08,0.16,0.08,0.16,0.05,0.09,0.14,0.05,0.14,Matches,Leonardo Sernicola,D/WB/M RL,24,120,128,Italy,Cremonese,10,13,12,9,10,4,12,10,12,12,10,6,12,11,14,13,11,10,12,10,10,17,5,10,13,10,12,14,12,13,10,13,15,12,15,12,14,5,14,4,16,4,2,3,3,1,3,2,2,4,3,2,12,15,2,14,15,16,15,7,1,19,14,20,18,19,1,15,1,16,1,1,1,1,188,77,8,20,969237,5993,5993,3743,Mediterranean_Hispanic,108,3,1997/7/30,0,0,2845.0,,43162020
1333,Stephan El Shaarawy,Roma,1992,496.0,it ITA,DFMF,29.0,16.9,21.0,9.0,8.0,10.0,3.0,6.0,22.0,27.3,16.0,11.0,1.0,10.0,15.0,36.0,11.0,0.0,Matches,496.0,it ITA,DFMF,29.0,16.9,72.0,4.25,49.0,8.0,9.0,4.0,2.0,0.0,7.0,0.41,4.0,0.0,1.0,1.0,1.0,0.0,Matches,,,,,,,,,,,,,,,,,,,,,,,,,,,,,,,,,,,,,,,,,,,,,,,,,,,,,,,,496.0,it ITA,DFMF,29.0,16.9,3.0,0.0,0.0,16.0,18.0,9.0,23.0,15.0,9.0,1.0,0.0,0.0,96.0,16.0,18.0,47.1,Matches,496.0,it ITA,DFMF,29.0,16.9,825.0,717.0,108.0,10.0,5.0,9.0,23.0,93.0,4.0,4.0,0.0,0.0,665.0,0.0,19.0,Matches,496.0,it ITA,DFMF,29.0,16.9,665.0,825.0,80.6,10633.0,2974.0,357.0,403.0,88.6,245.0,298.0,82.2,47.0,77.0,61.0,2.0,1.4,1.6,0.6,27.0,36.0,21.0,3.0,66.0,Matches,635,it ITA,DFMF,29,29,1523.0,53.0,44.5,16.9,14,77.0,5,15,30.0,5,1.62,35.0,16.0,19.0,1.12,1.45,32.2,16.0,16.2,0.96,0.53,Matches,496.0,it ITA,DFMF,29.0,16.9,1032.0,16.0,185.0,467.0,395.0,63.0,1032.0,70.0,26.0,37.1,39.0,55.7,619.0,3834.0,1842.0,58.0,41.0,20.0,35.0,11.0,681.0,136.0,Matches,496.0,it ITA,DFMF,29.0,16.9,7.0,42.0,19.0,45.2,2.48,1.12,0.17,0.37,19.2,0.0,0.0,0.0,5.5,5.5,0.13,1.5,1.5,Matches,496.0,it ITA,DFMF,29.0,29.0,14.0,1523.0,16.9,7.0,2.0,9.0,7.0,0.0,0.0,3.0,0.0,5.5,5.5,1.4,6.9,58.0,66.0,136.0,0.41,0.12,0.53,0.41,0.53,0.33,0.08,0.41,0.33,0.41,Matches,Stephan El Shaarawy,M/AM LC,29,140,152,"Italy,Egypt,Venezuela",Associazione Sportiva Roma,12,11,14,14,16,11,8,14,4,6,14,12,7,17,9,15,11,12,14,13,14,13,15,5,16,9,11,12,15,15,12,8,10,15,12,10,12,6,11,15,14,2,1,2,3,3,1,4,3,1,2,2,10,15,8,12,9,11,15,15,1,1,1,1,14,10,1,19,1,10,20,15,12,14,178,72,9,20,6886942,6997,6697,5747,Mediterranean_Hispanic,139,2,1992/10/27,29,6,106922.0,,43036636
1334,Marco Silvestri,Udinese,1991,499.0,it ITA,GK,31.0,38.0,2.0,1.0,2.0,0.0,0.0,2.0,3.0,66.7,1.0,0.0,0.0,0.0,1.0,3.0,15.0,1.0,Matches,499.0,it ITA,GK,31.0,38.0,8.0,0.21,7.0,1.0,0.0,0.0,0.0,0.0,0.0,0.0,0.0,0.0,0.0,0.0,0.0,0.0,Matches,37.0,it ITA,GK,31.0,38.0,48.0,6.0,2.0,3.0,2.0,48.7,0.31,2.7,0.07,144.0,380.0,37.9,872.0,142.0,31.9,32.0,302.0,33.8,34.1,547.0,13.0,2.4,21.0,0.55,12.2,Matches,37.0,it ITA,GK,31.0,38.0,38.0,3420.0,38.0,48.0,1.26,137.0,91.0,69.3,11.0,13.0,14.0,10.0,26.3,7.0,6.0,0.0,1.0,0.0,Matches,499.0,it ITA,GK,31.0,38.0,0.0,0.0,0.0,0.0,4.0,0.0,0.0,1.0,1.0,0.0,0.0,0.0,39.0,9.0,0.0,100.0,Matches,499.0,it ITA,GK,31.0,38.0,1177.0,783.0,391.0,89.0,0.0,5.0,0.0,0.0,0.0,0.0,0.0,0.0,916.0,3.0,0.0,Matches,499.0,it ITA,GK,31.0,38.0,916.0,1177.0,77.8,23603.0,17093.0,190.0,190.0,100.0,486.0,492.0,98.8,236.0,488.0,48.4,0.0,0.0,0.0,0.0,0.0,9.0,0.0,0.0,0.0,Matches,639,it ITA,GK,31,38,3420.0,90.0,100.0,38.0,38,90.0,38,0,,0,1.21,47.0,48.0,-1.0,-0.03,,46.9,51.8,-4.9,-0.13,,Matches,499.0,it ITA,GK,31.0,38.0,1267.0,1140.0,1267.0,0.0,0.0,0.0,1267.0,0.0,0.0,,0.0,,625.0,2964.0,2110.0,0.0,0.0,0.0,0.0,0.0,544.0,0.0,Matches,499.0,it ITA,GK,31.0,38.0,0.0,0.0,0.0,,0.0,0.0,,,,0.0,0.0,0.0,0.0,0.0,,0.0,0.0,Matches,499.0,it ITA,GK,31.0,38.0,38.0,3420.0,38.0,0.0,0.0,0.0,0.0,0.0,0.0,0.0,0.0,0.0,0.0,0.0,0.0,0.0,0.0,0.0,0.0,0.0,0.0,0.0,0.0,0.0,0.0,0.0,0.0,0.0,Matches,Marco Silvestri,GK,31,138,143,Italy,Udinese Calcio,6,3,3,2,7,7,5,3,2,2,7,4,2,8,11,14,14,13,13,9,14,14,6,10,8,15,15,13,12,15,11,14,13,11,13,13,15,9,12,5,12,14,15,14,11,14,10,13,16,11,15,9,15,13,6,12,13,17,13,14,20,1,1,1,1,1,1,1,1,1,1,1,1,1,191,80,6,20,347975206,6900,6850,5250,Mediterranean_Hispanic,138,4,1991/3/2,0,0,17885.0,,43041142
1335,Wilfried Singo,Torino,2000,501.0,ci CIV,DF,21.0,22.7,27.0,17.0,14.0,10.0,3.0,12.0,19.0,63.2,7.0,15.0,2.0,13.0,12.0,39.0,33.0,1.0,Matches,501.0,ci CIV,DF,21.0,22.7,45.0,1.98,29.0,0.0,7.0,7.0,2.0,0.0,4.0,0.18,2.0,0.0,1.0,1.0,0.0,0.0,Matches,,,,,,,,,,,,,,,,,,,,,,,,,,,,,,,,,,,,,,,,,,,,,,,,,,,,,,,,501.0,ci CIV,DF,21.0,22.7,8.0,0.0,0.0,42.0,35.0,1.0,56.0,12.0,17.0,0.0,0.0,0.0,116.0,53.0,23.0,69.7,Matches,501.0,ci CIV,DF,21.0,22.7,1138.0,923.0,207.0,20.0,3.0,7.0,56.0,187.0,0.0,0.0,0.0,0.0,853.0,8.0,19.0,Matches,501.0,ci CIV,DF,21.0,22.7,853.0,1138.0,75.0,14659.0,4321.0,393.0,458.0,85.8,376.0,492.0,76.4,67.0,131.0,51.1,1.0,1.9,1.7,-0.9,23.0,46.0,24.0,10.0,67.0,Matches,641,ci CIV,DF,21,31,2046.0,66.0,59.8,22.7,24,78.0,9,7,24.0,3,1.32,26.0,27.0,-1.0,-0.04,-0.17,22.6,23.6,-1.0,-0.04,-0.23,Matches,501.0,ci CIV,DF,21.0,22.7,1354.0,46.0,299.0,649.0,420.0,59.0,1354.0,54.0,30.0,55.6,13.0,24.1,708.0,3749.0,1789.0,54.0,34.0,9.0,33.0,17.0,849.0,93.0,Matches,501.0,ci CIV,DF,21.0,22.7,2.0,34.0,10.0,29.4,1.5,0.44,0.06,0.2,14.0,0.0,0.0,0.0,2.7,2.7,0.08,-0.7,-0.7,Matches,501.0,ci CIV,DF,21.0,31.0,24.0,2046.0,22.7,2.0,1.0,3.0,2.0,0.0,0.0,8.0,0.0,2.7,2.7,1.9,4.6,54.0,67.0,93.0,0.09,0.04,0.13,0.09,0.13,0.12,0.08,0.2,0.12,0.2,Matches,Wilfried Singo,D/WB/M R,21,135,159,Ivory Coast,Torino,6,12,14,8,11,5,12,7,12,10,13,8,12,12,14,11,11,12,12,11,11,17,11,6,13,12,12,15,16,14,12,13,14,16,14,14,12,12,11,4,13,3,3,3,3,1,2,2,3,2,2,1,12,15,6,12,13,14,13,10,1,1,12,20,1,20,1,1,1,19,1,1,1,1,190,79,9,20,19288499,6700,5615,5359,African_Caribbean,125,17,2000/12/25,2,0,4999.0,,12078947
1336,Łukasz Skorupski,Bologna,1991,504.0,pl POL,GK,31.0,37.0,2.0,1.0,2.0,0.0,0.0,1.0,2.0,50.0,1.0,0.0,0.0,0.0,0.0,2.0,19.0,2.0,Matches,504.0,pl POL,GK,31.0,37.0,4.0,0.11,1.0,3.0,0.0,0.0,0.0,0.0,0.0,0.0,0.0,0.0,0.0,0.0,0.0,0.0,Matches,39.0,pl POL,GK,31.0,37.0,49.0,7.0,1.0,6.0,3.0,47.8,0.25,1.8,0.05,146.0,371.0,39.4,933.0,206.0,29.8,31.7,278.0,33.5,33.0,492.0,29.0,5.9,24.0,0.65,12.9,Matches,39.0,pl POL,GK,31.0,37.0,37.0,3330.0,37.0,49.0,1.32,161.0,113.0,73.9,13.0,12.0,12.0,7.0,18.9,9.0,7.0,2.0,0.0,22.2,Matches,504.0,pl POL,GK,31.0,37.0,4.0,0.0,0.0,1.0,7.0,0.0,0.0,0.0,1.0,0.0,1.0,0.0,53.0,6.0,1.0,85.7,Matches,504.0,pl POL,GK,31.0,37.0,1216.0,854.0,357.0,79.0,0.0,3.0,0.0,0.0,0.0,0.0,0.0,0.0,957.0,5.0,0.0,Matches,504.0,pl POL,GK,31.0,37.0,957.0,1216.0,78.7,24937.0,16773.0,197.0,199.0,99.0,426.0,430.0,99.1,306.0,554.0,55.2,0.0,0.0,0.0,0.0,0.0,4.0,0.0,0.0,0.0,Matches,645,pl POL,GK,31,37,3330.0,90.0,97.4,37.0,37,90.0,37,0,,0,1.38,50.0,49.0,1.0,0.03,-2.97,43.2,47.9,-4.7,-0.13,0.01,Matches,504.0,pl POL,GK,31.0,37.0,1311.0,1189.0,1306.0,5.0,0.0,0.0,1311.0,0.0,0.0,,0.0,,707.0,3512.0,2253.0,0.0,0.0,0.0,1.0,0.0,553.0,0.0,Matches,504.0,pl POL,GK,31.0,37.0,0.0,0.0,0.0,,0.0,0.0,,,,0.0,0.0,0.0,0.0,0.0,,0.0,0.0,Matches,504.0,pl POL,GK,31.0,37.0,37.0,3330.0,37.0,0.0,0.0,0.0,0.0,0.0,0.0,4.0,0.0,0.0,0.0,0.0,0.0,0.0,0.0,0.0,0.0,0.0,0.0,0.0,0.0,0.0,0.0,0.0,0.0,0.0,Matches,Łukasz Skorupski,GK,31,130,137,Poland,Bologna FC 1909,7,3,1,1,5,8,6,2,3,3,5,3,2,5,13,13,14,12,12,5,13,13,10,11,9,14,17,16,12,16,15,14,14,13,15,15,14,8,12,4,11,13,11,11,1,12,9,17,16,3,16,9,12,13,5,14,10,17,17,14,20,1,1,1,1,1,1,1,1,1,1,1,1,1,187,84,5,20,2492869,6492,6492,5592,Northern_European,129,2,1991/5/5,7,0,32115.0,,54009099
1337,Milan Škriniar,Inter,1995,505.0,sk SVK,DF,27.0,19.7,29.0,18.0,14.0,11.0,4.0,18.0,32.0,56.3,14.0,18.0,13.0,5.0,13.0,42.0,46.0,3.0,Matches,505.0,sk SVK,DF,27.0,19.7,11.0,0.56,11.0,0.0,0.0,0.0,0.0,0.0,0.0,0.0,0.0,0.0,0.0,0.0,0.0,0.0,Matches,,,,,,,,,,,,,,,,,,,,,,,,,,,,,,,,,,,,,,,,,,,,,,,,,,,,,,,,505.0,sk SVK,DF,27.0,19.7,5.0,1.0,1.0,35.0,14.0,1.0,5.0,13.0,18.0,0.0,0.0,1.0,112.0,17.0,18.0,48.6,Matches,505.0,sk SVK,DF,27.0,19.7,1397.0,1328.0,67.0,43.0,1.0,13.0,5.0,22.0,0.0,0.0,0.0,0.0,1275.0,2.0,6.0,Matches,505.0,sk SVK,DF,27.0,19.7,1275.0,1397.0,91.3,23769.0,7731.0,445.0,479.0,92.9,707.0,739.0,95.7,103.0,144.0,71.5,0.0,0.3,0.4,-0.3,6.0,79.0,4.0,1.0,81.0,Matches,646,sk SVK,DF,27,21,1769.0,84.0,51.7,19.7,20,87.0,17,1,33.0,2,1.95,37.0,23.0,14.0,0.71,-0.11,32.8,17.6,15.2,0.77,-0.12,Matches,505.0,sk SVK,DF,27.0,19.7,1546.0,151.0,741.0,721.0,90.0,13.0,1546.0,3.0,3.0,100.0,0.0,0.0,976.0,4478.0,2134.0,16.0,11.0,0.0,14.0,3.0,1137.0,10.0,Matches,505.0,sk SVK,DF,27.0,19.7,0.0,9.0,2.0,22.2,0.46,0.1,0.0,0.0,13.0,0.0,0.0,0.0,0.8,0.8,0.09,-0.8,-0.8,Matches,505.0,sk SVK,DF,27.0,21.0,20.0,1769.0,19.7,0.0,0.0,0.0,0.0,0.0,0.0,5.0,1.0,0.8,0.8,0.3,1.1,16.0,81.0,10.0,0.0,0.0,0.0,0.0,0.0,0.04,0.01,0.05,0.04,0.05,Matches,Milan Škriniar,D C,27,161,168,Slovakia,FC Internazionale Milano,4,7,9,10,10,4,17,6,11,18,12,10,17,11,17,16,17,12,13,9,13,18,6,14,10,14,16,16,14,11,16,16,18,15,16,18,15,12,14,3,11,1,3,1,2,3,3,2,4,4,1,2,14,16,5,16,14,19,12,11,1,5,20,12,1,1,10,1,5,1,1,1,1,1,188,82,9,20,48719002,8050,8050,7750,Northern_European,159,2,1995/2/11,54,3,106922.0,,63013145
1338,Chris Smalling,Roma,1989,506.0,eng ENG,DF,32.0,31.2,26.0,15.0,16.0,10.0,0.0,13.0,21.0,61.9,8.0,51.0,36.0,15.0,43.0,69.0,123.0,0.0,Matches,506.0,eng ENG,DF,32.0,31.2,16.0,0.51,14.0,1.0,0.0,1.0,0.0,0.0,1.0,0.03,1.0,0.0,0.0,0.0,0.0,0.0,Matches,,,,,,,,,,,,,,,,,,,,,,,,,,,,,,,,,,,,,,,,,,,,,,,,,,,,,,,,506.0,eng ENG,DF,32.0,31.2,7.0,0.0,0.0,18.0,14.0,1.0,1.0,43.0,15.0,0.0,0.0,0.0,142.0,71.0,24.0,74.7,Matches,506.0,eng ENG,DF,32.0,31.2,1344.0,1315.0,27.0,25.0,1.0,4.0,1.0,2.0,0.0,0.0,0.0,0.0,1173.0,2.0,10.0,Matches,506.0,eng ENG,DF,32.0,31.2,1173.0,1344.0,87.3,22956.0,7520.0,335.0,366.0,91.5,713.0,778.0,91.6,113.0,162.0,69.8,1.0,0.4,0.8,0.6,6.0,35.0,3.0,0.0,51.0,Matches,647,eng ENG,DF,32,32,2808.0,88.0,82.1,31.2,31,89.0,30,1,63.0,2,1.88,45.0,27.0,18.0,0.58,1.46,50.9,25.0,25.9,0.83,0.91,Matches,506.0,eng ENG,DF,32.0,31.2,1657.0,254.0,977.0,637.0,52.0,34.0,1657.0,4.0,2.0,50.0,1.0,25.0,877.0,3859.0,1889.0,5.0,7.0,0.0,10.0,2.0,1002.0,7.0,Matches,506.0,eng ENG,DF,32.0,31.2,3.0,17.0,4.0,23.5,0.54,0.13,0.18,0.75,8.5,0.0,0.0,0.0,1.7,1.7,0.1,1.3,1.3,Matches,506.0,eng ENG,DF,32.0,32.0,31.0,2808.0,31.2,3.0,1.0,4.0,3.0,0.0,0.0,7.0,0.0,1.7,1.7,0.4,2.1,5.0,51.0,7.0,0.1,0.03,0.13,0.1,0.13,0.05,0.01,0.07,0.05,0.07,Matches,Chris Smalling,D C,32,152,154,England,Associazione Sportiva Roma,4,4,7,8,10,2,17,3,2,17,11,4,17,9,14,16,16,11,10,8,13,17,2,12,5,17,15,14,13,11,14,18,15,15,13,17,15,3,13,14,8,3,1,3,3,1,3,3,3,4,4,1,16,14,6,17,14,20,16,17,1,1,20,10,1,1,1,1,1,1,1,1,1,1,194,90,7,20,38375170,7600,6768,6266,African_Caribbean,147,13,1989/11/22,31,1,93653.0,,30022142
1339,Roberto Soriano,Bologna,1991,510.0,it ITA,FWMF,31.0,14.7,31.0,16.0,9.0,16.0,6.0,13.0,25.0,52.0,12.0,23.0,2.0,21.0,6.0,37.0,14.0,0.0,Matches,510.0,it ITA,FWMF,31.0,14.7,45.0,3.06,35.0,1.0,1.0,2.0,4.0,2.0,3.0,0.2,2.0,0.0,0.0,1.0,0.0,0.0,Matches,,,,,,,,,,,,,,,,,,,,,,,,,,,,,,,,,,,,,,,,,,,,,,,,,,,,,,,,510.0,it ITA,FWMF,31.0,14.7,1.0,0.0,0.0,20.0,33.0,2.0,11.0,6.0,16.0,0.0,0.0,0.0,77.0,11.0,16.0,40.7,Matches,510.0,it ITA,FWMF,31.0,14.7,605.0,595.0,10.0,4.0,5.0,3.0,11.0,6.0,0.0,0.0,0.0,0.0,486.0,0.0,15.0,Matches,510.0,it ITA,FWMF,31.0,14.7,486.0,605.0,80.3,6944.0,1994.0,306.0,349.0,87.7,139.0,171.0,81.3,26.0,42.0,61.9,3.0,2.5,1.5,0.5,20.0,35.0,10.0,2.0,56.0,Matches,651,it ITA,FWMF,31,27,1326.0,49.0,38.8,14.7,15,70.0,3,12,23.0,2,1.59,20.0,13.0,7.0,0.48,0.6,15.8,17.6,-1.8,-0.12,0.01,Matches,510.0,it ITA,FWMF,31.0,14.7,739.0,25.0,110.0,393.0,249.0,27.0,739.0,14.0,6.0,42.9,5.0,35.7,470.0,2620.0,1170.0,30.0,34.0,0.0,22.0,15.0,568.0,66.0,Matches,510.0,it ITA,FWMF,31.0,14.7,1.0,13.0,2.0,15.4,0.88,0.14,0.08,0.5,20.3,0.0,0.0,0.0,0.6,0.6,0.05,0.4,0.4,Matches,510.0,it ITA,FWMF,31.0,27.0,15.0,1326.0,14.7,1.0,3.0,4.0,1.0,0.0,0.0,1.0,0.0,0.6,0.6,2.5,3.1,30.0,56.0,66.0,0.07,0.2,0.27,0.07,0.27,0.04,0.17,0.21,0.04,0.21,Matches,Roberto Soriano,M/AM C,31,134,150,"Italy,Germany",Bologna FC 1909,8,11,14,11,15,9,8,13,4,8,14,9,11,16,12,14,13,13,14,15,13,13,15,12,13,11,16,16,12,13,14,10,13,11,11,13,14,13,12,7,12,1,2,1,1,3,3,3,1,3,2,2,16,15,8,14,13,15,11,7,1,1,1,1,1,1,12,10,18,7,10,20,9,11,182,76,12,20,3285844,6700,6500,6250,Mediterranean_Hispanic,134,6,1991/2/8,9,0,39422.0,,43044387
1340,Adama Soumaoro,Bologna,1992,514.0,fr FRA,DF,30.0,20.7,25.0,17.0,11.0,12.0,2.0,5.0,7.0,71.4,2.0,18.0,13.0,5.0,15.0,40.0,75.0,1.0,Matches,514.0,fr FRA,DF,30.0,20.7,7.0,0.34,7.0,0.0,0.0,0.0,0.0,0.0,1.0,0.05,1.0,0.0,0.0,0.0,0.0,0.0,Matches,,,,,,,,,,,,,,,,,,,,,,,,,,,,,,,,,,,,,,,,,,,,,,,,,,,,,,,,514.0,fr FRA,DF,30.0,20.7,5.0,1.0,1.0,21.0,12.0,0.0,0.0,15.0,17.0,0.0,0.0,0.0,96.0,31.0,15.0,67.4,Matches,514.0,fr FRA,DF,30.0,20.7,1075.0,1021.0,48.0,47.0,0.0,1.0,0.0,1.0,0.0,0.0,0.0,0.0,996.0,6.0,5.0,Matches,514.0,fr FRA,DF,30.0,20.7,996.0,1075.0,92.7,18518.0,6098.0,358.0,376.0,95.2,550.0,580.0,94.8,78.0,95.0,82.1,0.0,0.0,0.1,0.0,1.0,28.0,1.0,0.0,50.0,Matches,657,fr FRA,DF,30,23,1867.0,81.0,54.6,20.7,22,84.0,18,1,25.0,4,1.39,28.0,25.0,3.0,0.14,0.09,22.6,26.0,-3.5,-0.17,-0.09,Matches,514.0,fr FRA,DF,30.0,20.7,1226.0,158.0,649.0,557.0,23.0,7.0,1226.0,3.0,2.0,66.7,0.0,0.0,721.0,3553.0,1787.0,7.0,5.0,0.0,6.0,1.0,830.0,1.0,Matches,514.0,fr FRA,DF,30.0,20.7,0.0,2.0,1.0,50.0,0.1,0.05,0.0,0.0,8.8,0.0,0.0,0.0,0.3,0.3,0.16,-0.3,-0.3,Matches,514.0,fr FRA,DF,30.0,23.0,22.0,1867.0,20.7,0.0,0.0,0.0,0.0,0.0,0.0,5.0,1.0,0.3,0.3,0.0,0.3,7.0,50.0,1.0,0.0,0.0,0.0,0.0,0.0,0.02,0.0,0.02,0.02,0.02,Matches,Adama Soumaoro,D C,30,128,135,"France,Mali",Bologna FC 1909,4,5,8,8,10,5,16,6,8,15,9,6,13,10,16,12,13,13,13,8,12,10,5,6,7,15,10,12,10,11,16,14,14,12,14,17,13,14,10,8,9,3,2,2,1,1,3,1,2,2,3,1,10,10,7,16,12,10,14,8,1,1,20,12,1,1,11,1,7,1,1,1,1,1,186,93,9,20,2419711,6400,6250,3902,African_Caribbean,124,16,1992/6/18,0,0,26730.0,,85032346
1341,Leonardo Spinazzola,Roma,1993,515.0,it ITA,DF,29.0,18.4,15.0,8.0,7.0,6.0,2.0,8.0,23.0,34.8,15.0,13.0,3.0,10.0,9.0,24.0,25.0,0.0,Matches,515.0,it ITA,DF,29.0,18.4,46.0,2.5,36.0,2.0,4.0,1.0,3.0,0.0,7.0,0.38,6.0,0.0,1.0,0.0,0.0,0.0,Matches,,,,,,,,,,,,,,,,,,,,,,,,,,,,,,,,,,,,,,,,,,,,,,,,,,,,,,,,515.0,it ITA,DF,29.0,18.4,3.0,0.0,0.0,13.0,13.0,1.0,57.0,9.0,8.0,0.0,0.0,0.0,99.0,9.0,8.0,52.9,Matches,515.0,it ITA,DF,29.0,18.4,989.0,806.0,179.0,14.0,4.0,14.0,57.0,165.0,0.0,0.0,0.0,0.0,750.0,4.0,21.0,Matches,515.0,it ITA,DF,29.0,18.4,750.0,989.0,75.8,13111.0,4315.0,355.0,408.0,87.0,300.0,385.0,77.9,78.0,144.0,54.2,4.0,2.0,2.0,2.0,21.0,37.0,26.0,12.0,63.0,Matches,658,it ITA,DF,29,26,1654.0,64.0,48.4,18.4,18,81.0,12,8,24.0,4,1.73,20.0,21.0,-1.0,-0.05,-0.72,28.4,15.5,12.9,0.7,0.06,Matches,515.0,it ITA,DF,29.0,18.4,1157.0,36.0,296.0,560.0,319.0,41.0,1157.0,59.0,25.0,42.4,28.0,47.5,698.0,5327.0,3192.0,107.0,52.0,24.0,26.0,11.0,745.0,87.0,Matches,515.0,it ITA,DF,29.0,18.4,1.0,10.0,6.0,60.0,0.54,0.33,0.1,0.17,18.7,0.0,0.0,0.0,1.0,1.0,0.1,0.0,0.0,Matches,515.0,it ITA,DF,29.0,26.0,18.0,1654.0,18.4,1.0,4.0,5.0,1.0,0.0,0.0,3.0,0.0,1.0,1.0,2.0,3.0,107.0,63.0,87.0,0.05,0.22,0.27,0.05,0.27,0.06,0.11,0.16,0.06,0.16,Matches,Leonardo Spinazzola,D/WB/M L,29,147,153,Italy,Associazione Sportiva Roma,6,14,16,8,16,5,11,9,8,11,14,7,10,15,8,12,8,12,14,14,12,13,16,6,16,10,11,11,16,14,13,11,9,17,12,11,14,8,13,15,16,1,1,2,2,3,2,1,3,1,4,3,12,12,8,11,15,13,16,17,1,19,10,12,20,12,1,20,1,12,10,1,10,1,186,75,14,20,40261135,7348,7348,7148,Mediterranean_Hispanic,137,4,1993/3/25,20,0,106922.0,,43036586
1342,Marco Sportiello,Atalanta,1992,516.0,it ITA,GK,30.0,14.9,1.0,0.0,1.0,0.0,0.0,1.0,3.0,33.3,2.0,0.0,0.0,0.0,0.0,1.0,2.0,0.0,Matches,516.0,it ITA,GK,30.0,14.9,4.0,0.27,2.0,2.0,0.0,0.0,0.0,0.0,0.0,0.0,0.0,0.0,0.0,0.0,0.0,0.0,Matches,40.0,it ITA,GK,30.0,14.9,21.0,1.0,1.0,2.0,0.0,19.6,0.29,-1.4,-0.1,52.0,148.0,35.1,346.0,85.0,20.5,28.8,116.0,66.4,49.7,200.0,18.0,9.0,18.0,1.21,15.0,Matches,40.0,it ITA,GK,30.0,15.0,14.0,1339.0,14.9,21.0,1.41,64.0,43.0,68.8,6.0,3.0,5.0,2.0,14.3,1.0,1.0,0.0,0.0,0.0,Matches,516.0,it ITA,GK,30.0,14.9,0.0,0.0,0.0,0.0,2.0,0.0,0.0,0.0,0.0,0.0,0.0,0.0,27.0,4.0,0.0,100.0,Matches,516.0,it ITA,GK,30.0,14.9,462.0,325.0,137.0,21.0,0.0,0.0,0.0,0.0,0.0,0.0,0.0,0.0,362.0,0.0,0.0,Matches,516.0,it ITA,GK,30.0,14.9,362.0,462.0,78.4,9718.0,6618.0,59.0,59.0,100.0,209.0,212.0,98.6,94.0,191.0,49.2,0.0,0.0,0.0,0.0,0.0,1.0,0.0,0.0,2.0,Matches,659,it ITA,GK,30,15,1339.0,89.0,39.2,14.9,14,90.0,13,1,83.0,22,1.6,24.0,21.0,3.0,0.2,-0.45,20.8,17.9,2.9,0.2,-0.38,Matches,516.0,it ITA,GK,30.0,14.9,486.0,429.0,481.0,5.0,0.0,0.0,486.0,0.0,0.0,,0.0,,277.0,1367.0,863.0,0.0,0.0,0.0,0.0,1.0,202.0,0.0,Matches,516.0,it ITA,GK,30.0,14.9,0.0,0.0,0.0,,0.0,0.0,,,,0.0,0.0,0.0,0.0,0.0,,0.0,0.0,Matches,516.0,it ITA,GK,30.0,15.0,14.0,1339.0,14.9,0.0,0.0,0.0,0.0,0.0,0.0,0.0,0.0,0.0,0.0,0.0,0.0,0.0,2.0,0.0,0.0,0.0,0.0,0.0,0.0,0.0,0.0,0.0,0.0,0.0,Matches,Marco Sportiello,GK,30,130,140,Italy,Atalanta,5,2,3,2,8,7,5,1,1,3,7,5,3,8,10,14,12,14,12,8,12,13,3,13,5,13,13,13,10,14,13,15,13,10,14,13,13,5,14,5,13,14,15,13,8,13,13,15,15,14,13,12,11,15,5,12,12,13,11,10,20,1,1,1,1,1,1,1,1,1,1,1,1,1,192,87,7,20,2245552,6450,6450,5000,Mediterranean_Hispanic,130,3,1992/5/10,0,0,21346.0,,43058979
1343,Petar Stojanović,Empoli,1995,517.0,si SVN,DF,26.0,17.0,42.0,22.0,28.0,10.0,4.0,26.0,43.0,60.5,17.0,17.0,5.0,12.0,11.0,53.0,55.0,0.0,Matches,517.0,si SVN,DF,26.0,17.0,49.0,2.88,34.0,7.0,3.0,2.0,2.0,1.0,3.0,0.18,3.0,0.0,0.0,0.0,0.0,0.0,Matches,,,,,,,,,,,,,,,,,,,,,,,,,,,,,,,,,,,,,,,,,,,,,,,,,,,,,,,,517.0,si SVN,DF,26.0,17.0,3.0,0.0,0.0,12.0,15.0,0.0,35.0,11.0,22.0,0.0,0.0,0.0,91.0,4.0,7.0,36.4,Matches,517.0,si SVN,DF,26.0,17.0,1029.0,831.0,197.0,20.0,3.0,27.0,35.0,176.0,1.0,0.0,1.0,0.0,821.0,1.0,27.0,Matches,517.0,si SVN,DF,26.0,17.0,821.0,1029.0,79.8,14171.0,5058.0,410.0,466.0,88.0,308.0,370.0,83.2,89.0,145.0,61.4,1.0,1.0,1.2,0.0,19.0,58.0,19.0,6.0,91.0,Matches,661,si SVN,DF,26,27,1530.0,57.0,44.7,17.0,16,85.0,11,11,16.0,10,1.04,14.0,28.0,-14.0,-0.82,-0.92,15.4,28.3,-12.9,-0.76,-0.45,Matches,517.0,si SVN,DF,26.0,17.0,1210.0,60.0,387.0,539.0,293.0,15.0,1210.0,35.0,13.0,37.1,18.0,51.4,663.0,3977.0,2265.0,50.0,27.0,5.0,11.0,14.0,710.0,51.0,Matches,517.0,si SVN,DF,26.0,17.0,0.0,10.0,2.0,20.0,0.59,0.12,0.0,0.0,25.1,1.0,0.0,0.0,0.3,0.3,0.03,-0.3,-0.3,Matches,517.0,si SVN,DF,26.0,27.0,16.0,1530.0,17.0,0.0,1.0,1.0,0.0,0.0,0.0,3.0,0.0,0.3,0.3,1.0,1.3,50.0,91.0,51.0,0.0,0.06,0.06,0.0,0.06,0.02,0.06,0.08,0.02,0.08,Matches,Petar Stojanović,D/WB R,26,130,137,Slovenia,Empoli Football Club,8,12,15,8,12,7,10,12,14,11,13,8,17,13,18,10,14,11,10,11,9,15,10,9,13,12,16,17,14,12,14,11,16,14,15,14,14,13,11,7,13,1,2,2,1,3,3,1,3,2,2,3,15,12,12,12,13,12,2,4,1,1,1,20,1,18,1,1,1,13,1,1,6,1,178,72,10,20,2631968,6500,6950,5050,Northern_European,126,4,1995/10/7,37,2,12308.0,,62083371
1344,Gabriel Strefezza,Lecce,1997,518.0,br BRA,FWMF,25.0,27.1,50.0,24.0,18.0,20.0,12.0,27.0,53.0,50.9,26.0,36.0,3.0,33.0,16.0,66.0,15.0,0.0,Matches,518.0,br BRA,FWMF,25.0,27.1,101.0,3.72,77.0,6.0,8.0,6.0,3.0,1.0,8.0,0.29,8.0,0.0,0.0,0.0,0.0,0.0,Matches,,,,,,,,,,,,,,,,,,,,,,,,,,,,,,,,,,,,,,,,,,,,,,,,,,,,,,,,518.0,br BRA,FWMF,25.0,27.1,5.0,0.0,0.0,51.0,71.0,0.0,121.0,16.0,24.0,0.0,1.0,0.0,134.0,16.0,45.0,26.2,Matches,518.0,br BRA,FWMF,25.0,27.1,886.0,805.0,71.0,19.0,6.0,23.0,121.0,17.0,35.0,15.0,10.0,0.0,553.0,10.0,36.0,Matches,518.0,br BRA,FWMF,25.0,27.1,553.0,886.0,62.4,9963.0,3082.0,278.0,353.0,78.8,170.0,258.0,65.9,87.0,196.0,44.4,4.0,4.3,3.8,-0.3,48.0,64.0,43.0,17.0,107.0,Matches,662,br BRA,FWMF,25,35,2442.0,70.0,71.4,27.1,30,78.0,4,5,22.0,0,1.0,25.0,35.0,-10.0,-0.37,-0.09,24.7,30.0,-5.3,-0.2,-0.13,Matches,518.0,br BRA,FWMF,25.0,27.1,1285.0,14.0,131.0,531.0,648.0,68.0,1282.0,92.0,36.0,39.1,42.0,45.7,839.0,5004.0,2248.0,72.0,58.0,19.0,82.0,69.0,935.0,177.0,Matches,518.0,br BRA,FWMF,25.0,27.1,8.0,68.0,18.0,26.5,2.51,0.66,0.09,0.33,21.4,4.0,2.0,3.0,6.2,3.9,0.06,1.8,2.1,Matches,518.0,br BRA,FWMF,25.0,35.0,30.0,2442.0,27.1,8.0,4.0,12.0,6.0,2.0,3.0,5.0,0.0,6.2,3.9,4.3,8.2,72.0,107.0,177.0,0.29,0.15,0.44,0.22,0.37,0.23,0.16,0.39,0.14,0.3,Matches,Gabriel Strefezza,M/AM RL,25,131,139,"Brazil,Italy",Salento,12,14,14,14,13,11,6,13,5,9,14,11,10,15,15,12,13,10,10,13,12,14,13,9,13,12,14,14,15,15,9,6,13,15,12,7,14,7,13,9,14,4,3,4,1,1,3,2,2,1,2,3,10,14,8,10,10,14,7,8,1,1,1,1,12,13,1,15,1,18,18,11,20,11,168,63,7,20,4582555,6550,6350,5050,Mediterranean_Hispanic,129,6,1997/4/18,0,0,2214.0,,19223093
1345,Isaac Success,Udinese,1996,520.0,ng NGA,FW,26.0,20.2,8.0,4.0,2.0,5.0,1.0,3.0,8.0,37.5,5.0,13.0,2.0,11.0,4.0,12.0,18.0,0.0,Matches,520.0,ng NGA,FW,26.0,20.2,81.0,4.02,57.0,0.0,6.0,3.0,14.0,1.0,10.0,0.5,7.0,0.0,1.0,0.0,2.0,0.0,Matches,,,,,,,,,,,,,,,,,,,,,,,,,,,,,,,,,,,,,,,,,,,,,,,,,,,,,,,,520.0,ng NGA,FW,26.0,20.2,4.0,0.0,0.0,34.0,77.0,11.0,13.0,4.0,4.0,0.0,0.0,0.0,51.0,38.0,46.0,45.2,Matches,520.0,ng NGA,FW,26.0,20.2,570.0,552.0,11.0,0.0,9.0,8.0,13.0,0.0,0.0,0.0,0.0,0.0,372.0,7.0,23.0,Matches,520.0,ng NGA,FW,26.0,20.2,372.0,570.0,65.3,5429.0,1119.0,207.0,288.0,71.9,99.0,144.0,68.8,32.0,51.0,62.7,6.0,4.0,3.3,2.0,31.0,22.0,19.0,1.0,53.0,Matches,666,ng NGA,FW,26,30,1815.0,61.0,53.1,20.2,21,74.0,4,9,30.0,0,1.4,28.0,22.0,6.0,0.3,0.69,26.6,28.8,-2.2,-0.11,0.04,Matches,520.0,ng NGA,FW,26.0,20.2,831.0,20.0,48.0,356.0,439.0,101.0,831.0,64.0,30.0,46.9,29.0,45.3,569.0,2585.0,914.0,37.0,26.0,13.0,95.0,44.0,735.0,200.0,Matches,520.0,ng NGA,FW,26.0,20.2,1.0,35.0,5.0,14.3,1.74,0.25,0.03,0.2,16.3,0.0,0.0,0.0,3.3,3.3,0.1,-2.3,-2.3,Matches,520.0,ng NGA,FW,26.0,30.0,21.0,1815.0,20.2,1.0,6.0,7.0,1.0,0.0,0.0,4.0,0.0,3.3,3.3,4.0,7.3,37.0,53.0,200.0,0.05,0.3,0.35,0.05,0.35,0.17,0.2,0.36,0.17,0.36,Matches,Isaac Success,AM/S LC,26,130,135,Nigeria,Udinese Calcio,7,11,12,13,13,10,12,13,5,7,13,13,8,15,12,13,11,10,12,11,9,13,14,8,14,8,17,14,14,13,14,12,13,14,14,15,13,9,11,8,14,2,3,2,2,3,3,1,1,3,4,3,13,14,16,10,7,9,12,10,1,1,1,1,1,1,1,1,1,1,17,15,14,20,182,90,11,20,3353089,6500,5570,5063,African_Caribbean,128,17,1996/1/7,4,0,35960.0,,13135061
1346,Wojciech Szczęsny,Juventus,1990,523.0,pl POL,GK,32.0,27.5,1.0,0.0,1.0,0.0,0.0,0.0,1.0,0.0,1.0,0.0,0.0,0.0,0.0,1.0,7.0,0.0,Matches,523.0,pl POL,GK,32.0,27.5,2.0,0.07,2.0,0.0,0.0,0.0,0.0,0.0,0.0,0.0,0.0,0.0,0.0,0.0,0.0,0.0,Matches,42.0,pl POL,GK,32.0,27.5,26.0,3.0,0.0,5.0,0.0,26.0,0.25,0.0,0.0,128.0,270.0,47.4,634.0,128.0,32.2,33.5,153.0,43.1,38.3,389.0,11.0,2.8,21.0,0.76,14.7,Matches,42.0,pl POL,GK,32.0,28.0,28.0,2472.0,27.5,26.0,0.95,93.0,67.0,75.3,17.0,3.0,8.0,14.0,50.0,3.0,3.0,0.0,0.0,0.0,Matches,523.0,pl POL,GK,32.0,27.5,0.0,0.0,0.0,0.0,1.0,0.0,0.0,0.0,0.0,0.0,0.0,0.0,35.0,10.0,0.0,100.0,Matches,523.0,pl POL,GK,32.0,27.5,789.0,581.0,206.0,52.0,0.0,5.0,0.0,1.0,0.0,0.0,0.0,0.0,625.0,2.0,1.0,Matches,523.0,pl POL,GK,32.0,27.5,625.0,789.0,79.2,18108.0,12812.0,99.0,99.0,100.0,287.0,290.0,99.0,238.0,395.0,60.3,0.0,0.0,0.0,0.0,0.0,4.0,1.0,0.0,0.0,Matches,669,pl POL,GK,32,28,2472.0,88.0,72.3,27.5,28,88.0,27,0,,6,1.93,40.0,26.0,14.0,0.51,-0.34,40.4,29.1,11.3,0.41,0.18,Matches,523.0,pl POL,GK,32.0,27.5,837.0,731.0,833.0,4.0,0.0,0.0,837.0,1.0,1.0,100.0,0.0,0.0,498.0,2576.0,1593.0,0.0,0.0,0.0,1.0,0.0,406.0,0.0,Matches,523.0,pl POL,GK,32.0,27.5,0.0,0.0,0.0,,0.0,0.0,,,,0.0,0.0,0.0,0.0,0.0,,0.0,0.0,Matches,523.0,pl POL,GK,32.0,28.0,28.0,2472.0,27.5,0.0,0.0,0.0,0.0,0.0,0.0,0.0,0.0,0.0,0.0,0.0,0.0,0.0,0.0,0.0,0.0,0.0,0.0,0.0,0.0,0.0,0.0,0.0,0.0,0.0,Matches,Wojciech Szczęsny,GK,32,153,169,Poland,Juventus,3,3,2,1,10,1,5,3,2,2,11,6,1,8,12,13,14,17,12,10,12,15,7,8,4,14,9,11,9,15,11,17,12,12,11,15,15,5,14,8,2,16,14,14,13,18,16,16,17,16,7,13,17,13,12,12,12,16,9,14,20,1,1,1,1,1,1,1,1,1,1,1,1,1,195,90,9,20,347975206,7650,8250,7500,Northern_European,151,2,1990/4/18,64,0,231537.0,,28009478
1347,Adrien Tameze,Hellas Verona,1994,525.0,cm CMR,MF,28.0,33.7,51.0,30.0,21.0,26.0,4.0,28.0,63.0,44.4,35.0,51.0,14.0,37.0,37.0,88.0,55.0,2.0,Matches,525.0,cm CMR,MF,28.0,33.7,53.0,1.57,44.0,2.0,1.0,1.0,4.0,1.0,3.0,0.09,3.0,0.0,0.0,0.0,0.0,0.0,Matches,,,,,,,,,,,,,,,,,,,,,,,,,,,,,,,,,,,,,,,,,,,,,,,,,,,,,,,,525.0,cm CMR,MF,28.0,33.7,3.0,0.0,0.0,32.0,31.0,1.0,21.0,37.0,30.0,0.0,0.0,0.0,218.0,27.0,31.0,46.6,Matches,525.0,cm CMR,MF,28.0,33.7,1092.0,1020.0,64.0,49.0,0.0,6.0,21.0,4.0,0.0,0.0,0.0,0.0,835.0,8.0,30.0,Matches,525.0,cm CMR,MF,28.0,33.7,835.0,1092.0,76.5,14351.0,4390.0,376.0,468.0,80.3,363.0,430.0,84.4,73.0,116.0,62.9,0.0,0.9,1.2,-0.9,22.0,91.0,17.0,3.0,103.0,Matches,671,cm CMR,MF,28,37,3031.0,82.0,88.6,33.7,35,85.0,25,2,37.0,1,0.89,27.0,54.0,-27.0,-0.8,-0.57,30.1,45.4,-15.3,-0.45,-0.73,Matches,525.0,cm CMR,MF,28.0,33.7,1428.0,97.0,380.0,829.0,244.0,21.0,1428.0,53.0,26.0,49.1,22.0,41.5,713.0,3953.0,1618.0,32.0,34.0,4.0,39.0,34.0,739.0,58.0,Matches,525.0,cm CMR,MF,28.0,33.7,0.0,12.0,2.0,16.7,0.36,0.06,0.0,0.0,22.8,0.0,0.0,0.0,0.9,0.9,0.07,-0.9,-0.9,Matches,525.0,cm CMR,MF,28.0,37.0,35.0,3031.0,33.7,0.0,0.0,0.0,0.0,0.0,0.0,3.0,0.0,0.9,0.9,0.9,1.8,32.0,103.0,58.0,0.0,0.0,0.0,0.0,0.0,0.03,0.03,0.05,0.03,0.05,Matches,Adrien Tameze,DM/M/AM C,28,135,139,"France,Cameroon",Hellas Verona,5,9,12,10,13,5,11,11,7,11,13,9,14,13,13,14,14,12,14,12,14,14,10,8,14,12,16,17,13,14,15,10,16,14,16,13,14,7,12,6,17,1,1,4,3,1,4,2,1,3,3,1,13,14,6,15,12,16,14,16,1,10,10,1,11,1,16,10,20,1,1,17,1,10,180,78,9,20,6193901,6750,6550,5200,African_Caribbean,134,14,1994/2/4,0,0,12308.0,,85065498
1348,Pietro Terracciano,Fiorentina,1990,528.0,it ITA,GK,32.0,29.0,2.0,1.0,2.0,0.0,0.0,2.0,3.0,66.7,1.0,0.0,0.0,0.0,1.0,3.0,14.0,0.0,Matches,528.0,it ITA,GK,32.0,29.0,4.0,0.14,4.0,0.0,0.0,0.0,0.0,0.0,0.0,0.0,0.0,0.0,0.0,0.0,0.0,0.0,Matches,44.0,it ITA,GK,32.0,29.0,38.0,6.0,0.0,3.0,2.0,33.1,0.28,-2.9,-0.1,155.0,375.0,41.3,871.0,113.0,32.7,33.2,198.0,45.5,40.5,271.0,12.0,4.4,55.0,1.9,18.4,Matches,44.0,it ITA,GK,32.0,29.0,29.0,2610.0,29.0,38.0,1.31,96.0,59.0,66.7,9.0,8.0,12.0,5.0,17.2,7.0,6.0,1.0,0.0,14.3,Matches,528.0,it ITA,GK,32.0,29.0,1.0,0.0,0.0,2.0,0.0,0.0,0.0,1.0,1.0,0.0,2.0,0.0,51.0,6.0,0.0,100.0,Matches,528.0,it ITA,GK,32.0,29.0,1072.0,796.0,273.0,75.0,0.0,2.0,0.0,0.0,0.0,0.0,0.0,0.0,816.0,3.0,1.0,Matches,528.0,it ITA,GK,32.0,29.0,816.0,1072.0,76.1,23589.0,16226.0,130.0,133.0,97.7,358.0,365.0,98.1,324.0,566.0,57.2,0.0,0.0,0.0,0.0,0.0,16.0,0.0,0.0,0.0,Matches,675,it ITA,GK,32,29,2610.0,90.0,76.3,29.0,29,90.0,29,0,,8,1.21,35.0,38.0,-3.0,-0.1,-1.55,41.6,34.2,7.4,0.26,-0.22,Matches,528.0,it ITA,GK,32.0,29.0,1135.0,893.0,1125.0,10.0,0.0,0.0,1135.0,1.0,1.0,100.0,0.0,0.0,602.0,3154.0,1984.0,0.0,0.0,0.0,1.0,0.0,612.0,0.0,Matches,528.0,it ITA,GK,32.0,29.0,0.0,0.0,0.0,,0.0,0.0,,,,0.0,0.0,0.0,0.0,0.0,,0.0,0.0,Matches,528.0,it ITA,GK,32.0,29.0,29.0,2610.0,29.0,0.0,0.0,0.0,0.0,0.0,0.0,1.0,0.0,0.0,0.0,0.0,0.0,0.0,0.0,0.0,0.0,0.0,0.0,0.0,0.0,0.0,0.0,0.0,0.0,0.0,Matches,Pietro Terracciano,GK,32,139,145,Italy,ACF Fiorentina,5,3,2,2,9,9,10,3,2,2,10,5,1,9,4,14,14,14,14,11,10,13,8,12,7,15,14,10,10,12,15,17,13,9,13,14,14,5,12,6,15,14,16,15,8,14,15,15,15,12,14,16,12,12,5,13,12,16,16,13,20,1,1,1,1,1,1,1,1,1,1,1,1,1,193,78,6,20,347975206,6950,6950,4750,Mediterranean_Hispanic,141,2,1990/3/8,0,0,10769.0,,43017977
1349,Aleksa Terzić,Fiorentina,1999,529.0,rs SRB,DF,22.0,10.4,16.0,9.0,9.0,4.0,3.0,11.0,21.0,52.4,10.0,13.0,4.0,9.0,5.0,21.0,16.0,0.0,Matches,529.0,rs SRB,DF,22.0,10.4,43.0,4.13,32.0,6.0,4.0,1.0,0.0,0.0,5.0,0.48,3.0,1.0,0.0,1.0,0.0,0.0,Matches,,,,,,,,,,,,,,,,,,,,,,,,,,,,,,,,,,,,,,,,,,,,,,,,,,,,,,,,529.0,rs SRB,DF,22.0,10.4,2.0,0.0,0.0,4.0,12.0,3.0,79.0,5.0,9.0,0.0,0.0,0.0,59.0,7.0,9.0,43.8,Matches,529.0,rs SRB,DF,22.0,10.4,724.0,590.0,131.0,12.0,0.0,1.0,79.0,111.0,8.0,0.0,5.0,0.0,582.0,3.0,19.0,Matches,529.0,rs SRB,DF,22.0,10.4,582.0,724.0,80.4,10551.0,3203.0,258.0,282.0,91.5,239.0,292.0,81.8,73.0,112.0,65.2,1.0,1.9,1.9,-0.9,25.0,34.0,26.0,23.0,40.0,Matches,676,rs SRB,DF,22,22,935.0,43.0,27.3,10.4,8,85.0,5,14,18.0,13,1.32,16.0,8.0,8.0,0.77,0.7,17.5,9.4,8.1,0.78,0.64,Matches,529.0,rs SRB,DF,22.0,10.4,824.0,26.0,220.0,341.0,272.0,9.0,824.0,27.0,16.0,59.3,8.0,29.6,484.0,3453.0,1961.0,49.0,28.0,4.0,14.0,7.0,511.0,61.0,Matches,529.0,rs SRB,DF,22.0,10.4,1.0,10.0,2.0,20.0,0.96,0.19,0.1,0.5,24.8,0.0,0.0,0.0,0.4,0.4,0.04,0.6,0.6,Matches,529.0,rs SRB,DF,22.0,22.0,8.0,935.0,10.4,1.0,1.0,2.0,1.0,0.0,0.0,2.0,0.0,0.4,0.4,1.9,2.3,49.0,40.0,61.0,0.1,0.1,0.19,0.1,0.19,0.04,0.18,0.22,0.04,0.22,Matches,Aleksa Terzić,D/WB L,22,125,142,Serbia,ACF Fiorentina,12,12,12,7,12,10,11,8,8,12,12,10,13,12,10,12,13,11,13,11,13,12,7,7,12,13,13,14,14,12,12,13,14,14,13,12,12,10,11,7,11,3,4,1,2,3,2,3,4,1,3,3,11,12,9,11,12,13,12,11,1,20,1,12,19,8,1,15,1,1,13,1,1,1,184,71,20,9,3629998,6250,6400,4750,Northern_European,123,4,1999/8/17,5,0,7307.0,,62192744
1350,Malick Thiaw,Milan,2001,531.0,de GER,DF,20.0,15.1,31.0,26.0,22.0,9.0,0.0,11.0,20.0,55.0,9.0,11.0,5.0,6.0,12.0,43.0,65.0,1.0,Matches,531.0,de GER,DF,20.0,15.1,15.0,0.99,14.0,0.0,0.0,1.0,0.0,0.0,0.0,0.0,0.0,0.0,0.0,0.0,0.0,0.0,Matches,,,,,,,,,,,,,,,,,,,,,,,,,,,,,,,,,,,,,,,,,,,,,,,,,,,,,,,,531.0,de GER,DF,20.0,15.1,5.0,0.0,0.0,14.0,7.0,1.0,2.0,12.0,26.0,0.0,0.0,0.0,93.0,52.0,26.0,66.7,Matches,531.0,de GER,DF,20.0,15.1,1056.0,1037.0,19.0,12.0,0.0,4.0,2.0,5.0,0.0,0.0,0.0,0.0,932.0,0.0,5.0,Matches,531.0,de GER,DF,20.0,15.1,932.0,1056.0,88.3,18898.0,6496.0,275.0,311.0,88.4,541.0,576.0,93.9,112.0,154.0,72.7,0.0,0.2,0.2,-0.2,2.0,53.0,5.0,0.0,67.0,Matches,678,de GER,DF,20,20,1362.0,68.0,39.8,15.1,15,83.0,11,5,24.0,13,1.95,21.0,12.0,9.0,0.59,0.07,24.7,13.8,11.0,0.72,0.43,Matches,531.0,de GER,DF,20.0,15.1,1196.0,108.0,546.0,613.0,44.0,15.0,1196.0,4.0,1.0,25.0,2.0,50.0,732.0,3425.0,1896.0,6.0,10.0,0.0,4.0,4.0,824.0,2.0,Matches,531.0,de GER,DF,20.0,15.1,0.0,8.0,3.0,37.5,0.53,0.2,0.0,0.0,10.9,0.0,0.0,0.0,0.8,0.8,0.11,-0.8,-0.8,Matches,531.0,de GER,DF,20.0,20.0,15.0,1362.0,15.1,0.0,0.0,0.0,0.0,0.0,0.0,5.0,0.0,0.8,0.8,0.2,1.0,6.0,67.0,2.0,0.0,0.0,0.0,0.0,0.0,0.06,0.01,0.07,0.06,0.07,Matches,Malick Thiaw,D C,20,125,159,"Germany,Finland,Senegal",AC Milan,2,7,11,7,12,3,13,7,4,13,13,10,14,12,14,12,13,13,13,12,11,16,12,12,8,13,12,12,13,11,14,16,15,13,12,13,15,8,14,6,12,3,1,2,3,2,1,2,3,2,4,2,16,15,5,15,15,16,12,10,1,12,20,12,1,1,15,1,12,1,1,1,1,1,194,89,13,20,16030000,6250,6250,4500,Mixed_Race,124,12,2001/8/8,0,0,19808.0,,91206164
1351,Kristian Thorstvedt,Sassuolo,1999,532.0,no NOR,MF,23.0,12.6,16.0,7.0,4.0,9.0,3.0,6.0,17.0,35.3,11.0,19.0,5.0,14.0,14.0,30.0,13.0,0.0,Matches,532.0,no NOR,MF,23.0,12.6,28.0,2.21,21.0,0.0,2.0,3.0,1.0,1.0,1.0,0.08,1.0,0.0,0.0,0.0,0.0,0.0,Matches,,,,,,,,,,,,,,,,,,,,,,,,,,,,,,,,,,,,,,,,,,,,,,,,,,,,,,,,532.0,no NOR,MF,23.0,12.6,5.0,0.0,0.0,18.0,22.0,0.0,10.0,14.0,7.0,0.0,0.0,0.0,63.0,28.0,25.0,52.8,Matches,532.0,no NOR,MF,23.0,12.6,488.0,476.0,12.0,6.0,2.0,1.0,10.0,6.0,0.0,0.0,0.0,0.0,372.0,0.0,15.0,Matches,532.0,no NOR,MF,23.0,12.6,372.0,488.0,76.2,5598.0,1802.0,208.0,249.0,83.5,130.0,167.0,77.8,19.0,32.0,59.4,1.0,1.1,1.2,-0.1,10.0,44.0,6.0,1.0,60.0,Matches,679,no NOR,MF,23,31,1136.0,37.0,33.2,12.6,13,63.0,1,18,18.0,6,1.1,15.0,27.0,-12.0,-0.95,-0.87,16.5,20.0,-3.5,-0.28,-0.49,Matches,532.0,no NOR,MF,23.0,12.6,629.0,20.0,97.0,366.0,178.0,36.0,629.0,15.0,7.0,46.7,2.0,13.3,339.0,1778.0,892.0,31.0,19.0,7.0,20.0,11.0,445.0,54.0,Matches,532.0,no NOR,MF,23.0,12.6,2.0,20.0,8.0,40.0,1.58,0.63,0.1,0.25,16.4,0.0,0.0,0.0,2.1,2.1,0.11,-0.1,-0.1,Matches,532.0,no NOR,MF,23.0,31.0,13.0,1136.0,12.6,2.0,1.0,3.0,2.0,0.0,0.0,5.0,0.0,2.1,2.1,1.1,3.2,31.0,60.0,54.0,0.16,0.08,0.24,0.16,0.24,0.17,0.09,0.26,0.17,0.26,Matches,Kristian Thorstvedt,M/AM C,23,128,145,Norway,U.S. Sassuolo,9,10,11,12,12,12,11,12,6,8,13,12,9,13,13,14,15,14,14,14,14,15,13,12,13,9,16,15,11,11,14,14,14,11,14,14,13,9,12,11,12,1,1,2,1,3,1,2,1,4,1,1,10,13,6,14,12,12,11,5,1,1,1,1,1,1,10,10,19,10,11,20,11,14,189,84,20,12,9691568,6400,6400,5500,Northern_European,127,4,1999/3/13,17,4,14999.0,,53126110
1352,Jeremy Toljan,Sassuolo,1994,533.0,de GER,DF,27.0,29.7,36.0,23.0,17.0,14.0,5.0,22.0,33.0,66.7,11.0,31.0,14.0,17.0,18.0,54.0,60.0,1.0,Matches,533.0,de GER,DF,27.0,29.7,42.0,1.41,41.0,1.0,0.0,0.0,0.0,0.0,3.0,0.1,3.0,0.0,0.0,0.0,0.0,0.0,Matches,,,,,,,,,,,,,,,,,,,,,,,,,,,,,,,,,,,,,,,,,,,,,,,,,,,,,,,,533.0,de GER,DF,27.0,29.7,3.0,0.0,0.0,10.0,14.0,0.0,28.0,18.0,23.0,0.0,1.0,0.0,142.0,10.0,21.0,32.3,Matches,533.0,de GER,DF,27.0,29.7,1610.0,1299.0,308.0,33.0,2.0,10.0,28.0,275.0,0.0,0.0,0.0,0.0,1363.0,3.0,32.0,Matches,533.0,de GER,DF,27.0,29.7,1363.0,1610.0,84.7,21955.0,8084.0,722.0,793.0,91.0,505.0,576.0,87.7,104.0,163.0,63.8,1.0,2.4,1.6,-1.4,22.0,124.0,23.0,7.0,142.0,Matches,680,de GER,DF,27,31,2672.0,86.0,78.1,29.7,29,89.0,27,2,51.0,2,1.0,32.0,48.0,-16.0,-0.54,-0.78,39.9,39.4,0.5,0.02,-0.15,Matches,533.0,de GER,DF,27.0,29.7,1817.0,79.0,630.0,868.0,328.0,23.0,1817.0,13.0,7.0,53.8,6.0,46.2,970.0,5068.0,2834.0,56.0,41.0,3.0,25.0,14.0,1105.0,99.0,Matches,533.0,de GER,DF,27.0,29.7,0.0,5.0,0.0,0.0,0.17,0.0,0.0,,18.1,0.0,0.0,0.0,0.5,0.5,0.1,-0.5,-0.5,Matches,533.0,de GER,DF,27.0,31.0,29.0,2672.0,29.7,0.0,1.0,1.0,0.0,0.0,0.0,3.0,0.0,0.5,0.5,2.4,3.0,56.0,142.0,99.0,0.0,0.03,0.03,0.0,0.03,0.02,0.08,0.1,0.02,0.1,Matches,Jeremy Toljan,D/WB RL,27,128,134,"Germany,Croatia,United States",U.S. Sassuolo,5,10,12,5,13,5,9,8,12,10,13,7,11,13,13,12,12,10,11,11,11,12,9,7,14,11,12,13,15,15,12,12,15,16,13,10,12,12,11,10,16,3,2,3,3,1,4,2,1,2,1,3,14,12,5,11,11,13,14,17,1,15,1,20,10,18,1,1,1,15,1,1,1,1,182,74,12,20,4018481,6400,6600,5250,Mixed_Race,118,12,1994/8/8,0,0,17307.0,,92029806
1353,Fikayo Tomori,Milan,1997,535.0,eng ENG,DF,24.0,30.7,70.0,34.0,44.0,25.0,1.0,22.0,34.0,64.7,12.0,46.0,25.0,21.0,29.0,99.0,88.0,1.0,Matches,535.0,eng ENG,DF,24.0,30.7,23.0,0.75,19.0,2.0,0.0,0.0,1.0,1.0,2.0,0.07,2.0,0.0,0.0,0.0,0.0,0.0,Matches,,,,,,,,,,,,,,,,,,,,,,,,,,,,,,,,,,,,,,,,,,,,,,,,,,,,,,,,535.0,eng ENG,DF,24.0,30.7,5.0,0.0,0.0,28.0,25.0,1.0,6.0,29.0,34.0,0.0,1.0,0.0,190.0,62.0,30.0,67.4,Matches,535.0,eng ENG,DF,24.0,30.7,1922.0,1786.0,129.0,51.0,4.0,19.0,6.0,13.0,0.0,0.0,0.0,0.0,1697.0,7.0,18.0,Matches,535.0,eng ENG,DF,24.0,30.7,1697.0,1922.0,88.3,34375.0,10863.0,568.0,608.0,93.4,876.0,942.0,93.0,242.0,324.0,74.7,1.0,0.8,0.9,0.2,9.0,91.0,7.0,0.0,122.0,Matches,682,eng ENG,DF,24,33,2760.0,84.0,80.7,30.7,32,85.0,26,1,32.0,1,1.97,57.0,29.0,28.0,0.91,1.87,50.8,31.6,19.2,0.62,0.82,Matches,535.0,eng ENG,DF,24.0,30.7,2218.0,243.0,1089.0,1078.0,63.0,14.0,2218.0,6.0,3.0,50.0,1.0,16.7,1258.0,6315.0,3346.0,26.0,6.0,0.0,9.0,3.0,1423.0,10.0,Matches,535.0,eng ENG,DF,24.0,30.7,1.0,9.0,4.0,44.4,0.29,0.13,0.11,0.25,14.1,0.0,0.0,0.0,1.3,1.3,0.15,-0.3,-0.3,Matches,535.0,eng ENG,DF,24.0,33.0,32.0,2760.0,30.7,1.0,1.0,2.0,1.0,0.0,0.0,5.0,0.0,1.3,1.3,0.8,2.1,26.0,122.0,10.0,0.03,0.03,0.07,0.03,0.07,0.04,0.03,0.07,0.04,0.07,Matches,Fikayo Tomori,D C,24,153,167,"England,Canada,Nigeria",AC Milan,4,7,9,8,11,6,15,6,3,16,13,6,15,12,17,16,15,14,15,11,13,14,5,12,6,14,14,14,16,13,14,14,15,17,14,15,15,9,14,6,8,2,2,3,1,3,1,1,2,1,4,1,14,16,5,10,14,16,15,12,1,12,20,14,1,13,1,1,1,1,1,1,1,1,185,79,12,20,97731565,7650,7100,6400,African_Caribbean,152,16,1997/12/19,3,0,86345.0,,28097980
1354,Sandro Tonali,Milan,2000,536.0,it ITA,MF,22.0,30.1,64.0,41.0,35.0,24.0,5.0,27.0,44.0,61.4,17.0,34.0,9.0,25.0,25.0,89.0,26.0,1.0,Matches,536.0,it ITA,MF,22.0,30.1,101.0,3.35,62.0,26.0,2.0,6.0,2.0,3.0,13.0,0.43,9.0,1.0,1.0,1.0,0.0,1.0,Matches,,,,,,,,,,,,,,,,,,,,,,,,,,,,,,,,,,,,,,,,,,,,,,,,,,,,,,,,536.0,it ITA,MF,22.0,30.1,7.0,0.0,0.0,35.0,32.0,5.0,130.0,25.0,41.0,0.0,0.0,0.0,178.0,15.0,18.0,45.5,Matches,536.0,it ITA,MF,22.0,30.1,1565.0,1361.0,193.0,94.0,7.0,14.0,130.0,21.0,74.0,23.0,42.0,0.0,1185.0,11.0,30.0,Matches,536.0,it ITA,MF,22.0,30.1,1185.0,1565.0,75.7,21009.0,6485.0,526.0,610.0,86.2,482.0,583.0,82.7,139.0,278.0,50.0,7.0,5.7,4.5,1.3,62.0,124.0,29.0,8.0,159.0,Matches,683,it ITA,MF,22,34,2713.0,80.0,79.3,30.1,30,87.0,23,4,25.0,2,1.82,49.0,36.0,13.0,0.43,-0.59,47.0,33.1,13.9,0.46,-0.03,Matches,536.0,it ITA,MF,22.0,30.1,1836.0,48.0,356.0,1007.0,491.0,33.0,1836.0,23.0,9.0,39.1,10.0,43.5,937.0,5641.0,2809.0,61.0,40.0,2.0,41.0,9.0,1154.0,86.0,Matches,536.0,it ITA,MF,22.0,30.1,2.0,32.0,14.0,43.8,1.06,0.46,0.06,0.14,22.2,6.0,0.0,0.0,2.4,2.4,0.07,-0.4,-0.4,Matches,536.0,it ITA,MF,22.0,34.0,30.0,2713.0,30.1,2.0,7.0,9.0,2.0,0.0,0.0,7.0,0.0,2.4,2.4,5.7,8.1,61.0,159.0,86.0,0.07,0.23,0.3,0.07,0.3,0.08,0.19,0.27,0.08,0.27,Matches,Sandro Tonali,DM/M C,22,156,172,Italy,AC Milan,14,12,13,10,15,15,9,13,11,13,15,11,14,15,14,16,16,14,15,14,14,16,12,14,14,14,16,16,13,14,15,10,14,14,14,12,16,15,13,6,10,2,1,3,2,2,2,2,2,2,1,1,9,16,3,14,14,15,15,17,1,1,1,1,1,1,19,1,20,1,1,14,1,1,181,79,12,20,126967514,7800,7800,6900,Mediterranean_Hispanic,155,2,2000/5/8,11,0,89038.0,,43298481
1355,Frank Tsadjout,Cremonese,1999,539.0,it ITA,FW,23.0,11.7,10.0,8.0,3.0,6.0,1.0,3.0,9.0,33.3,6.0,7.0,1.0,6.0,8.0,18.0,9.0,0.0,Matches,539.0,it ITA,FW,23.0,11.7,22.0,1.89,18.0,0.0,0.0,3.0,1.0,0.0,3.0,0.26,3.0,0.0,0.0,0.0,0.0,0.0,Matches,,,,,,,,,,,,,,,,,,,,,,,,,,,,,,,,,,,,,,,,,,,,,,,,,,,,,,,,539.0,it ITA,FW,23.0,11.7,1.0,0.0,0.0,22.0,18.0,4.0,4.0,8.0,8.0,0.0,0.0,0.0,39.0,59.0,60.0,49.6,Matches,539.0,it ITA,FW,23.0,11.7,271.0,266.0,4.0,0.0,0.0,0.0,4.0,1.0,0.0,0.0,0.0,0.0,184.0,1.0,2.0,Matches,539.0,it ITA,FW,23.0,11.7,184.0,271.0,67.9,2340.0,400.0,113.0,155.0,72.9,54.0,76.0,71.1,3.0,8.0,37.5,1.0,0.5,0.3,0.5,10.0,14.0,5.0,0.0,18.0,Matches,689,it ITA,FW,23,20,1051.0,53.0,30.7,11.7,14,66.0,2,6,22.0,13,0.85,10.0,27.0,-17.0,-1.46,-0.85,9.1,21.6,-12.5,-1.07,-0.51,Matches,539.0,it ITA,FW,23.0,11.7,404.0,11.0,35.0,197.0,176.0,49.0,404.0,19.0,12.0,63.2,2.0,10.5,209.0,1004.0,415.0,15.0,10.0,5.0,37.0,10.0,299.0,63.0,Matches,539.0,it ITA,FW,23.0,11.7,3.0,26.0,10.0,38.5,2.23,0.86,0.12,0.3,17.3,0.0,0.0,0.0,2.0,2.0,0.08,1.0,1.0,Matches,539.0,it ITA,FW,23.0,20.0,14.0,1051.0,11.7,3.0,1.0,4.0,3.0,0.0,0.0,1.0,0.0,2.0,2.0,0.5,2.6,15.0,18.0,63.0,0.26,0.09,0.34,0.26,0.34,0.17,0.05,0.22,0.17,0.22,Matches,Frank Tsadjout,S,22,119,140,"Italy,Cameroon",Cremonese,7,9,11,10,12,5,15,11,7,6,11,10,8,12,14,13,13,12,13,10,10,15,11,10,12,10,12,12,12,12,14,16,14,13,15,14,12,8,9,12,12,2,2,2,3,1,3,3,1,3,1,1,12,13,10,13,13,11,10,8,1,1,1,1,1,1,1,1,1,1,1,12,1,20,190,83,20,10,2345599,5950,5400,3401,African_Caribbean,118,18,1999/7/28,0,0,10145.0,,43268698
1356,Destiny Udogie,Udinese,2002,542.0,it ITA,DF,19.0,30.0,71.0,45.0,42.0,24.0,5.0,34.0,59.0,57.6,25.0,34.0,6.0,28.0,36.0,107.0,25.0,0.0,Matches,542.0,it ITA,DF,19.0,30.0,88.0,2.93,61.0,6.0,7.0,4.0,7.0,3.0,8.0,0.27,7.0,0.0,0.0,1.0,0.0,0.0,Matches,,,,,,,,,,,,,,,,,,,,,,,,,,,,,,,,,,,,,,,,,,,,,,,,,,,,,,,,542.0,it ITA,DF,19.0,30.0,5.0,0.0,0.0,37.0,58.0,5.0,29.0,36.0,45.0,0.0,2.0,0.0,175.0,17.0,15.0,53.1,Matches,542.0,it ITA,DF,19.0,30.0,1127.0,966.0,160.0,23.0,1.0,2.0,29.0,133.0,4.0,0.0,0.0,0.0,931.0,1.0,40.0,Matches,542.0,it ITA,DF,19.0,30.0,931.0,1127.0,82.6,13917.0,4753.0,523.0,589.0,88.8,348.0,410.0,84.9,37.0,51.0,72.5,4.0,4.2,2.2,-0.2,34.0,67.0,30.0,4.0,106.0,Matches,692,it ITA,DF,19,33,2704.0,82.0,79.1,30.0,31,86.0,20,2,22.0,0,1.33,35.0,33.0,2.0,0.07,0.44,39.0,39.7,-0.7,-0.02,0.51,Matches,542.0,it ITA,DF,19.0,30.0,1503.0,67.0,346.0,652.0,545.0,76.0,1503.0,122.0,51.0,41.8,50.0,41.0,904.0,6569.0,3420.0,109.0,71.0,31.0,58.0,36.0,902.0,155.0,Matches,542.0,it ITA,DF,19.0,30.0,3.0,27.0,7.0,25.9,0.9,0.23,0.11,0.43,13.7,0.0,0.0,0.0,2.9,2.9,0.11,0.1,0.1,Matches,542.0,it ITA,DF,19.0,33.0,31.0,2704.0,30.0,3.0,4.0,7.0,3.0,0.0,0.0,5.0,0.0,2.9,2.9,4.2,7.1,109.0,106.0,155.0,0.1,0.13,0.23,0.1,0.23,0.1,0.14,0.24,0.1,0.24,Matches,Destiny Udogie,D/WB/M L,19,142,-9,"Italy,Nigeria",Tottenham Hotspur,7,13,14,11,12,7,12,10,12,11,13,10,12,13,10,13,12,10,12,12,12,14,12,8,13,11,12,15,16,15,14,13,14,16,15,12,14,8,13,7,14,2,3,2,4,1,2,2,2,2,3,2,15,14,7,12,13,15,12,8,1,20,1,1,20,1,10,16,12,1,1,1,1,1,187,73,20,9,71914876,7100,6500,5000,African_Caribbean,134,16,2002/11/28,0,0,57996.0,Udinese Calcio,43426047
1357,Samuel Umtiti,Lecce,1993,544.0,fr FRA,DF,28.0,23.5,52.0,34.0,25.0,25.0,2.0,18.0,26.0,69.2,8.0,26.0,14.0,12.0,26.0,78.0,79.0,0.0,Matches,544.0,fr FRA,DF,28.0,23.5,9.0,0.38,7.0,1.0,0.0,0.0,0.0,1.0,0.0,0.0,0.0,0.0,0.0,0.0,0.0,0.0,Matches,,,,,,,,,,,,,,,,,,,,,,,,,,,,,,,,,,,,,,,,,,,,,,,,,,,,,,,,544.0,fr FRA,DF,28.0,23.5,8.0,0.0,0.0,32.0,27.0,0.0,2.0,26.0,34.0,0.0,0.0,0.0,167.0,34.0,26.0,56.7,Matches,544.0,fr FRA,DF,28.0,23.5,868.0,807.0,57.0,53.0,0.0,8.0,2.0,4.0,0.0,0.0,0.0,0.0,724.0,4.0,12.0,Matches,544.0,fr FRA,DF,28.0,23.5,724.0,868.0,83.4,14243.0,4927.0,243.0,281.0,86.5,371.0,396.0,93.7,97.0,159.0,61.0,0.0,0.1,0.2,-0.1,3.0,47.0,5.0,1.0,56.0,Matches,694,fr FRA,DF,28,25,2113.0,85.0,61.8,23.5,24,88.0,20,1,8.0,9,1.04,22.0,28.0,-6.0,-0.26,0.23,25.2,23.9,1.4,0.06,0.57,Matches,544.0,fr FRA,DF,28.0,23.5,1107.0,123.0,538.0,543.0,37.0,10.0,1107.0,13.0,6.0,46.2,5.0,38.5,529.0,2483.0,1341.0,12.0,9.0,0.0,7.0,5.0,530.0,2.0,Matches,544.0,fr FRA,DF,28.0,23.5,0.0,12.0,0.0,0.0,0.51,0.0,0.0,,16.4,0.0,0.0,0.0,0.8,0.8,0.07,-0.8,-0.8,Matches,544.0,fr FRA,DF,28.0,25.0,24.0,2113.0,23.5,0.0,0.0,0.0,0.0,0.0,0.0,8.0,0.0,0.8,0.8,0.1,0.9,12.0,56.0,2.0,0.0,0.0,0.0,0.0,0.0,0.03,0.0,0.04,0.03,0.04,Matches,Samuel Umtiti,D C,28,133,165,"France,Cameroon",Barcelona,4,9,9,6,12,7,14,9,9,15,13,8,14,14,14,15,13,13,15,10,13,14,8,10,9,16,12,12,12,11,12,12,6,12,10,15,12,12,14,20,11,3,4,2,3,1,1,2,3,2,3,1,12,13,13,7,13,14,14,14,1,10,20,1,1,1,10,1,1,1,1,1,1,1,182,75,20,8,3470090,6639,7089,6589,African_Caribbean,131,17,1993/11/14,31,4,102497.0,Salento,85059774
1358,Emanuele Valeri,Cremonese,1998,546.0,it ITA,DF,23.0,30.9,54.0,27.0,29.0,21.0,4.0,29.0,69.0,42.0,40.0,17.0,3.0,14.0,22.0,76.0,44.0,1.0,Matches,546.0,it ITA,DF,23.0,30.9,94.0,3.04,67.0,15.0,2.0,1.0,8.0,1.0,5.0,0.16,3.0,2.0,0.0,0.0,0.0,0.0,Matches,,,,,,,,,,,,,,,,,,,,,,,,,,,,,,,,,,,,,,,,,,,,,,,,,,,,,,,,546.0,it ITA,DF,23.0,30.9,3.0,0.0,0.0,27.0,37.0,5.0,147.0,22.0,27.0,0.0,0.0,0.0,190.0,13.0,26.0,33.3,Matches,546.0,it ITA,DF,23.0,30.9,1258.0,940.0,309.0,24.0,4.0,20.0,147.0,272.0,13.0,0.0,12.0,0.0,753.0,9.0,44.0,Matches,546.0,it ITA,DF,23.0,30.9,753.0,1258.0,59.9,13771.0,6184.0,330.0,407.0,81.1,303.0,492.0,61.6,96.0,258.0,37.2,3.0,4.6,3.8,-1.6,53.0,66.0,52.0,32.0,90.0,Matches,697,it ITA,DF,23,37,2785.0,75.0,81.4,30.9,31,84.0,21,6,33.0,0,0.73,32.0,53.0,-21.0,-0.68,1.02,33.0,52.2,-19.2,-0.62,0.54,Matches,546.0,it ITA,DF,23.0,30.9,1610.0,64.0,418.0,642.0,584.0,56.0,1610.0,71.0,18.0,25.4,40.0,56.3,805.0,5645.0,3186.0,111.0,58.0,20.0,64.0,26.0,838.0,158.0,Matches,546.0,it ITA,DF,23.0,30.9,2.0,40.0,6.0,15.0,1.29,0.19,0.05,0.33,21.5,3.0,0.0,0.0,2.2,2.2,0.05,-0.2,-0.2,Matches,546.0,it ITA,DF,23.0,37.0,31.0,2785.0,30.9,2.0,3.0,5.0,2.0,0.0,0.0,3.0,0.0,2.2,2.2,4.6,6.8,111.0,90.0,158.0,0.06,0.1,0.16,0.06,0.16,0.07,0.15,0.22,0.07,0.22,Matches,Emanuele Valeri,D/WB/M L,23,128,150,Italy,Cremonese,11,14,14,10,12,13,8,13,12,10,12,10,14,13,15,15,13,13,12,13,12,18,13,8,14,9,13,14,14,14,12,8,14,14,15,10,15,8,16,6,13,3,2,2,2,1,2,3,3,3,1,2,11,16,12,17,11,12,8,10,1,20,1,1,20,1,1,18,1,1,1,1,1,1,180,78,20,5,3502421,6400,6400,4265,Mediterranean_Hispanic,123,2,1998/12/7,0,0,2115.0,,43315140
1359,Matías Vecino,Lazio,1991,549.0,uy URU,MF,30.0,18.8,47.0,27.0,13.0,23.0,11.0,23.0,48.0,47.9,25.0,33.0,10.0,23.0,16.0,63.0,39.0,1.0,Matches,549.0,uy URU,MF,30.0,18.8,29.0,1.54,27.0,0.0,1.0,1.0,0.0,0.0,3.0,0.16,3.0,0.0,0.0,0.0,0.0,0.0,Matches,,,,,,,,,,,,,,,,,,,,,,,,,,,,,,,,,,,,,,,,,,,,,,,,,,,,,,,,549.0,uy URU,MF,30.0,18.8,6.0,0.0,0.0,27.0,10.0,2.0,1.0,16.0,27.0,0.0,0.0,0.0,107.0,31.0,22.0,58.5,Matches,549.0,uy URU,MF,30.0,18.8,968.0,962.0,5.0,5.0,2.0,7.0,1.0,0.0,0.0,0.0,0.0,0.0,830.0,1.0,14.0,Matches,549.0,uy URU,MF,30.0,18.8,830.0,968.0,85.7,12291.0,3427.0,480.0,526.0,91.3,281.0,323.0,87.0,44.0,68.0,64.7,0.0,0.5,0.5,-0.5,9.0,86.0,8.0,0.0,88.0,Matches,702,uy URU,MF,30,32,1691.0,53.0,49.4,18.8,17,76.0,9,15,26.0,2,1.97,26.0,16.0,10.0,0.53,-0.51,23.3,21.7,1.6,0.09,-0.34,Matches,549.0,uy URU,MF,30.0,18.8,1165.0,65.0,278.0,712.0,184.0,25.0,1165.0,6.0,3.0,50.0,3.0,50.0,564.0,2330.0,1088.0,22.0,10.0,3.0,18.0,3.0,817.0,17.0,Matches,549.0,uy URU,MF,30.0,18.8,2.0,26.0,5.0,19.2,1.38,0.27,0.08,0.4,18.5,0.0,0.0,0.0,2.5,2.5,0.1,-0.5,-0.5,Matches,549.0,uy URU,MF,30.0,32.0,17.0,1691.0,18.8,2.0,0.0,2.0,2.0,0.0,0.0,6.0,0.0,2.5,2.5,0.5,3.0,22.0,88.0,17.0,0.11,0.0,0.11,0.11,0.11,0.13,0.03,0.16,0.13,0.16,Matches,Matías Vecino,M C,30,140,148,"Uruguay,Italy",S.S. Lazio,13,12,10,13,13,12,16,14,5,13,14,13,12,14,14,16,14,14,12,13,13,16,12,13,17,14,16,15,10,12,17,14,14,12,14,13,13,11,17,11,15,2,2,3,3,4,1,1,3,3,2,3,13,16,7,10,14,16,13,13,1,1,1,1,1,1,15,1,20,1,1,12,1,5,187,81,11,20,8397173,7000,7400,6500,Mediterranean_Hispanic,141,3,1991/8/24,60,4,67692.0,,78040720
1360,Miguel Veloso,Hellas Verona,1986,550.0,pt POR,MF,36.0,12.9,33.0,10.0,20.0,12.0,1.0,16.0,26.0,61.5,10.0,26.0,6.0,20.0,6.0,39.0,14.0,0.0,Matches,550.0,pt POR,MF,36.0,12.9,36.0,2.78,20.0,12.0,0.0,4.0,0.0,0.0,2.0,0.15,2.0,0.0,0.0,0.0,0.0,0.0,Matches,,,,,,,,,,,,,,,,,,,,,,,,,,,,,,,,,,,,,,,,,,,,,,,,,,,,,,,,550.0,pt POR,MF,36.0,12.9,6.0,0.0,0.0,20.0,8.0,1.0,62.0,6.0,10.0,0.0,0.0,1.0,114.0,14.0,14.0,50.0,Matches,550.0,pt POR,MF,36.0,12.9,599.0,511.0,86.0,49.0,1.0,4.0,62.0,6.0,29.0,17.0,9.0,1.0,429.0,2.0,12.0,Matches,550.0,pt POR,MF,36.0,12.9,429.0,599.0,71.6,8600.0,3315.0,161.0,191.0,84.3,188.0,224.0,83.9,72.0,153.0,47.1,0.0,2.1,1.8,-2.1,20.0,49.0,13.0,5.0,84.0,Matches,703,pt POR,MF,36,22,1163.0,53.0,34.0,12.9,14,66.0,3,8,29.0,5,0.5,11.0,16.0,-5.0,-0.39,0.53,13.3,16.0,-2.6,-0.2,0.25,Matches,550.0,pt POR,MF,36.0,12.9,723.0,31.0,168.0,403.0,168.0,7.0,723.0,8.0,4.0,50.0,2.0,25.0,309.0,1883.0,880.0,17.0,13.0,1.0,7.0,7.0,328.0,22.0,Matches,550.0,pt POR,MF,36.0,12.9,0.0,16.0,2.0,12.5,1.24,0.15,0.0,0.0,23.3,2.0,0.0,0.0,0.5,0.5,0.03,-0.5,-0.5,Matches,550.0,pt POR,MF,36.0,22.0,14.0,1163.0,12.9,0.0,0.0,0.0,0.0,0.0,0.0,6.0,0.0,0.5,0.5,2.1,2.6,17.0,84.0,22.0,0.0,0.0,0.0,0.0,0.0,0.04,0.16,0.2,0.04,0.2,Matches,Miguel Veloso,DM/M C,36,132,157,Portugal,Hellas Verona,15,11,12,7,14,16,9,14,3,12,15,13,14,15,15,15,10,14,13,16,14,17,11,15,9,14,15,13,11,12,14,10,14,10,12,12,15,14,13,8,12,3,3,3,1,3,2,4,1,1,1,3,14,15,8,12,17,19,14,12,1,1,10,1,1,1,20,1,20,1,1,1,1,1,180,79,20,8,363690,6600,6000,5600,Mediterranean_Hispanic,134,7,1986/5/11,56,3,17885.0,,744536
1361,Lorenzo Venuti,Fiorentina,1995,551.0,it ITA,DF,27.0,10.3,18.0,7.0,6.0,11.0,1.0,11.0,18.0,61.1,7.0,7.0,2.0,5.0,5.0,23.0,17.0,2.0,Matches,551.0,it ITA,DF,27.0,10.3,24.0,2.34,15.0,6.0,2.0,1.0,0.0,0.0,2.0,0.19,1.0,1.0,0.0,0.0,0.0,0.0,Matches,,,,,,,,,,,,,,,,,,,,,,,,,,,,,,,,,,,,,,,,,,,,,,,,,,,,,,,,551.0,it ITA,DF,27.0,10.3,2.0,0.0,0.0,7.0,9.0,1.0,37.0,5.0,7.0,0.0,0.0,0.0,53.0,10.0,9.0,52.6,Matches,551.0,it ITA,DF,27.0,10.3,609.0,501.0,106.0,12.0,0.0,3.0,37.0,87.0,7.0,0.0,5.0,0.0,497.0,2.0,16.0,Matches,551.0,it ITA,DF,27.0,10.3,497.0,609.0,81.6,8930.0,2556.0,217.0,227.0,95.6,228.0,263.0,86.7,49.0,97.0,50.5,1.0,0.5,0.7,0.5,8.0,36.0,9.0,4.0,44.0,Matches,704,it ITA,DF,27,17,924.0,54.0,27.0,10.3,9,71.0,3,8,36.0,20,1.35,12.0,13.0,-1.0,-0.1,-0.49,13.1,12.7,0.4,0.04,-0.36,Matches,551.0,it ITA,DF,27.0,10.3,695.0,25.0,202.0,332.0,165.0,10.0,695.0,6.0,3.0,50.0,2.0,33.3,364.0,1824.0,933.0,24.0,19.0,2.0,12.0,1.0,441.0,43.0,Matches,551.0,it ITA,DF,27.0,10.3,0.0,7.0,4.0,57.1,0.68,0.39,0.0,0.0,22.1,0.0,0.0,0.0,0.4,0.4,0.06,-0.4,-0.4,Matches,551.0,it ITA,DF,27.0,17.0,9.0,924.0,10.3,0.0,1.0,1.0,0.0,0.0,0.0,2.0,0.0,0.4,0.4,0.5,0.9,24.0,44.0,43.0,0.0,0.1,0.1,0.0,0.1,0.04,0.05,0.09,0.04,0.09,Matches,Lorenzo Venuti,D/WB/M RLC,27,132,140,Italy,ACF Fiorentina,8,11,11,6,12,7,10,9,10,12,12,9,13,12,13,10,14,12,13,11,12,14,7,8,11,13,14,14,13,14,13,10,11,14,14,12,15,10,11,12,17,1,3,1,1,3,1,3,1,3,2,2,12,13,6,13,11,13,14,10,1,17,15,20,14,20,1,12,1,16,1,1,1,1,179,67,12,20,5138863,6600,6600,5000,Mediterranean_Hispanic,124,3,1995/4/12,0,0,14230.0,,43093519
1362,Daniele Verde,Spezia,1996,552.0,it ITA,FWMF,26.0,11.1,4.0,4.0,3.0,0.0,1.0,3.0,7.0,42.9,4.0,6.0,0.0,6.0,8.0,12.0,4.0,0.0,Matches,552.0,it ITA,FWMF,26.0,11.1,44.0,3.97,27.0,12.0,0.0,1.0,1.0,3.0,1.0,0.09,0.0,1.0,0.0,0.0,0.0,0.0,Matches,,,,,,,,,,,,,,,,,,,,,,,,,,,,,,,,,,,,,,,,,,,,,,,,,,,,,,,,552.0,it ITA,FWMF,26.0,11.1,1.0,0.0,0.0,2.0,15.0,3.0,68.0,8.0,4.0,0.0,0.0,0.0,50.0,0.0,2.0,0.0,Matches,552.0,it ITA,FWMF,26.0,11.1,443.0,348.0,93.0,18.0,1.0,6.0,68.0,18.0,37.0,20.0,12.0,0.0,312.0,2.0,8.0,Matches,552.0,it ITA,FWMF,26.0,11.1,312.0,443.0,70.4,5403.0,1794.0,143.0,175.0,81.7,128.0,168.0,76.2,35.0,74.0,47.3,0.0,1.3,2.4,-1.3,18.0,28.0,17.0,6.0,42.0,Matches,705,it ITA,FWMF,26,25,998.0,40.0,29.2,11.1,11,62.0,0,14,23.0,7,0.58,8.0,20.0,-12.0,-1.08,-0.38,14.5,18.8,-4.3,-0.39,0.12,Matches,552.0,it ITA,FWMF,26.0,11.1,538.0,11.0,63.0,219.0,261.0,30.0,537.0,17.0,6.0,35.3,7.0,41.2,301.0,1569.0,592.0,18.0,9.0,8.0,17.0,12.0,345.0,57.0,Matches,552.0,it ITA,FWMF,26.0,11.1,3.0,32.0,10.0,31.3,2.89,0.9,0.06,0.2,21.6,1.0,1.0,1.0,2.9,2.1,0.07,0.1,-0.1,Matches,552.0,it ITA,FWMF,26.0,25.0,11.0,998.0,11.1,3.0,0.0,3.0,2.0,1.0,1.0,1.0,0.0,2.9,2.1,1.3,3.4,18.0,42.0,57.0,0.27,0.0,0.27,0.18,0.18,0.26,0.12,0.38,0.19,0.31,Matches,Daniele Verde,AM/S RC,26,129,135,Italy,Spezia Calcio,14,14,15,12,14,13,6,12,4,4,14,13,5,16,11,12,13,11,9,13,12,15,15,7,12,4,10,12,15,15,14,5,14,13,11,9,12,6,13,8,12,4,1,2,1,2,2,2,3,3,2,3,12,13,7,11,10,14,11,11,1,1,1,1,1,1,1,11,8,14,14,16,20,18,168,64,20,9,3518373,6449,6399,5249,Mediterranean_Hispanic,124,4,1996/6/20,0,0,14230.0,,43094108
1363,Simone Verdi,Hellas Verona,1992,553.0,it ITA,MFFW,30.0,12.2,15.0,10.0,7.0,5.0,3.0,6.0,17.0,35.3,11.0,8.0,1.0,7.0,0.0,15.0,2.0,0.0,Matches,553.0,it ITA,MFFW,30.0,12.2,47.0,3.87,25.0,12.0,2.0,2.0,4.0,2.0,0.0,0.0,0.0,0.0,0.0,0.0,0.0,0.0,Matches,,,,,,,,,,,,,,,,,,,,,,,,,,,,,,,,,,,,,,,,,,,,,,,,,,,,,,,,553.0,it ITA,MFFW,30.0,12.2,3.0,0.0,0.0,15.0,26.0,1.0,77.0,0.0,10.0,0.0,0.0,0.0,66.0,9.0,14.0,39.1,Matches,553.0,it ITA,MFFW,30.0,12.2,414.0,331.0,79.0,17.0,5.0,7.0,77.0,5.0,40.0,22.0,13.0,0.0,270.0,4.0,26.0,Matches,553.0,it ITA,MFFW,30.0,12.2,270.0,414.0,65.2,5101.0,1823.0,123.0,154.0,79.9,90.0,121.0,74.4,47.0,96.0,49.0,0.0,2.1,1.5,-2.1,20.0,38.0,12.0,5.0,46.0,Matches,706,it ITA,MFFW,30,24,1096.0,46.0,32.0,12.2,12,70.0,2,12,21.0,6,0.92,10.0,20.0,-10.0,-0.82,-0.12,13.0,16.2,-3.2,-0.27,0.15,Matches,553.0,it ITA,MFFW,30.0,12.2,567.0,6.0,50.0,281.0,250.0,25.0,566.0,63.0,35.0,55.6,19.0,30.2,327.0,2251.0,1029.0,34.0,23.0,3.0,35.0,32.0,357.0,57.0,Matches,553.0,it ITA,MFFW,30.0,12.2,5.0,29.0,10.0,34.5,2.38,0.82,0.14,0.4,20.9,6.0,1.0,1.0,2.6,1.8,0.06,2.4,2.2,Matches,553.0,it ITA,MFFW,30.0,24.0,12.0,1096.0,12.2,5.0,0.0,5.0,4.0,1.0,1.0,3.0,0.0,2.6,1.8,2.1,3.9,34.0,46.0,57.0,0.41,0.0,0.41,0.33,0.33,0.21,0.18,0.39,0.15,0.32,Matches,Simone Verdi,AM/S RLC,30,130,146,Italy,Torino,14,14,13,10,14,17,5,15,5,4,14,14,5,15,13,11,10,10,9,14,10,16,15,8,11,4,13,12,13,14,13,4,12,13,12,8,12,7,11,14,14,1,2,2,2,3,2,1,3,2,4,2,11,14,1,13,10,17,17,15,1,1,1,1,1,1,1,10,14,10,15,20,17,17,174,65,20,17,4889922,6500,6500,5400,Mediterranean_Hispanic,123,2,1992/7/12,4,0,60480.0,Hellas Verona,43061356
1364,Guglielmo Vicario,Empoli,1996,555.0,it ITA,GK,25.0,30.9,1.0,1.0,1.0,0.0,0.0,1.0,2.0,50.0,1.0,0.0,0.0,0.0,0.0,1.0,15.0,2.0,Matches,555.0,it ITA,GK,25.0,30.9,6.0,0.19,6.0,0.0,0.0,0.0,0.0,0.0,0.0,0.0,0.0,0.0,0.0,0.0,0.0,0.0,Matches,47.0,it ITA,GK,25.0,30.9,39.0,4.0,0.0,8.0,1.0,40.9,0.27,2.9,0.09,138.0,455.0,30.3,1106.0,151.0,33.5,33.8,170.0,50.0,42.9,606.0,34.0,5.6,22.0,0.71,11.5,Matches,47.0,it ITA,GK,25.0,31.0,31.0,2783.0,30.9,39.0,1.26,134.0,95.0,73.9,9.0,12.0,10.0,7.0,22.6,6.0,4.0,1.0,1.0,20.0,Matches,555.0,it ITA,GK,25.0,30.9,3.0,0.0,0.0,0.0,8.0,0.0,0.0,0.0,1.0,0.0,0.0,0.0,29.0,9.0,2.0,81.8,Matches,555.0,it ITA,GK,25.0,30.9,1277.0,999.0,277.0,107.0,0.0,0.0,0.0,0.0,0.0,0.0,0.0,0.0,923.0,1.0,0.0,Matches,555.0,it ITA,GK,25.0,30.9,923.0,1277.0,72.3,24781.0,16933.0,169.0,170.0,99.4,479.0,487.0,98.4,274.0,618.0,44.3,0.0,0.0,0.0,0.0,0.0,19.0,0.0,0.0,0.0,Matches,709,it ITA,GK,25,31,2783.0,90.0,81.4,30.9,31,90.0,30,0,,0,1.26,34.0,39.0,-5.0,-0.16,0.83,31.9,48.7,-16.7,-0.54,-0.16,Matches,555.0,it ITA,GK,25.0,30.9,1365.0,1120.0,1363.0,2.0,0.0,0.0,1365.0,0.0,0.0,,0.0,,820.0,4026.0,2527.0,0.0,0.0,0.0,0.0,0.0,736.0,0.0,Matches,555.0,it ITA,GK,25.0,30.9,0.0,0.0,0.0,,0.0,0.0,,,,0.0,0.0,0.0,0.0,0.0,,0.0,0.0,Matches,555.0,it ITA,GK,25.0,31.0,31.0,2783.0,30.9,0.0,0.0,0.0,0.0,0.0,0.0,3.0,0.0,0.0,0.0,0.0,0.0,0.0,0.0,0.0,0.0,0.0,0.0,0.0,0.0,0.0,0.0,0.0,0.0,0.0,Matches,Guglielmo Vicario,GK,25,141,150,Italy,Empoli Football Club,1,1,3,2,5,1,8,1,3,1,8,2,1,8,10,14,14,13,15,11,12,15,9,12,8,13,12,11,11,14,13,16,14,13,15,15,16,9,12,5,1,14,13,14,4,14,13,13,16,12,11,12,13,15,6,12,13,15,13,12,20,1,1,1,1,1,1,1,1,1,1,1,1,1,194,83,7,20,6126332,7050,7050,5000,Northern_European,139,2,1996/10/7,0,0,21346.0,,43155241
1365,Tonny Vilhena,Salernitana,1995,561.0,nl NED,MF,27.0,25.2,44.0,22.0,16.0,23.0,5.0,20.0,50.0,40.0,30.0,17.0,7.0,10.0,18.0,62.0,21.0,0.0,Matches,561.0,nl NED,MF,27.0,25.2,53.0,2.11,37.0,9.0,3.0,1.0,3.0,0.0,3.0,0.12,3.0,0.0,0.0,0.0,0.0,0.0,Matches,,,,,,,,,,,,,,,,,,,,,,,,,,,,,,,,,,,,,,,,,,,,,,,,,,,,,,,,561.0,nl NED,MF,27.0,25.2,5.0,0.0,0.0,34.0,34.0,1.0,52.0,18.0,22.0,0.0,1.0,0.0,126.0,10.0,34.0,22.7,Matches,561.0,nl NED,MF,27.0,25.2,864.0,799.0,61.0,24.0,1.0,14.0,52.0,9.0,28.0,5.0,16.0,0.0,662.0,4.0,22.0,Matches,561.0,nl NED,MF,27.0,25.2,662.0,864.0,76.6,10869.0,3264.0,344.0,392.0,87.8,224.0,269.0,83.3,61.0,120.0,50.8,1.0,1.7,1.6,-0.7,19.0,64.0,14.0,6.0,80.0,Matches,715,nl NED,MF,27,33,2265.0,69.0,66.2,25.2,27,76.0,9,6,33.0,4,1.12,28.0,44.0,-16.0,-0.64,-0.79,22.9,45.8,-22.8,-0.91,-0.31,Matches,561.0,nl NED,MF,27.0,25.2,1091.0,32.0,202.0,609.0,294.0,19.0,1091.0,39.0,17.0,43.6,19.0,48.7,591.0,3063.0,1302.0,30.0,35.0,3.0,37.0,24.0,682.0,59.0,Matches,561.0,nl NED,MF,27.0,25.2,4.0,31.0,9.0,29.0,1.23,0.36,0.13,0.44,26.0,1.0,0.0,0.0,2.4,2.4,0.08,1.6,1.6,Matches,561.0,nl NED,MF,27.0,33.0,27.0,2265.0,25.2,4.0,1.0,5.0,4.0,0.0,0.0,5.0,0.0,2.4,2.4,1.7,4.1,30.0,80.0,59.0,0.16,0.04,0.2,0.16,0.2,0.1,0.07,0.16,0.1,0.16,Matches,Tonny Vilhena,DM/M C,27,131,141,"Holland,Angola",Espanyol,11,11,13,11,14,12,7,15,7,7,13,8,12,13,14,14,13,13,12,13,11,10,14,9,14,11,9,14,13,14,15,8,17,13,15,12,13,7,13,7,13,1,1,1,2,3,2,4,1,2,3,2,8,15,13,9,8,10,13,18,1,1,1,1,10,1,18,14,20,1,11,14,11,1,176,75,20,14,5675138,6550,6500,5900,African_Caribbean,131,12,1995/1/3,15,0,20999.0,U.S. Salernitana 1919,168335
1366,Dušan Vlahović,Juventus,2000,564.0,rs SRB,FW,22.0,21.4,11.0,6.0,0.0,7.0,4.0,4.0,10.0,40.0,6.0,10.0,3.0,7.0,3.0,14.0,8.0,1.0,Matches,564.0,rs SRB,FW,22.0,21.4,45.0,2.1,27.0,0.0,3.0,11.0,4.0,0.0,7.0,0.33,3.0,0.0,0.0,3.0,1.0,0.0,Matches,,,,,,,,,,,,,,,,,,,,,,,,,,,,,,,,,,,,,,,,,,,,,,,,,,,,,,,,564.0,rs SRB,FW,22.0,21.4,1.0,0.0,0.0,19.0,26.0,22.0,7.0,3.0,6.0,1.0,0.0,0.0,55.0,36.0,56.0,39.1,Matches,564.0,rs SRB,FW,22.0,21.4,381.0,350.0,30.0,1.0,1.0,4.0,7.0,0.0,0.0,0.0,0.0,0.0,271.0,1.0,16.0,Matches,564.0,rs SRB,FW,22.0,21.4,271.0,381.0,71.1,4560.0,793.0,123.0,161.0,76.4,108.0,136.0,79.4,24.0,39.0,61.5,2.0,2.4,0.8,-0.4,21.0,23.0,12.0,1.0,40.0,Matches,719,rs SRB,FW,22,27,1925.0,71.0,56.3,21.4,22,83.0,11,5,19.0,1,1.81,34.0,20.0,14.0,0.65,0.11,31.0,24.9,6.1,0.29,-0.17,Matches,564.0,rs SRB,FW,22.0,21.4,610.0,12.0,35.0,293.0,292.0,102.0,607.0,33.0,14.0,42.4,18.0,54.5,347.0,1648.0,609.0,22.0,22.0,12.0,61.0,37.0,460.0,117.0,Matches,564.0,rs SRB,FW,22.0,21.4,10.0,65.0,20.0,30.8,3.04,0.94,0.12,0.4,15.5,4.0,2.0,3.0,9.7,7.3,0.11,0.3,0.7,Matches,564.0,rs SRB,FW,22.0,27.0,22.0,1925.0,21.4,10.0,2.0,12.0,8.0,2.0,3.0,1.0,0.0,9.7,7.3,2.4,9.8,22.0,40.0,117.0,0.47,0.09,0.56,0.37,0.47,0.45,0.11,0.57,0.34,0.46,Matches,Dušan Vlahović,S,22,153,170,Serbia,Juventus,6,8,13,17,12,16,15,15,4,4,12,18,7,14,14,15,16,15,14,13,14,17,14,11,16,7,14,15,12,13,15,14,17,15,16,18,15,11,14,9,9,3,3,1,1,1,2,3,2,2,3,1,12,17,9,10,15,16,9,13,1,1,1,1,1,1,1,1,1,1,1,1,1,20,191,81,20,9,106620002,7650,7650,6750,Northern_European,153,4,2000/1/28,14,7,249230.0,,62182055
1367,Nikola Vlašić,Torino,1997,565.0,hr CRO,MFFW,24.0,30.3,32.0,21.0,9.0,16.0,7.0,15.0,34.0,44.1,19.0,25.0,2.0,23.0,10.0,42.0,14.0,0.0,Matches,565.0,hr CRO,MFFW,24.0,30.3,115.0,3.79,96.0,5.0,4.0,7.0,1.0,2.0,8.0,0.26,7.0,0.0,0.0,0.0,1.0,0.0,Matches,,,,,,,,,,,,,,,,,,,,,,,,,,,,,,,,,,,,,,,,,,,,,,,,,,,,,,,,565.0,hr CRO,MFFW,24.0,30.3,1.0,0.0,0.0,32.0,38.0,15.0,46.0,10.0,21.0,0.0,0.0,0.0,128.0,25.0,49.0,33.8,Matches,565.0,hr CRO,MFFW,24.0,30.3,981.0,954.0,23.0,3.0,2.0,8.0,46.0,5.0,9.0,5.0,2.0,0.0,775.0,4.0,43.0,Matches,565.0,hr CRO,MFFW,24.0,30.3,775.0,981.0,79.0,10928.0,2475.0,448.0,510.0,87.8,234.0,286.0,81.8,42.0,62.0,67.7,6.0,4.1,3.3,1.9,63.0,70.0,26.0,8.0,106.0,Matches,720,hr CRO,MFFW,24,34,2728.0,80.0,79.8,30.3,29,87.0,23,5,42.0,0,1.35,33.0,30.0,3.0,0.1,0.36,33.6,33.7,-0.2,-0.01,-0.26,Matches,565.0,hr CRO,MFFW,24.0,30.3,1296.0,16.0,131.0,548.0,641.0,116.0,1296.0,64.0,30.0,46.9,26.0,40.6,782.0,4766.0,2266.0,85.0,59.0,28.0,94.0,49.0,968.0,210.0,Matches,565.0,hr CRO,MFFW,24.0,30.3,5.0,53.0,21.0,39.6,1.75,0.69,0.09,0.24,18.0,1.0,0.0,0.0,4.3,4.3,0.08,0.7,0.7,Matches,565.0,hr CRO,MFFW,24.0,34.0,29.0,2728.0,30.3,5.0,6.0,11.0,5.0,0.0,0.0,1.0,0.0,4.3,4.3,4.1,8.4,85.0,106.0,210.0,0.16,0.2,0.36,0.16,0.36,0.14,0.14,0.28,0.14,0.28,Matches,Nikola Vlašić,M/AM RLC,24,143,155,Croatia,West Ham United,12,12,16,13,15,12,9,14,4,7,14,13,8,14,13,15,11,14,13,14,14,17,14,13,14,6,11,12,15,14,15,10,17,14,14,12,12,6,15,6,10,3,2,3,1,2,3,2,1,2,1,1,15,15,5,11,14,13,15,16,1,1,1,1,1,1,7,12,16,11,15,20,16,12,178,79,11,20,44210250,7150,6550,5750,Northern_European,143,3,1997/10/4,39,7,81194.0,Torino,24039948
1368,Mërgim Vojvoda,Torino,1995,567.0,xk KVX,DF,27.0,19.1,22.0,12.0,15.0,6.0,1.0,12.0,24.0,50.0,12.0,14.0,2.0,12.0,10.0,32.0,31.0,1.0,Matches,567.0,xk KVX,DF,27.0,19.1,62.0,3.24,46.0,8.0,4.0,4.0,0.0,0.0,9.0,0.47,7.0,1.0,1.0,0.0,0.0,0.0,Matches,,,,,,,,,,,,,,,,,,,,,,,,,,,,,,,,,,,,,,,,,,,,,,,,,,,,,,,,567.0,xk KVX,DF,27.0,19.1,3.0,0.0,0.0,19.0,7.0,2.0,43.0,10.0,12.0,0.0,0.0,0.0,117.0,10.0,18.0,35.7,Matches,567.0,xk KVX,DF,27.0,19.1,1143.0,960.0,178.0,16.0,4.0,13.0,43.0,152.0,10.0,6.0,0.0,0.0,887.0,5.0,18.0,Matches,567.0,xk KVX,DF,27.0,19.1,887.0,1143.0,77.6,15034.0,6134.0,436.0,503.0,86.7,363.0,450.0,80.7,71.0,131.0,54.2,5.0,3.7,2.6,1.3,23.0,97.0,27.0,5.0,125.0,Matches,722,xk KVX,DF,27,29,1719.0,59.0,50.3,19.1,18,81.0,12,11,24.0,6,1.45,24.0,21.0,3.0,0.16,0.26,23.1,18.8,4.3,0.22,0.35,Matches,567.0,xk KVX,DF,27.0,19.1,1304.0,37.0,302.0,627.0,389.0,39.0,1304.0,22.0,12.0,54.5,8.0,36.4,686.0,3409.0,1607.0,30.0,27.0,10.0,20.0,17.0,841.0,81.0,Matches,567.0,xk KVX,DF,27.0,19.1,0.0,23.0,6.0,26.1,1.2,0.31,0.0,0.0,17.3,0.0,0.0,0.0,1.5,1.5,0.07,-1.5,-1.5,Matches,567.0,xk KVX,DF,27.0,29.0,18.0,1719.0,19.1,0.0,5.0,5.0,0.0,0.0,0.0,3.0,0.0,1.5,1.5,3.7,5.3,30.0,125.0,81.0,0.0,0.26,0.26,0.0,0.26,0.08,0.19,0.27,0.08,0.27,Matches,Mërgim Vojvoda,D/WB RLC,27,134,140,"Kosovo,Albania,Belgium",Torino,7,14,13,8,13,8,12,9,13,11,12,8,13,14,14,13,14,13,12,11,12,14,13,11,12,12,14,14,13,13,12,13,12,14,12,13,13,12,11,5,15,3,3,2,3,1,3,1,2,1,3,3,15,13,5,11,12,13,14,11,1,17,17,20,15,18,1,10,1,14,1,1,1,1,186,78,10,20,6121293,6700,6300,5150,Northern_European,126,3,1995/2/1,45,2,17307.0,,18086509
1369,Stefan de Vrij,Inter,1992,571.0,nl NED,DF,30.0,21.6,28.0,18.0,19.0,9.0,0.0,8.0,14.0,57.1,6.0,18.0,10.0,8.0,40.0,68.0,80.0,0.0,Matches,571.0,nl NED,DF,30.0,21.6,13.0,0.6,10.0,0.0,0.0,2.0,0.0,1.0,1.0,0.05,1.0,0.0,0.0,0.0,0.0,0.0,Matches,,,,,,,,,,,,,,,,,,,,,,,,,,,,,,,,,,,,,,,,,,,,,,,,,,,,,,,,571.0,nl NED,DF,30.0,21.6,4.0,0.0,0.0,15.0,7.0,0.0,0.0,40.0,18.0,0.0,1.0,0.0,100.0,82.0,30.0,73.2,Matches,571.0,nl NED,DF,30.0,21.6,1206.0,1183.0,21.0,17.0,1.0,1.0,0.0,2.0,0.0,0.0,0.0,0.0,1078.0,2.0,4.0,Matches,571.0,nl NED,DF,30.0,21.6,1078.0,1206.0,89.4,19552.0,5861.0,365.0,390.0,93.6,634.0,674.0,94.1,67.0,111.0,60.4,0.0,0.2,0.7,-0.2,1.0,42.0,0.0,0.0,55.0,Matches,726,nl NED,DF,30,27,1945.0,72.0,56.9,21.6,22,85.0,18,5,15.0,11,1.74,41.0,25.0,16.0,0.74,-0.05,37.8,20.5,17.3,0.8,-0.07,Matches,571.0,nl NED,DF,30.0,21.6,1423.0,159.0,709.0,681.0,35.0,24.0,1423.0,5.0,4.0,80.0,1.0,20.0,797.0,3663.0,2155.0,13.0,2.0,0.0,3.0,4.0,937.0,0.0,Matches,571.0,nl NED,DF,30.0,21.6,1.0,20.0,6.0,30.0,0.93,0.28,0.05,0.17,9.0,0.0,0.0,0.0,2.2,2.2,0.11,-1.2,-1.2,Matches,571.0,nl NED,DF,30.0,27.0,22.0,1945.0,21.6,1.0,0.0,1.0,1.0,0.0,0.0,4.0,0.0,2.2,2.2,0.2,2.4,13.0,55.0,0.0,0.05,0.0,0.05,0.05,0.05,0.1,0.01,0.11,0.1,0.11,Matches,Stefan de Vrij,D C,30,151,161,Holland,FC Internazionale Milano,4,8,10,9,13,6,16,8,7,17,14,8,15,14,13,17,15,14,13,12,13,14,12,13,8,14,16,15,12,12,14,15,16,12,15,15,12,10,13,9,9,3,3,3,3,1,1,2,3,2,3,3,16,16,2,12,14,16,14,16,1,1,20,8,1,1,1,1,1,1,1,1,1,1,189,78,10,20,14895474,7550,7500,6750,Northern_European,149,2,1992/2/5,57,3,135384.0,,37001814
1370,Walace,Udinese,1995,572.0,br BRA,MF,27.0,35.4,82.0,39.0,42.0,31.0,9.0,41.0,90.0,45.6,49.0,47.0,12.0,35.0,51.0,133.0,51.0,1.0,Matches,572.0,br BRA,MF,27.0,35.4,53.0,1.49,43.0,1.0,0.0,5.0,3.0,1.0,6.0,0.17,5.0,0.0,0.0,0.0,1.0,0.0,Matches,,,,,,,,,,,,,,,,,,,,,,,,,,,,,,,,,,,,,,,,,,,,,,,,,,,,,,,,572.0,br BRA,MF,27.0,35.4,6.0,0.0,0.0,40.0,39.0,0.0,21.0,51.0,39.0,0.0,1.0,0.0,297.0,23.0,29.0,44.2,Matches,572.0,br BRA,MF,27.0,35.4,1771.0,1688.0,77.0,56.0,1.0,25.0,21.0,7.0,1.0,0.0,0.0,0.0,1482.0,6.0,38.0,Matches,572.0,br BRA,MF,27.0,35.4,1482.0,1771.0,83.7,27539.0,8344.0,586.0,670.0,87.5,667.0,745.0,89.5,189.0,257.0,73.5,1.0,1.7,1.0,-0.7,17.0,153.0,12.0,3.0,170.0,Matches,728,br BRA,MF,27,37,3190.0,86.0,93.3,35.4,37,86.0,28,0,,0,1.24,42.0,44.0,-2.0,-0.06,-0.45,43.1,49.4,-6.3,-0.18,-0.74,Matches,572.0,br BRA,MF,27.0,35.4,2151.0,121.0,649.0,1266.0,260.0,15.0,2151.0,28.0,11.0,39.3,13.0,46.4,1222.0,6377.0,2966.0,47.0,32.0,0.0,39.0,29.0,1297.0,36.0,Matches,572.0,br BRA,MF,27.0,35.4,0.0,32.0,6.0,18.8,0.9,0.17,0.0,0.0,26.4,0.0,0.0,0.0,1.1,1.1,0.04,-1.1,-1.1,Matches,572.0,br BRA,MF,27.0,37.0,37.0,3190.0,35.4,0.0,1.0,1.0,0.0,0.0,0.0,6.0,0.0,1.1,1.1,1.7,2.8,47.0,170.0,36.0,0.0,0.03,0.03,0.0,0.03,0.03,0.05,0.08,0.03,0.08,Matches,Walace,DM/M C,27,132,138,Brazil,Udinese Calcio,5,7,11,7,12,7,9,9,10,15,12,8,16,11,15,14,16,13,12,10,12,15,7,9,8,14,14,15,12,12,14,14,14,14,15,17,13,14,15,5,11,1,1,1,2,3,3,2,3,2,4,2,13,13,15,10,12,11,9,8,1,1,14,1,1,1,20,1,20,1,1,1,1,1,188,75,10,20,4813546,6600,6200,5200,Mixed_Race,130,16,1995/4/4,5,0,12308.0,,19184263
1371,Harry Winks,Sampdoria,1996,575.0,eng ENG,MF,26.0,19.1,27.0,12.0,7.0,18.0,2.0,14.0,43.0,32.6,29.0,14.0,8.0,6.0,24.0,51.0,24.0,0.0,Matches,575.0,eng ENG,MF,26.0,19.1,36.0,1.89,24.0,7.0,1.0,3.0,1.0,0.0,1.0,0.05,1.0,0.0,0.0,0.0,0.0,0.0,Matches,,,,,,,,,,,,,,,,,,,,,,,,,,,,,,,,,,,,,,,,,,,,,,,,,,,,,,,,575.0,eng ENG,MF,26.0,19.1,2.0,0.0,0.0,15.0,13.0,1.0,46.0,24.0,12.0,0.0,0.0,0.0,120.0,6.0,12.0,33.3,Matches,575.0,eng ENG,MF,26.0,19.1,961.0,885.0,75.0,44.0,1.0,13.0,46.0,1.0,21.0,7.0,8.0,0.0,792.0,1.0,16.0,Matches,575.0,eng ENG,MF,26.0,19.1,792.0,961.0,82.4,14868.0,5159.0,319.0,360.0,88.6,352.0,400.0,88.0,104.0,162.0,64.2,0.0,1.3,1.5,-1.3,15.0,80.0,10.0,3.0,117.0,Matches,731,eng ENG,MF,26,20,1716.0,86.0,50.2,19.1,19,89.0,15,1,29.0,1,0.5,16.0,36.0,-20.0,-1.05,0.38,19.3,35.8,-16.5,-0.87,-0.04,Matches,575.0,eng ENG,MF,26.0,19.1,1117.0,49.0,274.0,686.0,171.0,4.0,1117.0,27.0,17.0,63.0,5.0,18.5,675.0,3357.0,1576.0,19.0,20.0,0.0,25.0,15.0,734.0,17.0,Matches,575.0,eng ENG,MF,26.0,19.1,0.0,14.0,0.0,0.0,0.73,0.0,0.0,,24.7,0.0,0.0,0.0,0.6,0.6,0.04,-0.6,-0.6,Matches,575.0,eng ENG,MF,26.0,20.0,19.0,1716.0,19.1,0.0,0.0,0.0,0.0,0.0,0.0,2.0,0.0,0.6,0.6,1.3,1.8,19.0,117.0,17.0,0.0,0.0,0.0,0.0,0.0,0.03,0.07,0.1,0.03,0.1,Matches,Harry Winks,DM/M C,26,138,144,England,Tottenham Hotspur,10,10,13,10,14,11,8,12,5,12,15,12,13,14,13,14,14,16,13,12,13,14,10,11,13,13,16,15,13,13,16,6,11,12,14,11,13,6,12,13,10,2,3,2,2,1,2,4,1,1,1,2,12,13,7,14,14,16,14,12,1,1,1,1,1,1,16,1,20,13,1,1,1,1,176,74,12,20,16236262,6893,6893,5743,Northern_European,137,4,1996/2/2,10,1,104393.0,U.C. Sampdoria,28088513
1372,Mattia Zaccagni,Lazio,1995,578.0,it ITA,FW,27.0,30.8,42.0,28.0,16.0,18.0,8.0,14.0,38.0,36.8,24.0,37.0,3.0,34.0,21.0,63.0,10.0,1.0,Matches,578.0,it ITA,FW,27.0,30.8,87.0,2.83,63.0,1.0,8.0,6.0,8.0,1.0,11.0,0.36,8.0,1.0,0.0,1.0,1.0,0.0,Matches,,,,,,,,,,,,,,,,,,,,,,,,,,,,,,,,,,,,,,,,,,,,,,,,,,,,,,,,578.0,it ITA,FW,27.0,30.8,9.0,0.0,0.0,53.0,117.0,5.0,62.0,21.0,28.0,0.0,1.0,0.0,132.0,15.0,29.0,34.1,Matches,578.0,it ITA,FW,27.0,30.8,1047.0,1024.0,21.0,7.0,2.0,7.0,62.0,8.0,6.0,4.0,1.0,0.0,841.0,2.0,35.0,Matches,578.0,it ITA,FW,27.0,30.8,841.0,1047.0,80.3,10898.0,2314.0,563.0,630.0,89.4,212.0,261.0,81.2,25.0,57.0,43.9,6.0,4.5,3.2,1.5,35.0,44.0,27.0,5.0,76.0,Matches,734,it ITA,FW,27,35,2770.0,79.0,81.0,30.8,33,82.0,17,2,31.0,0,1.94,50.0,23.0,27.0,0.88,0.46,39.5,34.6,4.9,0.16,-0.52,Matches,578.0,it ITA,FW,27.0,30.8,1402.0,16.0,162.0,628.0,636.0,120.0,1401.0,126.0,60.0,47.6,35.0,27.8,976.0,6797.0,3560.0,118.0,62.0,42.0,49.0,35.0,1136.0,282.0,Matches,578.0,it ITA,FW,27.0,30.8,10.0,56.0,23.0,41.1,1.82,0.75,0.16,0.39,16.7,1.0,1.0,1.0,6.7,5.9,0.11,3.3,3.1,Matches,578.0,it ITA,FW,27.0,35.0,33.0,2770.0,30.8,10.0,6.0,16.0,9.0,1.0,1.0,9.0,0.0,6.7,5.9,4.5,10.4,118.0,76.0,282.0,0.32,0.19,0.52,0.29,0.49,0.22,0.15,0.36,0.19,0.34,Matches,Mattia Zaccagni,AM LC,27,147,152,Italy,S.S. Lazio,12,14,17,13,15,12,7,11,3,3,15,12,8,15,13,16,12,12,12,15,14,17,16,13,14,6,15,14,14,15,14,10,14,14,12,10,13,12,14,3,10,3,1,1,1,1,3,1,2,1,2,4,14,16,8,16,13,16,13,10,1,1,1,1,1,1,11,11,11,8,20,18,12,12,177,63,14,20,21569229,7350,7150,5700,Mediterranean_Hispanic,147,2,1995/6/16,0,0,71154.0,,43125343
1373,Nicola Zalewski,Roma,2002,580.0,pl POL,DF,20.0,24.4,45.0,26.0,25.0,15.0,5.0,22.0,71.0,31.0,49.0,27.0,1.0,26.0,31.0,76.0,23.0,0.0,Matches,580.0,pl POL,DF,20.0,24.4,62.0,2.54,35.0,7.0,6.0,5.0,7.0,2.0,7.0,0.29,4.0,2.0,0.0,1.0,0.0,0.0,Matches,,,,,,,,,,,,,,,,,,,,,,,,,,,,,,,,,,,,,,,,,,,,,,,,,,,,,,,,580.0,pl POL,DF,20.0,24.4,3.0,0.0,0.0,22.0,51.0,1.0,76.0,31.0,26.0,0.0,0.0,0.0,135.0,4.0,16.0,20.0,Matches,580.0,pl POL,DF,20.0,24.4,1252.0,993.0,254.0,18.0,2.0,14.0,76.0,224.0,12.0,9.0,2.0,0.0,933.0,5.0,25.0,Matches,580.0,pl POL,DF,20.0,24.4,933.0,1252.0,74.5,16262.0,5001.0,441.0,503.0,87.7,364.0,462.0,78.8,103.0,220.0,46.8,1.0,1.2,1.9,-0.2,12.0,58.0,24.0,6.0,85.0,Matches,737,pl POL,DF,20,33,2197.0,67.0,64.2,24.4,26,78.0,10,7,23.0,3,1.61,29.0,24.0,5.0,0.2,-0.31,31.9,18.9,13.0,0.53,-0.38,Matches,580.0,pl POL,DF,20.0,24.4,1522.0,35.0,416.0,701.0,425.0,33.0,1522.0,71.0,29.0,40.8,30.0,42.3,839.0,5248.0,3029.0,92.0,56.0,21.0,29.0,14.0,942.0,99.0,Matches,580.0,pl POL,DF,20.0,24.4,2.0,29.0,9.0,31.0,1.19,0.37,0.07,0.22,23.1,1.0,0.0,0.0,1.3,1.3,0.05,0.7,0.7,Matches,580.0,pl POL,DF,20.0,33.0,26.0,2197.0,24.4,2.0,1.0,3.0,2.0,0.0,0.0,3.0,0.0,1.3,1.3,1.2,2.5,92.0,85.0,99.0,0.08,0.04,0.12,0.08,0.12,0.05,0.05,0.1,0.05,0.1,Matches,Nicola Zalewski,WB/M/AM L,20,137,-85,"Poland,Italy",Associazione Sportiva Roma,10,11,15,8,15,9,5,10,4,10,14,11,13,14,12,12,12,11,10,14,11,14,16,4,14,10,12,12,15,15,12,7,13,14,12,8,14,9,15,4,18,2,2,3,2,3,1,3,2,2,3,2,13,14,7,13,13,12,13,12,1,15,1,10,20,12,1,18,1,10,20,10,10,1,175,63,15,20,55520001,6847,5922,4446,Northern_European,124,1,2002/1/23,5,0,17885.0,,43426126
1374,Alessandro Zanoli,Sampdoria,2000,584.0,it ITA,DF,21.0,17.1,22.0,14.0,14.0,6.0,2.0,8.0,17.0,47.1,9.0,19.0,15.0,4.0,12.0,34.0,39.0,0.0,Matches,584.0,it ITA,DF,21.0,17.1,35.0,2.05,25.0,2.0,7.0,1.0,0.0,0.0,3.0,0.18,2.0,0.0,1.0,0.0,0.0,0.0,Matches,,,,,,,,,,,,,,,,,,,,,,,,,,,,,,,,,,,,,,,,,,,,,,,,,,,,,,,,584.0,it ITA,DF,21.0,17.1,3.0,0.0,0.0,4.0,10.0,0.0,33.0,12.0,14.0,0.0,0.0,0.0,79.0,10.0,19.0,34.5,Matches,584.0,it ITA,DF,21.0,17.1,700.0,594.0,105.0,12.0,0.0,2.0,33.0,93.0,0.0,0.0,0.0,0.0,535.0,1.0,23.0,Matches,584.0,it ITA,DF,21.0,17.1,535.0,700.0,76.4,8772.0,2740.0,265.0,295.0,89.8,219.0,279.0,78.5,39.0,80.0,48.8,3.0,1.2,0.9,1.8,14.0,19.0,13.0,7.0,36.0,Matches,741,it ITA,DF,21,22,1540.0,70.0,45.0,17.1,16,86.0,12,6,28.0,0,0.45,13.0,34.0,-21.0,-1.23,0.02,16.2,34.9,-18.7,-1.09,-0.44,Matches,584.0,it ITA,DF,21.0,17.1,862.0,74.0,326.0,339.0,213.0,22.0,862.0,45.0,27.0,60.0,12.0,26.7,455.0,2781.0,1661.0,50.0,23.0,10.0,15.0,9.0,522.0,60.0,Matches,584.0,it ITA,DF,21.0,17.1,2.0,15.0,7.0,46.7,0.88,0.41,0.13,0.29,13.8,0.0,0.0,0.0,2.6,2.6,0.17,-0.6,-0.6,Matches,584.0,it ITA,DF,21.0,22.0,16.0,1540.0,17.1,2.0,3.0,5.0,2.0,0.0,0.0,3.0,0.0,2.6,2.6,1.2,3.8,50.0,36.0,60.0,0.12,0.18,0.29,0.12,0.29,0.15,0.07,0.22,0.15,0.22,Matches,Alessandro Zanoli,D RC,21,123,146,Italy,Parthenope,8,11,9,6,11,6,11,8,14,12,11,7,14,11,9,13,12,12,14,10,12,13,6,7,12,13,13,13,13,12,14,13,14,14,14,14,12,7,9,6,14,3,3,1,2,3,4,2,2,1,2,2,15,14,6,11,13,14,10,12,1,13,16,20,10,14,1,1,1,14,1,1,1,1,188,81,10,20,4807499,6150,5800,3500,Mediterranean_Hispanic,123,3,2000/10/3,0,0,2115.0,,43390940
1375,Duván Zapata,Atalanta,1991,587.0,co COL,FW,31.0,15.4,8.0,4.0,1.0,3.0,4.0,3.0,5.0,60.0,2.0,6.0,2.0,4.0,4.0,12.0,17.0,1.0,Matches,587.0,co COL,FW,31.0,15.4,46.0,2.98,35.0,0.0,5.0,1.0,4.0,1.0,7.0,0.45,4.0,0.0,1.0,1.0,1.0,0.0,Matches,,,,,,,,,,,,,,,,,,,,,,,,,,,,,,,,,,,,,,,,,,,,,,,,,,,,,,,,587.0,co COL,FW,31.0,15.4,1.0,0.0,0.0,17.0,37.0,7.0,29.0,4.0,4.0,1.0,0.0,0.0,42.0,42.0,43.0,49.4,Matches,587.0,co COL,FW,31.0,15.4,412.0,377.0,31.0,1.0,0.0,6.0,29.0,7.0,1.0,0.0,0.0,0.0,281.0,4.0,14.0,Matches,587.0,co COL,FW,31.0,15.4,281.0,412.0,68.2,4370.0,805.0,156.0,208.0,75.0,91.0,128.0,71.1,24.0,36.0,66.7,2.0,1.1,1.2,0.9,17.0,19.0,14.0,4.0,40.0,Matches,744,co COL,FW,31,25,1390.0,56.0,40.6,15.4,16,73.0,5,9,25.0,0,1.68,18.0,20.0,-2.0,-0.13,-1.02,17.7,18.2,-0.5,-0.03,-0.78,Matches,587.0,co COL,FW,31.0,15.4,597.0,17.0,32.0,252.0,319.0,93.0,597.0,45.0,20.0,44.4,16.0,35.6,399.0,2196.0,752.0,35.0,20.0,21.0,53.0,45.0,492.0,140.0,Matches,587.0,co COL,FW,31.0,15.4,2.0,41.0,8.0,19.5,2.65,0.52,0.05,0.25,15.6,0.0,0.0,0.0,3.9,3.9,0.1,-1.9,-1.9,Matches,587.0,co COL,FW,31.0,25.0,16.0,1390.0,15.4,2.0,2.0,4.0,2.0,0.0,0.0,1.0,0.0,3.9,3.9,1.1,5.1,35.0,40.0,140.0,0.13,0.13,0.26,0.13,0.26,0.25,0.07,0.33,0.25,0.33,Matches,Duván Zapata,S,31,151,159,Colombia,Atalanta,4,9,12,18,13,4,15,11,4,4,13,14,7,13,13,16,14,15,12,12,14,15,12,7,15,3,18,13,13,10,15,15,16,17,14,19,14,11,14,10,5,4,1,3,1,1,3,2,2,2,2,2,14,15,5,13,12,19,18,13,1,1,1,1,1,1,1,1,1,1,1,1,1,20,189,88,10,20,347975206,7550,7500,6600,African_Caribbean,148,15,1991/4/1,34,4,64038.0,,76014012
1376,Davide Zappacosta,Atalanta,1992,588.0,it ITA,DF,30.0,16.3,34.0,18.0,17.0,12.0,5.0,15.0,22.0,68.2,7.0,23.0,2.0,21.0,9.0,43.0,16.0,0.0,Matches,588.0,it ITA,DF,30.0,16.3,39.0,2.38,26.0,6.0,3.0,2.0,1.0,1.0,8.0,0.49,5.0,1.0,1.0,1.0,0.0,0.0,Matches,,,,,,,,,,,,,,,,,,,,,,,,,,,,,,,,,,,,,,,,,,,,,,,,,,,,,,,,588.0,it ITA,DF,30.0,16.3,4.0,0.0,0.0,18.0,13.0,2.0,59.0,9.0,18.0,0.0,0.0,0.0,90.0,2.0,8.0,20.0,Matches,588.0,it ITA,DF,30.0,16.3,925.0,719.0,204.0,11.0,0.0,0.0,59.0,188.0,5.0,5.0,0.0,0.0,771.0,2.0,22.0,Matches,588.0,it ITA,DF,30.0,16.3,771.0,925.0,83.4,10806.0,3422.0,462.0,494.0,93.5,258.0,319.0,80.9,26.0,48.0,54.2,2.0,1.6,1.4,0.4,15.0,38.0,14.0,9.0,55.0,Matches,745,it ITA,DF,30,21,1471.0,70.0,43.0,16.3,18,76.0,9,3,34.0,1,1.81,34.0,22.0,12.0,0.73,0.46,25.6,17.0,8.7,0.53,0.18,Matches,588.0,it ITA,DF,30.0,16.3,1122.0,31.0,261.0,415.0,456.0,56.0,1122.0,57.0,17.0,29.8,33.0,57.9,607.0,3660.0,1893.0,48.0,39.0,18.0,26.0,14.0,692.0,101.0,Matches,588.0,it ITA,DF,30.0,16.3,4.0,25.0,10.0,40.0,1.53,0.61,0.16,0.4,16.6,0.0,0.0,0.0,1.5,1.5,0.06,2.5,2.5,Matches,588.0,it ITA,DF,30.0,21.0,18.0,1471.0,16.3,4.0,2.0,6.0,4.0,0.0,0.0,4.0,0.0,1.5,1.5,1.6,3.2,48.0,55.0,101.0,0.24,0.12,0.37,0.24,0.37,0.09,0.1,0.2,0.09,0.2,Matches,Davide Zappacosta,D/WB/M R,30,138,149,Italy,Atalanta,10,13,12,9,12,9,9,11,11,12,13,4,13,12,11,11,14,13,14,11,13,15,11,7,15,12,15,16,15,12,13,12,15,16,14,12,13,6,13,7,14,1,3,3,2,1,1,1,2,1,1,2,12,15,4,13,12,15,14,14,1,12,1,20,12,20,1,10,1,17,1,8,1,1,185,70,9,20,10006613,6900,6900,5650,Mediterranean_Hispanic,131,6,1992/6/11,13,0,32115.0,,43061433
1377,Piotr Zieliński,Napoli,1994,593.0,pl POL,MF,28.0,25.4,17.0,10.0,1.0,11.0,5.0,12.0,25.0,48.0,13.0,16.0,5.0,11.0,14.0,31.0,7.0,0.0,Matches,593.0,pl POL,MF,28.0,25.4,135.0,5.31,85.0,37.0,4.0,3.0,6.0,0.0,12.0,0.47,8.0,3.0,0.0,1.0,0.0,0.0,Matches,,,,,,,,,,,,,,,,,,,,,,,,,,,,,,,,,,,,,,,,,,,,,,,,,,,,,,,,593.0,pl POL,MF,28.0,25.4,3.0,0.0,0.0,21.0,35.0,2.0,112.0,14.0,10.0,0.0,0.0,0.0,102.0,4.0,13.0,23.5,Matches,593.0,pl POL,MF,28.0,25.4,1552.0,1381.0,167.0,41.0,2.0,6.0,112.0,4.0,92.0,30.0,36.0,1.0,1300.0,4.0,25.0,Matches,593.0,pl POL,MF,28.0,25.4,1300.0,1552.0,83.8,18650.0,5534.0,767.0,833.0,92.1,359.0,423.0,84.9,95.0,168.0,56.5,8.0,7.4,7.5,0.6,84.0,122.0,45.0,7.0,128.0,Matches,750,pl POL,MF,28,37,2287.0,62.0,66.9,25.4,27,73.0,3,10,31.0,1,2.35,57.0,21.0,36.0,1.42,0.38,46.6,22.8,23.8,0.93,0.2,Matches,593.0,pl POL,MF,28.0,25.4,1755.0,19.0,183.0,822.0,765.0,54.0,1755.0,58.0,22.0,37.9,29.0,50.0,1086.0,5372.0,2485.0,62.0,75.0,9.0,27.0,15.0,1361.0,129.0,Matches,593.0,pl POL,MF,28.0,25.4,3.0,53.0,19.0,35.8,2.09,0.75,0.06,0.16,22.4,6.0,0.0,0.0,3.5,3.5,0.07,-0.5,-0.5,Matches,593.0,pl POL,MF,28.0,37.0,27.0,2287.0,25.4,3.0,8.0,11.0,3.0,0.0,0.0,3.0,0.0,3.5,3.5,7.4,10.9,62.0,128.0,129.0,0.12,0.31,0.43,0.12,0.43,0.14,0.29,0.43,0.14,0.43,Matches,Piotr Zieliński,M/AM C,28,155,159,Poland,Parthenope,14,14,13,14,17,12,7,15,4,7,17,14,7,16,10,15,11,12,9,16,14,11,15,10,14,10,15,12,13,14,12,9,16,14,14,10,14,7,11,6,15,2,3,2,3,3,1,2,3,1,2,2,13,13,13,14,13,15,14,12,1,1,1,1,1,1,14,13,20,12,11,20,10,1,180,69,17,20,50943751,7750,7700,6750,Northern_European,149,2,1994/5/20,72,9,124615.0,,43093171
1378,Milan Đurić,Hellas Verona,1990,602.0,ba BIH,FW,32.0,15.2,2.0,1.0,1.0,0.0,1.0,1.0,3.0,33.3,2.0,7.0,4.0,3.0,1.0,3.0,24.0,0.0,Matches,602.0,ba BIH,FW,32.0,15.2,36.0,2.37,31.0,0.0,0.0,3.0,2.0,0.0,2.0,0.13,2.0,0.0,0.0,0.0,0.0,0.0,Matches,,,,,,,,,,,,,,,,,,,,,,,,,,,,,,,,,,,,,,,,,,,,,,,,,,,,,,,,602.0,ba BIH,FW,32.0,15.2,3.0,0.0,0.0,24.0,29.0,5.0,0.0,1.0,1.0,0.0,0.0,0.0,30.0,197.0,57.0,77.6,Matches,602.0,ba BIH,FW,32.0,15.2,523.0,514.0,7.0,0.0,2.0,0.0,0.0,2.0,0.0,0.0,0.0,0.0,268.0,2.0,3.0,Matches,602.0,ba BIH,FW,32.0,15.2,268.0,523.0,51.2,3119.0,740.0,186.0,336.0,55.4,54.0,119.0,45.4,5.0,13.0,38.5,1.0,1.3,0.9,-0.3,21.0,27.0,5.0,0.0,29.0,Matches,760,ba BIH,FW,32,28,1366.0,49.0,39.9,15.2,14,77.0,6,14,21.0,4,0.86,15.0,23.0,-8.0,-0.53,0.35,13.1,19.9,-6.9,-0.45,-0.14,Matches,602.0,ba BIH,FW,32.0,15.2,644.0,32.0,62.0,314.0,270.0,60.0,644.0,6.0,2.0,33.3,3.0,50.0,262.0,869.0,211.0,2.0,5.0,3.0,26.0,15.0,551.0,72.0,Matches,602.0,ba BIH,FW,32.0,15.2,1.0,16.0,5.0,31.3,1.05,0.33,0.06,0.2,10.7,0.0,0.0,0.0,1.4,1.4,0.09,-0.4,-0.4,Matches,602.0,ba BIH,FW,32.0,28.0,14.0,1366.0,15.2,1.0,1.0,2.0,1.0,0.0,0.0,3.0,0.0,1.4,1.4,1.3,2.7,2.0,29.0,72.0,0.07,0.07,0.13,0.07,0.13,0.09,0.08,0.18,0.09,0.18,Matches,Milan Đurić,S,32,126,130,"Bosnia and Herzegovina,Italy",Hellas Verona,3,3,5,12,12,6,19,10,3,5,14,14,5,13,14,15,16,12,13,11,14,17,7,11,15,9,18,18,11,9,16,18,16,11,12,19,13,14,12,5,5,1,3,2,2,3,2,2,3,2,3,2,18,15,8,14,12,18,14,13,1,1,1,1,1,1,1,1,1,1,7,1,7,20,199,94,8,20,1682233,6300,5900,3150,Northern_European,124,4,1990/5/22,15,7,24903.0,,43009443
1379,Filip Đuričić,Sampdoria,1992,603.0,rs SRB,MFFW,30.0,24.1,43.0,22.0,18.0,20.0,5.0,14.0,32.0,43.8,18.0,19.0,6.0,13.0,7.0,50.0,8.0,0.0,Matches,603.0,rs SRB,MFFW,30.0,24.1,69.0,2.86,45.0,9.0,4.0,3.0,6.0,2.0,3.0,0.12,3.0,0.0,0.0,0.0,0.0,0.0,Matches,,,,,,,,,,,,,,,,,,,,,,,,,,,,,,,,,,,,,,,,,,,,,,,,,,,,,,,,603.0,rs SRB,MFFW,30.0,24.1,9.0,0.0,0.0,38.0,48.0,0.0,41.0,7.0,22.0,0.0,0.0,0.0,110.0,14.0,29.0,32.6,Matches,603.0,rs SRB,MFFW,30.0,24.1,758.0,703.0,53.0,17.0,3.0,3.0,41.0,8.0,22.0,5.0,13.0,0.0,586.0,2.0,36.0,Matches,603.0,rs SRB,MFFW,30.0,24.1,586.0,758.0,77.3,9599.0,2169.0,302.0,347.0,87.0,211.0,254.0,83.1,52.0,86.0,60.5,0.0,1.9,1.6,-1.9,34.0,50.0,18.0,4.0,77.0,Matches,761,rs SRB,MFFW,30,32,2171.0,68.0,63.5,24.1,27,74.0,6,5,33.0,1,0.44,16.0,47.0,-31.0,-1.29,-0.13,21.4,39.3,-17.9,-0.74,0.28,Matches,603.0,rs SRB,MFFW,30.0,24.1,992.0,15.0,145.0,488.0,380.0,34.0,992.0,70.0,31.0,44.3,30.0,42.9,591.0,3342.0,1599.0,39.0,42.0,3.0,59.0,47.0,689.0,83.0,Matches,603.0,rs SRB,MFFW,30.0,24.1,3.0,26.0,12.0,46.2,1.08,0.5,0.12,0.25,18.3,1.0,0.0,0.0,2.7,2.7,0.1,0.3,0.3,Matches,603.0,rs SRB,MFFW,30.0,32.0,27.0,2171.0,24.1,3.0,0.0,3.0,3.0,0.0,0.0,9.0,0.0,2.7,2.7,1.9,4.6,39.0,77.0,83.0,0.12,0.0,0.12,0.12,0.12,0.11,0.08,0.19,0.11,0.19,Matches,Filip Đuričić,M/AM LC,30,130,142,Serbia,U.C. Sampdoria,11,11,14,13,16,10,4,12,4,4,14,13,4,16,9,14,7,13,10,14,13,14,17,12,15,6,12,12,13,14,15,8,13,12,12,9,12,8,10,12,16,3,1,3,2,2,2,3,2,2,2,3,14,14,16,5,13,11,11,10,1,1,1,1,1,1,1,16,14,1,18,20,14,14,181,67,14,20,3353089,6500,6800,5450,Northern_European,130,4,1992/1/30,35,4,24626.0,,62015188
